year,country_origin,country_origin(ISO),country_asylum,country_asylum(ISO),recognized_decisions,complementary_protection,rejected_decisions,otherwise_closed,total_decisions
2001,Afghanistan,AFG,Australia,AUS,247,0,93,5,345
2001,Albania,ALB,Australia,AUS,5,0,13,0,18
2001,Algeria,DZA,Australia,AUS,5,0,13,0,18
2001,Egypt,EGY,Australia,AUS,12,0,29,5,46
2001,Burundi,BDI,Australia,AUS,5,0,0,0,5
2001,Bangladesh,BGD,Australia,AUS,5,0,75,10,90
2001,Belarus,BLR,Australia,AUS,5,0,5,0,10
2001,Brazil,BRA,Australia,AUS,0,0,5,0,5
2001,Bosnia and Herzegovina,BIH,Australia,AUS,5,0,0,0,5
2001,Bulgaria,BGR,Australia,AUS,0,0,19,10,29
2001,Cambodia,KHM,Australia,AUS,0,0,31,0,31
2001,China,CHN,Australia,AUS,37,0,786,71,894
2001,Chile,CHL,Australia,AUS,0,0,13,0,13
2001,Dem. Rep. of the Congo,COD,Australia,AUS,5,0,0,0,5
2001,Colombia,COL,Australia,AUS,12,0,63,11,86
2001,Cuba,CUB,Australia,AUS,0,0,0,5,5
2001,Ecuador,ECU,Australia,AUS,0,0,11,0,11
2001,Ethiopia,ETH,Australia,AUS,5,0,5,0,10
2001,Fiji,FJI,Australia,AUS,0,0,347,39,386
2001,Palestinian,PSE,Australia,AUS,10,0,39,0,49
2001,Georgia,GEO,Australia,AUS,0,0,14,0,14
2001,Ghana,GHA,Australia,AUS,0,0,5,5,10
2001,"China, Hong Kong SAR",HKG,Australia,AUS,0,0,10,0,10
2001,Hungary,HUN,Australia,AUS,0,0,5,0,5
2001,India,IND,Australia,AUS,5,0,433,58,496
2001,Indonesia,IDN,Australia,AUS,10,0,872,59,941
2001,Iran (Islamic Rep. of),IRN,Australia,AUS,87,0,278,17,382
2001,Iraq,IRQ,Australia,AUS,101,0,17,5,123
2001,Israel,ISR,Australia,AUS,0,0,5,5,10
2001,Jordan,JOR,Australia,AUS,0,0,14,5,19
2001,Kenya,KEN,Australia,AUS,0,0,5,0,5
2001,Rep. of Korea,KOR,Australia,AUS,0,0,78,5,83
2001,Kuwait,KWT,Australia,AUS,5,0,0,0,5
2001,Lao People's Dem. Rep.,LAO,Australia,AUS,0,0,5,0,5
2001,Lebanon,LBN,Australia,AUS,5,0,46,17,68
2001,Sri Lanka,LKA,Australia,AUS,50,0,182,17,249
2001,Latvia,LVA,Australia,AUS,0,0,5,0,5
2001,North Macedonia,MKD,Australia,AUS,0,0,11,0,11
2001,Rep. of Moldova,MDA,Australia,AUS,0,0,13,5,18
2001,Malaysia,MYS,Australia,AUS,0,0,160,10,170
2001,Morocco,MAR,Australia,AUS,0,0,5,0,5
2001,Myanmar,MMR,Australia,AUS,35,0,33,0,68
2001,Nepal,NPL,Australia,AUS,0,0,52,12,64
2001,Nigeria,NGA,Australia,AUS,0,0,33,5,38
2001,Pakistan,PAK,Australia,AUS,5,0,66,12,83
2001,Peru,PER,Australia,AUS,0,0,24,5,29
2001,Philippines,PHL,Australia,AUS,0,0,193,17,210
2001,Poland,POL,Australia,AUS,0,0,5,0,5
2001,Romania,ROU,Australia,AUS,0,0,11,0,11
2001,South Africa,ZAF,Australia,AUS,0,0,5,0,5
2001,Russian Federation,RUS,Australia,AUS,12,0,30,10,52
2001,Rwanda,RWA,Australia,AUS,0,0,5,0,5
2001,El Salvador,SLV,Australia,AUS,0,0,5,0,5
2001,Serbia and Kosovo: S/RES/1244 (1999),SRB,Australia,AUS,10,0,30,5,45
2001,Senegal,SEN,Australia,AUS,0,0,0,5,5
2001,Singapore,SGP,Australia,AUS,0,0,5,0,5
2001,Sierra Leone,SLE,Australia,AUS,5,0,5,0,10
2001,Somalia,SOM,Australia,AUS,11,0,0,0,11
2001,Viet Nam,VNM,Australia,AUS,0,0,121,15,136
2001,Sudan,SDN,Australia,AUS,5,0,5,0,10
2001,Syrian Arab Rep.,SYR,Australia,AUS,13,0,57,5,75
2001,Thailand,THA,Australia,AUS,0,0,150,10,160
2001,Tonga,TON,Australia,AUS,0,0,10,0,10
2001,Tunisia,TUN,Australia,AUS,5,0,0,0,5
2001,Turkey,TUR,Australia,AUS,5,0,27,13,45
2001,Uganda,UGA,Australia,AUS,0,0,5,0,5
2001,Ukraine,UKR,Australia,AUS,5,0,43,10,58
2001,Yemen,YEM,Australia,AUS,0,0,0,5,5
2001,Afghanistan,AFG,Czechia,CZE,0,0,29,42,71
2001,Algeria,DZA,Czechia,CZE,0,0,0,14,14
2001,Angola,AGO,Czechia,CZE,0,0,0,5,5
2001,Armenia,ARM,Czechia,CZE,0,0,41,10,51
2001,Azerbaijan,AZE,Czechia,CZE,0,0,0,5,5
2001,Belarus,BLR,Czechia,CZE,5,0,5,13,23
2001,Bosnia and Herzegovina,BIH,Czechia,CZE,0,0,5,0,5
2001,Bulgaria,BGR,Czechia,CZE,0,0,51,21,72
2001,Georgia,GEO,Czechia,CZE,0,0,5,12,17
2001,Ghana,GHA,Czechia,CZE,0,0,5,0,5
2001,India,IND,Czechia,CZE,0,0,0,11,11
2001,Iran (Islamic Rep. of),IRN,Czechia,CZE,0,0,5,0,5
2001,Iraq,IRQ,Czechia,CZE,0,0,0,5,5
2001,Kazakhstan,KAZ,Czechia,CZE,0,0,13,0,13
2001,Sri Lanka,LKA,Czechia,CZE,0,0,5,0,5
2001,North Macedonia,MKD,Czechia,CZE,0,0,13,0,13
2001,Rep. of Moldova,MDA,Czechia,CZE,0,0,59,44,103
2001,Mongolia,MNG,Czechia,CZE,0,0,15,5,20
2001,Nigeria,NGA,Czechia,CZE,0,0,0,5,5
2001,Pakistan,PAK,Czechia,CZE,0,0,5,0,5
2001,Romania,ROU,Czechia,CZE,0,0,85,74,159
2001,Russian Federation,RUS,Czechia,CZE,0,0,46,54,100
2001,Serbia and Kosovo: S/RES/1244 (1999),SRB,Czechia,CZE,0,0,14,5,19
2001,Viet Nam,VNM,Czechia,CZE,0,0,119,55,174
2001,Slovakia,SVK,Czechia,CZE,0,0,119,125,244
2001,Ukraine,UKR,Czechia,CZE,0,0,329,177,506
2001,Uzbekistan,UZB,Czechia,CZE,0,0,0,5,5
2002,Afghanistan,AFG,Australia,AUS,49,0,101,0,150
2002,Albania,ALB,Australia,AUS,0,0,25,5,30
2002,Algeria,DZA,Australia,AUS,0,0,12,0,12
2002,Angola,AGO,Australia,AUS,0,0,5,0,5
2002,Egypt,EGY,Australia,AUS,14,0,31,0,45
2002,Argentina,ARG,Australia,AUS,0,0,11,5,16
2002,Armenia,ARM,Australia,AUS,0,0,0,5,5
2002,Azerbaijan,AZE,Australia,AUS,0,0,5,0,5
2002,Bangladesh,BGD,Australia,AUS,5,0,229,15,249
2002,Belarus,BLR,Australia,AUS,0,0,10,0,10
2002,Bolivia (Plurinational State of),BOL,Australia,AUS,0,0,5,0,5
2002,Brazil,BRA,Australia,AUS,0,0,14,5,19
2002,Bulgaria,BGR,Australia,AUS,0,0,22,0,22
2002,Cambodia,KHM,Australia,AUS,0,0,19,0,19
2002,China,CHN,Australia,AUS,30,0,684,55,769
2002,Chile,CHL,Australia,AUS,0,0,21,5,26
2002,Cameroon,CMR,Australia,AUS,5,0,0,0,5
2002,Dem. Rep. of the Congo,COD,Australia,AUS,0,0,10,0,10
2002,Colombia,COL,Australia,AUS,19,0,72,5,96
2002,Cuba,CUB,Australia,AUS,5,0,0,0,5
2002,Cyprus,CYP,Australia,AUS,0,0,5,0,5
2002,Czechia,CZE,Australia,AUS,0,0,5,0,5
2002,Ecuador,ECU,Australia,AUS,0,0,15,0,15
2002,Estonia,EST,Australia,AUS,0,0,5,0,5
2002,Ethiopia,ETH,Australia,AUS,0,0,12,0,12
2002,Fiji,FJI,Australia,AUS,0,0,340,49,389
2002,France,FRA,Australia,AUS,0,0,5,0,5
2002,Palestinian,PSE,Australia,AUS,12,0,5,0,17
2002,Georgia,GEO,Australia,AUS,0,0,16,0,16
2002,Ghana,GHA,Australia,AUS,0,0,31,0,31
2002,Croatia,HRV,Australia,AUS,0,0,13,0,13
2002,Hungary,HUN,Australia,AUS,0,0,0,5,5
2002,India,IND,Australia,AUS,5,0,710,54,769
2002,Indonesia,IDN,Australia,AUS,13,0,583,38,634
2002,Iran (Islamic Rep. of),IRN,Australia,AUS,39,0,99,0,138
2002,Iraq,IRQ,Australia,AUS,58,0,10,0,68
2002,Israel,ISR,Australia,AUS,0,0,0,11,11
2002,Italy,ITA,Australia,AUS,0,0,5,0,5
2002,Jordan,JOR,Australia,AUS,5,0,13,5,23
2002,Japan,JPN,Australia,AUS,0,0,0,5,5
2002,Kenya,KEN,Australia,AUS,0,0,13,0,13
2002,Kyrgyzstan,KGZ,Australia,AUS,14,0,0,0,14
2002,Rep. of Korea,KOR,Australia,AUS,0,0,119,5,124
2002,Lao People's Dem. Rep.,LAO,Australia,AUS,0,0,5,0,5
2002,Lebanon,LBN,Australia,AUS,12,0,94,13,119
2002,Sri Lanka,LKA,Australia,AUS,32,0,222,37,291
2002,Lithuania,LTU,Australia,AUS,0,0,5,0,5
2002,Latvia,LVA,Australia,AUS,0,0,21,0,21
2002,Mauritania,MRT,Australia,AUS,5,0,0,0,5
2002,North Macedonia,MKD,Australia,AUS,0,0,98,13,111
2002,Rep. of Moldova,MDA,Australia,AUS,0,0,21,0,21
2002,Malaysia,MYS,Australia,AUS,5,0,144,10,159
2002,Mongolia,MNG,Australia,AUS,0,0,44,5,49
2002,Morocco,MAR,Australia,AUS,0,0,5,0,5
2002,Mauritius,MUS,Australia,AUS,0,0,5,0,5
2002,Myanmar,MMR,Australia,AUS,23,0,51,5,79
2002,Nepal,NPL,Australia,AUS,12,0,177,12,201
2002,Nigeria,NGA,Australia,AUS,0,0,63,10,73
2002,Pakistan,PAK,Australia,AUS,10,0,104,14,128
2002,Peru,PER,Australia,AUS,5,0,41,5,51
2002,Philippines,PHL,Australia,AUS,0,0,106,11,117
2002,Poland,POL,Australia,AUS,0,0,11,0,11
2002,Portugal,PRT,Australia,AUS,0,0,5,0,5
2002,Romania,ROU,Australia,AUS,5,0,15,0,20
2002,South Africa,ZAF,Australia,AUS,0,0,26,0,26
2002,Russian Federation,RUS,Australia,AUS,17,0,56,5,78
2002,Rwanda,RWA,Australia,AUS,5,0,0,0,5
2002,Serbia and Kosovo: S/RES/1244 (1999),SRB,Australia,AUS,5,0,51,11,67
2002,Senegal,SEN,Australia,AUS,0,0,5,0,5
2002,Sierra Leone,SLE,Australia,AUS,0,0,14,0,14
2002,Solomon Islands,SLB,Australia,AUS,0,0,5,0,5
2002,Somalia,SOM,Australia,AUS,10,0,0,0,10
2002,Spain,ESP,Australia,AUS,0,0,5,0,5
2002,Viet Nam,VNM,Australia,AUS,0,0,147,20,167
2002,Sudan,SDN,Australia,AUS,5,0,5,0,10
2002,Syrian Arab Rep.,SYR,Australia,AUS,5,0,30,5,40
2002,United Rep. of Tanzania,TZA,Australia,AUS,0,0,5,0,5
2002,Thailand,THA,Australia,AUS,0,0,148,16,164
2002,Timor-Leste,TLS,Australia,AUS,0,0,40,5,45
2002,Tonga,TON,Australia,AUS,0,0,18,5,23
2002,Tunisia,TUN,Australia,AUS,5,0,0,0,5
2002,Turkey,TUR,Australia,AUS,18,0,44,10,72
2002,Uganda,UGA,Australia,AUS,0,0,10,0,10
2002,Ukraine,UKR,Australia,AUS,12,0,130,14,156
2002,Uruguay,URY,Australia,AUS,0,0,10,0,10
2002,Uzbekistan,UZB,Australia,AUS,0,0,11,0,11
2002,Samoa,WSM,Australia,AUS,0,0,5,0,5
2002,Zambia,ZMB,Australia,AUS,0,0,5,0,5
2002,Zimbabwe,ZWE,Australia,AUS,5,0,10,0,15
2002,Afghanistan,AFG,Czechia,CZE,0,0,18,5,23
2002,Algeria,DZA,Czechia,CZE,0,0,12,5,17
2002,Angola,AGO,Czechia,CZE,0,0,5,0,5
2002,Armenia,ARM,Czechia,CZE,0,0,15,10,25
2002,Belarus,BLR,Czechia,CZE,0,0,29,29,58
2002,Bulgaria,BGR,Czechia,CZE,0,0,45,25,70
2002,China,CHN,Czechia,CZE,0,0,0,5,5
2002,Georgia,GEO,Czechia,CZE,0,0,32,34,66
2002,Cote d'Ivoire,CIV,Czechia,CZE,0,0,0,5,5
2002,India,IND,Czechia,CZE,0,0,0,10,10
2002,Iraq,IRQ,Czechia,CZE,0,0,0,5,5
2002,Kazakhstan,KAZ,Czechia,CZE,0,0,11,10,21
2002,Sri Lanka,LKA,Czechia,CZE,0,0,0,5,5
2002,North Macedonia,MKD,Czechia,CZE,0,0,0,13,13
2002,Rep. of Moldova,MDA,Czechia,CZE,0,0,145,108,253
2002,Mongolia,MNG,Czechia,CZE,0,0,20,5,25
2002,Nigeria,NGA,Czechia,CZE,0,0,0,5,5
2002,Romania,ROU,Czechia,CZE,0,0,83,76,159
2002,Russian Federation,RUS,Czechia,CZE,0,0,84,40,124
2002,Serbia and Kosovo: S/RES/1244 (1999),SRB,Czechia,CZE,0,0,16,10,26
2002,Viet Nam,VNM,Czechia,CZE,0,0,214,94,308
2002,Slovakia,SVK,Czechia,CZE,0,0,60,28,88
2002,Turkey,TUR,Czechia,CZE,0,0,0,5,5
2002,Ukraine,UKR,Czechia,CZE,0,0,572,441,1013
2002,Stateless,XXA,Czechia,CZE,0,0,5,0,5
2002,Afghanistan,AFG,United Kingdom of Great Britain and Northern Ireland,GBR,230,0,1235,580,2045
2002,Albania,ALB,United Kingdom of Great Britain and Northern Ireland,GBR,165,0,955,80,1200
2002,Algeria,DZA,United Kingdom of Great Britain and Northern Ireland,GBR,200,0,1190,75,1465
2002,Angola,AGO,United Kingdom of Great Britain and Northern Ireland,GBR,120,0,365,80,565
2002,Burundi,BDI,United Kingdom of Great Britain and Northern Ireland,GBR,90,0,230,35,355
2002,Bangladesh,BGD,United Kingdom of Great Britain and Northern Ireland,GBR,55,0,505,25,585
2002,China,CHN,United Kingdom of Great Britain and Northern Ireland,GBR,165,0,2395,35,2595
2002,Cameroon,CMR,United Kingdom of Great Britain and Northern Ireland,GBR,150,0,315,15,480
2002,Congo,COG,United Kingdom of Great Britain and Northern Ireland,GBR,180,0,405,30,615
2002,Dem. Rep. of the Congo,COD,United Kingdom of Great Britain and Northern Ireland,GBR,520,0,1035,95,1650
2002,Colombia,COL,United Kingdom of Great Britain and Northern Ireland,GBR,160,0,465,35,660
2002,Czechia,CZE,United Kingdom of Great Britain and Northern Ireland,GBR,50,0,825,85,960
2002,Ecuador,ECU,United Kingdom of Great Britain and Northern Ireland,GBR,45,0,305,15,365
2002,Eritrea,ERI,United Kingdom of Great Britain and Northern Ireland,GBR,275,0,390,40,705
2002,Ethiopia,ETH,United Kingdom of Great Britain and Northern Ireland,GBR,230,0,340,50,620
2002,Gambia,GMB,United Kingdom of Great Britain and Northern Ireland,GBR,11,0,36,0,47
2002,Ghana,GHA,United Kingdom of Great Britain and Northern Ireland,GBR,10,0,175,15,200
2002,Cote d'Ivoire,CIV,United Kingdom of Great Britain and Northern Ireland,GBR,65,0,245,15,325
2002,India,IND,United Kingdom of Great Britain and Northern Ireland,GBR,45,0,1580,70,1695
2002,Iran (Islamic Rep. of),IRN,United Kingdom of Great Britain and Northern Ireland,GBR,1430,0,2210,125,3765
2002,Iraq,IRQ,United Kingdom of Great Britain and Northern Ireland,GBR,1130,0,2970,470,4570
2002,Jamaica,JAM,United Kingdom of Great Britain and Northern Ireland,GBR,40,0,320,40,400
2002,Kenya,KEN,United Kingdom of Great Britain and Northern Ireland,GBR,95,0,430,30,555
2002,Sri Lanka,LKA,United Kingdom of Great Britain and Northern Ireland,GBR,1455,0,4880,100,6435
2002,North Macedonia,MKD,United Kingdom of Great Britain and Northern Ireland,GBR,55,0,390,40,485
2002,Rep. of Moldova,MDA,United Kingdom of Great Britain and Northern Ireland,GBR,25,0,245,20,290
2002,Nigeria,NGA,United Kingdom of Great Britain and Northern Ireland,GBR,60,0,790,55,905
2002,Pakistan,PAK,United Kingdom of Great Britain and Northern Ireland,GBR,395,0,2150,150,2695
2002,Poland,POL,United Kingdom of Great Britain and Northern Ireland,GBR,35,0,800,60,895
2002,Romania,ROU,United Kingdom of Great Britain and Northern Ireland,GBR,35,0,670,55,760
2002,Russian Federation,RUS,United Kingdom of Great Britain and Northern Ireland,GBR,345,0,1360,105,1815
2002,Rwanda,RWA,United Kingdom of Great Britain and Northern Ireland,GBR,60,0,185,30,275
2002,Serbia and Kosovo: S/RES/1244 (1999),SRB,United Kingdom of Great Britain and Northern Ireland,GBR,995,0,4580,355,5930
2002,Sierra Leone,SLE,United Kingdom of Great Britain and Northern Ireland,GBR,120,0,870,40,1030
2002,Somalia,SOM,United Kingdom of Great Britain and Northern Ireland,GBR,1065,0,1570,380,3015
2002,Viet Nam,VNM,United Kingdom of Great Britain and Northern Ireland,GBR,50,0,250,5,305
2002,Sudan,SDN,United Kingdom of Great Britain and Northern Ireland,GBR,225,0,240,20,485
2002,United Rep. of Tanzania,TZA,United Kingdom of Great Britain and Northern Ireland,GBR,10,0,50,5,65
2002,Turkey,TUR,United Kingdom of Great Britain and Northern Ireland,GBR,1320,0,4070,130,5520
2002,Uganda,UGA,United Kingdom of Great Britain and Northern Ireland,GBR,155,0,570,25,750
2002,Ukraine,UKR,United Kingdom of Great Britain and Northern Ireland,GBR,65,0,420,30,515
2002,Zimbabwe,ZWE,United Kingdom of Great Britain and Northern Ireland,GBR,925,0,1370,110,2405
2003,Afghanistan,AFG,Australia,AUS,22,0,13,0,35
2003,Albania,ALB,Australia,AUS,0,0,23,5,28
2003,Algeria,DZA,Australia,AUS,0,0,5,0,5
2003,Angola,AGO,Australia,AUS,0,0,5,0,5
2003,Egypt,EGY,Australia,AUS,10,0,32,0,42
2003,Argentina,ARG,Australia,AUS,0,0,16,5,21
2003,Armenia,ARM,Australia,AUS,0,0,5,0,5
2003,Azerbaijan,AZE,Australia,AUS,0,0,5,0,5
2003,Bangladesh,BGD,Australia,AUS,16,0,341,10,367
2003,Belarus,BLR,Australia,AUS,5,0,5,0,10
2003,Bolivia (Plurinational State of),BOL,Australia,AUS,0,0,5,0,5
2003,Brazil,BRA,Australia,AUS,5,0,34,0,39
2003,Bosnia and Herzegovina,BIH,Australia,AUS,0,0,5,0,5
2003,Bulgaria,BGR,Australia,AUS,0,0,5,0,5
2003,Cambodia,KHM,Australia,AUS,0,0,16,0,16
2003,China,CHN,Australia,AUS,34,0,1069,88,1191
2003,Chile,CHL,Australia,AUS,0,0,12,5,17
2003,Cameroon,CMR,Australia,AUS,0,0,5,0,5
2003,Dem. Rep. of the Congo,COD,Australia,AUS,5,0,5,0,10
2003,Colombia,COL,Australia,AUS,12,0,21,5,38
2003,Cyprus,CYP,Australia,AUS,0,0,19,0,19
2003,Ecuador,ECU,Australia,AUS,0,0,13,0,13
2003,Eritrea,ERI,Australia,AUS,5,0,5,0,10
2003,Ethiopia,ETH,Australia,AUS,0,0,14,0,14
2003,Fiji,FJI,Australia,AUS,0,0,225,24,249
2003,Palestinian,PSE,Australia,AUS,5,0,5,0,10
2003,United Kingdom of Great Britain and Northern Ireland,GBR,Australia,AUS,0,0,5,0,5
2003,Georgia,GEO,Australia,AUS,0,0,5,0,5
2003,Ghana,GHA,Australia,AUS,0,0,26,0,26
2003,Guinea,GIN,Australia,AUS,5,0,0,0,5
2003,"China, Hong Kong SAR",HKG,Australia,AUS,0,0,5,5,10
2003,Croatia,HRV,Australia,AUS,0,0,5,5,10
2003,Hungary,HUN,Australia,AUS,0,0,5,0,5
2003,India,IND,Australia,AUS,0,0,607,46,653
2003,Indonesia,IDN,Australia,AUS,13,0,438,27,478
2003,Iran (Islamic Rep. of),IRN,Australia,AUS,29,0,45,0,74
2003,Iraq,IRQ,Australia,AUS,5,0,10,5,20
2003,Israel,ISR,Australia,AUS,5,0,14,13,32
2003,Jordan,JOR,Australia,AUS,0,0,14,0,14
2003,Kazakhstan,KAZ,Australia,AUS,5,0,0,0,5
2003,Kenya,KEN,Australia,AUS,0,0,12,0,12
2003,Kyrgyzstan,KGZ,Australia,AUS,5,0,0,0,5
2003,Rep. of Korea,KOR,Australia,AUS,0,0,211,17,228
2003,Lao People's Dem. Rep.,LAO,Australia,AUS,0,0,12,0,12
2003,Lebanon,LBN,Australia,AUS,17,0,165,11,193
2003,Sri Lanka,LKA,Australia,AUS,10,0,240,21,271
2003,Lithuania,LTU,Australia,AUS,0,0,23,0,23
2003,Latvia,LVA,Australia,AUS,0,0,5,0,5
2003,North Macedonia,MKD,Australia,AUS,0,0,24,5,29
2003,Rep. of Moldova,MDA,Australia,AUS,0,0,16,0,16
2003,Malaysia,MYS,Australia,AUS,0,0,145,13,158
2003,Mongolia,MNG,Australia,AUS,0,0,72,11,83
2003,Myanmar,MMR,Australia,AUS,28,0,31,0,59
2003,Nepal,NPL,Australia,AUS,10,0,59,0,69
2003,Nigeria,NGA,Australia,AUS,5,0,42,5,52
2003,Pakistan,PAK,Australia,AUS,11,0,141,10,162
2003,Peru,PER,Australia,AUS,0,0,55,0,55
2003,Philippines,PHL,Australia,AUS,0,0,27,5,32
2003,Poland,POL,Australia,AUS,0,0,26,0,26
2003,Portugal,PRT,Australia,AUS,0,0,0,5,5
2003,Romania,ROU,Australia,AUS,0,0,13,0,13
2003,South Africa,ZAF,Australia,AUS,0,0,18,0,18
2003,Russian Federation,RUS,Australia,AUS,18,0,77,5,100
2003,El Salvador,SLV,Australia,AUS,0,0,5,0,5
2003,Serbia and Kosovo: S/RES/1244 (1999),SRB,Australia,AUS,0,0,15,5,20
2003,Senegal,SEN,Australia,AUS,0,0,5,0,5
2003,Sierra Leone,SLE,Australia,AUS,0,0,5,0,5
2003,Somalia,SOM,Australia,AUS,5,0,0,0,5
2003,Viet Nam,VNM,Australia,AUS,5,0,88,10,103
2003,Syrian Arab Rep.,SYR,Australia,AUS,0,0,11,0,11
2003,United Rep. of Tanzania,TZA,Australia,AUS,0,0,5,0,5
2003,Thailand,THA,Australia,AUS,0,0,241,27,268
2003,Timor-Leste,TLS,Australia,AUS,0,0,584,42,626
2003,Tonga,TON,Australia,AUS,0,0,54,5,59
2003,Tunisia,TUN,Australia,AUS,5,0,0,0,5
2003,Turkey,TUR,Australia,AUS,12,0,32,5,49
2003,Uganda,UGA,Australia,AUS,5,0,0,0,5
2003,Ukraine,UKR,Australia,AUS,10,0,115,5,130
2003,Uruguay,URY,Australia,AUS,0,0,20,10,30
2003,United States of America,USA,Australia,AUS,0,0,5,0,5
2003,Uzbekistan,UZB,Australia,AUS,5,0,5,0,10
2003,Samoa,WSM,Australia,AUS,0,0,5,0,5
2003,Yemen,YEM,Australia,AUS,0,0,5,0,5
2003,Zimbabwe,ZWE,Australia,AUS,16,0,5,5,26
2003,Afghanistan,AFG,United Kingdom of Great Britain and Northern Ireland,GBR,695,0,4415,440,5550
2003,Albania,ALB,United Kingdom of Great Britain and Northern Ireland,GBR,120,0,885,90,1095
2003,Algeria,DZA,United Kingdom of Great Britain and Northern Ireland,GBR,200,0,1255,110,1565
2003,Angola,AGO,United Kingdom of Great Britain and Northern Ireland,GBR,160,0,690,80,930
2003,Burundi,BDI,United Kingdom of Great Britain and Northern Ireland,GBR,160,0,500,50,710
2003,Bangladesh,BGD,United Kingdom of Great Britain and Northern Ireland,GBR,50,0,575,45,670
2003,China,CHN,United Kingdom of Great Britain and Northern Ireland,GBR,160,0,2550,60,2770
2003,Cameroon,CMR,United Kingdom of Great Britain and Northern Ireland,GBR,170,0,540,25,735
2003,Congo,COG,United Kingdom of Great Britain and Northern Ireland,GBR,150,0,445,30,625
2003,Dem. Rep. of the Congo,COD,United Kingdom of Great Britain and Northern Ireland,GBR,720,0,1915,110,2745
2003,Colombia,COL,United Kingdom of Great Britain and Northern Ireland,GBR,160,0,475,30,665
2003,Czechia,CZE,United Kingdom of Great Britain and Northern Ireland,GBR,30,0,595,60,685
2003,Ecuador,ECU,United Kingdom of Great Britain and Northern Ireland,GBR,50,0,375,20,445
2003,Eritrea,ERI,United Kingdom of Great Britain and Northern Ireland,GBR,500,0,960,60,1520
2003,Ethiopia,ETH,United Kingdom of Great Britain and Northern Ireland,GBR,325,0,680,55,1060
2003,Gambia,GMB,United Kingdom of Great Britain and Northern Ireland,GBR,5,0,100,5,110
2003,Ghana,GHA,United Kingdom of Great Britain and Northern Ireland,GBR,20,0,285,35,340
2003,Cote d'Ivoire,CIV,United Kingdom of Great Britain and Northern Ireland,GBR,120,0,450,35,605
2003,India,IND,United Kingdom of Great Britain and Northern Ireland,GBR,55,0,1635,75,1765
2003,Iran (Islamic Rep. of),IRN,United Kingdom of Great Britain and Northern Ireland,GBR,1440,0,3255,175,4870
2003,Iraq,IRQ,United Kingdom of Great Britain and Northern Ireland,GBR,490,0,4435,475,5400
2003,Jamaica,JAM,United Kingdom of Great Britain and Northern Ireland,GBR,70,0,875,90,1035
2003,Kenya,KEN,United Kingdom of Great Britain and Northern Ireland,GBR,105,0,480,35,620
2003,Liberia,LBR,United Kingdom of Great Britain and Northern Ireland,GBR,110,0,345,20,475
2003,Sri Lanka,LKA,United Kingdom of Great Britain and Northern Ireland,GBR,715,0,4730,160,5605
2003,North Macedonia,MKD,United Kingdom of Great Britain and Northern Ireland,GBR,25,0,180,15,220
2003,Rep. of Moldova,MDA,United Kingdom of Great Britain and Northern Ireland,GBR,25,0,335,15,375
2003,Nigeria,NGA,United Kingdom of Great Britain and Northern Ireland,GBR,75,0,915,55,1045
2003,Pakistan,PAK,United Kingdom of Great Britain and Northern Ireland,GBR,535,0,2240,155,2930
2003,Poland,POL,United Kingdom of Great Britain and Northern Ireland,GBR,30,0,545,45,620
2003,Romania,ROU,United Kingdom of Great Britain and Northern Ireland,GBR,25,0,645,35,705
2003,Russian Federation,RUS,United Kingdom of Great Britain and Northern Ireland,GBR,325,0,1530,130,1985
2003,Rwanda,RWA,United Kingdom of Great Britain and Northern Ireland,GBR,130,0,465,40,635
2003,Serbia and Kosovo: S/RES/1244 (1999),SRB,United Kingdom of Great Britain and Northern Ireland,GBR,1010,0,5825,435,7270
2003,Sierra Leone,SLE,United Kingdom of Great Britain and Northern Ireland,GBR,155,0,930,90,1175
2003,Somalia,SOM,United Kingdom of Great Britain and Northern Ireland,GBR,2015,0,2960,390,5365
2003,Viet Nam,VNM,United Kingdom of Great Britain and Northern Ireland,GBR,75,0,760,30,865
2003,Sudan,SDN,United Kingdom of Great Britain and Northern Ireland,GBR,310,0,470,40,820
2003,United Rep. of Tanzania,TZA,United Kingdom of Great Britain and Northern Ireland,GBR,20,0,60,5,85
2003,Turkey,TUR,United Kingdom of Great Britain and Northern Ireland,GBR,1665,0,3880,185,5730
2003,Uganda,UGA,United Kingdom of Great Britain and Northern Ireland,GBR,205,0,680,40,925
2003,Ukraine,UKR,United Kingdom of Great Britain and Northern Ireland,GBR,70,0,415,30,515
2003,Zimbabwe,ZWE,United Kingdom of Great Britain and Northern Ireland,GBR,1140,0,2745,205,4090
2004,Afghanistan,AFG,Australia,AUS,729,0,63,5,797
2004,Albania,ALB,Australia,AUS,5,0,38,0,43
2004,Egypt,EGY,Australia,AUS,15,0,46,0,61
2004,Bangladesh,BGD,Australia,AUS,23,0,102,10,135
2004,Brazil,BRA,Australia,AUS,0,0,20,0,20
2004,China,CHN,Australia,AUS,77,0,841,44,962
2004,Fiji,FJI,Australia,AUS,5,0,75,10,90
2004,Ghana,GHA,Australia,AUS,5,0,14,0,19
2004,"China, Hong Kong SAR",HKG,Australia,AUS,0,0,16,0,16
2004,India,IND,Australia,AUS,5,0,422,24,451
2004,Indonesia,IDN,Australia,AUS,5,0,147,15,167
2004,Iran (Islamic Rep. of),IRN,Australia,AUS,45,0,19,0,64
2004,Iraq,IRQ,Australia,AUS,5,0,10,0,15
2004,Israel,ISR,Australia,AUS,5,0,21,5,31
2004,Jordan,JOR,Australia,AUS,5,0,11,0,16
2004,Kenya,KEN,Australia,AUS,0,0,19,0,19
2004,Rep. of Korea,KOR,Australia,AUS,0,0,53,5,58
2004,Lebanon,LBN,Australia,AUS,12,0,48,5,65
2004,Sri Lanka,LKA,Australia,AUS,15,0,108,5,128
2004,Lithuania,LTU,Australia,AUS,0,0,13,0,13
2004,North Macedonia,MKD,Australia,AUS,0,0,10,5,15
2004,Malaysia,MYS,Australia,AUS,0,0,134,14,148
2004,Mongolia,MNG,Australia,AUS,5,0,20,0,25
2004,Myanmar,MMR,Australia,AUS,14,0,12,0,26
2004,Nepal,NPL,Australia,AUS,5,0,50,0,55
2004,Nigeria,NGA,Australia,AUS,10,0,34,5,49
2004,Pakistan,PAK,Australia,AUS,12,0,42,5,59
2004,Philippines,PHL,Australia,AUS,0,0,49,5,54
2004,Poland,POL,Australia,AUS,0,0,15,0,15
2004,Romania,ROU,Australia,AUS,0,0,15,0,15
2004,Russian Federation,RUS,Australia,AUS,5,0,16,0,21
2004,Serbia and Kosovo: S/RES/1244 (1999),SRB,Australia,AUS,0,0,18,0,18
2004,Viet Nam,VNM,Australia,AUS,5,0,59,5,69
2004,Syrian Arab Rep.,SYR,Australia,AUS,11,0,17,0,28
2004,Thailand,THA,Australia,AUS,0,0,59,16,75
2004,Tonga,TON,Australia,AUS,0,0,32,0,32
2004,Turkey,TUR,Australia,AUS,16,0,39,5,60
2004,Afghanistan,AFG,United Kingdom of Great Britain and Northern Ireland,GBR,325,0,2595,150,3070
2004,Albania,ALB,United Kingdom of Great Britain and Northern Ireland,GBR,55,0,300,35,390
2004,Algeria,DZA,United Kingdom of Great Britain and Northern Ireland,GBR,60,0,760,70,890
2004,Angola,AGO,United Kingdom of Great Britain and Northern Ireland,GBR,125,0,645,30,800
2004,Burundi,BDI,United Kingdom of Great Britain and Northern Ireland,GBR,85,0,395,40,520
2004,Bangladesh,BGD,United Kingdom of Great Britain and Northern Ireland,GBR,10,0,185,20,215
2004,China,CHN,United Kingdom of Great Britain and Northern Ireland,GBR,135,0,2120,50,2305
2004,Cameroon,CMR,United Kingdom of Great Britain and Northern Ireland,GBR,115,0,405,25,545
2004,Congo,COG,United Kingdom of Great Britain and Northern Ireland,GBR,70,0,345,30,445
2004,Dem. Rep. of the Congo,COD,United Kingdom of Great Britain and Northern Ireland,GBR,400,0,1585,55,2040
2004,Colombia,COL,United Kingdom of Great Britain and Northern Ireland,GBR,45,0,230,35,310
2004,Czechia,CZE,United Kingdom of Great Britain and Northern Ireland,GBR,5,0,60,10,75
2004,Ecuador,ECU,United Kingdom of Great Britain and Northern Ireland,GBR,5,0,110,5,120
2004,Eritrea,ERI,United Kingdom of Great Britain and Northern Ireland,GBR,405,0,605,35,1045
2004,Ethiopia,ETH,United Kingdom of Great Britain and Northern Ireland,GBR,220,0,585,25,830
2004,Gambia,GMB,United Kingdom of Great Britain and Northern Ireland,GBR,5,0,110,5,120
2004,Ghana,GHA,United Kingdom of Great Britain and Northern Ireland,GBR,5,0,290,25,320
2004,Cote d'Ivoire,CIV,United Kingdom of Great Britain and Northern Ireland,GBR,65,0,275,15,355
2004,India,IND,United Kingdom of Great Britain and Northern Ireland,GBR,20,0,1040,35,1095
2004,Iran (Islamic Rep. of),IRN,United Kingdom of Great Britain and Northern Ireland,GBR,985,0,3305,140,4430
2004,Iraq,IRQ,United Kingdom of Great Britain and Northern Ireland,GBR,280,0,6250,135,6665
2004,Jamaica,JAM,United Kingdom of Great Britain and Northern Ireland,GBR,50,0,425,35,510
2004,Kenya,KEN,United Kingdom of Great Britain and Northern Ireland,GBR,25,0,270,20,315
2004,Liberia,LBR,United Kingdom of Great Britain and Northern Ireland,GBR,40,0,555,25,620
2004,Sri Lanka,LKA,United Kingdom of Great Britain and Northern Ireland,GBR,105,0,1400,55,1560
2004,North Macedonia,MKD,United Kingdom of Great Britain and Northern Ireland,GBR,5,0,55,0,60
2004,Rep. of Moldova,MDA,United Kingdom of Great Britain and Northern Ireland,GBR,5,0,75,5,85
2004,Nigeria,NGA,United Kingdom of Great Britain and Northern Ireland,GBR,40,0,905,50,995
2004,Pakistan,PAK,United Kingdom of Great Britain and Northern Ireland,GBR,410,0,2040,80,2530
2004,Poland,POL,United Kingdom of Great Britain and Northern Ireland,GBR,5,0,85,20,110
2004,Romania,ROU,United Kingdom of Great Britain and Northern Ireland,GBR,10,0,170,10,190
2004,Russian Federation,RUS,United Kingdom of Great Britain and Northern Ireland,GBR,235,0,790,75,1100
2004,Rwanda,RWA,United Kingdom of Great Britain and Northern Ireland,GBR,60,0,295,20,375
2004,Serbia and Kosovo: S/RES/1244 (1999),SRB,United Kingdom of Great Britain and Northern Ireland,GBR,375,0,1620,175,2170
2004,Sierra Leone,SLE,United Kingdom of Great Britain and Northern Ireland,GBR,65,0,475,40,580
2004,Somalia,SOM,United Kingdom of Great Britain and Northern Ireland,GBR,1835,0,2240,235,4310
2004,Viet Nam,VNM,United Kingdom of Great Britain and Northern Ireland,GBR,45,0,540,30,615
2004,Sudan,SDN,United Kingdom of Great Britain and Northern Ireland,GBR,445,0,645,45,1135
2004,United Rep. of Tanzania,TZA,United Kingdom of Great Britain and Northern Ireland,GBR,5,0,40,5,50
2004,Turkey,TUR,United Kingdom of Great Britain and Northern Ireland,GBR,840,0,2680,110,3630
2004,Uganda,UGA,United Kingdom of Great Britain and Northern Ireland,GBR,125,0,490,35,650
2004,Ukraine,UKR,United Kingdom of Great Britain and Northern Ireland,GBR,35,0,135,10,180
2004,Zimbabwe,ZWE,United Kingdom of Great Britain and Northern Ireland,GBR,595,0,2655,95,3345
2005,Afghanistan,AFG,Australia,AUS,238,0,23,5,266
2005,Albania,ALB,Australia,AUS,5,0,16,0,21
2005,Algeria,DZA,Australia,AUS,0,0,5,0,5
2005,Egypt,EGY,Australia,AUS,15,0,22,0,37
2005,Armenia,ARM,Australia,AUS,0,0,5,0,5
2005,Bangladesh,BGD,Australia,AUS,21,0,139,11,171
2005,Brazil,BRA,Australia,AUS,0,0,10,0,10
2005,Bulgaria,BGR,Australia,AUS,0,0,5,0,5
2005,Cambodia,KHM,Australia,AUS,0,0,5,0,5
2005,China,CHN,Australia,AUS,103,0,740,63,906
2005,Chile,CHL,Australia,AUS,0,0,5,0,5
2005,Dem. Rep. of the Congo,COD,Australia,AUS,5,0,0,0,5
2005,Colombia,COL,Australia,AUS,0,0,10,0,10
2005,Eritrea,ERI,Australia,AUS,5,0,0,0,5
2005,Ethiopia,ETH,Australia,AUS,10,0,0,0,10
2005,Fiji,FJI,Australia,AUS,0,0,40,5,45
2005,Palestinian,PSE,Australia,AUS,5,0,0,0,5
2005,United Kingdom of Great Britain and Northern Ireland,GBR,Australia,AUS,0,0,5,0,5
2005,Ghana,GHA,Australia,AUS,0,0,5,0,5
2005,"China, Hong Kong SAR",HKG,Australia,AUS,0,0,5,0,5
2005,Croatia,HRV,Australia,AUS,0,0,5,0,5
2005,India,IND,Australia,AUS,10,0,166,11,187
2005,Indonesia,IDN,Australia,AUS,10,0,70,5,85
2005,Iran (Islamic Rep. of),IRN,Australia,AUS,24,0,13,5,42
2005,Iraq,IRQ,Australia,AUS,557,0,17,5,579
2005,Israel,ISR,Australia,AUS,0,0,10,0,10
2005,Jordan,JOR,Australia,AUS,0,0,13,0,13
2005,Kenya,KEN,Australia,AUS,0,0,15,0,15
2005,Rep. of Korea,KOR,Australia,AUS,0,0,31,5,36
2005,Dem. People's Rep. of Korea,PRK,Australia,AUS,5,0,5,0,10
2005,Lebanon,LBN,Australia,AUS,12,0,41,5,58
2005,Sri Lanka,LKA,Australia,AUS,30,0,75,10,115
2005,North Macedonia,MKD,Australia,AUS,0,0,5,0,5
2005,Rep. of Moldova,MDA,Australia,AUS,0,0,5,0,5
2005,Malaysia,MYS,Australia,AUS,5,0,96,5,106
2005,Mongolia,MNG,Australia,AUS,5,0,27,5,37
2005,Myanmar,MMR,Australia,AUS,10,0,5,5,20
2005,Nepal,NPL,Australia,AUS,16,0,45,0,61
2005,Nigeria,NGA,Australia,AUS,5,0,12,0,17
2005,Pakistan,PAK,Australia,AUS,5,0,55,5,65
2005,Peru,PER,Australia,AUS,0,0,5,0,5
2005,Philippines,PHL,Australia,AUS,0,0,54,11,65
2005,Romania,ROU,Australia,AUS,0,0,10,0,10
2005,South Africa,ZAF,Australia,AUS,0,0,5,0,5
2005,Russian Federation,RUS,Australia,AUS,14,0,12,0,26
2005,Serbia and Kosovo: S/RES/1244 (1999),SRB,Australia,AUS,5,0,18,0,23
2005,Somalia,SOM,Australia,AUS,5,0,0,0,5
2005,Viet Nam,VNM,Australia,AUS,20,0,18,0,38
2005,Sudan,SDN,Australia,AUS,5,0,0,0,5
2005,Syrian Arab Rep.,SYR,Australia,AUS,5,0,0,0,5
2005,Thailand,THA,Australia,AUS,0,0,15,5,20
2005,Tonga,TON,Australia,AUS,0,0,10,0,10
2005,Turkey,TUR,Australia,AUS,10,0,18,5,33
2005,Uganda,UGA,Australia,AUS,0,0,5,0,5
2005,Ukraine,UKR,Australia,AUS,5,0,11,0,16
2005,Uzbekistan,UZB,Australia,AUS,5,0,5,0,10
2005,Samoa,WSM,Australia,AUS,0,0,5,0,5
2005,Zambia,ZMB,Australia,AUS,0,0,5,0,5
2005,Zimbabwe,ZWE,Australia,AUS,12,0,5,0,17
2005,Afghanistan,AFG,United Kingdom of Great Britain and Northern Ireland,GBR,205,0,1555,85,1845
2005,Albania,ALB,United Kingdom of Great Britain and Northern Ireland,GBR,20,0,175,25,220
2005,Algeria,DZA,United Kingdom of Great Britain and Northern Ireland,GBR,35,0,365,30,430
2005,Angola,AGO,United Kingdom of Great Britain and Northern Ireland,GBR,50,0,325,25,400
2005,Burundi,BDI,United Kingdom of Great Britain and Northern Ireland,GBR,45,0,205,20,270
2005,Bangladesh,BGD,United Kingdom of Great Britain and Northern Ireland,GBR,10,0,190,20,220
2005,China,CHN,United Kingdom of Great Britain and Northern Ireland,GBR,80,0,1120,60,1260
2005,Cameroon,CMR,United Kingdom of Great Britain and Northern Ireland,GBR,85,0,260,15,360
2005,Congo,COG,United Kingdom of Great Britain and Northern Ireland,GBR,25,0,165,15,205
2005,Dem. Rep. of the Congo,COD,United Kingdom of Great Britain and Northern Ireland,GBR,305,0,1360,75,1740
2005,Colombia,COL,United Kingdom of Great Britain and Northern Ireland,GBR,35,0,130,25,190
2005,Czechia,CZE,United Kingdom of Great Britain and Northern Ireland,GBR,0,0,10,0,10
2005,Ecuador,ECU,United Kingdom of Great Britain and Northern Ireland,GBR,5,0,30,10,45
2005,Eritrea,ERI,United Kingdom of Great Britain and Northern Ireland,GBR,475,0,625,55,1155
2005,Ethiopia,ETH,United Kingdom of Great Britain and Northern Ireland,GBR,170,0,475,30,675
2005,Gambia,GMB,United Kingdom of Great Britain and Northern Ireland,GBR,5,0,85,5,95
2005,Ghana,GHA,United Kingdom of Great Britain and Northern Ireland,GBR,0,0,161,5,166
2005,Cote d'Ivoire,CIV,United Kingdom of Great Britain and Northern Ireland,GBR,35,0,245,5,285
2005,India,IND,United Kingdom of Great Britain and Northern Ireland,GBR,10,0,185,25,220
2005,Iran (Islamic Rep. of),IRN,United Kingdom of Great Britain and Northern Ireland,GBR,705,0,3630,175,4510
2005,Iraq,IRQ,United Kingdom of Great Britain and Northern Ireland,GBR,160,0,2585,100,2845
2005,Jamaica,JAM,United Kingdom of Great Britain and Northern Ireland,GBR,40,0,290,30,360
2005,Kenya,KEN,United Kingdom of Great Britain and Northern Ireland,GBR,20,0,125,20,165
2005,Liberia,LBR,United Kingdom of Great Britain and Northern Ireland,GBR,25,0,255,15,295
2005,Libya,LBY,United Kingdom of Great Britain and Northern Ireland,GBR,40,0,140,10,190
2005,Sri Lanka,LKA,United Kingdom of Great Britain and Northern Ireland,GBR,80,0,475,55,610
2005,North Macedonia,MKD,United Kingdom of Great Britain and Northern Ireland,GBR,0,0,27,0,27
2005,Rep. of Moldova,MDA,United Kingdom of Great Britain and Northern Ireland,GBR,0,0,37,0,37
2005,Nigeria,NGA,United Kingdom of Great Britain and Northern Ireland,GBR,30,0,675,40,745
2005,Pakistan,PAK,United Kingdom of Great Britain and Northern Ireland,GBR,215,0,1385,100,1700
2005,Poland,POL,United Kingdom of Great Britain and Northern Ireland,GBR,0,0,5,0,5
2005,Romania,ROU,United Kingdom of Great Britain and Northern Ireland,GBR,10,0,60,15,85
2005,Russian Federation,RUS,United Kingdom of Great Britain and Northern Ireland,GBR,70,0,110,15,195
2005,Rwanda,RWA,United Kingdom of Great Britain and Northern Ireland,GBR,20,0,120,15,155
2005,Serbia and Kosovo: S/RES/1244 (1999),SRB,United Kingdom of Great Britain and Northern Ireland,GBR,140,0,675,150,965
2005,Sierra Leone,SLE,United Kingdom of Great Britain and Northern Ireland,GBR,30,0,210,20,260
2005,Somalia,SOM,United Kingdom of Great Britain and Northern Ireland,GBR,790,0,1045,165,2000
2005,Viet Nam,VNM,United Kingdom of Great Britain and Northern Ireland,GBR,20,0,270,15,305
2005,Sudan,SDN,United Kingdom of Great Britain and Northern Ireland,GBR,370,0,865,25,1260
2005,Syrian Arab Rep.,SYR,United Kingdom of Great Britain and Northern Ireland,GBR,120,0,255,15,390
2005,United Rep. of Tanzania,TZA,United Kingdom of Great Britain and Northern Ireland,GBR,5,0,16,0,21
2005,Turkey,TUR,United Kingdom of Great Britain and Northern Ireland,GBR,430,0,1315,120,1865
2005,Uganda,UGA,United Kingdom of Great Britain and Northern Ireland,GBR,55,0,325,15,395
2005,Ukraine,UKR,United Kingdom of Great Britain and Northern Ireland,GBR,15,0,70,10,95
2005,Zimbabwe,ZWE,United Kingdom of Great Britain and Northern Ireland,GBR,460,0,1285,65,1810
2005,Stateless,XXA,United Kingdom of Great Britain and Northern Ireland,GBR,75,0,25,15,115
2006,Afghanistan,AFG,Australia,AUS,20,0,0,5,25
2006,Albania,ALB,Australia,AUS,5,0,13,0,18
2006,Algeria,DZA,Australia,AUS,0,0,5,0,5
2006,Egypt,EGY,Australia,AUS,28,0,20,0,48
2006,Bahrain,BHR,Australia,AUS,11,0,0,0,11
2006,Bangladesh,BGD,Australia,AUS,22,0,111,82,215
2006,Belarus,BLR,Australia,AUS,0,0,5,0,5
2006,Brazil,BRA,Australia,AUS,0,0,5,0,5
2006,Bulgaria,BGR,Australia,AUS,0,0,5,0,5
2006,Cambodia,KHM,Australia,AUS,0,0,5,0,5
2006,China,CHN,Australia,AUS,209,0,832,44,1085
2006,Chile,CHL,Australia,AUS,0,0,5,0,5
2006,Cameroon,CMR,Australia,AUS,11,0,0,0,11
2006,Dem. Rep. of the Congo,COD,Australia,AUS,0,0,5,0,5
2006,Colombia,COL,Australia,AUS,5,0,5,0,10
2006,Ethiopia,ETH,Australia,AUS,12,0,0,0,12
2006,Fiji,FJI,Australia,AUS,5,0,28,5,38
2006,Palestinian,PSE,Australia,AUS,5,0,0,0,5
2006,United Kingdom of Great Britain and Northern Ireland,GBR,Australia,AUS,0,0,5,0,5
2006,Germany,DEU,Australia,AUS,0,0,5,0,5
2006,Ghana,GHA,Australia,AUS,0,0,13,0,13
2006,Guinea,GIN,Australia,AUS,0,0,5,0,5
2006,India,IND,Australia,AUS,16,0,281,32,329
2006,Indonesia,IDN,Australia,AUS,10,0,156,10,176
2006,Iran (Islamic Rep. of),IRN,Australia,AUS,11,0,12,0,23
2006,Iraq,IRQ,Australia,AUS,16,0,0,0,16
2006,Israel,ISR,Australia,AUS,0,0,5,0,5
2006,Jordan,JOR,Australia,AUS,5,0,5,0,10
2006,Kenya,KEN,Australia,AUS,0,0,5,0,5
2006,Kyrgyzstan,KGZ,Australia,AUS,0,0,5,0,5
2006,Rep. of Korea,KOR,Australia,AUS,0,0,41,10,51
2006,Dem. People's Rep. of Korea,PRK,Australia,AUS,5,0,5,0,10
2006,Lebanon,LBN,Australia,AUS,10,0,24,0,34
2006,Sri Lanka,LKA,Australia,AUS,43,0,92,5,140
2006,Latvia,LVA,Australia,AUS,5,0,0,0,5
2006,Malaysia,MYS,Australia,AUS,5,0,104,5,114
2006,Mongolia,MNG,Australia,AUS,5,0,14,0,19
2006,Morocco,MAR,Australia,AUS,0,0,5,0,5
2006,Myanmar,MMR,Australia,AUS,16,0,10,0,26
2006,Nepal,NPL,Australia,AUS,15,0,49,0,64
2006,Nigeria,NGA,Australia,AUS,12,0,21,0,33
2006,Pakistan,PAK,Australia,AUS,15,0,67,5,87
2006,Philippines,PHL,Australia,AUS,0,0,33,5,38
2006,Papua New Guinea,PNG,Australia,AUS,12,0,5,0,17
2006,Romania,ROU,Australia,AUS,5,0,0,0,5
2006,South Africa,ZAF,Australia,AUS,0,0,5,0,5
2006,Russian Federation,RUS,Australia,AUS,5,0,11,0,16
2006,Serbia and Kosovo: S/RES/1244 (1999),SRB,Australia,AUS,0,0,5,0,5
2006,Viet Nam,VNM,Australia,AUS,5,0,21,0,26
2006,Sudan,SDN,Australia,AUS,0,0,5,0,5
2006,Syrian Arab Rep.,SYR,Australia,AUS,0,0,10,0,10
2006,United Rep. of Tanzania,TZA,Australia,AUS,0,0,5,0,5
2006,Thailand,THA,Australia,AUS,5,0,40,5,50
2006,Timor-Leste,TLS,Australia,AUS,0,0,5,0,5
2006,Tonga,TON,Australia,AUS,0,0,12,0,12
2006,Turkey,TUR,Australia,AUS,5,0,27,5,37
2006,Uganda,UGA,Australia,AUS,5,0,0,0,5
2006,Ukraine,UKR,Australia,AUS,5,0,5,0,10
2006,United States of America,USA,Australia,AUS,0,0,5,0,5
2006,Uzbekistan,UZB,Australia,AUS,5,0,0,0,5
2006,Zimbabwe,ZWE,Australia,AUS,12,0,0,0,12
2006,Afghanistan,AFG,Azerbaijan,AZE,0,0,20,0,20
2006,Iran (Islamic Rep. of),IRN,Azerbaijan,AZE,0,0,14,0,14
2006,Pakistan,PAK,Azerbaijan,AZE,0,0,5,0,5
2006,Afghanistan,AFG,United Kingdom of Great Britain and Northern Ireland,GBR,135,0,1055,60,1250
2006,Albania,ALB,United Kingdom of Great Britain and Northern Ireland,GBR,15,0,70,5,85
2006,Algeria,DZA,United Kingdom of Great Britain and Northern Ireland,GBR,10,0,135,10,160
2006,Angola,AGO,United Kingdom of Great Britain and Northern Ireland,GBR,15,0,65,5,90
2006,Burundi,BDI,United Kingdom of Great Britain and Northern Ireland,GBR,10,0,55,5,65
2006,Bangladesh,BGD,United Kingdom of Great Britain and Northern Ireland,GBR,5,0,180,20,200
2006,China,CHN,United Kingdom of Great Britain and Northern Ireland,GBR,50,0,625,25,670
2006,Cameroon,CMR,United Kingdom of Great Britain and Northern Ireland,GBR,45,0,160,10,205
2006,Congo,COG,United Kingdom of Great Britain and Northern Ireland,GBR,10,0,55,5,65
2006,Dem. Rep. of the Congo,COD,United Kingdom of Great Britain and Northern Ireland,GBR,160,0,465,35,660
2006,Colombia,COL,United Kingdom of Great Britain and Northern Ireland,GBR,5,0,40,5,50
2006,Ecuador,ECU,United Kingdom of Great Britain and Northern Ireland,GBR,5,0,15,0,20
2006,Eritrea,ERI,United Kingdom of Great Britain and Northern Ireland,GBR,380,0,430,50,855
2006,Ethiopia,ETH,United Kingdom of Great Britain and Northern Ireland,GBR,70,0,165,10,260
2006,Gambia,GMB,United Kingdom of Great Britain and Northern Ireland,GBR,5,0,75,0,75
2006,Ghana,GHA,United Kingdom of Great Britain and Northern Ireland,GBR,0,0,40,5,40
2006,Cote d'Ivoire,CIV,United Kingdom of Great Britain and Northern Ireland,GBR,25,0,110,5,145
2006,India,IND,United Kingdom of Great Britain and Northern Ireland,GBR,15,0,70,10,85
2006,Iran (Islamic Rep. of),IRN,United Kingdom of Great Britain and Northern Ireland,GBR,385,0,1690,60,2095
2006,Iraq,IRQ,United Kingdom of Great Britain and Northern Ireland,GBR,105,0,610,40,755
2006,Jamaica,JAM,United Kingdom of Great Britain and Northern Ireland,GBR,15,0,110,5,130
2006,Kenya,KEN,United Kingdom of Great Britain and Northern Ireland,GBR,10,0,75,10,95
2006,Liberia,LBR,United Kingdom of Great Britain and Northern Ireland,GBR,5,0,55,0,60
2006,Libya,LBY,United Kingdom of Great Britain and Northern Ireland,GBR,15,0,75,5,100
2006,Sri Lanka,LKA,United Kingdom of Great Britain and Northern Ireland,GBR,85,0,295,10,400
2006,North Macedonia,MKD,United Kingdom of Great Britain and Northern Ireland,GBR,0,0,5,0,5
2006,Rep. of Moldova,MDA,United Kingdom of Great Britain and Northern Ireland,GBR,5,0,15,0,20
2006,Nigeria,NGA,United Kingdom of Great Britain and Northern Ireland,GBR,15,0,380,25,395
2006,Pakistan,PAK,United Kingdom of Great Britain and Northern Ireland,GBR,120,0,620,45,800
2006,Romania,ROU,United Kingdom of Great Britain and Northern Ireland,GBR,0,0,30,10,35
2006,Russian Federation,RUS,United Kingdom of Great Britain and Northern Ireland,GBR,75,0,190,25,290
2006,Rwanda,RWA,United Kingdom of Great Britain and Northern Ireland,GBR,10,0,30,0,45
2006,Serbia and Kosovo: S/RES/1244 (1999),SRB,United Kingdom of Great Britain and Northern Ireland,GBR,55,0,180,20,285
2006,Sierra Leone,SLE,United Kingdom of Great Britain and Northern Ireland,GBR,10,0,80,5,95
2006,Somalia,SOM,United Kingdom of Great Britain and Northern Ireland,GBR,460,0,470,55,1000
2006,Viet Nam,VNM,United Kingdom of Great Britain and Northern Ireland,GBR,5,0,35,5,45
2006,Sudan,SDN,United Kingdom of Great Britain and Northern Ireland,GBR,130,0,385,20,550
2006,Syrian Arab Rep.,SYR,United Kingdom of Great Britain and Northern Ireland,GBR,35,0,120,5,155
2006,United Rep. of Tanzania,TZA,United Kingdom of Great Britain and Northern Ireland,GBR,0,0,20,0,20
2006,Turkey,TUR,United Kingdom of Great Britain and Northern Ireland,GBR,150,0,435,30,650
2006,Uganda,UGA,United Kingdom of Great Britain and Northern Ireland,GBR,15,0,130,5,150
2006,Ukraine,UKR,United Kingdom of Great Britain and Northern Ireland,GBR,5,0,35,5,40
2006,Zimbabwe,ZWE,United Kingdom of Great Britain and Northern Ireland,GBR,735,0,960,55,1790
2006,Stateless,XXA,United Kingdom of Great Britain and Northern Ireland,GBR,0,0,0,0,35
2007,Afghanistan,AFG,Australia,AUS,5,0,0,0,5
2007,Albania,ALB,Australia,AUS,0,0,10,0,10
2007,Egypt,EGY,Australia,AUS,5,0,13,0,18
2007,Bahrain,BHR,Australia,AUS,5,0,0,0,5
2007,Bangladesh,BGD,Australia,AUS,19,0,55,96,170
2007,Brazil,BRA,Australia,AUS,0,0,5,0,5
2007,Cambodia,KHM,Australia,AUS,0,0,5,0,5
2007,China,CHN,Australia,AUS,213,0,673,34,920
2007,Chile,CHL,Australia,AUS,0,0,5,0,5
2007,Cameroon,CMR,Australia,AUS,5,0,0,0,5
2007,Colombia,COL,Australia,AUS,0,0,14,0,14
2007,Ethiopia,ETH,Australia,AUS,13,0,0,0,13
2007,Fiji,FJI,Australia,AUS,5,0,34,5,44
2007,Palestinian,PSE,Australia,AUS,5,0,0,0,5
2007,United Kingdom of Great Britain and Northern Ireland,GBR,Australia,AUS,0,0,5,0,5
2007,Ghana,GHA,Australia,AUS,0,0,10,0,10
2007,India,IND,Australia,AUS,16,0,271,38,325
2007,Indonesia,IDN,Australia,AUS,10,0,123,5,138
2007,Iran (Islamic Rep. of),IRN,Australia,AUS,16,0,5,0,21
2007,Iraq,IRQ,Australia,AUS,5,0,0,0,5
2007,Israel,ISR,Australia,AUS,5,0,10,0,15
2007,Jordan,JOR,Australia,AUS,0,0,5,0,5
2007,Kenya,KEN,Australia,AUS,5,0,5,0,10
2007,Kyrgyzstan,KGZ,Australia,AUS,5,0,0,0,5
2007,Rep. of Korea,KOR,Australia,AUS,0,0,41,0,41
2007,Dem. People's Rep. of Korea,PRK,Australia,AUS,0,0,5,0,5
2007,Lebanon,LBN,Australia,AUS,10,0,48,5,63
2007,Sri Lanka,LKA,Australia,AUS,43,0,38,0,81
2007,Lithuania,LTU,Australia,AUS,0,0,5,0,5
2007,North Macedonia,MKD,Australia,AUS,0,0,5,0,5
2007,Malaysia,MYS,Australia,AUS,0,0,68,13,81
2007,Mongolia,MNG,Australia,AUS,5,0,10,0,15
2007,Morocco,MAR,Australia,AUS,0,0,5,0,5
2007,Myanmar,MMR,Australia,AUS,5,0,12,0,17
2007,Nepal,NPL,Australia,AUS,14,0,42,5,61
2007,Nigeria,NGA,Australia,AUS,5,0,16,0,21
2007,Pakistan,PAK,Australia,AUS,15,0,36,5,56
2007,Philippines,PHL,Australia,AUS,0,0,36,5,41
2007,Papua New Guinea,PNG,Australia,AUS,0,0,5,0,5
2007,South Africa,ZAF,Australia,AUS,5,0,5,0,10
2007,Russian Federation,RUS,Australia,AUS,5,0,5,5,15
2007,Serbia and Kosovo: S/RES/1244 (1999),SRB,Australia,AUS,0,0,5,0,5
2007,Singapore,SGP,Australia,AUS,0,0,5,0,5
2007,Viet Nam,VNM,Australia,AUS,5,0,21,0,26
2007,Syrian Arab Rep.,SYR,Australia,AUS,0,0,10,0,10
2007,Thailand,THA,Australia,AUS,0,0,32,0,32
2007,Timor-Leste,TLS,Australia,AUS,0,0,14,0,14
2007,Tonga,TON,Australia,AUS,0,0,10,0,10
2007,Turkey,TUR,Australia,AUS,11,0,15,0,26
2007,Uganda,UGA,Australia,AUS,5,0,0,0,5
2007,Ukraine,UKR,Australia,AUS,0,0,10,0,10
2007,Uzbekistan,UZB,Australia,AUS,5,0,0,0,5
2007,Zimbabwe,ZWE,Australia,AUS,13,0,5,0,18
2007,Afghanistan,AFG,Azerbaijan,AZE,0,0,11,0,11
2007,Iran (Islamic Rep. of),IRN,Azerbaijan,AZE,0,0,10,0,10
2007,Afghanistan,AFG,United Kingdom of Great Britain and Northern Ireland,GBR,205,0,1100,90,1395
2007,Albania,ALB,United Kingdom of Great Britain and Northern Ireland,GBR,30,0,50,0,80
2007,Algeria,DZA,United Kingdom of Great Britain and Northern Ireland,GBR,15,0,110,5,130
2007,Angola,AGO,United Kingdom of Great Britain and Northern Ireland,GBR,30,0,90,10,130
2007,Burundi,BDI,United Kingdom of Great Britain and Northern Ireland,GBR,20,0,45,5,70
2007,Bangladesh,BGD,United Kingdom of Great Britain and Northern Ireland,GBR,15,0,205,10,230
2007,China,CHN,United Kingdom of Great Britain and Northern Ireland,GBR,75,0,465,15,555
2007,Cameroon,CMR,United Kingdom of Great Britain and Northern Ireland,GBR,55,0,155,10,220
2007,Congo,COG,United Kingdom of Great Britain and Northern Ireland,GBR,20,0,55,10,85
2007,Dem. Rep. of the Congo,COD,United Kingdom of Great Britain and Northern Ireland,GBR,120,0,315,20,455
2007,Colombia,COL,United Kingdom of Great Britain and Northern Ireland,GBR,5,0,35,0,40
2007,Ecuador,ECU,United Kingdom of Great Britain and Northern Ireland,GBR,0,0,10,0,10
2007,Eritrea,ERI,United Kingdom of Great Britain and Northern Ireland,GBR,300,0,345,55,700
2007,Ethiopia,ETH,United Kingdom of Great Britain and Northern Ireland,GBR,45,0,95,10,150
2007,Gambia,GMB,United Kingdom of Great Britain and Northern Ireland,GBR,15,0,60,0,75
2007,Ghana,GHA,United Kingdom of Great Britain and Northern Ireland,GBR,5,0,55,0,60
2007,Cote d'Ivoire,CIV,United Kingdom of Great Britain and Northern Ireland,GBR,35,0,95,0,130
2007,India,IND,United Kingdom of Great Britain and Northern Ireland,GBR,10,0,45,15,70
2007,Iran (Islamic Rep. of),IRN,United Kingdom of Great Britain and Northern Ireland,GBR,325,0,1480,75,1880
2007,Iraq,IRQ,United Kingdom of Great Britain and Northern Ireland,GBR,245,0,855,65,1165
2007,Jamaica,JAM,United Kingdom of Great Britain and Northern Ireland,GBR,20,0,85,5,110
2007,Kenya,KEN,United Kingdom of Great Britain and Northern Ireland,GBR,20,0,100,5,125
2007,Liberia,LBR,United Kingdom of Great Britain and Northern Ireland,GBR,10,0,45,5,60
2007,Libya,LBY,United Kingdom of Great Britain and Northern Ireland,GBR,5,0,45,5,55
2007,Sri Lanka,LKA,United Kingdom of Great Britain and Northern Ireland,GBR,245,0,590,25,860
2007,Rep. of Moldova,MDA,United Kingdom of Great Britain and Northern Ireland,GBR,5,0,5,0,10
2007,Nigeria,NGA,United Kingdom of Great Britain and Northern Ireland,GBR,45,0,285,20,350
2007,Pakistan,PAK,United Kingdom of Great Britain and Northern Ireland,GBR,90,0,695,55,840
2007,Romania,ROU,United Kingdom of Great Britain and Northern Ireland,GBR,0,0,0,5,5
2007,Russian Federation,RUS,United Kingdom of Great Britain and Northern Ireland,GBR,25,0,60,5,90
2007,Rwanda,RWA,United Kingdom of Great Britain and Northern Ireland,GBR,10,0,40,5,55
2007,Serbia and Kosovo: S/RES/1244 (1999),SRB,United Kingdom of Great Britain and Northern Ireland,GBR,5,0,25,0,30
2007,Sierra Leone,SLE,United Kingdom of Great Britain and Northern Ireland,GBR,30,0,95,5,130
2007,Somalia,SOM,United Kingdom of Great Britain and Northern Ireland,GBR,445,0,375,60,880
2007,Viet Nam,VNM,United Kingdom of Great Britain and Northern Ireland,GBR,0,0,30,0,30
2007,Sudan,SDN,United Kingdom of Great Britain and Northern Ireland,GBR,125,0,210,25,360
2007,Syrian Arab Rep.,SYR,United Kingdom of Great Britain and Northern Ireland,GBR,35,0,85,5,125
2007,United Rep. of Tanzania,TZA,United Kingdom of Great Britain and Northern Ireland,GBR,0,0,15,0,15
2007,Turkey,TUR,United Kingdom of Great Britain and Northern Ireland,GBR,105,0,270,20,395
2007,Uganda,UGA,United Kingdom of Great Britain and Northern Ireland,GBR,30,0,115,15,160
2007,Ukraine,UKR,United Kingdom of Great Britain and Northern Ireland,GBR,10,0,15,0,25
2007,Zimbabwe,ZWE,United Kingdom of Great Britain and Northern Ireland,GBR,285,0,910,45,1240
2008,Afghanistan,AFG,Australia,AUS,5,0,0,0,5
2008,Albania,ALB,Australia,AUS,5,0,5,0,10
2008,Egypt,EGY,Australia,AUS,10,0,17,0,27
2008,Bahrain,BHR,Australia,AUS,0,0,5,0,5
2008,Bangladesh,BGD,Australia,AUS,11,0,59,87,157
2008,Cambodia,KHM,Australia,AUS,0,0,0,5,5
2008,China,CHN,Australia,AUS,203,0,676,47,926
2008,Chile,CHL,Australia,AUS,0,0,5,0,5
2008,Cameroon,CMR,Australia,AUS,5,0,0,0,5
2008,Colombia,COL,Australia,AUS,5,0,5,0,10
2008,Czechia,CZE,Australia,AUS,0,0,5,0,5
2008,Ethiopia,ETH,Australia,AUS,5,0,12,0,17
2008,Fiji,FJI,Australia,AUS,5,0,28,5,38
2008,Palestinian,PSE,Australia,AUS,5,0,0,0,5
2008,United Kingdom of Great Britain and Northern Ireland,GBR,Australia,AUS,0,0,5,0,5
2008,Georgia,GEO,Australia,AUS,0,0,5,0,5
2008,Ghana,GHA,Australia,AUS,0,0,13,0,13
2008,India,IND,Australia,AUS,12,0,148,41,201
2008,Indonesia,IDN,Australia,AUS,10,0,133,17,160
2008,Iran (Islamic Rep. of),IRN,Australia,AUS,5,0,14,0,19
2008,Iraq,IRQ,Australia,AUS,5,0,0,0,5
2008,Israel,ISR,Australia,AUS,0,0,5,0,5
2008,Jordan,JOR,Australia,AUS,5,0,0,0,5
2008,Kenya,KEN,Australia,AUS,0,0,5,0,5
2008,Rep. of Korea,KOR,Australia,AUS,0,0,27,14,41
2008,Lebanon,LBN,Australia,AUS,21,0,38,5,64
2008,Sri Lanka,LKA,Australia,AUS,16,0,41,0,57
2008,North Macedonia,MKD,Australia,AUS,0,0,5,0,5
2008,Malaysia,MYS,Australia,AUS,10,0,137,10,157
2008,Mongolia,MNG,Australia,AUS,0,0,11,0,11
2008,Myanmar,MMR,Australia,AUS,5,0,5,0,10
2008,Nepal,NPL,Australia,AUS,16,0,17,5,38
2008,Nigeria,NGA,Australia,AUS,5,0,12,0,17
2008,Pakistan,PAK,Australia,AUS,14,0,34,10,58
2008,Philippines,PHL,Australia,AUS,5,0,16,0,21
2008,Papua New Guinea,PNG,Australia,AUS,0,0,5,0,5
2008,South Africa,ZAF,Australia,AUS,0,0,5,0,5
2008,Russian Federation,RUS,Australia,AUS,5,0,0,0,5
2008,Serbia and Kosovo: S/RES/1244 (1999),SRB,Australia,AUS,0,0,5,0,5
2008,Viet Nam,VNM,Australia,AUS,5,0,28,0,33
2008,Sudan,SDN,Australia,AUS,0,0,5,0,5
2008,Syrian Arab Rep.,SYR,Australia,AUS,5,0,0,0,5
2008,United Rep. of Tanzania,TZA,Australia,AUS,0,0,5,0,5
2008,Thailand,THA,Australia,AUS,0,0,11,0,11
2008,Tonga,TON,Australia,AUS,0,0,5,0,5
2008,Turkey,TUR,Australia,AUS,14,0,5,0,19
2008,Uganda,UGA,Australia,AUS,0,0,5,0,5
2008,Ukraine,UKR,Australia,AUS,0,0,5,0,5
2008,United States of America,USA,Australia,AUS,0,0,5,0,5
2008,Uzbekistan,UZB,Australia,AUS,0,0,5,0,5
2008,Samoa,WSM,Australia,AUS,0,0,5,0,5
2008,Zimbabwe,ZWE,Australia,AUS,22,0,10,0,32
2008,Stateless,XXA,Australia,AUS,5,0,0,0,5
2008,Afghanistan,AFG,Azerbaijan,AZE,0,0,15,0,15
2008,Iraq,IRQ,Azerbaijan,AZE,0,0,5,0,5
2008,Afghanistan,AFG,United Kingdom of Great Britain and Northern Ireland,GBR,165,0,635,65,865
2008,Albania,ALB,United Kingdom of Great Britain and Northern Ireland,GBR,15,0,30,10,55
2008,Algeria,DZA,United Kingdom of Great Britain and Northern Ireland,GBR,10,0,75,10,95
2008,Angola,AGO,United Kingdom of Great Britain and Northern Ireland,GBR,10,0,35,10,55
2008,Burundi,BDI,United Kingdom of Great Britain and Northern Ireland,GBR,5,0,10,5,20
2008,Bangladesh,BGD,United Kingdom of Great Britain and Northern Ireland,GBR,25,0,145,10,180
2008,China,CHN,United Kingdom of Great Britain and Northern Ireland,GBR,45,0,310,10,365
2008,Cameroon,CMR,United Kingdom of Great Britain and Northern Ireland,GBR,25,0,55,10,90
2008,Congo,COG,United Kingdom of Great Britain and Northern Ireland,GBR,20,0,50,5,75
2008,Dem. Rep. of the Congo,COD,United Kingdom of Great Britain and Northern Ireland,GBR,35,0,95,15,145
2008,Colombia,COL,United Kingdom of Great Britain and Northern Ireland,GBR,5,0,5,0,10
2008,Ecuador,ECU,United Kingdom of Great Britain and Northern Ireland,GBR,5,0,5,0,10
2008,Eritrea,ERI,United Kingdom of Great Britain and Northern Ireland,GBR,160,0,160,35,355
2008,Ethiopia,ETH,United Kingdom of Great Britain and Northern Ireland,GBR,15,0,35,5,55
2008,Gambia,GMB,United Kingdom of Great Britain and Northern Ireland,GBR,10,0,35,0,45
2008,Ghana,GHA,United Kingdom of Great Britain and Northern Ireland,GBR,0,0,35,0,35
2008,Cote d'Ivoire,CIV,United Kingdom of Great Britain and Northern Ireland,GBR,10,0,35,0,45
2008,India,IND,United Kingdom of Great Britain and Northern Ireland,GBR,5,0,25,10,40
2008,Iran (Islamic Rep. of),IRN,United Kingdom of Great Britain and Northern Ireland,GBR,240,0,880,35,1155
2008,Iraq,IRQ,United Kingdom of Great Britain and Northern Ireland,GBR,165,0,735,40,940
2008,Jamaica,JAM,United Kingdom of Great Britain and Northern Ireland,GBR,10,0,45,5,60
2008,Kenya,KEN,United Kingdom of Great Britain and Northern Ireland,GBR,10,0,55,5,70
2008,Liberia,LBR,United Kingdom of Great Britain and Northern Ireland,GBR,0,0,10,0,10
2008,Libya,LBY,United Kingdom of Great Britain and Northern Ireland,GBR,5,0,15,0,20
2008,Sri Lanka,LKA,United Kingdom of Great Britain and Northern Ireland,GBR,225,0,450,20,695
2008,North Macedonia,MKD,United Kingdom of Great Britain and Northern Ireland,GBR,0,0,5,0,5
2008,Rep. of Moldova,MDA,United Kingdom of Great Britain and Northern Ireland,GBR,0,0,5,0,5
2008,Nigeria,NGA,United Kingdom of Great Britain and Northern Ireland,GBR,35,0,240,15,290
2008,Pakistan,PAK,United Kingdom of Great Britain and Northern Ireland,GBR,80,0,600,50,730
2008,Russian Federation,RUS,United Kingdom of Great Britain and Northern Ireland,GBR,5,0,20,5,30
2008,Rwanda,RWA,United Kingdom of Great Britain and Northern Ireland,GBR,5,0,15,0,20
2008,Sierra Leone,SLE,United Kingdom of Great Britain and Northern Ireland,GBR,5,0,30,5,40
2008,Somalia,SOM,United Kingdom of Great Britain and Northern Ireland,GBR,215,0,265,55,535
2008,Viet Nam,VNM,United Kingdom of Great Britain and Northern Ireland,GBR,5,0,15,0,20
2008,Sudan,SDN,United Kingdom of Great Britain and Northern Ireland,GBR,40,0,80,5,125
2008,Syrian Arab Rep.,SYR,United Kingdom of Great Britain and Northern Ireland,GBR,30,0,55,5,90
2008,United Rep. of Tanzania,TZA,United Kingdom of Great Britain and Northern Ireland,GBR,0,0,15,0,15
2008,Turkey,TUR,United Kingdom of Great Britain and Northern Ireland,GBR,50,0,100,5,155
2008,Uganda,UGA,United Kingdom of Great Britain and Northern Ireland,GBR,20,0,70,5,95
2008,Ukraine,UKR,United Kingdom of Great Britain and Northern Ireland,GBR,0,0,5,0,5
2008,Zimbabwe,ZWE,United Kingdom of Great Britain and Northern Ireland,GBR,585,0,1480,135,2200
2009,Albania,ALB,Australia,AUS,5,0,5,0,10
2009,Egypt,EGY,Australia,AUS,13,0,15,5,33
2009,Bahrain,BHR,Australia,AUS,0,0,5,0,5
2009,Bangladesh,BGD,Australia,AUS,10,0,55,22,87
2009,Cambodia,KHM,Australia,AUS,0,0,5,0,5
2009,China,CHN,Australia,AUS,220,0,667,32,919
2009,Cameroon,CMR,Australia,AUS,0,0,5,0,5
2009,Dem. Rep. of the Congo,COD,Australia,AUS,5,0,0,0,5
2009,Colombia,COL,Australia,AUS,0,0,5,0,5
2009,Ethiopia,ETH,Australia,AUS,15,0,5,0,20
2009,Fiji,FJI,Australia,AUS,11,0,53,11,75
2009,Ghana,GHA,Australia,AUS,5,0,14,0,19
2009,India,IND,Australia,AUS,10,0,223,14,247
2009,Indonesia,IDN,Australia,AUS,10,0,94,13,117
2009,Iran (Islamic Rep. of),IRN,Australia,AUS,16,0,5,0,21
2009,Iraq,IRQ,Australia,AUS,0,0,11,0,11
2009,Israel,ISR,Australia,AUS,0,0,11,0,11
2009,Jordan,JOR,Australia,AUS,13,0,0,0,13
2009,Kenya,KEN,Australia,AUS,12,0,14,0,26
2009,Rep. of Korea,KOR,Australia,AUS,0,0,46,5,51
2009,Liberia,LBR,Australia,AUS,0,0,5,0,5
2009,Lebanon,LBN,Australia,AUS,25,0,51,0,76
2009,Sri Lanka,LKA,Australia,AUS,25,0,40,5,70
2009,North Macedonia,MKD,Australia,AUS,0,0,5,0,5
2009,Malaysia,MYS,Australia,AUS,10,0,135,13,158
2009,Mongolia,MNG,Australia,AUS,5,0,0,0,5
2009,Myanmar,MMR,Australia,AUS,10,0,5,0,15
2009,Nepal,NPL,Australia,AUS,5,0,17,0,22
2009,Nigeria,NGA,Australia,AUS,5,0,17,0,22
2009,New Zealand,NZL,Australia,AUS,0,0,5,0,5
2009,Pakistan,PAK,Australia,AUS,15,0,40,0,55
2009,Philippines,PHL,Australia,AUS,0,0,12,5,17
2009,Papua New Guinea,PNG,Australia,AUS,0,0,5,0,5
2009,South Africa,ZAF,Australia,AUS,0,0,5,0,5
2009,Russian Federation,RUS,Australia,AUS,0,0,5,0,5
2009,Rwanda,RWA,Australia,AUS,5,0,0,0,5
2009,Somalia,SOM,Australia,AUS,5,0,0,0,5
2009,Viet Nam,VNM,Australia,AUS,0,0,18,5,23
2009,Syrian Arab Rep.,SYR,Australia,AUS,5,0,0,0,5
2009,Togo,TGO,Australia,AUS,5,0,0,0,5
2009,Tonga,TON,Australia,AUS,0,0,10,0,10
2009,Turkey,TUR,Australia,AUS,12,0,5,0,17
2009,Uganda,UGA,Australia,AUS,5,0,5,0,10
2009,United States of America,USA,Australia,AUS,0,0,5,0,5
2009,Zimbabwe,ZWE,Australia,AUS,27,0,16,5,48
2009,Stateless,XXA,Australia,AUS,0,0,5,0,5
2009,Afghanistan,AFG,Azerbaijan,AZE,0,0,53,0,53
2009,Iran (Islamic Rep. of),IRN,Azerbaijan,AZE,0,0,11,0,11
2009,Pakistan,PAK,Azerbaijan,AZE,0,0,34,0,34
2009,Afghanistan,AFG,United Kingdom of Great Britain and Northern Ireland,GBR,330,0,1145,100,1575
2009,Albania,ALB,United Kingdom of Great Britain and Northern Ireland,GBR,15,0,45,5,65
2009,Algeria,DZA,United Kingdom of Great Britain and Northern Ireland,GBR,5,0,70,5,80
2009,Angola,AGO,United Kingdom of Great Britain and Northern Ireland,GBR,10,0,30,0,40
2009,Burundi,BDI,United Kingdom of Great Britain and Northern Ireland,GBR,0,0,10,0,10
2009,Bangladesh,BGD,United Kingdom of Great Britain and Northern Ireland,GBR,15,0,190,15,220
2009,China,CHN,United Kingdom of Great Britain and Northern Ireland,GBR,65,0,395,5,465
2009,Cameroon,CMR,United Kingdom of Great Britain and Northern Ireland,GBR,25,0,40,0,65
2009,Congo,COG,United Kingdom of Great Britain and Northern Ireland,GBR,20,0,60,5,85
2009,Dem. Rep. of the Congo,COD,United Kingdom of Great Britain and Northern Ireland,GBR,30,0,110,15,155
2009,Colombia,COL,United Kingdom of Great Britain and Northern Ireland,GBR,5,0,5,0,10
2009,Eritrea,ERI,United Kingdom of Great Britain and Northern Ireland,GBR,185,0,260,25,470
2009,Ethiopia,ETH,United Kingdom of Great Britain and Northern Ireland,GBR,15,0,40,0,55
2009,Gambia,GMB,United Kingdom of Great Britain and Northern Ireland,GBR,20,0,75,5,100
2009,Ghana,GHA,United Kingdom of Great Britain and Northern Ireland,GBR,10,0,30,0,40
2009,Cote d'Ivoire,CIV,United Kingdom of Great Britain and Northern Ireland,GBR,5,0,25,0,30
2009,India,IND,United Kingdom of Great Britain and Northern Ireland,GBR,15,0,35,10,60
2009,Iran (Islamic Rep. of),IRN,United Kingdom of Great Britain and Northern Ireland,GBR,390,0,1135,45,1570
2009,Iraq,IRQ,United Kingdom of Great Britain and Northern Ireland,GBR,155,0,840,40,1035
2009,Jamaica,JAM,United Kingdom of Great Britain and Northern Ireland,GBR,15,0,55,5,75
2009,Kenya,KEN,United Kingdom of Great Britain and Northern Ireland,GBR,15,0,35,0,50
2009,Liberia,LBR,United Kingdom of Great Britain and Northern Ireland,GBR,0,0,10,0,10
2009,Libya,LBY,United Kingdom of Great Britain and Northern Ireland,GBR,10,0,20,5,35
2009,Sri Lanka,LKA,United Kingdom of Great Britain and Northern Ireland,GBR,320,0,600,45,965
2009,Rep. of Moldova,MDA,United Kingdom of Great Britain and Northern Ireland,GBR,0,0,0,5,5
2009,Nigeria,NGA,United Kingdom of Great Britain and Northern Ireland,GBR,35,0,215,10,260
2009,Pakistan,PAK,United Kingdom of Great Britain and Northern Ireland,GBR,120,0,845,40,1005
2009,Russian Federation,RUS,United Kingdom of Great Britain and Northern Ireland,GBR,10,0,30,0,40
2009,Rwanda,RWA,United Kingdom of Great Britain and Northern Ireland,GBR,5,0,10,5,20
2009,Sierra Leone,SLE,United Kingdom of Great Britain and Northern Ireland,GBR,5,0,35,5,45
2009,Somalia,SOM,United Kingdom of Great Britain and Northern Ireland,GBR,230,0,230,30,490
2009,Viet Nam,VNM,United Kingdom of Great Britain and Northern Ireland,GBR,10,0,15,0,25
2009,Sudan,SDN,United Kingdom of Great Britain and Northern Ireland,GBR,35,0,65,25,125
2009,Syrian Arab Rep.,SYR,United Kingdom of Great Britain and Northern Ireland,GBR,20,0,50,0,70
2009,United Rep. of Tanzania,TZA,United Kingdom of Great Britain and Northern Ireland,GBR,0,0,15,0,15
2009,Turkey,TUR,United Kingdom of Great Britain and Northern Ireland,GBR,40,0,75,5,120
2009,Uganda,UGA,United Kingdom of Great Britain and Northern Ireland,GBR,20,0,90,10,120
2009,Ukraine,UKR,United Kingdom of Great Britain and Northern Ireland,GBR,0,0,15,0,15
2009,Zimbabwe,ZWE,United Kingdom of Great Britain and Northern Ireland,GBR,1690,0,2010,200,3900
2009,Iran (Islamic Rep. of),IRN,Luxembourg,LUX,5,0,0,0,5
2009,Serbia and Kosovo: S/RES/1244 (1999),SRB,Luxembourg,LUX,14,0,0,0,14
2010,Afghanistan,AFG,Australia,AUS,11,0,0,0,11
2010,Albania,ALB,Australia,AUS,0,0,11,0,11
2010,Egypt,EGY,Australia,AUS,22,0,30,0,52
2010,Bahrain,BHR,Australia,AUS,0,0,5,0,5
2010,Bangladesh,BGD,Australia,AUS,10,0,23,5,38
2010,Cambodia,KHM,Australia,AUS,0,0,5,0,5
2010,China,CHN,Australia,AUS,172,0,587,45,804
2010,Cameroon,CMR,Australia,AUS,0,0,5,0,5
2010,Dem. Rep. of the Congo,COD,Australia,AUS,5,0,0,0,5
2010,Colombia,COL,Australia,AUS,0,0,14,0,14
2010,Ethiopia,ETH,Australia,AUS,12,0,0,0,12
2010,Fiji,FJI,Australia,AUS,45,0,237,40,322
2010,Palestinian,PSE,Australia,AUS,5,0,0,0,5
2010,United Kingdom of Great Britain and Northern Ireland,GBR,Australia,AUS,0,0,0,5,5
2010,Ghana,GHA,Australia,AUS,0,0,10,0,10
2010,India,IND,Australia,AUS,16,0,148,5,169
2010,Indonesia,IDN,Australia,AUS,5,0,91,10,106
2010,Iran (Islamic Rep. of),IRN,Australia,AUS,25,0,10,0,35
2010,Iraq,IRQ,Australia,AUS,11,0,0,0,11
2010,Israel,ISR,Australia,AUS,0,0,5,0,5
2010,Jordan,JOR,Australia,AUS,0,0,5,0,5
2010,Kenya,KEN,Australia,AUS,5,0,5,0,10
2010,Rep. of Korea,KOR,Australia,AUS,5,0,25,0,30
2010,Dem. People's Rep. of Korea,PRK,Australia,AUS,11,0,0,0,11
2010,Kuwait,KWT,Australia,AUS,5,0,0,0,5
2010,Liberia,LBR,Australia,AUS,5,0,0,0,5
2010,Lebanon,LBN,Australia,AUS,26,0,65,0,91
2010,Sri Lanka,LKA,Australia,AUS,28,0,23,5,56
2010,North Macedonia,MKD,Australia,AUS,0,0,5,0,5
2010,Malaysia,MYS,Australia,AUS,5,0,216,10,231
2010,Mongolia,MNG,Australia,AUS,0,0,10,0,10
2010,Myanmar,MMR,Australia,AUS,12,0,5,0,17
2010,Nepal,NPL,Australia,AUS,10,0,24,5,39
2010,Nigeria,NGA,Australia,AUS,5,0,11,0,16
2010,New Zealand,NZL,Australia,AUS,0,0,5,0,5
2010,Pakistan,PAK,Australia,AUS,20,0,29,0,49
2010,Philippines,PHL,Australia,AUS,5,0,43,0,48
2010,Papua New Guinea,PNG,Australia,AUS,5,0,5,0,10
2010,Romania,ROU,Australia,AUS,0,0,5,0,5
2010,South Africa,ZAF,Australia,AUS,5,0,5,0,10
2010,Serbia and Kosovo: S/RES/1244 (1999),SRB,Australia,AUS,0,0,5,0,5
2010,Singapore,SGP,Australia,AUS,0,0,5,0,5
2010,Sierra Leone,SLE,Australia,AUS,0,0,5,0,5
2010,Somalia,SOM,Australia,AUS,5,0,0,0,5
2010,Viet Nam,VNM,Australia,AUS,0,0,13,5,18
2010,Sudan,SDN,Australia,AUS,5,0,0,0,5
2010,Syrian Arab Rep.,SYR,Australia,AUS,5,0,0,0,5
2010,United Rep. of Tanzania,TZA,Australia,AUS,5,0,0,0,5
2010,Thailand,THA,Australia,AUS,0,0,5,5,10
2010,Tonga,TON,Australia,AUS,0,0,20,0,20
2010,Turkey,TUR,Australia,AUS,11,0,10,0,21
2010,Ukraine,UKR,Australia,AUS,0,0,5,0,5
2010,Uzbekistan,UZB,Australia,AUS,5,0,5,0,10
2010,Zimbabwe,ZWE,Australia,AUS,36,0,25,0,61
2010,Stateless,XXA,Australia,AUS,0,0,5,0,5
2010,Afghanistan,AFG,Azerbaijan,AZE,0,0,40,0,40
2010,Iran (Islamic Rep. of),IRN,Azerbaijan,AZE,0,0,5,0,5
2010,Iraq,IRQ,Azerbaijan,AZE,0,0,15,0,15
2011,Afghanistan,AFG,Australia,AUS,13,0,0,0,13
2011,Albania,ALB,Australia,AUS,11,0,0,0,11
2011,Egypt,EGY,Australia,AUS,126,0,90,12,230
2011,Bangladesh,BGD,Australia,AUS,19,0,66,5,90
2011,Brazil,BRA,Australia,AUS,0,0,5,0,5
2011,Cambodia,KHM,Australia,AUS,5,0,0,0,5
2011,China,CHN,Australia,AUS,209,0,593,40,846
2011,Cameroon,CMR,Australia,AUS,5,0,0,0,5
2011,Dem. Rep. of the Congo,COD,Australia,AUS,5,0,0,0,5
2011,Colombia,COL,Australia,AUS,16,0,5,0,21
2011,Ethiopia,ETH,Australia,AUS,5,0,5,0,10
2011,Fiji,FJI,Australia,AUS,44,0,198,20,262
2011,Palestinian,PSE,Australia,AUS,15,0,0,0,15
2011,Ghana,GHA,Australia,AUS,0,0,12,0,12
2011,India,IND,Australia,AUS,17,0,205,26,248
2011,Indonesia,IDN,Australia,AUS,5,0,137,5,147
2011,Iran (Islamic Rep. of),IRN,Australia,AUS,54,0,11,5,70
2011,Iraq,IRQ,Australia,AUS,43,0,0,5,48
2011,Jordan,JOR,Australia,AUS,0,0,14,0,14
2011,Kazakhstan,KAZ,Australia,AUS,5,0,0,0,5
2011,Kenya,KEN,Australia,AUS,5,0,5,0,10
2011,Rep. of Korea,KOR,Australia,AUS,5,0,58,0,67
2011,Dem. People's Rep. of Korea,PRK,Australia,AUS,5,0,5,0,10
2011,Kuwait,KWT,Australia,AUS,5,0,0,0,5
2011,Libya,LBY,Australia,AUS,5,0,0,0,5
2011,Lebanon,LBN,Australia,AUS,42,0,67,5,114
2011,Sri Lanka,LKA,Australia,AUS,37,0,51,10,98
2011,Lithuania,LTU,Australia,AUS,0,0,5,0,5
2011,Malaysia,MYS,Australia,AUS,0,0,108,11,119
2011,Mongolia,MNG,Australia,AUS,0,0,10,0,10
2011,Mauritius,MUS,Australia,AUS,0,0,5,11,16
2011,Myanmar,MMR,Australia,AUS,13,0,5,0,18
2011,Nepal,NPL,Australia,AUS,16,0,73,5,94
2011,Nigeria,NGA,Australia,AUS,5,0,16,0,21
2011,Pakistan,PAK,Australia,AUS,48,0,62,5,115
2011,Peru,PER,Australia,AUS,0,0,5,0,5
2011,Philippines,PHL,Australia,AUS,5,0,39,0,44
2011,Papua New Guinea,PNG,Australia,AUS,0,0,18,0,18
2011,Poland,POL,Australia,AUS,0,0,5,0,5
2011,South Africa,ZAF,Australia,AUS,0,0,13,0,13
2011,Russian Federation,RUS,Australia,AUS,5,0,0,0,5
2011,El Salvador,SLV,Australia,AUS,0,0,5,0,5
2011,Sierra Leone,SLE,Australia,AUS,5,0,0,0,5
2011,Solomon Islands,SLB,Australia,AUS,0,0,5,0,5
2011,Viet Nam,VNM,Australia,AUS,5,0,59,5,69
2011,Sudan,SDN,Australia,AUS,0,0,0,5,5
2011,Syrian Arab Rep.,SYR,Australia,AUS,14,0,0,0,14
2011,Thailand,THA,Australia,AUS,0,0,10,5,15
2011,Timor-Leste,TLS,Australia,AUS,0,0,5,0,5
2011,Tonga,TON,Australia,AUS,0,0,24,0,24
2011,Turkey,TUR,Australia,AUS,28,0,15,0,43
2011,United Arab Emirates,ARE,Australia,AUS,5,0,5,0,10
2011,Uganda,UGA,Australia,AUS,5,0,0,0,5
2011,Ukraine,UKR,Australia,AUS,5,0,5,0,10
2011,United States of America,USA,Australia,AUS,0,0,10,0,10
2011,Zimbabwe,ZWE,Australia,AUS,43,0,26,0,69
2011,Stateless,XXA,Australia,AUS,11,0,0,0,11
2011,Afghanistan,AFG,Azerbaijan,AZE,0,0,5,0,5
2011,Afghanistan,AFG,United Kingdom of Great Britain and Northern Ireland,GBR,198,0,816,69,1083
2011,Albania,ALB,United Kingdom of Great Britain and Northern Ireland,GBR,27,0,65,5,97
2011,Algeria,DZA,United Kingdom of Great Britain and Northern Ireland,GBR,15,0,99,10,124
2011,Angola,AGO,United Kingdom of Great Britain and Northern Ireland,GBR,10,0,17,5,32
2011,Egypt,EGY,United Kingdom of Great Britain and Northern Ireland,GBR,17,0,42,5,64
2011,Armenia,ARM,United Kingdom of Great Britain and Northern Ireland,GBR,13,0,0,0,13
2011,Azerbaijan,AZE,United Kingdom of Great Britain and Northern Ireland,GBR,0,0,5,0,5
2011,Bahrain,BHR,United Kingdom of Great Britain and Northern Ireland,GBR,10,0,5,0,15
2011,Burundi,BDI,United Kingdom of Great Britain and Northern Ireland,GBR,0,0,5,0,5
2011,Bangladesh,BGD,United Kingdom of Great Britain and Northern Ireland,GBR,23,0,205,12,240
2011,Bhutan,BTN,United Kingdom of Great Britain and Northern Ireland,GBR,5,0,5,0,10
2011,Belarus,BLR,United Kingdom of Great Britain and Northern Ireland,GBR,5,0,5,0,10
2011,Bolivia (Plurinational State of),BOL,United Kingdom of Great Britain and Northern Ireland,GBR,0,0,5,0,5
2011,Botswana,BWA,United Kingdom of Great Britain and Northern Ireland,GBR,0,0,10,0,10
2011,Brazil,BRA,United Kingdom of Great Britain and Northern Ireland,GBR,0,0,5,0,5
2011,Chad,TCD,United Kingdom of Great Britain and Northern Ireland,GBR,0,0,5,0,5
2011,China,CHN,United Kingdom of Great Britain and Northern Ireland,GBR,91,0,406,40,537
2011,Cameroon,CMR,United Kingdom of Great Britain and Northern Ireland,GBR,14,0,25,5,44
2011,Congo,COG,United Kingdom of Great Britain and Northern Ireland,GBR,0,0,11,0,11
2011,Dem. Rep. of the Congo,COD,United Kingdom of Great Britain and Northern Ireland,GBR,47,0,78,11,136
2011,Colombia,COL,United Kingdom of Great Britain and Northern Ireland,GBR,0,0,13,0,13
2011,Cuba,CUB,United Kingdom of Great Britain and Northern Ireland,GBR,0,0,5,0,5
2011,Djibouti,DJI,United Kingdom of Great Britain and Northern Ireland,GBR,0,0,5,0,5
2011,Ecuador,ECU,United Kingdom of Great Britain and Northern Ireland,GBR,0,0,5,0,5
2011,Eritrea,ERI,United Kingdom of Great Britain and Northern Ireland,GBR,102,0,106,11,219
2011,Ethiopia,ETH,United Kingdom of Great Britain and Northern Ireland,GBR,23,0,40,5,68
2011,Gambia,GMB,United Kingdom of Great Britain and Northern Ireland,GBR,34,0,92,5,131
2011,Palestinian,PSE,United Kingdom of Great Britain and Northern Ireland,GBR,17,0,98,5,120
2011,Georgia,GEO,United Kingdom of Great Britain and Northern Ireland,GBR,5,0,19,0,24
2011,Ghana,GHA,United Kingdom of Great Britain and Northern Ireland,GBR,10,0,46,0,56
2011,Grenada,GRD,United Kingdom of Great Britain and Northern Ireland,GBR,0,0,5,0,5
2011,Guinea,GIN,United Kingdom of Great Britain and Northern Ireland,GBR,5,0,38,0,43
2011,Cote d'Ivoire,CIV,United Kingdom of Great Britain and Northern Ireland,GBR,25,0,72,5,102
2011,India,IND,United Kingdom of Great Britain and Northern Ireland,GBR,15,0,84,10,109
2011,Iran (Islamic Rep. of),IRN,United Kingdom of Great Britain and Northern Ireland,GBR,376,0,800,75,1251
2011,Iraq,IRQ,United Kingdom of Great Britain and Northern Ireland,GBR,66,0,210,27,303
2011,Jamaica,JAM,United Kingdom of Great Britain and Northern Ireland,GBR,22,0,44,5,71
2011,Jordan,JOR,United Kingdom of Great Britain and Northern Ireland,GBR,0,0,10,0,10
2011,Kenya,KEN,United Kingdom of Great Britain and Northern Ireland,GBR,12,0,47,0,59
2011,Kyrgyzstan,KGZ,United Kingdom of Great Britain and Northern Ireland,GBR,0,0,5,0,5
2011,Dem. People's Rep. of Korea,PRK,United Kingdom of Great Britain and Northern Ireland,GBR,12,0,11,0,23
2011,Kuwait,KWT,United Kingdom of Great Britain and Northern Ireland,GBR,13,0,17,0,30
2011,Liberia,LBR,United Kingdom of Great Britain and Northern Ireland,GBR,0,0,5,0,5
2011,Libya,LBY,United Kingdom of Great Britain and Northern Ireland,GBR,92,0,247,45,384
2011,Lebanon,LBN,United Kingdom of Great Britain and Northern Ireland,GBR,5,0,25,5,35
2011,Sri Lanka,LKA,United Kingdom of Great Britain and Northern Ireland,GBR,467,0,751,46,1264
2011,Mexico,MEX,United Kingdom of Great Britain and Northern Ireland,GBR,0,0,5,0,5
2011,Malaysia,MYS,United Kingdom of Great Britain and Northern Ireland,GBR,10,0,14,0,24
2011,Malawi,MWI,United Kingdom of Great Britain and Northern Ireland,GBR,17,0,51,5,73
2011,Mongolia,MNG,United Kingdom of Great Britain and Northern Ireland,GBR,5,0,11,0,16
2011,Morocco,MAR,United Kingdom of Great Britain and Northern Ireland,GBR,5,0,15,0,20
2011,Mauritius,MUS,United Kingdom of Great Britain and Northern Ireland,GBR,0,0,14,0,14
2011,Myanmar,MMR,United Kingdom of Great Britain and Northern Ireland,GBR,65,0,34,5,104
2011,Namibia,NAM,United Kingdom of Great Britain and Northern Ireland,GBR,0,0,11,0,11
2011,Nepal,NPL,United Kingdom of Great Britain and Northern Ireland,GBR,0,0,19,0,19
2011,Niger,NER,United Kingdom of Great Britain and Northern Ireland,GBR,0,0,5,0,5
2011,Nigeria,NGA,United Kingdom of Great Britain and Northern Ireland,GBR,64,0,256,19,339
2011,Pakistan,PAK,United Kingdom of Great Britain and Northern Ireland,GBR,201,0,997,63,1261
2011,Philippines,PHL,United Kingdom of Great Britain and Northern Ireland,GBR,0,0,5,0,5
2011,South Africa,ZAF,United Kingdom of Great Britain and Northern Ireland,GBR,13,0,39,5,57
2011,Russian Federation,RUS,United Kingdom of Great Britain and Northern Ireland,GBR,12,0,17,5,34
2011,Rwanda,RWA,United Kingdom of Great Britain and Northern Ireland,GBR,14,0,0,0,14
2011,Serbia and Kosovo: S/RES/1244 (1999),SRB,United Kingdom of Great Britain and Northern Ireland,GBR,0,0,11,0,11
2011,Senegal,SEN,United Kingdom of Great Britain and Northern Ireland,GBR,5,0,23,0,28
2011,Sierra Leone,SLE,United Kingdom of Great Britain and Northern Ireland,GBR,10,0,33,5,48
2011,Somalia,SOM,United Kingdom of Great Britain and Northern Ireland,GBR,114,0,80,21,215
2011,Viet Nam,VNM,United Kingdom of Great Britain and Northern Ireland,GBR,19,0,38,5,62
2011,Sudan,SDN,United Kingdom of Great Britain and Northern Ireland,GBR,50,0,65,14,129
2011,Eswatini,SWZ,United Kingdom of Great Britain and Northern Ireland,GBR,0,0,5,0,5
2011,Syrian Arab Rep.,SYR,United Kingdom of Great Britain and Northern Ireland,GBR,47,0,63,10,120
2011,United Rep. of Tanzania,TZA,United Kingdom of Great Britain and Northern Ireland,GBR,5,0,19,0,24
2011,Togo,TGO,United Kingdom of Great Britain and Northern Ireland,GBR,0,0,5,0,5
2011,Trinidad and Tobago,TTO,United Kingdom of Great Britain and Northern Ireland,GBR,5,0,5,0,10
2011,Tunisia,TUN,United Kingdom of Great Britain and Northern Ireland,GBR,5,0,15,0,20
2011,Turkey,TUR,United Kingdom of Great Britain and Northern Ireland,GBR,32,0,65,5,102
2011,Uganda,UGA,United Kingdom of Great Britain and Northern Ireland,GBR,37,0,89,11,137
2011,Ukraine,UKR,United Kingdom of Great Britain and Northern Ireland,GBR,5,0,5,0,10
2011,Uzbekistan,UZB,United Kingdom of Great Britain and Northern Ireland,GBR,0,0,5,0,5
2011,Saint Vincent and the Grenadines,VCT,United Kingdom of Great Britain and Northern Ireland,GBR,0,0,5,0,5
2011,Venezuela (Bolivarian Republic of),VEN,United Kingdom of Great Britain and Northern Ireland,GBR,0,0,5,0,5
2011,Western Sahara,ESH,United Kingdom of Great Britain and Northern Ireland,GBR,0,0,5,0,5
2011,Yemen,YEM,United Kingdom of Great Britain and Northern Ireland,GBR,10,0,10,0,20
2011,Zambia,ZMB,United Kingdom of Great Britain and Northern Ireland,GBR,11,0,0,0,11
2011,Zimbabwe,ZWE,United Kingdom of Great Britain and Northern Ireland,GBR,205,0,364,34,603
2011,Stateless,XXA,United Kingdom of Great Britain and Northern Ireland,GBR,50,0,53,5,108
2012,Afghanistan,AFG,Australia,AUS,729,0,108,0,837
2012,Albania,ALB,Australia,AUS,5,0,18,0,23
2012,Algeria,DZA,Australia,AUS,0,0,5,0,5
2012,Egypt,EGY,Australia,AUS,126,0,78,5,209
2012,Bahrain,BHR,Australia,AUS,5,0,5,0,10
2012,Burundi,BDI,Australia,AUS,5,0,0,0,5
2012,Bangladesh,BGD,Australia,AUS,12,0,42,0,54
2012,Brazil,BRA,Australia,AUS,0,0,11,0,11
2012,Cambodia,KHM,Australia,AUS,5,0,13,0,18
2012,China,CHN,Australia,AUS,151,0,631,42,824
2012,Cameroon,CMR,Australia,AUS,0,0,5,0,5
2012,Colombia,COL,Australia,AUS,21,0,12,0,33
2012,Ethiopia,ETH,Australia,AUS,10,0,5,0,15
2012,Fiji,FJI,Australia,AUS,41,0,91,10,142
2012,United Kingdom of Great Britain and Northern Ireland,GBR,Australia,AUS,0,0,5,0,5
2012,Georgia,GEO,Australia,AUS,0,0,5,5,10
2012,Germany,DEU,Australia,AUS,5,0,0,0,5
2012,Ghana,GHA,Australia,AUS,0,0,14,0,14
2012,India,IND,Australia,AUS,40,0,463,44,547
2012,Indonesia,IDN,Australia,AUS,5,0,100,0,105
2012,Iran (Islamic Rep. of),IRN,Australia,AUS,747,0,444,5,1196
2012,Iraq,IRQ,Australia,AUS,176,0,67,0,243
2012,Israel,ISR,Australia,AUS,5,0,0,0,5
2012,Jordan,JOR,Australia,AUS,5,0,13,0,18
2012,Japan,JPN,Australia,AUS,0,0,5,0,5
2012,Kenya,KEN,Australia,AUS,10,0,11,0,21
2012,Rep. of Korea,KOR,Australia,AUS,0,0,35,11,46
2012,Kuwait,KWT,Australia,AUS,5,0,0,0,5
2012,Libya,LBY,Australia,AUS,19,0,16,0,35
2012,Lebanon,LBN,Australia,AUS,39,0,67,5,111
2012,Sri Lanka,LKA,Australia,AUS,219,0,150,5,374
2012,Lithuania,LTU,Australia,AUS,0,0,5,0,5
2012,North Macedonia,MKD,Australia,AUS,0,0,5,0,5
2012,Malaysia,MYS,Australia,AUS,13,0,100,17,130
2012,Mongolia,MNG,Australia,AUS,0,0,11,0,11
2012,Morocco,MAR,Australia,AUS,5,0,0,0,5
2012,Mauritius,MUS,Australia,AUS,0,0,29,0,29
2012,Myanmar,MMR,Australia,AUS,14,0,0,0,14
2012,Nepal,NPL,Australia,AUS,17,0,185,10,212
2012,Nigeria,NGA,Australia,AUS,12,0,21,5,38
2012,New Zealand,NZL,Australia,AUS,0,0,10,0,10
2012,Pakistan,PAK,Australia,AUS,262,0,128,20,410
2012,Peru,PER,Australia,AUS,0,0,5,0,5
2012,Philippines,PHL,Australia,AUS,5,0,34,5,44
2012,Papua New Guinea,PNG,Australia,AUS,19,0,0,0,19
2012,Romania,ROU,Australia,AUS,0,0,5,5,10
2012,South Africa,ZAF,Australia,AUS,0,0,5,0,5
2012,Russian Federation,RUS,Australia,AUS,12,0,0,0,12
2012,El Salvador,SLV,Australia,AUS,0,0,5,0,5
2012,Singapore,SGP,Australia,AUS,0,0,5,0,5
2012,Solomon Islands,SLB,Australia,AUS,0,0,5,0,5
2012,Viet Nam,VNM,Australia,AUS,29,0,95,0,124
2012,Sudan,SDN,Australia,AUS,5,0,0,0,5
2012,Syrian Arab Rep.,SYR,Australia,AUS,12,0,5,0,17
2012,Thailand,THA,Australia,AUS,0,0,5,0,5
2012,Tonga,TON,Australia,AUS,0,0,39,5,44
2012,Turkey,TUR,Australia,AUS,49,0,30,0,79
2012,Uganda,UGA,Australia,AUS,0,0,5,0,5
2012,Ukraine,UKR,Australia,AUS,0,0,0,5,5
2012,Uzbekistan,UZB,Australia,AUS,0,0,5,0,5
2012,Zimbabwe,ZWE,Australia,AUS,44,0,44,5,93
2012,Stateless,XXA,Australia,AUS,239,0,62,0,301
2012,Afghanistan,AFG,United Kingdom of Great Britain and Northern Ireland,GBR,172,0,397,40,609
2012,Albania,ALB,United Kingdom of Great Britain and Northern Ireland,GBR,34,0,112,14,160
2012,Algeria,DZA,United Kingdom of Great Britain and Northern Ireland,GBR,11,0,66,0,77
2012,Angola,AGO,United Kingdom of Great Britain and Northern Ireland,GBR,5,0,13,0,18
2012,Egypt,EGY,United Kingdom of Great Britain and Northern Ireland,GBR,21,0,64,5,90
2012,Armenia,ARM,United Kingdom of Great Britain and Northern Ireland,GBR,0,0,5,0,5
2012,Bahrain,BHR,United Kingdom of Great Britain and Northern Ireland,GBR,5,0,5,0,10
2012,Burundi,BDI,United Kingdom of Great Britain and Northern Ireland,GBR,0,0,5,0,5
2012,Benin,BEN,United Kingdom of Great Britain and Northern Ireland,GBR,0,0,5,0,5
2012,Bangladesh,BGD,United Kingdom of Great Britain and Northern Ireland,GBR,25,0,282,10,317
2012,Bhutan,BTN,United Kingdom of Great Britain and Northern Ireland,GBR,5,0,0,0,5
2012,Belarus,BLR,United Kingdom of Great Britain and Northern Ireland,GBR,5,0,5,0,10
2012,Bolivia (Plurinational State of),BOL,United Kingdom of Great Britain and Northern Ireland,GBR,0,0,5,0,5
2012,Botswana,BWA,United Kingdom of Great Britain and Northern Ireland,GBR,0,0,10,0,10
2012,Central African Rep.,CAF,United Kingdom of Great Britain and Northern Ireland,GBR,0,0,5,0,5
2012,Chad,TCD,United Kingdom of Great Britain and Northern Ireland,GBR,5,0,0,0,5
2012,China,CHN,United Kingdom of Great Britain and Northern Ireland,GBR,47,0,270,12,329
2012,Cameroon,CMR,United Kingdom of Great Britain and Northern Ireland,GBR,11,0,38,5,54
2012,Congo,COG,United Kingdom of Great Britain and Northern Ireland,GBR,5,0,5,0,10
2012,Dem. Rep. of the Congo,COD,United Kingdom of Great Britain and Northern Ireland,GBR,32,0,48,5,85
2012,Colombia,COL,United Kingdom of Great Britain and Northern Ireland,GBR,5,0,5,0,10
2012,Cuba,CUB,United Kingdom of Great Britain and Northern Ireland,GBR,5,0,0,0,5
2012,Eritrea,ERI,United Kingdom of Great Britain and Northern Ireland,GBR,49,0,52,5,106
2012,Ethiopia,ETH,United Kingdom of Great Britain and Northern Ireland,GBR,13,0,40,5,58
2012,Gambia,GMB,United Kingdom of Great Britain and Northern Ireland,GBR,40,0,101,5,146
2012,Palestinian,PSE,United Kingdom of Great Britain and Northern Ireland,GBR,14,0,57,5,76
2012,Georgia,GEO,United Kingdom of Great Britain and Northern Ireland,GBR,5,0,11,0,16
2012,Ghana,GHA,United Kingdom of Great Britain and Northern Ireland,GBR,13,0,43,5,61
2012,Guinea,GIN,United Kingdom of Great Britain and Northern Ireland,GBR,10,0,28,0,38
2012,Honduras,HND,United Kingdom of Great Britain and Northern Ireland,GBR,0,0,5,0,5
2012,Cote d'Ivoire,CIV,United Kingdom of Great Britain and Northern Ireland,GBR,10,0,24,0,34
2012,India,IND,United Kingdom of Great Britain and Northern Ireland,GBR,17,0,55,0,72
2012,Iran (Islamic Rep. of),IRN,United Kingdom of Great Britain and Northern Ireland,GBR,333,0,579,70,982
2012,Iraq,IRQ,United Kingdom of Great Britain and Northern Ireland,GBR,38,0,126,18,182
2012,Jamaica,JAM,United Kingdom of Great Britain and Northern Ireland,GBR,11,0,23,0,34
2012,Jordan,JOR,United Kingdom of Great Britain and Northern Ireland,GBR,5,0,11,0,16
2012,Kenya,KEN,United Kingdom of Great Britain and Northern Ireland,GBR,5,0,37,5,47
2012,Rep. of Korea,KOR,United Kingdom of Great Britain and Northern Ireland,GBR,0,0,5,0,5
2012,Dem. People's Rep. of Korea,PRK,United Kingdom of Great Britain and Northern Ireland,GBR,11,0,0,0,11
2012,Kuwait,KWT,United Kingdom of Great Britain and Northern Ireland,GBR,10,0,26,0,36
2012,Liberia,LBR,United Kingdom of Great Britain and Northern Ireland,GBR,5,0,5,0,10
2012,Libya,LBY,United Kingdom of Great Britain and Northern Ireland,GBR,28,0,78,10,116
2012,Lebanon,LBN,United Kingdom of Great Britain and Northern Ireland,GBR,5,0,15,0,20
2012,Sri Lanka,LKA,United Kingdom of Great Britain and Northern Ireland,GBR,405,0,543,48,996
2012,Mauritania,MRT,United Kingdom of Great Britain and Northern Ireland,GBR,0,0,5,0,5
2012,Mexico,MEX,United Kingdom of Great Britain and Northern Ireland,GBR,5,0,0,0,5
2012,Mali,MLI,United Kingdom of Great Britain and Northern Ireland,GBR,0,0,5,0,5
2012,Malaysia,MYS,United Kingdom of Great Britain and Northern Ireland,GBR,0,0,17,0,17
2012,Malawi,MWI,United Kingdom of Great Britain and Northern Ireland,GBR,15,0,37,10,62
2012,Mongolia,MNG,United Kingdom of Great Britain and Northern Ireland,GBR,5,0,5,0,10
2012,Morocco,MAR,United Kingdom of Great Britain and Northern Ireland,GBR,5,0,25,0,30
2012,Mauritius,MUS,United Kingdom of Great Britain and Northern Ireland,GBR,0,0,12,0,12
2012,Myanmar,MMR,United Kingdom of Great Britain and Northern Ireland,GBR,14,0,10,5,29
2012,Namibia,NAM,United Kingdom of Great Britain and Northern Ireland,GBR,0,0,11,0,11
2012,Nepal,NPL,United Kingdom of Great Britain and Northern Ireland,GBR,0,0,23,5,28
2012,Nigeria,NGA,United Kingdom of Great Britain and Northern Ireland,GBR,61,0,258,18,337
2012,Pakistan,PAK,United Kingdom of Great Britain and Northern Ireland,GBR,284,0,1175,104,1563
2012,Philippines,PHL,United Kingdom of Great Britain and Northern Ireland,GBR,0,0,10,0,10
2012,South Africa,ZAF,United Kingdom of Great Britain and Northern Ireland,GBR,5,0,10,0,15
2012,Russian Federation,RUS,United Kingdom of Great Britain and Northern Ireland,GBR,12,0,14,5,31
2012,Rwanda,RWA,United Kingdom of Great Britain and Northern Ireland,GBR,0,0,15,0,15
2012,Saudi Arabia,SAU,United Kingdom of Great Britain and Northern Ireland,GBR,0,0,5,0,5
2012,Serbia and Kosovo: S/RES/1244 (1999),SRB,United Kingdom of Great Britain and Northern Ireland,GBR,0,0,13,0,13
2012,Senegal,SEN,United Kingdom of Great Britain and Northern Ireland,GBR,5,0,18,0,23
2012,Sierra Leone,SLE,United Kingdom of Great Britain and Northern Ireland,GBR,10,0,14,0,24
2012,Somalia,SOM,United Kingdom of Great Britain and Northern Ireland,GBR,43,0,56,19,118
2012,Viet Nam,VNM,United Kingdom of Great Britain and Northern Ireland,GBR,15,0,37,10,62
2012,Sudan,SDN,United Kingdom of Great Britain and Northern Ireland,GBR,33,0,31,13,77
2012,Eswatini,SWZ,United Kingdom of Great Britain and Northern Ireland,GBR,5,0,0,0,5
2012,Syrian Arab Rep.,SYR,United Kingdom of Great Britain and Northern Ireland,GBR,102,0,60,33,195
2012,United Rep. of Tanzania,TZA,United Kingdom of Great Britain and Northern Ireland,GBR,0,0,14,0,14
2012,Thailand,THA,United Kingdom of Great Britain and Northern Ireland,GBR,5,0,0,0,5
2012,Turkmenistan,TKM,United Kingdom of Great Britain and Northern Ireland,GBR,0,0,5,0,5
2012,Togo,TGO,United Kingdom of Great Britain and Northern Ireland,GBR,0,0,5,0,5
2012,Trinidad and Tobago,TTO,United Kingdom of Great Britain and Northern Ireland,GBR,11,0,0,0,11
2012,Tunisia,TUN,United Kingdom of Great Britain and Northern Ireland,GBR,0,0,12,0,12
2012,Turkey,TUR,United Kingdom of Great Britain and Northern Ireland,GBR,26,0,50,10,86
2012,Uganda,UGA,United Kingdom of Great Britain and Northern Ireland,GBR,33,0,73,11,117
2012,Ukraine,UKR,United Kingdom of Great Britain and Northern Ireland,GBR,12,0,0,0,12
2012,Uzbekistan,UZB,United Kingdom of Great Britain and Northern Ireland,GBR,0,0,5,0,5
2012,Venezuela (Bolivarian Republic of),VEN,United Kingdom of Great Britain and Northern Ireland,GBR,0,0,5,0,5
2012,Yemen,YEM,United Kingdom of Great Britain and Northern Ireland,GBR,11,0,10,0,21
2012,Zambia,ZMB,United Kingdom of Great Britain and Northern Ireland,GBR,5,0,5,0,10
2012,Zimbabwe,ZWE,United Kingdom of Great Britain and Northern Ireland,GBR,61,0,151,34,246
2012,Stateless,XXA,United Kingdom of Great Britain and Northern Ireland,GBR,21,0,31,5,57
2013,Afghanistan,AFG,Australia,AUS,301,0,70,0,371
2013,Albania,ALB,Australia,AUS,0,0,12,0,12
2013,Egypt,EGY,Australia,AUS,45,0,56,5,106
2013,Bangladesh,BGD,Australia,AUS,5,0,67,10,82
2013,Brazil,BRA,Australia,AUS,0,0,5,0,5
2013,Cambodia,KHM,Australia,AUS,0,0,5,0,5
2013,China,CHN,Australia,AUS,69,0,444,48,561
2013,Cameroon,CMR,Australia,AUS,0,0,5,0,5
2013,Colombia,COL,Australia,AUS,0,0,12,0,12
2013,Ethiopia,ETH,Australia,AUS,11,0,5,0,16
2013,Fiji,FJI,Australia,AUS,11,0,97,5,113
2013,Palestinian,PSE,Australia,AUS,0,0,5,0,5
2013,United Kingdom of Great Britain and Northern Ireland,GBR,Australia,AUS,0,0,11,0,11
2013,Georgia,GEO,Australia,AUS,0,0,5,0,5
2013,Ghana,GHA,Australia,AUS,0,0,13,0,13
2013,India,IND,Australia,AUS,29,0,383,35,447
2013,Indonesia,IDN,Australia,AUS,5,0,26,0,31
2013,Ireland,IRL,Australia,AUS,0,0,5,0,5
2013,Iran (Islamic Rep. of),IRN,Australia,AUS,110,0,84,5,199
2013,Iraq,IRQ,Australia,AUS,28,0,24,10,62
2013,Israel,ISR,Australia,AUS,0,0,5,0,5
2013,Jordan,JOR,Australia,AUS,5,0,20,5,30
2013,Kenya,KEN,Australia,AUS,0,0,13,0,13
2013,Rep. of Korea,KOR,Australia,AUS,0,0,23,0,23
2013,Kuwait,KWT,Australia,AUS,0,0,5,0,5
2013,Libya,LBY,Australia,AUS,13,0,0,0,13
2013,Lebanon,LBN,Australia,AUS,40,0,136,5,181
2013,Sri Lanka,LKA,Australia,AUS,174,0,381,10,565
2013,Malaysia,MYS,Australia,AUS,5,0,59,5,69
2013,Mongolia,MNG,Australia,AUS,0,0,5,0,5
2013,Mauritius,MUS,Australia,AUS,0,0,10,0,10
2013,Myanmar,MMR,Australia,AUS,5,0,5,0,10
2013,Nepal,NPL,Australia,AUS,5,0,91,10,106
2013,Nigeria,NGA,Australia,AUS,10,0,17,0,27
2013,New Zealand,NZL,Australia,AUS,0,0,5,0,5
2013,Pakistan,PAK,Australia,AUS,172,0,127,5,304
2013,Peru,PER,Australia,AUS,0,0,5,0,5
2013,Philippines,PHL,Australia,AUS,0,0,26,0,26
2013,Papua New Guinea,PNG,Australia,AUS,0,0,5,0,5
2013,Romania,ROU,Australia,AUS,0,0,5,0,5
2013,South Africa,ZAF,Australia,AUS,5,0,0,0,5
2013,Russian Federation,RUS,Australia,AUS,0,0,5,0,5
2013,Singapore,SGP,Australia,AUS,0,0,5,0,5
2013,Solomon Islands,SLB,Australia,AUS,0,0,5,0,5
2013,Viet Nam,VNM,Australia,AUS,0,0,23,5,28
2013,Sudan,SDN,Australia,AUS,5,0,0,0,5
2013,Syrian Arab Rep.,SYR,Australia,AUS,5,0,0,0,5
2013,Thailand,THA,Australia,AUS,0,0,14,0,14
2013,Tonga,TON,Australia,AUS,0,0,23,0,23
2013,Turkey,TUR,Australia,AUS,15,0,15,0,30
2013,Uganda,UGA,Australia,AUS,0,0,11,0,11
2013,Ukraine,UKR,Australia,AUS,0,0,10,0,10
2013,Uzbekistan,UZB,Australia,AUS,0,0,5,0,5
2013,Zimbabwe,ZWE,Australia,AUS,13,0,32,0,45
2013,Stateless,XXA,Australia,AUS,20,0,10,0,30
2013,Afghanistan,AFG,United Kingdom of Great Britain and Northern Ireland,GBR,176,0,340,40,556
2013,Albania,ALB,United Kingdom of Great Britain and Northern Ireland,GBR,86,0,215,25,326
2013,Algeria,DZA,United Kingdom of Great Britain and Northern Ireland,GBR,15,0,60,5,80
2013,Angola,AGO,United Kingdom of Great Britain and Northern Ireland,GBR,5,0,17,0,22
2013,Egypt,EGY,United Kingdom of Great Britain and Northern Ireland,GBR,21,0,100,5,126
2013,Armenia,ARM,United Kingdom of Great Britain and Northern Ireland,GBR,0,0,5,0,5
2013,Azerbaijan,AZE,United Kingdom of Great Britain and Northern Ireland,GBR,5,0,0,0,5
2013,Burundi,BDI,United Kingdom of Great Britain and Northern Ireland,GBR,0,0,5,0,5
2013,Bangladesh,BGD,United Kingdom of Great Britain and Northern Ireland,GBR,21,0,451,34,506
2013,Belarus,BLR,United Kingdom of Great Britain and Northern Ireland,GBR,5,0,0,0,5
2013,Botswana,BWA,United Kingdom of Great Britain and Northern Ireland,GBR,0,0,5,0,5
2013,Canada,CAN,United Kingdom of Great Britain and Northern Ireland,GBR,0,0,0,5,5
2013,Chad,TCD,United Kingdom of Great Britain and Northern Ireland,GBR,0,0,5,0,5
2013,China,CHN,United Kingdom of Great Britain and Northern Ireland,GBR,45,0,283,20,348
2013,Cameroon,CMR,United Kingdom of Great Britain and Northern Ireland,GBR,24,0,41,0,65
2013,Congo,COG,United Kingdom of Great Britain and Northern Ireland,GBR,5,0,10,0,15
2013,Dem. Rep. of the Congo,COD,United Kingdom of Great Britain and Northern Ireland,GBR,24,0,28,11,63
2013,Colombia,COL,United Kingdom of Great Britain and Northern Ireland,GBR,0,0,5,0,5
2013,Eritrea,ERI,United Kingdom of Great Britain and Northern Ireland,GBR,28,0,43,5,76
2013,Ethiopia,ETH,United Kingdom of Great Britain and Northern Ireland,GBR,32,0,30,5,67
2013,Gambia,GMB,United Kingdom of Great Britain and Northern Ireland,GBR,25,0,87,13,125
2013,Palestinian,PSE,United Kingdom of Great Britain and Northern Ireland,GBR,10,0,27,5,42
2013,Georgia,GEO,United Kingdom of Great Britain and Northern Ireland,GBR,0,0,11,0,11
2013,Ghana,GHA,United Kingdom of Great Britain and Northern Ireland,GBR,10,0,52,5,67
2013,Guinea,GIN,United Kingdom of Great Britain and Northern Ireland,GBR,5,0,27,5,37
2013,Cote d'Ivoire,CIV,United Kingdom of Great Britain and Northern Ireland,GBR,13,0,19,5,37
2013,India,IND,United Kingdom of Great Britain and Northern Ireland,GBR,14,0,100,11,125
2013,Indonesia,IDN,United Kingdom of Great Britain and Northern Ireland,GBR,0,0,0,5,5
2013,Iran (Islamic Rep. of),IRN,United Kingdom of Great Britain and Northern Ireland,GBR,289,0,555,47,891
2013,Iraq,IRQ,United Kingdom of Great Britain and Northern Ireland,GBR,40,0,93,12,145
2013,Jamaica,JAM,United Kingdom of Great Britain and Northern Ireland,GBR,10,0,25,0,35
2013,Jordan,JOR,United Kingdom of Great Britain and Northern Ireland,GBR,5,0,13,0,18
2013,Kenya,KEN,United Kingdom of Great Britain and Northern Ireland,GBR,19,0,26,5,50
2013,Kyrgyzstan,KGZ,United Kingdom of Great Britain and Northern Ireland,GBR,0,0,5,0,5
2013,Dem. People's Rep. of Korea,PRK,United Kingdom of Great Britain and Northern Ireland,GBR,0,0,5,5,10
2013,Kuwait,KWT,United Kingdom of Great Britain and Northern Ireland,GBR,10,0,12,0,22
2013,Liberia,LBR,United Kingdom of Great Britain and Northern Ireland,GBR,5,0,0,0,5
2013,Libya,LBY,United Kingdom of Great Britain and Northern Ireland,GBR,29,0,72,5,106
2013,Lebanon,LBN,United Kingdom of Great Britain and Northern Ireland,GBR,10,0,16,0,26
2013,Sri Lanka,LKA,United Kingdom of Great Britain and Northern Ireland,GBR,417,0,492,50,959
2013,Mexico,MEX,United Kingdom of Great Britain and Northern Ireland,GBR,0,0,5,0,5
2013,Mali,MLI,United Kingdom of Great Britain and Northern Ireland,GBR,0,0,5,0,5
2013,Malaysia,MYS,United Kingdom of Great Britain and Northern Ireland,GBR,0,0,23,0,23
2013,Malawi,MWI,United Kingdom of Great Britain and Northern Ireland,GBR,10,0,52,0,62
2013,Mongolia,MNG,United Kingdom of Great Britain and Northern Ireland,GBR,0,0,5,0,5
2013,Morocco,MAR,United Kingdom of Great Britain and Northern Ireland,GBR,5,0,14,0,19
2013,Mauritius,MUS,United Kingdom of Great Britain and Northern Ireland,GBR,0,0,5,5,10
2013,Myanmar,MMR,United Kingdom of Great Britain and Northern Ireland,GBR,5,0,11,5,21
2013,Namibia,NAM,United Kingdom of Great Britain and Northern Ireland,GBR,5,0,0,0,5
2013,Nepal,NPL,United Kingdom of Great Britain and Northern Ireland,GBR,5,0,23,0,28
2013,Nigeria,NGA,United Kingdom of Great Britain and Northern Ireland,GBR,59,0,280,22,361
2013,Pakistan,PAK,United Kingdom of Great Britain and Northern Ireland,GBR,270,0,1272,92,1634
2013,Philippines,PHL,United Kingdom of Great Britain and Northern Ireland,GBR,0,0,10,0,10
2013,South Africa,ZAF,United Kingdom of Great Britain and Northern Ireland,GBR,0,0,14,0,14
2013,Russian Federation,RUS,United Kingdom of Great Britain and Northern Ireland,GBR,16,0,11,0,27
2013,Rwanda,RWA,United Kingdom of Great Britain and Northern Ireland,GBR,5,0,5,0,10
2013,Saudi Arabia,SAU,United Kingdom of Great Britain and Northern Ireland,GBR,0,0,5,0,5
2013,Serbia and Kosovo: S/RES/1244 (1999),SRB,United Kingdom of Great Britain and Northern Ireland,GBR,0,0,14,5,19
2013,Senegal,SEN,United Kingdom of Great Britain and Northern Ireland,GBR,5,0,15,0,20
2013,Sierra Leone,SLE,United Kingdom of Great Britain and Northern Ireland,GBR,5,0,19,5,29
2013,Somalia,SOM,United Kingdom of Great Britain and Northern Ireland,GBR,53,0,61,16,130
2013,Viet Nam,VNM,United Kingdom of Great Britain and Northern Ireland,GBR,28,0,78,12,118
2013,Sudan,SDN,United Kingdom of Great Britain and Northern Ireland,GBR,35,0,35,10,80
2013,Eswatini,SWZ,United Kingdom of Great Britain and Northern Ireland,GBR,5,0,0,0,5
2013,Syrian Arab Rep.,SYR,United Kingdom of Great Britain and Northern Ireland,GBR,10,0,67,11,88
2013,United Rep. of Tanzania,TZA,United Kingdom of Great Britain and Northern Ireland,GBR,0,0,20,0,20
2013,Thailand,THA,United Kingdom of Great Britain and Northern Ireland,GBR,5,0,5,0,10
2013,Turkmenistan,TKM,United Kingdom of Great Britain and Northern Ireland,GBR,0,0,5,0,5
2013,Togo,TGO,United Kingdom of Great Britain and Northern Ireland,GBR,5,0,5,0,10
2013,Trinidad and Tobago,TTO,United Kingdom of Great Britain and Northern Ireland,GBR,0,0,10,0,10
2013,Tunisia,TUN,United Kingdom of Great Britain and Northern Ireland,GBR,0,0,11,0,11
2013,Turkey,TUR,United Kingdom of Great Britain and Northern Ireland,GBR,34,0,54,10,98
2013,Uganda,UGA,United Kingdom of Great Britain and Northern Ireland,GBR,28,0,53,5,86
2013,Ukraine,UKR,United Kingdom of Great Britain and Northern Ireland,GBR,5,0,5,0,10
2013,United States of America,USA,United Kingdom of Great Britain and Northern Ireland,GBR,5,0,0,0,5
2013,Uzbekistan,UZB,United Kingdom of Great Britain and Northern Ireland,GBR,5,0,5,0,10
2013,Western Sahara,ESH,United Kingdom of Great Britain and Northern Ireland,GBR,0,0,5,0,5
2013,Yemen,YEM,United Kingdom of Great Britain and Northern Ireland,GBR,11,0,5,5,21
2013,Zambia,ZMB,United Kingdom of Great Britain and Northern Ireland,GBR,0,0,11,0,11
2013,Zimbabwe,ZWE,United Kingdom of Great Britain and Northern Ireland,GBR,52,0,125,15,192
2013,Stateless,XXA,United Kingdom of Great Britain and Northern Ireland,GBR,5,0,18,5,28
2014,Afghanistan,AFG,Australia,AUS,36,0,10,0,46
2014,Albania,ALB,Australia,AUS,0,0,5,5,10
2014,Egypt,EGY,Australia,AUS,34,0,101,10,145
2014,Bahrain,BHR,Australia,AUS,5,0,0,0,5
2014,Bangladesh,BGD,Australia,AUS,14,0,96,12,122
2014,Brazil,BRA,Australia,AUS,0,0,5,0,5
2014,Cambodia,KHM,Australia,AUS,5,0,5,0,10
2014,China,CHN,Australia,AUS,71,0,673,41,785
2014,Colombia,COL,Australia,AUS,5,0,5,0,10
2014,Ethiopia,ETH,Australia,AUS,12,0,5,0,17
2014,Fiji,FJI,Australia,AUS,10,0,112,16,138
2014,United Kingdom of Great Britain and Northern Ireland,GBR,Australia,AUS,0,0,5,0,5
2014,Georgia,GEO,Australia,AUS,0,0,10,0,10
2014,Ghana,GHA,Australia,AUS,0,0,12,0,12
2014,Greece,GRC,Australia,AUS,0,0,5,0,5
2014,Guinea,GIN,Australia,AUS,0,0,5,0,5
2014,India,IND,Australia,AUS,29,0,428,38,495
2014,Indonesia,IDN,Australia,AUS,10,0,33,5,48
2014,Ireland,IRL,Australia,AUS,0,0,5,0,5
2014,Iran (Islamic Rep. of),IRN,Australia,AUS,104,0,60,11,175
2014,Iraq,IRQ,Australia,AUS,37,0,5,5,47
2014,Jordan,JOR,Australia,AUS,5,0,31,5,41
2014,Kenya,KEN,Australia,AUS,0,0,16,0,16
2014,Rep. of Korea,KOR,Australia,AUS,0,0,24,5,29
2014,Liberia,LBR,Australia,AUS,0,0,5,0,5
2014,Libya,LBY,Australia,AUS,11,0,12,0,23
2014,Lebanon,LBN,Australia,AUS,27,0,151,13,191
2014,Sri Lanka,LKA,Australia,AUS,57,0,205,14,276
2014,Malaysia,MYS,Australia,AUS,10,0,68,10,88
2014,Mongolia,MNG,Australia,AUS,0,0,11,0,11
2014,Morocco,MAR,Australia,AUS,0,0,5,0,5
2014,Mauritius,MUS,Australia,AUS,0,0,5,0,5
2014,Myanmar,MMR,Australia,AUS,5,0,0,0,5
2014,Nepal,NPL,Australia,AUS,10,0,135,10,155
2014,Nigeria,NGA,Australia,AUS,10,0,32,0,42
2014,Pakistan,PAK,Australia,AUS,123,0,179,10,312
2014,Peru,PER,Australia,AUS,0,0,5,0,5
2014,Philippines,PHL,Australia,AUS,0,0,25,0,25
2014,Papua New Guinea,PNG,Australia,AUS,11,0,0,0,11
2014,South Africa,ZAF,Australia,AUS,0,0,10,0,10
2014,Singapore,SGP,Australia,AUS,0,0,5,0,5
2014,Solomon Islands,SLB,Australia,AUS,5,0,0,0,5
2014,Somalia,SOM,Australia,AUS,5,0,0,0,5
2014,Viet Nam,VNM,Australia,AUS,5,0,33,0,38
2014,Thailand,THA,Australia,AUS,0,0,5,5,10
2014,Tonga,TON,Australia,AUS,0,0,31,5,36
2014,Turkey,TUR,Australia,AUS,20,0,21,0,41
2014,Uganda,UGA,Australia,AUS,0,0,5,0,5
2014,Ukraine,UKR,Australia,AUS,0,0,5,0,5
2014,United States of America,USA,Australia,AUS,0,0,5,0,5
2014,Uzbekistan,UZB,Australia,AUS,0,0,5,0,5
2014,Yemen,YEM,Australia,AUS,0,0,5,0,5
2014,Zambia,ZMB,Australia,AUS,5,0,0,0,5
2014,Zimbabwe,ZWE,Australia,AUS,20,0,28,5,53
2014,Stateless,XXA,Australia,AUS,11,0,12,0,23
2014,Afghanistan,AFG,United Kingdom of Great Britain and Northern Ireland,GBR,171,0,287,22,480
2014,Albania,ALB,United Kingdom of Great Britain and Northern Ireland,GBR,105,0,203,21,329
2014,Algeria,DZA,United Kingdom of Great Britain and Northern Ireland,GBR,17,0,46,0,63
2014,Angola,AGO,United Kingdom of Great Britain and Northern Ireland,GBR,0,0,12,0,12
2014,Egypt,EGY,United Kingdom of Great Britain and Northern Ireland,GBR,16,0,55,0,71
2014,Bahrain,BHR,United Kingdom of Great Britain and Northern Ireland,GBR,0,0,5,0,5
2014,Burundi,BDI,United Kingdom of Great Britain and Northern Ireland,GBR,0,0,5,0,5
2014,Bangladesh,BGD,United Kingdom of Great Britain and Northern Ireland,GBR,36,0,258,10,304
2014,Botswana,BWA,United Kingdom of Great Britain and Northern Ireland,GBR,0,0,5,0,5
2014,Brazil,BRA,United Kingdom of Great Britain and Northern Ireland,GBR,0,0,5,0,5
2014,Central African Rep.,CAF,United Kingdom of Great Britain and Northern Ireland,GBR,0,0,0,5,5
2014,China,CHN,United Kingdom of Great Britain and Northern Ireland,GBR,32,0,257,5,294
2014,Cameroon,CMR,United Kingdom of Great Britain and Northern Ireland,GBR,18,0,40,5,63
2014,Congo,COG,United Kingdom of Great Britain and Northern Ireland,GBR,0,0,5,0,5
2014,Dem. Rep. of the Congo,COD,United Kingdom of Great Britain and Northern Ireland,GBR,33,0,35,5,73
2014,Colombia,COL,United Kingdom of Great Britain and Northern Ireland,GBR,0,0,5,0,5
2014,Eritrea,ERI,United Kingdom of Great Britain and Northern Ireland,GBR,50,0,59,5,114
2014,Ethiopia,ETH,United Kingdom of Great Britain and Northern Ireland,GBR,25,0,27,0,52
2014,Gambia,GMB,United Kingdom of Great Britain and Northern Ireland,GBR,17,0,38,5,60
2014,Palestinian,PSE,United Kingdom of Great Britain and Northern Ireland,GBR,10,0,19,0,29
2014,Georgia,GEO,United Kingdom of Great Britain and Northern Ireland,GBR,5,0,5,0,10
2014,Ghana,GHA,United Kingdom of Great Britain and Northern Ireland,GBR,10,0,30,5,45
2014,Guinea,GIN,United Kingdom of Great Britain and Northern Ireland,GBR,10,0,14,0,24
2014,Honduras,HND,United Kingdom of Great Britain and Northern Ireland,GBR,0,0,5,0,5
2014,Cote d'Ivoire,CIV,United Kingdom of Great Britain and Northern Ireland,GBR,11,0,25,0,36
2014,India,IND,United Kingdom of Great Britain and Northern Ireland,GBR,15,0,75,5,95
2014,Indonesia,IDN,United Kingdom of Great Britain and Northern Ireland,GBR,5,0,0,0,5
2014,Iran (Islamic Rep. of),IRN,United Kingdom of Great Britain and Northern Ireland,GBR,203,0,268,35,506
2014,Iraq,IRQ,United Kingdom of Great Britain and Northern Ireland,GBR,33,0,83,5,121
2014,Jamaica,JAM,United Kingdom of Great Britain and Northern Ireland,GBR,10,0,11,5,26
2014,Jordan,JOR,United Kingdom of Great Britain and Northern Ireland,GBR,5,0,5,0,10
2014,Kenya,KEN,United Kingdom of Great Britain and Northern Ireland,GBR,11,0,15,5,31
2014,Dem. People's Rep. of Korea,PRK,United Kingdom of Great Britain and Northern Ireland,GBR,0,0,5,0,5
2014,Kuwait,KWT,United Kingdom of Great Britain and Northern Ireland,GBR,0,0,5,0,5
2014,Libya,LBY,United Kingdom of Great Britain and Northern Ireland,GBR,12,0,36,5,53
2014,Lebanon,LBN,United Kingdom of Great Britain and Northern Ireland,GBR,5,0,10,0,15
2014,Sri Lanka,LKA,United Kingdom of Great Britain and Northern Ireland,GBR,288,0,340,34,662
2014,Mali,MLI,United Kingdom of Great Britain and Northern Ireland,GBR,5,0,5,0,10
2014,Malaysia,MYS,United Kingdom of Great Britain and Northern Ireland,GBR,0,0,12,0,12
2014,Malawi,MWI,United Kingdom of Great Britain and Northern Ireland,GBR,5,0,22,0,27
2014,Mongolia,MNG,United Kingdom of Great Britain and Northern Ireland,GBR,0,0,10,0,10
2014,Morocco,MAR,United Kingdom of Great Britain and Northern Ireland,GBR,0,0,13,5,18
2014,Mauritius,MUS,United Kingdom of Great Britain and Northern Ireland,GBR,5,0,0,0,5
2014,Myanmar,MMR,United Kingdom of Great Britain and Northern Ireland,GBR,13,0,5,0,18
2014,Namibia,NAM,United Kingdom of Great Britain and Northern Ireland,GBR,0,0,10,0,10
2014,Nepal,NPL,United Kingdom of Great Britain and Northern Ireland,GBR,0,0,19,0,19
2014,Nigeria,NGA,United Kingdom of Great Britain and Northern Ireland,GBR,64,0,206,23,293
2014,Pakistan,PAK,United Kingdom of Great Britain and Northern Ireland,GBR,244,0,913,61,1218
2014,Philippines,PHL,United Kingdom of Great Britain and Northern Ireland,GBR,5,0,10,0,15
2014,South Africa,ZAF,United Kingdom of Great Britain and Northern Ireland,GBR,0,0,12,0,12
2014,Russian Federation,RUS,United Kingdom of Great Britain and Northern Ireland,GBR,5,0,15,0,20
2014,Rwanda,RWA,United Kingdom of Great Britain and Northern Ireland,GBR,11,0,0,0,11
2014,El Salvador,SLV,United Kingdom of Great Britain and Northern Ireland,GBR,5,0,0,0,5
2014,Saudi Arabia,SAU,United Kingdom of Great Britain and Northern Ireland,GBR,0,0,5,0,5
2014,Serbia and Kosovo: S/RES/1244 (1999),SRB,United Kingdom of Great Britain and Northern Ireland,GBR,5,0,14,0,19
2014,Senegal,SEN,United Kingdom of Great Britain and Northern Ireland,GBR,0,0,5,5,10
2014,Seychelles,SYC,United Kingdom of Great Britain and Northern Ireland,GBR,0,0,5,0,5
2014,Sierra Leone,SLE,United Kingdom of Great Britain and Northern Ireland,GBR,5,0,14,0,19
2014,Somalia,SOM,United Kingdom of Great Britain and Northern Ireland,GBR,37,0,42,5,84
2014,Viet Nam,VNM,United Kingdom of Great Britain and Northern Ireland,GBR,24,0,49,5,78
2014,Sudan,SDN,United Kingdom of Great Britain and Northern Ireland,GBR,27,0,28,5,60
2014,Eswatini,SWZ,United Kingdom of Great Britain and Northern Ireland,GBR,0,0,5,0,5
2014,Syrian Arab Rep.,SYR,United Kingdom of Great Britain and Northern Ireland,GBR,14,0,54,5,73
2014,United Rep. of Tanzania,TZA,United Kingdom of Great Britain and Northern Ireland,GBR,0,0,13,0,13
2014,Thailand,THA,United Kingdom of Great Britain and Northern Ireland,GBR,0,0,5,0,5
2014,Trinidad and Tobago,TTO,United Kingdom of Great Britain and Northern Ireland,GBR,5,0,5,0,10
2014,Tunisia,TUN,United Kingdom of Great Britain and Northern Ireland,GBR,0,0,23,0,23
2014,Turkey,TUR,United Kingdom of Great Britain and Northern Ireland,GBR,33,0,60,10,103
2014,Uganda,UGA,United Kingdom of Great Britain and Northern Ireland,GBR,30,0,45,5,80
2014,Ukraine,UKR,United Kingdom of Great Britain and Northern Ireland,GBR,0,0,14,0,14
2014,United States of America,USA,United Kingdom of Great Britain and Northern Ireland,GBR,0,0,5,0,5
2014,Uzbekistan,UZB,United Kingdom of Great Britain and Northern Ireland,GBR,5,0,0,0,5
2014,Venezuela (Bolivarian Republic of),VEN,United Kingdom of Great Britain and Northern Ireland,GBR,5,0,5,0,10
2014,Yemen,YEM,United Kingdom of Great Britain and Northern Ireland,GBR,0,0,12,0,12
2014,Zambia,ZMB,United Kingdom of Great Britain and Northern Ireland,GBR,5,0,0,0,5
2014,Zimbabwe,ZWE,United Kingdom of Great Britain and Northern Ireland,GBR,17,0,74,5,96
2014,Stateless,XXA,United Kingdom of Great Britain and Northern Ireland,GBR,16,0,15,5,36
2015,Afghanistan,AFG,Australia,AUS,145,0,36,0,181
2015,Albania,ALB,Australia,AUS,0,0,5,0,5
2015,Egypt,EGY,Australia,AUS,39,0,89,5,133
2015,Burundi,BDI,Australia,AUS,5,0,0,0,5
2015,Bangladesh,BGD,Australia,AUS,19,0,84,5,108
2015,Cambodia,KHM,Australia,AUS,0,0,5,0,5
2015,China,CHN,Australia,AUS,55,0,397,54,506
2015,Cameroon,CMR,Australia,AUS,0,0,5,0,5
2015,Colombia,COL,Australia,AUS,0,0,5,0,5
2015,Ethiopia,ETH,Australia,AUS,0,0,5,0,5
2015,Fiji,FJI,Australia,AUS,5,0,122,15,142
2015,Georgia,GEO,Australia,AUS,0,0,5,0,5
2015,Ghana,GHA,Australia,AUS,0,0,5,5,10
2015,India,IND,Australia,AUS,10,0,226,46,282
2015,Indonesia,IDN,Australia,AUS,5,0,26,5,36
2015,Ireland,IRL,Australia,AUS,0,0,5,5,10
2015,Iran (Islamic Rep. of),IRN,Australia,AUS,99,0,110,16,225
2015,Iraq,IRQ,Australia,AUS,43,0,5,0,48
2015,Jordan,JOR,Australia,AUS,0,0,11,5,16
2015,Kenya,KEN,Australia,AUS,11,0,0,0,11
2015,Rep. of Korea,KOR,Australia,AUS,0,0,16,0,16
2015,Liberia,LBR,Australia,AUS,0,0,5,0,5
2015,Libya,LBY,Australia,AUS,21,0,0,0,21
2015,Lebanon,LBN,Australia,AUS,13,0,72,10,95
2015,Sri Lanka,LKA,Australia,AUS,159,0,780,29,968
2015,Malaysia,MYS,Australia,AUS,5,0,186,47,238
2015,Mongolia,MNG,Australia,AUS,0,0,5,0,5
2015,Mauritius,MUS,Australia,AUS,0,0,5,0,5
2015,Myanmar,MMR,Australia,AUS,0,0,5,0,5
2015,Nepal,NPL,Australia,AUS,5,0,76,11,92
2015,Nigeria,NGA,Australia,AUS,0,0,14,0,14
2015,Pakistan,PAK,Australia,AUS,63,0,117,17,197
2015,Peru,PER,Australia,AUS,5,0,0,0,5
2015,Philippines,PHL,Australia,AUS,0,0,13,0,13
2015,Papua New Guinea,PNG,Australia,AUS,5,0,12,0,17
2015,South Africa,ZAF,Australia,AUS,0,0,5,0,5
2015,Russian Federation,RUS,Australia,AUS,0,0,5,0,5
2015,Rwanda,RWA,Australia,AUS,5,0,0,0,5
2015,Somalia,SOM,Australia,AUS,0,0,5,0,5
2015,Viet Nam,VNM,Australia,AUS,11,0,35,5,51
2015,Thailand,THA,Australia,AUS,0,0,0,5,5
2015,Tonga,TON,Australia,AUS,0,0,5,5,10
2015,Turkey,TUR,Australia,AUS,5,0,10,5,20
2015,Ukraine,UKR,Australia,AUS,0,0,5,0,5
2015,United States of America,USA,Australia,AUS,0,0,5,0,5
2015,Zimbabwe,ZWE,Australia,AUS,5,0,10,5,20
2015,Stateless,XXA,Australia,AUS,10,0,13,0,23
2015,Afghanistan,AFG,United Kingdom of Great Britain and Northern Ireland,GBR,261,0,252,28,541
2015,Albania,ALB,United Kingdom of Great Britain and Northern Ireland,GBR,138,0,286,20,444
2015,Algeria,DZA,United Kingdom of Great Britain and Northern Ireland,GBR,10,0,37,0,47
2015,Angola,AGO,United Kingdom of Great Britain and Northern Ireland,GBR,5,0,17,5,27
2015,Egypt,EGY,United Kingdom of Great Britain and Northern Ireland,GBR,33,0,87,10,130
2015,Armenia,ARM,United Kingdom of Great Britain and Northern Ireland,GBR,0,0,5,5,10
2015,Azerbaijan,AZE,United Kingdom of Great Britain and Northern Ireland,GBR,0,0,5,0,5
2015,Bahrain,BHR,United Kingdom of Great Britain and Northern Ireland,GBR,5,0,0,0,5
2015,Burundi,BDI,United Kingdom of Great Britain and Northern Ireland,GBR,0,0,5,0,5
2015,Bangladesh,BGD,United Kingdom of Great Britain and Northern Ireland,GBR,49,0,330,20,399
2015,Belarus,BLR,United Kingdom of Great Britain and Northern Ireland,GBR,5,0,0,0,5
2015,Botswana,BWA,United Kingdom of Great Britain and Northern Ireland,GBR,0,0,5,0,5
2015,Chad,TCD,United Kingdom of Great Britain and Northern Ireland,GBR,5,0,0,0,5
2015,China,CHN,United Kingdom of Great Britain and Northern Ireland,GBR,49,0,386,15,450
2015,Cameroon,CMR,United Kingdom of Great Britain and Northern Ireland,GBR,18,0,34,5,57
2015,Congo,COG,United Kingdom of Great Britain and Northern Ireland,GBR,5,0,11,5,21
2015,Dem. Rep. of the Congo,COD,United Kingdom of Great Britain and Northern Ireland,GBR,61,0,80,5,146
2015,Colombia,COL,United Kingdom of Great Britain and Northern Ireland,GBR,0,0,5,0,5
2015,Eritrea,ERI,United Kingdom of Great Britain and Northern Ireland,GBR,452,0,94,16,562
2015,Ethiopia,ETH,United Kingdom of Great Britain and Northern Ireland,GBR,30,0,43,5,78
2015,Gambia,GMB,United Kingdom of Great Britain and Northern Ireland,GBR,25,0,77,5,107
2015,Palestinian,PSE,United Kingdom of Great Britain and Northern Ireland,GBR,20,0,31,5,56
2015,Georgia,GEO,United Kingdom of Great Britain and Northern Ireland,GBR,5,0,13,0,18
2015,Ghana,GHA,United Kingdom of Great Britain and Northern Ireland,GBR,10,0,38,5,53
2015,Guinea,GIN,United Kingdom of Great Britain and Northern Ireland,GBR,14,0,5,0,19
2015,Honduras,HND,United Kingdom of Great Britain and Northern Ireland,GBR,5,0,0,0,5
2015,Cote d'Ivoire,CIV,United Kingdom of Great Britain and Northern Ireland,GBR,10,0,23,0,33
2015,India,IND,United Kingdom of Great Britain and Northern Ireland,GBR,21,0,90,10,121
2015,Indonesia,IDN,United Kingdom of Great Britain and Northern Ireland,GBR,0,0,10,0,10
2015,Iran (Islamic Rep. of),IRN,United Kingdom of Great Britain and Northern Ireland,GBR,338,0,409,49,796
2015,Iraq,IRQ,United Kingdom of Great Britain and Northern Ireland,GBR,100,0,155,17,272
2015,Israel,ISR,United Kingdom of Great Britain and Northern Ireland,GBR,0,0,5,0,5
2015,Jamaica,JAM,United Kingdom of Great Britain and Northern Ireland,GBR,17,0,23,0,40
2015,Jordan,JOR,United Kingdom of Great Britain and Northern Ireland,GBR,0,0,11,0,11
2015,Kazakhstan,KAZ,United Kingdom of Great Britain and Northern Ireland,GBR,5,0,0,0,5
2015,Kenya,KEN,United Kingdom of Great Britain and Northern Ireland,GBR,5,0,25,5,35
2015,Dem. People's Rep. of Korea,PRK,United Kingdom of Great Britain and Northern Ireland,GBR,0,0,5,0,5
2015,Kuwait,KWT,United Kingdom of Great Britain and Northern Ireland,GBR,0,0,11,0,11
2015,Libya,LBY,United Kingdom of Great Britain and Northern Ireland,GBR,80,0,95,12,187
2015,Saint Lucia,LCA,United Kingdom of Great Britain and Northern Ireland,GBR,5,0,0,0,5
2015,Lebanon,LBN,United Kingdom of Great Britain and Northern Ireland,GBR,5,0,11,5,21
2015,Sri Lanka,LKA,United Kingdom of Great Britain and Northern Ireland,GBR,505,0,572,46,1123
2015,North Macedonia,MKD,United Kingdom of Great Britain and Northern Ireland,GBR,5,0,0,0,5
2015,Mali,MLI,United Kingdom of Great Britain and Northern Ireland,GBR,0,0,5,0,5
2015,Malaysia,MYS,United Kingdom of Great Britain and Northern Ireland,GBR,0,0,16,0,16
2015,Malawi,MWI,United Kingdom of Great Britain and Northern Ireland,GBR,5,0,31,5,41
2015,Mongolia,MNG,United Kingdom of Great Britain and Northern Ireland,GBR,5,0,0,0,5
2015,Morocco,MAR,United Kingdom of Great Britain and Northern Ireland,GBR,5,0,18,5,28
2015,Mauritius,MUS,United Kingdom of Great Britain and Northern Ireland,GBR,5,0,5,0,10
2015,Myanmar,MMR,United Kingdom of Great Britain and Northern Ireland,GBR,25,0,33,0,58
2015,Nepal,NPL,United Kingdom of Great Britain and Northern Ireland,GBR,0,0,20,0,20
2015,Nigeria,NGA,United Kingdom of Great Britain and Northern Ireland,GBR,58,0,262,14,334
2015,Pakistan,PAK,United Kingdom of Great Britain and Northern Ireland,GBR,298,0,858,51,1207
2015,Philippines,PHL,United Kingdom of Great Britain and Northern Ireland,GBR,0,0,10,0,10
2015,South Africa,ZAF,United Kingdom of Great Britain and Northern Ireland,GBR,0,0,12,0,12
2015,Russian Federation,RUS,United Kingdom of Great Britain and Northern Ireland,GBR,16,0,12,5,33
2015,Rwanda,RWA,United Kingdom of Great Britain and Northern Ireland,GBR,5,0,5,0,10
2015,El Salvador,SLV,United Kingdom of Great Britain and Northern Ireland,GBR,5,0,5,0,10
2015,Saudi Arabia,SAU,United Kingdom of Great Britain and Northern Ireland,GBR,5,0,0,0,5
2015,Serbia and Kosovo: S/RES/1244 (1999),SRB,United Kingdom of Great Britain and Northern Ireland,GBR,0,0,5,0,5
2015,Senegal,SEN,United Kingdom of Great Britain and Northern Ireland,GBR,0,0,13,0,13
2015,Sierra Leone,SLE,United Kingdom of Great Britain and Northern Ireland,GBR,19,0,18,0,37
2015,Somalia,SOM,United Kingdom of Great Britain and Northern Ireland,GBR,61,0,105,17,183
2015,Viet Nam,VNM,United Kingdom of Great Britain and Northern Ireland,GBR,39,0,77,11,127
2015,Sudan,SDN,United Kingdom of Great Britain and Northern Ireland,GBR,74,0,55,14,143
2015,Syrian Arab Rep.,SYR,United Kingdom of Great Britain and Northern Ireland,GBR,33,0,54,5,92
2015,United Rep. of Tanzania,TZA,United Kingdom of Great Britain and Northern Ireland,GBR,5,0,14,0,19
2015,Thailand,THA,United Kingdom of Great Britain and Northern Ireland,GBR,0,0,5,0,5
2015,Togo,TGO,United Kingdom of Great Britain and Northern Ireland,GBR,0,0,5,0,5
2015,Trinidad and Tobago,TTO,United Kingdom of Great Britain and Northern Ireland,GBR,12,0,0,0,12
2015,Tunisia,TUN,United Kingdom of Great Britain and Northern Ireland,GBR,5,0,10,0,15
2015,Turkey,TUR,United Kingdom of Great Britain and Northern Ireland,GBR,56,0,121,10,187
2015,United Arab Emirates,ARE,United Kingdom of Great Britain and Northern Ireland,GBR,5,0,0,0,5
2015,Uganda,UGA,United Kingdom of Great Britain and Northern Ireland,GBR,39,0,39,5,83
2015,Ukraine,UKR,United Kingdom of Great Britain and Northern Ireland,GBR,14,0,20,0,34
2015,Uzbekistan,UZB,United Kingdom of Great Britain and Northern Ireland,GBR,0,0,12,0,12
2015,Saint Vincent and the Grenadines,VCT,United Kingdom of Great Britain and Northern Ireland,GBR,0,0,5,0,5
2015,Venezuela (Bolivarian Republic of),VEN,United Kingdom of Great Britain and Northern Ireland,GBR,0,0,10,0,10
2015,Yemen,YEM,United Kingdom of Great Britain and Northern Ireland,GBR,22,0,18,0,40
2015,Zambia,ZMB,United Kingdom of Great Britain and Northern Ireland,GBR,0,0,14,0,14
2015,Zimbabwe,ZWE,United Kingdom of Great Britain and Northern Ireland,GBR,55,0,189,11,255
2015,Stateless,XXA,United Kingdom of Great Britain and Northern Ireland,GBR,20,0,23,5,48
2016,Afghanistan,AFG,United Kingdom of Great Britain and Northern Ireland,GBR,395,0,388,24,807
2016,Albania,ALB,United Kingdom of Great Britain and Northern Ireland,GBR,241,0,441,31,713
2016,Algeria,DZA,United Kingdom of Great Britain and Northern Ireland,GBR,10,0,34,5,49
2016,Angola,AGO,United Kingdom of Great Britain and Northern Ireland,GBR,5,0,11,0,16
2016,Egypt,EGY,United Kingdom of Great Britain and Northern Ireland,GBR,40,0,110,11,161
2016,Armenia,ARM,United Kingdom of Great Britain and Northern Ireland,GBR,0,0,14,0,14
2016,Azerbaijan,AZE,United Kingdom of Great Britain and Northern Ireland,GBR,5,0,0,0,5
2016,Bahrain,BHR,United Kingdom of Great Britain and Northern Ireland,GBR,5,0,0,0,5
2016,Burundi,BDI,United Kingdom of Great Britain and Northern Ireland,GBR,5,0,0,0,5
2016,Bangladesh,BGD,United Kingdom of Great Britain and Northern Ireland,GBR,110,0,535,21,666
2016,Botswana,BWA,United Kingdom of Great Britain and Northern Ireland,GBR,0,0,5,0,5
2016,Brazil,BRA,United Kingdom of Great Britain and Northern Ireland,GBR,0,0,5,0,5
2016,Chad,TCD,United Kingdom of Great Britain and Northern Ireland,GBR,0,0,14,0,14
2016,China,CHN,United Kingdom of Great Britain and Northern Ireland,GBR,23,0,236,11,270
2016,Cameroon,CMR,United Kingdom of Great Britain and Northern Ireland,GBR,21,0,50,5,76
2016,Congo,COG,United Kingdom of Great Britain and Northern Ireland,GBR,5,0,13,0,18
2016,Dem. Rep. of the Congo,COD,United Kingdom of Great Britain and Northern Ireland,GBR,33,0,72,0,105
2016,Colombia,COL,United Kingdom of Great Britain and Northern Ireland,GBR,5,0,0,0,5
2016,Eritrea,ERI,United Kingdom of Great Britain and Northern Ireland,GBR,1187,0,162,234,1583
2016,Ethiopia,ETH,United Kingdom of Great Britain and Northern Ireland,GBR,119,0,147,5,271
2016,Gambia,GMB,United Kingdom of Great Britain and Northern Ireland,GBR,45,0,98,0,143
2016,Palestinian,PSE,United Kingdom of Great Britain and Northern Ireland,GBR,17,0,37,5,59
2016,Georgia,GEO,United Kingdom of Great Britain and Northern Ireland,GBR,5,0,11,5,21
2016,Ghana,GHA,United Kingdom of Great Britain and Northern Ireland,GBR,17,0,50,0,67
2016,Guinea,GIN,United Kingdom of Great Britain and Northern Ireland,GBR,5,0,11,0,16
2016,Guyana,GUY,United Kingdom of Great Britain and Northern Ireland,GBR,5,0,0,0,5
2016,Cote d'Ivoire,CIV,United Kingdom of Great Britain and Northern Ireland,GBR,10,0,16,0,26
2016,India,IND,United Kingdom of Great Britain and Northern Ireland,GBR,21,0,80,5,106
2016,Indonesia,IDN,United Kingdom of Great Britain and Northern Ireland,GBR,5,0,0,0,5
2016,Iran (Islamic Rep. of),IRN,United Kingdom of Great Britain and Northern Ireland,GBR,542,0,657,33,1232
2016,Iraq,IRQ,United Kingdom of Great Britain and Northern Ireland,GBR,359,0,618,28,1005
2016,Israel,ISR,United Kingdom of Great Britain and Northern Ireland,GBR,0,0,5,0,5
2016,Jamaica,JAM,United Kingdom of Great Britain and Northern Ireland,GBR,10,0,31,5,46
2016,Jordan,JOR,United Kingdom of Great Britain and Northern Ireland,GBR,0,0,5,0,5
2016,Kenya,KEN,United Kingdom of Great Britain and Northern Ireland,GBR,10,0,25,0,35
2016,Kyrgyzstan,KGZ,United Kingdom of Great Britain and Northern Ireland,GBR,0,0,5,0,5
2016,Dem. People's Rep. of Korea,PRK,United Kingdom of Great Britain and Northern Ireland,GBR,0,0,5,0,5
2016,Kuwait,KWT,United Kingdom of Great Britain and Northern Ireland,GBR,5,0,10,0,15
2016,Liberia,LBR,United Kingdom of Great Britain and Northern Ireland,GBR,5,0,0,0,5
2016,Libya,LBY,United Kingdom of Great Britain and Northern Ireland,GBR,136,0,129,10,275
2016,Saint Lucia,LCA,United Kingdom of Great Britain and Northern Ireland,GBR,5,0,0,0,5
2016,Lebanon,LBN,United Kingdom of Great Britain and Northern Ireland,GBR,5,0,19,0,24
2016,Sri Lanka,LKA,United Kingdom of Great Britain and Northern Ireland,GBR,412,0,442,23,877
2016,Latvia,LVA,United Kingdom of Great Britain and Northern Ireland,GBR,0,0,5,0,5
2016,Mexico,MEX,United Kingdom of Great Britain and Northern Ireland,GBR,0,0,5,0,5
2016,Mali,MLI,United Kingdom of Great Britain and Northern Ireland,GBR,0,0,5,0,5
2016,Malaysia,MYS,United Kingdom of Great Britain and Northern Ireland,GBR,5,0,17,0,22
2016,Malawi,MWI,United Kingdom of Great Britain and Northern Ireland,GBR,11,0,27,0,38
2016,Mongolia,MNG,United Kingdom of Great Britain and Northern Ireland,GBR,5,0,0,0,5
2016,Morocco,MAR,United Kingdom of Great Britain and Northern Ireland,GBR,10,0,20,0,30
2016,Mauritius,MUS,United Kingdom of Great Britain and Northern Ireland,GBR,0,0,5,0,5
2016,Myanmar,MMR,United Kingdom of Great Britain and Northern Ireland,GBR,39,0,80,0,119
2016,Namibia,NAM,United Kingdom of Great Britain and Northern Ireland,GBR,0,0,5,0,5
2016,Nepal,NPL,United Kingdom of Great Britain and Northern Ireland,GBR,5,0,25,0,30
2016,Nigeria,NGA,United Kingdom of Great Britain and Northern Ireland,GBR,97,0,280,17,394
2016,Oman,OMN,United Kingdom of Great Britain and Northern Ireland,GBR,5,0,0,0,5
2016,Pakistan,PAK,United Kingdom of Great Britain and Northern Ireland,GBR,310,0,769,30,1109
2016,Philippines,PHL,United Kingdom of Great Britain and Northern Ireland,GBR,5,0,20,0,25
2016,Poland,POL,United Kingdom of Great Britain and Northern Ireland,GBR,0,0,5,0,5
2016,Romania,ROU,United Kingdom of Great Britain and Northern Ireland,GBR,5,0,0,0,5
2016,South Africa,ZAF,United Kingdom of Great Britain and Northern Ireland,GBR,5,0,13,5,23
2016,Russian Federation,RUS,United Kingdom of Great Britain and Northern Ireland,GBR,15,0,14,5,34
2016,Rwanda,RWA,United Kingdom of Great Britain and Northern Ireland,GBR,5,0,5,0,10
2016,El Salvador,SLV,United Kingdom of Great Britain and Northern Ireland,GBR,0,0,10,0,10
2016,Saudi Arabia,SAU,United Kingdom of Great Britain and Northern Ireland,GBR,5,0,0,0,5
2016,Serbia and Kosovo: S/RES/1244 (1999),SRB,United Kingdom of Great Britain and Northern Ireland,GBR,13,0,0,0,13
2016,Senegal,SEN,United Kingdom of Great Britain and Northern Ireland,GBR,0,0,12,0,12
2016,Sierra Leone,SLE,United Kingdom of Great Britain and Northern Ireland,GBR,11,0,17,0,28
2016,Somalia,SOM,United Kingdom of Great Britain and Northern Ireland,GBR,67,0,122,10,199
2016,Viet Nam,VNM,United Kingdom of Great Britain and Northern Ireland,GBR,49,0,95,5,149
2016,Sudan,SDN,United Kingdom of Great Britain and Northern Ireland,GBR,159,0,103,10,272
2016,Eswatini,SWZ,United Kingdom of Great Britain and Northern Ireland,GBR,0,0,5,0,5
2016,Syrian Arab Rep.,SYR,United Kingdom of Great Britain and Northern Ireland,GBR,47,0,92,10,149
2016,United Rep. of Tanzania,TZA,United Kingdom of Great Britain and Northern Ireland,GBR,0,0,20,0,20
2016,Thailand,THA,United Kingdom of Great Britain and Northern Ireland,GBR,0,0,0,5,5
2016,Turkmenistan,TKM,United Kingdom of Great Britain and Northern Ireland,GBR,5,0,0,0,5
2016,Togo,TGO,United Kingdom of Great Britain and Northern Ireland,GBR,0,0,5,0,5
2016,Trinidad and Tobago,TTO,United Kingdom of Great Britain and Northern Ireland,GBR,5,0,5,0,10
2016,Tunisia,TUN,United Kingdom of Great Britain and Northern Ireland,GBR,0,0,14,0,14
2016,Turkey,TUR,United Kingdom of Great Britain and Northern Ireland,GBR,57,0,73,11,141
2016,United Arab Emirates,ARE,United Kingdom of Great Britain and Northern Ireland,GBR,5,0,0,0,5
2016,Uganda,UGA,United Kingdom of Great Britain and Northern Ireland,GBR,43,0,50,5,98
2016,Ukraine,UKR,United Kingdom of Great Britain and Northern Ireland,GBR,13,0,34,5,52
2016,Uzbekistan,UZB,United Kingdom of Great Britain and Northern Ireland,GBR,5,0,5,0,10
2016,Venezuela (Bolivarian Republic of),VEN,United Kingdom of Great Britain and Northern Ireland,GBR,0,0,5,0,5
2016,Yemen,YEM,United Kingdom of Great Britain and Northern Ireland,GBR,26,0,11,5,42
2016,Zambia,ZMB,United Kingdom of Great Britain and Northern Ireland,GBR,5,0,5,0,10
2016,Zimbabwe,ZWE,United Kingdom of Great Britain and Northern Ireland,GBR,60,0,135,5,200
2016,Stateless,XXA,United Kingdom of Great Britain and Northern Ireland,GBR,35,0,40,5,80
2017,Afghanistan,AFG,United Kingdom of Great Britain and Northern Ireland,GBR,568,0,491,40,1099
2017,Albania,ALB,United Kingdom of Great Britain and Northern Ireland,GBR,142,0,318,29,489
2017,Algeria,DZA,United Kingdom of Great Britain and Northern Ireland,GBR,22,0,58,0,80
2017,Angola,AGO,United Kingdom of Great Britain and Northern Ireland,GBR,0,0,25,0,25
2017,Egypt,EGY,United Kingdom of Great Britain and Northern Ireland,GBR,53,0,139,5,197
2017,Armenia,ARM,United Kingdom of Great Britain and Northern Ireland,GBR,5,0,5,0,10
2017,Azerbaijan,AZE,United Kingdom of Great Britain and Northern Ireland,GBR,0,0,14,0,14
2017,Burundi,BDI,United Kingdom of Great Britain and Northern Ireland,GBR,5,0,5,0,10
2017,Benin,BEN,United Kingdom of Great Britain and Northern Ireland,GBR,0,0,5,0,5
2017,Bangladesh,BGD,United Kingdom of Great Britain and Northern Ireland,GBR,188,0,865,33,1086
2017,Burkina Faso,BFA,United Kingdom of Great Britain and Northern Ireland,GBR,0,0,5,0,5
2017,Belarus,BLR,United Kingdom of Great Britain and Northern Ireland,GBR,0,0,5,0,5
2017,Bolivia (Plurinational State of),BOL,United Kingdom of Great Britain and Northern Ireland,GBR,0,0,5,0,5
2017,Botswana,BWA,United Kingdom of Great Britain and Northern Ireland,GBR,0,0,10,0,10
2017,Brazil,BRA,United Kingdom of Great Britain and Northern Ireland,GBR,0,0,5,0,5
2017,Chad,TCD,United Kingdom of Great Britain and Northern Ireland,GBR,0,0,5,0,5
2017,China,CHN,United Kingdom of Great Britain and Northern Ireland,GBR,30,0,270,13,313
2017,Cameroon,CMR,United Kingdom of Great Britain and Northern Ireland,GBR,39,0,73,0,112
2017,Congo,COG,United Kingdom of Great Britain and Northern Ireland,GBR,5,0,11,0,16
2017,Dem. Rep. of the Congo,COD,United Kingdom of Great Britain and Northern Ireland,GBR,51,0,75,5,131
2017,Colombia,COL,United Kingdom of Great Britain and Northern Ireland,GBR,0,0,5,0,5
2017,Eritrea,ERI,United Kingdom of Great Britain and Northern Ireland,GBR,199,0,132,209,540
2017,Ethiopia,ETH,United Kingdom of Great Britain and Northern Ireland,GBR,76,0,96,5,177
2017,Gambia,GMB,United Kingdom of Great Britain and Northern Ireland,GBR,22,0,59,5,86
2017,Palestinian,PSE,United Kingdom of Great Britain and Northern Ireland,GBR,18,0,31,0,49
2017,Georgia,GEO,United Kingdom of Great Britain and Northern Ireland,GBR,5,0,15,0,20
2017,Ghana,GHA,United Kingdom of Great Britain and Northern Ireland,GBR,11,0,93,5,109
2017,Guinea-Bissau,GNB,United Kingdom of Great Britain and Northern Ireland,GBR,0,0,5,0,5
2017,Guatemala,GTM,United Kingdom of Great Britain and Northern Ireland,GBR,0,0,5,0,5
2017,Guinea,GIN,United Kingdom of Great Britain and Northern Ireland,GBR,5,0,12,0,17
2017,Cote d'Ivoire,CIV,United Kingdom of Great Britain and Northern Ireland,GBR,5,0,21,0,26
2017,India,IND,United Kingdom of Great Britain and Northern Ireland,GBR,46,0,145,13,204
2017,Indonesia,IDN,United Kingdom of Great Britain and Northern Ireland,GBR,0,0,5,0,5
2017,Iran (Islamic Rep. of),IRN,United Kingdom of Great Britain and Northern Ireland,GBR,1001,0,1138,33,2172
2017,Iraq,IRQ,United Kingdom of Great Britain and Northern Ireland,GBR,604,0,1065,34,1703
2017,Israel,ISR,United Kingdom of Great Britain and Northern Ireland,GBR,0,0,5,0,5
2017,Jamaica,JAM,United Kingdom of Great Britain and Northern Ireland,GBR,15,0,45,0,60
2017,Jordan,JOR,United Kingdom of Great Britain and Northern Ireland,GBR,0,0,14,0,14
2017,Kazakhstan,KAZ,United Kingdom of Great Britain and Northern Ireland,GBR,0,0,5,0,5
2017,Kenya,KEN,United Kingdom of Great Britain and Northern Ireland,GBR,10,0,30,5,45
2017,Kuwait,KWT,United Kingdom of Great Britain and Northern Ireland,GBR,11,0,12,0,23
2017,Libya,LBY,United Kingdom of Great Britain and Northern Ireland,GBR,126,0,56,23,205
2017,Saint Lucia,LCA,United Kingdom of Great Britain and Northern Ireland,GBR,5,0,5,0,10
2017,Lebanon,LBN,United Kingdom of Great Britain and Northern Ireland,GBR,16,0,24,0,40
2017,Sri Lanka,LKA,United Kingdom of Great Britain and Northern Ireland,GBR,337,0,358,15,710
2017,Maldives,MDV,United Kingdom of Great Britain and Northern Ireland,GBR,0,0,0,5,5
2017,Mexico,MEX,United Kingdom of Great Britain and Northern Ireland,GBR,5,0,5,0,10
2017,Mali,MLI,United Kingdom of Great Britain and Northern Ireland,GBR,0,0,5,0,5
2017,Malaysia,MYS,United Kingdom of Great Britain and Northern Ireland,GBR,10,0,24,0,34
2017,Malawi,MWI,United Kingdom of Great Britain and Northern Ireland,GBR,5,0,23,5,33
2017,Mongolia,MNG,United Kingdom of Great Britain and Northern Ireland,GBR,0,0,5,0,5
2017,Morocco,MAR,United Kingdom of Great Britain and Northern Ireland,GBR,12,0,30,0,42
2017,Mauritius,MUS,United Kingdom of Great Britain and Northern Ireland,GBR,5,0,11,0,16
2017,Myanmar,MMR,United Kingdom of Great Britain and Northern Ireland,GBR,10,0,30,0,40
2017,Namibia,NAM,United Kingdom of Great Britain and Northern Ireland,GBR,5,0,13,0,18
2017,Nepal,NPL,United Kingdom of Great Britain and Northern Ireland,GBR,10,0,45,0,55
2017,Nigeria,NGA,United Kingdom of Great Britain and Northern Ireland,GBR,134,0,388,17,539
2017,Pakistan,PAK,United Kingdom of Great Britain and Northern Ireland,GBR,357,0,1138,35,1530
2017,Philippines,PHL,United Kingdom of Great Britain and Northern Ireland,GBR,5,0,29,0,34
2017,South Africa,ZAF,United Kingdom of Great Britain and Northern Ireland,GBR,5,0,12,0,17
2017,Russian Federation,RUS,United Kingdom of Great Britain and Northern Ireland,GBR,20,0,22,0,42
2017,Rwanda,RWA,United Kingdom of Great Britain and Northern Ireland,GBR,10,0,10,0,20
2017,El Salvador,SLV,United Kingdom of Great Britain and Northern Ireland,GBR,11,0,10,0,21
2017,Saudi Arabia,SAU,United Kingdom of Great Britain and Northern Ireland,GBR,5,0,15,0,20
2017,Serbia and Kosovo: S/RES/1244 (1999),SRB,United Kingdom of Great Britain and Northern Ireland,GBR,5,0,5,0,10
2017,Senegal,SEN,United Kingdom of Great Britain and Northern Ireland,GBR,10,0,13,0,23
2017,Sierra Leone,SLE,United Kingdom of Great Britain and Northern Ireland,GBR,5,0,18,0,23
2017,Somalia,SOM,United Kingdom of Great Britain and Northern Ireland,GBR,98,0,80,0,178
2017,Viet Nam,VNM,United Kingdom of Great Britain and Northern Ireland,GBR,99,0,133,10,242
2017,Sudan,SDN,United Kingdom of Great Britain and Northern Ireland,GBR,103,0,87,10,200
2017,Eswatini,SWZ,United Kingdom of Great Britain and Northern Ireland,GBR,0,0,5,0,5
2017,Syrian Arab Rep.,SYR,United Kingdom of Great Britain and Northern Ireland,GBR,63,0,97,5,165
2017,United Rep. of Tanzania,TZA,United Kingdom of Great Britain and Northern Ireland,GBR,5,0,12,0,17
2017,Thailand,THA,United Kingdom of Great Britain and Northern Ireland,GBR,5,0,5,0,10
2017,Turkmenistan,TKM,United Kingdom of Great Britain and Northern Ireland,GBR,5,0,0,0,5
2017,Togo,TGO,United Kingdom of Great Britain and Northern Ireland,GBR,0,0,5,0,5
2017,Trinidad and Tobago,TTO,United Kingdom of Great Britain and Northern Ireland,GBR,0,0,10,0,10
2017,Tunisia,TUN,United Kingdom of Great Britain and Northern Ireland,GBR,0,0,12,0,12
2017,Turkey,TUR,United Kingdom of Great Britain and Northern Ireland,GBR,95,0,113,5,213
2017,Uganda,UGA,United Kingdom of Great Britain and Northern Ireland,GBR,27,0,61,5,93
2017,Ukraine,UKR,United Kingdom of Great Britain and Northern Ireland,GBR,13,0,42,5,60
2017,Uzbekistan,UZB,United Kingdom of Great Britain and Northern Ireland,GBR,0,0,5,0,5
2017,Saint Vincent and the Grenadines,VCT,United Kingdom of Great Britain and Northern Ireland,GBR,5,0,0,0,5
2017,Venezuela (Bolivarian Republic of),VEN,United Kingdom of Great Britain and Northern Ireland,GBR,5,0,0,0,5
2017,Yemen,YEM,United Kingdom of Great Britain and Northern Ireland,GBR,23,0,10,0,33
2017,Zambia,ZMB,United Kingdom of Great Britain and Northern Ireland,GBR,0,0,16,0,16
2017,Zimbabwe,ZWE,United Kingdom of Great Britain and Northern Ireland,GBR,65,0,156,5,226
2017,Stateless,XXA,United Kingdom of Great Britain and Northern Ireland,GBR,21,0,56,10,87
2018,Afghanistan,AFG,United Kingdom of Great Britain and Northern Ireland,GBR,408,0,313,32,753
2018,Albania,ALB,United Kingdom of Great Britain and Northern Ireland,GBR,166,0,238,21,425
2018,Algeria,DZA,United Kingdom of Great Britain and Northern Ireland,GBR,18,0,50,0,68
2018,Angola,AGO,United Kingdom of Great Britain and Northern Ireland,GBR,10,0,20,0,30
2018,Egypt,EGY,United Kingdom of Great Britain and Northern Ireland,GBR,72,0,152,10,234
2018,Armenia,ARM,United Kingdom of Great Britain and Northern Ireland,GBR,5,0,16,0,21
2018,Azerbaijan,AZE,United Kingdom of Great Britain and Northern Ireland,GBR,14,0,5,0,19
2018,Bahrain,BHR,United Kingdom of Great Britain and Northern Ireland,GBR,0,0,5,0,5
2018,Burundi,BDI,United Kingdom of Great Britain and Northern Ireland,GBR,5,0,11,0,16
2018,Bangladesh,BGD,United Kingdom of Great Britain and Northern Ireland,GBR,202,0,820,30,1052
2018,Burkina Faso,BFA,United Kingdom of Great Britain and Northern Ireland,GBR,0,0,5,0,5
2018,Belarus,BLR,United Kingdom of Great Britain and Northern Ireland,GBR,5,0,0,0,5
2018,Botswana,BWA,United Kingdom of Great Britain and Northern Ireland,GBR,0,0,12,0,12
2018,Brazil,BRA,United Kingdom of Great Britain and Northern Ireland,GBR,0,0,5,0,5
2018,China,CHN,United Kingdom of Great Britain and Northern Ireland,GBR,43,0,171,12,226
2018,Cameroon,CMR,United Kingdom of Great Britain and Northern Ireland,GBR,67,0,67,0,134
2018,Congo,COG,United Kingdom of Great Britain and Northern Ireland,GBR,5,0,11,5,21
2018,Dem. Rep. of the Congo,COD,United Kingdom of Great Britain and Northern Ireland,GBR,59,0,61,5,125
2018,Colombia,COL,United Kingdom of Great Britain and Northern Ireland,GBR,0,0,10,0,10
2018,Cuba,CUB,United Kingdom of Great Britain and Northern Ireland,GBR,0,0,5,0,5
2018,Eritrea,ERI,United Kingdom of Great Britain and Northern Ireland,GBR,43,0,38,5,86
2018,Ethiopia,ETH,United Kingdom of Great Britain and Northern Ireland,GBR,69,0,96,5,170
2018,Gambia,GMB,United Kingdom of Great Britain and Northern Ireland,GBR,14,0,34,5,53
2018,Palestinian,PSE,United Kingdom of Great Britain and Northern Ireland,GBR,18,0,36,5,59
2018,Georgia,GEO,United Kingdom of Great Britain and Northern Ireland,GBR,10,0,11,0,21
2018,Ghana,GHA,United Kingdom of Great Britain and Northern Ireland,GBR,15,0,57,0,72
2018,Grenada,GRD,United Kingdom of Great Britain and Northern Ireland,GBR,5,0,5,0,10
2018,Guinea,GIN,United Kingdom of Great Britain and Northern Ireland,GBR,5,0,13,0,18
2018,"China, Hong Kong SAR",HKG,United Kingdom of Great Britain and Northern Ireland,GBR,0,0,5,0,5
2018,Cote d'Ivoire,CIV,United Kingdom of Great Britain and Northern Ireland,GBR,10,0,21,5,36
2018,India,IND,United Kingdom of Great Britain and Northern Ireland,GBR,35,0,102,12,149
2018,Indonesia,IDN,United Kingdom of Great Britain and Northern Ireland,GBR,0,0,5,0,5
2018,Iran (Islamic Rep. of),IRN,United Kingdom of Great Britain and Northern Ireland,GBR,687,0,634,51,1372
2018,Iraq,IRQ,United Kingdom of Great Britain and Northern Ireland,GBR,549,0,814,60,1423
2018,Jamaica,JAM,United Kingdom of Great Britain and Northern Ireland,GBR,15,0,38,5,58
2018,Jordan,JOR,United Kingdom of Great Britain and Northern Ireland,GBR,10,0,11,0,21
2018,Kazakhstan,KAZ,United Kingdom of Great Britain and Northern Ireland,GBR,5,0,5,0,10
2018,Kenya,KEN,United Kingdom of Great Britain and Northern Ireland,GBR,22,0,40,0,62
2018,Kyrgyzstan,KGZ,United Kingdom of Great Britain and Northern Ireland,GBR,0,0,5,0,5
2018,Kuwait,KWT,United Kingdom of Great Britain and Northern Ireland,GBR,10,0,16,0,26
2018,Libya,LBY,United Kingdom of Great Britain and Northern Ireland,GBR,14,0,10,5,29
2018,Saint Lucia,LCA,United Kingdom of Great Britain and Northern Ireland,GBR,0,0,5,0,5
2018,Lebanon,LBN,United Kingdom of Great Britain and Northern Ireland,GBR,10,0,16,0,26
2018,Sri Lanka,LKA,United Kingdom of Great Britain and Northern Ireland,GBR,294,0,243,20,557
2018,Mexico,MEX,United Kingdom of Great Britain and Northern Ireland,GBR,0,0,5,0,5
2018,Malaysia,MYS,United Kingdom of Great Britain and Northern Ireland,GBR,16,0,27,5,48
2018,Malawi,MWI,United Kingdom of Great Britain and Northern Ireland,GBR,10,0,36,0,46
2018,Mongolia,MNG,United Kingdom of Great Britain and Northern Ireland,GBR,5,0,0,0,5
2018,Morocco,MAR,United Kingdom of Great Britain and Northern Ireland,GBR,14,0,26,0,40
2018,Mozambique,MOZ,United Kingdom of Great Britain and Northern Ireland,GBR,0,0,5,0,5
2018,Mauritius,MUS,United Kingdom of Great Britain and Northern Ireland,GBR,0,0,11,0,11
2018,Myanmar,MMR,United Kingdom of Great Britain and Northern Ireland,GBR,18,0,22,0,40
2018,Namibia,NAM,United Kingdom of Great Britain and Northern Ireland,GBR,5,0,33,5,43
2018,Nepal,NPL,United Kingdom of Great Britain and Northern Ireland,GBR,5,0,39,5,49
2018,Nigeria,NGA,United Kingdom of Great Britain and Northern Ireland,GBR,106,0,318,24,448
2018,Oman,OMN,United Kingdom of Great Britain and Northern Ireland,GBR,5,0,0,0,5
2018,Pakistan,PAK,United Kingdom of Great Britain and Northern Ireland,GBR,361,0,891,42,1294
2018,Philippines,PHL,United Kingdom of Great Britain and Northern Ireland,GBR,5,0,21,5,31
2018,South Africa,ZAF,United Kingdom of Great Britain and Northern Ireland,GBR,5,0,20,0,25
2018,Russian Federation,RUS,United Kingdom of Great Britain and Northern Ireland,GBR,23,0,10,5,38
2018,Rwanda,RWA,United Kingdom of Great Britain and Northern Ireland,GBR,5,0,10,0,15
2018,El Salvador,SLV,United Kingdom of Great Britain and Northern Ireland,GBR,5,0,16,0,21
2018,Saudi Arabia,SAU,United Kingdom of Great Britain and Northern Ireland,GBR,0,0,14,0,14
2018,Serbia and Kosovo: S/RES/1244 (1999),SRB,United Kingdom of Great Britain and Northern Ireland,GBR,5,0,5,0,10
2018,Senegal,SEN,United Kingdom of Great Britain and Northern Ireland,GBR,14,0,0,0,14
2018,Sierra Leone,SLE,United Kingdom of Great Britain and Northern Ireland,GBR,10,0,11,5,26
2018,Somalia,SOM,United Kingdom of Great Britain and Northern Ireland,GBR,44,0,52,5,101
2018,Viet Nam,VNM,United Kingdom of Great Britain and Northern Ireland,GBR,126,0,164,19,309
2018,Sudan,SDN,United Kingdom of Great Britain and Northern Ireland,GBR,295,0,82,38,415
2018,South Sudan,SSD,United Kingdom of Great Britain and Northern Ireland,GBR,0,0,5,0,5
2018,Eswatini,SWZ,United Kingdom of Great Britain and Northern Ireland,GBR,5,0,0,0,5
2018,Syrian Arab Rep.,SYR,United Kingdom of Great Britain and Northern Ireland,GBR,27,0,39,5,71
2018,United Rep. of Tanzania,TZA,United Kingdom of Great Britain and Northern Ireland,GBR,5,0,20,0,25
2018,Thailand,THA,United Kingdom of Great Britain and Northern Ireland,GBR,11,0,5,0,16
2018,Togo,TGO,United Kingdom of Great Britain and Northern Ireland,GBR,0,0,5,0,5
2018,Trinidad and Tobago,TTO,United Kingdom of Great Britain and Northern Ireland,GBR,0,0,13,0,13
2018,Tunisia,TUN,United Kingdom of Great Britain and Northern Ireland,GBR,5,0,13,0,18
2018,Turkey,TUR,United Kingdom of Great Britain and Northern Ireland,GBR,104,0,117,10,231
2018,Uganda,UGA,United Kingdom of Great Britain and Northern Ireland,GBR,22,0,27,10,59
2018,Ukraine,UKR,United Kingdom of Great Britain and Northern Ireland,GBR,26,0,36,0,62
2018,Uzbekistan,UZB,United Kingdom of Great Britain and Northern Ireland,GBR,5,0,5,0,10
2018,Saint Vincent and the Grenadines,VCT,United Kingdom of Great Britain and Northern Ireland,GBR,0,0,5,0,5
2018,Venezuela (Bolivarian Republic of),VEN,United Kingdom of Great Britain and Northern Ireland,GBR,12,0,0,0,12
2018,Yemen,YEM,United Kingdom of Great Britain and Northern Ireland,GBR,18,0,13,5,36
2018,Zambia,ZMB,United Kingdom of Great Britain and Northern Ireland,GBR,0,0,11,0,11
2018,Zimbabwe,ZWE,United Kingdom of Great Britain and Northern Ireland,GBR,50,0,88,10,148
2018,Stateless,XXA,United Kingdom of Great Britain and Northern Ireland,GBR,34,0,37,20,91
2018,Afghanistan,AFG,Kazakhstan,KAZ,0,0,64,15,79
2018,Syrian Arab Rep.,SYR,Kazakhstan,KAZ,0,0,17,0,17
2018,Turkey,TUR,Kazakhstan,KAZ,0,0,0,10,10
2019,Afghanistan,AFG,United Kingdom of Great Britain and Northern Ireland,GBR,299,0,248,48,595
2019,Albania,ALB,United Kingdom of Great Britain and Northern Ireland,GBR,295,0,278,35,608
2019,Algeria,DZA,United Kingdom of Great Britain and Northern Ireland,GBR,19,0,42,0,61
2019,Angola,AGO,United Kingdom of Great Britain and Northern Ireland,GBR,5,0,22,0,27
2019,Egypt,EGY,United Kingdom of Great Britain and Northern Ireland,GBR,53,0,94,10,157
2019,Armenia,ARM,United Kingdom of Great Britain and Northern Ireland,GBR,5,0,0,0,5
2019,Azerbaijan,AZE,United Kingdom of Great Britain and Northern Ireland,GBR,5,0,14,0,19
2019,Bahrain,BHR,United Kingdom of Great Britain and Northern Ireland,GBR,5,0,0,0,5
2019,Barbados,BRB,United Kingdom of Great Britain and Northern Ireland,GBR,0,0,5,0,5
2019,Burundi,BDI,United Kingdom of Great Britain and Northern Ireland,GBR,0,0,5,0,5
2019,Benin,BEN,United Kingdom of Great Britain and Northern Ireland,GBR,5,0,0,0,5
2019,Bangladesh,BGD,United Kingdom of Great Britain and Northern Ireland,GBR,166,0,458,12,636
2019,Burkina Faso,BFA,United Kingdom of Great Britain and Northern Ireland,GBR,0,0,5,0,5
2019,Bolivia (Plurinational State of),BOL,United Kingdom of Great Britain and Northern Ireland,GBR,0,0,5,0,5
2019,Botswana,BWA,United Kingdom of Great Britain and Northern Ireland,GBR,5,0,5,0,10
2019,Brazil,BRA,United Kingdom of Great Britain and Northern Ireland,GBR,5,0,5,0,10
2019,Chad,TCD,United Kingdom of Great Britain and Northern Ireland,GBR,0,0,5,0,5
2019,China,CHN,United Kingdom of Great Britain and Northern Ireland,GBR,52,0,151,26,229
2019,Cameroon,CMR,United Kingdom of Great Britain and Northern Ireland,GBR,51,0,35,5,91
2019,Congo,COG,United Kingdom of Great Britain and Northern Ireland,GBR,0,0,14,0,14
2019,Dem. Rep. of the Congo,COD,United Kingdom of Great Britain and Northern Ireland,GBR,33,0,46,5,84
2019,Colombia,COL,United Kingdom of Great Britain and Northern Ireland,GBR,0,0,5,0,5
2019,Eritrea,ERI,United Kingdom of Great Britain and Northern Ireland,GBR,49,0,30,10,89
2019,Ethiopia,ETH,United Kingdom of Great Britain and Northern Ireland,GBR,104,0,116,5,225
2019,Gambia,GMB,United Kingdom of Great Britain and Northern Ireland,GBR,12,0,17,0,29
2019,Palestinian,PSE,United Kingdom of Great Britain and Northern Ireland,GBR,19,0,27,0,46
2019,Georgia,GEO,United Kingdom of Great Britain and Northern Ireland,GBR,5,0,5,5,15
2019,Ghana,GHA,United Kingdom of Great Britain and Northern Ireland,GBR,14,0,50,5,69
2019,Grenada,GRD,United Kingdom of Great Britain and Northern Ireland,GBR,0,0,5,0,5
2019,Guinea,GIN,United Kingdom of Great Britain and Northern Ireland,GBR,0,0,14,0,14
2019,Honduras,HND,United Kingdom of Great Britain and Northern Ireland,GBR,0,0,12,0,12
2019,Cote d'Ivoire,CIV,United Kingdom of Great Britain and Northern Ireland,GBR,16,0,5,0,21
2019,India,IND,United Kingdom of Great Britain and Northern Ireland,GBR,35,0,129,14,178
2019,Iran (Islamic Rep. of),IRN,United Kingdom of Great Britain and Northern Ireland,GBR,618,0,428,86,1132
2019,Iraq,IRQ,United Kingdom of Great Britain and Northern Ireland,GBR,620,0,960,74,1654
2019,Jamaica,JAM,United Kingdom of Great Britain and Northern Ireland,GBR,17,0,24,5,46
2019,Jordan,JOR,United Kingdom of Great Britain and Northern Ireland,GBR,0,0,16,0,16
2019,Kazakhstan,KAZ,United Kingdom of Great Britain and Northern Ireland,GBR,5,0,0,0,5
2019,Kenya,KEN,United Kingdom of Great Britain and Northern Ireland,GBR,14,0,35,5,54
2019,Kyrgyzstan,KGZ,United Kingdom of Great Britain and Northern Ireland,GBR,0,0,5,0,5
2019,Kuwait,KWT,United Kingdom of Great Britain and Northern Ireland,GBR,5,0,14,0,19
2019,Libya,LBY,United Kingdom of Great Britain and Northern Ireland,GBR,13,0,13,5,31
2019,Saint Lucia,LCA,United Kingdom of Great Britain and Northern Ireland,GBR,0,0,5,0,5
2019,Lebanon,LBN,United Kingdom of Great Britain and Northern Ireland,GBR,5,0,15,0,20
2019,Sri Lanka,LKA,United Kingdom of Great Britain and Northern Ireland,GBR,218,0,150,32,400
2019,Mexico,MEX,United Kingdom of Great Britain and Northern Ireland,GBR,0,0,5,0,5
2019,Malaysia,MYS,United Kingdom of Great Britain and Northern Ireland,GBR,12,0,29,0,41
2019,Malawi,MWI,United Kingdom of Great Britain and Northern Ireland,GBR,10,0,13,5,28
2019,Mongolia,MNG,United Kingdom of Great Britain and Northern Ireland,GBR,0,0,5,0,5
2019,Morocco,MAR,United Kingdom of Great Britain and Northern Ireland,GBR,10,0,22,5,37
2019,Mozambique,MOZ,United Kingdom of Great Britain and Northern Ireland,GBR,0,0,5,0,5
2019,Mauritius,MUS,United Kingdom of Great Britain and Northern Ireland,GBR,0,0,11,0,11
2019,Myanmar,MMR,United Kingdom of Great Britain and Northern Ireland,GBR,10,0,5,5,20
2019,Namibia,NAM,United Kingdom of Great Britain and Northern Ireland,GBR,35,0,64,5,104
2019,Nepal,NPL,United Kingdom of Great Britain and Northern Ireland,GBR,10,0,24,5,39
2019,Nicaragua,NIC,United Kingdom of Great Britain and Northern Ireland,GBR,5,0,0,0,5
2019,Nigeria,NGA,United Kingdom of Great Britain and Northern Ireland,GBR,124,0,252,27,403
2019,Pakistan,PAK,United Kingdom of Great Britain and Northern Ireland,GBR,207,0,460,44,711
2019,Philippines,PHL,United Kingdom of Great Britain and Northern Ireland,GBR,5,0,20,0,25
2019,South Africa,ZAF,United Kingdom of Great Britain and Northern Ireland,GBR,5,0,16,0,21
2019,Russian Federation,RUS,United Kingdom of Great Britain and Northern Ireland,GBR,21,0,12,5,38
2019,Rwanda,RWA,United Kingdom of Great Britain and Northern Ireland,GBR,12,0,0,0,12
2019,El Salvador,SLV,United Kingdom of Great Britain and Northern Ireland,GBR,50,0,27,10,87
2019,Saudi Arabia,SAU,United Kingdom of Great Britain and Northern Ireland,GBR,0,0,5,5,10
2019,Serbia and Kosovo: S/RES/1244 (1999),SRB,United Kingdom of Great Britain and Northern Ireland,GBR,5,0,0,0,5
2019,Senegal,SEN,United Kingdom of Great Britain and Northern Ireland,GBR,5,0,5,0,10
2019,Sierra Leone,SLE,United Kingdom of Great Britain and Northern Ireland,GBR,10,0,15,0,25
2019,Somalia,SOM,United Kingdom of Great Britain and Northern Ireland,GBR,33,0,37,5,75
2019,Viet Nam,VNM,United Kingdom of Great Britain and Northern Ireland,GBR,195,0,126,30,351
2019,Saint Kitts and Nevis,KNA,United Kingdom of Great Britain and Northern Ireland,GBR,0,0,5,0,5
2019,Sudan,SDN,United Kingdom of Great Britain and Northern Ireland,GBR,114,0,41,62,217
2019,South Sudan,SSD,United Kingdom of Great Britain and Northern Ireland,GBR,5,0,0,0,5
2019,Syrian Arab Rep.,SYR,United Kingdom of Great Britain and Northern Ireland,GBR,25,0,22,0,47
2019,United Rep. of Tanzania,TZA,United Kingdom of Great Britain and Northern Ireland,GBR,5,0,14,5,24
2019,Thailand,THA,United Kingdom of Great Britain and Northern Ireland,GBR,5,0,0,0,5
2019,Togo,TGO,United Kingdom of Great Britain and Northern Ireland,GBR,0,0,5,0,5
2019,Trinidad and Tobago,TTO,United Kingdom of Great Britain and Northern Ireland,GBR,0,0,11,0,11
2019,Tunisia,TUN,United Kingdom of Great Britain and Northern Ireland,GBR,5,0,13,0,18
2019,Turkey,TUR,United Kingdom of Great Britain and Northern Ireland,GBR,101,0,84,5,190
2019,Uganda,UGA,United Kingdom of Great Britain and Northern Ireland,GBR,17,0,16,0,33
2019,Ukraine,UKR,United Kingdom of Great Britain and Northern Ireland,GBR,29,0,33,5,67
2019,Uzbekistan,UZB,United Kingdom of Great Britain and Northern Ireland,GBR,5,0,0,0,5
2019,Saint Vincent and the Grenadines,VCT,United Kingdom of Great Britain and Northern Ireland,GBR,5,0,0,0,5
2019,Venezuela (Bolivarian Republic of),VEN,United Kingdom of Great Britain and Northern Ireland,GBR,12,0,0,0,12
2019,Yemen,YEM,United Kingdom of Great Britain and Northern Ireland,GBR,10,0,5,5,20
2019,Zambia,ZMB,United Kingdom of Great Britain and Northern Ireland,GBR,5,0,0,0,5
2019,Zimbabwe,ZWE,United Kingdom of Great Britain and Northern Ireland,GBR,28,0,40,0,68
2019,Stateless,XXA,United Kingdom of Great Britain and Northern Ireland,GBR,19,0,20,12,51
2020,Afghanistan,AFG,United Kingdom of Great Britain and Northern Ireland,GBR,99,0,101,42,242
2020,Albania,ALB,United Kingdom of Great Britain and Northern Ireland,GBR,128,0,87,40,255
2020,Algeria,DZA,United Kingdom of Great Britain and Northern Ireland,GBR,5,0,12,0,17
2020,Angola,AGO,United Kingdom of Great Britain and Northern Ireland,GBR,0,0,5,0,5
2020,Egypt,EGY,United Kingdom of Great Britain and Northern Ireland,GBR,19,0,29,5,53
2020,Armenia,ARM,United Kingdom of Great Britain and Northern Ireland,GBR,0,0,5,0,5
2020,Azerbaijan,AZE,United Kingdom of Great Britain and Northern Ireland,GBR,0,0,5,0,5
2020,Bangladesh,BGD,United Kingdom of Great Britain and Northern Ireland,GBR,53,0,129,15,197
2020,Bolivia (Plurinational State of),BOL,United Kingdom of Great Britain and Northern Ireland,GBR,5,0,0,5,10
2020,Botswana,BWA,United Kingdom of Great Britain and Northern Ireland,GBR,0,0,5,0,5
2020,Brazil,BRA,United Kingdom of Great Britain and Northern Ireland,GBR,5,0,5,0,10
2020,Chad,TCD,United Kingdom of Great Britain and Northern Ireland,GBR,5,0,5,0,10
2020,China,CHN,United Kingdom of Great Britain and Northern Ireland,GBR,15,0,46,5,66
2020,Cameroon,CMR,United Kingdom of Great Britain and Northern Ireland,GBR,15,0,12,0,27
2020,Congo,COG,United Kingdom of Great Britain and Northern Ireland,GBR,0,0,5,0,5
2020,Dem. Rep. of the Congo,COD,United Kingdom of Great Britain and Northern Ireland,GBR,10,0,14,5,29
2020,Dominica,DMA,United Kingdom of Great Britain and Northern Ireland,GBR,5,0,0,0,5
2020,Eritrea,ERI,United Kingdom of Great Britain and Northern Ireland,GBR,35,0,14,10,59
2020,Ethiopia,ETH,United Kingdom of Great Britain and Northern Ireland,GBR,76,0,63,14,153
2020,Gambia,GMB,United Kingdom of Great Britain and Northern Ireland,GBR,0,0,13,0,13
2020,Palestinian,PSE,United Kingdom of Great Britain and Northern Ireland,GBR,12,0,5,5,22
2020,Georgia,GEO,United Kingdom of Great Britain and Northern Ireland,GBR,5,0,5,0,10
2020,Ghana,GHA,United Kingdom of Great Britain and Northern Ireland,GBR,5,0,24,5,34
2020,Guinea,GIN,United Kingdom of Great Britain and Northern Ireland,GBR,0,0,5,0,5
2020,Honduras,HND,United Kingdom of Great Britain and Northern Ireland,GBR,11,0,0,0,11
2020,Cote d'Ivoire,CIV,United Kingdom of Great Britain and Northern Ireland,GBR,0,0,11,0,11
2020,India,IND,United Kingdom of Great Britain and Northern Ireland,GBR,14,0,70,12,96
2020,Iran (Islamic Rep. of),IRN,United Kingdom of Great Britain and Northern Ireland,GBR,171,0,138,50,359
2020,Iraq,IRQ,United Kingdom of Great Britain and Northern Ireland,GBR,279,0,479,31,789
2020,Jamaica,JAM,United Kingdom of Great Britain and Northern Ireland,GBR,5,0,10,0,15
2020,Jordan,JOR,United Kingdom of Great Britain and Northern Ireland,GBR,5,0,5,0,10
2020,Kenya,KEN,United Kingdom of Great Britain and Northern Ireland,GBR,13,0,5,0,18
2020,Kuwait,KWT,United Kingdom of Great Britain and Northern Ireland,GBR,5,0,0,5,10
2020,Libya,LBY,United Kingdom of Great Britain and Northern Ireland,GBR,5,0,5,0,10
2020,Saint Lucia,LCA,United Kingdom of Great Britain and Northern Ireland,GBR,0,0,5,0,5
2020,Lebanon,LBN,United Kingdom of Great Britain and Northern Ireland,GBR,5,0,5,0,10
2020,Sri Lanka,LKA,United Kingdom of Great Britain and Northern Ireland,GBR,48,0,33,12,93
2020,Mexico,MEX,United Kingdom of Great Britain and Northern Ireland,GBR,0,0,5,0,5
2020,Mali,MLI,United Kingdom of Great Britain and Northern Ireland,GBR,0,0,5,0,5
2020,Malaysia,MYS,United Kingdom of Great Britain and Northern Ireland,GBR,13,0,0,0,13
2020,Malawi,MWI,United Kingdom of Great Britain and Northern Ireland,GBR,5,0,0,0,5
2020,Morocco,MAR,United Kingdom of Great Britain and Northern Ireland,GBR,0,0,5,0,5
2020,Mauritius,MUS,United Kingdom of Great Britain and Northern Ireland,GBR,5,0,0,0,5
2020,Namibia,NAM,United Kingdom of Great Britain and Northern Ireland,GBR,10,0,47,0,57
2020,Nepal,NPL,United Kingdom of Great Britain and Northern Ireland,GBR,0,0,15,0,15
2020,Nicaragua,NIC,United Kingdom of Great Britain and Northern Ireland,GBR,5,0,5,0,10
2020,Nigeria,NGA,United Kingdom of Great Britain and Northern Ireland,GBR,54,0,94,22,170
2020,Oman,OMN,United Kingdom of Great Britain and Northern Ireland,GBR,0,0,0,5,5
2020,Pakistan,PAK,United Kingdom of Great Britain and Northern Ireland,GBR,73,0,133,17,223
2020,Philippines,PHL,United Kingdom of Great Britain and Northern Ireland,GBR,0,0,12,0,12
2020,South Africa,ZAF,United Kingdom of Great Britain and Northern Ireland,GBR,0,0,13,0,13
2020,Russian Federation,RUS,United Kingdom of Great Britain and Northern Ireland,GBR,13,0,5,10,28
2020,Rwanda,RWA,United Kingdom of Great Britain and Northern Ireland,GBR,0,0,5,0,5
2020,El Salvador,SLV,United Kingdom of Great Britain and Northern Ireland,GBR,31,0,19,10,60
2020,Saudi Arabia,SAU,United Kingdom of Great Britain and Northern Ireland,GBR,5,0,0,0,5
2020,Serbia and Kosovo: S/RES/1244 (1999),SRB,United Kingdom of Great Britain and Northern Ireland,GBR,5,0,0,0,5
2020,Senegal,SEN,United Kingdom of Great Britain and Northern Ireland,GBR,0,0,5,0,5
2020,Sierra Leone,SLE,United Kingdom of Great Britain and Northern Ireland,GBR,12,0,0,0,12
2020,Somalia,SOM,United Kingdom of Great Britain and Northern Ireland,GBR,10,0,10,5,25
2020,Viet Nam,VNM,United Kingdom of Great Britain and Northern Ireland,GBR,51,0,40,16,107
2020,Sudan,SDN,United Kingdom of Great Britain and Northern Ireland,GBR,12,0,5,11,28
2020,South Sudan,SSD,United Kingdom of Great Britain and Northern Ireland,GBR,5,0,0,0,5
2020,Syrian Arab Rep.,SYR,United Kingdom of Great Britain and Northern Ireland,GBR,14,0,0,0,14
2020,United Rep. of Tanzania,TZA,United Kingdom of Great Britain and Northern Ireland,GBR,5,0,5,0,10
2020,Thailand,THA,United Kingdom of Great Britain and Northern Ireland,GBR,0,0,0,5,5
2020,Togo,TGO,United Kingdom of Great Britain and Northern Ireland,GBR,0,0,5,0,5
2020,Trinidad and Tobago,TTO,United Kingdom of Great Britain and Northern Ireland,GBR,0,0,5,0,5
2020,Tunisia,TUN,United Kingdom of Great Britain and Northern Ireland,GBR,0,0,5,0,5
2020,Turkey,TUR,United Kingdom of Great Britain and Northern Ireland,GBR,43,0,22,5,70
2020,Uganda,UGA,United Kingdom of Great Britain and Northern Ireland,GBR,5,0,0,0,5
2020,Ukraine,UKR,United Kingdom of Great Britain and Northern Ireland,GBR,10,0,17,0,27
2020,Uzbekistan,UZB,United Kingdom of Great Britain and Northern Ireland,GBR,5,0,0,0,5
2020,Venezuela (Bolivarian Republic of),VEN,United Kingdom of Great Britain and Northern Ireland,GBR,5,0,0,0,5
2020,Yemen,YEM,United Kingdom of Great Britain and Northern Ireland,GBR,13,0,0,0,13
2020,Zimbabwe,ZWE,United Kingdom of Great Britain and Northern Ireland,GBR,13,0,19,5,37
2020,Stateless,XXA,United Kingdom of Great Britain and Northern Ireland,GBR,13,0,5,11,29
2021,Afghanistan,AFG,United Kingdom of Great Britain and Northern Ireland,GBR,111,0,61,223,395
2021,Albania,ALB,United Kingdom of Great Britain and Northern Ireland,GBR,119,0,87,20,226
2021,Algeria,DZA,United Kingdom of Great Britain and Northern Ireland,GBR,10,0,16,0,26
2021,Angola,AGO,United Kingdom of Great Britain and Northern Ireland,GBR,11,0,5,0,16
2021,Egypt,EGY,United Kingdom of Great Britain and Northern Ireland,GBR,12,0,26,5,43
2021,Azerbaijan,AZE,United Kingdom of Great Britain and Northern Ireland,GBR,5,0,0,0,5
2021,Burundi,BDI,United Kingdom of Great Britain and Northern Ireland,GBR,5,0,0,0,5
2021,Bangladesh,BGD,United Kingdom of Great Britain and Northern Ireland,GBR,49,0,118,18,185
2021,Belarus,BLR,United Kingdom of Great Britain and Northern Ireland,GBR,5,0,0,0,5
2021,Brazil,BRA,United Kingdom of Great Britain and Northern Ireland,GBR,5,0,5,0,10
2021,Chad,TCD,United Kingdom of Great Britain and Northern Ireland,GBR,5,0,0,0,5
2021,China,CHN,United Kingdom of Great Britain and Northern Ireland,GBR,14,0,45,12,71
2021,Cameroon,CMR,United Kingdom of Great Britain and Northern Ireland,GBR,10,0,12,0,22
2021,Congo,COG,United Kingdom of Great Britain and Northern Ireland,GBR,0,0,0,5,5
2021,Dem. Rep. of the Congo,COD,United Kingdom of Great Britain and Northern Ireland,GBR,10,0,10,0,20
2021,Cuba,CUB,United Kingdom of Great Britain and Northern Ireland,GBR,0,0,5,0,5
2021,Eritrea,ERI,United Kingdom of Great Britain and Northern Ireland,GBR,28,0,12,0,40
2021,Ethiopia,ETH,United Kingdom of Great Britain and Northern Ireland,GBR,76,0,42,20,138
2021,Gambia,GMB,United Kingdom of Great Britain and Northern Ireland,GBR,11,0,0,0,11
2021,Georgia,GEO,United Kingdom of Great Britain and Northern Ireland,GBR,0,0,13,0,13
2021,Ghana,GHA,United Kingdom of Great Britain and Northern Ireland,GBR,11,0,22,5,38
2021,Guinea,GIN,United Kingdom of Great Britain and Northern Ireland,GBR,5,0,5,0,10
2021,Honduras,HND,United Kingdom of Great Britain and Northern Ireland,GBR,5,0,14,5,24
2021,Cote d'Ivoire,CIV,United Kingdom of Great Britain and Northern Ireland,GBR,5,0,5,0,10
2021,India,IND,United Kingdom of Great Britain and Northern Ireland,GBR,34,0,75,5,114
2021,Iran (Islamic Rep. of),IRN,United Kingdom of Great Britain and Northern Ireland,GBR,184,0,86,52,322
2021,Iraq,IRQ,United Kingdom of Great Britain and Northern Ireland,GBR,319,0,358,36,713
2021,Israel,ISR,United Kingdom of Great Britain and Northern Ireland,GBR,15,0,14,0,29
2021,Jamaica,JAM,United Kingdom of Great Britain and Northern Ireland,GBR,0,0,13,0,13
2021,Jordan,JOR,United Kingdom of Great Britain and Northern Ireland,GBR,0,0,5,0,5
2021,Kazakhstan,KAZ,United Kingdom of Great Britain and Northern Ireland,GBR,10,0,0,0,10
2021,Kenya,KEN,United Kingdom of Great Britain and Northern Ireland,GBR,10,0,14,5,29
2021,Kyrgyzstan,KGZ,United Kingdom of Great Britain and Northern Ireland,GBR,5,0,0,0,5
2021,Kuwait,KWT,United Kingdom of Great Britain and Northern Ireland,GBR,11,0,0,0,11
2021,Libya,LBY,United Kingdom of Great Britain and Northern Ireland,GBR,5,0,5,0,10
2021,Lebanon,LBN,United Kingdom of Great Britain and Northern Ireland,GBR,5,0,5,0,10
2021,Sri Lanka,LKA,United Kingdom of Great Britain and Northern Ireland,GBR,70,0,36,15,121
2021,Mali,MLI,United Kingdom of Great Britain and Northern Ireland,GBR,5,0,0,0,5
2021,Malaysia,MYS,United Kingdom of Great Britain and Northern Ireland,GBR,0,0,11,0,11
2021,Malawi,MWI,United Kingdom of Great Britain and Northern Ireland,GBR,5,0,0,0,5
2021,Mongolia,MNG,United Kingdom of Great Britain and Northern Ireland,GBR,0,0,5,0,5
2021,Morocco,MAR,United Kingdom of Great Britain and Northern Ireland,GBR,5,0,13,0,18
2021,Mauritius,MUS,United Kingdom of Great Britain and Northern Ireland,GBR,0,0,5,0,5
2021,Myanmar,MMR,United Kingdom of Great Britain and Northern Ireland,GBR,0,0,5,0,5
2021,Namibia,NAM,United Kingdom of Great Britain and Northern Ireland,GBR,28,0,53,5,86
2021,Nepal,NPL,United Kingdom of Great Britain and Northern Ireland,GBR,5,0,11,0,16
2021,Nicaragua,NIC,United Kingdom of Great Britain and Northern Ireland,GBR,0,0,5,0,5
2021,Nigeria,NGA,United Kingdom of Great Britain and Northern Ireland,GBR,60,0,83,13,156
2021,Pakistan,PAK,United Kingdom of Great Britain and Northern Ireland,GBR,58,0,153,24,235
2021,Philippines,PHL,United Kingdom of Great Britain and Northern Ireland,GBR,5,0,10,0,15
2021,South Africa,ZAF,United Kingdom of Great Britain and Northern Ireland,GBR,12,0,0,0,12
2021,Russian Federation,RUS,United Kingdom of Great Britain and Northern Ireland,GBR,19,0,0,5,24
2021,Rwanda,RWA,United Kingdom of Great Britain and Northern Ireland,GBR,5,0,0,0,5
2021,El Salvador,SLV,United Kingdom of Great Britain and Northern Ireland,GBR,58,0,27,5,90
2021,Saudi Arabia,SAU,United Kingdom of Great Britain and Northern Ireland,GBR,5,0,0,0,5
2021,Serbia and Kosovo: S/RES/1244 (1999),SRB,United Kingdom of Great Britain and Northern Ireland,GBR,0,0,5,0,5
2021,Senegal,SEN,United Kingdom of Great Britain and Northern Ireland,GBR,0,0,5,0,5
2021,Sierra Leone,SLE,United Kingdom of Great Britain and Northern Ireland,GBR,12,0,5,0,17
2021,Somalia,SOM,United Kingdom of Great Britain and Northern Ireland,GBR,21,0,12,0,33
2021,Viet Nam,VNM,United Kingdom of Great Britain and Northern Ireland,GBR,47,0,35,13,95
2021,Sudan,SDN,United Kingdom of Great Britain and Northern Ireland,GBR,13,0,12,0,25
2021,South Sudan,SSD,United Kingdom of Great Britain and Northern Ireland,GBR,0,0,5,0,5
2021,Syrian Arab Rep.,SYR,United Kingdom of Great Britain and Northern Ireland,GBR,15,0,5,0,20
2021,United Rep. of Tanzania,TZA,United Kingdom of Great Britain and Northern Ireland,GBR,11,0,0,0,11
2021,Thailand,THA,United Kingdom of Great Britain and Northern Ireland,GBR,0,0,5,0,5
2021,Togo,TGO,United Kingdom of Great Britain and Northern Ireland,GBR,0,0,5,0,5
2021,Trinidad and Tobago,TTO,United Kingdom of Great Britain and Northern Ireland,GBR,5,0,5,0,10
2021,Tunisia,TUN,United Kingdom of Great Britain and Northern Ireland,GBR,0,0,5,0,5
2021,Turkey,TUR,United Kingdom of Great Britain and Northern Ireland,GBR,33,0,21,5,59
2021,Uganda,UGA,United Kingdom of Great Britain and Northern Ireland,GBR,11,0,10,0,21
2021,Ukraine,UKR,United Kingdom of Great Britain and Northern Ireland,GBR,13,0,13,5,31
2021,Venezuela (Bolivarian Republic of),VEN,United Kingdom of Great Britain and Northern Ireland,GBR,5,0,0,0,5
2021,Yemen,YEM,United Kingdom of Great Britain and Northern Ireland,GBR,14,0,0,0,14
2021,Zimbabwe,ZWE,United Kingdom of Great Britain and Northern Ireland,GBR,19,0,20,5,44
2021,Stateless,XXA,United Kingdom of Great Britain and Northern Ireland,GBR,13,0,0,0,13
2001,Afghanistan,AFG,Belgium,BEL,5,0,12,0,17
2001,Albania,ALB,Belgium,BEL,5,0,15,0,20
2001,Algeria,DZA,Belgium,BEL,0,0,10,5,15
2001,Angola,AGO,Belgium,BEL,5,0,19,0,24
2001,Armenia,ARM,Belgium,BEL,0,0,41,5,46
2001,Azerbaijan,AZE,Belgium,BEL,0,0,12,0,12
2001,Burundi,BDI,Belgium,BEL,23,0,112,5,140
2001,Bangladesh,BGD,Belgium,BEL,0,0,5,0,5
2001,Bhutan,BTN,Belgium,BEL,0,0,54,0,54
2001,Belarus,BLR,Belgium,BEL,0,0,24,5,29
2001,Bosnia and Herzegovina,BIH,Belgium,BEL,0,0,5,0,5
2001,Bulgaria,BGR,Belgium,BEL,0,0,14,0,14
2001,China,CHN,Belgium,BEL,0,0,0,5,5
2001,Cameroon,CMR,Belgium,BEL,5,0,89,12,106
2001,Congo,COG,Belgium,BEL,0,0,15,5,20
2001,Dem. Rep. of the Congo,COD,Belgium,BEL,72,0,202,32,306
2001,Colombia,COL,Belgium,BEL,0,0,5,0,5
2001,Cuba,CUB,Belgium,BEL,0,0,5,0,5
2001,Djibouti,DJI,Belgium,BEL,5,0,5,0,10
2001,Ethiopia,ETH,Belgium,BEL,5,0,5,0,10
2001,Palestinian,PSE,Belgium,BEL,0,0,0,5,5
2001,Georgia,GEO,Belgium,BEL,0,0,23,0,23
2001,Guinea,GIN,Belgium,BEL,0,0,75,0,75
2001,Cote d'Ivoire,CIV,Belgium,BEL,0,0,5,0,5
2001,India,IND,Belgium,BEL,5,0,5,0,10
2001,Iran (Islamic Rep. of),IRN,Belgium,BEL,5,0,36,5,46
2001,Iraq,IRQ,Belgium,BEL,5,0,18,0,23
2001,Israel,ISR,Belgium,BEL,0,0,5,0,5
2001,Kazakhstan,KAZ,Belgium,BEL,0,0,52,5,57
2001,Kyrgyzstan,KGZ,Belgium,BEL,0,0,5,0,5
2001,Lebanon,LBN,Belgium,BEL,0,0,0,5,5
2001,Mauritania,MRT,Belgium,BEL,0,0,45,0,45
2001,Rep. of Moldova,MDA,Belgium,BEL,0,0,0,5,5
2001,Niger,NER,Belgium,BEL,0,0,10,0,10
2001,Nigeria,NGA,Belgium,BEL,0,0,5,0,5
2001,Pakistan,PAK,Belgium,BEL,0,0,13,0,13
2001,Romania,ROU,Belgium,BEL,0,0,12,0,12
2001,Russian Federation,RUS,Belgium,BEL,0,0,21,0,21
2001,Rwanda,RWA,Belgium,BEL,96,0,129,12,237
2001,Serbia and Kosovo: S/RES/1244 (1999),SRB,Belgium,BEL,10,0,320,62,392
2001,Senegal,SEN,Belgium,BEL,0,0,5,0,5
2001,Sierra Leone,SLE,Belgium,BEL,0,0,37,5,42
2001,Somalia,SOM,Belgium,BEL,5,0,42,10,57
2001,Sudan,SDN,Belgium,BEL,5,0,0,0,5
2001,Slovakia,SVK,Belgium,BEL,0,0,21,0,21
2001,Syrian Arab Rep.,SYR,Belgium,BEL,0,0,12,5,17
2001,Togo,TGO,Belgium,BEL,0,0,5,0,5
2001,Turkey,TUR,Belgium,BEL,5,0,36,0,41
2001,Ukraine,UKR,Belgium,BEL,5,0,5,0,10
2001,Uzbekistan,UZB,Belgium,BEL,0,0,5,0,5
2001,Afghanistan,AFG,Denmark,DNK,5,18,24,0,47
2001,Albania,ALB,Denmark,DNK,0,5,18,0,23
2001,Algeria,DZA,Denmark,DNK,0,0,5,0,5
2001,Egypt,EGY,Denmark,DNK,0,0,5,0,5
2001,Armenia,ARM,Denmark,DNK,5,5,179,0,189
2001,Azerbaijan,AZE,Denmark,DNK,14,5,34,0,53
2001,Bangladesh,BGD,Denmark,DNK,0,0,5,0,5
2001,Belarus,BLR,Denmark,DNK,5,0,19,0,24
2001,Bosnia and Herzegovina,BIH,Denmark,DNK,0,56,312,0,368
2001,China,CHN,Denmark,DNK,5,0,21,0,26
2001,Cameroon,CMR,Denmark,DNK,0,0,10,0,10
2001,Dem. Rep. of the Congo,COD,Denmark,DNK,0,0,5,0,5
2001,Colombia,COL,Denmark,DNK,5,0,0,0,5
2001,Cuba,CUB,Denmark,DNK,0,0,5,0,5
2001,Czechia,CZE,Denmark,DNK,0,0,12,0,12
2001,Ecuador,ECU,Denmark,DNK,0,0,5,0,5
2001,Ethiopia,ETH,Denmark,DNK,0,0,5,0,5
2001,Gambia,GMB,Denmark,DNK,0,0,13,0,13
2001,Palestinian,PSE,Denmark,DNK,14,5,80,0,99
2001,Georgia,GEO,Denmark,DNK,0,5,63,0,68
2001,Croatia,HRV,Denmark,DNK,0,0,5,0,5
2001,India,IND,Denmark,DNK,0,0,21,0,21
2001,Iran (Islamic Rep. of),IRN,Denmark,DNK,16,39,126,0,181
2001,Iraq,IRQ,Denmark,DNK,5,30,121,0,156
2001,Jordan,JOR,Denmark,DNK,0,0,5,0,5
2001,Kazakhstan,KAZ,Denmark,DNK,0,0,16,0,16
2001,Kyrgyzstan,KGZ,Denmark,DNK,0,0,18,0,18
2001,Lebanon,LBN,Denmark,DNK,0,5,20,0,25
2001,Sri Lanka,LKA,Denmark,DNK,0,5,22,0,27
2001,North Macedonia,MKD,Denmark,DNK,0,0,11,0,11
2001,Rep. of Moldova,MDA,Denmark,DNK,5,0,33,0,38
2001,Mongolia,MNG,Denmark,DNK,0,0,27,0,27
2001,Morocco,MAR,Denmark,DNK,0,0,5,0,5
2001,Nepal,NPL,Denmark,DNK,0,0,5,0,5
2001,Pakistan,PAK,Denmark,DNK,0,0,43,0,43
2001,Peru,PER,Denmark,DNK,0,0,5,0,5
2001,Romania,ROU,Denmark,DNK,0,0,5,0,5
2001,Russian Federation,RUS,Denmark,DNK,22,30,69,0,121
2001,Serbia and Kosovo: S/RES/1244 (1999),SRB,Denmark,DNK,39,149,570,0,758
2001,Sierra Leone,SLE,Denmark,DNK,0,5,5,0,10
2001,Somalia,SOM,Denmark,DNK,0,0,11,0,11
2001,Viet Nam,VNM,Denmark,DNK,0,0,5,0,5
2001,Slovakia,SVK,Denmark,DNK,0,0,24,0,24
2001,Syrian Arab Rep.,SYR,Denmark,DNK,10,0,16,0,26
2001,Tajikistan,TJK,Denmark,DNK,0,0,5,0,5
2001,Turkmenistan,TKM,Denmark,DNK,0,0,5,0,5
2001,Turkey,TUR,Denmark,DNK,5,0,15,0,20
2001,Ukraine,UKR,Denmark,DNK,5,0,32,0,37
2001,Albania,ALB,France,FRA,40,0,100,0,140
2001,Algeria,DZA,France,FRA,118,0,1168,0,1286
2001,Angola,AGO,France,FRA,48,0,174,0,222
2001,Armenia,ARM,France,FRA,67,0,156,0,223
2001,Bangladesh,BGD,France,FRA,130,0,608,0,738
2001,China,CHN,France,FRA,11,0,3906,0,3917
2001,Congo,COG,France,FRA,103,0,275,0,378
2001,Dem. Rep. of the Congo,COD,France,FRA,147,0,1003,0,1150
2001,Georgia,GEO,France,FRA,60,0,117,0,177
2001,Guinea,GIN,France,FRA,18,0,181,0,199
2001,Haiti,HTI,France,FRA,116,0,1780,0,1896
2001,India,IND,France,FRA,29,0,390,0,419
2001,Iraq,IRQ,France,FRA,65,0,66,0,131
2001,Sri Lanka,LKA,France,FRA,305,0,737,0,1042
2001,Mauritania,MRT,France,FRA,115,0,457,0,572
2001,Rep. of Moldova,MDA,France,FRA,23,0,615,0,638
2001,Mali,MLI,France,FRA,11,0,2557,0,2568
2001,Nigeria,NGA,France,FRA,10,0,96,0,106
2001,Pakistan,PAK,France,FRA,20,0,525,0,545
2001,Russian Federation,RUS,France,FRA,108,0,285,0,393
2001,Serbia and Kosovo: S/RES/1244 (1999),SRB,France,FRA,153,0,797,0,950
2001,Senegal,SEN,France,FRA,15,0,251,0,266
2001,Turkey,TUR,France,FRA,288,0,1871,0,2159
2001,Ukraine,UKR,France,FRA,56,0,446,0,502
2001,Serbia and Kosovo: S/RES/1244 (1999),SRB,Iceland,ISL,0,0,0,5,5
2001,Albania,ALB,Ireland,IRL,5,0,0,0,0
2001,Algeria,DZA,Ireland,IRL,31,0,0,0,0
2001,Angola,AGO,Ireland,IRL,42,0,0,0,0
2001,Armenia,ARM,Ireland,IRL,5,0,0,0,0
2001,Belarus,BLR,Ireland,IRL,5,0,0,0,0
2001,Bulgaria,BGR,Ireland,IRL,13,0,0,0,0
2001,Central African Rep.,CAF,Ireland,IRL,5,0,0,0,0
2001,Cameroon,CMR,Ireland,IRL,5,0,0,0,0
2001,Congo,COG,Ireland,IRL,5,0,0,0,0
2001,Dem. Rep. of the Congo,COD,Ireland,IRL,46,0,0,0,0
2001,Czechia,CZE,Ireland,IRL,15,0,0,0,0
2001,Croatia,HRV,Ireland,IRL,5,0,0,0,0
2001,Iraq,IRQ,Ireland,IRL,22,0,0,0,0
2001,Libya,LBY,Ireland,IRL,32,0,0,0,0
2001,Rep. of Moldova,MDA,Ireland,IRL,14,0,0,0,0
2001,Nigeria,NGA,Ireland,IRL,44,0,0,0,0
2001,Pakistan,PAK,Ireland,IRL,5,0,0,0,0
2001,Poland,POL,Ireland,IRL,5,0,0,0,0
2001,Romania,ROU,Ireland,IRL,45,0,0,0,0
2001,Russian Federation,RUS,Ireland,IRL,17,0,0,0,0
2001,Rwanda,RWA,Ireland,IRL,5,0,0,0,0
2001,Serbia and Kosovo: S/RES/1244 (1999),SRB,Ireland,IRL,36,0,0,0,0
2001,Sierra Leone,SLE,Ireland,IRL,10,0,0,0,0
2001,Somalia,SOM,Ireland,IRL,20,0,0,0,0
2001,Sudan,SDN,Ireland,IRL,5,0,0,0,0
2001,Tajikistan,TJK,Ireland,IRL,5,0,0,0,0
2001,Togo,TGO,Ireland,IRL,5,0,0,0,0
2001,Ukraine,UKR,Ireland,IRL,12,0,0,0,0
2001,Afghanistan,AFG,Japan,JPN,0,0,11,5,16
2001,China,CHN,Japan,JPN,0,0,5,0,5
2001,Ethiopia,ETH,Japan,JPN,0,0,5,0,5
2001,Iran (Islamic Rep. of),IRN,Japan,JPN,0,0,5,0,5
2001,Sri Lanka,LKA,Japan,JPN,0,0,5,0,5
2001,Myanmar,MMR,Japan,JPN,0,0,11,0,11
2001,Pakistan,PAK,Japan,JPN,0,0,18,0,18
2001,Sudan,SDN,Japan,JPN,0,0,5,0,5
2001,Turkey,TUR,Japan,JPN,0,0,21,10,31
2001,Afghanistan,AFG,Netherlands,NLD,95,215,27,5295,5632
2001,Albania,ALB,Netherlands,NLD,5,10,0,64,79
2001,Algeria,DZA,Netherlands,NLD,0,14,0,235,249
2001,Angola,AGO,Netherlands,NLD,10,71,5,619,705
2001,Egypt,EGY,Netherlands,NLD,0,0,0,10,10
2001,Armenia,ARM,Netherlands,NLD,14,42,13,497,566
2001,Azerbaijan,AZE,Netherlands,NLD,11,37,10,807,865
2001,Bahrain,BHR,Netherlands,NLD,0,0,0,5,5
2001,Burundi,BDI,Netherlands,NLD,5,19,0,239,263
2001,Benin,BEN,Netherlands,NLD,0,0,0,5,5
2001,Bangladesh,BGD,Netherlands,NLD,0,0,0,21,21
2001,Burkina Faso,BFA,Netherlands,NLD,0,0,0,11,11
2001,Belarus,BLR,Netherlands,NLD,5,0,0,25,30
2001,Bosnia and Herzegovina,BIH,Netherlands,NLD,10,127,20,1072,1229
2001,Bulgaria,BGR,Netherlands,NLD,0,0,0,5,5
2001,Central African Rep.,CAF,Netherlands,NLD,0,0,0,5,5
2001,Chad,TCD,Netherlands,NLD,0,0,0,24,24
2001,China,CHN,Netherlands,NLD,0,37,0,310,347
2001,Cameroon,CMR,Netherlands,NLD,0,5,0,56,61
2001,Congo,COG,Netherlands,NLD,0,17,0,269,286
2001,Dem. Rep. of the Congo,COD,Netherlands,NLD,12,28,0,292,332
2001,Colombia,COL,Netherlands,NLD,0,5,0,5,10
2001,Cuba,CUB,Netherlands,NLD,0,0,0,11,11
2001,Czechia,CZE,Netherlands,NLD,0,11,0,43,54
2001,Djibouti,DJI,Netherlands,NLD,0,0,0,5,5
2001,Ecuador,ECU,Netherlands,NLD,0,0,0,13,13
2001,Eritrea,ERI,Netherlands,NLD,0,10,0,97,107
2001,Ethiopia,ETH,Netherlands,NLD,0,19,0,137,156
2001,Georgia,GEO,Netherlands,NLD,5,11,0,109,125
2001,Germany,DEU,Netherlands,NLD,0,0,0,5,5
2001,Ghana,GHA,Netherlands,NLD,0,0,0,5,5
2001,Guinea-Bissau,GNB,Netherlands,NLD,0,0,0,10,10
2001,Guinea,GIN,Netherlands,NLD,5,37,0,291,333
2001,Croatia,HRV,Netherlands,NLD,5,5,0,46,56
2001,Hungary,HUN,Netherlands,NLD,0,0,0,25,25
2001,Cote d'Ivoire,CIV,Netherlands,NLD,0,5,0,19,24
2001,India,IND,Netherlands,NLD,0,5,0,5,10
2001,Indonesia,IDN,Netherlands,NLD,0,5,0,17,22
2001,Iran (Islamic Rep. of),IRN,Netherlands,NLD,28,98,23,1333,1482
2001,Iraq,IRQ,Netherlands,NLD,222,571,64,6034,6891
2001,Jordan,JOR,Netherlands,NLD,0,0,0,5,5
2001,Kazakhstan,KAZ,Netherlands,NLD,5,11,0,67,83
2001,Kenya,KEN,Netherlands,NLD,0,0,0,10,10
2001,Kyrgyzstan,KGZ,Netherlands,NLD,0,0,0,31,31
2001,Dem. People's Rep. of Korea,PRK,Netherlands,NLD,0,0,0,5,5
2001,Kuwait,KWT,Netherlands,NLD,0,0,0,5,5
2001,Liberia,LBR,Netherlands,NLD,5,10,0,87,102
2001,Libya,LBY,Netherlands,NLD,0,5,0,46,51
2001,Lebanon,LBN,Netherlands,NLD,0,10,0,42,52
2001,Sri Lanka,LKA,Netherlands,NLD,10,47,0,341,398
2001,Lithuania,LTU,Netherlands,NLD,0,0,0,5,5
2001,Latvia,LVA,Netherlands,NLD,0,0,0,5,5
2001,Mauritania,MRT,Netherlands,NLD,0,5,0,41,46
2001,North Macedonia,MKD,Netherlands,NLD,0,0,0,23,23
2001,Rep. of Moldova,MDA,Netherlands,NLD,0,0,0,5,5
2001,Mongolia,MNG,Netherlands,NLD,0,5,0,70,75
2001,Morocco,MAR,Netherlands,NLD,0,0,0,5,5
2001,Myanmar,MMR,Netherlands,NLD,0,0,0,11,11
2001,Netherlands,NLD,Netherlands,NLD,5,10,0,120,135
2001,Niger,NER,Netherlands,NLD,0,0,0,22,22
2001,Nigeria,NGA,Netherlands,NLD,0,5,0,71,76
2001,Pakistan,PAK,Netherlands,NLD,5,17,0,63,85
2001,Peru,PER,Netherlands,NLD,0,0,0,5,5
2001,Poland,POL,Netherlands,NLD,0,0,0,12,12
2001,Romania,ROU,Netherlands,NLD,0,0,0,17,17
2001,Russian Federation,RUS,Netherlands,NLD,5,50,0,357,412
2001,Rwanda,RWA,Netherlands,NLD,5,21,0,206,232
2001,Serbia and Kosovo: S/RES/1244 (1999),SRB,Netherlands,NLD,50,216,83,4052,4401
2001,Senegal,SEN,Netherlands,NLD,0,0,0,5,5
2001,Sierra Leone,SLE,Netherlands,NLD,5,397,5,588,995
2001,Somalia,SOM,Netherlands,NLD,30,172,21,1660,1883
2001,Viet Nam,VNM,Netherlands,NLD,0,5,0,24,29
2001,Sudan,SDN,Netherlands,NLD,50,93,5,1042,1190
2001,Suriname,SUR,Netherlands,NLD,0,0,0,5,5
2001,Slovakia,SVK,Netherlands,NLD,0,0,0,278,278
2001,Syrian Arab Rep.,SYR,Netherlands,NLD,15,68,0,543,626
2001,United Rep. of Tanzania,TZA,Netherlands,NLD,0,0,0,5,5
2001,Tajikistan,TJK,Netherlands,NLD,0,0,0,17,17
2001,Togo,TGO,Netherlands,NLD,0,10,0,86,96
2001,Tunisia,TUN,Netherlands,NLD,0,0,0,10,10
2001,Turkey,TUR,Netherlands,NLD,16,64,13,1165,1258
2001,Uganda,UGA,Netherlands,NLD,0,5,0,27,32
2001,Ukraine,UKR,Netherlands,NLD,0,12,5,129,146
2001,United States of America,USA,Netherlands,NLD,0,0,0,5,5
2001,Uzbekistan,UZB,Netherlands,NLD,10,0,0,28,38
2001,Yemen,YEM,Netherlands,NLD,0,5,0,24,29
2001,Stateless,XXA,Netherlands,NLD,0,40,0,307,347
2001,Algeria,DZA,Poland,POL,0,0,5,0,5
2001,Armenia,ARM,Poland,POL,0,0,729,5,734
2001,Azerbaijan,AZE,Poland,POL,0,0,35,5,40
2001,Bangladesh,BGD,Poland,POL,0,0,10,0,10
2001,Belarus,BLR,Poland,POL,5,0,37,0,42
2001,Bulgaria,BGR,Poland,POL,0,0,198,5,203
2001,China,CHN,Poland,POL,0,0,5,0,5
2001,Georgia,GEO,Poland,POL,0,0,39,0,39
2001,India,IND,Poland,POL,0,0,12,0,12
2001,Iraq,IRQ,Poland,POL,0,0,5,0,5
2001,Jordan,JOR,Poland,POL,0,0,5,0,5
2001,Kazakhstan,KAZ,Poland,POL,0,0,0,5,5
2001,Kyrgyzstan,KGZ,Poland,POL,0,0,5,0,5
2001,Sri Lanka,LKA,Poland,POL,0,0,5,0,5
2001,Latvia,LVA,Poland,POL,0,0,5,0,5
2001,Rep. of Moldova,MDA,Poland,POL,0,0,85,0,85
2001,Mongolia,MNG,Poland,POL,0,0,152,0,152
2001,Pakistan,PAK,Poland,POL,0,0,5,0,5
2001,Romania,ROU,Poland,POL,0,0,239,0,239
2001,Russian Federation,RUS,Poland,POL,0,0,111,10,121
2001,Serbia and Kosovo: S/RES/1244 (1999),SRB,Poland,POL,0,0,5,0,5
2001,Somalia,SOM,Poland,POL,0,0,0,5,5
2001,Viet Nam,VNM,Poland,POL,0,0,96,0,96
2001,Sudan,SDN,Poland,POL,5,0,0,0,5
2001,Syrian Arab Rep.,SYR,Poland,POL,0,0,5,0,5
2001,Ukraine,UKR,Poland,POL,0,0,73,0,73
2001,Uzbekistan,UZB,Poland,POL,0,0,0,5,5
2001,Stateless,XXA,Poland,POL,0,0,10,0,10
2001,Afghanistan,AFG,Sweden,SWE,0,11,513,5,529
2001,Albania,ALB,Sweden,SWE,0,10,39,0,49
2001,Algeria,DZA,Sweden,SWE,0,12,16,0,28
2001,Egypt,EGY,Sweden,SWE,0,0,10,0,10
2001,Armenia,ARM,Sweden,SWE,0,37,49,13,99
2001,Azerbaijan,AZE,Sweden,SWE,0,0,14,0,14
2001,Burundi,BDI,Sweden,SWE,0,0,5,0,5
2001,Bangladesh,BGD,Sweden,SWE,0,23,30,5,58
2001,Belarus,BLR,Sweden,SWE,5,5,64,5,79
2001,Bolivia (Plurinational State of),BOL,Sweden,SWE,0,5,13,0,18
2001,Brazil,BRA,Sweden,SWE,0,0,5,0,5
2001,Bosnia and Herzegovina,BIH,Sweden,SWE,0,233,1054,115,1402
2001,Bulgaria,BGR,Sweden,SWE,0,0,42,5,47
2001,China,CHN,Sweden,SWE,5,5,15,0,25
2001,Chile,CHL,Sweden,SWE,0,11,26,5,42
2001,Cameroon,CMR,Sweden,SWE,0,0,5,0,5
2001,Dem. Rep. of the Congo,COD,Sweden,SWE,0,0,29,0,29
2001,Colombia,COL,Sweden,SWE,28,41,30,0,99
2001,Cuba,CUB,Sweden,SWE,0,5,0,0,5
2001,Ecuador,ECU,Sweden,SWE,0,0,68,5,73
2001,Eritrea,ERI,Sweden,SWE,0,10,39,5,54
2001,Estonia,EST,Sweden,SWE,0,0,5,0,5
2001,Ethiopia,ETH,Sweden,SWE,0,10,42,0,52
2001,Gambia,GMB,Sweden,SWE,0,0,10,0,10
2001,Georgia,GEO,Sweden,SWE,0,5,14,10,29
2001,Ghana,GHA,Sweden,SWE,0,0,10,0,10
2001,Guatemala,GTM,Sweden,SWE,0,5,0,0,5
2001,Guinea,GIN,Sweden,SWE,0,0,5,0,5
2001,Honduras,HND,Sweden,SWE,0,0,5,0,5
2001,Croatia,HRV,Sweden,SWE,0,10,52,0,62
2001,Hungary,HUN,Sweden,SWE,0,0,5,0,5
2001,India,IND,Sweden,SWE,0,5,27,0,32
2001,Iran (Islamic Rep. of),IRN,Sweden,SWE,38,179,373,24,614
2001,Iraq,IRQ,Sweden,SWE,0,68,160,21,249
2001,Israel,ISR,Sweden,SWE,0,0,10,0,10
2001,Jordan,JOR,Sweden,SWE,0,13,24,10,47
2001,Kazakhstan,KAZ,Sweden,SWE,0,52,69,0,121
2001,Kenya,KEN,Sweden,SWE,0,5,15,0,20
2001,Kyrgyzstan,KGZ,Sweden,SWE,0,0,5,0,5
2001,Rep. of Korea,KOR,Sweden,SWE,0,5,0,0,5
2001,Liberia,LBR,Sweden,SWE,0,0,5,0,5
2001,Libya,LBY,Sweden,SWE,0,0,5,0,5
2001,Lebanon,LBN,Sweden,SWE,15,41,52,5,113
2001,Sri Lanka,LKA,Sweden,SWE,5,0,38,5,48
2001,Lithuania,LTU,Sweden,SWE,0,0,17,0,17
2001,Latvia,LVA,Sweden,SWE,0,0,10,0,10
2001,North Macedonia,MKD,Sweden,SWE,0,5,20,0,25
2001,Rep. of Moldova,MDA,Sweden,SWE,0,0,10,0,10
2001,Mongolia,MNG,Sweden,SWE,0,0,17,0,17
2001,Nigeria,NGA,Sweden,SWE,0,5,16,0,21
2001,Pakistan,PAK,Sweden,SWE,0,26,42,5,73
2001,Paraguay,PRY,Sweden,SWE,0,0,5,0,5
2001,Peru,PER,Sweden,SWE,0,22,21,22,65
2001,Poland,POL,Sweden,SWE,0,5,0,0,5
2001,Romania,ROU,Sweden,SWE,0,5,19,0,24
2001,Russian Federation,RUS,Sweden,SWE,15,59,176,31,281
2001,Rwanda,RWA,Sweden,SWE,0,5,10,0,15
2001,El Salvador,SLV,Sweden,SWE,0,0,5,0,5
2001,Serbia and Kosovo: S/RES/1244 (1999),SRB,Sweden,SWE,0,993,1581,48,2622
2001,Senegal,SEN,Sweden,SWE,0,0,5,0,5
2001,Sierra Leone,SLE,Sweden,SWE,0,0,12,0,12
2001,Somalia,SOM,Sweden,SWE,0,11,13,0,24
2001,Viet Nam,VNM,Sweden,SWE,0,11,0,0,11
2001,Slovakia,SVK,Sweden,SWE,0,0,59,5,64
2001,Syrian Arab Rep.,SYR,Sweden,SWE,15,100,153,12,280
2001,United Rep. of Tanzania,TZA,Sweden,SWE,0,0,10,0,10
2001,Tajikistan,TJK,Sweden,SWE,0,5,12,0,17
2001,Tunisia,TUN,Sweden,SWE,0,0,5,0,5
2001,Turkey,TUR,Sweden,SWE,5,69,97,0,171
2001,Ukraine,UKR,Sweden,SWE,0,16,39,5,60
2001,Uzbekistan,UZB,Sweden,SWE,0,13,5,0,18
2001,Yemen,YEM,Sweden,SWE,0,0,10,0,10
2001,Stateless,XXA,Sweden,SWE,11,53,193,10,267
2002,Afghanistan,AFG,Belgium,BEL,0,0,5,0,5
2002,Albania,ALB,Belgium,BEL,0,0,52,5,57
2002,Algeria,DZA,Belgium,BEL,5,0,235,36,276
2002,Angola,AGO,Belgium,BEL,0,0,34,5,39
2002,Armenia,ARM,Belgium,BEL,0,0,31,5,35
2002,Azerbaijan,AZE,Belgium,BEL,0,0,5,0,5
2002,Burundi,BDI,Belgium,BEL,5,0,38,10,53
2002,Bangladesh,BGD,Belgium,BEL,0,0,5,0,5
2002,Bhutan,BTN,Belgium,BEL,0,0,5,0,5
2002,Belarus,BLR,Belgium,BEL,0,0,24,5,33
2002,Bosnia and Herzegovina,BIH,Belgium,BEL,5,0,17,0,22
2002,Bulgaria,BGR,Belgium,BEL,0,0,5,0,5
2002,China,CHN,Belgium,BEL,0,0,5,0,5
2002,Cameroon,CMR,Belgium,BEL,5,0,37,0,42
2002,Dem. Rep. of the Congo,COD,Belgium,BEL,18,0,147,38,208
2002,Colombia,COL,Belgium,BEL,0,0,0,5,5
2002,Czechia,CZE,Belgium,BEL,0,0,10,0,10
2002,Djibouti,DJI,Belgium,BEL,5,0,5,0,10
2002,Ethiopia,ETH,Belgium,BEL,0,0,5,0,5
2002,Georgia,GEO,Belgium,BEL,10,0,44,5,59
2002,Guinea,GIN,Belgium,BEL,5,0,150,16,171
2002,Croatia,HRV,Belgium,BEL,0,0,5,0,5
2002,Cote d'Ivoire,CIV,Belgium,BEL,0,0,0,5,5
2002,India,IND,Belgium,BEL,0,0,5,0,5
2002,Iran (Islamic Rep. of),IRN,Belgium,BEL,0,0,69,12,81
2002,Iraq,IRQ,Belgium,BEL,5,0,24,0,29
2002,Israel,ISR,Belgium,BEL,5,0,0,0,5
2002,Kazakhstan,KAZ,Belgium,BEL,0,0,22,5,27
2002,Kyrgyzstan,KGZ,Belgium,BEL,0,0,5,0,5
2002,Liberia,LBR,Belgium,BEL,0,0,5,0,5
2002,Lebanon,LBN,Belgium,BEL,0,0,0,5,5
2002,Mauritania,MRT,Belgium,BEL,0,0,24,0,25
2002,North Macedonia,MKD,Belgium,BEL,0,0,16,0,16
2002,Rep. of Moldova,MDA,Belgium,BEL,0,0,5,0,5
2002,Myanmar,MMR,Belgium,BEL,0,0,5,0,5
2002,Nepal,NPL,Belgium,BEL,0,0,105,5,110
2002,Niger,NER,Belgium,BEL,0,0,16,5,21
2002,Nigeria,NGA,Belgium,BEL,0,0,11,0,11
2002,Pakistan,PAK,Belgium,BEL,0,0,26,5,31
2002,Romania,ROU,Belgium,BEL,0,0,10,0,10
2002,Russian Federation,RUS,Belgium,BEL,11,0,57,5,73
2002,Rwanda,RWA,Belgium,BEL,54,0,50,10,114
2002,Serbia and Kosovo: S/RES/1244 (1999),SRB,Belgium,BEL,10,0,198,51,259
2002,Sierra Leone,SLE,Belgium,BEL,0,0,34,5,39
2002,Somalia,SOM,Belgium,BEL,0,0,18,5,23
2002,Slovakia,SVK,Belgium,BEL,0,0,17,0,17
2002,Syrian Arab Rep.,SYR,Belgium,BEL,0,0,5,0,5
2002,Togo,TGO,Belgium,BEL,0,0,5,5,10
2002,Turkey,TUR,Belgium,BEL,10,0,33,14,57
2002,Ukraine,UKR,Belgium,BEL,0,0,15,5,20
2002,Uzbekistan,UZB,Belgium,BEL,5,0,18,0,23
2002,Afghanistan,AFG,Denmark,DNK,22,12,98,0,132
2002,Albania,ALB,Denmark,DNK,0,0,33,0,33
2002,Algeria,DZA,Denmark,DNK,0,0,5,0,5
2002,Armenia,ARM,Denmark,DNK,0,0,53,0,53
2002,Azerbaijan,AZE,Denmark,DNK,12,5,82,0,99
2002,Bangladesh,BGD,Denmark,DNK,0,0,14,0,14
2002,Belarus,BLR,Denmark,DNK,0,0,5,0,5
2002,Bosnia and Herzegovina,BIH,Denmark,DNK,5,72,651,0,728
2002,China,CHN,Denmark,DNK,5,0,34,0,39
2002,Cameroon,CMR,Denmark,DNK,0,0,11,0,11
2002,Dem. Rep. of the Congo,COD,Denmark,DNK,0,0,23,0,23
2002,Eritrea,ERI,Denmark,DNK,0,0,5,0,5
2002,Ethiopia,ETH,Denmark,DNK,0,0,16,0,16
2002,Gambia,GMB,Denmark,DNK,0,0,16,0,16
2002,Palestinian,PSE,Denmark,DNK,5,5,97,0,107
2002,Georgia,GEO,Denmark,DNK,0,0,21,0,21
2002,Guatemala,GTM,Denmark,DNK,0,0,5,0,5
2002,Croatia,HRV,Denmark,DNK,0,0,5,0,5
2002,India,IND,Denmark,DNK,0,0,38,0,38
2002,Iran (Islamic Rep. of),IRN,Denmark,DNK,21,33,165,0,219
2002,Iraq,IRQ,Denmark,DNK,24,113,534,0,671
2002,Jordan,JOR,Denmark,DNK,0,0,5,0,5
2002,Kazakhstan,KAZ,Denmark,DNK,0,0,23,0,23
2002,Kyrgyzstan,KGZ,Denmark,DNK,0,0,5,0,5
2002,Libya,LBY,Denmark,DNK,0,0,5,0,5
2002,Lebanon,LBN,Denmark,DNK,0,0,31,0,31
2002,Sri Lanka,LKA,Denmark,DNK,0,0,23,0,23
2002,North Macedonia,MKD,Denmark,DNK,0,0,36,0,36
2002,Rep. of Moldova,MDA,Denmark,DNK,0,0,5,0,5
2002,Mongolia,MNG,Denmark,DNK,0,0,5,0,5
2002,Nepal,NPL,Denmark,DNK,0,0,10,0,10
2002,Nigeria,NGA,Denmark,DNK,0,0,11,0,11
2002,Pakistan,PAK,Denmark,DNK,0,0,40,0,40
2002,Peru,PER,Denmark,DNK,0,0,5,0,5
2002,Russian Federation,RUS,Denmark,DNK,5,11,24,0,40
2002,Rwanda,RWA,Denmark,DNK,0,0,5,0,5
2002,Serbia and Kosovo: S/RES/1244 (1999),SRB,Denmark,DNK,0,31,417,0,448
2002,Sierra Leone,SLE,Denmark,DNK,0,0,10,0,10
2002,Somalia,SOM,Denmark,DNK,5,5,16,0,26
2002,Viet Nam,VNM,Denmark,DNK,0,0,5,0,5
2002,Syrian Arab Rep.,SYR,Denmark,DNK,20,0,15,0,35
2002,Tajikistan,TJK,Denmark,DNK,0,0,5,0,5
2002,Tunisia,TUN,Denmark,DNK,0,0,5,0,5
2002,Turkey,TUR,Denmark,DNK,0,0,39,0,39
2002,Ukraine,UKR,Denmark,DNK,0,0,15,0,15
2002,Uzbekistan,UZB,Denmark,DNK,0,5,0,0,5
2002,Stateless,XXA,Denmark,DNK,0,0,5,0,5
2002,Albania,ALB,France,FRA,79,0,139,0,218
2002,Algeria,DZA,France,FRA,118,0,1169,0,1287
2002,Angola,AGO,France,FRA,36,0,207,0,243
2002,Armenia,ARM,France,FRA,62,0,188,0,250
2002,Bangladesh,BGD,France,FRA,83,0,647,0,730
2002,China,CHN,France,FRA,10,0,2128,0,2138
2002,Congo,COG,France,FRA,87,0,358,0,445
2002,Dem. Rep. of the Congo,COD,France,FRA,189,0,1480,0,1669
2002,Georgia,GEO,France,FRA,61,0,282,0,343
2002,Guinea,GIN,France,FRA,35,0,343,0,378
2002,Haiti,HTI,France,FRA,134,0,1503,0,1637
2002,Cote d'Ivoire,CIV,France,FRA,5,0,176,0,181
2002,India,IND,France,FRA,20,0,330,0,350
2002,Iran (Islamic Rep. of),IRN,France,FRA,37,0,96,0,133
2002,Iraq,IRQ,France,FRA,44,0,62,0,106
2002,Sri Lanka,LKA,France,FRA,333,0,1024,0,1357
2002,Mauritania,MRT,France,FRA,113,0,653,0,766
2002,Rep. of Moldova,MDA,France,FRA,15,0,404,0,419
2002,Mali,MLI,France,FRA,5,0,1679,0,1684
2002,Nigeria,NGA,France,FRA,5,0,119,0,124
2002,Pakistan,PAK,France,FRA,5,0,285,0,290
2002,Russian Federation,RUS,France,FRA,130,0,264,0,394
2002,Serbia and Kosovo: S/RES/1244 (1999),SRB,France,FRA,113,0,775,0,888
2002,Senegal,SEN,France,FRA,18,0,373,0,391
2002,Turkey,TUR,France,FRA,262,0,2201,0,2463
2002,Ukraine,UKR,France,FRA,40,0,255,0,295
2002,Albania,ALB,Iceland,ISL,0,5,0,0,5
2002,Iran (Islamic Rep. of),IRN,Iceland,ISL,0,5,0,0,5
2002,Afghanistan,AFG,Ireland,IRL,5,0,5,0,10
2002,Albania,ALB,Ireland,IRL,18,0,32,10,60
2002,Algeria,DZA,Ireland,IRL,56,0,151,5,212
2002,Angola,AGO,Ireland,IRL,81,0,69,0,150
2002,Egypt,EGY,Ireland,IRL,10,0,10,0,20
2002,Armenia,ARM,Ireland,IRL,12,0,0,0,12
2002,Azerbaijan,AZE,Ireland,IRL,12,0,0,0,12
2002,Burundi,BDI,Ireland,IRL,0,0,12,0,12
2002,Bangladesh,BGD,Ireland,IRL,5,0,0,0,5
2002,Belarus,BLR,Ireland,IRL,20,0,20,0,40
2002,Bosnia and Herzegovina,BIH,Ireland,IRL,5,0,0,0,5
2002,Bulgaria,BGR,Ireland,IRL,17,0,55,5,77
2002,Cambodia,KHM,Ireland,IRL,12,0,44,5,61
2002,China,CHN,Ireland,IRL,0,0,5,0,5
2002,Congo,COG,Ireland,IRL,0,0,13,0,13
2002,Dem. Rep. of the Congo,COD,Ireland,IRL,66,0,113,10,189
2002,Czechia,CZE,Ireland,IRL,41,0,127,19,187
2002,Estonia,EST,Ireland,IRL,0,0,20,10,30
2002,Ethiopia,ETH,Ireland,IRL,0,0,5,0,5
2002,Georgia,GEO,Ireland,IRL,15,0,39,0,54
2002,Ghana,GHA,Ireland,IRL,5,0,46,10,61
2002,Guinea-Bissau,GNB,Ireland,IRL,0,0,14,0,14
2002,Guinea,GIN,Ireland,IRL,0,0,5,0,5
2002,Croatia,HRV,Ireland,IRL,49,0,98,10,157
2002,Cote d'Ivoire,CIV,Ireland,IRL,5,0,26,5,36
2002,Iran (Islamic Rep. of),IRN,Ireland,IRL,5,0,10,0,15
2002,Iraq,IRQ,Ireland,IRL,25,0,20,0,45
2002,Israel,ISR,Ireland,IRL,0,0,5,5,10
2002,Kazakhstan,KAZ,Ireland,IRL,10,0,21,5,36
2002,Kenya,KEN,Ireland,IRL,10,0,14,0,24
2002,Dem. People's Rep. of Korea,PRK,Ireland,IRL,5,0,0,0,5
2002,Liberia,LBR,Ireland,IRL,0,0,12,0,12
2002,Libya,LBY,Ireland,IRL,12,0,13,5,30
2002,Lebanon,LBN,Ireland,IRL,0,0,5,0,5
2002,Lithuania,LTU,Ireland,IRL,5,0,52,13,70
2002,Latvia,LVA,Ireland,IRL,5,0,34,5,44
2002,North Macedonia,MKD,Ireland,IRL,0,0,13,0,13
2002,Rep. of Moldova,MDA,Ireland,IRL,56,0,177,28,261
2002,Malaysia,MYS,Ireland,IRL,0,0,5,0,5
2002,Malawi,MWI,Ireland,IRL,0,0,5,0,5
2002,Morocco,MAR,Ireland,IRL,0,0,0,5,5
2002,Niger,NER,Ireland,IRL,5,0,0,0,5
2002,Nigeria,NGA,Ireland,IRL,131,0,1099,228,1458
2002,Pakistan,PAK,Ireland,IRL,11,0,41,5,57
2002,Poland,POL,Ireland,IRL,30,0,102,42,174
2002,Romania,ROU,Ireland,IRL,109,0,579,138,826
2002,South Africa,ZAF,Ireland,IRL,12,0,95,12,119
2002,Russian Federation,RUS,Ireland,IRL,65,0,139,14,218
2002,Rwanda,RWA,Ireland,IRL,5,0,13,0,18
2002,Serbia and Kosovo: S/RES/1244 (1999),SRB,Ireland,IRL,39,0,126,10,175
2002,Sierra Leone,SLE,Ireland,IRL,21,0,96,15,132
2002,Somalia,SOM,Ireland,IRL,19,0,18,0,37
2002,Sudan,SDN,Ireland,IRL,5,0,11,5,21
2002,Slovakia,SVK,Ireland,IRL,10,0,13,0,23
2002,Tajikistan,TJK,Ireland,IRL,0,0,5,0,5
2002,Togo,TGO,Ireland,IRL,5,0,5,0,10
2002,Turkey,TUR,Ireland,IRL,0,0,13,0,13
2002,Uganda,UGA,Ireland,IRL,14,0,0,0,14
2002,Ukraine,UKR,Ireland,IRL,34,0,78,21,133
2002,Uzbekistan,UZB,Ireland,IRL,5,0,15,5,25
2002,Zimbabwe,ZWE,Ireland,IRL,16,0,26,0,42
2002,Stateless,XXA,Ireland,IRL,5,0,12,0,17
2002,Afghanistan,AFG,Japan,JPN,0,0,36,5,41
2002,Bangladesh,BGD,Japan,JPN,0,0,5,0,5
2002,China,CHN,Japan,JPN,0,0,5,0,5
2002,Ethiopia,ETH,Japan,JPN,0,0,5,0,5
2002,Iran (Islamic Rep. of),IRN,Japan,JPN,0,0,15,0,15
2002,Myanmar,MMR,Japan,JPN,0,0,18,5,23
2002,Pakistan,PAK,Japan,JPN,0,0,38,5,43
2002,Viet Nam,VNM,Japan,JPN,0,0,5,0,5
2002,Sudan,SDN,Japan,JPN,0,0,5,0,5
2002,Turkey,TUR,Japan,JPN,0,0,92,10,102
2002,Afghanistan,AFG,Netherlands,NLD,17,110,454,697,1278
2002,Albania,ALB,Netherlands,NLD,0,5,23,16,44
2002,Algeria,DZA,Netherlands,NLD,0,26,141,34,201
2002,Angola,AGO,Netherlands,NLD,5,225,1743,202,2175
2002,Egypt,EGY,Netherlands,NLD,0,0,10,0,10
2002,Armenia,ARM,Netherlands,NLD,5,121,945,98,1169
2002,Azerbaijan,AZE,Netherlands,NLD,20,319,2042,167,2548
2002,Burundi,BDI,Netherlands,NLD,5,15,47,41,108
2002,Benin,BEN,Netherlands,NLD,0,0,10,0,10
2002,Bangladesh,BGD,Netherlands,NLD,0,5,17,5,27
2002,Bhutan,BTN,Netherlands,NLD,0,0,0,5,5
2002,Burkina Faso,BFA,Netherlands,NLD,0,0,18,0,18
2002,Belarus,BLR,Netherlands,NLD,0,0,36,0,36
2002,Bosnia and Herzegovina,BIH,Netherlands,NLD,10,85,433,114,642
2002,Bulgaria,BGR,Netherlands,NLD,0,0,10,0,10
2002,Central African Rep.,CAF,Netherlands,NLD,0,0,5,0,5
2002,Chad,TCD,Netherlands,NLD,0,0,34,0,34
2002,China,CHN,Netherlands,NLD,0,73,716,88,877
2002,Cameroon,CMR,Netherlands,NLD,0,11,97,16,124
2002,Congo,COG,Netherlands,NLD,10,66,448,66,590
2002,Dem. Rep. of the Congo,COD,Netherlands,NLD,5,56,362,61,484
2002,Comoros,COM,Netherlands,NLD,0,0,5,0,5
2002,Colombia,COL,Netherlands,NLD,0,0,0,12,12
2002,Cuba,CUB,Netherlands,NLD,0,0,5,0,5
2002,Czechia,CZE,Netherlands,NLD,0,0,16,10,26
2002,Eritrea,ERI,Netherlands,NLD,0,32,207,24,263
2002,Ethiopia,ETH,Netherlands,NLD,5,15,167,22,209
2002,Gambia,GMB,Netherlands,NLD,0,0,5,0,5
2002,Georgia,GEO,Netherlands,NLD,5,17,190,25,237
2002,Ghana,GHA,Netherlands,NLD,0,0,5,0,5
2002,Guinea-Bissau,GNB,Netherlands,NLD,0,5,14,0,19
2002,Guinea,GIN,Netherlands,NLD,0,43,422,76,541
2002,Croatia,HRV,Netherlands,NLD,0,5,87,12,104
2002,Hungary,HUN,Netherlands,NLD,0,5,0,0,5
2002,Cote d'Ivoire,CIV,Netherlands,NLD,0,0,26,5,31
2002,India,IND,Netherlands,NLD,0,5,12,0,17
2002,Indonesia,IDN,Netherlands,NLD,0,5,19,5,29
2002,Iran (Islamic Rep. of),IRN,Netherlands,NLD,32,255,1348,157,1792
2002,Iraq,IRQ,Netherlands,NLD,175,1185,4740,646,6746
2002,Israel,ISR,Netherlands,NLD,0,0,5,0,5
2002,Jordan,JOR,Netherlands,NLD,0,5,5,0,10
2002,Kazakhstan,KAZ,Netherlands,NLD,0,10,118,11,139
2002,Kenya,KEN,Netherlands,NLD,0,5,10,0,15
2002,Kyrgyzstan,KGZ,Netherlands,NLD,0,5,42,0,47
2002,Dem. People's Rep. of Korea,PRK,Netherlands,NLD,0,0,5,0,5
2002,Kuwait,KWT,Netherlands,NLD,0,0,5,0,5
2002,Liberia,LBR,Netherlands,NLD,5,24,105,30,164
2002,Libya,LBY,Netherlands,NLD,0,12,31,13,56
2002,Lebanon,LBN,Netherlands,NLD,0,5,49,0,54
2002,Sri Lanka,LKA,Netherlands,NLD,10,87,387,57,541
2002,Lithuania,LTU,Netherlands,NLD,0,0,5,0,5
2002,Latvia,LVA,Netherlands,NLD,0,0,10,0,10
2002,Mauritania,MRT,Netherlands,NLD,0,10,49,10,69
2002,North Macedonia,MKD,Netherlands,NLD,0,5,27,5,37
2002,Rep. of Moldova,MDA,Netherlands,NLD,0,5,10,0,15
2002,Mali,MLI,Netherlands,NLD,0,0,5,0,5
2002,Mongolia,MNG,Netherlands,NLD,0,5,138,10,153
2002,Morocco,MAR,Netherlands,NLD,0,0,12,0,12
2002,Myanmar,MMR,Netherlands,NLD,0,0,5,0,5
2002,Netherlands,NLD,Netherlands,NLD,20,57,30,92,199
2002,Niger,NER,Netherlands,NLD,0,0,43,10,53
2002,Nigeria,NGA,Netherlands,NLD,0,16,102,10,128
2002,Pakistan,PAK,Netherlands,NLD,0,20,49,5,74
2002,Peru,PER,Netherlands,NLD,0,0,0,5,5
2002,Romania,ROU,Netherlands,NLD,0,10,15,0,25
2002,Russian Federation,RUS,Netherlands,NLD,5,96,742,79,922
2002,Rwanda,RWA,Netherlands,NLD,25,47,341,91,504
2002,Serbia and Kosovo: S/RES/1244 (1999),SRB,Netherlands,NLD,51,144,1726,191,2112
2002,Senegal,SEN,Netherlands,NLD,0,0,10,0,10
2002,Sierra Leone,SLE,Netherlands,NLD,10,245,393,189,837
2002,Somalia,SOM,Netherlands,NLD,64,293,1970,312,2639
2002,Viet Nam,VNM,Netherlands,NLD,5,0,28,0,33
2002,Sudan,SDN,Netherlands,NLD,46,203,1272,282,1803
2002,Slovakia,SVK,Netherlands,NLD,0,10,122,63,195
2002,Syrian Arab Rep.,SYR,Netherlands,NLD,16,144,577,90,827
2002,Tajikistan,TJK,Netherlands,NLD,0,0,20,5,25
2002,Togo,TGO,Netherlands,NLD,5,13,153,26,197
2002,Tunisia,TUN,Netherlands,NLD,0,0,12,0,12
2002,Turkey,TUR,Netherlands,NLD,10,50,821,144,1025
2002,Uganda,UGA,Netherlands,NLD,0,5,14,0,19
2002,Ukraine,UKR,Netherlands,NLD,0,25,132,25,182
2002,Uzbekistan,UZB,Netherlands,NLD,0,5,70,10,85
2002,Yemen,YEM,Netherlands,NLD,0,0,39,10,49
2002,Zimbabwe,ZWE,Netherlands,NLD,0,0,5,0,5
2002,Stateless,XXA,Netherlands,NLD,20,117,506,69,712
2002,Afghanistan,AFG,Poland,POL,0,0,144,5,149
2002,Algeria,DZA,Poland,POL,0,0,10,0,10
2002,Egypt,EGY,Poland,POL,0,0,5,0,5
2002,Armenia,ARM,Poland,POL,0,0,391,0,391
2002,Azerbaijan,AZE,Poland,POL,0,0,75,5,80
2002,Belarus,BLR,Poland,POL,5,0,44,0,49
2002,Bulgaria,BGR,Poland,POL,0,0,16,0,16
2002,China,CHN,Poland,POL,0,0,15,0,15
2002,Cameroon,CMR,Poland,POL,0,0,5,0,5
2002,Dem. Rep. of the Congo,COD,Poland,POL,5,0,0,0,5
2002,Georgia,GEO,Poland,POL,0,0,48,0,48
2002,India,IND,Poland,POL,0,0,73,0,73
2002,Iran (Islamic Rep. of),IRN,Poland,POL,0,0,5,0,5
2002,Iraq,IRQ,Poland,POL,0,0,5,0,5
2002,Kazakhstan,KAZ,Poland,POL,0,0,14,0,14
2002,Sri Lanka,LKA,Poland,POL,0,0,11,0,11
2002,Lithuania,LTU,Poland,POL,0,0,5,0,5
2002,Latvia,LVA,Poland,POL,0,0,5,0,5
2002,North Macedonia,MKD,Poland,POL,0,0,5,0,5
2002,Rep. of Moldova,MDA,Poland,POL,0,0,44,0,44
2002,Mongolia,MNG,Poland,POL,0,0,109,0,109
2002,Morocco,MAR,Poland,POL,0,0,5,0,5
2002,Nigeria,NGA,Poland,POL,0,0,10,0,10
2002,Pakistan,PAK,Poland,POL,0,0,15,0,15
2002,Romania,ROU,Poland,POL,0,0,36,0,36
2002,Russian Federation,RUS,Poland,POL,19,0,536,61,616
2002,Somalia,SOM,Poland,POL,0,0,5,0,5
2002,Viet Nam,VNM,Poland,POL,0,0,48,0,48
2002,Sudan,SDN,Poland,POL,0,0,5,0,5
2002,Syrian Arab Rep.,SYR,Poland,POL,0,0,10,0,10
2002,Tajikistan,TJK,Poland,POL,0,0,5,0,5
2002,Turkey,TUR,Poland,POL,0,0,10,0,10
2002,Ukraine,UKR,Poland,POL,0,0,93,0,93
2002,Uzbekistan,UZB,Poland,POL,0,0,13,0,13
2002,Stateless,XXA,Poland,POL,0,0,10,0,10
2002,Afghanistan,AFG,Sweden,SWE,0,5,312,5,322
2002,Albania,ALB,Sweden,SWE,0,13,76,5,94
2002,Algeria,DZA,Sweden,SWE,0,10,29,5,44
2002,Egypt,EGY,Sweden,SWE,0,5,30,5,40
2002,Argentina,ARG,Sweden,SWE,0,0,5,0,5
2002,Armenia,ARM,Sweden,SWE,0,38,105,11,154
2002,Azerbaijan,AZE,Sweden,SWE,0,5,50,0,55
2002,Burundi,BDI,Sweden,SWE,0,5,0,0,5
2002,Bangladesh,BGD,Sweden,SWE,0,25,75,5,105
2002,Belarus,BLR,Sweden,SWE,11,10,105,10,136
2002,Bolivia (Plurinational State of),BOL,Sweden,SWE,0,11,27,10,48
2002,Bosnia and Herzegovina,BIH,Sweden,SWE,5,524,3253,181,3963
2002,Bulgaria,BGR,Sweden,SWE,0,5,179,25,209
2002,China,CHN,Sweden,SWE,0,0,27,0,27
2002,Chile,CHL,Sweden,SWE,0,0,14,0,14
2002,Cameroon,CMR,Sweden,SWE,0,0,10,0,10
2002,Congo,COG,Sweden,SWE,0,0,5,0,5
2002,Dem. Rep. of the Congo,COD,Sweden,SWE,0,0,31,0,31
2002,Colombia,COL,Sweden,SWE,10,24,37,10,81
2002,Cuba,CUB,Sweden,SWE,0,0,13,0,13
2002,Czechia,CZE,Sweden,SWE,0,0,31,10,41
2002,Ecuador,ECU,Sweden,SWE,0,5,72,11,88
2002,Eritrea,ERI,Sweden,SWE,5,5,77,5,92
2002,Estonia,EST,Sweden,SWE,0,5,5,0,10
2002,Ethiopia,ETH,Sweden,SWE,0,12,67,0,79
2002,Gambia,GMB,Sweden,SWE,0,0,14,0,14
2002,Georgia,GEO,Sweden,SWE,0,5,35,10,50
2002,Ghana,GHA,Sweden,SWE,0,0,5,0,5
2002,Guinea-Bissau,GNB,Sweden,SWE,0,0,5,0,5
2002,Guinea,GIN,Sweden,SWE,0,0,19,0,19
2002,Honduras,HND,Sweden,SWE,0,0,5,5,10
2002,Croatia,HRV,Sweden,SWE,0,5,199,30,234
2002,Hungary,HUN,Sweden,SWE,0,0,5,0,5
2002,India,IND,Sweden,SWE,0,0,41,5,46
2002,Iran (Islamic Rep. of),IRN,Sweden,SWE,79,161,354,28,622
2002,Iraq,IRQ,Sweden,SWE,0,43,434,20,497
2002,Israel,ISR,Sweden,SWE,0,5,22,0,27
2002,Jordan,JOR,Sweden,SWE,0,11,29,0,40
2002,Kazakhstan,KAZ,Sweden,SWE,0,32,32,5,69
2002,Kenya,KEN,Sweden,SWE,0,5,13,0,18
2002,Liberia,LBR,Sweden,SWE,0,0,5,0,5
2002,Libya,LBY,Sweden,SWE,11,0,15,0,26
2002,Lebanon,LBN,Sweden,SWE,5,37,52,5,99
2002,Sri Lanka,LKA,Sweden,SWE,0,0,20,5,25
2002,Lithuania,LTU,Sweden,SWE,0,0,20,5,25
2002,Latvia,LVA,Sweden,SWE,0,0,5,0,5
2002,North Macedonia,MKD,Sweden,SWE,0,5,189,10,204
2002,Rep. of Moldova,MDA,Sweden,SWE,0,5,20,0,25
2002,Mongolia,MNG,Sweden,SWE,0,0,103,11,114
2002,Morocco,MAR,Sweden,SWE,0,0,11,0,11
2002,Nicaragua,NIC,Sweden,SWE,0,5,0,0,5
2002,Nigeria,NGA,Sweden,SWE,0,0,20,0,20
2002,Pakistan,PAK,Sweden,SWE,5,35,120,0,160
2002,Peru,PER,Sweden,SWE,0,5,41,10,56
2002,Philippines,PHL,Sweden,SWE,0,0,5,0,5
2002,Poland,POL,Sweden,SWE,0,0,18,0,18
2002,Romania,ROU,Sweden,SWE,0,5,34,0,39
2002,Russian Federation,RUS,Sweden,SWE,5,61,250,24,340
2002,El Salvador,SLV,Sweden,SWE,0,0,335,30,365
2002,Serbia and Kosovo: S/RES/1244 (1999),SRB,Sweden,SWE,29,703,1878,74,2684
2002,Sierra Leone,SLE,Sweden,SWE,0,0,19,0,19
2002,Somalia,SOM,Sweden,SWE,0,5,17,0,22
2002,Viet Nam,VNM,Sweden,SWE,0,5,5,0,10
2002,Sudan,SDN,Sweden,SWE,0,0,10,0,10
2002,Slovakia,SVK,Sweden,SWE,0,0,109,5,114
2002,Sweden,SWE,Sweden,SWE,5,0,0,0,5
2002,Syrian Arab Rep.,SYR,Sweden,SWE,33,100,187,25,345
2002,United Rep. of Tanzania,TZA,Sweden,SWE,0,5,0,0,5
2002,Thailand,THA,Sweden,SWE,0,5,0,0,5
2002,Tajikistan,TJK,Sweden,SWE,0,12,0,0,12
2002,Turkmenistan,TKM,Sweden,SWE,0,0,0,5,5
2002,Tunisia,TUN,Sweden,SWE,0,5,12,0,17
2002,Turkey,TUR,Sweden,SWE,5,35,119,10,169
2002,Uganda,UGA,Sweden,SWE,0,0,11,0,11
2002,Ukraine,UKR,Sweden,SWE,0,5,156,19,180
2002,United States of America,USA,Sweden,SWE,0,0,5,0,5
2002,Uzbekistan,UZB,Sweden,SWE,0,10,121,10,141
2002,Venezuela (Bolivarian Republic of),VEN,Sweden,SWE,0,0,5,0,5
2002,Zambia,ZMB,Sweden,SWE,0,0,5,0,5
2002,Stateless,XXA,Sweden,SWE,10,92,179,10,291
2003,Afghanistan,AFG,Belgium,BEL,10,0,184,24,218
2003,Albania,ALB,Belgium,BEL,5,0,48,5,58
2003,Algeria,DZA,Belgium,BEL,17,0,193,48,258
2003,Angola,AGO,Belgium,BEL,0,0,16,0,16
2003,Armenia,ARM,Belgium,BEL,0,0,17,10,27
2003,Azerbaijan,AZE,Belgium,BEL,0,0,5,5,10
2003,Burundi,BDI,Belgium,BEL,13,0,10,5,28
2003,Bhutan,BTN,Belgium,BEL,0,0,5,0,5
2003,Belarus,BLR,Belgium,BEL,0,0,19,10,29
2003,Bosnia and Herzegovina,BIH,Belgium,BEL,0,0,5,5,10
2003,Bulgaria,BGR,Belgium,BEL,0,0,10,5,15
2003,China,CHN,Belgium,BEL,0,0,5,0,5
2003,Cameroon,CMR,Belgium,BEL,0,0,5,0,5
2003,Dem. Rep. of the Congo,COD,Belgium,BEL,23,0,206,47,276
2003,Colombia,COL,Belgium,BEL,0,0,13,5,18
2003,Djibouti,DJI,Belgium,BEL,0,0,0,5,5
2003,Ecuador,ECU,Belgium,BEL,0,0,5,0,5
2003,Palestinian,PSE,Belgium,BEL,0,0,5,0,5
2003,Georgia,GEO,Belgium,BEL,0,0,42,17,59
2003,Guinea,GIN,Belgium,BEL,5,0,156,20,181
2003,India,IND,Belgium,BEL,0,0,5,0,5
2003,Iran (Islamic Rep. of),IRN,Belgium,BEL,5,0,159,21,185
2003,Iraq,IRQ,Belgium,BEL,5,0,5,0,10
2003,Kazakhstan,KAZ,Belgium,BEL,0,0,38,5,43
2003,Kyrgyzstan,KGZ,Belgium,BEL,0,0,5,0,5
2003,Liberia,LBR,Belgium,BEL,5,0,0,0,5
2003,Lebanon,LBN,Belgium,BEL,0,0,5,0,5
2003,Sri Lanka,LKA,Belgium,BEL,0,0,5,0,5
2003,Mauritania,MRT,Belgium,BEL,0,0,5,0,5
2003,North Macedonia,MKD,Belgium,BEL,0,0,18,0,18
2003,Rep. of Moldova,MDA,Belgium,BEL,0,0,5,0,5
2003,Nepal,NPL,Belgium,BEL,0,0,93,10,103
2003,Niger,NER,Belgium,BEL,0,0,5,0,5
2003,Pakistan,PAK,Belgium,BEL,0,0,5,0,5
2003,Romania,ROU,Belgium,BEL,0,0,5,5,10
2003,Russian Federation,RUS,Belgium,BEL,13,0,64,17,94
2003,Rwanda,RWA,Belgium,BEL,38,0,24,10,72
2003,Serbia and Kosovo: S/RES/1244 (1999),SRB,Belgium,BEL,25,0,129,29,183
2003,Sierra Leone,SLE,Belgium,BEL,0,0,14,0,14
2003,Somalia,SOM,Belgium,BEL,0,0,5,0,5
2003,Sudan,SDN,Belgium,BEL,0,0,18,0,18
2003,Slovakia,SVK,Belgium,BEL,0,0,0,5,5
2003,Syrian Arab Rep.,SYR,Belgium,BEL,0,0,20,5,25
2003,Togo,TGO,Belgium,BEL,0,0,21,5,26
2003,Turkey,TUR,Belgium,BEL,10,0,36,15,61
2003,Ukraine,UKR,Belgium,BEL,0,0,20,5,25
2003,Uzbekistan,UZB,Belgium,BEL,0,0,14,0,14
2003,Chad,TCD,Benin,BEN,5,0,5,0,10
2003,Congo,COG,Benin,BEN,0,0,16,0,16
2003,Dem. Rep. of the Congo,COD,Benin,BEN,0,0,34,0,34
2003,Equatorial Guinea,GNQ,Benin,BEN,0,0,5,0,5
2003,Cote d'Ivoire,CIV,Benin,BEN,5,0,18,0,23
2003,Nigeria,NGA,Benin,BEN,0,0,0,40,40
2003,Rwanda,RWA,Benin,BEN,0,0,10,0,10
2003,Sudan,SDN,Benin,BEN,0,0,20,0,20
2003,Togo,TGO,Benin,BEN,0,0,63,0,63
2003,Afghanistan,AFG,Czechia,CZE,16,0,5,0,21
2003,Algeria,DZA,Czechia,CZE,0,0,14,0,14
2003,Angola,AGO,Czechia,CZE,0,0,5,0,5
2003,Armenia,ARM,Czechia,CZE,0,0,94,11,105
2003,Belarus,BLR,Czechia,CZE,0,0,24,0,24
2003,Bulgaria,BGR,Czechia,CZE,0,0,12,0,12
2003,China,CHN,Czechia,CZE,0,0,0,5,5
2003,Georgia,GEO,Czechia,CZE,0,0,45,0,45
2003,Guinea,GIN,Czechia,CZE,0,0,0,5,5
2003,Cote d'Ivoire,CIV,Czechia,CZE,0,0,5,0,5
2003,Iran (Islamic Rep. of),IRN,Czechia,CZE,0,0,0,5,5
2003,Kazakhstan,KAZ,Czechia,CZE,5,0,16,5,26
2003,Kyrgyzstan,KGZ,Czechia,CZE,0,0,10,0,10
2003,Sri Lanka,LKA,Czechia,CZE,0,0,5,0,5
2003,North Macedonia,MKD,Czechia,CZE,0,0,21,0,21
2003,Rep. of Moldova,MDA,Czechia,CZE,0,0,188,52,240
2003,Mongolia,MNG,Czechia,CZE,0,0,46,5,51
2003,Nigeria,NGA,Czechia,CZE,0,0,0,5,5
2003,Pakistan,PAK,Czechia,CZE,0,0,5,0,5
2003,Romania,ROU,Czechia,CZE,0,0,54,13,67
2003,Russian Federation,RUS,Czechia,CZE,0,0,36,11,47
2003,Serbia and Kosovo: S/RES/1244 (1999),SRB,Czechia,CZE,0,0,21,0,21
2003,Viet Nam,VNM,Czechia,CZE,0,0,107,5,112
2003,Ukraine,UKR,Czechia,CZE,0,0,576,111,687
2003,Uzbekistan,UZB,Czechia,CZE,0,0,5,5,10
2003,Stateless,XXA,Czechia,CZE,0,0,0,5,5
2003,Afghanistan,AFG,Denmark,DNK,118,93,980,0,1191
2003,Albania,ALB,Denmark,DNK,0,0,21,0,21
2003,Algeria,DZA,Denmark,DNK,0,0,10,0,10
2003,Egypt,EGY,Denmark,DNK,0,0,5,0,5
2003,Armenia,ARM,Denmark,DNK,5,0,5,0,10
2003,Azerbaijan,AZE,Denmark,DNK,5,0,16,0,21
2003,Burundi,BDI,Denmark,DNK,0,0,14,0,14
2003,Bangladesh,BGD,Denmark,DNK,0,0,5,0,5
2003,Bosnia and Herzegovina,BIH,Denmark,DNK,0,21,130,0,151
2003,Bulgaria,BGR,Denmark,DNK,0,0,5,0,5
2003,China,CHN,Denmark,DNK,5,5,20,0,30
2003,Cameroon,CMR,Denmark,DNK,0,0,5,0,5
2003,Dem. Rep. of the Congo,COD,Denmark,DNK,0,0,13,0,13
2003,Colombia,COL,Denmark,DNK,0,0,5,0,5
2003,Ethiopia,ETH,Denmark,DNK,0,0,5,0,5
2003,Gambia,GMB,Denmark,DNK,0,0,5,0,5
2003,Palestinian,PSE,Denmark,DNK,13,13,97,0,123
2003,Georgia,GEO,Denmark,DNK,0,0,13,0,13
2003,Croatia,HRV,Denmark,DNK,0,0,10,0,10
2003,India,IND,Denmark,DNK,5,0,24,0,29
2003,Iran (Islamic Rep. of),IRN,Denmark,DNK,38,30,148,0,216
2003,Iraq,IRQ,Denmark,DNK,5,73,227,0,305
2003,Jordan,JOR,Denmark,DNK,0,5,27,0,32
2003,Kenya,KEN,Denmark,DNK,0,0,10,0,10
2003,Libya,LBY,Denmark,DNK,0,5,15,0,20
2003,Lebanon,LBN,Denmark,DNK,0,10,35,0,45
2003,Sri Lanka,LKA,Denmark,DNK,0,0,11,0,11
2003,North Macedonia,MKD,Denmark,DNK,0,0,31,0,31
2003,Rep. of Moldova,MDA,Denmark,DNK,0,0,5,0,5
2003,Mongolia,MNG,Denmark,DNK,0,5,0,0,5
2003,Nigeria,NGA,Denmark,DNK,0,0,5,0,5
2003,Pakistan,PAK,Denmark,DNK,0,0,15,0,15
2003,Russian Federation,RUS,Denmark,DNK,10,12,30,0,52
2003,Rwanda,RWA,Denmark,DNK,0,0,20,0,20
2003,Serbia and Kosovo: S/RES/1244 (1999),SRB,Denmark,DNK,0,34,392,0,426
2003,Seychelles,SYC,Denmark,DNK,0,0,5,0,5
2003,Sierra Leone,SLE,Denmark,DNK,0,0,5,0,5
2003,Somalia,SOM,Denmark,DNK,0,10,84,0,94
2003,Viet Nam,VNM,Denmark,DNK,0,0,5,0,5
2003,Sudan,SDN,Denmark,DNK,0,0,13,0,13
2003,Slovakia,SVK,Denmark,DNK,0,0,5,0,5
2003,Syrian Arab Rep.,SYR,Denmark,DNK,5,5,30,0,40
2003,Tunisia,TUN,Denmark,DNK,0,0,5,0,5
2003,Turkey,TUR,Denmark,DNK,0,5,21,0,26
2003,Ukraine,UKR,Denmark,DNK,5,0,5,0,10
2003,Uzbekistan,UZB,Denmark,DNK,0,0,10,0,10
2003,Yemen,YEM,Denmark,DNK,0,0,5,0,5
2003,Stateless,XXA,Denmark,DNK,0,0,14,0,14
2003,Albania,ALB,France,FRA,119,0,196,0,315
2003,Algeria,DZA,France,FRA,114,0,1131,0,1245
2003,Angola,AGO,France,FRA,76,0,531,0,607
2003,Armenia,ARM,France,FRA,92,0,375,0,467
2003,Azerbaijan,AZE,France,FRA,96,0,59,0,155
2003,Bangladesh,BGD,France,FRA,60,0,345,0,405
2003,Belarus,BLR,France,FRA,30,0,57,0,87
2003,Bosnia and Herzegovina,BIH,France,FRA,26,0,90,0,116
2003,Central African Rep.,CAF,France,FRA,15,0,57,0,72
2003,China,CHN,France,FRA,5,0,2153,0,2158
2003,Cameroon,CMR,France,FRA,12,0,117,0,129
2003,Congo,COG,France,FRA,139,0,742,0,881
2003,Dem. Rep. of the Congo,COD,France,FRA,305,0,2465,0,2770
2003,Georgia,GEO,France,FRA,61,0,277,0,338
2003,Guinea,GIN,France,FRA,54,0,535,0,589
2003,Haiti,HTI,France,FRA,121,0,961,0,1082
2003,India,IND,France,FRA,24,0,199,0,223
2003,Iran (Islamic Rep. of),IRN,France,FRA,34,0,56,0,90
2003,Sri Lanka,LKA,France,FRA,344,0,1180,0,1524
2003,Mauritania,MRT,France,FRA,278,0,1682,0,1960
2003,North Macedonia,MKD,France,FRA,31,0,166,0,197
2003,Rep. of Moldova,MDA,France,FRA,37,0,420,0,457
2003,Mali,MLI,France,FRA,5,0,1217,0,1222
2003,Nigeria,NGA,France,FRA,15,0,201,0,216
2003,Pakistan,PAK,France,FRA,15,0,175,0,190
2003,Russian Federation,RUS,France,FRA,255,0,390,0,645
2003,Serbia and Kosovo: S/RES/1244 (1999),SRB,France,FRA,188,0,627,0,815
2003,Senegal,SEN,France,FRA,14,0,266,0,280
2003,Sierra Leone,SLE,France,FRA,24,0,245,0,269
2003,Turkey,TUR,France,FRA,397,0,3065,0,3462
2003,Ukraine,UKR,France,FRA,74,0,260,0,334
2003,Afghanistan,AFG,Ireland,IRL,0,0,5,0,5
2003,Albania,ALB,Ireland,IRL,17,0,57,5,79
2003,Algeria,DZA,Ireland,IRL,24,0,74,0,98
2003,Angola,AGO,Ireland,IRL,28,0,60,0,88
2003,Egypt,EGY,Ireland,IRL,0,0,10,0,10
2003,Armenia,ARM,Ireland,IRL,0,0,5,0,5
2003,Azerbaijan,AZE,Ireland,IRL,0,0,5,0,5
2003,Burundi,BDI,Ireland,IRL,0,0,12,0,12
2003,Bangladesh,BGD,Ireland,IRL,0,0,5,0,5
2003,Belarus,BLR,Ireland,IRL,5,0,12,0,17
2003,Bosnia and Herzegovina,BIH,Ireland,IRL,0,0,5,0,5
2003,Bulgaria,BGR,Ireland,IRL,5,0,16,5,26
2003,China,CHN,Ireland,IRL,0,0,12,0,12
2003,Cameroon,CMR,Ireland,IRL,29,0,59,0,88
2003,Congo,COG,Ireland,IRL,5,0,5,0,10
2003,Dem. Rep. of the Congo,COD,Ireland,IRL,60,0,86,0,146
2003,Cuba,CUB,Ireland,IRL,0,0,5,0,5
2003,Czechia,CZE,Ireland,IRL,22,0,126,13,161
2003,Estonia,EST,Ireland,IRL,10,0,35,0,45
2003,Ethiopia,ETH,Ireland,IRL,10,0,0,0,10
2003,Gambia,GMB,Ireland,IRL,0,0,5,0,5
2003,Palestinian,PSE,Ireland,IRL,5,0,19,0,24
2003,Georgia,GEO,Ireland,IRL,20,0,51,0,71
2003,Ghana,GHA,Ireland,IRL,12,0,104,0,116
2003,Croatia,HRV,Ireland,IRL,45,0,132,5,182
2003,Hungary,HUN,Ireland,IRL,0,0,0,15,15
2003,Cote d'Ivoire,CIV,Ireland,IRL,5,0,30,0,35
2003,India,IND,Ireland,IRL,0,0,0,11,11
2003,Iran (Islamic Rep. of),IRN,Ireland,IRL,5,0,5,0,10
2003,Iraq,IRQ,Ireland,IRL,5,0,11,0,16
2003,Israel,ISR,Ireland,IRL,0,0,45,0,45
2003,Jamaica,JAM,Ireland,IRL,5,0,0,0,5
2003,Kazakhstan,KAZ,Ireland,IRL,29,0,36,0,65
2003,Kenya,KEN,Ireland,IRL,20,0,36,0,56
2003,Kyrgyzstan,KGZ,Ireland,IRL,0,0,10,0,10
2003,Liberia,LBR,Ireland,IRL,5,0,10,0,15
2003,Libya,LBY,Ireland,IRL,5,0,5,0,10
2003,Lebanon,LBN,Ireland,IRL,14,0,0,0,14
2003,Lesotho,LSO,Ireland,IRL,0,0,5,0,5
2003,Sri Lanka,LKA,Ireland,IRL,5,0,0,0,5
2003,Lithuania,LTU,Ireland,IRL,10,0,80,5,95
2003,Latvia,LVA,Ireland,IRL,10,0,23,0,33
2003,North Macedonia,MKD,Ireland,IRL,0,0,11,0,11
2003,Rep. of Moldova,MDA,Ireland,IRL,52,0,161,5,218
2003,Mongolia,MNG,Ireland,IRL,0,0,5,0,5
2003,Morocco,MAR,Ireland,IRL,0,0,5,0,5
2003,Nigeria,NGA,Ireland,IRL,106,0,1303,41,1450
2003,Pakistan,PAK,Ireland,IRL,10,0,27,0,37
2003,Philippines,PHL,Ireland,IRL,0,0,5,0,5
2003,Poland,POL,Ireland,IRL,10,0,119,24,153
2003,Romania,ROU,Ireland,IRL,46,0,524,22,592
2003,South Africa,ZAF,Ireland,IRL,10,0,105,5,120
2003,Russian Federation,RUS,Ireland,IRL,24,0,72,5,101
2003,Rwanda,RWA,Ireland,IRL,0,0,5,0,5
2003,Serbia and Kosovo: S/RES/1244 (1999),SRB,Ireland,IRL,25,0,73,5,103
2003,Sierra Leone,SLE,Ireland,IRL,5,0,85,5,95
2003,Somalia,SOM,Ireland,IRL,20,0,15,0,35
2003,Sudan,SDN,Ireland,IRL,10,0,10,0,20
2003,Slovakia,SVK,Ireland,IRL,5,0,12,0,17
2003,Syrian Arab Rep.,SYR,Ireland,IRL,0,0,5,0,5
2003,Togo,TGO,Ireland,IRL,10,0,22,0,32
2003,Turkey,TUR,Ireland,IRL,5,0,5,0,10
2003,Uganda,UGA,Ireland,IRL,0,0,11,0,11
2003,Ukraine,UKR,Ireland,IRL,37,0,89,5,131
2003,Uzbekistan,UZB,Ireland,IRL,5,0,13,0,18
2003,Zimbabwe,ZWE,Ireland,IRL,50,0,93,0,143
2003,Stateless,XXA,Ireland,IRL,5,0,10,0,15
2003,Afghanistan,AFG,Japan,JPN,0,0,18,10,28
2003,Bangladesh,BGD,Japan,JPN,0,0,10,0,10
2003,China,CHN,Japan,JPN,0,0,17,0,17
2003,Cameroon,CMR,Japan,JPN,0,0,5,0,5
2003,Colombia,COL,Japan,JPN,0,0,5,0,5
2003,Gambia,GMB,Japan,JPN,0,0,5,0,5
2003,India,IND,Japan,JPN,0,0,10,0,10
2003,Indonesia,IDN,Japan,JPN,0,0,5,0,5
2003,Iran (Islamic Rep. of),IRN,Japan,JPN,0,0,21,0,21
2003,Myanmar,MMR,Japan,JPN,5,5,19,0,29
2003,Nigeria,NGA,Japan,JPN,0,0,5,0,5
2003,Pakistan,PAK,Japan,JPN,0,5,10,0,15
2003,Turkey,TUR,Japan,JPN,0,0,51,0,51
2003,Afghanistan,AFG,Netherlands,NLD,134,67,537,242,980
2003,Albania,ALB,Netherlands,NLD,0,0,14,5,19
2003,Algeria,DZA,Netherlands,NLD,0,0,48,12,60
2003,Angola,AGO,Netherlands,NLD,20,23,550,158,751
2003,Armenia,ARM,Netherlands,NLD,23,15,144,39,221
2003,Azerbaijan,AZE,Netherlands,NLD,56,43,360,128,587
2003,Burundi,BDI,Netherlands,NLD,5,5,18,5,33
2003,Benin,BEN,Netherlands,NLD,0,0,10,0,10
2003,Bangladesh,BGD,Netherlands,NLD,0,0,5,5,10
2003,Burkina Faso,BFA,Netherlands,NLD,0,0,0,5,5
2003,Belarus,BLR,Netherlands,NLD,0,0,11,0,11
2003,Bosnia and Herzegovina,BIH,Netherlands,NLD,13,12,93,66,184
2003,Bulgaria,BGR,Netherlands,NLD,0,0,5,0,5
2003,Chad,TCD,Netherlands,NLD,0,0,13,5,18
2003,China,CHN,Netherlands,NLD,5,11,225,77,318
2003,Cameroon,CMR,Netherlands,NLD,0,5,36,10,51
2003,Congo,COG,Netherlands,NLD,0,11,85,29,125
2003,Dem. Rep. of the Congo,COD,Netherlands,NLD,13,17,146,50,226
2003,Colombia,COL,Netherlands,NLD,0,0,11,0,11
2003,Czechia,CZE,Netherlands,NLD,0,0,0,5,5
2003,Eritrea,ERI,Netherlands,NLD,0,0,56,22,78
2003,Ethiopia,ETH,Netherlands,NLD,5,5,66,21,97
2003,Palestinian,PSE,Netherlands,NLD,0,0,5,0,5
2003,Georgia,GEO,Netherlands,NLD,0,0,60,10,70
2003,Ghana,GHA,Netherlands,NLD,0,0,5,5,10
2003,Guinea-Bissau,GNB,Netherlands,NLD,0,0,5,0,5
2003,Guinea,GIN,Netherlands,NLD,10,27,215,61,313
2003,Croatia,HRV,Netherlands,NLD,0,5,0,0,5
2003,Cote d'Ivoire,CIV,Netherlands,NLD,0,5,21,5,31
2003,India,IND,Netherlands,NLD,0,0,5,5,10
2003,Indonesia,IDN,Netherlands,NLD,0,0,0,5,5
2003,Iran (Islamic Rep. of),IRN,Netherlands,NLD,41,29,295,85,450
2003,Iraq,IRQ,Netherlands,NLD,87,1830,496,692,3105
2003,Jordan,JOR,Netherlands,NLD,0,0,0,5,5
2003,Kazakhstan,KAZ,Netherlands,NLD,0,0,36,5,41
2003,Kyrgyzstan,KGZ,Netherlands,NLD,0,0,11,5,16
2003,Kuwait,KWT,Netherlands,NLD,0,0,0,5,5
2003,Liberia,LBR,Netherlands,NLD,5,5,35,43,88
2003,Libya,LBY,Netherlands,NLD,5,0,18,5,28
2003,Lebanon,LBN,Netherlands,NLD,0,0,5,5,10
2003,Sri Lanka,LKA,Netherlands,NLD,11,10,74,19,114
2003,Mauritania,MRT,Netherlands,NLD,0,5,18,10,33
2003,North Macedonia,MKD,Netherlands,NLD,0,0,0,12,12
2003,Rep. of Moldova,MDA,Netherlands,NLD,0,0,5,0,5
2003,Mongolia,MNG,Netherlands,NLD,0,0,66,15,81
2003,Morocco,MAR,Netherlands,NLD,0,0,5,0,5
2003,Myanmar,MMR,Netherlands,NLD,0,5,5,0,10
2003,Nepal,NPL,Netherlands,NLD,0,0,5,0,5
2003,Netherlands,NLD,Netherlands,NLD,0,0,5,13,18
2003,Niger,NER,Netherlands,NLD,0,0,32,16,48
2003,Nigeria,NGA,Netherlands,NLD,0,0,41,13,54
2003,Pakistan,PAK,Netherlands,NLD,5,0,33,5,43
2003,Poland,POL,Netherlands,NLD,0,0,5,0,5
2003,Romania,ROU,Netherlands,NLD,0,0,0,5,5
2003,Russian Federation,RUS,Netherlands,NLD,20,31,173,50,274
2003,Rwanda,RWA,Netherlands,NLD,19,14,117,40,190
2003,Serbia and Kosovo: S/RES/1244 (1999),SRB,Netherlands,NLD,47,31,256,134,468
2003,Senegal,SEN,Netherlands,NLD,0,0,5,0,5
2003,Sierra Leone,SLE,Netherlands,NLD,5,5,271,102,383
2003,Somalia,SOM,Netherlands,NLD,68,44,399,130,641
2003,Viet Nam,VNM,Netherlands,NLD,0,0,35,5,40
2003,Sudan,SDN,Netherlands,NLD,37,32,327,134,530
2003,Slovakia,SVK,Netherlands,NLD,0,0,23,27,50
2003,Syrian Arab Rep.,SYR,Netherlands,NLD,34,33,180,93,340
2003,Tajikistan,TJK,Netherlands,NLD,0,0,5,0,5
2003,Togo,TGO,Netherlands,NLD,0,5,82,22,109
2003,Turkey,TUR,Netherlands,NLD,5,0,129,62,196
2003,Uganda,UGA,Netherlands,NLD,0,0,13,5,18
2003,Ukraine,UKR,Netherlands,NLD,5,5,33,17,60
2003,Uzbekistan,UZB,Netherlands,NLD,5,0,19,5,29
2003,Yemen,YEM,Netherlands,NLD,0,0,12,10,22
2003,Stateless,XXA,Netherlands,NLD,10,13,129,36,188
2003,Afghanistan,AFG,New Zealand,NZL,0,0,5,0,5
2003,Albania,ALB,New Zealand,NZL,0,0,5,0,5
2003,Algeria,DZA,New Zealand,NZL,5,0,5,0,10
2003,Egypt,EGY,New Zealand,NZL,0,0,5,0,5
2003,Bangladesh,BGD,New Zealand,NZL,0,0,16,0,16
2003,Bulgaria,BGR,New Zealand,NZL,0,0,5,0,5
2003,China,CHN,New Zealand,NZL,0,0,21,0,21
2003,Chile,CHL,New Zealand,NZL,0,0,5,0,5
2003,Congo,COG,New Zealand,NZL,0,0,5,0,5
2003,Colombia,COL,New Zealand,NZL,5,0,0,0,5
2003,Czechia,CZE,New Zealand,NZL,5,0,24,0,29
2003,Ecuador,ECU,New Zealand,NZL,0,0,5,0,5
2003,Fiji,FJI,New Zealand,NZL,0,0,15,0,15
2003,Hungary,HUN,New Zealand,NZL,0,0,5,0,5
2003,India,IND,New Zealand,NZL,0,0,56,0,56
2003,Indonesia,IDN,New Zealand,NZL,0,0,5,0,5
2003,Iran (Islamic Rep. of),IRN,New Zealand,NZL,20,0,42,0,62
2003,Iraq,IRQ,New Zealand,NZL,0,0,5,0,5
2003,Kuwait,KWT,New Zealand,NZL,0,0,5,0,5
2003,Sri Lanka,LKA,New Zealand,NZL,0,0,43,0,43
2003,Malaysia,MYS,New Zealand,NZL,0,0,15,0,15
2003,Nepal,NPL,New Zealand,NZL,0,0,11,0,11
2003,Nigeria,NGA,New Zealand,NZL,0,0,12,0,12
2003,Pakistan,PAK,New Zealand,NZL,5,0,14,0,19
2003,South Africa,ZAF,New Zealand,NZL,0,0,5,0,5
2003,Somalia,SOM,New Zealand,NZL,5,0,0,0,5
2003,Viet Nam,VNM,New Zealand,NZL,0,0,5,0,5
2003,Thailand,THA,New Zealand,NZL,0,0,127,0,127
2003,Turkey,TUR,New Zealand,NZL,0,0,5,0,5
2003,Zimbabwe,ZWE,New Zealand,NZL,10,0,10,0,20
2003,Afghanistan,AFG,Poland,POL,0,0,57,0,0
2003,Egypt,EGY,Poland,POL,0,0,5,0,0
2003,Armenia,ARM,Poland,POL,0,0,100,0,0
2003,Azerbaijan,AZE,Poland,POL,0,0,10,0,0
2003,Belarus,BLR,Poland,POL,0,0,12,0,0
2003,Bulgaria,BGR,Poland,POL,0,0,5,0,0
2003,China,CHN,Poland,POL,0,0,5,0,0
2003,Czechia,CZE,Poland,POL,0,0,5,0,0
2003,Georgia,GEO,Poland,POL,0,0,5,0,0
2003,India,IND,Poland,POL,0,0,105,0,0
2003,Iraq,IRQ,Poland,POL,0,0,17,0,0
2003,Jordan,JOR,Poland,POL,0,0,5,0,0
2003,Kyrgyzstan,KGZ,Poland,POL,0,0,5,0,0
2003,Sri Lanka,LKA,Poland,POL,0,0,18,0,0
2003,Mongolia,MNG,Poland,POL,0,0,22,0,0
2003,Nigeria,NGA,Poland,POL,0,0,10,0,0
2003,Pakistan,PAK,Poland,POL,0,0,16,0,0
2003,Romania,ROU,Poland,POL,0,0,11,0,0
2003,Russian Federation,RUS,Poland,POL,24,0,379,36,0
2003,Viet Nam,VNM,Poland,POL,0,0,10,0,0
2003,Sudan,SDN,Poland,POL,0,0,10,0,0
2003,Syrian Arab Rep.,SYR,Poland,POL,0,0,5,0,0
2003,Turkey,TUR,Poland,POL,0,0,5,0,0
2003,Ukraine,UKR,Poland,POL,0,0,23,0,0
2003,Stateless,XXA,Poland,POL,0,0,5,0,0
2003,Afghanistan,AFG,Sweden,SWE,0,5,62,5,72
2003,Albania,ALB,Sweden,SWE,0,10,164,5,179
2003,Algeria,DZA,Sweden,SWE,0,5,127,5,137
2003,Angola,AGO,Sweden,SWE,0,0,5,0,5
2003,Egypt,EGY,Sweden,SWE,5,5,81,0,91
2003,Argentina,ARG,Sweden,SWE,0,0,5,0,5
2003,Armenia,ARM,Sweden,SWE,0,26,102,0,128
2003,Azerbaijan,AZE,Sweden,SWE,0,13,122,12,147
2003,Bangladesh,BGD,Sweden,SWE,0,33,108,0,141
2003,Belarus,BLR,Sweden,SWE,5,12,169,25,211
2003,Bolivia (Plurinational State of),BOL,Sweden,SWE,0,0,140,17,157
2003,Brazil,BRA,Sweden,SWE,0,0,5,0,5
2003,Bosnia and Herzegovina,BIH,Sweden,SWE,10,607,2407,42,3066
2003,Bulgaria,BGR,Sweden,SWE,5,5,159,5,174
2003,China,CHN,Sweden,SWE,5,0,37,0,42
2003,Chile,CHL,Sweden,SWE,0,5,69,0,74
2003,Cameroon,CMR,Sweden,SWE,0,0,11,0,11
2003,Congo,COG,Sweden,SWE,0,0,5,0,5
2003,Dem. Rep. of the Congo,COD,Sweden,SWE,0,5,34,0,39
2003,Colombia,COL,Sweden,SWE,0,10,11,0,21
2003,Cuba,CUB,Sweden,SWE,0,5,11,0,16
2003,Czechia,CZE,Sweden,SWE,0,0,11,0,11
2003,Ecuador,ECU,Sweden,SWE,0,22,147,13,182
2003,Eritrea,ERI,Sweden,SWE,0,5,120,0,125
2003,Estonia,EST,Sweden,SWE,0,0,5,0,5
2003,Ethiopia,ETH,Sweden,SWE,0,5,64,0,69
2003,Gambia,GMB,Sweden,SWE,0,0,5,0,5
2003,Georgia,GEO,Sweden,SWE,0,17,92,10,119
2003,Germany,DEU,Sweden,SWE,0,0,0,5,5
2003,Ghana,GHA,Sweden,SWE,0,0,5,0,5
2003,Guinea,GIN,Sweden,SWE,0,0,28,0,28
2003,Honduras,HND,Sweden,SWE,0,5,5,0,10
2003,Croatia,HRV,Sweden,SWE,0,18,205,5,228
2003,Hungary,HUN,Sweden,SWE,0,0,11,0,11
2003,Cote d'Ivoire,CIV,Sweden,SWE,0,0,10,0,10
2003,India,IND,Sweden,SWE,0,0,26,5,31
2003,Iran (Islamic Rep. of),IRN,Sweden,SWE,54,69,389,35,547
2003,Iraq,IRQ,Sweden,SWE,5,71,477,34,587
2003,Israel,ISR,Sweden,SWE,0,0,23,0,23
2003,Jordan,JOR,Sweden,SWE,0,5,30,5,40
2003,Kazakhstan,KAZ,Sweden,SWE,10,30,71,5,116
2003,Kiribati,KIR,Sweden,SWE,0,5,57,5,67
2003,Liberia,LBR,Sweden,SWE,0,0,5,0,5
2003,Libya,LBY,Sweden,SWE,5,0,124,15,144
2003,Lebanon,LBN,Sweden,SWE,10,20,0,15,45
2003,Sri Lanka,LKA,Sweden,SWE,0,0,16,0,16
2003,Lithuania,LTU,Sweden,SWE,0,0,13,0,13
2003,Latvia,LVA,Sweden,SWE,0,5,0,5,10
2003,North Macedonia,MKD,Sweden,SWE,0,13,377,18,408
2003,Rep. of Moldova,MDA,Sweden,SWE,0,0,45,0,45
2003,Malaysia,MYS,Sweden,SWE,0,0,5,0,5
2003,Mongolia,MNG,Sweden,SWE,0,0,173,5,178
2003,Morocco,MAR,Sweden,SWE,0,5,16,0,21
2003,Myanmar,MMR,Sweden,SWE,0,5,0,0,5
2003,Nigeria,NGA,Sweden,SWE,0,0,88,0,88
2003,Pakistan,PAK,Sweden,SWE,5,20,51,0,76
2003,Paraguay,PRY,Sweden,SWE,0,0,5,0,5
2003,Peru,PER,Sweden,SWE,0,5,69,0,74
2003,Poland,POL,Sweden,SWE,0,0,5,0,5
2003,Romania,ROU,Sweden,SWE,0,0,68,0,68
2003,Russian Federation,RUS,Sweden,SWE,13,43,504,34,594
2003,El Salvador,SLV,Sweden,SWE,5,5,71,5,86
2003,Serbia and Kosovo: S/RES/1244 (1999),SRB,Sweden,SWE,37,345,3212,37,3631
2003,Sierra Leone,SLE,Sweden,SWE,0,0,17,0,17
2003,Somalia,SOM,Sweden,SWE,0,5,42,0,47
2003,Viet Nam,VNM,Sweden,SWE,0,0,15,0,15
2003,Sudan,SDN,Sweden,SWE,0,5,12,0,17
2003,Slovakia,SVK,Sweden,SWE,0,0,83,5,88
2003,Sweden,SWE,Sweden,SWE,0,5,0,0,5
2003,Syrian Arab Rep.,SYR,Sweden,SWE,26,72,456,12,566
2003,United Rep. of Tanzania,TZA,Sweden,SWE,0,0,10,0,10
2003,Tajikistan,TJK,Sweden,SWE,0,0,11,0,11
2003,Turkmenistan,TKM,Sweden,SWE,0,0,5,0,5
2003,Togo,TGO,Sweden,SWE,0,0,5,0,5
2003,Tunisia,TUN,Sweden,SWE,0,0,30,5,35
2003,Turkey,TUR,Sweden,SWE,5,38,392,15,450
2003,Uganda,UGA,Sweden,SWE,0,0,13,0,13
2003,Ukraine,UKR,Sweden,SWE,0,12,269,13,294
2003,United States of America,USA,Sweden,SWE,0,0,5,0,5
2003,Uzbekistan,UZB,Sweden,SWE,5,36,220,14,275
2003,Venezuela (Bolivarian Republic of),VEN,Sweden,SWE,0,11,0,0,11
2003,Yemen,YEM,Sweden,SWE,0,5,12,0,17
2003,Stateless,XXA,Sweden,SWE,0,121,174,10,305
2004,Afghanistan,AFG,Azerbaijan,AZE,0,0,40,0,40
2004,Afghanistan,AFG,Belgium,BEL,14,0,283,34,331
2004,Albania,ALB,Belgium,BEL,0,0,52,5,57
2004,Algeria,DZA,Belgium,BEL,5,0,62,25,92
2004,Angola,AGO,Belgium,BEL,0,0,10,0,10
2004,Armenia,ARM,Belgium,BEL,0,0,11,10,21
2004,Azerbaijan,AZE,Belgium,BEL,0,0,5,0,5
2004,Burundi,BDI,Belgium,BEL,5,0,10,5,20
2004,Bangladesh,BGD,Belgium,BEL,0,0,22,0,22
2004,Bhutan,BTN,Belgium,BEL,0,0,5,0,5
2004,Belarus,BLR,Belgium,BEL,5,0,10,5,20
2004,Bosnia and Herzegovina,BIH,Belgium,BEL,0,0,14,0,14
2004,Bulgaria,BGR,Belgium,BEL,5,0,5,0,10
2004,China,CHN,Belgium,BEL,0,0,0,5,5
2004,Cameroon,CMR,Belgium,BEL,0,0,38,10,48
2004,Dem. Rep. of the Congo,COD,Belgium,BEL,5,0,337,69,411
2004,Colombia,COL,Belgium,BEL,5,0,26,5,36
2004,Cuba,CUB,Belgium,BEL,0,0,5,0,5
2004,Ecuador,ECU,Belgium,BEL,0,0,5,0,5
2004,Palestinian,PSE,Belgium,BEL,0,0,0,5,5
2004,Georgia,GEO,Belgium,BEL,0,0,34,14,48
2004,Guinea,GIN,Belgium,BEL,5,0,17,5,27
2004,Cote d'Ivoire,CIV,Belgium,BEL,0,0,5,0,5
2004,Iran (Islamic Rep. of),IRN,Belgium,BEL,5,0,74,13,92
2004,Iraq,IRQ,Belgium,BEL,0,0,0,5,5
2004,Kazakhstan,KAZ,Belgium,BEL,0,0,5,5,10
2004,Kyrgyzstan,KGZ,Belgium,BEL,0,0,5,0,5
2004,Lebanon,LBN,Belgium,BEL,0,0,13,0,13
2004,Sri Lanka,LKA,Belgium,BEL,0,0,5,0,5
2004,Mauritania,MRT,Belgium,BEL,0,0,13,0,13
2004,North Macedonia,MKD,Belgium,BEL,0,0,10,5,15
2004,Rep. of Moldova,MDA,Belgium,BEL,0,0,0,5,5
2004,Mongolia,MNG,Belgium,BEL,0,0,10,0,10
2004,Myanmar,MMR,Belgium,BEL,0,0,5,0,5
2004,Nepal,NPL,Belgium,BEL,0,0,38,5,43
2004,Pakistan,PAK,Belgium,BEL,0,0,20,10,30
2004,Romania,ROU,Belgium,BEL,0,0,12,0,12
2004,Russian Federation,RUS,Belgium,BEL,14,0,78,24,116
2004,Rwanda,RWA,Belgium,BEL,14,0,15,10,39
2004,El Salvador,SLV,Belgium,BEL,0,0,5,0,5
2004,Serbia and Kosovo: S/RES/1244 (1999),SRB,Belgium,BEL,0,0,87,20,107
2004,Sierra Leone,SLE,Belgium,BEL,0,0,0,5,5
2004,Sudan,SDN,Belgium,BEL,0,0,18,0,18
2004,Slovakia,SVK,Belgium,BEL,0,0,5,0,5
2004,Syrian Arab Rep.,SYR,Belgium,BEL,0,0,64,5,69
2004,Togo,TGO,Belgium,BEL,0,0,75,15,90
2004,Turkey,TUR,Belgium,BEL,12,0,123,34,169
2004,Ukraine,UKR,Belgium,BEL,0,0,23,0,23
2004,Uzbekistan,UZB,Belgium,BEL,0,0,5,5,10
2004,Chad,TCD,Benin,BEN,0,0,14,0,14
2004,Congo,COG,Benin,BEN,0,0,10,0,10
2004,Dem. Rep. of the Congo,COD,Benin,BEN,0,0,25,0,25
2004,Cote d'Ivoire,CIV,Benin,BEN,0,0,11,0,11
2004,Liberia,LBR,Benin,BEN,5,0,0,0,5
2004,Nigeria,NGA,Benin,BEN,0,0,21,0,21
2004,Rwanda,RWA,Benin,BEN,5,0,0,0,5
2004,Togo,TGO,Benin,BEN,5,0,29,0,34
2004,Bangladesh,BGD,Cyprus,CYP,0,0,12,0,12
2004,Palestinian,PSE,Cyprus,CYP,0,0,0,14,14
2004,Iran (Islamic Rep. of),IRN,Cyprus,CYP,0,0,69,23,92
2004,Lebanon,LBN,Cyprus,CYP,0,0,0,5,5
2004,Rep. of Moldova,MDA,Cyprus,CYP,0,0,5,0,5
2004,Nigeria,NGA,Cyprus,CYP,0,0,5,0,5
2004,Pakistan,PAK,Cyprus,CYP,0,0,13,5,18
2004,Russian Federation,RUS,Cyprus,CYP,0,0,45,11,56
2004,Turkey,TUR,Cyprus,CYP,0,0,54,5,59
2004,Ukraine,UKR,Cyprus,CYP,0,0,17,5,22
2004,Algeria,DZA,Czechia,CZE,0,0,0,5,5
2004,Armenia,ARM,Czechia,CZE,0,0,5,5,10
2004,Georgia,GEO,Czechia,CZE,0,0,0,5,5
2004,North Macedonia,MKD,Czechia,CZE,0,0,0,5,5
2004,Rep. of Moldova,MDA,Czechia,CZE,0,0,0,33,33
2004,Russian Federation,RUS,Czechia,CZE,0,0,0,5,5
2004,Serbia and Kosovo: S/RES/1244 (1999),SRB,Czechia,CZE,0,0,5,12,17
2004,Ukraine,UKR,Czechia,CZE,0,0,5,12,17
2004,Afghanistan,AFG,Denmark,DNK,45,15,210,0,270
2004,Albania,ALB,Denmark,DNK,0,0,10,0,10
2004,Algeria,DZA,Denmark,DNK,0,0,5,0,5
2004,Armenia,ARM,Denmark,DNK,0,0,10,0,10
2004,Azerbaijan,AZE,Denmark,DNK,0,0,12,0,12
2004,Burundi,BDI,Denmark,DNK,0,0,16,0,16
2004,Bangladesh,BGD,Denmark,DNK,0,0,12,0,12
2004,Belarus,BLR,Denmark,DNK,0,0,5,0,5
2004,Brazil,BRA,Denmark,DNK,0,0,5,0,5
2004,Bosnia and Herzegovina,BIH,Denmark,DNK,0,0,30,0,30
2004,Bulgaria,BGR,Denmark,DNK,0,0,5,0,5
2004,China,CHN,Denmark,DNK,5,0,5,0,10
2004,Dem. Rep. of the Congo,COD,Denmark,DNK,0,0,5,0,5
2004,Palestinian,PSE,Denmark,DNK,48,0,59,0,107
2004,Georgia,GEO,Denmark,DNK,5,0,0,0,5
2004,Guinea,GIN,Denmark,DNK,0,0,5,0,5
2004,Hungary,HUN,Denmark,DNK,0,0,5,0,5
2004,Cote d'Ivoire,CIV,Denmark,DNK,0,0,5,0,5
2004,India,IND,Denmark,DNK,0,0,17,0,17
2004,Iran (Islamic Rep. of),IRN,Denmark,DNK,21,19,51,0,91
2004,Iraq,IRQ,Denmark,DNK,0,37,789,0,826
2004,Jordan,JOR,Denmark,DNK,0,0,5,0,5
2004,Liberia,LBR,Denmark,DNK,0,0,5,0,5
2004,Libya,LBY,Denmark,DNK,0,0,5,0,5
2004,Lebanon,LBN,Denmark,DNK,0,14,5,0,19
2004,Sri Lanka,LKA,Denmark,DNK,0,0,5,0,5
2004,Lithuania,LTU,Denmark,DNK,0,0,5,0,5
2004,North Macedonia,MKD,Denmark,DNK,0,0,25,0,25
2004,Myanmar,MMR,Denmark,DNK,5,0,0,0,5
2004,Nigeria,NGA,Denmark,DNK,0,0,13,0,13
2004,Pakistan,PAK,Denmark,DNK,0,0,27,0,27
2004,Romania,ROU,Denmark,DNK,0,0,5,0,5
2004,Russian Federation,RUS,Denmark,DNK,18,5,31,0,54
2004,Rwanda,RWA,Denmark,DNK,0,0,5,0,5
2004,Serbia and Kosovo: S/RES/1244 (1999),SRB,Denmark,DNK,0,14,134,0,148
2004,Somalia,SOM,Denmark,DNK,5,5,89,0,99
2004,Sudan,SDN,Denmark,DNK,0,0,5,0,5
2004,Syrian Arab Rep.,SYR,Denmark,DNK,10,5,19,0,34
2004,Turkey,TUR,Denmark,DNK,0,0,10,0,10
2004,Uganda,UGA,Denmark,DNK,0,0,5,0,5
2004,Ukraine,UKR,Denmark,DNK,0,0,5,0,5
2004,Stateless,XXA,Denmark,DNK,12,0,0,0,12
2004,Albania,ALB,France,FRA,112,0,176,29,317
2004,Algeria,DZA,France,FRA,74,0,720,241,1035
2004,Angola,AGO,France,FRA,214,0,1328,133,1675
2004,Armenia,ARM,France,FRA,199,0,481,52,732
2004,Azerbaijan,AZE,France,FRA,161,0,122,15,298
2004,Bangladesh,BGD,France,FRA,82,0,355,22,459
2004,Bosnia and Herzegovina,BIH,France,FRA,51,0,178,25,254
2004,Central African Rep.,CAF,France,FRA,28,0,201,85,314
2004,Chad,TCD,France,FRA,70,0,169,21,260
2004,China,CHN,France,FRA,11,0,2537,132,2680
2004,Cameroon,CMR,France,FRA,38,0,277,127,442
2004,Congo,COG,France,FRA,238,0,1253,430,1921
2004,Dem. Rep. of the Congo,COD,France,FRA,610,0,4642,611,5863
2004,Georgia,GEO,France,FRA,313,0,918,85,1316
2004,Guinea,GIN,France,FRA,91,0,505,80,676
2004,Haiti,HTI,France,FRA,60,0,507,139,706
2004,Cote d'Ivoire,CIV,France,FRA,112,0,431,144,687
2004,India,IND,France,FRA,17,0,330,44,391
2004,Sri Lanka,LKA,France,FRA,396,0,1131,106,1633
2004,Mauritania,MRT,France,FRA,480,0,2396,316,3192
2004,Rep. of Moldova,MDA,France,FRA,60,0,798,178,1036
2004,Mali,MLI,France,FRA,5,0,506,139,650
2004,Nigeria,NGA,France,FRA,29,0,564,207,800
2004,Pakistan,PAK,France,FRA,19,0,268,80,367
2004,Russian Federation,RUS,France,FRA,267,0,489,75,831
2004,Serbia and Kosovo: S/RES/1244 (1999),SRB,France,FRA,144,0,599,117,860
2004,Senegal,SEN,France,FRA,16,0,157,43,216
2004,Sierra Leone,SLE,France,FRA,21,0,305,98,424
2004,Togo,TGO,France,FRA,37,0,115,51,203
2004,Turkey,TUR,France,FRA,566,0,5075,756,6397
2004,Ukraine,UKR,France,FRA,55,0,315,60,430
2004,Afghanistan,AFG,Hungary,HUN,0,0,10,0,10
2004,Algeria,DZA,Hungary,HUN,0,0,20,0,20
2004,Angola,AGO,Hungary,HUN,0,0,5,0,5
2004,Armenia,ARM,Hungary,HUN,0,0,10,0,10
2004,Bangladesh,BGD,Hungary,HUN,0,0,10,0,10
2004,China,CHN,Hungary,HUN,0,0,64,0,64
2004,Palestinian,PSE,Hungary,HUN,0,0,5,0,5
2004,Georgia,GEO,Hungary,HUN,0,0,0,5,5
2004,India,IND,Hungary,HUN,0,0,5,0,5
2004,Iran (Islamic Rep. of),IRN,Hungary,HUN,0,0,14,0,14
2004,Iraq,IRQ,Hungary,HUN,0,0,15,0,15
2004,Liberia,LBR,Hungary,HUN,0,0,10,0,10
2004,Rep. of Moldova,MDA,Hungary,HUN,0,0,5,0,5
2004,Mongolia,MNG,Hungary,HUN,0,0,5,0,5
2004,Nigeria,NGA,Hungary,HUN,0,0,31,0,31
2004,Pakistan,PAK,Hungary,HUN,0,0,5,0,5
2004,Romania,ROU,Hungary,HUN,0,0,13,0,13
2004,Russian Federation,RUS,Hungary,HUN,0,0,5,0,5
2004,Serbia and Kosovo: S/RES/1244 (1999),SRB,Hungary,HUN,0,0,17,0,17
2004,Senegal,SEN,Hungary,HUN,0,0,5,0,5
2004,Sierra Leone,SLE,Hungary,HUN,0,0,5,0,5
2004,Viet Nam,VNM,Hungary,HUN,0,0,26,0,26
2004,Sudan,SDN,Hungary,HUN,0,0,5,0,5
2004,Slovakia,SVK,Hungary,HUN,0,0,5,0,5
2004,Syrian Arab Rep.,SYR,Hungary,HUN,0,0,5,0,5
2004,Turkey,TUR,Hungary,HUN,0,0,5,0,5
2004,Ukraine,UKR,Hungary,HUN,0,0,5,0,5
2004,Afghanistan,AFG,Ireland,IRL,5,0,11,0,16
2004,Albania,ALB,Ireland,IRL,38,0,85,5,128
2004,Algeria,DZA,Ireland,IRL,10,0,64,0,74
2004,Angola,AGO,Ireland,IRL,13,0,86,5,104
2004,Egypt,EGY,Ireland,IRL,0,0,12,0,12
2004,Armenia,ARM,Ireland,IRL,0,0,15,0,15
2004,Azerbaijan,AZE,Ireland,IRL,5,0,0,0,5
2004,Burundi,BDI,Ireland,IRL,0,0,22,0,22
2004,Benin,BEN,Ireland,IRL,0,0,5,0,5
2004,Bangladesh,BGD,Ireland,IRL,0,0,5,0,5
2004,Belarus,BLR,Ireland,IRL,10,0,13,0,23
2004,Brazil,BRA,Ireland,IRL,0,0,5,0,5
2004,Bosnia and Herzegovina,BIH,Ireland,IRL,0,0,10,0,10
2004,Bulgaria,BGR,Ireland,IRL,0,0,13,0,13
2004,China,CHN,Ireland,IRL,5,0,40,0,45
2004,Cameroon,CMR,Ireland,IRL,18,0,72,5,95
2004,Congo,COG,Ireland,IRL,0,0,12,0,12
2004,Dem. Rep. of the Congo,COD,Ireland,IRL,52,0,179,5,236
2004,Czechia,CZE,Ireland,IRL,18,0,104,10,132
2004,Eritrea,ERI,Ireland,IRL,13,0,5,0,18
2004,Estonia,EST,Ireland,IRL,0,0,19,5,24
2004,Ethiopia,ETH,Ireland,IRL,0,0,5,0,5
2004,Gambia,GMB,Ireland,IRL,0,0,5,0,5
2004,Palestinian,PSE,Ireland,IRL,16,0,5,0,21
2004,Georgia,GEO,Ireland,IRL,15,0,80,5,100
2004,Ghana,GHA,Ireland,IRL,12,0,158,5,175
2004,Guinea,GIN,Ireland,IRL,0,0,14,0,14
2004,Croatia,HRV,Ireland,IRL,63,0,105,0,168
2004,Cote d'Ivoire,CIV,Ireland,IRL,11,0,48,0,59
2004,India,IND,Ireland,IRL,0,0,5,0,5
2004,Iran (Islamic Rep. of),IRN,Ireland,IRL,5,0,10,0,15
2004,Iraq,IRQ,Ireland,IRL,21,0,43,0,64
2004,Israel,ISR,Ireland,IRL,5,0,32,5,42
2004,Jamaica,JAM,Ireland,IRL,0,0,11,0,11
2004,Kazakhstan,KAZ,Ireland,IRL,10,0,23,0,33
2004,Kenya,KEN,Ireland,IRL,13,0,42,0,55
2004,Kyrgyzstan,KGZ,Ireland,IRL,0,0,5,0,5
2004,Liberia,LBR,Ireland,IRL,5,0,75,5,85
2004,Libya,LBY,Ireland,IRL,0,0,5,0,5
2004,Lebanon,LBN,Ireland,IRL,0,0,5,0,5
2004,Sri Lanka,LKA,Ireland,IRL,0,0,5,0,5
2004,Lithuania,LTU,Ireland,IRL,10,0,44,5,59
2004,Latvia,LVA,Ireland,IRL,0,0,10,0,10
2004,North Macedonia,MKD,Ireland,IRL,5,0,5,0,10
2004,Rep. of Moldova,MDA,Ireland,IRL,35,0,189,0,224
2004,Malawi,MWI,Ireland,IRL,0,0,5,0,5
2004,Mongolia,MNG,Ireland,IRL,0,0,5,0,5
2004,Morocco,MAR,Ireland,IRL,0,0,5,0,5
2004,Mozambique,MOZ,Ireland,IRL,5,0,0,0,5
2004,Nigeria,NGA,Ireland,IRL,94,0,2669,105,2868
2004,Pakistan,PAK,Ireland,IRL,14,0,27,5,46
2004,Philippines,PHL,Ireland,IRL,5,0,0,0,5
2004,Poland,POL,Ireland,IRL,0,0,87,10,97
2004,Romania,ROU,Ireland,IRL,45,0,453,19,517
2004,South Africa,ZAF,Ireland,IRL,10,0,73,5,88
2004,Russian Federation,RUS,Ireland,IRL,23,0,74,5,102
2004,Rwanda,RWA,Ireland,IRL,0,0,19,0,19
2004,Serbia and Kosovo: S/RES/1244 (1999),SRB,Ireland,IRL,38,0,59,5,102
2004,Sierra Leone,SLE,Ireland,IRL,5,0,45,0,50
2004,Somalia,SOM,Ireland,IRL,10,0,51,0,61
2004,Sudan,SDN,Ireland,IRL,10,0,46,0,56
2004,Slovakia,SVK,Ireland,IRL,0,0,13,0,13
2004,Syrian Arab Rep.,SYR,Ireland,IRL,0,0,5,0,5
2004,Togo,TGO,Ireland,IRL,10,0,42,0,52
2004,Turkey,TUR,Ireland,IRL,0,0,11,0,11
2004,Uganda,UGA,Ireland,IRL,0,0,13,0,13
2004,Ukraine,UKR,Ireland,IRL,33,0,83,5,121
2004,United States of America,USA,Ireland,IRL,0,0,5,0,5
2004,Uzbekistan,UZB,Ireland,IRL,0,0,5,0,5
2004,Zimbabwe,ZWE,Ireland,IRL,24,0,59,5,88
2004,Stateless,XXA,Ireland,IRL,0,0,15,5,20
2004,Myanmar,MMR,Japan,JPN,5,0,30,0,35
2004,Turkey,TUR,Japan,JPN,0,0,47,0,47
2004,Afghanistan,AFG,Netherlands,NLD,37,20,54,67,178
2004,Albania,ALB,Netherlands,NLD,0,0,12,0,12
2004,Algeria,DZA,Netherlands,NLD,0,0,5,13,18
2004,Angola,AGO,Netherlands,NLD,5,13,129,77,224
2004,Egypt,EGY,Netherlands,NLD,0,0,0,5,5
2004,Armenia,ARM,Netherlands,NLD,0,5,60,30,95
2004,Azerbaijan,AZE,Netherlands,NLD,15,19,230,117,381
2004,Burundi,BDI,Netherlands,NLD,0,0,11,0,11
2004,Benin,BEN,Netherlands,NLD,0,0,5,5,10
2004,Bangladesh,BGD,Netherlands,NLD,0,0,5,0,5
2004,Burkina Faso,BFA,Netherlands,NLD,0,0,0,5,5
2004,Belarus,BLR,Netherlands,NLD,0,0,5,0,5
2004,Bosnia and Herzegovina,BIH,Netherlands,NLD,0,10,16,17,43
2004,China,CHN,Netherlands,NLD,0,0,77,42,119
2004,Cameroon,CMR,Netherlands,NLD,0,0,15,11,26
2004,Congo,COG,Netherlands,NLD,0,5,12,5,22
2004,Dem. Rep. of the Congo,COD,Netherlands,NLD,14,10,52,28,104
2004,Eritrea,ERI,Netherlands,NLD,0,5,18,5,28
2004,Ethiopia,ETH,Netherlands,NLD,5,5,13,5,28
2004,Georgia,GEO,Netherlands,NLD,0,10,21,12,43
2004,Ghana,GHA,Netherlands,NLD,0,0,5,0,5
2004,Guinea,GIN,Netherlands,NLD,5,11,64,24,104
2004,Croatia,HRV,Netherlands,NLD,0,0,13,0,13
2004,Cote d'Ivoire,CIV,Netherlands,NLD,0,0,5,5,10
2004,India,IND,Netherlands,NLD,5,0,0,0,5
2004,Indonesia,IDN,Netherlands,NLD,0,0,5,5,10
2004,Iran (Islamic Rep. of),IRN,Netherlands,NLD,27,33,100,65,225
2004,Iraq,IRQ,Netherlands,NLD,27,244,235,337,843
2004,Kazakhstan,KAZ,Netherlands,NLD,0,0,5,0,5
2004,Kenya,KEN,Netherlands,NLD,0,0,5,5,10
2004,Kyrgyzstan,KGZ,Netherlands,NLD,0,0,0,5,5
2004,Liberia,LBR,Netherlands,NLD,0,5,25,15,45
2004,Libya,LBY,Netherlands,NLD,0,0,5,5,10
2004,Lebanon,LBN,Netherlands,NLD,0,0,5,0,5
2004,Sri Lanka,LKA,Netherlands,NLD,0,5,17,0,22
2004,Mauritania,MRT,Netherlands,NLD,0,0,11,0,11
2004,Mongolia,MNG,Netherlands,NLD,0,0,11,5,16
2004,Netherlands,NLD,Netherlands,NLD,0,5,0,12,17
2004,Niger,NER,Netherlands,NLD,0,0,5,0,5
2004,Nigeria,NGA,Netherlands,NLD,5,0,13,12,30
2004,Pakistan,PAK,Netherlands,NLD,0,0,10,5,15
2004,Russian Federation,RUS,Netherlands,NLD,0,13,57,24,94
2004,Rwanda,RWA,Netherlands,NLD,5,10,15,17,47
2004,Serbia and Kosovo: S/RES/1244 (1999),SRB,Netherlands,NLD,19,26,115,80,240
2004,Sierra Leone,SLE,Netherlands,NLD,10,10,102,40,162
2004,Somalia,SOM,Netherlands,NLD,51,27,92,71,241
2004,Viet Nam,VNM,Netherlands,NLD,0,0,10,0,10
2004,Sudan,SDN,Netherlands,NLD,5,18,133,63,219
2004,Syrian Arab Rep.,SYR,Netherlands,NLD,37,28,55,33,153
2004,Tajikistan,TJK,Netherlands,NLD,0,5,0,0,5
2004,Togo,TGO,Netherlands,NLD,0,0,27,10,37
2004,Tunisia,TUN,Netherlands,NLD,0,0,0,5,5
2004,Turkey,TUR,Netherlands,NLD,0,5,61,41,107
2004,Uganda,UGA,Netherlands,NLD,0,0,0,5,5
2004,Ukraine,UKR,Netherlands,NLD,0,0,14,5,19
2004,Uzbekistan,UZB,Netherlands,NLD,0,0,15,0,15
2004,Yemen,YEM,Netherlands,NLD,0,0,10,0,10
2004,Stateless,XXA,Netherlands,NLD,0,11,56,34,101
2004,Afghanistan,AFG,Norway,NOR,0,5,95,0,100
2004,Albania,ALB,Norway,NOR,0,10,156,0,166
2004,Algeria,DZA,Norway,NOR,0,0,126,0,126
2004,Angola,AGO,Norway,NOR,0,0,10,0,10
2004,Egypt,EGY,Norway,NOR,0,0,5,0,5
2004,Armenia,ARM,Norway,NOR,0,10,63,0,73
2004,Azerbaijan,AZE,Norway,NOR,0,5,87,0,92
2004,Benin,BEN,Norway,NOR,0,0,5,0,5
2004,Bangladesh,BGD,Norway,NOR,0,5,45,0,50
2004,Belarus,BLR,Norway,NOR,0,5,152,0,157
2004,Bosnia and Herzegovina,BIH,Norway,NOR,0,22,171,0,193
2004,Bulgaria,BGR,Norway,NOR,0,0,34,0,34
2004,China,CHN,Norway,NOR,0,0,27,0,27
2004,Chile,CHL,Norway,NOR,0,0,5,0,5
2004,Cameroon,CMR,Norway,NOR,0,0,71,0,71
2004,Dem. Rep. of the Congo,COD,Norway,NOR,0,0,15,0,15
2004,Czechia,CZE,Norway,NOR,0,0,17,0,17
2004,Eritrea,ERI,Norway,NOR,0,28,35,0,63
2004,Estonia,EST,Norway,NOR,0,0,5,0,5
2004,Ethiopia,ETH,Norway,NOR,0,20,350,0,370
2004,Georgia,GEO,Norway,NOR,0,0,82,0,82
2004,Guatemala,GTM,Norway,NOR,0,0,5,0,5
2004,Guinea,GIN,Norway,NOR,0,0,24,0,24
2004,Croatia,HRV,Norway,NOR,0,5,19,0,24
2004,Hungary,HUN,Norway,NOR,0,0,5,0,5
2004,India,IND,Norway,NOR,0,0,39,0,39
2004,Iran (Islamic Rep. of),IRN,Norway,NOR,0,20,359,0,379
2004,Iraq,IRQ,Norway,NOR,0,68,668,0,736
2004,Israel,ISR,Norway,NOR,0,0,44,0,44
2004,Jordan,JOR,Norway,NOR,0,5,10,0,15
2004,Kazakhstan,KAZ,Norway,NOR,0,5,80,0,85
2004,Kenya,KEN,Norway,NOR,0,5,0,0,5
2004,Kyrgyzstan,KGZ,Norway,NOR,0,5,86,0,91
2004,Liberia,LBR,Norway,NOR,0,5,0,0,5
2004,Libya,LBY,Norway,NOR,0,0,156,0,156
2004,Lebanon,LBN,Norway,NOR,0,5,22,0,27
2004,Sri Lanka,LKA,Norway,NOR,0,12,59,0,71
2004,Lithuania,LTU,Norway,NOR,0,0,10,0,10
2004,Latvia,LVA,Norway,NOR,0,0,5,0,5
2004,North Macedonia,MKD,Norway,NOR,0,0,156,0,156
2004,Rep. of Moldova,MDA,Norway,NOR,0,0,38,0,38
2004,Mali,MLI,Norway,NOR,0,0,5,0,5
2004,Mongolia,MNG,Norway,NOR,0,0,38,0,38
2004,Morocco,MAR,Norway,NOR,0,0,10,0,10
2004,Nepal,NPL,Norway,NOR,0,0,60,0,60
2004,Niger,NER,Norway,NOR,0,0,78,0,78
2004,Nigeria,NGA,Norway,NOR,0,0,158,0,158
2004,Pakistan,PAK,Norway,NOR,5,0,145,0,150
2004,Romania,ROU,Norway,NOR,0,0,32,0,32
2004,Russian Federation,RUS,Norway,NOR,5,32,448,0,485
2004,Rwanda,RWA,Norway,NOR,0,0,5,0,5
2004,Serbia and Kosovo: S/RES/1244 (1999),SRB,Norway,NOR,40,273,1328,0,1641
2004,Sierra Leone,SLE,Norway,NOR,0,0,5,0,5
2004,Somalia,SOM,Norway,NOR,0,10,211,0,221
2004,Viet Nam,VNM,Norway,NOR,0,0,52,0,52
2004,Sudan,SDN,Norway,NOR,0,0,37,0,37
2004,Slovakia,SVK,Norway,NOR,0,0,10,0,10
2004,Syrian Arab Rep.,SYR,Norway,NOR,0,23,55,0,78
2004,Tajikistan,TJK,Norway,NOR,0,0,23,0,23
2004,Turkmenistan,TKM,Norway,NOR,0,0,5,0,5
2004,Togo,TGO,Norway,NOR,0,0,13,0,13
2004,Tunisia,TUN,Norway,NOR,0,0,5,0,5
2004,Turkey,TUR,Norway,NOR,0,21,195,0,216
2004,Uganda,UGA,Norway,NOR,0,0,5,0,5
2004,Ukraine,UKR,Norway,NOR,0,0,44,0,44
2004,Uzbekistan,UZB,Norway,NOR,0,5,117,0,122
2004,Yemen,YEM,Norway,NOR,0,0,5,0,5
2004,Stateless,XXA,Norway,NOR,0,10,298,0,308
2004,Afghanistan,AFG,New Zealand,NZL,0,0,5,0,5
2004,Albania,ALB,New Zealand,NZL,0,0,5,0,5
2004,Algeria,DZA,New Zealand,NZL,0,0,5,0,5
2004,Egypt,EGY,New Zealand,NZL,0,0,5,0,5
2004,Bangladesh,BGD,New Zealand,NZL,0,0,19,5,24
2004,Brazil,BRA,New Zealand,NZL,0,0,5,0,5
2004,Bulgaria,BGR,New Zealand,NZL,0,0,0,5,5
2004,China,CHN,New Zealand,NZL,5,0,28,5,38
2004,Chile,CHL,New Zealand,NZL,0,0,25,0,25
2004,Dem. Rep. of the Congo,COD,New Zealand,NZL,5,0,0,0,5
2004,Colombia,COL,New Zealand,NZL,5,0,0,0,5
2004,Czechia,CZE,New Zealand,NZL,15,0,16,10,41
2004,Eritrea,ERI,New Zealand,NZL,0,0,5,0,5
2004,Ethiopia,ETH,New Zealand,NZL,0,0,5,0,5
2004,Fiji,FJI,New Zealand,NZL,0,0,10,5,15
2004,Hungary,HUN,New Zealand,NZL,0,0,23,0,23
2004,India,IND,New Zealand,NZL,0,0,57,5,62
2004,Iran (Islamic Rep. of),IRN,New Zealand,NZL,43,0,30,0,73
2004,Iraq,IRQ,New Zealand,NZL,11,0,22,0,33
2004,Israel,ISR,New Zealand,NZL,5,0,5,0,10
2004,Jordan,JOR,New Zealand,NZL,0,0,5,0,5
2004,Kuwait,KWT,New Zealand,NZL,0,0,5,0,5
2004,Sri Lanka,LKA,New Zealand,NZL,5,0,27,5,37
2004,Malaysia,MYS,New Zealand,NZL,0,0,17,5,22
2004,Myanmar,MMR,New Zealand,NZL,5,0,0,0,5
2004,Nepal,NPL,New Zealand,NZL,5,0,0,0,5
2004,Nigeria,NGA,New Zealand,NZL,0,0,10,0,10
2004,Pakistan,PAK,New Zealand,NZL,0,0,12,5,17
2004,Peru,PER,New Zealand,NZL,0,0,5,0,5
2004,Russian Federation,RUS,New Zealand,NZL,0,0,10,0,10
2004,Sierra Leone,SLE,New Zealand,NZL,0,0,0,5,5
2004,Solomon Islands,SLB,New Zealand,NZL,0,0,5,0,5
2004,Viet Nam,VNM,New Zealand,NZL,0,0,12,0,12
2004,Thailand,THA,New Zealand,NZL,0,0,59,0,59
2004,Turkey,TUR,New Zealand,NZL,5,0,5,0,10
2004,Zimbabwe,ZWE,New Zealand,NZL,11,0,12,0,23
2004,Afghanistan,AFG,Poland,POL,0,0,18,0,18
2004,Algeria,DZA,Poland,POL,0,0,5,0,5
2004,Armenia,ARM,Poland,POL,0,0,15,0,15
2004,Belarus,BLR,Poland,POL,0,0,10,0,10
2004,Bulgaria,BGR,Poland,POL,0,0,5,0,5
2004,China,CHN,Poland,POL,0,0,15,0,15
2004,Palestinian,PSE,Poland,POL,0,0,5,0,5
2004,Georgia,GEO,Poland,POL,0,0,5,0,5
2004,Cote d'Ivoire,CIV,Poland,POL,0,0,5,0,5
2004,India,IND,Poland,POL,0,0,26,5,31
2004,Iran (Islamic Rep. of),IRN,Poland,POL,0,0,5,0,5
2004,Iraq,IRQ,Poland,POL,0,0,15,0,15
2004,Rep. of Moldova,MDA,Poland,POL,0,0,5,0,5
2004,Mongolia,MNG,Poland,POL,0,0,5,0,5
2004,Pakistan,PAK,Poland,POL,0,0,47,5,52
2004,Russian Federation,RUS,Poland,POL,10,0,401,62,473
2004,Serbia and Kosovo: S/RES/1244 (1999),SRB,Poland,POL,0,0,5,0,5
2004,Somalia,SOM,Poland,POL,0,0,5,0,5
2004,Viet Nam,VNM,Poland,POL,0,0,5,0,5
2004,Turkey,TUR,Poland,POL,0,0,10,0,10
2004,Ukraine,UKR,Poland,POL,0,0,18,5,23
2004,Uzbekistan,UZB,Poland,POL,0,0,5,0,5
2004,Afghanistan,AFG,Sweden,SWE,5,22,165,5,197
2004,Albania,ALB,Sweden,SWE,0,16,142,10,168
2004,Algeria,DZA,Sweden,SWE,0,0,161,10,171
2004,Angola,AGO,Sweden,SWE,0,0,15,0,15
2004,Egypt,EGY,Sweden,SWE,0,10,40,5,55
2004,Argentina,ARG,Sweden,SWE,0,0,5,0,5
2004,Armenia,ARM,Sweden,SWE,0,27,236,17,280
2004,Azerbaijan,AZE,Sweden,SWE,0,52,581,54,687
2004,Burundi,BDI,Sweden,SWE,0,0,15,0,15
2004,Benin,BEN,Sweden,SWE,0,0,5,0,5
2004,Bangladesh,BGD,Sweden,SWE,0,25,92,5,122
2004,Belarus,BLR,Sweden,SWE,0,13,501,67,581
2004,Bolivia (Plurinational State of),BOL,Sweden,SWE,0,5,255,38,298
2004,Brazil,BRA,Sweden,SWE,0,0,5,0,5
2004,Bosnia and Herzegovina,BIH,Sweden,SWE,0,206,703,19,928
2004,Bulgaria,BGR,Sweden,SWE,0,0,194,5,199
2004,Chad,TCD,Sweden,SWE,0,0,5,0,5
2004,China,CHN,Sweden,SWE,5,5,28,0,38
2004,Chile,CHL,Sweden,SWE,0,0,20,5,25
2004,Cameroon,CMR,Sweden,SWE,0,5,16,0,21
2004,Congo,COG,Sweden,SWE,0,0,5,0,5
2004,Dem. Rep. of the Congo,COD,Sweden,SWE,0,5,70,0,75
2004,Colombia,COL,Sweden,SWE,0,10,35,10,55
2004,Cuba,CUB,Sweden,SWE,0,5,12,0,17
2004,Ecuador,ECU,Sweden,SWE,0,10,117,10,137
2004,Eritrea,ERI,Sweden,SWE,5,30,244,16,295
2004,Estonia,EST,Sweden,SWE,0,0,5,0,5
2004,Ethiopia,ETH,Sweden,SWE,0,5,103,0,108
2004,Gabon,GAB,Sweden,SWE,0,0,5,0,5
2004,Gambia,GMB,Sweden,SWE,0,0,5,0,5
2004,Georgia,GEO,Sweden,SWE,0,16,373,30,419
2004,Ghana,GHA,Sweden,SWE,0,0,13,0,13
2004,Guinea,GIN,Sweden,SWE,0,5,16,0,21
2004,Honduras,HND,Sweden,SWE,0,0,11,0,11
2004,Croatia,HRV,Sweden,SWE,0,5,64,0,69
2004,Cote d'Ivoire,CIV,Sweden,SWE,0,0,20,5,25
2004,India,IND,Sweden,SWE,5,0,46,5,56
2004,Iran (Islamic Rep. of),IRN,Sweden,SWE,50,96,577,49,772
2004,Iraq,IRQ,Sweden,SWE,5,94,1170,160,1429
2004,Israel,ISR,Sweden,SWE,0,0,17,5,22
2004,Jordan,JOR,Sweden,SWE,0,12,76,14,102
2004,Kazakhstan,KAZ,Sweden,SWE,5,13,129,15,162
2004,Kenya,KEN,Sweden,SWE,0,0,10,0,10
2004,Kyrgyzstan,KGZ,Sweden,SWE,0,0,208,10,218
2004,Kiribati,KIR,Sweden,SWE,0,16,0,0,16
2004,Liberia,LBR,Sweden,SWE,0,0,21,0,21
2004,Libya,LBY,Sweden,SWE,0,5,164,24,193
2004,Lebanon,LBN,Sweden,SWE,0,17,276,20,313
2004,Sri Lanka,LKA,Sweden,SWE,0,0,17,0,17
2004,Lithuania,LTU,Sweden,SWE,0,0,5,5,10
2004,Latvia,LVA,Sweden,SWE,0,0,10,5,15
2004,Mauritania,MRT,Sweden,SWE,0,0,5,0,5
2004,North Macedonia,MKD,Sweden,SWE,0,20,300,5,325
2004,Rep. of Moldova,MDA,Sweden,SWE,0,0,48,5,53
2004,Mali,MLI,Sweden,SWE,0,0,5,0,5
2004,Malaysia,MYS,Sweden,SWE,0,5,5,0,10
2004,Mongolia,MNG,Sweden,SWE,0,10,167,5,182
2004,Morocco,MAR,Sweden,SWE,0,0,22,5,27
2004,Myanmar,MMR,Sweden,SWE,0,5,5,0,10
2004,Nepal,NPL,Sweden,SWE,5,0,5,0,10
2004,Niger,NER,Sweden,SWE,0,0,10,0,10
2004,Nigeria,NGA,Sweden,SWE,0,5,315,14,334
2004,Pakistan,PAK,Sweden,SWE,0,10,21,0,31
2004,Paraguay,PRY,Sweden,SWE,0,0,0,5,5
2004,Peru,PER,Sweden,SWE,0,10,85,10,105
2004,Philippines,PHL,Sweden,SWE,0,5,5,0,10
2004,Poland,POL,Sweden,SWE,0,0,5,5,10
2004,Romania,ROU,Sweden,SWE,0,0,98,0,98
2004,Russian Federation,RUS,Sweden,SWE,0,73,850,98,1021
2004,Rwanda,RWA,Sweden,SWE,0,0,15,0,15
2004,El Salvador,SLV,Sweden,SWE,0,0,14,0,14
2004,Saudi Arabia,SAU,Sweden,SWE,0,0,10,0,10
2004,Serbia and Kosovo: S/RES/1244 (1999),SRB,Sweden,SWE,38,310,2611,178,3137
2004,Senegal,SEN,Sweden,SWE,0,0,5,0,5
2004,Sierra Leone,SLE,Sweden,SWE,0,5,37,0,42
2004,Somalia,SOM,Sweden,SWE,14,32,453,36,535
2004,Viet Nam,VNM,Sweden,SWE,0,0,65,5,70
2004,Sudan,SDN,Sweden,SWE,0,0,28,5,33
2004,Slovakia,SVK,Sweden,SWE,0,0,26,0,26
2004,Sweden,SWE,Sweden,SWE,0,10,0,0,10
2004,Syrian Arab Rep.,SYR,Sweden,SWE,32,56,479,26,593
2004,United Rep. of Tanzania,TZA,Sweden,SWE,0,0,5,5,10
2004,Tajikistan,TJK,Sweden,SWE,5,0,43,0,48
2004,Turkmenistan,TKM,Sweden,SWE,0,0,12,0,12
2004,Togo,TGO,Sweden,SWE,0,0,5,0,5
2004,Tunisia,TUN,Sweden,SWE,0,0,38,14,52
2004,Turkey,TUR,Sweden,SWE,0,46,624,29,699
2004,Uganda,UGA,Sweden,SWE,0,0,29,0,29
2004,Ukraine,UKR,Sweden,SWE,0,16,285,20,321
2004,United States of America,USA,Sweden,SWE,0,0,5,0,5
2004,Uzbekistan,UZB,Sweden,SWE,0,33,368,5,406
2004,Venezuela (Bolivarian Republic of),VEN,Sweden,SWE,0,0,12,0,12
2004,Yemen,YEM,Sweden,SWE,0,0,47,0,47
2004,Stateless,XXA,Sweden,SWE,0,81,404,48,533
2004,Cote d'Ivoire,CIV,Togo,TGO,5,0,0,0,5
2004,Nigeria,NGA,Togo,TGO,5,0,0,0,5
2004,Rwanda,RWA,Togo,TGO,5,0,0,0,5
2004,Afghanistan,AFG,Ukraine,UKR,0,0,12,38,50
2004,Angola,AGO,Ukraine,UKR,0,0,5,21,26
2004,Armenia,ARM,Ukraine,UKR,0,0,5,5,10
2004,Bangladesh,BGD,Ukraine,UKR,0,0,96,19,115
2004,China,CHN,Ukraine,UKR,0,0,13,0,13
2004,Congo,COG,Ukraine,UKR,0,0,0,5,5
2004,Dem. Rep. of the Congo,COD,Ukraine,UKR,0,0,0,5,5
2004,Ethiopia,ETH,Ukraine,UKR,0,0,0,12,12
2004,Palestinian,PSE,Ukraine,UKR,0,0,5,5,10
2004,Georgia,GEO,Ukraine,UKR,0,0,0,10,10
2004,India,IND,Ukraine,UKR,0,0,29,5,34
2004,Iran (Islamic Rep. of),IRN,Ukraine,UKR,0,0,5,14,19
2004,Iraq,IRQ,Ukraine,UKR,0,0,5,13,18
2004,Lebanon,LBN,Ukraine,UKR,0,0,5,0,5
2004,Sri Lanka,LKA,Ukraine,UKR,0,0,0,14,14
2004,Nigeria,NGA,Ukraine,UKR,0,0,10,11,21
2004,Pakistan,PAK,Ukraine,UKR,0,0,12,5,17
2004,Russian Federation,RUS,Ukraine,UKR,0,0,5,20,25
2004,Somalia,SOM,Ukraine,UKR,0,0,17,10,27
2004,Syrian Arab Rep.,SYR,Ukraine,UKR,0,0,0,5,5
2004,Uganda,UGA,Ukraine,UKR,0,0,0,5,5
2005,Afghanistan,AFG,Azerbaijan,AZE,0,0,163,0,163
2005,Iran (Islamic Rep. of),IRN,Azerbaijan,AZE,0,0,10,0,10
2005,Iraq,IRQ,Azerbaijan,AZE,0,0,12,0,12
2005,Pakistan,PAK,Azerbaijan,AZE,0,0,19,0,19
2005,Tajikistan,TJK,Azerbaijan,AZE,0,0,5,0,5
2005,Afghanistan,AFG,Belgium,BEL,0,0,34,21,55
2005,Albania,ALB,Belgium,BEL,0,0,24,34,58
2005,Algeria,DZA,Belgium,BEL,0,0,17,17,34
2005,Angola,AGO,Belgium,BEL,0,0,13,10,23
2005,Armenia,ARM,Belgium,BEL,0,0,0,21,21
2005,Azerbaijan,AZE,Belgium,BEL,0,0,5,13,18
2005,Burundi,BDI,Belgium,BEL,0,0,0,12,12
2005,Bangladesh,BGD,Belgium,BEL,0,0,16,5,21
2005,Bhutan,BTN,Belgium,BEL,0,0,5,5,10
2005,Belarus,BLR,Belgium,BEL,0,0,14,5,19
2005,Bosnia and Herzegovina,BIH,Belgium,BEL,0,0,13,5,18
2005,Bulgaria,BGR,Belgium,BEL,0,0,0,27,27
2005,China,CHN,Belgium,BEL,5,0,151,11,167
2005,Cameroon,CMR,Belgium,BEL,0,0,33,33,66
2005,Dem. Rep. of the Congo,COD,Belgium,BEL,21,0,248,87,356
2005,Colombia,COL,Belgium,BEL,0,0,22,10,32
2005,Cuba,CUB,Belgium,BEL,0,0,5,0,5
2005,Ecuador,ECU,Belgium,BEL,0,0,0,5,5
2005,Georgia,GEO,Belgium,BEL,0,0,33,63,96
2005,Guinea,GIN,Belgium,BEL,0,0,5,12,17
2005,India,IND,Belgium,BEL,0,0,10,0,10
2005,Iran (Islamic Rep. of),IRN,Belgium,BEL,10,0,364,41,415
2005,Iraq,IRQ,Belgium,BEL,0,0,5,10,15
2005,Israel,ISR,Belgium,BEL,0,0,5,0,5
2005,Kazakhstan,KAZ,Belgium,BEL,0,0,5,53,58
2005,Kyrgyzstan,KGZ,Belgium,BEL,0,0,5,20,25
2005,Lebanon,LBN,Belgium,BEL,0,0,5,5,10
2005,Sri Lanka,LKA,Belgium,BEL,0,0,37,5,42
2005,Mauritania,MRT,Belgium,BEL,0,0,20,5,25
2005,North Macedonia,MKD,Belgium,BEL,0,0,5,0,5
2005,Rep. of Moldova,MDA,Belgium,BEL,0,0,0,16,16
2005,Myanmar,MMR,Belgium,BEL,0,0,5,0,5
2005,Nepal,NPL,Belgium,BEL,0,0,45,37,82
2005,Pakistan,PAK,Belgium,BEL,10,0,108,18,136
2005,Romania,ROU,Belgium,BEL,0,0,0,5,5
2005,Russian Federation,RUS,Belgium,BEL,579,0,95,171,845
2005,Rwanda,RWA,Belgium,BEL,10,0,14,5,29
2005,Serbia and Kosovo: S/RES/1244 (1999),SRB,Belgium,BEL,10,0,43,61,114
2005,Sierra Leone,SLE,Belgium,BEL,0,0,0,5,5
2005,Somalia,SOM,Belgium,BEL,5,0,5,0,10
2005,Sudan,SDN,Belgium,BEL,0,0,15,0,15
2005,Syrian Arab Rep.,SYR,Belgium,BEL,0,0,41,16,57
2005,Togo,TGO,Belgium,BEL,0,0,24,14,38
2005,Turkey,TUR,Belgium,BEL,12,0,91,74,177
2005,Ukraine,UKR,Belgium,BEL,0,0,5,13,18
2005,Uzbekistan,UZB,Belgium,BEL,0,0,0,23,23
2005,Togo,TGO,Benin,BEN,0,0,5,0,5
2005,Cuba,CUB,Colombia,COL,0,0,5,0,5
2005,Peru,PER,Colombia,COL,0,0,5,0,5
2005,Venezuela (Bolivarian Republic of),VEN,Colombia,COL,0,0,5,0,5
2005,Afghanistan,AFG,Cyprus,CYP,0,0,0,5,5
2005,Bangladesh,BGD,Cyprus,CYP,0,0,790,36,826
2005,Burkina Faso,BFA,Cyprus,CYP,0,0,0,5,5
2005,Belarus,BLR,Cyprus,CYP,0,0,5,0,5
2005,China,CHN,Cyprus,CYP,0,0,5,0,5
2005,Dem. Rep. of the Congo,COD,Cyprus,CYP,0,0,5,0,5
2005,Palestinian,PSE,Cyprus,CYP,0,0,15,0,15
2005,Georgia,GEO,Cyprus,CYP,0,0,15,5,20
2005,Cote d'Ivoire,CIV,Cyprus,CYP,0,0,0,5,5
2005,India,IND,Cyprus,CYP,0,0,0,12,12
2005,Iran (Islamic Rep. of),IRN,Cyprus,CYP,0,5,141,5,151
2005,Lebanon,LBN,Cyprus,CYP,0,0,5,0,5
2005,Sri Lanka,LKA,Cyprus,CYP,0,0,0,5,5
2005,Rep. of Moldova,MDA,Cyprus,CYP,0,0,5,0,5
2005,Pakistan,PAK,Cyprus,CYP,0,0,101,22,123
2005,Russian Federation,RUS,Cyprus,CYP,0,0,29,5,34
2005,Syrian Arab Rep.,SYR,Cyprus,CYP,0,0,5,0,5
2005,Turkey,TUR,Cyprus,CYP,0,10,71,11,92
2005,Ukraine,UKR,Cyprus,CYP,0,0,23,5,28
2005,Afghanistan,AFG,Denmark,DNK,19,15,120,0,154
2005,Albania,ALB,Denmark,DNK,0,0,10,0,10
2005,Algeria,DZA,Denmark,DNK,0,0,5,0,5
2005,Azerbaijan,AZE,Denmark,DNK,0,0,11,0,11
2005,Burundi,BDI,Denmark,DNK,0,0,12,0,12
2005,Bangladesh,BGD,Denmark,DNK,0,0,5,0,5
2005,Bosnia and Herzegovina,BIH,Denmark,DNK,0,0,5,0,5
2005,China,CHN,Denmark,DNK,0,0,13,0,13
2005,Dem. Rep. of the Congo,COD,Denmark,DNK,0,0,5,0,5
2005,Eritrea,ERI,Denmark,DNK,0,0,5,0,5
2005,Palestinian,PSE,Denmark,DNK,12,0,41,0,53
2005,Guinea,GIN,Denmark,DNK,0,0,5,0,5
2005,India,IND,Denmark,DNK,0,0,12,0,12
2005,Iran (Islamic Rep. of),IRN,Denmark,DNK,19,19,36,0,74
2005,Iraq,IRQ,Denmark,DNK,0,16,221,0,237
2005,Kyrgyzstan,KGZ,Denmark,DNK,0,0,5,0,5
2005,Lebanon,LBN,Denmark,DNK,0,0,5,0,5
2005,Sri Lanka,LKA,Denmark,DNK,0,0,10,0,10
2005,Rep. of Moldova,MDA,Denmark,DNK,0,0,5,0,5
2005,Morocco,MAR,Denmark,DNK,0,0,5,0,5
2005,Nigeria,NGA,Denmark,DNK,0,0,20,0,20
2005,Pakistan,PAK,Denmark,DNK,0,0,5,0,5
2005,Russian Federation,RUS,Denmark,DNK,5,5,23,0,33
2005,Rwanda,RWA,Denmark,DNK,5,0,0,0,5
2005,Serbia and Kosovo: S/RES/1244 (1999),SRB,Denmark,DNK,0,0,99,0,99
2005,Sierra Leone,SLE,Denmark,DNK,0,0,5,0,5
2005,Somalia,SOM,Denmark,DNK,0,5,49,0,54
2005,Sudan,SDN,Denmark,DNK,0,0,5,0,5
2005,Syrian Arab Rep.,SYR,Denmark,DNK,5,0,15,0,20
2005,Togo,TGO,Denmark,DNK,0,0,5,0,5
2005,Turkey,TUR,Denmark,DNK,0,0,10,0,10
2005,Albania,ALB,France,FRA,207,0,272,47,526
2005,Algeria,DZA,France,FRA,214,0,1625,371,2210
2005,Angola,AGO,France,FRA,317,0,1213,137,1667
2005,Armenia,ARM,France,FRA,536,0,932,128,1596
2005,Azerbaijan,AZE,France,FRA,359,0,323,49,731
2005,Bangladesh,BGD,France,FRA,342,0,921,123,1386
2005,Bosnia and Herzegovina,BIH,France,FRA,80,0,398,103,581
2005,Central African Rep.,CAF,France,FRA,41,0,213,44,298
2005,Chad,TCD,France,FRA,97,0,164,29,290
2005,China,CHN,France,FRA,33,0,4764,1619,6416
2005,Congo,COG,France,FRA,404,0,1708,322,2434
2005,Dem. Rep. of the Congo,COD,France,FRA,826,0,4765,474,6065
2005,Georgia,GEO,France,FRA,558,0,1520,218,2296
2005,Guinea,GIN,France,FRA,228,0,903,160,1291
2005,Haiti,HTI,France,FRA,209,0,1613,723,2545
2005,India,IND,France,FRA,34,0,826,193,1053
2005,Sri Lanka,LKA,France,FRA,899,0,2512,200,3611
2005,Madagascar,MDG,France,FRA,37,0,222,31,290
2005,Mauritania,MRT,France,FRA,375,0,1535,309,2219
2005,North Macedonia,MKD,France,FRA,50,0,199,35,284
2005,Rep. of Moldova,MDA,France,FRA,85,0,1165,1046,2296
2005,Mali,MLI,France,FRA,16,0,614,303,933
2005,Mongolia,MNG,France,FRA,86,0,490,97,673
2005,Nigeria,NGA,France,FRA,130,0,1170,456,1756
2005,Pakistan,PAK,France,FRA,46,0,715,226,987
2005,Russian Federation,RUS,France,FRA,736,0,1015,130,1881
2005,Serbia and Kosovo: S/RES/1244 (1999),SRB,France,FRA,542,0,1213,373,2128
2005,Sierra Leone,SLE,France,FRA,23,0,285,83,391
2005,Turkey,TUR,France,FRA,789,0,4419,1368,6576
2005,Ukraine,UKR,France,FRA,76,0,473,188,737
2005,Afghanistan,AFG,Hungary,HUN,0,0,5,5,10
2005,Algeria,DZA,Hungary,HUN,0,0,19,5,24
2005,Angola,AGO,Hungary,HUN,0,0,5,0,5
2005,Armenia,ARM,Hungary,HUN,0,0,5,5,10
2005,Bangladesh,BGD,Hungary,HUN,0,0,5,0,5
2005,China,CHN,Hungary,HUN,0,0,26,10,36
2005,Cameroon,CMR,Hungary,HUN,0,0,5,0,5
2005,Congo,COG,Hungary,HUN,0,0,5,5,10
2005,Gambia,GMB,Hungary,HUN,0,0,5,0,5
2005,Palestinian,PSE,Hungary,HUN,0,0,0,5,5
2005,Georgia,GEO,Hungary,HUN,0,0,11,10,21
2005,Guinea-Bissau,GNB,Hungary,HUN,0,0,5,0,5
2005,Cote d'Ivoire,CIV,Hungary,HUN,0,0,0,5,5
2005,India,IND,Hungary,HUN,0,0,0,5,5
2005,Iraq,IRQ,Hungary,HUN,0,0,10,0,10
2005,Jordan,JOR,Hungary,HUN,0,0,5,5,10
2005,Liberia,LBR,Hungary,HUN,0,0,0,5,5
2005,Mongolia,MNG,Hungary,HUN,0,0,5,0,5
2005,Nepal,NPL,Hungary,HUN,0,0,5,0,5
2005,Nigeria,NGA,Hungary,HUN,0,0,27,10,37
2005,Pakistan,PAK,Hungary,HUN,0,0,0,5,5
2005,Romania,ROU,Hungary,HUN,0,0,5,5,10
2005,Russian Federation,RUS,Hungary,HUN,0,0,12,0,12
2005,Serbia and Kosovo: S/RES/1244 (1999),SRB,Hungary,HUN,0,5,21,11,37
2005,Senegal,SEN,Hungary,HUN,0,0,5,0,5
2005,Sierra Leone,SLE,Hungary,HUN,0,0,5,0,5
2005,Somalia,SOM,Hungary,HUN,0,0,5,0,5
2005,Viet Nam,VNM,Hungary,HUN,0,0,118,19,137
2005,Slovakia,SVK,Hungary,HUN,0,0,10,0,10
2005,Syrian Arab Rep.,SYR,Hungary,HUN,0,5,5,0,10
2005,Tunisia,TUN,Hungary,HUN,0,0,5,0,5
2005,Turkey,TUR,Hungary,HUN,0,0,16,5,21
2005,Ukraine,UKR,Hungary,HUN,0,0,11,0,11
2005,Afghanistan,AFG,Iceland,ISL,0,0,5,0,5
2005,Algeria,DZA,Iceland,ISL,0,0,5,0,5
2005,Kazakhstan,KAZ,Iceland,ISL,0,0,5,0,5
2005,China,CHN,Japan,JPN,0,0,5,0,5
2005,Myanmar,MMR,Japan,JPN,14,38,76,5,133
2005,Turkey,TUR,Japan,JPN,0,0,35,5,40
2005,Bhutan,BTN,Nepal,NPL,0,89,11,0,100
2005,Afghanistan,AFG,Netherlands,NLD,0,42,34,186,262
2005,Albania,ALB,Netherlands,NLD,0,0,0,5,5
2005,Algeria,DZA,Netherlands,NLD,0,5,0,11,16
2005,Angola,AGO,Netherlands,NLD,0,19,33,260,312
2005,Egypt,EGY,Netherlands,NLD,0,0,0,5,5
2005,Armenia,ARM,Netherlands,NLD,0,50,44,135,229
2005,Azerbaijan,AZE,Netherlands,NLD,0,114,85,405,604
2005,Burundi,BDI,Netherlands,NLD,0,0,5,10,15
2005,Benin,BEN,Netherlands,NLD,0,0,0,5,5
2005,Bangladesh,BGD,Netherlands,NLD,0,0,0,5,5
2005,Burkina Faso,BFA,Netherlands,NLD,0,0,0,10,10
2005,Belarus,BLR,Netherlands,NLD,0,0,0,5,5
2005,Bosnia and Herzegovina,BIH,Netherlands,NLD,0,15,5,58,78
2005,Chad,TCD,Netherlands,NLD,0,5,0,0,5
2005,China,CHN,Netherlands,NLD,0,5,21,146,172
2005,Cameroon,CMR,Netherlands,NLD,0,5,0,15,20
2005,Congo,COG,Netherlands,NLD,0,5,5,18,28
2005,Dem. Rep. of the Congo,COD,Netherlands,NLD,0,25,13,100,138
2005,Eritrea,ERI,Netherlands,NLD,0,5,5,23,33
2005,Ethiopia,ETH,Netherlands,NLD,0,5,5,34,44
2005,Georgia,GEO,Netherlands,NLD,0,5,5,34,44
2005,Guinea,GIN,Netherlands,NLD,0,11,26,121,158
2005,Croatia,HRV,Netherlands,NLD,0,0,0,5,5
2005,Cote d'Ivoire,CIV,Netherlands,NLD,0,0,0,12,12
2005,Iran (Islamic Rep. of),IRN,Netherlands,NLD,0,52,23,140,215
2005,Iraq,IRQ,Netherlands,NLD,0,343,82,774,1199
2005,Kazakhstan,KAZ,Netherlands,NLD,0,11,0,22,33
2005,Kyrgyzstan,KGZ,Netherlands,NLD,0,5,5,15,25
2005,Liberia,LBR,Netherlands,NLD,0,5,5,25,35
2005,Libya,LBY,Netherlands,NLD,0,0,0,5,5
2005,Lebanon,LBN,Netherlands,NLD,0,0,0,5,5
2005,Sri Lanka,LKA,Netherlands,NLD,0,5,0,27,32
2005,Mauritania,MRT,Netherlands,NLD,0,0,0,18,18
2005,Rep. of Moldova,MDA,Netherlands,NLD,0,0,0,5,5
2005,Mongolia,MNG,Netherlands,NLD,0,0,5,14,19
2005,Myanmar,MMR,Netherlands,NLD,0,0,0,10,10
2005,Niger,NER,Netherlands,NLD,0,0,0,5,5
2005,Nigeria,NGA,Netherlands,NLD,0,5,5,21,31
2005,Pakistan,PAK,Netherlands,NLD,0,0,5,20,25
2005,Russian Federation,RUS,Netherlands,NLD,0,38,44,145,227
2005,Rwanda,RWA,Netherlands,NLD,0,17,5,86,108
2005,Serbia and Kosovo: S/RES/1244 (1999),SRB,Netherlands,NLD,0,37,54,165,256
2005,Senegal,SEN,Netherlands,NLD,0,0,0,5,5
2005,Sierra Leone,SLE,Netherlands,NLD,0,10,18,134,162
2005,Somalia,SOM,Netherlands,NLD,0,83,39,232,354
2005,Viet Nam,VNM,Netherlands,NLD,0,0,0,5,5
2005,Sudan,SDN,Netherlands,NLD,0,40,49,171,260
2005,Slovakia,SVK,Netherlands,NLD,0,0,10,10,20
2005,Syrian Arab Rep.,SYR,Netherlands,NLD,0,32,24,100,156
2005,Tajikistan,TJK,Netherlands,NLD,0,0,5,0,5
2005,Togo,TGO,Netherlands,NLD,0,0,5,36,41
2005,Tunisia,TUN,Netherlands,NLD,0,0,0,10,10
2005,Turkey,TUR,Netherlands,NLD,0,12,16,67,95
2005,Uganda,UGA,Netherlands,NLD,0,0,0,5,5
2005,Ukraine,UKR,Netherlands,NLD,0,5,5,11,21
2005,Uzbekistan,UZB,Netherlands,NLD,0,5,0,11,16
2005,Yemen,YEM,Netherlands,NLD,0,0,0,5,5
2005,Zimbabwe,ZWE,Netherlands,NLD,0,5,0,0,5
2005,Stateless,XXA,Netherlands,NLD,0,18,59,107,184
2005,Dem. Rep. of the Congo,COD,Niger,NER,0,0,5,0,5
2005,Afghanistan,AFG,Norway,NOR,0,16,390,0,406
2005,Albania,ALB,Norway,NOR,5,5,124,0,134
2005,Algeria,DZA,Norway,NOR,0,0,122,0,122
2005,Angola,AGO,Norway,NOR,0,0,23,0,23
2005,Egypt,EGY,Norway,NOR,0,0,5,0,5
2005,Armenia,ARM,Norway,NOR,0,0,17,0,17
2005,Azerbaijan,AZE,Norway,NOR,0,15,58,0,73
2005,Burundi,BDI,Norway,NOR,0,0,10,0,10
2005,Benin,BEN,Norway,NOR,0,0,5,0,5
2005,Bangladesh,BGD,Norway,NOR,0,0,19,0,19
2005,Belarus,BLR,Norway,NOR,0,0,35,0,35
2005,Bosnia and Herzegovina,BIH,Norway,NOR,0,5,162,0,167
2005,Bulgaria,BGR,Norway,NOR,0,0,10,0,10
2005,China,CHN,Norway,NOR,0,0,22,0,22
2005,Cameroon,CMR,Norway,NOR,0,5,58,0,63
2005,Dem. Rep. of the Congo,COD,Norway,NOR,0,13,5,0,18
2005,Colombia,COL,Norway,NOR,0,0,10,0,10
2005,Cabo Verde,CPV,Norway,NOR,0,0,5,0,5
2005,Czechia,CZE,Norway,NOR,0,0,10,0,10
2005,Eritrea,ERI,Norway,NOR,5,166,44,0,215
2005,Ethiopia,ETH,Norway,NOR,10,32,166,0,208
2005,Georgia,GEO,Norway,NOR,0,5,22,0,27
2005,Ghana,GHA,Norway,NOR,0,0,10,0,10
2005,Guinea,GIN,Norway,NOR,0,5,29,0,34
2005,Croatia,HRV,Norway,NOR,0,5,25,0,30
2005,Hungary,HUN,Norway,NOR,0,0,10,0,10
2005,Cote d'Ivoire,CIV,Norway,NOR,0,0,10,0,10
2005,India,IND,Norway,NOR,0,0,11,0,11
2005,Iran (Islamic Rep. of),IRN,Norway,NOR,0,5,393,0,398
2005,Iraq,IRQ,Norway,NOR,0,5,646,0,651
2005,Israel,ISR,Norway,NOR,0,0,30,0,30
2005,Jordan,JOR,Norway,NOR,0,0,10,0,10
2005,Kazakhstan,KAZ,Norway,NOR,0,5,16,0,21
2005,Kyrgyzstan,KGZ,Norway,NOR,0,0,34,0,34
2005,Kuwait,KWT,Norway,NOR,0,0,5,0,5
2005,Liberia,LBR,Norway,NOR,0,5,44,0,49
2005,Libya,LBY,Norway,NOR,0,0,156,0,156
2005,Lebanon,LBN,Norway,NOR,0,0,36,0,36
2005,Sri Lanka,LKA,Norway,NOR,0,10,77,0,87
2005,Lithuania,LTU,Norway,NOR,0,0,5,0,5
2005,Latvia,LVA,Norway,NOR,0,0,5,0,5
2005,Mauritania,MRT,Norway,NOR,0,0,10,0,10
2005,North Macedonia,MKD,Norway,NOR,0,0,76,0,76
2005,Rep. of Moldova,MDA,Norway,NOR,0,0,10,0,10
2005,Mongolia,MNG,Norway,NOR,0,0,26,0,26
2005,Morocco,MAR,Norway,NOR,0,0,15,0,15
2005,Nepal,NPL,Norway,NOR,0,0,30,0,30
2005,Niger,NER,Norway,NOR,0,0,14,0,14
2005,Nigeria,NGA,Norway,NOR,0,5,185,0,190
2005,Pakistan,PAK,Norway,NOR,0,11,126,0,137
2005,Poland,POL,Norway,NOR,0,0,5,0,5
2005,Romania,ROU,Norway,NOR,0,0,13,0,13
2005,Russian Federation,RUS,Norway,NOR,5,49,349,0,403
2005,Rwanda,RWA,Norway,NOR,0,0,23,0,23
2005,Serbia and Kosovo: S/RES/1244 (1999),SRB,Norway,NOR,28,94,889,0,1011
2005,Senegal,SEN,Norway,NOR,0,0,5,0,5
2005,Sierra Leone,SLE,Norway,NOR,0,5,54,0,59
2005,Somalia,SOM,Norway,NOR,10,26,233,0,269
2005,Viet Nam,VNM,Norway,NOR,0,0,10,0,10
2005,Sudan,SDN,Norway,NOR,0,0,32,0,32
2005,Suriname,SUR,Norway,NOR,0,0,5,0,5
2005,Syrian Arab Rep.,SYR,Norway,NOR,0,5,71,0,76
2005,Tajikistan,TJK,Norway,NOR,0,0,10,0,10
2005,Togo,TGO,Norway,NOR,0,0,5,0,5
2005,Tunisia,TUN,Norway,NOR,0,0,5,0,5
2005,Turkey,TUR,Norway,NOR,0,0,90,0,90
2005,Uganda,UGA,Norway,NOR,0,0,5,0,5
2005,Ukraine,UKR,Norway,NOR,0,14,25,0,39
2005,Uzbekistan,UZB,Norway,NOR,5,0,56,0,61
2005,Western Sahara,ESH,Norway,NOR,0,0,11,0,11
2005,Yemen,YEM,Norway,NOR,0,0,12,0,12
2005,Afghanistan,AFG,New Zealand,NZL,0,0,0,5,5
2005,Albania,ALB,New Zealand,NZL,0,0,5,0,5
2005,Algeria,DZA,New Zealand,NZL,5,0,0,0,5
2005,Bangladesh,BGD,New Zealand,NZL,0,0,29,5,34
2005,Brazil,BRA,New Zealand,NZL,0,0,5,0,5
2005,China,CHN,New Zealand,NZL,11,0,13,0,24
2005,Chile,CHL,New Zealand,NZL,0,0,25,5,30
2005,Congo,COG,New Zealand,NZL,5,0,5,0,10
2005,Czechia,CZE,New Zealand,NZL,18,0,17,5,40
2005,Palestinian,PSE,New Zealand,NZL,5,0,0,0,5
2005,Hungary,HUN,New Zealand,NZL,0,0,5,5,10
2005,India,IND,New Zealand,NZL,0,0,81,10,91
2005,Iran (Islamic Rep. of),IRN,New Zealand,NZL,19,0,26,5,50
2005,Iraq,IRQ,New Zealand,NZL,14,0,5,0,19
2005,Israel,ISR,New Zealand,NZL,0,0,5,0,5
2005,Jordan,JOR,New Zealand,NZL,5,0,15,0,20
2005,Kyrgyzstan,KGZ,New Zealand,NZL,5,0,0,0,5
2005,Lebanon,LBN,New Zealand,NZL,5,0,0,0,5
2005,Sri Lanka,LKA,New Zealand,NZL,5,0,31,5,41
2005,Malaysia,MYS,New Zealand,NZL,0,0,5,0,5
2005,Myanmar,MMR,New Zealand,NZL,0,0,5,0,5
2005,Nepal,NPL,New Zealand,NZL,5,0,5,0,10
2005,Nigeria,NGA,New Zealand,NZL,0,0,10,0,10
2005,Pakistan,PAK,New Zealand,NZL,5,0,12,0,17
2005,Peru,PER,New Zealand,NZL,0,0,5,0,5
2005,South Africa,ZAF,New Zealand,NZL,0,0,12,0,12
2005,Russian Federation,RUS,New Zealand,NZL,0,0,5,0,5
2005,Saudi Arabia,SAU,New Zealand,NZL,0,0,0,5,5
2005,Serbia and Kosovo: S/RES/1244 (1999),SRB,New Zealand,NZL,5,0,0,0,5
2005,Somalia,SOM,New Zealand,NZL,5,0,0,0,5
2005,Viet Nam,VNM,New Zealand,NZL,0,0,5,0,5
2005,Sudan,SDN,New Zealand,NZL,0,0,10,0,10
2005,Syrian Arab Rep.,SYR,New Zealand,NZL,0,0,5,0,5
2005,Thailand,THA,New Zealand,NZL,0,0,5,0,5
2005,Turkey,TUR,New Zealand,NZL,0,0,5,0,5
2005,Zimbabwe,ZWE,New Zealand,NZL,12,0,0,0,12
2005,Armenia,ARM,Poland,POL,0,0,5,0,5
2005,Belarus,BLR,Poland,POL,0,0,13,0,13
2005,Bulgaria,BGR,Poland,POL,0,0,11,0,11
2005,Georgia,GEO,Poland,POL,0,0,13,0,13
2005,India,IND,Poland,POL,0,0,5,0,5
2005,Kazakhstan,KAZ,Poland,POL,0,0,10,0,10
2005,Rep. of Moldova,MDA,Poland,POL,0,0,5,0,5
2005,Pakistan,PAK,Poland,POL,0,0,10,0,10
2005,Russian Federation,RUS,Poland,POL,23,23,253,155,454
2005,Turkmenistan,TKM,Poland,POL,0,0,5,0,5
2005,Turkey,TUR,Poland,POL,0,0,5,0,5
2005,Ukraine,UKR,Poland,POL,0,0,33,10,43
2005,Uzbekistan,UZB,Poland,POL,0,0,5,0,5
2005,Afghanistan,AFG,Sweden,SWE,5,77,757,50,889
2005,Albania,ALB,Sweden,SWE,0,21,294,5,320
2005,Algeria,DZA,Sweden,SWE,0,5,194,15,214
2005,Angola,AGO,Sweden,SWE,0,0,151,5,156
2005,Egypt,EGY,Sweden,SWE,5,5,76,10,96
2005,Armenia,ARM,Sweden,SWE,0,31,636,30,697
2005,Azerbaijan,AZE,Sweden,SWE,0,93,2265,61,2419
2005,Bahrain,BHR,Sweden,SWE,0,0,0,5,5
2005,Burundi,BDI,Sweden,SWE,0,0,33,0,33
2005,Benin,BEN,Sweden,SWE,0,0,10,0,10
2005,Bangladesh,BGD,Sweden,SWE,0,38,188,5,231
2005,Burkina Faso,BFA,Sweden,SWE,0,0,10,0,10
2005,Belarus,BLR,Sweden,SWE,0,10,630,29,669
2005,Bolivia (Plurinational State of),BOL,Sweden,SWE,0,0,252,35,287
2005,Bosnia and Herzegovina,BIH,Sweden,SWE,0,82,832,10,924
2005,Bulgaria,BGR,Sweden,SWE,0,0,254,20,274
2005,Cambodia,KHM,Sweden,SWE,0,0,5,0,5
2005,Chad,TCD,Sweden,SWE,0,0,5,0,5
2005,China,CHN,Sweden,SWE,11,0,135,5,151
2005,Chile,CHL,Sweden,SWE,0,10,26,0,36
2005,Cameroon,CMR,Sweden,SWE,0,0,55,0,55
2005,Congo,COG,Sweden,SWE,0,5,11,0,16
2005,Dem. Rep. of the Congo,COD,Sweden,SWE,0,10,129,0,139
2005,Colombia,COL,Sweden,SWE,5,10,46,5,66
2005,Cuba,CUB,Sweden,SWE,0,5,25,0,30
2005,Czechia,CZE,Sweden,SWE,0,0,5,0,5
2005,Ecuador,ECU,Sweden,SWE,0,0,68,5,73
2005,Eritrea,ERI,Sweden,SWE,5,218,262,10,495
2005,Estonia,EST,Sweden,SWE,0,5,0,0,5
2005,Ethiopia,ETH,Sweden,SWE,0,14,219,5,238
2005,Gambia,GMB,Sweden,SWE,0,0,11,5,16
2005,Georgia,GEO,Sweden,SWE,0,19,265,12,296
2005,Ghana,GHA,Sweden,SWE,0,0,21,0,21
2005,Guatemala,GTM,Sweden,SWE,0,0,5,0,5
2005,Guinea,GIN,Sweden,SWE,0,5,46,0,51
2005,Honduras,HND,Sweden,SWE,0,0,10,0,10
2005,Croatia,HRV,Sweden,SWE,10,0,126,17,153
2005,Hungary,HUN,Sweden,SWE,0,0,5,0,5
2005,Cote d'Ivoire,CIV,Sweden,SWE,0,10,53,0,63
2005,India,IND,Sweden,SWE,0,10,101,5,116
2005,Iran (Islamic Rep. of),IRN,Sweden,SWE,15,44,1145,48,1252
2005,Iraq,IRQ,Sweden,SWE,0,440,4581,110,5131
2005,Israel,ISR,Sweden,SWE,0,0,18,5,23
2005,Jordan,JOR,Sweden,SWE,0,16,233,42,291
2005,Kazakhstan,KAZ,Sweden,SWE,0,13,195,5,213
2005,Kenya,KEN,Sweden,SWE,0,0,22,0,22
2005,Kyrgyzstan,KGZ,Sweden,SWE,0,43,237,10,290
2005,Kuwait,KWT,Sweden,SWE,0,0,5,0,5
2005,Lao People's Dem. Rep.,LAO,Sweden,SWE,0,0,5,0,5
2005,Liberia,LBR,Sweden,SWE,0,0,15,5,20
2005,Libya,LBY,Sweden,SWE,5,51,394,22,472
2005,Lebanon,LBN,Sweden,SWE,5,28,589,31,653
2005,Sri Lanka,LKA,Sweden,SWE,0,0,41,5,46
2005,Lithuania,LTU,Sweden,SWE,0,5,0,0,5
2005,Latvia,LVA,Sweden,SWE,0,0,10,0,10
2005,Mauritania,MRT,Sweden,SWE,0,0,10,0,10
2005,North Macedonia,MKD,Sweden,SWE,0,28,274,5,307
2005,Rep. of Moldova,MDA,Sweden,SWE,0,0,35,5,40
2005,Mongolia,MNG,Sweden,SWE,0,5,170,5,180
2005,Morocco,MAR,Sweden,SWE,0,5,31,0,36
2005,Myanmar,MMR,Sweden,SWE,0,0,10,0,10
2005,Nepal,NPL,Sweden,SWE,5,0,15,0,20
2005,Niger,NER,Sweden,SWE,0,0,12,0,12
2005,Nicaragua,NIC,Sweden,SWE,0,0,5,0,5
2005,Nigeria,NGA,Sweden,SWE,0,5,358,19,382
2005,Pakistan,PAK,Sweden,SWE,0,10,118,5,133
2005,Peru,PER,Sweden,SWE,0,11,48,5,64
2005,Philippines,PHL,Sweden,SWE,0,15,20,0,35
2005,Romania,ROU,Sweden,SWE,0,0,42,5,47
2005,Russian Federation,RUS,Sweden,SWE,0,62,1140,46,1248
2005,Rwanda,RWA,Sweden,SWE,0,5,18,0,23
2005,El Salvador,SLV,Sweden,SWE,0,5,14,0,19
2005,Saudi Arabia,SAU,Sweden,SWE,0,0,5,0,5
2005,Serbia and Kosovo: S/RES/1244 (1999),SRB,Sweden,SWE,178,314,3915,130,4537
2005,Sierra Leone,SLE,Sweden,SWE,0,0,76,0,76
2005,Somalia,SOM,Sweden,SWE,115,161,1213,73,1562
2005,Viet Nam,VNM,Sweden,SWE,0,5,83,0,88
2005,Sudan,SDN,Sweden,SWE,0,0,73,0,73
2005,Syrian Arab Rep.,SYR,Sweden,SWE,15,77,934,17,1043
2005,United Rep. of Tanzania,TZA,Sweden,SWE,0,0,14,0,14
2005,Thailand,THA,Sweden,SWE,0,0,34,0,34
2005,Tajikistan,TJK,Sweden,SWE,0,0,61,0,61
2005,Turkmenistan,TKM,Sweden,SWE,13,5,43,0,61
2005,Togo,TGO,Sweden,SWE,0,0,26,0,26
2005,Tunisia,TUN,Sweden,SWE,0,10,72,5,87
2005,Turkey,TUR,Sweden,SWE,0,36,677,26,739
2005,Uganda,UGA,Sweden,SWE,0,0,34,0,34
2005,Ukraine,UKR,Sweden,SWE,0,17,239,21,277
2005,United States of America,USA,Sweden,SWE,0,0,18,0,18
2005,Uzbekistan,UZB,Sweden,SWE,5,453,422,22,902
2005,Yemen,YEM,Sweden,SWE,0,0,60,0,60
2005,Zimbabwe,ZWE,Sweden,SWE,14,0,0,0,14
2005,Stateless,XXA,Sweden,SWE,34,57,1600,231,1922
2006,Afghanistan,AFG,Belgium,BEL,22,0,24,5,51
2006,Albania,ALB,Belgium,BEL,0,0,18,38,56
2006,Algeria,DZA,Belgium,BEL,5,0,29,79,113
2006,Angola,AGO,Belgium,BEL,0,0,42,51,93
2006,Armenia,ARM,Belgium,BEL,0,0,40,41,81
2006,Azerbaijan,AZE,Belgium,BEL,0,0,22,14,36
2006,Burundi,BDI,Belgium,BEL,5,0,0,42,47
2006,Benin,BEN,Belgium,BEL,0,0,0,5,5
2006,Bangladesh,BGD,Belgium,BEL,0,0,12,5,17
2006,Bhutan,BTN,Belgium,BEL,0,0,5,5,10
2006,Belarus,BLR,Belgium,BEL,5,0,21,37,63
2006,Bosnia and Herzegovina,BIH,Belgium,BEL,5,0,5,32,42
2006,Bulgaria,BGR,Belgium,BEL,5,0,5,16,26
2006,Chad,TCD,Belgium,BEL,0,0,0,5,5
2006,China,CHN,Belgium,BEL,19,0,134,10,163
2006,Cameroon,CMR,Belgium,BEL,5,0,98,99,202
2006,Congo,COG,Belgium,BEL,0,0,5,5,10
2006,Dem. Rep. of the Congo,COD,Belgium,BEL,31,0,478,300,809
2006,Colombia,COL,Belgium,BEL,0,0,11,0,11
2006,Djibouti,DJI,Belgium,BEL,5,0,11,14,30
2006,Ethiopia,ETH,Belgium,BEL,0,0,5,0,5
2006,Palestinian,PSE,Belgium,BEL,0,0,5,23,28
2006,Georgia,GEO,Belgium,BEL,0,0,14,69,83
2006,Guinea,GIN,Belgium,BEL,0,0,5,65,70
2006,Cote d'Ivoire,CIV,Belgium,BEL,25,5,0,22,52
2006,India,IND,Belgium,BEL,0,0,0,5,5
2006,Iran (Islamic Rep. of),IRN,Belgium,BEL,28,0,214,137,379
2006,Iraq,IRQ,Belgium,BEL,0,0,10,66,76
2006,Israel,ISR,Belgium,BEL,0,0,5,13,18
2006,Jordan,JOR,Belgium,BEL,0,0,0,5,5
2006,Kazakhstan,KAZ,Belgium,BEL,0,0,5,37,42
2006,Kenya,KEN,Belgium,BEL,0,0,0,5,5
2006,Kyrgyzstan,KGZ,Belgium,BEL,0,0,5,23,28
2006,Liberia,LBR,Belgium,BEL,0,0,13,5,18
2006,Libya,LBY,Belgium,BEL,0,0,0,5,5
2006,Lebanon,LBN,Belgium,BEL,0,0,13,64,77
2006,Sri Lanka,LKA,Belgium,BEL,0,0,13,10,23
2006,Mauritania,MRT,Belgium,BEL,5,0,56,38,99
2006,North Macedonia,MKD,Belgium,BEL,0,0,5,19,24
2006,Rep. of Moldova,MDA,Belgium,BEL,5,0,5,13,23
2006,Morocco,MAR,Belgium,BEL,5,0,0,0,5
2006,Myanmar,MMR,Belgium,BEL,0,0,5,0,5
2006,Nepal,NPL,Belgium,BEL,0,0,186,37,223
2006,Niger,NER,Belgium,BEL,0,0,0,35,35
2006,Nigeria,NGA,Belgium,BEL,0,0,0,11,11
2006,Pakistan,PAK,Belgium,BEL,5,0,41,16,62
2006,Romania,ROU,Belgium,BEL,0,0,5,5,10
2006,Russian Federation,RUS,Belgium,BEL,187,0,159,241,587
2006,Rwanda,RWA,Belgium,BEL,11,0,17,57,85
2006,Serbia and Kosovo: S/RES/1244 (1999),SRB,Belgium,BEL,32,0,69,66,167
2006,Sierra Leone,SLE,Belgium,BEL,0,0,12,14,26
2006,Somalia,SOM,Belgium,BEL,5,0,11,0,16
2006,Sudan,SDN,Belgium,BEL,5,0,18,10,33
2006,Syrian Arab Rep.,SYR,Belgium,BEL,5,0,67,100,172
2006,Togo,TGO,Belgium,BEL,5,0,27,72,104
2006,Turkey,TUR,Belgium,BEL,36,0,67,95,198
2006,Ukraine,UKR,Belgium,BEL,0,0,5,30,35
2006,Uzbekistan,UZB,Belgium,BEL,0,0,10,31,41
2006,Venezuela (Bolivarian Republic of),VEN,Belgium,BEL,0,0,0,5,5
2006,Yemen,YEM,Belgium,BEL,0,0,5,0,5
2006,Central African Rep.,CAF,Benin,BEN,0,0,0,14,14
2006,Dem. Rep. of the Congo,COD,Benin,BEN,0,0,10,0,10
2006,Nigeria,NGA,Benin,BEN,0,0,17,0,17
2006,Togo,TGO,Benin,BEN,0,0,5,0,5
2006,Central African Rep.,CAF,Burkina Faso,BFA,0,0,0,12,12
2006,Chad,TCD,Burkina Faso,BFA,0,0,0,17,17
2006,Cameroon,CMR,Burkina Faso,BFA,0,0,0,15,15
2006,Congo,COG,Burkina Faso,BFA,0,0,0,58,58
2006,Dem. Rep. of the Congo,COD,Burkina Faso,BFA,0,0,0,10,10
2006,Ghana,GHA,Burkina Faso,BFA,0,0,0,5,5
2006,Nigeria,NGA,Burkina Faso,BFA,0,0,0,12,12
2006,Rwanda,RWA,Burkina Faso,BFA,0,0,0,13,13
2006,Togo,TGO,Burkina Faso,BFA,0,0,0,50,50
2006,Cuba,CUB,Colombia,COL,0,0,13,0,13
2006,Guinea-Bissau,GNB,Colombia,COL,0,0,5,0,5
2006,Afghanistan,AFG,Cyprus,CYP,0,0,0,5,5
2006,Egypt,EGY,Cyprus,CYP,5,0,0,0,5
2006,Armenia,ARM,Cyprus,CYP,0,0,5,0,5
2006,Bangladesh,BGD,Cyprus,CYP,0,0,1104,48,1152
2006,China,CHN,Cyprus,CYP,0,0,5,5,10
2006,Dem. Rep. of the Congo,COD,Cyprus,CYP,0,0,0,5,5
2006,Palestinian,PSE,Cyprus,CYP,0,0,29,0,29
2006,Georgia,GEO,Cyprus,CYP,0,0,79,32,111
2006,India,IND,Cyprus,CYP,0,0,17,10,27
2006,Iran (Islamic Rep. of),IRN,Cyprus,CYP,5,16,219,22,262
2006,Lebanon,LBN,Cyprus,CYP,0,0,11,0,11
2006,Sri Lanka,LKA,Cyprus,CYP,0,0,21,22,43
2006,Rep. of Moldova,MDA,Cyprus,CYP,0,0,5,5,10
2006,Nigeria,NGA,Cyprus,CYP,0,0,5,0,5
2006,Pakistan,PAK,Cyprus,CYP,0,0,157,28,185
2006,Russian Federation,RUS,Cyprus,CYP,0,0,53,11,64
2006,Serbia and Kosovo: S/RES/1244 (1999),SRB,Cyprus,CYP,0,0,5,0,5
2006,Syrian Arab Rep.,SYR,Cyprus,CYP,0,0,50,10,60
2006,Turkey,TUR,Cyprus,CYP,0,0,50,17,67
2006,Ukraine,UKR,Cyprus,CYP,0,0,32,16,48
2006,Afghanistan,AFG,Czechia,CZE,5,0,0,11,16
2006,Algeria,DZA,Czechia,CZE,0,0,22,34,56
2006,Angola,AGO,Czechia,CZE,5,0,0,5,10
2006,Egypt,EGY,Czechia,CZE,0,0,96,54,150
2006,Armenia,ARM,Czechia,CZE,10,0,51,0,61
2006,Belarus,BLR,Czechia,CZE,10,0,60,35,105
2006,Bosnia and Herzegovina,BIH,Czechia,CZE,0,0,0,5,5
2006,Bulgaria,BGR,Czechia,CZE,0,0,13,10,23
2006,China,CHN,Czechia,CZE,5,0,66,69,140
2006,Georgia,GEO,Czechia,CZE,5,0,17,21,43
2006,Ghana,GHA,Czechia,CZE,0,0,5,0,5
2006,Guinea,GIN,Czechia,CZE,5,0,0,0,5
2006,Cote d'Ivoire,CIV,Czechia,CZE,5,0,5,0,10
2006,India,IND,Czechia,CZE,0,0,10,41,51
2006,Iraq,IRQ,Czechia,CZE,0,0,5,0,5
2006,Kazakhstan,KAZ,Czechia,CZE,5,0,11,5,21
2006,Kyrgyzstan,KGZ,Czechia,CZE,5,0,27,10,42
2006,Sri Lanka,LKA,Czechia,CZE,0,0,0,5,5
2006,North Macedonia,MKD,Czechia,CZE,0,0,0,13,13
2006,Rep. of Moldova,MDA,Czechia,CZE,5,0,48,12,65
2006,Mongolia,MNG,Czechia,CZE,0,0,57,51,108
2006,Nigeria,NGA,Czechia,CZE,0,0,25,20,45
2006,Pakistan,PAK,Czechia,CZE,0,0,5,12,17
2006,Romania,ROU,Czechia,CZE,0,0,17,0,17
2006,Russian Federation,RUS,Czechia,CZE,12,0,100,72,184
2006,Senegal,SEN,Czechia,CZE,0,0,0,5,5
2006,Viet Nam,VNM,Czechia,CZE,5,0,114,68,187
2006,Slovakia,SVK,Czechia,CZE,0,0,110,109,219
2006,Turkey,TUR,Czechia,CZE,0,0,5,12,17
2006,Ukraine,UKR,Czechia,CZE,13,0,559,199,771
2006,Uzbekistan,UZB,Czechia,CZE,0,0,10,0,10
2006,Stateless,XXA,Czechia,CZE,5,0,5,21,31
2006,Afghanistan,AFG,Denmark,DNK,28,11,55,0,94
2006,Algeria,DZA,Denmark,DNK,0,0,5,0,5
2006,Azerbaijan,AZE,Denmark,DNK,0,0,5,0,5
2006,Bangladesh,BGD,Denmark,DNK,0,0,5,0,5
2006,Burkina Faso,BFA,Denmark,DNK,0,0,5,0,5
2006,Bosnia and Herzegovina,BIH,Denmark,DNK,0,0,10,0,10
2006,China,CHN,Denmark,DNK,0,0,15,0,15
2006,Cameroon,CMR,Denmark,DNK,0,0,5,0,5
2006,Dem. Rep. of the Congo,COD,Denmark,DNK,0,0,5,0,5
2006,Ethiopia,ETH,Denmark,DNK,0,0,5,0,5
2006,Palestinian,PSE,Denmark,DNK,36,0,25,0,61
2006,Georgia,GEO,Denmark,DNK,0,0,5,0,5
2006,India,IND,Denmark,DNK,0,5,5,0,10
2006,Iran (Islamic Rep. of),IRN,Denmark,DNK,10,10,18,0,38
2006,Iraq,IRQ,Denmark,DNK,5,5,87,0,97
2006,Libya,LBY,Denmark,DNK,0,0,5,0,5
2006,Sri Lanka,LKA,Denmark,DNK,0,0,12,0,12
2006,Nepal,NPL,Denmark,DNK,0,0,5,0,5
2006,Nigeria,NGA,Denmark,DNK,0,0,12,0,12
2006,Pakistan,PAK,Denmark,DNK,0,5,0,0,5
2006,Russian Federation,RUS,Denmark,DNK,0,0,10,0,10
2006,Serbia and Kosovo: S/RES/1244 (1999),SRB,Denmark,DNK,0,0,102,0,102
2006,Somalia,SOM,Denmark,DNK,0,5,38,0,43
2006,Sudan,SDN,Denmark,DNK,0,0,5,0,5
2006,Syrian Arab Rep.,SYR,Denmark,DNK,12,0,0,0,12
2006,Turkey,TUR,Denmark,DNK,0,0,5,0,5
2006,Algeria,DZA,France,FRA,73,25,1076,0,1174
2006,Angola,AGO,France,FRA,85,5,531,0,621
2006,Armenia,ARM,France,FRA,181,21,633,0,835
2006,Bangladesh,BGD,France,FRA,128,5,559,0,692
2006,Bosnia and Herzegovina,BIH,France,FRA,242,5,818,0,1065
2006,China,CHN,France,FRA,17,0,1890,0,1907
2006,Congo,COG,France,FRA,77,5,650,0,732
2006,Dem. Rep. of the Congo,COD,France,FRA,256,15,1805,0,2076
2006,Georgia,GEO,France,FRA,130,20,720,0,870
2006,Guinea,GIN,France,FRA,150,11,578,0,739
2006,Haiti,HTI,France,FRA,159,39,2464,0,2662
2006,Cote d'Ivoire,CIV,France,FRA,102,5,532,0,639
2006,India,IND,France,FRA,0,0,89,0,89
2006,Sri Lanka,LKA,France,FRA,342,5,1159,0,1506
2006,Mauritania,MRT,France,FRA,162,0,1009,0,1171
2006,Rep. of Moldova,MDA,France,FRA,23,12,613,0,648
2006,Nigeria,NGA,France,FRA,53,115,543,0,711
2006,Pakistan,PAK,France,FRA,29,10,456,0,495
2006,Russian Federation,RUS,France,FRA,336,32,756,0,1124
2006,Serbia and Kosovo: S/RES/1244 (1999),SRB,France,FRA,358,11,993,0,1362
2006,Turkey,TUR,France,FRA,293,5,2557,0,2855
2006,Afghanistan,AFG,Ireland,IRL,15,0,63,5,83
2006,Albania,ALB,Ireland,IRL,11,0,21,0,32
2006,Algeria,DZA,Ireland,IRL,0,0,26,0,26
2006,Angola,AGO,Ireland,IRL,0,0,30,5,35
2006,Egypt,EGY,Ireland,IRL,5,0,0,0,5
2006,Armenia,ARM,Ireland,IRL,5,0,0,0,5
2006,Azerbaijan,AZE,Ireland,IRL,0,0,5,0,5
2006,Burundi,BDI,Ireland,IRL,5,0,11,0,16
2006,Bangladesh,BGD,Ireland,IRL,0,0,14,0,14
2006,Belarus,BLR,Ireland,IRL,0,0,5,0,5
2006,China,CHN,Ireland,IRL,0,0,13,0,13
2006,Cameroon,CMR,Ireland,IRL,5,0,44,0,49
2006,Congo,COG,Ireland,IRL,0,0,11,0,11
2006,Dem. Rep. of the Congo,COD,Ireland,IRL,5,0,121,0,126
2006,Eritrea,ERI,Ireland,IRL,0,0,16,0,16
2006,Ethiopia,ETH,Ireland,IRL,0,0,12,0,12
2006,Gambia,GMB,Ireland,IRL,0,0,5,0,5
2006,Palestinian,PSE,Ireland,IRL,5,0,15,0,20
2006,Georgia,GEO,Ireland,IRL,24,0,62,0,86
2006,Ghana,GHA,Ireland,IRL,0,0,38,0,38
2006,Guinea,GIN,Ireland,IRL,0,0,11,0,11
2006,Guyana,GUY,Ireland,IRL,0,0,0,5,5
2006,Croatia,HRV,Ireland,IRL,5,0,19,5,29
2006,Cote d'Ivoire,CIV,Ireland,IRL,0,0,14,0,14
2006,India,IND,Ireland,IRL,5,0,5,0,10
2006,Iran (Islamic Rep. of),IRN,Ireland,IRL,11,0,53,5,69
2006,Iraq,IRQ,Ireland,IRL,16,0,15,0,31
2006,Israel,ISR,Ireland,IRL,0,0,5,0,5
2006,Kazakhstan,KAZ,Ireland,IRL,5,0,0,0,5
2006,Kenya,KEN,Ireland,IRL,5,0,36,0,41
2006,Kyrgyzstan,KGZ,Ireland,IRL,5,0,0,0,5
2006,Kuwait,KWT,Ireland,IRL,5,0,13,0,18
2006,Liberia,LBR,Ireland,IRL,0,0,17,0,17
2006,Libya,LBY,Ireland,IRL,0,0,5,0,5
2006,Lebanon,LBN,Ireland,IRL,0,0,11,0,11
2006,North Macedonia,MKD,Ireland,IRL,0,0,5,0,5
2006,Rep. of Moldova,MDA,Ireland,IRL,5,0,21,5,31
2006,Malawi,MWI,Ireland,IRL,0,0,5,0,5
2006,Morocco,MAR,Ireland,IRL,0,0,5,0,5
2006,Myanmar,MMR,Ireland,IRL,0,0,5,0,5
2006,Nepal,NPL,Ireland,IRL,0,0,5,0,5
2006,Niger,NER,Ireland,IRL,0,0,0,5,5
2006,Nigeria,NGA,Ireland,IRL,22,0,436,25,483
2006,Pakistan,PAK,Ireland,IRL,10,0,26,5,41
2006,Romania,ROU,Ireland,IRL,5,0,71,5,81
2006,South Africa,ZAF,Ireland,IRL,0,0,17,0,17
2006,Russian Federation,RUS,Ireland,IRL,0,0,14,5,19
2006,Rwanda,RWA,Ireland,IRL,5,0,5,0,10
2006,Serbia and Kosovo: S/RES/1244 (1999),SRB,Ireland,IRL,10,0,5,0,15
2006,Sierra Leone,SLE,Ireland,IRL,0,0,12,0,12
2006,Somalia,SOM,Ireland,IRL,39,0,128,5,172
2006,Viet Nam,VNM,Ireland,IRL,0,0,5,0,5
2006,Sudan,SDN,Ireland,IRL,5,0,42,5,52
2006,Syrian Arab Rep.,SYR,Ireland,IRL,0,0,10,0,10
2006,Togo,TGO,Ireland,IRL,0,0,23,0,23
2006,Uganda,UGA,Ireland,IRL,0,0,12,0,12
2006,Ukraine,UKR,Ireland,IRL,0,0,16,5,21
2006,Uzbekistan,UZB,Ireland,IRL,0,0,5,0,5
2006,Zimbabwe,ZWE,Ireland,IRL,5,0,19,0,24
2006,Stateless,XXA,Ireland,IRL,0,0,5,0,5
2006,Bhutan,BTN,Nepal,NPL,0,5,0,0,5
2006,Afghanistan,AFG,Netherlands,NLD,0,129,159,145,433
2006,Albania,ALB,Netherlands,NLD,0,0,0,5,5
2006,Algeria,DZA,Netherlands,NLD,0,0,11,0,11
2006,Angola,AGO,Netherlands,NLD,0,62,49,67,178
2006,Armenia,ARM,Netherlands,NLD,0,75,35,50,160
2006,Azerbaijan,AZE,Netherlands,NLD,0,229,60,213,502
2006,Burundi,BDI,Netherlands,NLD,0,25,22,21,68
2006,Bangladesh,BGD,Netherlands,NLD,0,0,0,5,5
2006,Belarus,BLR,Netherlands,NLD,0,11,5,0,16
2006,Bosnia and Herzegovina,BIH,Netherlands,NLD,0,30,24,13,67
2006,Bulgaria,BGR,Netherlands,NLD,0,0,5,0,5
2006,China,CHN,Netherlands,NLD,0,46,24,36,106
2006,Cameroon,CMR,Netherlands,NLD,0,13,0,5,18
2006,Congo,COG,Netherlands,NLD,0,20,16,20,56
2006,Dem. Rep. of the Congo,COD,Netherlands,NLD,0,25,26,30,81
2006,Colombia,COL,Netherlands,NLD,0,12,11,5,28
2006,Czechia,CZE,Netherlands,NLD,0,0,5,0,5
2006,Eritrea,ERI,Netherlands,NLD,0,67,12,31,110
2006,Ethiopia,ETH,Netherlands,NLD,0,17,10,24,51
2006,Georgia,GEO,Netherlands,NLD,0,11,12,12,35
2006,Guinea-Bissau,GNB,Netherlands,NLD,0,0,0,5,5
2006,Guinea,GIN,Netherlands,NLD,0,29,27,21,77
2006,Croatia,HRV,Netherlands,NLD,0,12,5,20,37
2006,Cote d'Ivoire,CIV,Netherlands,NLD,0,65,11,5,81
2006,India,IND,Netherlands,NLD,0,0,5,0,5
2006,Iran (Islamic Rep. of),IRN,Netherlands,NLD,0,116,33,79,228
2006,Iraq,IRQ,Netherlands,NLD,0,183,131,236,550
2006,Kazakhstan,KAZ,Netherlands,NLD,0,20,12,21,53
2006,Kenya,KEN,Netherlands,NLD,0,0,0,5,5
2006,Kyrgyzstan,KGZ,Netherlands,NLD,0,10,0,0,10
2006,Dem. People's Rep. of Korea,PRK,Netherlands,NLD,0,5,0,0,5
2006,Kuwait,KWT,Netherlands,NLD,0,5,0,0,5
2006,Liberia,LBR,Netherlands,NLD,0,31,27,23,81
2006,Libya,LBY,Netherlands,NLD,0,5,0,11,16
2006,Lebanon,LBN,Netherlands,NLD,0,5,0,0,5
2006,Sri Lanka,LKA,Netherlands,NLD,0,19,5,13,37
2006,Mauritania,MRT,Netherlands,NLD,0,0,0,5,5
2006,North Macedonia,MKD,Netherlands,NLD,0,0,5,5,10
2006,Rep. of Moldova,MDA,Netherlands,NLD,0,0,5,0,5
2006,Mongolia,MNG,Netherlands,NLD,0,5,5,12,22
2006,Morocco,MAR,Netherlands,NLD,0,5,0,0,5
2006,Myanmar,MMR,Netherlands,NLD,0,0,5,0,5
2006,Nepal,NPL,Netherlands,NLD,0,13,21,5,39
2006,Niger,NER,Netherlands,NLD,0,0,5,5,10
2006,Nigeria,NGA,Netherlands,NLD,0,22,12,17,51
2006,Pakistan,PAK,Netherlands,NLD,0,12,5,0,17
2006,Russian Federation,RUS,Netherlands,NLD,0,95,35,66,196
2006,Rwanda,RWA,Netherlands,NLD,0,20,5,22,47
2006,Serbia and Kosovo: S/RES/1244 (1999),SRB,Netherlands,NLD,0,64,35,76,175
2006,Senegal,SEN,Netherlands,NLD,0,5,0,0,5
2006,Sierra Leone,SLE,Netherlands,NLD,0,39,40,55,134
2006,Somalia,SOM,Netherlands,NLD,0,125,26,76,227
2006,Viet Nam,VNM,Netherlands,NLD,0,0,5,0,5
2006,Sudan,SDN,Netherlands,NLD,0,48,32,75,155
2006,Slovakia,SVK,Netherlands,NLD,0,5,5,0,10
2006,Syrian Arab Rep.,SYR,Netherlands,NLD,0,64,22,42,128
2006,Tajikistan,TJK,Netherlands,NLD,0,14,5,5,24
2006,Togo,TGO,Netherlands,NLD,0,15,5,5,25
2006,Turkey,TUR,Netherlands,NLD,0,42,13,49,104
2006,Uganda,UGA,Netherlands,NLD,0,14,0,0,14
2006,Ukraine,UKR,Netherlands,NLD,0,5,11,10,26
2006,Uzbekistan,UZB,Netherlands,NLD,0,5,5,11,21
2006,Yemen,YEM,Netherlands,NLD,0,0,5,5,10
2006,Stateless,XXA,Netherlands,NLD,0,69,27,62,158
2006,Chad,TCD,Niger,NER,0,0,0,5,5
2006,Congo,COG,Niger,NER,0,0,0,5,5
2006,Afghanistan,AFG,Norway,NOR,10,34,655,0,699
2006,Albania,ALB,Norway,NOR,0,0,51,0,51
2006,Algeria,DZA,Norway,NOR,0,0,42,0,42
2006,Angola,AGO,Norway,NOR,0,0,52,0,52
2006,Armenia,ARM,Norway,NOR,0,10,14,0,24
2006,Azerbaijan,AZE,Norway,NOR,0,5,56,0,61
2006,Burundi,BDI,Norway,NOR,0,5,66,0,71
2006,Benin,BEN,Norway,NOR,0,0,5,0,5
2006,Bangladesh,BGD,Norway,NOR,0,0,16,0,16
2006,Bhutan,BTN,Norway,NOR,0,0,10,0,10
2006,Belarus,BLR,Norway,NOR,0,0,13,0,13
2006,Bosnia and Herzegovina,BIH,Norway,NOR,0,5,60,0,65
2006,Bulgaria,BGR,Norway,NOR,0,0,13,0,13
2006,China,CHN,Norway,NOR,0,0,27,5,32
2006,Cameroon,CMR,Norway,NOR,5,10,86,0,101
2006,Congo,COG,Norway,NOR,0,5,13,0,18
2006,Dem. Rep. of the Congo,COD,Norway,NOR,0,5,77,0,82
2006,Cuba,CUB,Norway,NOR,0,0,5,0,5
2006,Eritrea,ERI,Norway,NOR,0,55,38,0,93
2006,Ethiopia,ETH,Norway,NOR,5,26,126,0,157
2006,Gambia,GMB,Norway,NOR,0,0,5,0,5
2006,Georgia,GEO,Norway,NOR,0,10,19,0,29
2006,Guinea,GIN,Norway,NOR,5,5,48,0,58
2006,Croatia,HRV,Norway,NOR,0,0,13,0,13
2006,Hungary,HUN,Norway,NOR,0,0,5,0,5
2006,Cote d'Ivoire,CIV,Norway,NOR,0,5,12,0,17
2006,India,IND,Norway,NOR,0,0,25,0,25
2006,Iran (Islamic Rep. of),IRN,Norway,NOR,0,11,550,10,571
2006,Iraq,IRQ,Norway,NOR,0,5,776,5,786
2006,Israel,ISR,Norway,NOR,0,0,16,0,16
2006,Jordan,JOR,Norway,NOR,0,0,5,0,5
2006,Kazakhstan,KAZ,Norway,NOR,0,5,11,0,16
2006,Kyrgyzstan,KGZ,Norway,NOR,0,0,16,0,16
2006,Liberia,LBR,Norway,NOR,0,0,47,0,47
2006,Libya,LBY,Norway,NOR,0,0,38,5,43
2006,Lebanon,LBN,Norway,NOR,0,0,28,0,28
2006,Sri Lanka,LKA,Norway,NOR,0,5,74,0,79
2006,Mauritania,MRT,Norway,NOR,0,0,5,0,5
2006,North Macedonia,MKD,Norway,NOR,0,5,15,0,20
2006,Rep. of Moldova,MDA,Norway,NOR,0,0,10,0,10
2006,Mongolia,MNG,Norway,NOR,0,0,5,0,5
2006,Morocco,MAR,Norway,NOR,0,5,10,0,15
2006,Mozambique,MOZ,Norway,NOR,0,0,5,0,5
2006,Nepal,NPL,Norway,NOR,0,0,110,0,110
2006,Niger,NER,Norway,NOR,0,0,14,0,14
2006,Nigeria,NGA,Norway,NOR,0,10,113,0,123
2006,Pakistan,PAK,Norway,NOR,0,13,93,0,106
2006,Romania,ROU,Norway,NOR,0,0,5,0,5
2006,Russian Federation,RUS,Norway,NOR,0,27,236,5,268
2006,Rwanda,RWA,Norway,NOR,0,0,53,0,53
2006,Serbia and Kosovo: S/RES/1244 (1999),SRB,Norway,NOR,21,66,473,0,560
2006,Sierra Leone,SLE,Norway,NOR,0,0,29,0,29
2006,Somalia,SOM,Norway,NOR,5,113,284,10,412
2006,Viet Nam,VNM,Norway,NOR,0,0,5,0,5
2006,Sudan,SDN,Norway,NOR,5,5,64,0,74
2006,Syrian Arab Rep.,SYR,Norway,NOR,0,5,69,0,74
2006,United Rep. of Tanzania,TZA,Norway,NOR,0,0,5,0,5
2006,Togo,TGO,Norway,NOR,0,0,19,0,19
2006,Tunisia,TUN,Norway,NOR,0,0,5,0,5
2006,Turkey,TUR,Norway,NOR,0,5,58,0,63
2006,Uganda,UGA,Norway,NOR,0,0,12,0,12
2006,Ukraine,UKR,Norway,NOR,0,0,10,0,10
2006,Uzbekistan,UZB,Norway,NOR,0,11,25,0,36
2006,Western Sahara,ESH,Norway,NOR,0,0,10,0,10
2006,Yemen,YEM,Norway,NOR,0,0,5,0,5
2006,Afghanistan,AFG,New Zealand,NZL,0,0,5,0,5
2006,Bangladesh,BGD,New Zealand,NZL,0,0,27,5,32
2006,Bulgaria,BGR,New Zealand,NZL,5,0,0,0,5
2006,China,CHN,New Zealand,NZL,0,0,5,0,5
2006,Chile,CHL,New Zealand,NZL,0,0,5,5,10
2006,Congo,COG,New Zealand,NZL,0,0,0,14,14
2006,Czechia,CZE,New Zealand,NZL,5,0,12,0,17
2006,Ethiopia,ETH,New Zealand,NZL,0,0,5,13,18
2006,Hungary,HUN,New Zealand,NZL,0,0,5,0,5
2006,India,IND,New Zealand,NZL,0,0,22,0,22
2006,Iran (Islamic Rep. of),IRN,New Zealand,NZL,21,0,50,0,71
2006,Iraq,IRQ,New Zealand,NZL,11,0,5,0,16
2006,Jordan,JOR,New Zealand,NZL,0,0,5,0,5
2006,Sri Lanka,LKA,New Zealand,NZL,0,0,22,0,22
2006,Malaysia,MYS,New Zealand,NZL,0,0,10,0,10
2006,Myanmar,MMR,New Zealand,NZL,0,0,0,5,5
2006,Nepal,NPL,New Zealand,NZL,5,0,12,0,17
2006,Nigeria,NGA,New Zealand,NZL,0,0,5,0,5
2006,Pakistan,PAK,New Zealand,NZL,0,0,5,0,5
2006,El Salvador,SLV,New Zealand,NZL,0,0,5,0,5
2006,Somalia,SOM,New Zealand,NZL,0,0,5,0,5
2006,Viet Nam,VNM,New Zealand,NZL,0,0,5,0,5
2006,Syrian Arab Rep.,SYR,New Zealand,NZL,0,0,11,0,11
2006,Zimbabwe,ZWE,New Zealand,NZL,5,0,5,0,10
2006,Armenia,ARM,Poland,POL,0,0,5,0,5
2006,Belarus,BLR,Poland,POL,0,0,13,0,13
2006,Georgia,GEO,Poland,POL,0,0,5,0,5
2006,Guinea,GIN,Poland,POL,0,0,5,0,5
2006,Kazakhstan,KAZ,Poland,POL,0,0,10,0,10
2006,Kyrgyzstan,KGZ,Poland,POL,0,0,5,0,5
2006,Nepal,NPL,Poland,POL,0,0,5,0,5
2006,Nigeria,NGA,Poland,POL,0,0,5,0,5
2006,Pakistan,PAK,Poland,POL,0,0,5,0,5
2006,Russian Federation,RUS,Poland,POL,54,61,224,46,385
2006,Syrian Arab Rep.,SYR,Poland,POL,5,0,0,0,5
2006,Ukraine,UKR,Poland,POL,0,0,5,5,10
2006,Stateless,XXA,Poland,POL,0,0,5,0,5
2006,Afghanistan,AFG,Ukraine,UKR,0,0,19,15,34
2006,Angola,AGO,Ukraine,UKR,0,0,0,5,5
2006,Burundi,BDI,Ukraine,UKR,0,0,5,0,5
2006,Bangladesh,BGD,Ukraine,UKR,0,0,59,0,59
2006,Belarus,BLR,Ukraine,UKR,0,0,5,0,5
2006,Chad,TCD,Ukraine,UKR,0,0,0,5,5
2006,China,CHN,Ukraine,UKR,0,0,5,0,5
2006,Congo,COG,Ukraine,UKR,0,0,0,5,5
2006,Ethiopia,ETH,Ukraine,UKR,0,0,12,0,12
2006,Palestinian,PSE,Ukraine,UKR,0,0,72,0,72
2006,Georgia,GEO,Ukraine,UKR,0,0,5,5,10
2006,Ghana,GHA,Ukraine,UKR,0,0,0,5,5
2006,India,IND,Ukraine,UKR,0,0,185,0,185
2006,Iran (Islamic Rep. of),IRN,Ukraine,UKR,0,0,0,16,16
2006,Iraq,IRQ,Ukraine,UKR,0,0,41,28,69
2006,Liberia,LBR,Ukraine,UKR,0,0,0,5,5
2006,Sri Lanka,LKA,Ukraine,UKR,0,0,0,5,5
2006,Nigeria,NGA,Ukraine,UKR,0,0,10,5,15
2006,Pakistan,PAK,Ukraine,UKR,0,0,72,0,72
2006,Russian Federation,RUS,Ukraine,UKR,5,0,13,16,34
2006,Somalia,SOM,Ukraine,UKR,0,0,0,11,11
2006,Sudan,SDN,Ukraine,UKR,0,0,5,0,5
2006,Uzbekistan,UZB,Ukraine,UKR,0,0,18,24,42
2007,Central African Rep.,CAF,Benin,BEN,0,0,5,0,5
2007,Congo,COG,Benin,BEN,0,0,10,5,15
2007,Dem. Rep. of the Congo,COD,Benin,BEN,0,0,50,65,115
2007,Cote d'Ivoire,CIV,Benin,BEN,0,0,0,14,14
2007,Nigeria,NGA,Benin,BEN,0,0,22,16,38
2007,Rwanda,RWA,Benin,BEN,0,0,0,5,5
2007,Togo,TGO,Benin,BEN,0,0,32,13,45
2007,Chad,TCD,Burkina Faso,BFA,0,0,5,0,5
2007,Congo,COG,Burkina Faso,BFA,0,0,5,0,5
2007,Togo,TGO,Burkina Faso,BFA,0,0,5,0,5
2007,Afghanistan,AFG,Cyprus,CYP,0,0,13,5,18
2007,Egypt,EGY,Cyprus,CYP,0,0,13,0,13
2007,Armenia,ARM,Cyprus,CYP,0,11,5,0,16
2007,Bangladesh,BGD,Cyprus,CYP,0,0,329,46,375
2007,Belarus,BLR,Cyprus,CYP,0,0,0,5,5
2007,China,CHN,Cyprus,CYP,0,0,66,10,76
2007,Cameroon,CMR,Cyprus,CYP,0,0,5,0,5
2007,Palestinian,PSE,Cyprus,CYP,0,0,34,5,39
2007,Georgia,GEO,Cyprus,CYP,0,11,302,74,387
2007,India,IND,Cyprus,CYP,0,0,89,25,114
2007,Iran (Islamic Rep. of),IRN,Cyprus,CYP,0,0,140,26,166
2007,Iraq,IRQ,Cyprus,CYP,0,0,5,5,10
2007,Kazakhstan,KAZ,Cyprus,CYP,0,0,5,0,5
2007,Lebanon,LBN,Cyprus,CYP,0,0,5,0,5
2007,Sri Lanka,LKA,Cyprus,CYP,0,0,154,36,190
2007,Rep. of Moldova,MDA,Cyprus,CYP,0,5,19,5,29
2007,Nigeria,NGA,Cyprus,CYP,0,0,5,0,5
2007,Pakistan,PAK,Cyprus,CYP,0,0,259,46,305
2007,Philippines,PHL,Cyprus,CYP,0,0,12,0,12
2007,Russian Federation,RUS,Cyprus,CYP,0,5,81,12,98
2007,Syrian Arab Rep.,SYR,Cyprus,CYP,0,14,168,42,224
2007,Turkey,TUR,Cyprus,CYP,0,0,76,10,86
2007,Ukraine,UKR,Cyprus,CYP,0,0,92,34,126
2007,Uzbekistan,UZB,Cyprus,CYP,0,0,5,0,5
2007,Algeria,DZA,Czechia,CZE,5,0,10,16,31
2007,Egypt,EGY,Czechia,CZE,0,0,0,113,113
2007,Armenia,ARM,Czechia,CZE,5,0,22,5,32
2007,Bangladesh,BGD,Czechia,CZE,0,0,5,0,5
2007,Belarus,BLR,Czechia,CZE,5,0,22,5,32
2007,Bulgaria,BGR,Czechia,CZE,0,0,0,5,5
2007,China,CHN,Czechia,CZE,0,0,37,33,70
2007,Cameroon,CMR,Czechia,CZE,0,0,0,13,13
2007,Congo,COG,Czechia,CZE,0,0,5,0,5
2007,Dem. Rep. of the Congo,COD,Czechia,CZE,0,0,13,0,13
2007,Georgia,GEO,Czechia,CZE,0,0,27,10,37
2007,Ghana,GHA,Czechia,CZE,0,0,0,10,10
2007,Guinea,GIN,Czechia,CZE,5,0,5,0,10
2007,Cote d'Ivoire,CIV,Czechia,CZE,0,0,5,5,10
2007,India,IND,Czechia,CZE,0,0,10,11,21
2007,Iran (Islamic Rep. of),IRN,Czechia,CZE,0,0,0,5,5
2007,Iraq,IRQ,Czechia,CZE,5,0,0,0,5
2007,Kazakhstan,KAZ,Czechia,CZE,11,0,28,0,39
2007,Kyrgyzstan,KGZ,Czechia,CZE,10,0,0,35,45
2007,Sri Lanka,LKA,Czechia,CZE,0,0,0,5,5
2007,North Macedonia,MKD,Czechia,CZE,0,0,5,5,10
2007,Rep. of Moldova,MDA,Czechia,CZE,0,0,22,5,27
2007,Mongolia,MNG,Czechia,CZE,0,0,47,21,68
2007,Morocco,MAR,Czechia,CZE,0,0,5,0,5
2007,Nigeria,NGA,Czechia,CZE,0,0,26,47,73
2007,Pakistan,PAK,Czechia,CZE,0,0,5,10,15
2007,Russian Federation,RUS,Czechia,CZE,10,0,62,23,95
2007,Serbia and Kosovo: S/RES/1244 (1999),SRB,Czechia,CZE,0,0,5,5,10
2007,Senegal,SEN,Czechia,CZE,0,0,5,0,5
2007,Sierra Leone,SLE,Czechia,CZE,0,0,5,0,5
2007,Viet Nam,VNM,Czechia,CZE,0,0,78,28,106
2007,Slovakia,SVK,Czechia,CZE,0,0,5,0,5
2007,Syrian Arab Rep.,SYR,Czechia,CZE,5,0,5,0,10
2007,Thailand,THA,Czechia,CZE,0,0,5,0,5
2007,Turkey,TUR,Czechia,CZE,0,0,5,22,27
2007,Ukraine,UKR,Czechia,CZE,5,0,335,116,456
2007,Uzbekistan,UZB,Czechia,CZE,0,0,5,0,5
2007,Stateless,XXA,Czechia,CZE,5,0,11,26,42
2007,Afghanistan,AFG,Denmark,DNK,5,5,20,0,30
2007,Armenia,ARM,Denmark,DNK,0,0,11,0,11
2007,Azerbaijan,AZE,Denmark,DNK,5,0,0,0,5
2007,China,CHN,Denmark,DNK,0,0,5,0,5
2007,Ethiopia,ETH,Denmark,DNK,0,0,5,0,5
2007,Palestinian,PSE,Denmark,DNK,5,0,11,0,16
2007,India,IND,Denmark,DNK,0,0,5,0,5
2007,Iran (Islamic Rep. of),IRN,Denmark,DNK,5,5,16,0,26
2007,Iraq,IRQ,Denmark,DNK,0,18,46,0,64
2007,Lebanon,LBN,Denmark,DNK,0,0,11,0,11
2007,Sri Lanka,LKA,Denmark,DNK,0,0,20,0,20
2007,Nigeria,NGA,Denmark,DNK,0,0,12,0,12
2007,Pakistan,PAK,Denmark,DNK,0,0,5,0,5
2007,Russian Federation,RUS,Denmark,DNK,5,0,5,0,10
2007,Serbia and Kosovo: S/RES/1244 (1999),SRB,Denmark,DNK,0,0,15,0,15
2007,Somalia,SOM,Denmark,DNK,0,0,10,0,10
2007,Syrian Arab Rep.,SYR,Denmark,DNK,5,0,5,0,10
2007,Turkey,TUR,Denmark,DNK,0,0,5,0,5
2007,Albania,ALB,France,FRA,27,30,144,18,219
2007,Algeria,DZA,France,FRA,83,48,664,346,1141
2007,Angola,AGO,France,FRA,116,5,400,55,576
2007,Armenia,ARM,France,FRA,192,42,683,131,1048
2007,Azerbaijan,AZE,France,FRA,172,0,191,39,402
2007,Bangladesh,BGD,France,FRA,198,5,545,155,903
2007,Bosnia and Herzegovina,BIH,France,FRA,176,5,351,62,594
2007,China,CHN,France,FRA,13,0,355,1034,1402
2007,Cameroon,CMR,France,FRA,38,11,168,36,253
2007,Congo,COG,France,FRA,100,5,505,155,765
2007,Dem. Rep. of the Congo,COD,France,FRA,285,28,1364,304,1981
2007,Georgia,GEO,France,FRA,92,22,321,52,487
2007,Guinea,GIN,France,FRA,210,24,470,104,808
2007,Haiti,HTI,France,FRA,175,68,1552,591,2386
2007,Cote d'Ivoire,CIV,France,FRA,82,5,459,143,689
2007,Sri Lanka,LKA,France,FRA,561,32,975,304,1872
2007,Madagascar,MDG,France,FRA,19,5,113,31,168
2007,Mauritania,MRT,France,FRA,103,0,569,159,831
2007,Rep. of Moldova,MDA,France,FRA,27,5,211,116,359
2007,Nigeria,NGA,France,FRA,35,11,360,96,502
2007,Pakistan,PAK,France,FRA,27,5,232,96,360
2007,Russian Federation,RUS,France,FRA,457,49,644,134,1284
2007,Serbia and Kosovo: S/RES/1244 (1999),SRB,France,FRA,539,47,1013,492,2091
2007,Togo,TGO,France,FRA,45,0,120,24,189
2007,Turkey,TUR,France,FRA,468,12,1798,662,2940
2007,Afghanistan,AFG,Greece,GRC,5,0,0,0,5
2007,Bangladesh,BGD,Greece,GRC,0,5,0,0,5
2007,Cameroon,CMR,Greece,GRC,5,0,0,0,5
2007,Iran (Islamic Rep. of),IRN,Greece,GRC,10,5,0,0,15
2007,Iraq,IRQ,Greece,GRC,107,5,0,0,112
2007,Nigeria,NGA,Greece,GRC,5,0,0,0,5
2007,Albania,ALB,Croatia,HRV,0,0,5,0,5
2007,Bosnia and Herzegovina,BIH,Croatia,HRV,0,0,5,0,5
2007,North Macedonia,MKD,Croatia,HRV,0,0,5,0,5
2007,Serbia and Kosovo: S/RES/1244 (1999),SRB,Croatia,HRV,0,0,13,0,13
2007,Afghanistan,AFG,Ireland,IRL,11,0,42,5,58
2007,Albania,ALB,Ireland,IRL,5,0,16,0,21
2007,Algeria,DZA,Ireland,IRL,5,0,20,0,25
2007,Angola,AGO,Ireland,IRL,5,0,11,5,21
2007,Egypt,EGY,Ireland,IRL,5,0,0,0,5
2007,Armenia,ARM,Ireland,IRL,0,0,5,0,5
2007,Burundi,BDI,Ireland,IRL,0,0,10,0,10
2007,Bhutan,BTN,Ireland,IRL,0,0,5,0,5
2007,Belarus,BLR,Ireland,IRL,0,0,10,0,10
2007,Brazil,BRA,Ireland,IRL,0,0,5,0,5
2007,China,CHN,Ireland,IRL,0,0,12,5,17
2007,Cameroon,CMR,Ireland,IRL,5,0,30,0,35
2007,Congo,COG,Ireland,IRL,0,0,10,0,10
2007,Dem. Rep. of the Congo,COD,Ireland,IRL,10,0,64,0,74
2007,Eritrea,ERI,Ireland,IRL,0,0,12,0,12
2007,Ethiopia,ETH,Ireland,IRL,0,0,14,0,14
2007,Palestinian,PSE,Ireland,IRL,0,0,14,0,14
2007,Georgia,GEO,Ireland,IRL,5,0,80,13,98
2007,Ghana,GHA,Ireland,IRL,5,0,39,0,44
2007,Guinea,GIN,Ireland,IRL,0,0,11,0,11
2007,Croatia,HRV,Ireland,IRL,5,0,15,0,20
2007,Cote d'Ivoire,CIV,Ireland,IRL,5,0,5,0,10
2007,India,IND,Ireland,IRL,0,0,5,0,5
2007,Iran (Islamic Rep. of),IRN,Ireland,IRL,16,0,40,5,61
2007,Iraq,IRQ,Ireland,IRL,19,0,27,0,46
2007,Israel,ISR,Ireland,IRL,0,0,27,5,32
2007,Kazakhstan,KAZ,Ireland,IRL,0,0,5,0,5
2007,Kenya,KEN,Ireland,IRL,0,0,16,0,16
2007,Kuwait,KWT,Ireland,IRL,0,0,5,0,5
2007,Liberia,LBR,Ireland,IRL,0,0,18,5,23
2007,Libya,LBY,Ireland,IRL,0,0,5,0,5
2007,Lebanon,LBN,Ireland,IRL,0,0,5,0,5
2007,North Macedonia,MKD,Ireland,IRL,0,0,5,0,5
2007,Rep. of Moldova,MDA,Ireland,IRL,5,0,34,0,39
2007,Malaysia,MYS,Ireland,IRL,0,0,5,0,5
2007,Malawi,MWI,Ireland,IRL,0,0,0,5,5
2007,Mongolia,MNG,Ireland,IRL,0,0,5,0,5
2007,Morocco,MAR,Ireland,IRL,0,0,5,0,5
2007,Nigeria,NGA,Ireland,IRL,25,0,522,45,592
2007,Pakistan,PAK,Ireland,IRL,12,0,50,0,62
2007,Romania,ROU,Ireland,IRL,0,0,42,0,42
2007,South Africa,ZAF,Ireland,IRL,0,0,32,5,37
2007,Russian Federation,RUS,Ireland,IRL,10,0,17,0,27
2007,Rwanda,RWA,Ireland,IRL,5,0,5,0,10
2007,Serbia and Kosovo: S/RES/1244 (1999),SRB,Ireland,IRL,0,0,11,0,11
2007,Sierra Leone,SLE,Ireland,IRL,0,0,10,0,10
2007,Somalia,SOM,Ireland,IRL,15,0,79,5,99
2007,Sudan,SDN,Ireland,IRL,14,0,77,5,96
2007,Syrian Arab Rep.,SYR,Ireland,IRL,5,0,0,0,5
2007,Togo,TGO,Ireland,IRL,5,0,11,0,16
2007,Turkey,TUR,Ireland,IRL,0,0,5,0,5
2007,Uganda,UGA,Ireland,IRL,0,0,12,5,17
2007,Ukraine,UKR,Ireland,IRL,0,0,11,0,11
2007,Zimbabwe,ZWE,Ireland,IRL,10,0,24,5,39
2007,Myanmar,MMR,Japan,JPN,5,20,149,0,174
2007,Turkey,TUR,Japan,JPN,0,5,11,0,16
2007,Algeria,DZA,Malta,MLT,0,0,5,0,5
2007,Egypt,EGY,Malta,MLT,0,0,5,0,5
2007,Burkina Faso,BFA,Malta,MLT,0,0,5,0,5
2007,Chad,TCD,Malta,MLT,0,0,5,0,5
2007,Dem. Rep. of the Congo,COD,Malta,MLT,0,0,10,0,10
2007,Eritrea,ERI,Malta,MLT,0,0,18,0,18
2007,Ethiopia,ETH,Malta,MLT,0,0,34,0,34
2007,Palestinian,PSE,Malta,MLT,0,0,5,0,5
2007,Cote d'Ivoire,CIV,Malta,MLT,0,0,59,0,59
2007,Iraq,IRQ,Malta,MLT,0,0,5,0,5
2007,Liberia,LBR,Malta,MLT,0,0,5,0,5
2007,Mali,MLI,Malta,MLT,0,0,27,0,27
2007,Niger,NER,Malta,MLT,0,0,39,0,39
2007,Serbia and Kosovo: S/RES/1244 (1999),SRB,Malta,MLT,0,0,5,0,5
2007,Senegal,SEN,Malta,MLT,0,0,5,0,5
2007,Somalia,SOM,Malta,MLT,0,0,5,0,5
2007,Sudan,SDN,Malta,MLT,0,0,24,0,24
2007,Togo,TGO,Malta,MLT,0,0,18,0,18
2007,Turkey,TUR,Malta,MLT,0,0,5,0,5
2007,Bhutan,BTN,Nepal,NPL,0,0,0,336,336
2007,Afghanistan,AFG,Netherlands,NLD,13,58,168,101,340
2007,Algeria,DZA,Netherlands,NLD,0,0,0,5,5
2007,Angola,AGO,Netherlands,NLD,0,10,28,28,66
2007,Armenia,ARM,Netherlands,NLD,5,21,11,25,62
2007,Azerbaijan,AZE,Netherlands,NLD,10,28,36,28,102
2007,Burundi,BDI,Netherlands,NLD,5,10,30,10,55
2007,Belarus,BLR,Netherlands,NLD,5,5,0,0,10
2007,Bosnia and Herzegovina,BIH,Netherlands,NLD,0,22,10,36,68
2007,China,CHN,Netherlands,NLD,5,5,11,12,33
2007,Cameroon,CMR,Netherlands,NLD,5,0,0,0,5
2007,Congo,COG,Netherlands,NLD,0,10,11,5,26
2007,Dem. Rep. of the Congo,COD,Netherlands,NLD,5,5,10,10,30
2007,Colombia,COL,Netherlands,NLD,5,5,10,13,33
2007,Cuba,CUB,Netherlands,NLD,0,0,5,0,5
2007,Eritrea,ERI,Netherlands,NLD,5,20,0,5,30
2007,Ethiopia,ETH,Netherlands,NLD,5,5,5,5,20
2007,Georgia,GEO,Netherlands,NLD,0,5,13,0,18
2007,Guinea,GIN,Netherlands,NLD,5,10,5,20,40
2007,Croatia,HRV,Netherlands,NLD,0,0,0,5,5
2007,Cote d'Ivoire,CIV,Netherlands,NLD,0,5,0,5,10
2007,India,IND,Netherlands,NLD,0,0,0,5,5
2007,Indonesia,IDN,Netherlands,NLD,0,0,0,5,5
2007,Iran (Islamic Rep. of),IRN,Netherlands,NLD,17,51,19,57,144
2007,Iraq,IRQ,Netherlands,NLD,28,465,59,127,679
2007,Kazakhstan,KAZ,Netherlands,NLD,0,5,0,5,10
2007,Kenya,KEN,Netherlands,NLD,0,0,5,0,5
2007,Kyrgyzstan,KGZ,Netherlands,NLD,5,0,5,0,10
2007,Dem. People's Rep. of Korea,PRK,Netherlands,NLD,0,5,0,0,5
2007,Liberia,LBR,Netherlands,NLD,0,10,16,5,31
2007,Libya,LBY,Netherlands,NLD,0,18,0,5,23
2007,Lebanon,LBN,Netherlands,NLD,0,5,0,0,5
2007,Sri Lanka,LKA,Netherlands,NLD,0,12,0,5,17
2007,Rep. of Moldova,MDA,Netherlands,NLD,0,0,5,0,5
2007,Mali,MLI,Netherlands,NLD,0,5,0,0,5
2007,Mongolia,MNG,Netherlands,NLD,0,5,0,5,10
2007,Morocco,MAR,Netherlands,NLD,0,0,5,0,5
2007,Nepal,NPL,Netherlands,NLD,14,5,10,0,29
2007,Nigeria,NGA,Netherlands,NLD,0,5,11,5,21
2007,Pakistan,PAK,Netherlands,NLD,0,5,14,5,24
2007,Russian Federation,RUS,Netherlands,NLD,10,15,15,25,65
2007,Rwanda,RWA,Netherlands,NLD,0,11,5,15,31
2007,Saudi Arabia,SAU,Netherlands,NLD,0,0,5,0,5
2007,Serbia and Kosovo: S/RES/1244 (1999),SRB,Netherlands,NLD,0,24,13,40,77
2007,Sierra Leone,SLE,Netherlands,NLD,0,14,15,36,65
2007,Somalia,SOM,Netherlands,NLD,0,50,16,25,91
2007,Sudan,SDN,Netherlands,NLD,5,10,16,14,45
2007,Slovakia,SVK,Netherlands,NLD,0,0,0,5,5
2007,Syrian Arab Rep.,SYR,Netherlands,NLD,5,0,13,12,30
2007,Tajikistan,TJK,Netherlands,NLD,0,5,0,0,5
2007,Togo,TGO,Netherlands,NLD,0,0,0,14,14
2007,Turkey,TUR,Netherlands,NLD,11,16,17,16,60
2007,Uganda,UGA,Netherlands,NLD,5,0,0,0,5
2007,Ukraine,UKR,Netherlands,NLD,5,0,11,0,16
2007,Uzbekistan,UZB,Netherlands,NLD,0,5,0,5,10
2007,Stateless,XXA,Netherlands,NLD,12,31,11,14,68
2007,Afghanistan,AFG,Norway,NOR,5,231,498,53,787
2007,Albania,ALB,Norway,NOR,0,0,37,0,37
2007,Algeria,DZA,Norway,NOR,0,10,37,10,57
2007,Angola,AGO,Norway,NOR,0,5,18,5,28
2007,Egypt,EGY,Norway,NOR,0,0,5,0,5
2007,Armenia,ARM,Norway,NOR,0,10,17,0,27
2007,Azerbaijan,AZE,Norway,NOR,0,5,71,12,88
2007,Burundi,BDI,Norway,NOR,0,10,31,22,63
2007,Bangladesh,BGD,Norway,NOR,0,0,5,0,5
2007,Bhutan,BTN,Norway,NOR,0,0,10,0,10
2007,Belarus,BLR,Norway,NOR,0,17,12,5,34
2007,Bosnia and Herzegovina,BIH,Norway,NOR,0,10,28,10,48
2007,Bulgaria,BGR,Norway,NOR,0,0,10,0,10
2007,China,CHN,Norway,NOR,0,5,11,0,16
2007,Chile,CHL,Norway,NOR,0,0,5,0,5
2007,Cameroon,CMR,Norway,NOR,0,0,13,5,18
2007,Congo,COG,Norway,NOR,0,0,5,0,5
2007,Dem. Rep. of the Congo,COD,Norway,NOR,0,0,38,5,43
2007,Czechia,CZE,Norway,NOR,0,0,5,0,5
2007,Eritrea,ERI,Norway,NOR,0,20,28,74,122
2007,Ethiopia,ETH,Norway,NOR,5,88,242,29,364
2007,Gambia,GMB,Norway,NOR,0,0,5,0,5
2007,Georgia,GEO,Norway,NOR,0,5,14,0,19
2007,Ghana,GHA,Norway,NOR,0,0,0,10,10
2007,Guinea,GIN,Norway,NOR,0,0,12,0,12
2007,Croatia,HRV,Norway,NOR,0,0,11,0,11
2007,Cote d'Ivoire,CIV,Norway,NOR,0,0,5,5,10
2007,India,IND,Norway,NOR,0,5,19,0,24
2007,Iran (Islamic Rep. of),IRN,Norway,NOR,0,104,311,32,447
2007,Iraq,IRQ,Norway,NOR,0,185,443,198,826
2007,Israel,ISR,Norway,NOR,0,0,13,0,13
2007,Jordan,JOR,Norway,NOR,0,5,5,0,10
2007,Kazakhstan,KAZ,Norway,NOR,0,10,11,0,21
2007,Kenya,KEN,Norway,NOR,0,5,14,0,19
2007,Kyrgyzstan,KGZ,Norway,NOR,0,5,31,5,41
2007,Liberia,LBR,Norway,NOR,0,0,18,0,18
2007,Libya,LBY,Norway,NOR,0,0,37,5,42
2007,Lebanon,LBN,Norway,NOR,0,5,13,10,28
2007,Sri Lanka,LKA,Norway,NOR,0,14,28,33,75
2007,Mauritania,MRT,Norway,NOR,0,0,5,0,5
2007,North Macedonia,MKD,Norway,NOR,0,0,32,5,37
2007,Rep. of Moldova,MDA,Norway,NOR,0,0,25,0,25
2007,Mongolia,MNG,Norway,NOR,0,0,0,5,5
2007,Morocco,MAR,Norway,NOR,0,5,12,0,17
2007,Myanmar,MMR,Norway,NOR,0,12,0,0,12
2007,Nepal,NPL,Norway,NOR,0,0,76,5,81
2007,Netherlands,NLD,Norway,NOR,0,0,5,0,5
2007,Niger,NER,Norway,NOR,0,0,13,0,13
2007,Nigeria,NGA,Norway,NOR,0,5,42,12,59
2007,Pakistan,PAK,Norway,NOR,5,5,21,5,36
2007,Romania,ROU,Norway,NOR,0,0,5,0,5
2007,Russian Federation,RUS,Norway,NOR,5,155,187,115,462
2007,Rwanda,RWA,Norway,NOR,0,20,39,5,64
2007,Serbia and Kosovo: S/RES/1244 (1999),SRB,Norway,NOR,19,129,336,55,539
2007,Senegal,SEN,Norway,NOR,0,0,5,0,5
2007,Sierra Leone,SLE,Norway,NOR,0,0,26,5,31
2007,Somalia,SOM,Norway,NOR,5,278,199,46,528
2007,Viet Nam,VNM,Norway,NOR,0,5,12,0,17
2007,Sudan,SDN,Norway,NOR,0,0,36,5,41
2007,Slovakia,SVK,Norway,NOR,0,0,16,0,16
2007,Syrian Arab Rep.,SYR,Norway,NOR,0,24,28,17,69
2007,United Rep. of Tanzania,TZA,Norway,NOR,0,0,0,5,5
2007,Tajikistan,TJK,Norway,NOR,0,5,0,0,5
2007,Togo,TGO,Norway,NOR,0,5,5,0,10
2007,Tunisia,TUN,Norway,NOR,0,0,5,5,10
2007,Turkey,TUR,Norway,NOR,0,22,58,18,98
2007,Uganda,UGA,Norway,NOR,0,0,14,0,14
2007,Ukraine,UKR,Norway,NOR,0,0,11,0,11
2007,Uzbekistan,UZB,Norway,NOR,0,13,27,5,45
2007,Venezuela (Bolivarian Republic of),VEN,Norway,NOR,0,0,5,0,5
2007,Western Sahara,ESH,Norway,NOR,0,0,5,5,10
2007,Yemen,YEM,Norway,NOR,0,0,0,5,5
2007,Zambia,ZMB,Norway,NOR,0,0,10,0,10
2007,Stateless,XXA,Norway,NOR,0,78,122,64,264
2007,Bangladesh,BGD,New Zealand,NZL,0,0,10,0,10
2007,Chad,TCD,New Zealand,NZL,0,0,5,0,5
2007,China,CHN,New Zealand,NZL,13,0,0,0,13
2007,Czechia,CZE,New Zealand,NZL,0,0,5,0,5
2007,Fiji,FJI,New Zealand,NZL,0,0,12,0,12
2007,Hungary,HUN,New Zealand,NZL,0,0,0,14,14
2007,India,IND,New Zealand,NZL,0,0,5,5,10
2007,Iran (Islamic Rep. of),IRN,New Zealand,NZL,10,0,20,5,35
2007,Iraq,IRQ,New Zealand,NZL,5,0,0,0,5
2007,Israel,ISR,New Zealand,NZL,0,0,5,0,5
2007,Kyrgyzstan,KGZ,New Zealand,NZL,5,0,0,0,5
2007,Sri Lanka,LKA,New Zealand,NZL,5,0,22,0,27
2007,Nepal,NPL,New Zealand,NZL,5,0,0,0,5
2007,Pakistan,PAK,New Zealand,NZL,5,0,5,0,10
2007,Somalia,SOM,New Zealand,NZL,0,0,5,0,5
2007,Slovakia,SVK,New Zealand,NZL,5,0,5,0,10
2007,Zimbabwe,ZWE,New Zealand,NZL,0,0,5,0,5
2007,Algeria,DZA,Poland,POL,0,0,5,0,5
2007,Armenia,ARM,Poland,POL,0,0,5,0,5
2007,Bangladesh,BGD,Poland,POL,0,0,5,0,5
2007,Belarus,BLR,Poland,POL,0,0,22,0,22
2007,Cameroon,CMR,Poland,POL,0,0,5,0,5
2007,Dem. Rep. of the Congo,COD,Poland,POL,0,0,5,0,5
2007,Palestinian,PSE,Poland,POL,0,0,5,0,5
2007,Georgia,GEO,Poland,POL,0,0,0,5,5
2007,India,IND,Poland,POL,0,0,5,0,5
2007,Kyrgyzstan,KGZ,Poland,POL,0,0,0,5,5
2007,Mongolia,MNG,Poland,POL,0,0,5,0,5
2007,Nigeria,NGA,Poland,POL,0,0,5,0,5
2007,Pakistan,PAK,Poland,POL,0,0,0,5,5
2007,Russian Federation,RUS,Poland,POL,61,40,399,130,630
2007,Sierra Leone,SLE,Poland,POL,0,0,5,0,5
2007,Viet Nam,VNM,Poland,POL,0,0,5,0,5
2007,Turkey,TUR,Poland,POL,0,0,5,0,5
2007,Uganda,UGA,Poland,POL,0,0,5,0,5
2007,Ukraine,UKR,Poland,POL,0,0,24,0,24
2007,Stateless,XXA,Poland,POL,0,0,5,0,5
2007,Afghanistan,AFG,Sweden,SWE,15,42,110,10,177
2007,Albania,ALB,Sweden,SWE,5,10,15,5,35
2007,Algeria,DZA,Sweden,SWE,0,0,42,10,52
2007,Angola,AGO,Sweden,SWE,0,10,11,0,21
2007,Egypt,EGY,Sweden,SWE,0,0,25,11,36
2007,Argentina,ARG,Sweden,SWE,0,0,5,0,5
2007,Armenia,ARM,Sweden,SWE,0,10,82,14,106
2007,Azerbaijan,AZE,Sweden,SWE,11,15,64,15,105
2007,Burundi,BDI,Sweden,SWE,5,5,40,5,55
2007,Benin,BEN,Sweden,SWE,0,0,5,0,5
2007,Bangladesh,BGD,Sweden,SWE,0,10,36,5,51
2007,Belarus,BLR,Sweden,SWE,0,5,96,21,122
2007,Bolivia (Plurinational State of),BOL,Sweden,SWE,0,5,469,62,536
2007,Bosnia and Herzegovina,BIH,Sweden,SWE,0,15,53,16,84
2007,Bulgaria,BGR,Sweden,SWE,0,0,36,19,55
2007,China,CHN,Sweden,SWE,10,0,26,0,36
2007,Chile,CHL,Sweden,SWE,0,0,15,0,15
2007,Cameroon,CMR,Sweden,SWE,0,0,14,0,14
2007,Congo,COG,Sweden,SWE,0,0,14,0,14
2007,Dem. Rep. of the Congo,COD,Sweden,SWE,5,5,72,0,82
2007,Colombia,COL,Sweden,SWE,0,0,13,0,13
2007,Cuba,CUB,Sweden,SWE,0,0,5,0,5
2007,Ecuador,ECU,Sweden,SWE,0,0,12,0,12
2007,Eritrea,ERI,Sweden,SWE,21,27,146,14,208
2007,Ethiopia,ETH,Sweden,SWE,0,5,48,5,58
2007,Georgia,GEO,Sweden,SWE,0,10,36,5,51
2007,Ghana,GHA,Sweden,SWE,0,0,5,5,10
2007,Guinea,GIN,Sweden,SWE,5,0,11,5,21
2007,Honduras,HND,Sweden,SWE,0,5,0,0,5
2007,Croatia,HRV,Sweden,SWE,0,0,10,0,10
2007,Hungary,HUN,Sweden,SWE,0,0,5,5,10
2007,Cote d'Ivoire,CIV,Sweden,SWE,0,5,13,0,18
2007,India,IND,Sweden,SWE,0,0,27,0,27
2007,Iran (Islamic Rep. of),IRN,Sweden,SWE,25,24,123,23,195
2007,Iraq,IRQ,Sweden,SWE,10,75,666,115,866
2007,Israel,ISR,Sweden,SWE,0,0,0,5,5
2007,Jordan,JOR,Sweden,SWE,0,5,26,0,31
2007,Kazakhstan,KAZ,Sweden,SWE,5,5,22,10,42
2007,Kenya,KEN,Sweden,SWE,0,0,14,5,19
2007,Kyrgyzstan,KGZ,Sweden,SWE,0,5,16,0,21
2007,Liberia,LBR,Sweden,SWE,0,0,14,0,14
2007,Libya,LBY,Sweden,SWE,5,5,114,27,151
2007,Lebanon,LBN,Sweden,SWE,5,26,187,23,241
2007,Sri Lanka,LKA,Sweden,SWE,0,0,5,0,5
2007,North Macedonia,MKD,Sweden,SWE,0,0,26,5,31
2007,Rep. of Moldova,MDA,Sweden,SWE,0,0,12,0,12
2007,Mongolia,MNG,Sweden,SWE,0,5,139,27,171
2007,Morocco,MAR,Sweden,SWE,0,0,15,5,20
2007,Montenegro,MNE,Sweden,SWE,0,5,17,0,22
2007,Myanmar,MMR,Sweden,SWE,0,0,5,0,5
2007,Nepal,NPL,Sweden,SWE,0,0,15,5,20
2007,Nicaragua,NIC,Sweden,SWE,0,0,5,0,5
2007,Nigeria,NGA,Sweden,SWE,0,5,44,5,54
2007,Pakistan,PAK,Sweden,SWE,0,0,28,5,33
2007,Peru,PER,Sweden,SWE,0,0,14,0,14
2007,Romania,ROU,Sweden,SWE,0,5,14,5,24
2007,Russian Federation,RUS,Sweden,SWE,0,19,195,40,254
2007,Rwanda,RWA,Sweden,SWE,0,0,12,0,12
2007,El Salvador,SLV,Sweden,SWE,0,0,10,5,15
2007,Saudi Arabia,SAU,Sweden,SWE,0,0,5,0,5
2007,Serbia and Kosovo: S/RES/1244 (1999),SRB,Sweden,SWE,39,68,539,60,706
2007,Senegal,SEN,Sweden,SWE,0,0,5,0,5
2007,Sierra Leone,SLE,Sweden,SWE,0,0,12,0,12
2007,Somalia,SOM,Sweden,SWE,0,16,45,11,72
2007,Viet Nam,VNM,Sweden,SWE,0,0,21,5,26
2007,Sudan,SDN,Sweden,SWE,5,0,10,0,15
2007,Syrian Arab Rep.,SYR,Sweden,SWE,10,5,134,11,160
2007,United Rep. of Tanzania,TZA,Sweden,SWE,0,0,5,0,5
2007,Thailand,THA,Sweden,SWE,0,5,0,0,5
2007,Tajikistan,TJK,Sweden,SWE,0,0,5,0,5
2007,Turkmenistan,TKM,Sweden,SWE,0,5,0,0,5
2007,Togo,TGO,Sweden,SWE,0,0,5,0,5
2007,Tunisia,TUN,Sweden,SWE,5,0,19,0,24
2007,Turkey,TUR,Sweden,SWE,0,11,92,17,120
2007,Uganda,UGA,Sweden,SWE,0,0,12,0,12
2007,Ukraine,UKR,Sweden,SWE,0,0,28,5,33
2007,United States of America,USA,Sweden,SWE,0,0,0,5,5
2007,Uzbekistan,UZB,Sweden,SWE,0,15,81,24,120
2007,Yemen,YEM,Sweden,SWE,0,0,5,0,5
2007,Zimbabwe,ZWE,Sweden,SWE,0,0,5,0,5
2007,Stateless,XXA,Sweden,SWE,0,60,210,40,310
2007,Dem. Rep. of the Congo,COD,Togo,TGO,0,0,0,5,5
2007,Afghanistan,AFG,Ukraine,UKR,5,0,47,5,57
2007,Angola,AGO,Ukraine,UKR,0,0,0,19,19
2007,Armenia,ARM,Ukraine,UKR,0,0,0,13,13
2007,Azerbaijan,AZE,Ukraine,UKR,0,0,0,5,5
2007,Bangladesh,BGD,Ukraine,UKR,0,0,83,0,83
2007,China,CHN,Ukraine,UKR,0,0,0,10,10
2007,Cameroon,CMR,Ukraine,UKR,0,0,5,0,5
2007,Congo,COG,Ukraine,UKR,0,0,5,0,5
2007,Dem. Rep. of the Congo,COD,Ukraine,UKR,0,0,5,5,10
2007,Eritrea,ERI,Ukraine,UKR,0,0,0,5,5
2007,Ethiopia,ETH,Ukraine,UKR,0,0,10,0,10
2007,Palestinian,PSE,Ukraine,UKR,0,0,13,42,55
2007,Georgia,GEO,Ukraine,UKR,0,0,0,5,5
2007,Ghana,GHA,Ukraine,UKR,0,0,5,0,5
2007,Cote d'Ivoire,CIV,Ukraine,UKR,0,0,5,0,5
2007,India,IND,Ukraine,UKR,0,0,98,0,98
2007,Iran (Islamic Rep. of),IRN,Ukraine,UKR,0,0,0,14,14
2007,Iraq,IRQ,Ukraine,UKR,0,0,11,12,23
2007,Sri Lanka,LKA,Ukraine,UKR,0,0,5,5,10
2007,Mauritania,MRT,Ukraine,UKR,0,0,0,5,5
2007,Nepal,NPL,Ukraine,UKR,0,0,5,0,5
2007,Nigeria,NGA,Ukraine,UKR,0,0,0,10,10
2007,Pakistan,PAK,Ukraine,UKR,0,0,163,0,163
2007,Russian Federation,RUS,Ukraine,UKR,0,0,5,58,63
2007,Somalia,SOM,Ukraine,UKR,0,0,0,27,27
2007,Viet Nam,VNM,Ukraine,UKR,0,0,5,0,5
2007,Sudan,SDN,Ukraine,UKR,0,0,10,13,23
2007,Syrian Arab Rep.,SYR,Ukraine,UKR,0,0,10,11,21
2007,Uganda,UGA,Ukraine,UKR,0,0,0,5,5
2007,Uzbekistan,UZB,Ukraine,UKR,0,0,0,5,5
2007,Stateless,XXA,Ukraine,UKR,0,0,5,0,5
2008,Central African Rep.,CAF,Benin,BEN,0,0,5,0,5
2008,Congo,COG,Benin,BEN,0,0,29,0,29
2008,Dem. Rep. of the Congo,COD,Benin,BEN,5,0,79,0,84
2008,Cote d'Ivoire,CIV,Benin,BEN,0,0,0,5,5
2008,Nigeria,NGA,Benin,BEN,0,0,81,0,81
2008,Rwanda,RWA,Benin,BEN,5,0,0,0,5
2008,Togo,TGO,Benin,BEN,0,0,143,0,143
2008,Cuba,CUB,Colombia,COL,0,0,10,0,10
2008,Afghanistan,AFG,Cyprus,CYP,0,0,48,14,62
2008,Egypt,EGY,Cyprus,CYP,0,0,16,5,21
2008,Armenia,ARM,Cyprus,CYP,0,0,117,12,129
2008,Bangladesh,BGD,Cyprus,CYP,0,0,268,61,329
2008,China,CHN,Cyprus,CYP,0,0,5,5,10
2008,Cameroon,CMR,Cyprus,CYP,0,0,16,11,27
2008,Dem. Rep. of the Congo,COD,Cyprus,CYP,0,0,5,0,5
2008,Palestinian,PSE,Cyprus,CYP,0,0,5,0,5
2008,Georgia,GEO,Cyprus,CYP,0,10,74,34,118
2008,India,IND,Cyprus,CYP,0,0,10,21,31
2008,Iran (Islamic Rep. of),IRN,Cyprus,CYP,10,0,45,14,69
2008,Iraq,IRQ,Cyprus,CYP,0,0,16,0,16
2008,Jordan,JOR,Cyprus,CYP,0,0,0,5,5
2008,Lebanon,LBN,Cyprus,CYP,0,0,5,0,5
2008,Sri Lanka,LKA,Cyprus,CYP,0,0,291,44,335
2008,Rep. of Moldova,MDA,Cyprus,CYP,0,0,25,5,30
2008,Nepal,NPL,Cyprus,CYP,0,0,0,10,10
2008,Nigeria,NGA,Cyprus,CYP,0,0,22,13,35
2008,Pakistan,PAK,Cyprus,CYP,0,0,301,20,321
2008,Philippines,PHL,Cyprus,CYP,0,0,18,5,23
2008,Russian Federation,RUS,Cyprus,CYP,0,5,24,5,34
2008,Serbia and Kosovo: S/RES/1244 (1999),SRB,Cyprus,CYP,0,12,0,0,12
2008,Somalia,SOM,Cyprus,CYP,0,0,0,5,5
2008,Viet Nam,VNM,Cyprus,CYP,0,0,5,0,5
2008,Syrian Arab Rep.,SYR,Cyprus,CYP,0,5,1011,97,1113
2008,Turkey,TUR,Cyprus,CYP,5,0,32,5,42
2008,Ukraine,UKR,Cyprus,CYP,0,5,30,11,46
2008,Uzbekistan,UZB,Cyprus,CYP,0,0,0,5,5
2008,Afghanistan,AFG,Czechia,CZE,0,0,0,5,5
2008,Algeria,DZA,Czechia,CZE,0,0,0,5,5
2008,Egypt,EGY,Czechia,CZE,0,0,0,5,5
2008,Armenia,ARM,Czechia,CZE,0,0,26,0,26
2008,Azerbaijan,AZE,Czechia,CZE,0,0,5,0,5
2008,Bangladesh,BGD,Czechia,CZE,0,0,5,5,10
2008,Belarus,BLR,Czechia,CZE,5,0,41,5,51
2008,China,CHN,Czechia,CZE,0,0,24,10,34
2008,Cameroon,CMR,Czechia,CZE,0,0,5,0,5
2008,Dem. Rep. of the Congo,COD,Czechia,CZE,5,0,5,0,10
2008,Georgia,GEO,Czechia,CZE,0,0,14,0,14
2008,Ghana,GHA,Czechia,CZE,0,0,5,0,5
2008,Guinea,GIN,Czechia,CZE,0,0,5,0,5
2008,Cote d'Ivoire,CIV,Czechia,CZE,0,0,5,0,5
2008,India,IND,Czechia,CZE,0,0,12,0,12
2008,Iraq,IRQ,Czechia,CZE,11,0,0,0,11
2008,Kazakhstan,KAZ,Czechia,CZE,5,0,132,10,147
2008,Kyrgyzstan,KGZ,Czechia,CZE,0,0,27,17,44
2008,Sri Lanka,LKA,Czechia,CZE,0,0,5,12,17
2008,North Macedonia,MKD,Czechia,CZE,0,0,5,5,10
2008,Rep. of Moldova,MDA,Czechia,CZE,0,0,13,0,13
2008,Mongolia,MNG,Czechia,CZE,0,0,94,38,132
2008,Morocco,MAR,Czechia,CZE,0,0,0,5,5
2008,Nigeria,NGA,Czechia,CZE,0,0,25,5,30
2008,Pakistan,PAK,Czechia,CZE,0,0,5,5,10
2008,Russian Federation,RUS,Czechia,CZE,5,0,46,15,66
2008,Serbia and Kosovo: S/RES/1244 (1999),SRB,Czechia,CZE,0,0,10,5,15
2008,Senegal,SEN,Czechia,CZE,0,0,0,5,5
2008,Sierra Leone,SLE,Czechia,CZE,0,0,0,5,5
2008,Somalia,SOM,Czechia,CZE,0,0,5,0,5
2008,Viet Nam,VNM,Czechia,CZE,0,0,52,18,70
2008,Syrian Arab Rep.,SYR,Czechia,CZE,0,0,5,0,5
2008,Turkey,TUR,Czechia,CZE,5,0,50,153,208
2008,Ukraine,UKR,Czechia,CZE,5,0,186,36,227
2008,Uzbekistan,UZB,Czechia,CZE,0,0,17,0,17
2008,Stateless,XXA,Czechia,CZE,0,0,10,0,10
2008,Afghanistan,AFG,Denmark,DNK,0,10,31,0,41
2008,Algeria,DZA,Denmark,DNK,0,0,5,0,5
2008,Armenia,ARM,Denmark,DNK,0,0,5,0,5
2008,Azerbaijan,AZE,Denmark,DNK,0,5,5,0,10
2008,Belarus,BLR,Denmark,DNK,0,0,5,0,5
2008,Bosnia and Herzegovina,BIH,Denmark,DNK,0,0,10,0,10
2008,China,CHN,Denmark,DNK,0,0,14,0,14
2008,Georgia,GEO,Denmark,DNK,0,0,5,0,5
2008,Haiti,HTI,Denmark,DNK,0,0,5,0,5
2008,Iran (Islamic Rep. of),IRN,Denmark,DNK,5,5,15,0,25
2008,Iraq,IRQ,Denmark,DNK,74,21,71,0,166
2008,Kyrgyzstan,KGZ,Denmark,DNK,0,0,5,0,5
2008,Liberia,LBR,Denmark,DNK,0,0,5,0,5
2008,Lebanon,LBN,Denmark,DNK,0,0,5,0,5
2008,Sri Lanka,LKA,Denmark,DNK,0,5,15,0,20
2008,Nigeria,NGA,Denmark,DNK,0,0,11,0,11
2008,Pakistan,PAK,Denmark,DNK,0,0,5,0,5
2008,Russian Federation,RUS,Denmark,DNK,0,0,18,0,18
2008,Serbia and Kosovo: S/RES/1244 (1999),SRB,Denmark,DNK,0,0,18,0,18
2008,Somalia,SOM,Denmark,DNK,0,0,5,0,5
2008,Syrian Arab Rep.,SYR,Denmark,DNK,5,0,5,0,10
2008,Turkey,TUR,Denmark,DNK,0,0,5,0,5
2008,Uzbekistan,UZB,Denmark,DNK,0,0,5,0,5
2008,Stateless,XXA,Denmark,DNK,10,0,11,0,21
2008,Iran (Islamic Rep. of),IRN,Greece,GRC,5,0,0,0,5
2008,Iraq,IRQ,Greece,GRC,331,14,0,0,345
2008,Somalia,SOM,Greece,GRC,0,5,0,0,5
2008,Viet Nam,VNM,Greece,GRC,5,0,0,0,5
2008,Pakistan,PAK,Croatia,HRV,0,5,0,0,5
2008,Serbia and Kosovo: S/RES/1244 (1999),SRB,Croatia,HRV,0,0,14,0,14
2008,Russian Federation,RUS,Iceland,ISL,0,0,5,0,5
2008,Afghanistan,AFG,Ireland,IRL,20,0,41,10,71
2008,Albania,ALB,Ireland,IRL,5,0,23,0,28
2008,Algeria,DZA,Ireland,IRL,5,0,11,5,21
2008,Angola,AGO,Ireland,IRL,5,0,15,0,20
2008,Egypt,EGY,Ireland,IRL,0,0,5,0,5
2008,Armenia,ARM,Ireland,IRL,0,0,10,0,10
2008,Azerbaijan,AZE,Ireland,IRL,5,0,0,0,5
2008,Burundi,BDI,Ireland,IRL,0,0,15,0,15
2008,Benin,BEN,Ireland,IRL,0,0,10,0,10
2008,Bangladesh,BGD,Ireland,IRL,0,0,10,0,10
2008,Bhutan,BTN,Ireland,IRL,5,0,5,0,10
2008,Belarus,BLR,Ireland,IRL,0,0,12,0,12
2008,Botswana,BWA,Ireland,IRL,0,0,5,0,5
2008,Brazil,BRA,Ireland,IRL,0,0,10,0,10
2008,China,CHN,Ireland,IRL,5,0,30,5,40
2008,Cameroon,CMR,Ireland,IRL,5,0,47,5,57
2008,Congo,COG,Ireland,IRL,0,0,13,0,13
2008,Dem. Rep. of the Congo,COD,Ireland,IRL,0,0,118,13,131
2008,Eritrea,ERI,Ireland,IRL,0,0,14,0,14
2008,Ethiopia,ETH,Ireland,IRL,5,0,15,0,20
2008,Gambia,GMB,Ireland,IRL,0,0,5,0,5
2008,Palestinian,PSE,Ireland,IRL,14,0,0,0,14
2008,Georgia,GEO,Ireland,IRL,5,0,79,11,95
2008,Ghana,GHA,Ireland,IRL,5,0,70,5,80
2008,Guinea,GIN,Ireland,IRL,5,0,13,0,18
2008,Guyana,GUY,Ireland,IRL,0,0,0,5,5
2008,Croatia,HRV,Ireland,IRL,10,0,12,0,22
2008,Cote d'Ivoire,CIV,Ireland,IRL,0,0,14,0,14
2008,India,IND,Ireland,IRL,0,0,12,0,12
2008,Iran (Islamic Rep. of),IRN,Ireland,IRL,11,0,17,5,33
2008,Iraq,IRQ,Ireland,IRL,31,0,29,5,65
2008,Israel,ISR,Ireland,IRL,0,0,12,5,17
2008,Jamaica,JAM,Ireland,IRL,0,0,5,0,5
2008,Kenya,KEN,Ireland,IRL,0,0,37,5,42
2008,Kuwait,KWT,Ireland,IRL,0,0,12,0,12
2008,Liberia,LBR,Ireland,IRL,0,0,19,5,24
2008,Sri Lanka,LKA,Ireland,IRL,5,0,0,0,5
2008,Rep. of Moldova,MDA,Ireland,IRL,10,0,65,12,87
2008,Malaysia,MYS,Ireland,IRL,0,0,5,0,5
2008,Malawi,MWI,Ireland,IRL,0,0,10,0,10
2008,Mongolia,MNG,Ireland,IRL,0,0,5,0,5
2008,Morocco,MAR,Ireland,IRL,5,0,0,0,5
2008,Mauritius,MUS,Ireland,IRL,0,0,13,0,13
2008,Nepal,NPL,Ireland,IRL,0,0,5,0,5
2008,Niger,NER,Ireland,IRL,0,0,5,0,5
2008,Nigeria,NGA,Ireland,IRL,57,0,804,57,918
2008,Pakistan,PAK,Ireland,IRL,16,0,49,10,75
2008,Romania,ROU,Ireland,IRL,0,0,14,0,14
2008,South Africa,ZAF,Ireland,IRL,5,0,52,0,57
2008,Russian Federation,RUS,Ireland,IRL,5,0,11,14,30
2008,Rwanda,RWA,Ireland,IRL,0,0,10,0,10
2008,Serbia and Kosovo: S/RES/1244 (1999),SRB,Ireland,IRL,5,0,33,0,38
2008,Sierra Leone,SLE,Ireland,IRL,0,0,15,0,15
2008,Somalia,SOM,Ireland,IRL,15,0,61,10,86
2008,Viet Nam,VNM,Ireland,IRL,0,0,5,0,5
2008,Sudan,SDN,Ireland,IRL,5,0,62,25,92
2008,Syrian Arab Rep.,SYR,Ireland,IRL,0,0,5,0,5
2008,United Rep. of Tanzania,TZA,Ireland,IRL,0,0,0,5,5
2008,Togo,TGO,Ireland,IRL,5,0,13,0,18
2008,Uganda,UGA,Ireland,IRL,0,0,14,0,14
2008,Ukraine,UKR,Ireland,IRL,5,0,11,5,21
2008,Uzbekistan,UZB,Ireland,IRL,0,0,5,0,5
2008,Zimbabwe,ZWE,Ireland,IRL,5,0,34,5,44
2008,Stateless,XXA,Ireland,IRL,0,0,0,5,5
2008,Myanmar,MMR,Japan,JPN,16,16,200,0,216
2008,Turkey,TUR,Japan,JPN,0,0,51,0,51
2008,Benin,BEN,Malta,MLT,0,0,5,0,5
2008,Burkina Faso,BFA,Malta,MLT,0,0,5,0,5
2008,Eritrea,ERI,Malta,MLT,0,0,12,0,12
2008,Ethiopia,ETH,Malta,MLT,0,0,11,0,11
2008,Gambia,GMB,Malta,MLT,0,0,5,0,5
2008,Ghana,GHA,Malta,MLT,0,0,46,0,46
2008,Guinea-Bissau,GNB,Malta,MLT,0,0,5,0,5
2008,Cote d'Ivoire,CIV,Malta,MLT,0,0,36,0,36
2008,Mali,MLI,Malta,MLT,0,0,15,0,15
2008,Nigeria,NGA,Malta,MLT,0,0,5,0,5
2008,Senegal,SEN,Malta,MLT,0,0,5,0,5
2008,Sierra Leone,SLE,Malta,MLT,0,0,5,0,5
2008,Somalia,SOM,Malta,MLT,0,0,15,0,15
2008,Sudan,SDN,Malta,MLT,0,0,11,0,11
2008,Togo,TGO,Malta,MLT,0,0,5,0,5
2008,Afghanistan,AFG,Norway,NOR,22,163,325,0,510
2008,Albania,ALB,Norway,NOR,0,5,32,0,37
2008,Algeria,DZA,Norway,NOR,0,5,22,0,27
2008,Angola,AGO,Norway,NOR,0,0,23,0,23
2008,Egypt,EGY,Norway,NOR,0,0,17,0,17
2008,Armenia,ARM,Norway,NOR,0,5,0,0,5
2008,Azerbaijan,AZE,Norway,NOR,0,17,36,0,53
2008,Burundi,BDI,Norway,NOR,0,10,17,0,27
2008,Bangladesh,BGD,Norway,NOR,0,0,11,0,11
2008,Bhutan,BTN,Norway,NOR,0,0,28,0,28
2008,Belarus,BLR,Norway,NOR,0,5,17,0,22
2008,Bosnia and Herzegovina,BIH,Norway,NOR,0,5,16,0,21
2008,Bulgaria,BGR,Norway,NOR,0,5,5,0,10
2008,China,CHN,Norway,NOR,0,5,5,0,10
2008,Cameroon,CMR,Norway,NOR,0,0,21,0,21
2008,Dem. Rep. of the Congo,COD,Norway,NOR,0,0,37,0,37
2008,Czechia,CZE,Norway,NOR,0,0,5,0,5
2008,Djibouti,DJI,Norway,NOR,0,0,5,0,5
2008,Eritrea,ERI,Norway,NOR,0,5,40,0,45
2008,Ethiopia,ETH,Norway,NOR,15,46,232,0,293
2008,Georgia,GEO,Norway,NOR,0,0,10,0,10
2008,Ghana,GHA,Norway,NOR,0,0,5,0,5
2008,Guinea,GIN,Norway,NOR,0,0,5,0,5
2008,Croatia,HRV,Norway,NOR,0,0,5,0,5
2008,Hungary,HUN,Norway,NOR,0,0,5,0,5
2008,Iran (Islamic Rep. of),IRN,Norway,NOR,5,22,282,0,309
2008,Iraq,IRQ,Norway,NOR,10,39,956,10,1015
2008,Israel,ISR,Norway,NOR,0,0,5,0,5
2008,Jordan,JOR,Norway,NOR,0,0,16,0,16
2008,Kazakhstan,KAZ,Norway,NOR,0,0,13,0,13
2008,Kyrgyzstan,KGZ,Norway,NOR,0,0,38,0,38
2008,Liberia,LBR,Norway,NOR,0,0,14,0,14
2008,Libya,LBY,Norway,NOR,0,5,29,0,34
2008,Lebanon,LBN,Norway,NOR,0,0,97,0,97
2008,Sri Lanka,LKA,Norway,NOR,0,0,74,0,74
2008,Latvia,LVA,Norway,NOR,0,0,5,0,5
2008,North Macedonia,MKD,Norway,NOR,0,0,18,0,18
2008,Rep. of Moldova,MDA,Norway,NOR,0,0,5,0,5
2008,Mongolia,MNG,Norway,NOR,0,0,12,0,12
2008,Morocco,MAR,Norway,NOR,0,0,12,0,12
2008,Montenegro,MNE,Norway,NOR,0,0,19,0,19
2008,Nepal,NPL,Norway,NOR,0,5,63,0,68
2008,Niger,NER,Norway,NOR,0,0,5,0,5
2008,Nigeria,NGA,Norway,NOR,0,12,32,0,44
2008,Pakistan,PAK,Norway,NOR,0,0,14,0,14
2008,Romania,ROU,Norway,NOR,0,0,10,0,10
2008,Russian Federation,RUS,Norway,NOR,5,100,330,0,435
2008,Rwanda,RWA,Norway,NOR,0,0,23,0,23
2008,Serbia and Kosovo: S/RES/1244 (1999),SRB,Norway,NOR,0,0,294,0,294
2008,Sierra Leone,SLE,Norway,NOR,0,5,5,0,10
2008,Somalia,SOM,Norway,NOR,10,46,121,0,177
2008,Viet Nam,VNM,Norway,NOR,0,0,5,0,5
2008,Sudan,SDN,Norway,NOR,0,0,41,0,41
2008,Syrian Arab Rep.,SYR,Norway,NOR,0,0,34,0,34
2008,Tajikistan,TJK,Norway,NOR,0,5,0,0,5
2008,Turkmenistan,TKM,Norway,NOR,0,0,5,0,5
2008,Turkey,TUR,Norway,NOR,0,10,38,0,48
2008,Ukraine,UKR,Norway,NOR,0,0,13,0,13
2008,Uzbekistan,UZB,Norway,NOR,5,28,28,0,61
2008,Yemen,YEM,Norway,NOR,0,5,5,0,10
2008,Zimbabwe,ZWE,Norway,NOR,0,0,5,0,5
2008,Stateless,XXA,Norway,NOR,0,10,181,0,191
2008,Afghanistan,AFG,New Zealand,NZL,5,0,0,0,5
2008,Bangladesh,BGD,New Zealand,NZL,0,0,11,0,11
2008,Bolivia (Plurinational State of),BOL,New Zealand,NZL,0,0,5,0,5
2008,China,CHN,New Zealand,NZL,14,0,0,0,14
2008,Czechia,CZE,New Zealand,NZL,0,0,5,0,5
2008,Fiji,FJI,New Zealand,NZL,0,0,10,0,10
2008,United Kingdom of Great Britain and Northern Ireland,GBR,New Zealand,NZL,0,0,0,5,5
2008,India,IND,New Zealand,NZL,0,0,5,0,5
2008,Iran (Islamic Rep. of),IRN,New Zealand,NZL,14,0,12,0,26
2008,Iraq,IRQ,New Zealand,NZL,5,0,0,0,5
2008,Sri Lanka,LKA,New Zealand,NZL,5,0,10,0,15
2008,Myanmar,MMR,New Zealand,NZL,5,0,0,0,5
2008,Nigeria,NGA,New Zealand,NZL,0,0,5,0,5
2008,South Africa,ZAF,New Zealand,NZL,0,0,5,0,5
2008,Russian Federation,RUS,New Zealand,NZL,0,0,5,0,5
2008,Somalia,SOM,New Zealand,NZL,0,0,10,0,10
2008,Slovakia,SVK,New Zealand,NZL,0,0,5,0,5
2008,Syrian Arab Rep.,SYR,New Zealand,NZL,5,0,0,0,5
2008,Belarus,BLR,Poland,POL,0,0,10,0,10
2008,Cameroon,CMR,Poland,POL,0,0,5,5,10
2008,Congo,COG,Poland,POL,0,0,5,0,5
2008,Nepal,NPL,Poland,POL,0,0,5,0,5
2008,Nigeria,NGA,Poland,POL,0,0,5,0,5
2008,Russian Federation,RUS,Poland,POL,0,5,104,132,241
2008,Serbia and Kosovo: S/RES/1244 (1999),SRB,Poland,POL,0,0,5,0,5
2008,Sierra Leone,SLE,Poland,POL,0,0,5,0,5
2008,Turkmenistan,TKM,Poland,POL,5,0,0,0,5
2008,Ukraine,UKR,Poland,POL,0,0,11,5,16
2008,Afghanistan,AFG,Sweden,SWE,19,102,281,22,424
2008,Albania,ALB,Sweden,SWE,0,0,54,10,64
2008,Algeria,DZA,Sweden,SWE,0,0,67,17,84
2008,Angola,AGO,Sweden,SWE,0,0,31,0,31
2008,Egypt,EGY,Sweden,SWE,0,0,110,11,121
2008,Armenia,ARM,Sweden,SWE,0,10,128,17,155
2008,Azerbaijan,AZE,Sweden,SWE,5,5,162,24,196
2008,Burundi,BDI,Sweden,SWE,5,17,146,15,183
2008,Benin,BEN,Sweden,SWE,0,0,5,0,5
2008,Bangladesh,BGD,Sweden,SWE,5,5,71,5,86
2008,Belarus,BLR,Sweden,SWE,0,5,265,35,305
2008,Bolivia (Plurinational State of),BOL,Sweden,SWE,0,0,372,28,400
2008,Brazil,BRA,Sweden,SWE,0,0,5,0,5
2008,Bosnia and Herzegovina,BIH,Sweden,SWE,0,17,103,15,135
2008,Bulgaria,BGR,Sweden,SWE,0,0,20,0,20
2008,China,CHN,Sweden,SWE,0,5,20,5,30
2008,Chile,CHL,Sweden,SWE,0,0,40,11,51
2008,Cameroon,CMR,Sweden,SWE,5,0,28,0,33
2008,Congo,COG,Sweden,SWE,0,0,17,0,17
2008,Dem. Rep. of the Congo,COD,Sweden,SWE,10,0,74,0,84
2008,Colombia,COL,Sweden,SWE,0,0,11,0,11
2008,Cuba,CUB,Sweden,SWE,5,0,13,5,23
2008,Czechia,CZE,Sweden,SWE,0,0,0,5,5
2008,Ecuador,ECU,Sweden,SWE,0,0,15,5,20
2008,Eritrea,ERI,Sweden,SWE,14,47,196,13,270
2008,Ethiopia,ETH,Sweden,SWE,10,10,97,5,122
2008,Gambia,GMB,Sweden,SWE,0,0,12,0,12
2008,Georgia,GEO,Sweden,SWE,0,0,64,5,69
2008,Germany,DEU,Sweden,SWE,0,5,0,0,5
2008,Ghana,GHA,Sweden,SWE,0,0,22,0,22
2008,Guatemala,GTM,Sweden,SWE,0,0,11,0,11
2008,Guinea,GIN,Sweden,SWE,0,0,16,5,21
2008,Honduras,HND,Sweden,SWE,0,0,5,0,5
2008,Croatia,HRV,Sweden,SWE,0,0,16,0,16
2008,Cote d'Ivoire,CIV,Sweden,SWE,5,0,22,5,32
2008,India,IND,Sweden,SWE,0,0,38,0,38
2008,Indonesia,IDN,Sweden,SWE,0,0,12,0,12
2008,Iran (Islamic Rep. of),IRN,Sweden,SWE,37,45,364,32,478
2008,Iraq,IRQ,Sweden,SWE,24,126,1922,481,2553
2008,Israel,ISR,Sweden,SWE,0,0,16,5,21
2008,Jordan,JOR,Sweden,SWE,0,10,46,5,61
2008,Kazakhstan,KAZ,Sweden,SWE,0,5,52,10,67
2008,Kenya,KEN,Sweden,SWE,0,5,29,5,39
2008,Kyrgyzstan,KGZ,Sweden,SWE,0,0,52,5,57
2008,Liberia,LBR,Sweden,SWE,0,0,13,0,13
2008,Libya,LBY,Sweden,SWE,5,5,326,30,366
2008,Lebanon,LBN,Sweden,SWE,0,18,475,50,543
2008,Sri Lanka,LKA,Sweden,SWE,0,0,15,0,15
2008,Latvia,LVA,Sweden,SWE,0,5,0,0,5
2008,North Macedonia,MKD,Sweden,SWE,0,5,27,0,32
2008,Rep. of Moldova,MDA,Sweden,SWE,0,0,11,0,11
2008,Mongolia,MNG,Sweden,SWE,0,5,631,24,660
2008,Morocco,MAR,Sweden,SWE,0,5,34,0,39
2008,Montenegro,MNE,Sweden,SWE,0,5,56,5,66
2008,Nepal,NPL,Sweden,SWE,0,0,15,0,15
2008,Nicaragua,NIC,Sweden,SWE,0,0,22,5,27
2008,Nigeria,NGA,Sweden,SWE,0,5,76,5,86
2008,Norway,NOR,Sweden,SWE,0,5,0,0,5
2008,Pakistan,PAK,Sweden,SWE,0,0,35,11,46
2008,Panama,PAN,Sweden,SWE,0,0,5,0,5
2008,Paraguay,PRY,Sweden,SWE,0,0,5,0,5
2008,Peru,PER,Sweden,SWE,0,0,16,5,21
2008,Philippines,PHL,Sweden,SWE,0,0,5,0,5
2008,Romania,ROU,Sweden,SWE,0,0,18,5,23
2008,Russian Federation,RUS,Sweden,SWE,5,10,380,71,466
2008,Rwanda,RWA,Sweden,SWE,0,0,5,0,5
2008,El Salvador,SLV,Sweden,SWE,0,0,48,13,61
2008,Serbia and Kosovo: S/RES/1244 (1999),SRB,Sweden,SWE,15,71,1126,144,1356
2008,Senegal,SEN,Sweden,SWE,0,0,11,0,11
2008,Sierra Leone,SLE,Sweden,SWE,0,0,12,0,12
2008,Somalia,SOM,Sweden,SWE,5,5,110,28,148
2008,Viet Nam,VNM,Sweden,SWE,0,0,47,5,52
2008,Sudan,SDN,Sweden,SWE,0,0,18,5,23
2008,Syrian Arab Rep.,SYR,Sweden,SWE,13,21,309,20,363
2008,United Rep. of Tanzania,TZA,Sweden,SWE,0,0,5,0,5
2008,Thailand,THA,Sweden,SWE,0,0,5,0,5
2008,Tajikistan,TJK,Sweden,SWE,0,0,5,0,5
2008,Turkmenistan,TKM,Sweden,SWE,0,5,0,0,5
2008,Togo,TGO,Sweden,SWE,0,0,11,0,11
2008,Tunisia,TUN,Sweden,SWE,0,0,40,5,45
2008,Turkey,TUR,Sweden,SWE,0,19,233,36,288
2008,Uganda,UGA,Sweden,SWE,0,5,24,0,29
2008,Ukraine,UKR,Sweden,SWE,0,0,46,10,56
2008,United States of America,USA,Sweden,SWE,0,0,5,5,10
2008,Uzbekistan,UZB,Sweden,SWE,5,20,419,38,482
2008,Venezuela (Bolivarian Republic of),VEN,Sweden,SWE,0,0,5,0,5
2008,Yemen,YEM,Sweden,SWE,0,0,44,0,44
2008,Stateless,XXA,Sweden,SWE,5,30,409,64,508
2008,Afghanistan,AFG,Ukraine,UKR,0,0,52,19,71
2008,Algeria,DZA,Ukraine,UKR,0,0,5,0,5
2008,Angola,AGO,Ukraine,UKR,0,0,0,5,5
2008,Azerbaijan,AZE,Ukraine,UKR,0,0,0,5,5
2008,Bangladesh,BGD,Ukraine,UKR,0,0,70,0,70
2008,Belarus,BLR,Ukraine,UKR,0,0,0,5,5
2008,Dem. Rep. of the Congo,COD,Ukraine,UKR,0,0,10,0,10
2008,Ethiopia,ETH,Ukraine,UKR,0,0,10,0,10
2008,Palestinian,PSE,Ukraine,UKR,0,0,19,0,19
2008,Georgia,GEO,Ukraine,UKR,0,0,5,0,5
2008,India,IND,Ukraine,UKR,0,0,49,5,54
2008,Iran (Islamic Rep. of),IRN,Ukraine,UKR,0,0,11,5,16
2008,Iraq,IRQ,Ukraine,UKR,0,0,21,13,34
2008,Liberia,LBR,Ukraine,UKR,0,0,0,5,5
2008,Sri Lanka,LKA,Ukraine,UKR,0,0,5,0,5
2008,Nigeria,NGA,Ukraine,UKR,0,0,5,0,5
2008,Pakistan,PAK,Ukraine,UKR,0,0,222,0,222
2008,Russian Federation,RUS,Ukraine,UKR,0,0,11,0,11
2008,Somalia,SOM,Ukraine,UKR,0,0,13,0,13
2008,Sudan,SDN,Ukraine,UKR,0,0,5,0,5
2008,Syrian Arab Rep.,SYR,Ukraine,UKR,0,0,5,0,5
2008,Uzbekistan,UZB,Ukraine,UKR,0,0,0,5,5
2008,Stateless,XXA,Ukraine,UKR,0,0,5,0,5
2009,Chad,TCD,Benin,BEN,0,0,14,0,14
2009,Congo,COG,Benin,BEN,0,0,5,0,5
2009,Dem. Rep. of the Congo,COD,Benin,BEN,5,0,62,0,67
2009,Kenya,KEN,Benin,BEN,0,0,5,0,5
2009,Nigeria,NGA,Benin,BEN,0,0,30,0,30
2009,Togo,TGO,Benin,BEN,5,0,67,0,72
2009,Chad,TCD,Burkina Faso,BFA,0,0,0,5,5
2009,Congo,COG,Burkina Faso,BFA,0,0,0,11,11
2009,Dem. Rep. of the Congo,COD,Burkina Faso,BFA,0,0,0,10,10
2009,Togo,TGO,Burkina Faso,BFA,0,0,0,15,15
2009,Afghanistan,AFG,Belarus,BLR,0,0,14,0,14
2009,Azerbaijan,AZE,Belarus,BLR,0,0,5,0,5
2009,Iran (Islamic Rep. of),IRN,Belarus,BLR,0,0,5,0,5
2009,Cuba,CUB,Colombia,COL,0,0,5,0,5
2009,Eritrea,ERI,Colombia,COL,0,0,5,0,5
2009,Ethiopia,ETH,Colombia,COL,0,0,5,0,5
2009,Venezuela (Bolivarian Republic of),VEN,Colombia,COL,0,0,5,0,5
2009,Afghanistan,AFG,Cyprus,CYP,0,0,5,0,5
2009,Egypt,EGY,Cyprus,CYP,0,0,35,16,51
2009,Armenia,ARM,Cyprus,CYP,0,10,0,0,10
2009,Bangladesh,BGD,Cyprus,CYP,0,0,171,42,213
2009,China,CHN,Cyprus,CYP,0,0,0,31,31
2009,Cameroon,CMR,Cyprus,CYP,0,0,17,10,27
2009,Palestinian,PSE,Cyprus,CYP,5,5,10,5,25
2009,Georgia,GEO,Cyprus,CYP,0,0,5,22,27
2009,Ghana,GHA,Cyprus,CYP,0,0,0,5,5
2009,Cote d'Ivoire,CIV,Cyprus,CYP,0,0,0,5,5
2009,India,IND,Cyprus,CYP,0,0,195,65,260
2009,Iran (Islamic Rep. of),IRN,Cyprus,CYP,5,0,39,36,80
2009,Iraq,IRQ,Cyprus,CYP,0,0,36,0,36
2009,Jordan,JOR,Cyprus,CYP,0,0,14,5,19
2009,Kazakhstan,KAZ,Cyprus,CYP,0,0,5,0,5
2009,Lebanon,LBN,Cyprus,CYP,0,0,5,5,10
2009,Sri Lanka,LKA,Cyprus,CYP,0,5,482,62,549
2009,Rep. of Moldova,MDA,Cyprus,CYP,0,0,0,14,14
2009,Mongolia,MNG,Cyprus,CYP,0,0,5,12,17
2009,Morocco,MAR,Cyprus,CYP,0,0,5,0,5
2009,Nepal,NPL,Cyprus,CYP,0,0,163,34,197
2009,Nigeria,NGA,Cyprus,CYP,0,0,180,14,194
2009,Pakistan,PAK,Cyprus,CYP,0,5,161,38,204
2009,Philippines,PHL,Cyprus,CYP,0,0,13,10,23
2009,Russian Federation,RUS,Cyprus,CYP,0,0,18,15,33
2009,Serbia and Kosovo: S/RES/1244 (1999),SRB,Cyprus,CYP,0,0,0,10,10
2009,Senegal,SEN,Cyprus,CYP,0,0,0,5,5
2009,Viet Nam,VNM,Cyprus,CYP,0,0,5,5,10
2009,Syrian Arab Rep.,SYR,Cyprus,CYP,10,10,344,134,498
2009,Turkey,TUR,Cyprus,CYP,0,0,21,11,32
2009,Ukraine,UKR,Cyprus,CYP,0,0,0,10,10
2009,Uzbekistan,UZB,Cyprus,CYP,0,0,5,11,16
2009,Afghanistan,AFG,Czechia,CZE,5,0,0,0,5
2009,Algeria,DZA,Czechia,CZE,0,0,0,5,5
2009,Armenia,ARM,Czechia,CZE,5,0,12,0,17
2009,Azerbaijan,AZE,Czechia,CZE,0,0,5,0,5
2009,Belarus,BLR,Czechia,CZE,10,0,46,12,68
2009,China,CHN,Czechia,CZE,0,0,11,0,11
2009,Cameroon,CMR,Czechia,CZE,0,0,5,0,5
2009,Congo,COG,Czechia,CZE,0,0,0,5,5
2009,Dem. Rep. of the Congo,COD,Czechia,CZE,12,0,0,0,12
2009,Cuba,CUB,Czechia,CZE,0,0,5,0,5
2009,Georgia,GEO,Czechia,CZE,0,0,18,13,31
2009,Kazakhstan,KAZ,Czechia,CZE,10,0,53,0,63
2009,Kyrgyzstan,KGZ,Czechia,CZE,5,0,14,0,19
2009,Sri Lanka,LKA,Czechia,CZE,0,0,0,5,5
2009,North Macedonia,MKD,Czechia,CZE,0,0,5,0,5
2009,Rep. of Moldova,MDA,Czechia,CZE,5,0,5,0,10
2009,Mongolia,MNG,Czechia,CZE,5,0,59,36,100
2009,Nigeria,NGA,Czechia,CZE,5,0,18,11,34
2009,Philippines,PHL,Czechia,CZE,0,0,0,31,31
2009,Russian Federation,RUS,Czechia,CZE,14,0,29,5,48
2009,Serbia and Kosovo: S/RES/1244 (1999),SRB,Czechia,CZE,0,0,0,13,13
2009,Viet Nam,VNM,Czechia,CZE,0,0,18,16,34
2009,Syrian Arab Rep.,SYR,Czechia,CZE,11,0,5,0,16
2009,Turkey,TUR,Czechia,CZE,5,0,18,27,50
2009,Ukraine,UKR,Czechia,CZE,21,0,84,31,136
2009,Uzbekistan,UZB,Czechia,CZE,5,0,5,0,10
2009,Stateless,XXA,Czechia,CZE,5,0,5,10,20
2009,Afghanistan,AFG,Denmark,DNK,5,16,46,0,67
2009,Armenia,ARM,Denmark,DNK,5,0,0,0,5
2009,Azerbaijan,AZE,Denmark,DNK,0,0,5,0,5
2009,Burundi,BDI,Denmark,DNK,0,0,5,0,5
2009,Bosnia and Herzegovina,BIH,Denmark,DNK,0,0,14,0,14
2009,Ghana,GHA,Denmark,DNK,0,0,5,0,5
2009,India,IND,Denmark,DNK,0,0,5,0,5
2009,Iran (Islamic Rep. of),IRN,Denmark,DNK,15,5,17,0,37
2009,Iraq,IRQ,Denmark,DNK,27,31,67,0,125
2009,Lebanon,LBN,Denmark,DNK,0,0,5,0,5
2009,Sri Lanka,LKA,Denmark,DNK,5,5,0,0,10
2009,Morocco,MAR,Denmark,DNK,0,0,5,0,5
2009,Nigeria,NGA,Denmark,DNK,0,5,12,0,17
2009,Pakistan,PAK,Denmark,DNK,0,5,0,0,5
2009,Russian Federation,RUS,Denmark,DNK,0,5,16,0,21
2009,Serbia and Kosovo: S/RES/1244 (1999),SRB,Denmark,DNK,0,0,17,0,17
2009,Somalia,SOM,Denmark,DNK,0,0,13,0,13
2009,Syrian Arab Rep.,SYR,Denmark,DNK,5,0,0,0,5
2009,Tunisia,TUN,Denmark,DNK,0,0,5,0,5
2009,Uganda,UGA,Denmark,DNK,0,0,5,0,5
2009,Zimbabwe,ZWE,Denmark,DNK,0,0,5,0,5
2009,Stateless,XXA,Denmark,DNK,5,0,13,0,18
2009,Bosnia and Herzegovina,BIH,Croatia,HRV,0,0,5,0,5
2009,Iran (Islamic Rep. of),IRN,Croatia,HRV,0,0,5,5,10
2009,Nigeria,NGA,Croatia,HRV,0,0,0,5,5
2009,Pakistan,PAK,Croatia,HRV,0,0,0,5,5
2009,Russian Federation,RUS,Croatia,HRV,5,0,0,0,5
2009,Serbia and Kosovo: S/RES/1244 (1999),SRB,Croatia,HRV,0,0,0,5,5
2009,Afghanistan,AFG,Iceland,ISL,0,5,0,0,5
2009,Iraq,IRQ,Iceland,ISL,0,0,0,5,5
2009,Serbia and Kosovo: S/RES/1244 (1999),SRB,Iceland,ISL,0,0,0,5,5
2009,Afghanistan,AFG,Ireland,IRL,24,0,69,10,103
2009,Albania,ALB,Ireland,IRL,0,0,69,15,84
2009,Algeria,DZA,Ireland,IRL,0,0,46,16,62
2009,Angola,AGO,Ireland,IRL,10,0,36,5,51
2009,Egypt,EGY,Ireland,IRL,0,0,14,0,14
2009,Armenia,ARM,Ireland,IRL,0,0,5,0,5
2009,Azerbaijan,AZE,Ireland,IRL,0,0,5,0,5
2009,Bahrain,BHR,Ireland,IRL,0,0,5,0,5
2009,Burundi,BDI,Ireland,IRL,0,0,21,0,21
2009,Benin,BEN,Ireland,IRL,0,0,5,0,5
2009,Bangladesh,BGD,Ireland,IRL,0,0,47,0,47
2009,Bhutan,BTN,Ireland,IRL,0,0,41,5,46
2009,Belarus,BLR,Ireland,IRL,5,0,12,5,22
2009,Brazil,BRA,Ireland,IRL,5,0,5,0,10
2009,China,CHN,Ireland,IRL,0,0,37,5,42
2009,Cameroon,CMR,Ireland,IRL,5,0,63,5,73
2009,Congo,COG,Ireland,IRL,0,0,15,5,20
2009,Dem. Rep. of the Congo,COD,Ireland,IRL,10,0,135,5,150
2009,Eritrea,ERI,Ireland,IRL,5,0,34,5,44
2009,Ethiopia,ETH,Ireland,IRL,0,0,12,0,12
2009,Gambia,GMB,Ireland,IRL,0,0,5,0,5
2009,Palestinian,PSE,Ireland,IRL,5,0,14,5,24
2009,Georgia,GEO,Ireland,IRL,5,0,176,32,213
2009,Ghana,GHA,Ireland,IRL,5,0,87,0,92
2009,Guinea-Bissau,GNB,Ireland,IRL,0,0,5,0,5
2009,Guinea,GIN,Ireland,IRL,5,0,18,0,23
2009,Croatia,HRV,Ireland,IRL,10,0,12,0,22
2009,Cote d'Ivoire,CIV,Ireland,IRL,5,0,25,0,30
2009,India,IND,Ireland,IRL,0,0,18,0,18
2009,Iran (Islamic Rep. of),IRN,Ireland,IRL,22,0,32,23,77
2009,Iraq,IRQ,Ireland,IRL,50,0,57,12,119
2009,Israel,ISR,Ireland,IRL,0,0,15,0,15
2009,Jamaica,JAM,Ireland,IRL,0,0,5,0,5
2009,Jordan,JOR,Ireland,IRL,0,0,5,0,5
2009,Kazakhstan,KAZ,Ireland,IRL,0,0,5,0,5
2009,Kenya,KEN,Ireland,IRL,5,0,34,0,39
2009,Kuwait,KWT,Ireland,IRL,0,0,13,0,13
2009,Liberia,LBR,Ireland,IRL,0,0,37,0,37
2009,Libya,LBY,Ireland,IRL,0,0,5,0,5
2009,Lebanon,LBN,Ireland,IRL,5,0,0,0,5
2009,Sri Lanka,LKA,Ireland,IRL,0,0,11,0,11
2009,Rep. of Moldova,MDA,Ireland,IRL,5,0,101,5,111
2009,Mali,MLI,Ireland,IRL,0,0,5,0,5
2009,Malaysia,MYS,Ireland,IRL,0,0,10,0,10
2009,Malawi,MWI,Ireland,IRL,0,0,14,0,14
2009,Mongolia,MNG,Ireland,IRL,0,0,5,0,5
2009,Morocco,MAR,Ireland,IRL,5,0,14,0,19
2009,Mauritius,MUS,Ireland,IRL,0,0,20,0,20
2009,Myanmar,MMR,Ireland,IRL,0,0,13,0,13
2009,Nepal,NPL,Ireland,IRL,0,0,15,0,15
2009,Niger,NER,Ireland,IRL,0,0,10,0,10
2009,Nigeria,NGA,Ireland,IRL,25,0,800,64,889
2009,Pakistan,PAK,Ireland,IRL,10,0,229,31,270
2009,Romania,ROU,Ireland,IRL,0,0,5,0,5
2009,South Africa,ZAF,Ireland,IRL,5,0,54,0,59
2009,Russian Federation,RUS,Ireland,IRL,5,0,26,0,31
2009,Rwanda,RWA,Ireland,IRL,0,0,10,0,10
2009,Serbia and Kosovo: S/RES/1244 (1999),SRB,Ireland,IRL,5,0,35,5,45
2009,Sierra Leone,SLE,Ireland,IRL,0,0,25,0,25
2009,Somalia,SOM,Ireland,IRL,10,0,47,5,62
2009,Sudan,SDN,Ireland,IRL,5,0,70,14,89
2009,Eswatini,SWZ,Ireland,IRL,0,0,5,0,5
2009,Syrian Arab Rep.,SYR,Ireland,IRL,0,0,11,0,11
2009,Togo,TGO,Ireland,IRL,0,0,27,5,32
2009,Turkey,TUR,Ireland,IRL,0,0,0,5,5
2009,Uganda,UGA,Ireland,IRL,0,0,37,0,37
2009,Ukraine,UKR,Ireland,IRL,5,0,38,5,48
2009,Uzbekistan,UZB,Ireland,IRL,0,0,5,0,5
2009,Zimbabwe,ZWE,Ireland,IRL,10,0,106,5,121
2009,Stateless,XXA,Ireland,IRL,0,0,0,5,5
2009,Iran (Islamic Rep. of),IRN,Japan,JPN,0,0,13,0,13
2009,Sri Lanka,LKA,Japan,JPN,0,0,19,5,24
2009,Myanmar,MMR,Japan,JPN,5,0,110,10,125
2009,Pakistan,PAK,Japan,JPN,0,0,13,0,13
2009,Turkey,TUR,Japan,JPN,0,0,41,28,69
2009,Rwanda,RWA,Malawi,MWI,0,0,0,132,132
2009,Burundi,BDI,Mozambique,MOZ,0,0,0,5,5
2009,Dem. Rep. of the Congo,COD,Mozambique,MOZ,0,0,0,21,21
2009,Gambia,GMB,Malta,MLT,0,0,11,0,11
2009,Palestinian,PSE,Malta,MLT,0,0,5,0,5
2009,Ghana,GHA,Malta,MLT,0,0,5,38,43
2009,Guinea,GIN,Malta,MLT,0,0,5,0,5
2009,Cote d'Ivoire,CIV,Malta,MLT,0,0,17,0,17
2009,India,IND,Malta,MLT,0,0,0,10,10
2009,Mali,MLI,Malta,MLT,0,0,21,0,21
2009,Niger,NER,Malta,MLT,0,0,5,0,5
2009,Nigeria,NGA,Malta,MLT,0,0,62,5,67
2009,Somalia,SOM,Malta,MLT,0,0,34,0,34
2009,Sudan,SDN,Malta,MLT,0,0,5,0,5
2009,Chad,TCD,Niger,NER,0,0,5,0,5
2009,Afghanistan,AFG,Norway,NOR,0,54,318,17,389
2009,Albania,ALB,Norway,NOR,0,0,36,0,36
2009,Algeria,DZA,Norway,NOR,0,0,83,0,83
2009,Angola,AGO,Norway,NOR,0,0,21,0,21
2009,Egypt,EGY,Norway,NOR,0,0,10,0,10
2009,Armenia,ARM,Norway,NOR,0,0,10,0,10
2009,Azerbaijan,AZE,Norway,NOR,0,0,48,0,48
2009,Burundi,BDI,Norway,NOR,0,10,124,0,134
2009,Bangladesh,BGD,Norway,NOR,0,0,14,0,14
2009,Bhutan,BTN,Norway,NOR,0,0,24,0,24
2009,Burkina Faso,BFA,Norway,NOR,0,0,5,0,5
2009,Belarus,BLR,Norway,NOR,0,0,12,0,12
2009,Bosnia and Herzegovina,BIH,Norway,NOR,0,0,10,0,10
2009,Bulgaria,BGR,Norway,NOR,0,0,10,0,10
2009,Chad,TCD,Norway,NOR,0,0,5,0,5
2009,China,CHN,Norway,NOR,0,0,17,0,17
2009,Cameroon,CMR,Norway,NOR,0,0,41,5,46
2009,Congo,COG,Norway,NOR,0,0,13,0,13
2009,Dem. Rep. of the Congo,COD,Norway,NOR,0,10,69,10,89
2009,Cuba,CUB,Norway,NOR,0,5,0,0,5
2009,Ecuador,ECU,Norway,NOR,0,0,5,0,5
2009,Eritrea,ERI,Norway,NOR,0,10,401,22,433
2009,Ethiopia,ETH,Norway,NOR,0,15,330,5,350
2009,Gambia,GMB,Norway,NOR,0,0,23,0,23
2009,Georgia,GEO,Norway,NOR,0,0,15,0,15
2009,Ghana,GHA,Norway,NOR,0,0,47,0,47
2009,Guinea,GIN,Norway,NOR,0,0,39,0,39
2009,Croatia,HRV,Norway,NOR,0,0,5,0,5
2009,Hungary,HUN,Norway,NOR,0,0,5,0,5
2009,Cote d'Ivoire,CIV,Norway,NOR,0,0,12,0,12
2009,India,IND,Norway,NOR,0,0,13,0,13
2009,Iran (Islamic Rep. of),IRN,Norway,NOR,5,40,305,5,355
2009,Iraq,IRQ,Norway,NOR,5,14,1861,32,1912
2009,Jordan,JOR,Norway,NOR,0,0,17,0,17
2009,Kazakhstan,KAZ,Norway,NOR,0,0,5,0,5
2009,Kenya,KEN,Norway,NOR,0,0,11,0,11
2009,Kyrgyzstan,KGZ,Norway,NOR,0,5,14,0,19
2009,Rep. of Korea,KOR,Norway,NOR,0,0,32,0,32
2009,Dem. People's Rep. of Korea,PRK,Norway,NOR,0,0,22,0,22
2009,Liberia,LBR,Norway,NOR,0,0,39,5,44
2009,Libya,LBY,Norway,NOR,0,0,87,0,87
2009,Lebanon,LBN,Norway,NOR,0,0,63,0,63
2009,Sri Lanka,LKA,Norway,NOR,0,20,213,5,238
2009,Mauritania,MRT,Norway,NOR,0,0,23,0,23
2009,North Macedonia,MKD,Norway,NOR,0,0,12,5,17
2009,Rep. of Moldova,MDA,Norway,NOR,0,0,12,0,12
2009,Morocco,MAR,Norway,NOR,0,0,38,0,38
2009,Montenegro,MNE,Norway,NOR,0,0,5,0,5
2009,Myanmar,MMR,Norway,NOR,0,0,10,0,10
2009,Nepal,NPL,Norway,NOR,0,5,98,0,103
2009,Niger,NER,Norway,NOR,0,0,10,0,10
2009,Nigeria,NGA,Norway,NOR,0,0,387,10,397
2009,Pakistan,PAK,Norway,NOR,0,5,46,5,56
2009,Philippines,PHL,Norway,NOR,0,0,5,0,5
2009,Romania,ROU,Norway,NOR,0,0,5,0,5
2009,Russian Federation,RUS,Norway,NOR,21,122,907,25,1075
2009,Rwanda,RWA,Norway,NOR,0,0,23,0,23
2009,Serbia and Kosovo: S/RES/1244 (1999),SRB,Norway,NOR,5,25,771,5,806
2009,Senegal,SEN,Norway,NOR,0,0,14,0,14
2009,Sierra Leone,SLE,Norway,NOR,0,0,22,0,22
2009,Somalia,SOM,Norway,NOR,5,32,657,33,727
2009,Viet Nam,VNM,Norway,NOR,0,0,13,0,13
2009,Sudan,SDN,Norway,NOR,0,0,39,5,44
2009,Syrian Arab Rep.,SYR,Norway,NOR,0,0,66,0,66
2009,Tajikistan,TJK,Norway,NOR,0,0,5,0,5
2009,Turkmenistan,TKM,Norway,NOR,0,0,5,0,5
2009,Togo,TGO,Norway,NOR,0,0,5,0,5
2009,Tunisia,TUN,Norway,NOR,0,0,13,0,13
2009,Turkey,TUR,Norway,NOR,0,0,61,0,61
2009,Uganda,UGA,Norway,NOR,0,0,20,0,20
2009,Ukraine,UKR,Norway,NOR,0,0,21,0,21
2009,Uzbekistan,UZB,Norway,NOR,5,10,37,5,57
2009,Western Sahara,ESH,Norway,NOR,0,0,5,0,5
2009,Yemen,YEM,Norway,NOR,0,0,15,0,15
2009,Zimbabwe,ZWE,Norway,NOR,0,0,23,0,23
2009,Stateless,XXA,Norway,NOR,0,5,263,12,280
2009,Egypt,EGY,New Zealand,NZL,0,0,5,0,5
2009,Bangladesh,BGD,New Zealand,NZL,0,0,5,0,5
2009,China,CHN,New Zealand,NZL,0,0,5,0,5
2009,Congo,COG,New Zealand,NZL,5,0,0,0,5
2009,Czechia,CZE,New Zealand,NZL,0,0,0,5,5
2009,Ethiopia,ETH,New Zealand,NZL,5,0,0,0,5
2009,Fiji,FJI,New Zealand,NZL,0,0,5,0,5
2009,Iran (Islamic Rep. of),IRN,New Zealand,NZL,21,0,10,0,31
2009,Iraq,IRQ,New Zealand,NZL,5,0,0,0,5
2009,Israel,ISR,New Zealand,NZL,0,0,5,0,5
2009,Sri Lanka,LKA,New Zealand,NZL,5,0,5,0,10
2009,Malaysia,MYS,New Zealand,NZL,0,0,5,0,5
2009,Myanmar,MMR,New Zealand,NZL,0,0,5,0,5
2009,Nepal,NPL,New Zealand,NZL,0,0,5,0,5
2009,Pakistan,PAK,New Zealand,NZL,0,0,5,0,5
2009,Somalia,SOM,New Zealand,NZL,5,0,0,0,5
2009,Syrian Arab Rep.,SYR,New Zealand,NZL,0,0,0,10,10
2009,Turkey,TUR,New Zealand,NZL,0,0,5,0,5
2009,Armenia,ARM,Poland,POL,0,5,0,5,10
2009,Bangladesh,BGD,Poland,POL,0,0,0,5,5
2009,Belarus,BLR,Poland,POL,0,0,0,5,5
2009,Georgia,GEO,Poland,POL,0,0,0,55,55
2009,Kazakhstan,KAZ,Poland,POL,0,5,0,0,5
2009,Russian Federation,RUS,Poland,POL,0,71,5,304,380
2009,Uzbekistan,UZB,Poland,POL,0,0,0,5,5
2009,Afghanistan,AFG,Sweden,SWE,26,76,334,31,467
2009,Albania,ALB,Sweden,SWE,0,0,84,5,89
2009,Algeria,DZA,Sweden,SWE,0,0,56,5,61
2009,Angola,AGO,Sweden,SWE,0,5,13,0,18
2009,Egypt,EGY,Sweden,SWE,5,0,43,5,53
2009,Argentina,ARG,Sweden,SWE,0,0,5,0,5
2009,Armenia,ARM,Sweden,SWE,5,16,134,35,190
2009,Azerbaijan,AZE,Sweden,SWE,0,10,168,35,213
2009,Burundi,BDI,Sweden,SWE,5,5,83,11,104
2009,Benin,BEN,Sweden,SWE,0,0,5,0,5
2009,Bangladesh,BGD,Sweden,SWE,0,0,68,11,79
2009,Bhutan,BTN,Sweden,SWE,0,0,5,0,5
2009,Belarus,BLR,Sweden,SWE,5,0,139,26,170
2009,Bolivia (Plurinational State of),BOL,Sweden,SWE,0,0,29,5,34
2009,Bosnia and Herzegovina,BIH,Sweden,SWE,0,5,79,5,89
2009,Bulgaria,BGR,Sweden,SWE,0,0,5,0,5
2009,China,CHN,Sweden,SWE,5,0,39,10,54
2009,Chile,CHL,Sweden,SWE,0,0,12,0,12
2009,Cameroon,CMR,Sweden,SWE,5,0,31,5,41
2009,Congo,COG,Sweden,SWE,0,0,5,0,5
2009,Dem. Rep. of the Congo,COD,Sweden,SWE,5,17,38,0,60
2009,Colombia,COL,Sweden,SWE,0,0,0,5,5
2009,Cuba,CUB,Sweden,SWE,0,0,11,0,11
2009,Ecuador,ECU,Sweden,SWE,0,0,5,5,10
2009,Eritrea,ERI,Sweden,SWE,14,55,134,23,226
2009,Ethiopia,ETH,Sweden,SWE,5,5,112,17,139
2009,Gambia,GMB,Sweden,SWE,0,0,15,0,15
2009,Georgia,GEO,Sweden,SWE,0,0,99,20,119
2009,Ghana,GHA,Sweden,SWE,0,0,15,5,20
2009,Guinea,GIN,Sweden,SWE,5,0,20,0,25
2009,Croatia,HRV,Sweden,SWE,0,0,23,10,33
2009,Cote d'Ivoire,CIV,Sweden,SWE,0,5,24,0,29
2009,India,IND,Sweden,SWE,0,0,42,5,47
2009,Indonesia,IDN,Sweden,SWE,0,5,5,0,10
2009,Iran (Islamic Rep. of),IRN,Sweden,SWE,44,43,371,40,498
2009,Iraq,IRQ,Sweden,SWE,90,418,5113,825,6446
2009,Israel,ISR,Sweden,SWE,0,0,18,5,23
2009,Jordan,JOR,Sweden,SWE,0,10,59,27,96
2009,Kazakhstan,KAZ,Sweden,SWE,0,0,157,24,181
2009,Kenya,KEN,Sweden,SWE,0,5,18,10,33
2009,Kyrgyzstan,KGZ,Sweden,SWE,0,0,25,5,30
2009,Liberia,LBR,Sweden,SWE,0,5,0,0,5
2009,Libya,LBY,Sweden,SWE,5,5,257,45,312
2009,Lebanon,LBN,Sweden,SWE,5,16,241,34,296
2009,Sri Lanka,LKA,Sweden,SWE,0,5,13,0,18
2009,Latvia,LVA,Sweden,SWE,0,0,5,0,5
2009,North Macedonia,MKD,Sweden,SWE,0,0,24,10,34
2009,Rep. of Moldova,MDA,Sweden,SWE,0,0,10,0,10
2009,Mali,MLI,Sweden,SWE,0,0,0,5,5
2009,Mongolia,MNG,Sweden,SWE,0,5,445,31,481
2009,Morocco,MAR,Sweden,SWE,0,5,34,10,49
2009,Montenegro,MNE,Sweden,SWE,0,0,27,5,32
2009,Nepal,NPL,Sweden,SWE,0,0,49,0,49
2009,Nicaragua,NIC,Sweden,SWE,0,0,26,5,31
2009,Nigeria,NGA,Sweden,SWE,0,5,87,22,114
2009,Pakistan,PAK,Sweden,SWE,0,5,52,5,62
2009,Peru,PER,Sweden,SWE,0,0,16,0,16
2009,Philippines,PHL,Sweden,SWE,0,0,5,0,5
2009,Romania,ROU,Sweden,SWE,0,0,0,10,10
2009,Russian Federation,RUS,Sweden,SWE,5,23,457,79,564
2009,Rwanda,RWA,Sweden,SWE,0,0,13,0,13
2009,El Salvador,SLV,Sweden,SWE,0,5,34,5,44
2009,Serbia and Kosovo: S/RES/1244 (1999),SRB,Sweden,SWE,15,70,1462,115,1662
2009,Senegal,SEN,Sweden,SWE,0,0,16,0,16
2009,Sierra Leone,SLE,Sweden,SWE,0,0,14,0,14
2009,Somalia,SOM,Sweden,SWE,15,411,581,70,1077
2009,Viet Nam,VNM,Sweden,SWE,0,0,28,5,33
2009,Sudan,SDN,Sweden,SWE,0,10,27,5,42
2009,Syrian Arab Rep.,SYR,Sweden,SWE,0,14,363,46,423
2009,United Rep. of Tanzania,TZA,Sweden,SWE,0,0,13,5,18
2009,Thailand,THA,Sweden,SWE,0,0,13,0,13
2009,Turkmenistan,TKM,Sweden,SWE,0,0,5,0,5
2009,Togo,TGO,Sweden,SWE,0,0,12,0,12
2009,Tunisia,TUN,Sweden,SWE,0,0,42,5,47
2009,Turkey,TUR,Sweden,SWE,5,14,174,27,220
2009,Uganda,UGA,Sweden,SWE,5,5,14,0,24
2009,Ukraine,UKR,Sweden,SWE,0,0,29,0,29
2009,United States of America,USA,Sweden,SWE,0,0,5,0,5
2009,Uzbekistan,UZB,Sweden,SWE,5,5,401,40,451
2009,Venezuela (Bolivarian Republic of),VEN,Sweden,SWE,0,0,5,0,5
2009,Yemen,YEM,Sweden,SWE,5,5,53,5,68
2009,Zimbabwe,ZWE,Sweden,SWE,0,5,11,0,16
2009,Stateless,XXA,Sweden,SWE,10,64,426,93,593
2009,Afghanistan,AFG,Ukraine,UKR,5,0,72,36,113
2009,Algeria,DZA,Ukraine,UKR,0,0,5,0,5
2009,Azerbaijan,AZE,Ukraine,UKR,0,0,0,5,5
2009,Bangladesh,BGD,Ukraine,UKR,0,0,15,0,15
2009,Belarus,BLR,Ukraine,UKR,0,0,0,5,5
2009,Congo,COG,Ukraine,UKR,0,0,5,0,5
2009,Dem. Rep. of the Congo,COD,Ukraine,UKR,0,0,0,11,11
2009,Ethiopia,ETH,Ukraine,UKR,0,0,5,0,5
2009,Palestinian,PSE,Ukraine,UKR,0,0,11,5,16
2009,Georgia,GEO,Ukraine,UKR,5,0,5,5,15
2009,Guinea,GIN,Ukraine,UKR,0,0,5,0,5
2009,India,IND,Ukraine,UKR,0,0,0,11,11
2009,Iran (Islamic Rep. of),IRN,Ukraine,UKR,5,0,5,0,10
2009,Iraq,IRQ,Ukraine,UKR,5,0,12,5,22
2009,Lebanon,LBN,Ukraine,UKR,0,0,5,5,10
2009,Sri Lanka,LKA,Ukraine,UKR,0,0,5,0,5
2009,Mali,MLI,Ukraine,UKR,0,0,0,5,5
2009,Nepal,NPL,Ukraine,UKR,0,0,5,0,5
2009,Nigeria,NGA,Ukraine,UKR,0,0,5,5,10
2009,Pakistan,PAK,Ukraine,UKR,0,0,14,0,14
2009,Russian Federation,RUS,Ukraine,UKR,0,0,5,12,17
2009,Saudi Arabia,SAU,Ukraine,UKR,0,0,0,5,5
2009,Somalia,SOM,Ukraine,UKR,0,0,25,10,35
2009,Sudan,SDN,Ukraine,UKR,0,0,5,5,10
2009,Syrian Arab Rep.,SYR,Ukraine,UKR,0,0,10,10,20
2009,Uzbekistan,UZB,Ukraine,UKR,0,0,0,5,5
2009,Stateless,XXA,Ukraine,UKR,0,0,5,0,5
2010,Georgia,GEO,Armenia,ARM,0,0,10,0,10
2010,Chad,TCD,Benin,BEN,0,0,19,0,19
2010,Congo,COG,Benin,BEN,5,0,0,0,5
2010,Dem. Rep. of the Congo,COD,Benin,BEN,5,0,0,5,10
2010,Nigeria,NGA,Benin,BEN,0,0,17,0,17
2010,Togo,TGO,Benin,BEN,0,0,10,0,10
2010,Afghanistan,AFG,Belarus,BLR,0,0,77,0,77
2010,Pakistan,PAK,Belarus,BLR,0,0,5,0,5
2010,Russian Federation,RUS,Belarus,BLR,0,0,5,0,5
2010,Afghanistan,AFG,Cyprus,CYP,0,0,11,0,11
2010,Egypt,EGY,Cyprus,CYP,0,14,294,40,348
2010,Armenia,ARM,Cyprus,CYP,0,0,5,5,10
2010,Bangladesh,BGD,Cyprus,CYP,0,0,144,26,170
2010,China,CHN,Cyprus,CYP,0,0,165,39,204
2010,Cameroon,CMR,Cyprus,CYP,0,0,45,10,55
2010,Dem. Rep. of the Congo,COD,Cyprus,CYP,0,5,0,0,5
2010,Ethiopia,ETH,Cyprus,CYP,0,0,0,5,5
2010,Palestinian,PSE,Cyprus,CYP,5,0,193,22,220
2010,Georgia,GEO,Cyprus,CYP,0,5,286,69,360
2010,Ghana,GHA,Cyprus,CYP,0,0,0,5,5
2010,Cote d'Ivoire,CIV,Cyprus,CYP,0,0,0,5,5
2010,India,IND,Cyprus,CYP,0,0,422,100,522
2010,Indonesia,IDN,Cyprus,CYP,0,0,5,0,5
2010,Iran (Islamic Rep. of),IRN,Cyprus,CYP,10,17,134,50,211
2010,Iraq,IRQ,Cyprus,CYP,0,0,57,5,62
2010,Jordan,JOR,Cyprus,CYP,0,0,11,0,11
2010,Lebanon,LBN,Cyprus,CYP,0,0,5,11,16
2010,Sri Lanka,LKA,Cyprus,CYP,5,0,109,21,135
2010,Rep. of Moldova,MDA,Cyprus,CYP,0,0,5,5,10
2010,Mongolia,MNG,Cyprus,CYP,0,0,18,5,23
2010,Morocco,MAR,Cyprus,CYP,0,0,0,5,5
2010,Nepal,NPL,Cyprus,CYP,0,0,0,14,14
2010,Nigeria,NGA,Cyprus,CYP,0,0,106,5,111
2010,Pakistan,PAK,Cyprus,CYP,0,0,139,34,173
2010,Philippines,PHL,Cyprus,CYP,0,0,154,16,170
2010,Russian Federation,RUS,Cyprus,CYP,0,0,5,5,10
2010,Serbia and Kosovo: S/RES/1244 (1999),SRB,Cyprus,CYP,0,5,0,5,10
2010,Viet Nam,VNM,Cyprus,CYP,0,0,133,14,147
2010,Syrian Arab Rep.,SYR,Cyprus,CYP,0,16,203,104,323
2010,Turkey,TUR,Cyprus,CYP,0,5,10,5,20
2010,Ukraine,UKR,Cyprus,CYP,0,0,5,22,27
2010,Uzbekistan,UZB,Cyprus,CYP,0,0,0,5,5
2010,Afghanistan,AFG,Czechia,CZE,0,0,0,5,5
2010,Algeria,DZA,Czechia,CZE,0,0,5,5,10
2010,Armenia,ARM,Czechia,CZE,5,0,5,0,10
2010,Belarus,BLR,Czechia,CZE,10,0,24,11,45
2010,China,CHN,Czechia,CZE,0,0,5,0,5
2010,Dem. Rep. of the Congo,COD,Czechia,CZE,14,0,0,0,14
2010,Georgia,GEO,Czechia,CZE,0,0,10,0,10
2010,Ghana,GHA,Czechia,CZE,5,0,0,0,5
2010,Kazakhstan,KAZ,Czechia,CZE,13,0,5,0,18
2010,Kyrgyzstan,KGZ,Czechia,CZE,0,0,13,5,18
2010,Sri Lanka,LKA,Czechia,CZE,0,0,0,5,5
2010,North Macedonia,MKD,Czechia,CZE,5,0,0,0,5
2010,Rep. of Moldova,MDA,Czechia,CZE,0,0,10,0,10
2010,Mongolia,MNG,Czechia,CZE,10,0,56,38,104
2010,Nigeria,NGA,Czechia,CZE,13,0,0,5,18
2010,Russian Federation,RUS,Czechia,CZE,12,0,5,5,22
2010,Serbia and Kosovo: S/RES/1244 (1999),SRB,Czechia,CZE,0,0,10,0,10
2010,Somalia,SOM,Czechia,CZE,5,0,0,0,5
2010,Viet Nam,VNM,Czechia,CZE,5,0,10,10,25
2010,Syrian Arab Rep.,SYR,Czechia,CZE,0,0,13,5,18
2010,Turkey,TUR,Czechia,CZE,18,0,5,10,33
2010,Ukraine,UKR,Czechia,CZE,23,0,69,22,114
2010,Uzbekistan,UZB,Czechia,CZE,5,0,5,0,10
2010,Stateless,XXA,Czechia,CZE,5,0,5,0,10
2010,Afghanistan,AFG,Denmark,DNK,10,80,282,0,372
2010,Armenia,ARM,Denmark,DNK,0,0,22,0,22
2010,Palestinian,PSE,Denmark,DNK,0,5,24,0,29
2010,Iran (Islamic Rep. of),IRN,Denmark,DNK,34,14,52,0,100
2010,Iraq,IRQ,Denmark,DNK,5,11,55,0,71
2010,Sri Lanka,LKA,Denmark,DNK,0,5,47,0,52
2010,Russian Federation,RUS,Denmark,DNK,5,10,20,0,35
2010,Serbia and Kosovo: S/RES/1244 (1999),SRB,Denmark,DNK,0,0,26,0,26
2010,Somalia,SOM,Denmark,DNK,0,5,36,0,41
2010,Syrian Arab Rep.,SYR,Denmark,DNK,32,11,63,0,106
2010,Algeria,DZA,France,FRA,13,12,524,0,549
2010,Angola,AGO,France,FRA,44,5,229,0,278
2010,Armenia,ARM,France,FRA,164,50,1554,0,1768
2010,Azerbaijan,AZE,France,FRA,83,5,295,0,383
2010,Bangladesh,BGD,France,FRA,339,5,1290,0,1634
2010,China,CHN,France,FRA,13,0,735,0,748
2010,Congo,COG,France,FRA,69,15,538,0,622
2010,Dem. Rep. of the Congo,COD,France,FRA,325,28,1495,0,1848
2010,Guinea,GIN,France,FRA,175,68,799,0,1042
2010,Haiti,HTI,France,FRA,14,22,786,0,822
2010,Cote d'Ivoire,CIV,France,FRA,27,10,286,0,323
2010,Sri Lanka,LKA,France,FRA,842,160,1750,0,2751
2010,Mauritania,MRT,France,FRA,93,25,711,0,829
2010,Mali,MLI,France,FRA,10,179,172,0,361
2010,Nigeria,NGA,France,FRA,21,25,435,0,481
2010,Pakistan,PAK,France,FRA,37,5,345,0,387
2010,Russian Federation,RUS,France,FRA,754,55,973,0,1782
2010,Serbia and Kosovo: S/RES/1244 (1999),SRB,France,FRA,331,157,1678,0,2166
2010,Turkey,TUR,France,FRA,357,18,1577,0,1952
2010,Iran (Islamic Rep. of),IRN,Greece,GRC,32,0,0,0,32
2010,Afghanistan,AFG,Croatia,HRV,0,0,0,5,5
2010,Bosnia and Herzegovina,BIH,Croatia,HRV,0,0,13,0,13
2010,Congo,COG,Croatia,HRV,5,0,0,0,5
2010,Georgia,GEO,Croatia,HRV,0,5,0,0,5
2010,Iran (Islamic Rep. of),IRN,Croatia,HRV,0,0,0,5,5
2010,Pakistan,PAK,Croatia,HRV,0,0,0,5,5
2010,Russian Federation,RUS,Croatia,HRV,0,0,5,0,5
2010,Serbia and Kosovo: S/RES/1244 (1999),SRB,Croatia,HRV,0,0,18,0,18
2010,Ukraine,UKR,Croatia,HRV,0,0,5,0,5
2010,Afghanistan,AFG,Ireland,IRL,13,0,35,0,48
2010,Albania,ALB,Ireland,IRL,5,0,46,0,51
2010,Algeria,DZA,Ireland,IRL,0,0,48,5,53
2010,Angola,AGO,Ireland,IRL,5,0,32,0,37
2010,Egypt,EGY,Ireland,IRL,0,0,11,0,11
2010,Armenia,ARM,Ireland,IRL,0,0,12,0,12
2010,Burundi,BDI,Ireland,IRL,0,0,5,0,5
2010,Benin,BEN,Ireland,IRL,0,0,18,0,18
2010,Bangladesh,BGD,Ireland,IRL,0,0,56,0,56
2010,Bhutan,BTN,Ireland,IRL,0,0,16,0,16
2010,Belarus,BLR,Ireland,IRL,0,0,5,0,5
2010,Bolivia (Plurinational State of),BOL,Ireland,IRL,0,0,5,0,5
2010,Chad,TCD,Ireland,IRL,0,0,5,0,5
2010,China,CHN,Ireland,IRL,5,0,29,5,39
2010,Cameroon,CMR,Ireland,IRL,5,0,75,0,80
2010,Congo,COG,Ireland,IRL,0,0,11,0,11
2010,Dem. Rep. of the Congo,COD,Ireland,IRL,5,0,140,0,145
2010,Cabo Verde,CPV,Ireland,IRL,0,0,5,0,5
2010,Eritrea,ERI,Ireland,IRL,5,0,17,0,22
2010,Ethiopia,ETH,Ireland,IRL,0,0,10,0,10
2010,Palestinian,PSE,Ireland,IRL,5,0,11,5,21
2010,Georgia,GEO,Ireland,IRL,5,0,64,5,74
2010,Ghana,GHA,Ireland,IRL,0,0,107,5,112
2010,Guinea,GIN,Ireland,IRL,5,0,20,0,25
2010,Guyana,GUY,Ireland,IRL,0,0,5,0,5
2010,Croatia,HRV,Ireland,IRL,0,0,16,0,16
2010,Cote d'Ivoire,CIV,Ireland,IRL,0,0,11,0,11
2010,India,IND,Ireland,IRL,0,0,11,5,16
2010,Iran (Islamic Rep. of),IRN,Ireland,IRL,11,0,32,0,43
2010,Iraq,IRQ,Ireland,IRL,0,0,76,10,86
2010,Israel,ISR,Ireland,IRL,0,0,5,0,5
2010,Jordan,JOR,Ireland,IRL,0,0,5,0,5
2010,Kenya,KEN,Ireland,IRL,0,0,34,0,34
2010,Kuwait,KWT,Ireland,IRL,0,0,10,0,10
2010,Liberia,LBR,Ireland,IRL,0,0,14,0,14
2010,Libya,LBY,Ireland,IRL,0,0,5,0,5
2010,Sri Lanka,LKA,Ireland,IRL,0,0,10,5,15
2010,Rep. of Moldova,MDA,Ireland,IRL,5,0,37,5,47
2010,Malawi,MWI,Ireland,IRL,5,0,19,0,24
2010,Morocco,MAR,Ireland,IRL,0,0,5,5,10
2010,Mauritius,MUS,Ireland,IRL,0,0,19,0,19
2010,Myanmar,MMR,Ireland,IRL,0,0,5,0,5
2010,Nepal,NPL,Ireland,IRL,0,0,12,0,12
2010,Niger,NER,Ireland,IRL,0,0,5,0,5
2010,Nigeria,NGA,Ireland,IRL,14,0,657,82,753
2010,Pakistan,PAK,Ireland,IRL,5,0,214,10,229
2010,South Africa,ZAF,Ireland,IRL,0,0,38,0,38
2010,Russian Federation,RUS,Ireland,IRL,5,0,24,0,29
2010,Rwanda,RWA,Ireland,IRL,0,0,10,0,10
2010,Serbia and Kosovo: S/RES/1244 (1999),SRB,Ireland,IRL,5,0,34,0,39
2010,Senegal,SEN,Ireland,IRL,0,0,5,0,5
2010,Sierra Leone,SLE,Ireland,IRL,0,0,39,0,39
2010,Somalia,SOM,Ireland,IRL,11,0,114,5,130
2010,Sudan,SDN,Ireland,IRL,5,0,79,5,89
2010,Syrian Arab Rep.,SYR,Ireland,IRL,0,0,5,0,5
2010,United Rep. of Tanzania,TZA,Ireland,IRL,0,0,5,0,5
2010,Togo,TGO,Ireland,IRL,0,0,11,5,16
2010,Turkey,TUR,Ireland,IRL,0,0,5,0,5
2010,Uganda,UGA,Ireland,IRL,5,0,41,5,51
2010,Ukraine,UKR,Ireland,IRL,0,0,14,0,14
2010,Zimbabwe,ZWE,Ireland,IRL,5,0,111,5,121
2010,Sri Lanka,LKA,Japan,JPN,0,0,27,17,44
2010,Myanmar,MMR,Japan,JPN,13,31,160,40,244
2010,Pakistan,PAK,Japan,JPN,0,0,14,5,19
2010,Turkey,TUR,Japan,JPN,0,5,44,16,65
2010,Rwanda,RWA,Malawi,MWI,0,0,0,80,80
2010,Bangladesh,BGD,Malta,MLT,0,0,14,0,14
2010,Eritrea,ERI,Malta,MLT,0,0,5,0,5
2010,Ethiopia,ETH,Malta,MLT,0,0,0,5,5
2010,India,IND,Malta,MLT,0,0,0,5,5
2010,Nigeria,NGA,Malta,MLT,0,0,11,0,11
2010,Somalia,SOM,Malta,MLT,0,0,5,0,5
2010,Afghanistan,AFG,Norway,NOR,54,15,1275,160,1504
2010,Albania,ALB,Norway,NOR,0,0,20,0,20
2010,Algeria,DZA,Norway,NOR,0,0,110,0,110
2010,Angola,AGO,Norway,NOR,0,0,32,0,32
2010,Egypt,EGY,Norway,NOR,0,0,23,0,23
2010,Armenia,ARM,Norway,NOR,0,0,36,0,36
2010,Azerbaijan,AZE,Norway,NOR,5,0,70,0,75
2010,Burundi,BDI,Norway,NOR,0,0,74,5,79
2010,Benin,BEN,Norway,NOR,0,0,5,0,5
2010,Bangladesh,BGD,Norway,NOR,0,5,5,0,10
2010,Bhutan,BTN,Norway,NOR,0,0,15,0,15
2010,Burkina Faso,BFA,Norway,NOR,0,0,10,0,10
2010,Belarus,BLR,Norway,NOR,0,0,11,0,11
2010,Bosnia and Herzegovina,BIH,Norway,NOR,0,0,5,0,5
2010,Bulgaria,BGR,Norway,NOR,0,5,0,0,5
2010,China,CHN,Norway,NOR,0,0,11,0,11
2010,Cameroon,CMR,Norway,NOR,0,0,31,0,31
2010,Congo,COG,Norway,NOR,0,0,5,0,5
2010,Dem. Rep. of the Congo,COD,Norway,NOR,0,0,61,5,66
2010,Colombia,COL,Norway,NOR,0,0,16,0,16
2010,Czechia,CZE,Norway,NOR,0,0,5,0,5
2010,Ecuador,ECU,Norway,NOR,0,0,5,0,5
2010,Eritrea,ERI,Norway,NOR,22,5,601,69,697
2010,Ethiopia,ETH,Norway,NOR,15,11,384,10,420
2010,Gabon,GAB,Norway,NOR,0,0,5,0,5
2010,Gambia,GMB,Norway,NOR,0,0,59,0,59
2010,Palestinian,PSE,Norway,NOR,0,0,5,0,5
2010,Georgia,GEO,Norway,NOR,0,0,67,0,67
2010,Ghana,GHA,Norway,NOR,0,0,69,0,69
2010,Guinea-Bissau,GNB,Norway,NOR,0,0,10,0,10
2010,Guatemala,GTM,Norway,NOR,5,0,0,0,5
2010,Guinea,GIN,Norway,NOR,0,0,61,0,61
2010,Croatia,HRV,Norway,NOR,0,0,15,0,15
2010,Hungary,HUN,Norway,NOR,0,0,5,0,5
2010,Cote d'Ivoire,CIV,Norway,NOR,0,0,19,0,19
2010,India,IND,Norway,NOR,0,0,63,0,63
2010,Iran (Islamic Rep. of),IRN,Norway,NOR,17,12,567,15,611
2010,Iraq,IRQ,Norway,NOR,28,17,1020,33,1098
2010,Israel,ISR,Norway,NOR,0,0,11,0,11
2010,Jordan,JOR,Norway,NOR,0,0,16,0,16
2010,Kazakhstan,KAZ,Norway,NOR,0,0,18,5,23
2010,Kenya,KEN,Norway,NOR,0,0,35,0,35
2010,Kyrgyzstan,KGZ,Norway,NOR,0,0,30,0,30
2010,Dem. People's Rep. of Korea,PRK,Norway,NOR,0,0,10,0,10
2010,Liberia,LBR,Norway,NOR,0,0,39,0,39
2010,Libya,LBY,Norway,NOR,0,0,62,0,62
2010,Lebanon,LBN,Norway,NOR,0,0,49,0,49
2010,Sri Lanka,LKA,Norway,NOR,0,10,296,0,306
2010,Mauritania,MRT,Norway,NOR,0,0,41,0,41
2010,North Macedonia,MKD,Norway,NOR,0,0,73,0,73
2010,Rep. of Moldova,MDA,Norway,NOR,0,0,10,0,10
2010,Morocco,MAR,Norway,NOR,0,0,43,0,43
2010,Montenegro,MNE,Norway,NOR,5,0,5,0,10
2010,Myanmar,MMR,Norway,NOR,0,0,10,0,10
2010,Nepal,NPL,Norway,NOR,0,0,169,5,174
2010,Niger,NER,Norway,NOR,0,0,24,0,24
2010,Nigeria,NGA,Norway,NOR,0,5,471,23,499
2010,Pakistan,PAK,Norway,NOR,0,0,57,5,62
2010,Philippines,PHL,Norway,NOR,0,5,0,0,5
2010,Romania,ROU,Norway,NOR,0,0,5,0,5
2010,Russian Federation,RUS,Norway,NOR,74,45,942,27,1088
2010,Rwanda,RWA,Norway,NOR,0,0,20,0,20
2010,Serbia and Kosovo: S/RES/1244 (1999),SRB,Norway,NOR,0,14,477,10,501
2010,Senegal,SEN,Norway,NOR,0,0,25,0,25
2010,Sierra Leone,SLE,Norway,NOR,0,0,25,0,25
2010,Somalia,SOM,Norway,NOR,5,5,806,79,895
2010,Viet Nam,VNM,Norway,NOR,0,0,16,0,16
2010,Sudan,SDN,Norway,NOR,0,0,80,10,90
2010,Syrian Arab Rep.,SYR,Norway,NOR,0,5,136,10,151
2010,Tajikistan,TJK,Norway,NOR,0,0,17,0,17
2010,Turkmenistan,TKM,Norway,NOR,0,0,5,0,5
2010,Togo,TGO,Norway,NOR,0,0,11,0,11
2010,Tunisia,TUN,Norway,NOR,0,0,21,0,21
2010,Turkey,TUR,Norway,NOR,0,0,57,10,67
2010,Uganda,UGA,Norway,NOR,0,0,30,0,30
2010,Ukraine,UKR,Norway,NOR,0,0,25,0,25
2010,United States of America,USA,Norway,NOR,0,0,5,0,5
2010,Uzbekistan,UZB,Norway,NOR,0,5,165,5,175
2010,Western Sahara,ESH,Norway,NOR,0,0,5,0,5
2010,Yemen,YEM,Norway,NOR,0,0,81,0,81
2010,Zimbabwe,ZWE,Norway,NOR,0,0,39,0,39
2010,Stateless,XXA,Norway,NOR,0,11,478,25,514
2010,Afghanistan,AFG,New Zealand,NZL,5,0,0,0,5
2010,Algeria,DZA,New Zealand,NZL,5,0,0,0,5
2010,Egypt,EGY,New Zealand,NZL,0,0,5,0,5
2010,Bangladesh,BGD,New Zealand,NZL,0,0,5,0,5
2010,China,CHN,New Zealand,NZL,5,0,5,0,10
2010,Congo,COG,New Zealand,NZL,0,0,5,0,5
2010,Colombia,COL,New Zealand,NZL,5,0,0,0,5
2010,Czechia,CZE,New Zealand,NZL,5,0,5,5,15
2010,Fiji,FJI,New Zealand,NZL,5,0,16,5,26
2010,India,IND,New Zealand,NZL,0,0,22,0,22
2010,Iran (Islamic Rep. of),IRN,New Zealand,NZL,14,0,10,0,24
2010,Iraq,IRQ,New Zealand,NZL,0,0,5,0,5
2010,Sri Lanka,LKA,New Zealand,NZL,5,0,19,0,24
2010,Pakistan,PAK,New Zealand,NZL,5,0,5,0,10
2010,South Africa,ZAF,New Zealand,NZL,0,0,5,0,5
2010,Slovakia,SVK,New Zealand,NZL,0,0,5,5,10
2010,Turkey,TUR,New Zealand,NZL,5,0,0,0,5
2010,Armenia,ARM,Poland,POL,0,0,0,5,5
2010,Georgia,GEO,Poland,POL,0,0,5,63,68
2010,Iraq,IRQ,Poland,POL,0,5,0,0,5
2010,Rep. of Moldova,MDA,Poland,POL,0,0,0,5,5
2010,Russian Federation,RUS,Poland,POL,0,32,53,246,331
2010,Afghanistan,AFG,Serbia and Kosovo: S/RES/1244 (1999),SRB,0,0,23,252,275
2010,Algeria,DZA,Serbia and Kosovo: S/RES/1244 (1999),SRB,0,0,0,5,5
2010,Palestinian,PSE,Serbia and Kosovo: S/RES/1244 (1999),SRB,0,0,0,68,68
2010,Iran (Islamic Rep. of),IRN,Serbia and Kosovo: S/RES/1244 (1999),SRB,0,0,0,5,5
2010,Iraq,IRQ,Serbia and Kosovo: S/RES/1244 (1999),SRB,0,0,0,18,18
2010,Morocco,MAR,Serbia and Kosovo: S/RES/1244 (1999),SRB,0,0,0,5,5
2010,Netherlands,NLD,Serbia and Kosovo: S/RES/1244 (1999),SRB,0,0,0,5,5
2010,Pakistan,PAK,Serbia and Kosovo: S/RES/1244 (1999),SRB,0,0,0,21,21
2010,Somalia,SOM,Serbia and Kosovo: S/RES/1244 (1999),SRB,0,0,0,5,5
2010,Afghanistan,AFG,Ukraine,UKR,0,14,19,76,109
2010,Azerbaijan,AZE,Ukraine,UKR,0,0,0,5,5
2010,Bangladesh,BGD,Ukraine,UKR,0,0,0,5,5
2010,Belarus,BLR,Ukraine,UKR,0,0,0,5,5
2010,Cameroon,CMR,Ukraine,UKR,0,0,0,5,5
2010,Congo,COG,Ukraine,UKR,0,0,5,0,5
2010,Dem. Rep. of the Congo,COD,Ukraine,UKR,0,0,0,13,13
2010,Palestinian,PSE,Ukraine,UKR,0,0,0,14,14
2010,Georgia,GEO,Ukraine,UKR,0,0,5,0,5
2010,Guinea,GIN,Ukraine,UKR,0,0,5,10,15
2010,Cote d'Ivoire,CIV,Ukraine,UKR,0,0,0,5,5
2010,India,IND,Ukraine,UKR,0,0,0,13,13
2010,Iran (Islamic Rep. of),IRN,Ukraine,UKR,0,0,0,16,16
2010,Iraq,IRQ,Ukraine,UKR,0,5,11,0,16
2010,Kyrgyzstan,KGZ,Ukraine,UKR,0,5,0,5,10
2010,Lebanon,LBN,Ukraine,UKR,0,0,0,5,5
2010,Nigeria,NGA,Ukraine,UKR,0,0,5,0,5
2010,Pakistan,PAK,Ukraine,UKR,0,0,0,10,10
2010,Russian Federation,RUS,Ukraine,UKR,0,0,5,0,5
2010,Somalia,SOM,Ukraine,UKR,0,0,5,22,27
2010,Syrian Arab Rep.,SYR,Ukraine,UKR,5,0,5,0,10
2010,Uzbekistan,UZB,Ukraine,UKR,0,14,0,10,24
2011,Dem. Rep. of the Congo,COD,Benin,BEN,0,0,10,0,10
2011,Nigeria,NGA,Benin,BEN,0,0,5,0,5
2011,Togo,TGO,Benin,BEN,0,0,14,0,14
2011,Afghanistan,AFG,Belarus,BLR,0,0,40,0,40
2011,Georgia,GEO,Belarus,BLR,0,0,10,0,10
2011,Russian Federation,RUS,Belarus,BLR,0,0,5,0,5
2011,Myanmar,MMR,Cambodia,KHM,0,0,5,0,5
2011,Cuba,CUB,Colombia,COL,0,0,5,0,5
2011,Peru,PER,Colombia,COL,0,0,5,0,5
2011,Venezuela (Bolivarian Republic of),VEN,Colombia,COL,0,0,5,0,5
2011,Afghanistan,AFG,Cyprus,CYP,0,0,14,0,14
2011,Algeria,DZA,Cyprus,CYP,0,0,5,0,5
2011,Egypt,EGY,Cyprus,CYP,0,5,105,5,115
2011,Armenia,ARM,Cyprus,CYP,0,0,10,5,15
2011,Bangladesh,BGD,Cyprus,CYP,0,0,94,19,113
2011,Burkina Faso,BFA,Cyprus,CYP,0,0,5,0,5
2011,China,CHN,Cyprus,CYP,0,0,50,10,60
2011,Cameroon,CMR,Cyprus,CYP,0,0,132,10,142
2011,Ethiopia,ETH,Cyprus,CYP,0,0,5,5,10
2011,Palestinian,PSE,Cyprus,CYP,5,5,1111,55,1176
2011,Georgia,GEO,Cyprus,CYP,0,0,10,27,37
2011,Ghana,GHA,Cyprus,CYP,0,0,48,5,53
2011,Guinea,GIN,Cyprus,CYP,0,0,28,0,28
2011,Cote d'Ivoire,CIV,Cyprus,CYP,0,0,5,0,5
2011,India,IND,Cyprus,CYP,0,0,184,26,210
2011,Indonesia,IDN,Cyprus,CYP,0,0,5,0,5
2011,Iran (Islamic Rep. of),IRN,Cyprus,CYP,0,0,276,58,334
2011,Iraq,IRQ,Cyprus,CYP,0,10,109,19,138
2011,Jordan,JOR,Cyprus,CYP,0,0,26,13,39
2011,Kazakhstan,KAZ,Cyprus,CYP,0,0,0,5,5
2011,Kenya,KEN,Cyprus,CYP,0,0,11,0,11
2011,Liberia,LBR,Cyprus,CYP,0,0,5,0,5
2011,Lebanon,LBN,Cyprus,CYP,0,0,19,10,29
2011,Sri Lanka,LKA,Cyprus,CYP,0,5,128,19,152
2011,Rep. of Moldova,MDA,Cyprus,CYP,0,0,0,5,5
2011,Mali,MLI,Cyprus,CYP,0,0,5,0,5
2011,Mongolia,MNG,Cyprus,CYP,0,0,15,14,29
2011,Morocco,MAR,Cyprus,CYP,0,0,13,5,18
2011,Nepal,NPL,Cyprus,CYP,0,0,132,26,158
2011,Nigeria,NGA,Cyprus,CYP,0,0,72,10,82
2011,Pakistan,PAK,Cyprus,CYP,0,0,79,20,99
2011,Philippines,PHL,Cyprus,CYP,0,0,77,5,82
2011,Russian Federation,RUS,Cyprus,CYP,0,0,5,11,16
2011,Serbia and Kosovo: S/RES/1244 (1999),SRB,Cyprus,CYP,0,0,5,0,5
2011,Senegal,SEN,Cyprus,CYP,0,0,5,0,5
2011,Sierra Leone,SLE,Cyprus,CYP,0,0,5,0,5
2011,Viet Nam,VNM,Cyprus,CYP,0,0,222,5,227
2011,Syrian Arab Rep.,SYR,Cyprus,CYP,5,5,78,28,116
2011,Togo,TGO,Cyprus,CYP,0,0,5,0,5
2011,Tunisia,TUN,Cyprus,CYP,0,0,5,5,10
2011,Turkey,TUR,Cyprus,CYP,0,0,34,5,39
2011,Ukraine,UKR,Cyprus,CYP,0,0,10,10,20
2011,Uzbekistan,UZB,Cyprus,CYP,0,0,0,11,11
2011,Afghanistan,AFG,Denmark,DNK,5,151,479,10,645
2011,Albania,ALB,Denmark,DNK,0,0,5,0,5
2011,Azerbaijan,AZE,Denmark,DNK,0,0,11,0,11
2011,Bosnia and Herzegovina,BIH,Denmark,DNK,0,0,5,0,5
2011,China,CHN,Denmark,DNK,0,0,5,0,5
2011,Cameroon,CMR,Denmark,DNK,0,0,5,0,5
2011,Congo,COG,Denmark,DNK,5,0,0,0,5
2011,Dem. Rep. of the Congo,COD,Denmark,DNK,0,0,10,0,10
2011,Eritrea,ERI,Denmark,DNK,0,0,5,0,5
2011,Palestinian,PSE,Denmark,DNK,0,0,11,0,11
2011,Guinea-Bissau,GNB,Denmark,DNK,0,0,5,0,5
2011,India,IND,Denmark,DNK,0,0,5,0,5
2011,Iran (Islamic Rep. of),IRN,Denmark,DNK,57,5,66,0,128
2011,Iraq,IRQ,Denmark,DNK,10,5,40,0,55
2011,Israel,ISR,Denmark,DNK,0,0,5,0,5
2011,Jordan,JOR,Denmark,DNK,0,0,5,0,5
2011,Kyrgyzstan,KGZ,Denmark,DNK,0,0,5,0,5
2011,Sri Lanka,LKA,Denmark,DNK,5,0,13,0,18
2011,Morocco,MAR,Denmark,DNK,0,0,5,0,5
2011,Myanmar,MMR,Denmark,DNK,5,0,5,0,10
2011,Nigeria,NGA,Denmark,DNK,0,0,13,0,13
2011,Pakistan,PAK,Denmark,DNK,0,0,5,0,5
2011,Russian Federation,RUS,Denmark,DNK,5,16,33,5,59
2011,Rwanda,RWA,Denmark,DNK,0,0,5,0,5
2011,Serbia and Kosovo: S/RES/1244 (1999),SRB,Denmark,DNK,0,0,10,0,10
2011,Somalia,SOM,Denmark,DNK,0,0,13,0,13
2011,Sudan,SDN,Denmark,DNK,0,0,5,0,5
2011,Syrian Arab Rep.,SYR,Denmark,DNK,102,5,62,5,174
2011,Turkey,TUR,Denmark,DNK,0,0,10,0,10
2011,Uganda,UGA,Denmark,DNK,0,5,5,0,10
2011,Uzbekistan,UZB,Denmark,DNK,0,0,5,0,5
2011,Stateless,XXA,Denmark,DNK,14,0,11,0,25
2011,Afghanistan,AFG,Greece,GRC,47,53,0,0,100
2011,Palestinian,PSE,Greece,GRC,5,0,0,0,5
2011,Georgia,GEO,Greece,GRC,0,5,0,0,5
2011,Iran (Islamic Rep. of),IRN,Greece,GRC,11,10,0,0,21
2011,Iraq,IRQ,Greece,GRC,75,47,0,0,122
2011,Somalia,SOM,Greece,GRC,10,0,0,0,10
2011,Turkey,TUR,Greece,GRC,5,0,0,0,5
2011,Afghanistan,AFG,Croatia,HRV,14,0,0,0,14
2011,Bosnia and Herzegovina,BIH,Croatia,HRV,0,0,0,5,5
2011,Iraq,IRQ,Croatia,HRV,0,0,5,0,5
2011,Russian Federation,RUS,Croatia,HRV,0,0,5,0,5
2011,Senegal,SEN,Croatia,HRV,0,0,5,0,5
2011,Russian Federation,RUS,Iceland,ISL,0,0,0,5,5
2011,Spain,ESP,Iceland,ISL,0,0,0,5,5
2011,Afghanistan,AFG,Ireland,IRL,10,0,55,0,65
2011,Albania,ALB,Ireland,IRL,0,0,20,0,20
2011,Algeria,DZA,Ireland,IRL,0,0,25,0,25
2011,Angola,AGO,Ireland,IRL,0,0,17,0,17
2011,Armenia,ARM,Ireland,IRL,0,0,12,0,12
2011,Burundi,BDI,Ireland,IRL,0,0,5,0,5
2011,Bangladesh,BGD,Ireland,IRL,0,0,26,0,26
2011,Bhutan,BTN,Ireland,IRL,0,0,5,0,5
2011,Belarus,BLR,Ireland,IRL,11,0,0,0,11
2011,Bolivia (Plurinational State of),BOL,Ireland,IRL,0,0,5,0,5
2011,Brazil,BRA,Ireland,IRL,0,0,5,0,5
2011,China,CHN,Ireland,IRL,0,0,17,0,17
2011,Cameroon,CMR,Ireland,IRL,0,0,38,0,38
2011,Congo,COG,Ireland,IRL,0,0,13,0,13
2011,Dem. Rep. of the Congo,COD,Ireland,IRL,0,0,79,5,84
2011,Eritrea,ERI,Ireland,IRL,0,0,5,0,5
2011,Ethiopia,ETH,Ireland,IRL,0,0,5,0,5
2011,Palestinian,PSE,Ireland,IRL,0,0,5,0,5
2011,Georgia,GEO,Ireland,IRL,5,0,23,0,28
2011,Ghana,GHA,Ireland,IRL,0,0,40,0,40
2011,Guinea,GIN,Ireland,IRL,0,0,5,0,5
2011,Cote d'Ivoire,CIV,Ireland,IRL,5,0,5,0,10
2011,India,IND,Ireland,IRL,0,0,5,0,5
2011,Iran (Islamic Rep. of),IRN,Ireland,IRL,5,0,20,0,25
2011,Iraq,IRQ,Ireland,IRL,0,0,22,0,22
2011,Israel,ISR,Ireland,IRL,0,0,5,0,5
2011,Kenya,KEN,Ireland,IRL,0,0,5,5,10
2011,Liberia,LBR,Ireland,IRL,0,0,5,0,5
2011,Lebanon,LBN,Ireland,IRL,0,0,5,0,5
2011,Sri Lanka,LKA,Ireland,IRL,0,0,5,0,5
2011,Rep. of Moldova,MDA,Ireland,IRL,0,0,17,0,17
2011,Malawi,MWI,Ireland,IRL,5,0,5,0,10
2011,Mongolia,MNG,Ireland,IRL,5,0,0,0,5
2011,Morocco,MAR,Ireland,IRL,0,0,5,0,5
2011,Mauritius,MUS,Ireland,IRL,0,0,5,0,5
2011,Nepal,NPL,Ireland,IRL,0,0,5,0,5
2011,Niger,NER,Ireland,IRL,0,0,5,0,5
2011,Nigeria,NGA,Ireland,IRL,5,0,264,24,293
2011,Pakistan,PAK,Ireland,IRL,5,0,150,5,160
2011,South Africa,ZAF,Ireland,IRL,0,0,32,0,32
2011,Russian Federation,RUS,Ireland,IRL,0,0,13,0,13
2011,Rwanda,RWA,Ireland,IRL,0,0,5,0,5
2011,Serbia and Kosovo: S/RES/1244 (1999),SRB,Ireland,IRL,0,0,10,0,10
2011,Sierra Leone,SLE,Ireland,IRL,0,0,5,0,5
2011,Somalia,SOM,Ireland,IRL,0,0,40,0,40
2011,Sudan,SDN,Ireland,IRL,0,0,31,0,31
2011,Eswatini,SWZ,Ireland,IRL,0,0,5,0,5
2011,Togo,TGO,Ireland,IRL,0,0,5,0,5
2011,Uganda,UGA,Ireland,IRL,5,0,14,0,19
2011,Yemen,YEM,Ireland,IRL,0,0,5,0,5
2011,Zimbabwe,ZWE,Ireland,IRL,0,0,64,0,64
2011,Sri Lanka,LKA,Japan,JPN,0,0,40,46,86
2011,Myanmar,MMR,Japan,JPN,12,60,377,70,459
2011,Nepal,NPL,Japan,JPN,0,0,20,0,20
2011,Pakistan,PAK,Japan,JPN,0,0,19,23,42
2011,Turkey,TUR,Japan,JPN,0,0,72,27,99
2011,India,IND,"China, Macao SAR",MAC,0,0,0,5,5
2011,Syrian Arab Rep.,SYR,"China, Macao SAR",MAC,0,0,0,5,5
2011,Burundi,BDI,Malawi,MWI,0,0,0,28,28
2011,Dem. Rep. of the Congo,COD,Malawi,MWI,0,0,0,14,14
2011,Ethiopia,ETH,Malawi,MWI,0,0,0,5,5
2011,Rwanda,RWA,Malawi,MWI,0,0,0,29,29
2011,Burundi,BDI,Mozambique,MOZ,0,0,0,24,24
2011,Dem. Rep. of the Congo,COD,Mozambique,MOZ,0,0,0,56,56
2011,Rwanda,RWA,Mozambique,MOZ,0,0,0,5,5
2011,Armenia,ARM,Malta,MLT,0,0,5,0,5
2011,Bangladesh,BGD,Malta,MLT,0,0,10,0,10
2011,Burkina Faso,BFA,Malta,MLT,0,0,15,0,15
2011,Chad,TCD,Malta,MLT,0,0,10,0,10
2011,Cameroon,CMR,Malta,MLT,0,0,5,0,5
2011,Dem. Rep. of the Congo,COD,Malta,MLT,0,0,5,0,5
2011,Eritrea,ERI,Malta,MLT,0,0,29,0,29
2011,Ethiopia,ETH,Malta,MLT,0,0,75,0,75
2011,Gambia,GMB,Malta,MLT,0,0,14,0,14
2011,Palestinian,PSE,Malta,MLT,0,0,5,0,5
2011,Ghana,GHA,Malta,MLT,0,0,71,0,71
2011,Guinea,GIN,Malta,MLT,0,0,10,0,10
2011,Cote d'Ivoire,CIV,Malta,MLT,0,0,63,0,63
2011,India,IND,Malta,MLT,0,0,10,0,10
2011,Iraq,IRQ,Malta,MLT,0,0,5,0,5
2011,Liberia,LBR,Malta,MLT,0,0,14,0,14
2011,Mali,MLI,Malta,MLT,0,0,48,0,48
2011,Morocco,MAR,Malta,MLT,0,0,5,0,5
2011,Niger,NER,Malta,MLT,0,0,197,0,197
2011,Nigeria,NGA,Malta,MLT,0,0,19,0,19
2011,Pakistan,PAK,Malta,MLT,0,0,17,0,17
2011,Somalia,SOM,Malta,MLT,0,0,27,0,27
2011,Sudan,SDN,Malta,MLT,0,0,14,0,14
2011,Syrian Arab Rep.,SYR,Malta,MLT,0,0,5,0,5
2011,Togo,TGO,Malta,MLT,0,0,26,0,26
2011,Tunisia,TUN,Malta,MLT,0,0,5,0,5
2011,Afghanistan,AFG,Norway,NOR,52,116,1410,179,1757
2011,Albania,ALB,Norway,NOR,0,0,24,5,29
2011,Algeria,DZA,Norway,NOR,0,0,78,5,83
2011,Angola,AGO,Norway,NOR,0,5,27,0,32
2011,Egypt,EGY,Norway,NOR,0,5,12,5,22
2011,Armenia,ARM,Norway,NOR,0,0,19,0,19
2011,Azerbaijan,AZE,Norway,NOR,5,0,65,5,75
2011,Burundi,BDI,Norway,NOR,0,12,66,0,78
2011,Bangladesh,BGD,Norway,NOR,0,0,18,0,18
2011,Bhutan,BTN,Norway,NOR,0,0,5,0,5
2011,Burkina Faso,BFA,Norway,NOR,0,0,5,0,5
2011,Belarus,BLR,Norway,NOR,0,0,14,0,14
2011,Bosnia and Herzegovina,BIH,Norway,NOR,0,0,23,5,28
2011,Chad,TCD,Norway,NOR,0,0,5,0,5
2011,China,CHN,Norway,NOR,5,0,11,0,16
2011,Cameroon,CMR,Norway,NOR,0,0,28,5,33
2011,Congo,COG,Norway,NOR,0,0,5,5,10
2011,Dem. Rep. of the Congo,COD,Norway,NOR,0,5,96,5,106
2011,Colombia,COL,Norway,NOR,0,0,5,0,5
2011,Cuba,CUB,Norway,NOR,0,5,0,0,5
2011,Czechia,CZE,Norway,NOR,0,0,5,0,5
2011,Eritrea,ERI,Norway,NOR,81,5,428,90,604
2011,Ethiopia,ETH,Norway,NOR,14,20,399,22,455
2011,Gambia,GMB,Norway,NOR,0,0,51,0,51
2011,Palestinian,PSE,Norway,NOR,0,0,5,0,5
2011,Georgia,GEO,Norway,NOR,0,5,45,0,50
2011,Ghana,GHA,Norway,NOR,0,0,37,0,37
2011,Guinea-Bissau,GNB,Norway,NOR,0,0,10,0,10
2011,Guinea,GIN,Norway,NOR,0,0,62,0,62
2011,Cote d'Ivoire,CIV,Norway,NOR,0,0,24,0,24
2011,India,IND,Norway,NOR,0,0,47,5,52
2011,Iran (Islamic Rep. of),IRN,Norway,NOR,31,23,414,26,494
2011,Iraq,IRQ,Norway,NOR,10,43,752,58,863
2011,Israel,ISR,Norway,NOR,0,0,5,0,5
2011,Jordan,JOR,Norway,NOR,0,0,35,5,40
2011,Kazakhstan,KAZ,Norway,NOR,0,0,22,0,22
2011,Kenya,KEN,Norway,NOR,0,0,11,0,11
2011,Kyrgyzstan,KGZ,Norway,NOR,0,0,28,0,28
2011,Dem. People's Rep. of Korea,PRK,Norway,NOR,0,0,5,0,5
2011,Liberia,LBR,Norway,NOR,0,0,52,0,52
2011,Libya,LBY,Norway,NOR,0,0,15,0,15
2011,Lebanon,LBN,Norway,NOR,0,0,47,5,52
2011,Sri Lanka,LKA,Norway,NOR,0,17,325,16,358
2011,Latvia,LVA,Norway,NOR,0,0,5,0,5
2011,Mauritania,MRT,Norway,NOR,0,0,10,0,10
2011,North Macedonia,MKD,Norway,NOR,0,0,32,0,32
2011,Rep. of Moldova,MDA,Norway,NOR,0,0,5,0,5
2011,Mexico,MEX,Norway,NOR,0,0,14,0,14
2011,Mali,MLI,Norway,NOR,0,0,5,0,5
2011,Mongolia,MNG,Norway,NOR,0,0,5,5,10
2011,Morocco,MAR,Norway,NOR,0,0,63,10,73
2011,Montenegro,MNE,Norway,NOR,0,0,5,0,5
2011,Myanmar,MMR,Norway,NOR,0,0,21,0,21
2011,Nepal,NPL,Norway,NOR,0,0,47,0,47
2011,Niger,NER,Norway,NOR,0,0,16,0,16
2011,Nicaragua,NIC,Norway,NOR,0,0,5,0,5
2011,Nigeria,NGA,Norway,NOR,0,0,298,30,328
2011,Pakistan,PAK,Norway,NOR,0,0,115,5,120
2011,Philippines,PHL,Norway,NOR,0,0,5,0,5
2011,Romania,ROU,Norway,NOR,0,0,5,0,5
2011,South Africa,ZAF,Norway,NOR,0,0,5,0,5
2011,Russian Federation,RUS,Norway,NOR,58,42,582,21,703
2011,Rwanda,RWA,Norway,NOR,0,5,25,0,30
2011,El Salvador,SLV,Norway,NOR,0,0,5,0,5
2011,Serbia and Kosovo: S/RES/1244 (1999),SRB,Norway,NOR,0,5,295,10,310
2011,Senegal,SEN,Norway,NOR,0,0,20,0,20
2011,Sierra Leone,SLE,Norway,NOR,0,5,25,0,30
2011,Somalia,SOM,Norway,NOR,5,78,399,131,613
2011,Viet Nam,VNM,Norway,NOR,0,0,10,0,10
2011,Sudan,SDN,Norway,NOR,0,0,59,13,72
2011,Syrian Arab Rep.,SYR,Norway,NOR,0,0,115,5,120
2011,United Rep. of Tanzania,TZA,Norway,NOR,0,0,5,0,5
2011,Tajikistan,TJK,Norway,NOR,0,0,22,0,22
2011,Togo,TGO,Norway,NOR,0,0,10,0,10
2011,Tunisia,TUN,Norway,NOR,0,0,28,0,28
2011,Turkey,TUR,Norway,NOR,0,5,76,10,91
2011,Uganda,UGA,Norway,NOR,0,5,27,0,32
2011,Ukraine,UKR,Norway,NOR,0,0,10,0,10
2011,Uzbekistan,UZB,Norway,NOR,14,5,103,0,122
2011,Yemen,YEM,Norway,NOR,0,0,39,0,39
2011,Zimbabwe,ZWE,Norway,NOR,0,0,23,0,23
2011,Stateless,XXA,Norway,NOR,5,22,655,27,709
2011,Afghanistan,AFG,New Zealand,NZL,5,0,0,0,5
2011,Egypt,EGY,New Zealand,NZL,5,0,0,0,5
2011,Bangladesh,BGD,New Zealand,NZL,0,0,5,0,5
2011,Brazil,BRA,New Zealand,NZL,0,0,5,0,5
2011,China,CHN,New Zealand,NZL,5,0,5,0,10
2011,Czechia,CZE,New Zealand,NZL,0,0,5,0,5
2011,Fiji,FJI,New Zealand,NZL,5,0,23,0,28
2011,Iran (Islamic Rep. of),IRN,New Zealand,NZL,16,0,5,0,21
2011,Sri Lanka,LKA,New Zealand,NZL,0,0,12,0,12
2011,South Africa,ZAF,New Zealand,NZL,0,0,11,0,11
2011,Saudi Arabia,SAU,New Zealand,NZL,5,0,0,0,5
2011,Syrian Arab Rep.,SYR,New Zealand,NZL,0,0,5,0,5
2011,Zimbabwe,ZWE,New Zealand,NZL,5,0,0,0,5
2011,Armenia,ARM,Poland,POL,0,5,0,5,10
2011,Belarus,BLR,Poland,POL,5,0,0,0,5
2011,Georgia,GEO,Poland,POL,0,0,0,20,20
2011,Rep. of Moldova,MDA,Poland,POL,0,0,0,5,5
2011,Russian Federation,RUS,Poland,POL,0,78,0,161,239
2011,Afghanistan,AFG,Sweden,SWE,48,119,552,101,820
2011,Albania,ALB,Sweden,SWE,0,5,80,5,90
2011,Algeria,DZA,Sweden,SWE,0,0,112,16,128
2011,Angola,AGO,Sweden,SWE,0,0,27,5,32
2011,Egypt,EGY,Sweden,SWE,5,0,139,24,168
2011,Armenia,ARM,Sweden,SWE,10,13,231,31,285
2011,Azerbaijan,AZE,Sweden,SWE,5,14,382,33,434
2011,Burundi,BDI,Sweden,SWE,0,5,26,5,36
2011,Benin,BEN,Sweden,SWE,0,0,11,0,11
2011,Bangladesh,BGD,Sweden,SWE,5,5,80,5,95
2011,Belarus,BLR,Sweden,SWE,0,5,184,40,229
2011,Bolivia (Plurinational State of),BOL,Sweden,SWE,0,0,25,5,30
2011,Bosnia and Herzegovina,BIH,Sweden,SWE,5,0,139,26,170
2011,Bulgaria,BGR,Sweden,SWE,0,0,5,0,5
2011,Chad,TCD,Sweden,SWE,0,0,5,0,5
2011,China,CHN,Sweden,SWE,11,0,42,10,63
2011,Chile,CHL,Sweden,SWE,0,0,5,0,5
2011,Cameroon,CMR,Sweden,SWE,5,0,17,5,27
2011,Congo,COG,Sweden,SWE,0,0,10,0,10
2011,Dem. Rep. of the Congo,COD,Sweden,SWE,0,5,91,12,108
2011,Colombia,COL,Sweden,SWE,0,0,13,5,18
2011,Cuba,CUB,Sweden,SWE,5,0,11,5,21
2011,Djibouti,DJI,Sweden,SWE,0,0,14,0,14
2011,Ecuador,ECU,Sweden,SWE,0,0,5,5,10
2011,Eritrea,ERI,Sweden,SWE,5,27,141,24,197
2011,Ethiopia,ETH,Sweden,SWE,10,0,190,17,217
2011,Gambia,GMB,Sweden,SWE,0,0,29,5,34
2011,Georgia,GEO,Sweden,SWE,0,5,174,10,189
2011,Ghana,GHA,Sweden,SWE,5,0,39,0,44
2011,Guinea,GIN,Sweden,SWE,0,0,32,0,32
2011,Honduras,HND,Sweden,SWE,0,0,10,0,10
2011,Croatia,HRV,Sweden,SWE,0,0,12,5,17
2011,Cote d'Ivoire,CIV,Sweden,SWE,0,0,11,5,16
2011,India,IND,Sweden,SWE,0,0,44,0,44
2011,Indonesia,IDN,Sweden,SWE,0,5,0,0,5
2011,Iran (Islamic Rep. of),IRN,Sweden,SWE,146,37,782,105,1070
2011,Iraq,IRQ,Sweden,SWE,60,87,1259,202,1608
2011,Israel,ISR,Sweden,SWE,0,0,17,0,17
2011,Italy,ITA,Sweden,SWE,0,0,5,0,5
2011,Jordan,JOR,Sweden,SWE,0,0,103,20,123
2011,Kazakhstan,KAZ,Sweden,SWE,0,5,306,46,357
2011,Kenya,KEN,Sweden,SWE,0,5,83,14,102
2011,Kyrgyzstan,KGZ,Sweden,SWE,5,5,274,69,353
2011,Rep. of Korea,KOR,Sweden,SWE,0,0,0,5,5
2011,Dem. People's Rep. of Korea,PRK,Sweden,SWE,0,0,5,0,5
2011,Kuwait,KWT,Sweden,SWE,0,0,11,0,11
2011,Liberia,LBR,Sweden,SWE,0,0,5,0,5
2011,Libya,LBY,Sweden,SWE,0,27,152,53,232
2011,Lebanon,LBN,Sweden,SWE,0,10,176,20,206
2011,Sri Lanka,LKA,Sweden,SWE,0,5,40,0,45
2011,Mauritania,MRT,Sweden,SWE,0,0,5,0,5
2011,North Macedonia,MKD,Sweden,SWE,0,5,335,30,370
2011,Mexico,MEX,Sweden,SWE,0,0,5,0,5
2011,Mali,MLI,Sweden,SWE,0,0,5,0,5
2011,Mongolia,MNG,Sweden,SWE,0,10,549,80,639
2011,Morocco,MAR,Sweden,SWE,0,5,44,0,49
2011,Montenegro,MNE,Sweden,SWE,0,0,35,11,46
2011,Myanmar,MMR,Sweden,SWE,0,0,5,0,5
2011,Nepal,NPL,Sweden,SWE,0,0,20,0,20
2011,Nicaragua,NIC,Sweden,SWE,0,0,24,0,24
2011,Nigeria,NGA,Sweden,SWE,0,0,211,29,240
2011,Pakistan,PAK,Sweden,SWE,5,10,63,10,88
2011,Paraguay,PRY,Sweden,SWE,0,0,5,0,5
2011,Peru,PER,Sweden,SWE,0,0,10,0,10
2011,Romania,ROU,Sweden,SWE,0,0,5,0,5
2011,South Africa,ZAF,Sweden,SWE,0,0,10,0,10
2011,Russian Federation,RUS,Sweden,SWE,10,39,611,105,765
2011,Rwanda,RWA,Sweden,SWE,0,0,5,5,10
2011,El Salvador,SLV,Sweden,SWE,0,0,37,5,42
2011,Serbia and Kosovo: S/RES/1244 (1999),SRB,Sweden,SWE,0,44,2593,357,2994
2011,Senegal,SEN,Sweden,SWE,0,0,15,0,15
2011,Sierra Leone,SLE,Sweden,SWE,0,0,16,5,21
2011,Somalia,SOM,Sweden,SWE,16,159,451,112,738
2011,Viet Nam,VNM,Sweden,SWE,0,0,111,10,121
2011,Sudan,SDN,Sweden,SWE,0,5,37,10,52
2011,Sweden,SWE,Sweden,SWE,0,0,0,5,5
2011,Syrian Arab Rep.,SYR,Sweden,SWE,12,16,389,39,456
2011,United Rep. of Tanzania,TZA,Sweden,SWE,0,0,21,10,31
2011,Tajikistan,TJK,Sweden,SWE,0,5,34,5,44
2011,Turkmenistan,TKM,Sweden,SWE,0,0,5,0,5
2011,Togo,TGO,Sweden,SWE,0,0,5,0,5
2011,Tunisia,TUN,Sweden,SWE,0,0,46,12,58
2011,Turkey,TUR,Sweden,SWE,5,5,122,42,174
2011,Uganda,UGA,Sweden,SWE,5,0,46,5,56
2011,Ukraine,UKR,Sweden,SWE,0,5,104,11,120
2011,United States of America,USA,Sweden,SWE,0,0,5,0,5
2011,Uzbekistan,UZB,Sweden,SWE,13,10,265,34,322
2011,Yemen,YEM,Sweden,SWE,5,0,76,5,86
2011,Stateless,XXA,Sweden,SWE,25,59,664,61,809
2012,Chad,TCD,Benin,BEN,0,0,0,5,5
2012,Eritrea,ERI,Benin,BEN,13,0,0,0,13
2012,Myanmar,MMR,Cambodia,KHM,0,0,5,0,5
2012,Cuba,CUB,Colombia,COL,0,0,5,0,5
2012,Peru,PER,Colombia,COL,0,0,5,0,5
2012,Afghanistan,AFG,Cyprus,CYP,0,0,95,10,105
2012,Egypt,EGY,Cyprus,CYP,0,5,104,0,109
2012,Armenia,ARM,Cyprus,CYP,0,0,15,0,15
2012,Bangladesh,BGD,Cyprus,CYP,0,0,115,25,140
2012,Bosnia and Herzegovina,BIH,Cyprus,CYP,0,0,20,0,20
2012,China,CHN,Cyprus,CYP,0,0,11,13,24
2012,Cameroon,CMR,Cyprus,CYP,0,0,44,11,55
2012,Dem. Rep. of the Congo,COD,Cyprus,CYP,0,0,5,0,5
2012,Ethiopia,ETH,Cyprus,CYP,0,0,12,0,12
2012,Palestinian,PSE,Cyprus,CYP,5,0,21,0,26
2012,Georgia,GEO,Cyprus,CYP,0,0,19,0,19
2012,Ghana,GHA,Cyprus,CYP,0,0,10,0,10
2012,Guinea,GIN,Cyprus,CYP,0,0,15,5,20
2012,India,IND,Cyprus,CYP,0,0,41,19,60
2012,Indonesia,IDN,Cyprus,CYP,0,0,5,0,5
2012,Iran (Islamic Rep. of),IRN,Cyprus,CYP,0,0,83,34,117
2012,Jordan,JOR,Cyprus,CYP,0,5,23,15,43
2012,Kenya,KEN,Cyprus,CYP,0,0,5,0,5
2012,Kyrgyzstan,KGZ,Cyprus,CYP,0,0,5,0,5
2012,Lebanon,LBN,Cyprus,CYP,0,0,45,0,45
2012,Sri Lanka,LKA,Cyprus,CYP,0,0,92,5,97
2012,Rep. of Moldova,MDA,Cyprus,CYP,0,0,12,5,17
2012,Mali,MLI,Cyprus,CYP,0,0,5,0,5
2012,Mongolia,MNG,Cyprus,CYP,0,0,0,5,5
2012,Morocco,MAR,Cyprus,CYP,0,0,5,5,10
2012,Nepal,NPL,Cyprus,CYP,0,0,44,5,49
2012,Nigeria,NGA,Cyprus,CYP,0,0,20,0,20
2012,Pakistan,PAK,Cyprus,CYP,0,0,100,20,120
2012,Philippines,PHL,Cyprus,CYP,0,0,35,13,48
2012,Russian Federation,RUS,Cyprus,CYP,0,0,37,21,58
2012,Serbia and Kosovo: S/RES/1244 (1999),SRB,Cyprus,CYP,0,0,5,48,53
2012,Senegal,SEN,Cyprus,CYP,0,0,5,0,5
2012,Sierra Leone,SLE,Cyprus,CYP,0,0,5,0,5
2012,Viet Nam,VNM,Cyprus,CYP,0,0,143,5,148
2012,Sudan,SDN,Cyprus,CYP,0,5,0,0,5
2012,Turkey,TUR,Cyprus,CYP,0,5,87,0,92
2012,Ukraine,UKR,Cyprus,CYP,0,0,30,19,49
2012,Uzbekistan,UZB,Cyprus,CYP,0,0,12,5,17
2012,Afghanistan,AFG,Denmark,DNK,10,114,439,0,563
2012,Armenia,ARM,Denmark,DNK,0,12,5,0,17
2012,Azerbaijan,AZE,Denmark,DNK,0,0,16,0,16
2012,Bangladesh,BGD,Denmark,DNK,0,0,48,0,48
2012,Belarus,BLR,Denmark,DNK,0,0,5,0,5
2012,Bosnia and Herzegovina,BIH,Denmark,DNK,0,0,5,0,5
2012,Cambodia,KHM,Denmark,DNK,0,0,10,0,10
2012,China,CHN,Denmark,DNK,0,0,5,0,5
2012,Dem. Rep. of the Congo,COD,Denmark,DNK,0,0,14,0,14
2012,Eritrea,ERI,Denmark,DNK,0,5,0,0,5
2012,Gambia,GMB,Denmark,DNK,0,0,5,0,5
2012,Palestinian,PSE,Denmark,DNK,0,0,14,0,14
2012,Georgia,GEO,Denmark,DNK,0,0,5,0,5
2012,Ghana,GHA,Denmark,DNK,0,0,10,0,10
2012,Guatemala,GTM,Denmark,DNK,5,0,0,0,5
2012,Cote d'Ivoire,CIV,Denmark,DNK,0,0,5,0,5
2012,India,IND,Denmark,DNK,0,5,5,0,10
2012,Iran (Islamic Rep. of),IRN,Denmark,DNK,104,14,112,0,230
2012,Iraq,IRQ,Denmark,DNK,0,5,49,0,54
2012,Kenya,KEN,Denmark,DNK,0,0,5,0,5
2012,Kyrgyzstan,KGZ,Denmark,DNK,5,0,0,0,5
2012,Libya,LBY,Denmark,DNK,0,0,5,0,5
2012,Sri Lanka,LKA,Denmark,DNK,0,0,10,0,10
2012,Myanmar,MMR,Denmark,DNK,0,0,11,0,11
2012,Nepal,NPL,Denmark,DNK,0,5,5,0,10
2012,Nigeria,NGA,Denmark,DNK,0,0,32,0,32
2012,Pakistan,PAK,Denmark,DNK,0,0,22,0,22
2012,Russian Federation,RUS,Denmark,DNK,5,10,63,0,78
2012,Serbia and Kosovo: S/RES/1244 (1999),SRB,Denmark,DNK,0,0,10,0,10
2012,Sierra Leone,SLE,Denmark,DNK,0,0,5,0,5
2012,Somalia,SOM,Denmark,DNK,0,0,11,0,11
2012,Sudan,SDN,Denmark,DNK,0,0,5,0,5
2012,Syrian Arab Rep.,SYR,Denmark,DNK,80,11,93,0,184
2012,Turkey,TUR,Denmark,DNK,0,0,5,0,5
2012,Uganda,UGA,Denmark,DNK,0,0,14,0,14
2012,Stateless,XXA,Denmark,DNK,10,0,21,0,31
2012,Afghanistan,AFG,France,FRA,58,162,118,0,338
2012,Albania,ALB,France,FRA,18,67,299,0,384
2012,Algeria,DZA,France,FRA,29,13,677,0,719
2012,Angola,AGO,France,FRA,42,5,309,0,356
2012,Egypt,EGY,France,FRA,57,0,61,0,118
2012,Armenia,ARM,France,FRA,71,87,1778,0,1936
2012,Azerbaijan,AZE,France,FRA,57,12,322,0,391
2012,Burundi,BDI,France,FRA,5,0,10,0,15
2012,Benin,BEN,France,FRA,0,0,5,0,5
2012,Bangladesh,BGD,France,FRA,409,32,3699,0,4140
2012,Bhutan,BTN,France,FRA,10,0,10,0,20
2012,Burkina Faso,BFA,France,FRA,5,5,16,0,26
2012,Belarus,BLR,France,FRA,14,0,40,0,54
2012,Bolivia (Plurinational State of),BOL,France,FRA,0,0,5,0,5
2012,Brazil,BRA,France,FRA,0,0,5,0,5
2012,Bosnia and Herzegovina,BIH,France,FRA,10,5,102,0,117
2012,Cambodia,KHM,France,FRA,0,0,11,0,11
2012,Central African Rep.,CAF,France,FRA,5,0,39,0,44
2012,Chad,TCD,France,FRA,40,0,81,0,121
2012,China,CHN,France,FRA,23,13,1936,0,1972
2012,Cameroon,CMR,France,FRA,26,10,129,0,165
2012,Congo,COG,France,FRA,36,14,387,0,437
2012,Dem. Rep. of the Congo,COD,France,FRA,327,58,2201,0,2586
2012,Comoros,COM,France,FRA,13,5,686,0,704
2012,Colombia,COL,France,FRA,13,5,63,0,81
2012,Djibouti,DJI,France,FRA,0,0,5,0,5
2012,Dominican Rep.,DOM,France,FRA,0,5,48,0,53
2012,Equatorial Guinea,GNQ,France,FRA,0,0,5,0,5
2012,Eritrea,ERI,France,FRA,132,5,113,0,250
2012,Ethiopia,ETH,France,FRA,10,5,37,0,52
2012,Gabon,GAB,France,FRA,0,0,5,0,5
2012,Gambia,GMB,France,FRA,5,0,26,0,31
2012,Palestinian,PSE,France,FRA,12,0,21,0,33
2012,Georgia,GEO,France,FRA,79,38,655,0,772
2012,Ghana,GHA,France,FRA,0,0,10,0,10
2012,Guinea-Bissau,GNB,France,FRA,0,5,121,0,126
2012,Guinea,GIN,France,FRA,119,62,912,0,1093
2012,Guyana,GUY,France,FRA,0,5,0,0,5
2012,Haiti,HTI,France,FRA,46,37,956,0,1039
2012,Cote d'Ivoire,CIV,France,FRA,43,28,597,0,668
2012,India,IND,France,FRA,0,0,23,0,23
2012,Indonesia,IDN,France,FRA,0,0,5,0,5
2012,Iran (Islamic Rep. of),IRN,France,FRA,35,0,43,0,78
2012,Iraq,IRQ,France,FRA,28,5,54,0,87
2012,Jordan,JOR,France,FRA,0,0,5,0,5
2012,Kazakhstan,KAZ,France,FRA,16,0,64,0,80
2012,Kenya,KEN,France,FRA,5,5,15,0,25
2012,Kyrgyzstan,KGZ,France,FRA,23,5,30,0,58
2012,Dem. People's Rep. of Korea,PRK,France,FRA,0,0,39,0,39
2012,Lao People's Dem. Rep.,LAO,France,FRA,0,0,17,0,17
2012,Liberia,LBR,France,FRA,0,0,16,0,16
2012,Libya,LBY,France,FRA,0,0,16,0,16
2012,Lebanon,LBN,France,FRA,0,0,12,0,12
2012,Sri Lanka,LKA,France,FRA,611,44,1956,0,2611
2012,Madagascar,MDG,France,FRA,10,0,93,0,103
2012,Mauritania,MRT,France,FRA,115,15,991,0,1121
2012,North Macedonia,MKD,France,FRA,10,11,331,0,352
2012,Rep. of Moldova,MDA,France,FRA,5,0,109,0,114
2012,Mali,MLI,France,FRA,5,69,89,0,163
2012,Mongolia,MNG,France,FRA,5,17,142,0,164
2012,Morocco,MAR,France,FRA,5,0,27,0,32
2012,Montenegro,MNE,France,FRA,5,10,106,0,121
2012,Myanmar,MMR,France,FRA,15,0,48,0,63
2012,Nepal,NPL,France,FRA,5,0,47,0,52
2012,Niger,NER,France,FRA,0,0,12,0,12
2012,Nigeria,NGA,France,FRA,25,37,507,0,569
2012,Pakistan,PAK,France,FRA,53,12,837,0,902
2012,Peru,PER,France,FRA,5,10,74,0,89
2012,Romania,ROU,France,FRA,0,0,5,0,5
2012,Russian Federation,RUS,France,FRA,661,82,1441,0,2184
2012,Rwanda,RWA,France,FRA,46,5,88,0,139
2012,Serbia and Kosovo: S/RES/1244 (1999),SRB,France,FRA,384,180,2429,0,2993
2012,Senegal,SEN,France,FRA,5,11,63,0,79
2012,Sierra Leone,SLE,France,FRA,5,0,96,0,101
2012,Somalia,SOM,France,FRA,17,101,63,0,181
2012,Viet Nam,VNM,France,FRA,5,0,10,0,15
2012,Sudan,SDN,France,FRA,147,38,315,0,500
2012,Suriname,SUR,France,FRA,0,0,20,0,20
2012,Syrian Arab Rep.,SYR,France,FRA,37,5,5,0,47
2012,Thailand,THA,France,FRA,0,0,52,0,52
2012,Tajikistan,TJK,France,FRA,0,0,10,0,10
2012,Turkmenistan,TKM,France,FRA,0,0,5,0,5
2012,Togo,TGO,France,FRA,10,0,96,0,106
2012,Tunisia,TUN,France,FRA,0,0,49,0,49
2012,Turkey,TUR,France,FRA,220,14,1342,0,1576
2012,Uganda,UGA,France,FRA,0,0,11,0,11
2012,Ukraine,UKR,France,FRA,5,0,63,0,68
2012,Uzbekistan,UZB,France,FRA,5,0,13,0,18
2012,Venezuela (Bolivarian Republic of),VEN,France,FRA,0,0,5,0,5
2012,Western Sahara,ESH,France,FRA,5,0,5,0,10
2012,Afghanistan,AFG,Greece,GRC,19,97,0,0,116
2012,Albania,ALB,Greece,GRC,0,5,0,0,5
2012,Bangladesh,BGD,Greece,GRC,0,5,0,0,5
2012,China,CHN,Greece,GRC,5,0,0,0,5
2012,Dem. Rep. of the Congo,COD,Greece,GRC,0,5,0,0,5
2012,Georgia,GEO,Greece,GRC,0,15,0,0,15
2012,Ghana,GHA,Greece,GRC,0,5,0,0,5
2012,Iran (Islamic Rep. of),IRN,Greece,GRC,28,54,0,0,82
2012,Iraq,IRQ,Greece,GRC,107,96,0,0,203
2012,Lebanon,LBN,Greece,GRC,0,5,0,0,5
2012,Nigeria,NGA,Greece,GRC,5,11,0,0,16
2012,Pakistan,PAK,Greece,GRC,0,5,0,0,5
2012,Sierra Leone,SLE,Greece,GRC,0,5,0,0,5
2012,Sudan,SDN,Greece,GRC,5,5,0,0,10
2012,Syrian Arab Rep.,SYR,Greece,GRC,0,10,0,0,10
2012,Turkey,TUR,Greece,GRC,10,20,0,0,30
2012,Albania,ALB,Iceland,ISL,0,0,5,0,5
2012,Algeria,DZA,Iceland,ISL,0,0,5,5,10
2012,Iraq,IRQ,Iceland,ISL,0,0,0,5,5
2012,Nigeria,NGA,Iceland,ISL,0,0,0,11,11
2012,Afghanistan,AFG,Ireland,IRL,0,0,31,0,31
2012,Albania,ALB,Ireland,IRL,0,0,23,0,23
2012,Algeria,DZA,Ireland,IRL,0,0,23,5,28
2012,Angola,AGO,Ireland,IRL,0,0,5,0,5
2012,Egypt,EGY,Ireland,IRL,0,0,5,0,5
2012,Armenia,ARM,Ireland,IRL,0,0,5,0,5
2012,Bangladesh,BGD,Ireland,IRL,0,0,18,0,18
2012,Bolivia (Plurinational State of),BOL,Ireland,IRL,0,0,5,0,5
2012,Brazil,BRA,Ireland,IRL,0,0,10,0,10
2012,China,CHN,Ireland,IRL,0,0,11,0,11
2012,Chile,CHL,Ireland,IRL,0,0,5,0,5
2012,Cameroon,CMR,Ireland,IRL,0,0,19,0,19
2012,Congo,COG,Ireland,IRL,0,0,11,0,11
2012,Dem. Rep. of the Congo,COD,Ireland,IRL,5,0,35,0,40
2012,Ethiopia,ETH,Ireland,IRL,0,0,10,0,10
2012,Palestinian,PSE,Ireland,IRL,5,0,5,0,10
2012,Georgia,GEO,Ireland,IRL,0,0,14,0,14
2012,Ghana,GHA,Ireland,IRL,0,0,10,0,10
2012,Cote d'Ivoire,CIV,Ireland,IRL,0,0,5,0,5
2012,India,IND,Ireland,IRL,0,0,5,0,5
2012,Iran (Islamic Rep. of),IRN,Ireland,IRL,0,0,10,0,10
2012,Iraq,IRQ,Ireland,IRL,0,0,5,0,5
2012,Israel,ISR,Ireland,IRL,0,0,12,0,12
2012,Kenya,KEN,Ireland,IRL,0,0,5,0,5
2012,Rep. of Moldova,MDA,Ireland,IRL,5,0,14,0,19
2012,Malawi,MWI,Ireland,IRL,0,0,19,0,19
2012,Mauritius,MUS,Ireland,IRL,0,0,5,0,5
2012,Nepal,NPL,Ireland,IRL,0,0,10,0,10
2012,Niger,NER,Ireland,IRL,0,0,5,0,5
2012,Nigeria,NGA,Ireland,IRL,0,0,90,16,106
2012,Pakistan,PAK,Ireland,IRL,0,0,53,5,58
2012,South Africa,ZAF,Ireland,IRL,0,0,34,0,34
2012,Russian Federation,RUS,Ireland,IRL,0,0,0,12,12
2012,Rwanda,RWA,Ireland,IRL,0,0,11,0,11
2012,Serbia and Kosovo: S/RES/1244 (1999),SRB,Ireland,IRL,0,0,14,0,14
2012,Somalia,SOM,Ireland,IRL,0,0,14,0,14
2012,Sudan,SDN,Ireland,IRL,10,0,10,0,20
2012,Syrian Arab Rep.,SYR,Ireland,IRL,0,0,5,0,5
2012,Uganda,UGA,Ireland,IRL,0,0,5,0,5
2012,Ukraine,UKR,Ireland,IRL,0,0,13,0,13
2012,Yemen,YEM,Ireland,IRL,0,0,5,0,5
2012,Zimbabwe,ZWE,Ireland,IRL,0,0,32,0,32
2012,India,IND,Japan,JPN,0,0,0,13,13
2012,Sri Lanka,LKA,Japan,JPN,0,0,81,22,103
2012,Myanmar,MMR,Japan,JPN,11,0,350,55,416
2012,Nepal,NPL,Japan,JPN,0,0,71,0,71
2012,Pakistan,PAK,Japan,JPN,0,0,53,21,74
2012,Turkey,TUR,Japan,JPN,0,0,58,13,71
2012,Burundi,BDI,Malawi,MWI,0,0,0,150,150
2012,Dem. Rep. of the Congo,COD,Malawi,MWI,0,0,0,92,92
2012,Ethiopia,ETH,Malawi,MWI,0,0,0,5,5
2012,Rwanda,RWA,Malawi,MWI,0,0,0,132,132
2012,Egypt,EGY,Malta,MLT,0,0,5,0,5
2012,Eritrea,ERI,Malta,MLT,0,0,5,0,5
2012,Ethiopia,ETH,Malta,MLT,0,0,10,5,15
2012,Ghana,GHA,Malta,MLT,0,0,5,5,10
2012,Cote d'Ivoire,CIV,Malta,MLT,0,0,5,0,5
2012,Iraq,IRQ,Malta,MLT,0,0,5,0,5
2012,Libya,LBY,Malta,MLT,0,0,5,0,5
2012,Mali,MLI,Malta,MLT,0,0,15,0,15
2012,Nigeria,NGA,Malta,MLT,0,0,5,5,10
2012,Senegal,SEN,Malta,MLT,0,0,0,5,5
2012,Somalia,SOM,Malta,MLT,0,0,5,0,5
2012,Afghanistan,AFG,Norway,NOR,32,49,1485,37,1603
2012,Albania,ALB,Norway,NOR,0,0,72,0,72
2012,Algeria,DZA,Norway,NOR,0,0,53,5,58
2012,Angola,AGO,Norway,NOR,0,0,27,0,27
2012,Egypt,EGY,Norway,NOR,0,0,23,0,23
2012,Armenia,ARM,Norway,NOR,0,0,13,0,13
2012,Azerbaijan,AZE,Norway,NOR,0,0,16,0,16
2012,Burundi,BDI,Norway,NOR,0,0,33,0,33
2012,Benin,BEN,Norway,NOR,0,0,5,0,5
2012,Bangladesh,BGD,Norway,NOR,0,0,96,5,101
2012,Belarus,BLR,Norway,NOR,0,0,62,0,62
2012,Brazil,BRA,Norway,NOR,0,0,5,0,5
2012,Bosnia and Herzegovina,BIH,Norway,NOR,0,0,21,5,26
2012,Bulgaria,BGR,Norway,NOR,0,0,19,0,19
2012,Chad,TCD,Norway,NOR,0,0,5,0,5
2012,China,CHN,Norway,NOR,0,0,34,0,34
2012,Chile,CHL,Norway,NOR,0,0,5,0,5
2012,Cameroon,CMR,Norway,NOR,0,0,29,0,29
2012,Congo,COG,Norway,NOR,0,0,5,0,5
2012,Dem. Rep. of the Congo,COD,Norway,NOR,5,0,121,0,126
2012,Colombia,COL,Norway,NOR,0,0,10,0,10
2012,Eritrea,ERI,Norway,NOR,87,0,452,51,590
2012,Ethiopia,ETH,Norway,NOR,15,0,528,10,553
2012,Gambia,GMB,Norway,NOR,0,0,38,5,43
2012,Palestinian,PSE,Norway,NOR,0,0,5,0,5
2012,Georgia,GEO,Norway,NOR,0,0,31,0,31
2012,Ghana,GHA,Norway,NOR,0,0,29,0,0
2012,Guinea-Bissau,GNB,Norway,NOR,0,0,5,0,5
2012,Guinea,GIN,Norway,NOR,0,0,34,0,34
2012,Hungary,HUN,Norway,NOR,0,0,20,0,20
2012,Cote d'Ivoire,CIV,Norway,NOR,0,0,46,0,46
2012,India,IND,Norway,NOR,0,0,48,0,48
2012,Iran (Islamic Rep. of),IRN,Norway,NOR,41,0,526,25,592
2012,Iraq,IRQ,Norway,NOR,30,10,471,18,529
2012,Israel,ISR,Norway,NOR,0,0,5,0,5
2012,Jordan,JOR,Norway,NOR,0,0,13,0,13
2012,Kazakhstan,KAZ,Norway,NOR,0,0,12,0,12
2012,Kenya,KEN,Norway,NOR,0,0,14,0,14
2012,Kyrgyzstan,KGZ,Norway,NOR,0,0,49,5,54
2012,Kuwait,KWT,Norway,NOR,0,0,5,0,5
2012,Liberia,LBR,Norway,NOR,0,0,18,0,18
2012,Libya,LBY,Norway,NOR,0,0,69,5,74
2012,Lebanon,LBN,Norway,NOR,0,0,17,0,17
2012,Sri Lanka,LKA,Norway,NOR,5,0,91,0,96
2012,Mauritania,MRT,Norway,NOR,0,0,10,0,10
2012,North Macedonia,MKD,Norway,NOR,0,0,17,5,22
2012,Rep. of Moldova,MDA,Norway,NOR,0,0,5,0,5
2012,Mexico,MEX,Norway,NOR,0,0,10,0,10
2012,Mongolia,MNG,Norway,NOR,0,0,5,0,5
2012,Morocco,MAR,Norway,NOR,0,0,53,0,53
2012,Myanmar,MMR,Norway,NOR,0,0,28,0,28
2012,Nepal,NPL,Norway,NOR,0,0,25,0,25
2012,Niger,NER,Norway,NOR,0,0,19,0,19
2012,Nigeria,NGA,Norway,NOR,10,0,234,17,261
2012,Pakistan,PAK,Norway,NOR,0,0,110,10,120
2012,Russian Federation,RUS,Norway,NOR,29,0,476,68,573
2012,Rwanda,RWA,Norway,NOR,0,0,20,0,20
2012,El Salvador,SLV,Norway,NOR,0,0,5,0,5
2012,Serbia and Kosovo: S/RES/1244 (1999),SRB,Norway,NOR,0,0,210,5,215
2012,Senegal,SEN,Norway,NOR,0,0,17,0,17
2012,Sierra Leone,SLE,Norway,NOR,0,0,19,0,19
2012,Somalia,SOM,Norway,NOR,5,22,532,68,627
2012,Viet Nam,VNM,Norway,NOR,0,0,11,0,11
2012,Sudan,SDN,Norway,NOR,5,0,41,0,46
2012,Syrian Arab Rep.,SYR,Norway,NOR,0,159,37,5,201
2012,Tajikistan,TJK,Norway,NOR,0,0,5,5,10
2012,Tunisia,TUN,Norway,NOR,0,0,32,0,32
2012,Turkey,TUR,Norway,NOR,0,0,32,5,37
2012,Uganda,UGA,Norway,NOR,5,0,32,0,37
2012,Ukraine,UKR,Norway,NOR,0,0,5,0,5
2012,Uzbekistan,UZB,Norway,NOR,10,0,56,21,87
2012,Yemen,YEM,Norway,NOR,0,0,107,0,107
2012,Zimbabwe,ZWE,Norway,NOR,0,0,15,0,15
2012,Stateless,XXA,Norway,NOR,5,49,384,16,454
2012,Afghanistan,AFG,New Zealand,NZL,5,0,0,0,5
2012,Egypt,EGY,New Zealand,NZL,10,0,0,0,10
2012,China,CHN,New Zealand,NZL,0,0,11,0,11
2012,Chile,CHL,New Zealand,NZL,0,0,5,0,5
2012,Czechia,CZE,New Zealand,NZL,5,0,0,0,5
2012,Fiji,FJI,New Zealand,NZL,0,0,18,0,18
2012,Germany,DEU,New Zealand,NZL,0,0,5,0,5
2012,Hungary,HUN,New Zealand,NZL,0,0,5,0,5
2012,Iran (Islamic Rep. of),IRN,New Zealand,NZL,14,0,11,0,25
2012,Iraq,IRQ,New Zealand,NZL,5,0,0,0,5
2012,Sri Lanka,LKA,New Zealand,NZL,5,0,0,5,10
2012,Pakistan,PAK,New Zealand,NZL,5,0,5,0,10
2012,South Africa,ZAF,New Zealand,NZL,5,0,0,0,5
2012,Russian Federation,RUS,New Zealand,NZL,5,0,0,0,5
2012,Syrian Arab Rep.,SYR,New Zealand,NZL,5,0,0,0,5
2012,Tunisia,TUN,New Zealand,NZL,0,0,5,0,5
2012,Zimbabwe,ZWE,New Zealand,NZL,0,0,5,0,5
2012,Afghanistan,AFG,Poland,POL,0,0,16,0,16
2012,Armenia,ARM,Poland,POL,0,0,29,10,39
2012,Belarus,BLR,Poland,POL,0,5,11,0,16
2012,Cameroon,CMR,Poland,POL,0,0,5,0,5
2012,Dem. Rep. of the Congo,COD,Poland,POL,0,0,5,0,5
2012,Palestinian,PSE,Poland,POL,0,0,0,5,5
2012,Georgia,GEO,Poland,POL,0,0,186,32,218
2012,India,IND,Poland,POL,0,0,5,0,5
2012,Iran (Islamic Rep. of),IRN,Poland,POL,0,0,5,0,5
2012,Kenya,KEN,Poland,POL,0,5,0,0,5
2012,Kyrgyzstan,KGZ,Poland,POL,0,0,12,0,12
2012,Mongolia,MNG,Poland,POL,0,0,5,0,5
2012,Nigeria,NGA,Poland,POL,0,0,11,0,11
2012,Pakistan,PAK,Poland,POL,0,0,5,0,5
2012,Russian Federation,RUS,Poland,POL,17,42,560,129,748
2012,Viet Nam,VNM,Poland,POL,0,0,5,0,5
2012,Uganda,UGA,Poland,POL,0,0,5,0,5
2012,Ukraine,UKR,Poland,POL,0,0,11,10,21
2012,Uzbekistan,UZB,Poland,POL,0,0,10,0,10
2012,Stateless,XXA,Poland,POL,0,0,5,0,5
2012,Angola,AGO,South Africa,ZAF,0,0,5,0,5
2012,Burundi,BDI,South Africa,ZAF,0,0,52,5,57
2012,Bangladesh,BGD,South Africa,ZAF,0,0,143,5,148
2012,China,CHN,South Africa,ZAF,0,0,5,0,5
2012,Cameroon,CMR,South Africa,ZAF,0,0,5,0,5
2012,Congo,COG,South Africa,ZAF,0,0,5,0,5
2012,Dem. Rep. of the Congo,COD,South Africa,ZAF,33,0,120,12,165
2012,Eritrea,ERI,South Africa,ZAF,0,0,5,0,5
2012,Ethiopia,ETH,South Africa,ZAF,0,0,673,5,678
2012,Ghana,GHA,South Africa,ZAF,0,0,0,5,5
2012,India,IND,South Africa,ZAF,0,0,26,0,26
2012,Kenya,KEN,South Africa,ZAF,0,0,5,5,10
2012,Liberia,LBR,South Africa,ZAF,0,0,5,0,5
2012,Malawi,MWI,South Africa,ZAF,0,0,10,0,10
2012,Nigeria,NGA,South Africa,ZAF,0,0,17,0,17
2012,Pakistan,PAK,South Africa,ZAF,0,0,37,0,37
2012,Rwanda,RWA,South Africa,ZAF,0,0,5,0,5
2012,Senegal,SEN,South Africa,ZAF,0,0,5,0,5
2012,Somalia,SOM,South Africa,ZAF,10,0,5,0,15
2012,United Rep. of Tanzania,TZA,South Africa,ZAF,0,0,5,0,5
2012,Uganda,UGA,South Africa,ZAF,0,0,30,0,30
2012,Zimbabwe,ZWE,South Africa,ZAF,0,0,105,37,142
2012,Afghanistan,AFG,Sweden,SWE,92,118,1473,137,1820
2012,Albania,ALB,Sweden,SWE,0,15,380,38,433
2012,Algeria,DZA,Sweden,SWE,0,0,101,21,122
2012,Angola,AGO,Sweden,SWE,0,0,13,5,18
2012,Egypt,EGY,Sweden,SWE,5,0,136,5,146
2012,Armenia,ARM,Sweden,SWE,0,5,261,26,292
2012,Azerbaijan,AZE,Sweden,SWE,5,5,320,26,356
2012,Burundi,BDI,Sweden,SWE,0,0,16,0,16
2012,Bangladesh,BGD,Sweden,SWE,5,0,133,13,151
2012,Burkina Faso,BFA,Sweden,SWE,0,0,5,0,5
2012,Belarus,BLR,Sweden,SWE,0,0,221,41,262
2012,Bolivia (Plurinational State of),BOL,Sweden,SWE,0,0,23,5,28
2012,Bosnia and Herzegovina,BIH,Sweden,SWE,0,0,529,114,643
2012,Bulgaria,BGR,Sweden,SWE,0,0,5,0,5
2012,Chad,TCD,Sweden,SWE,0,0,5,0,5
2012,China,CHN,Sweden,SWE,23,0,64,10,97
2012,Chile,CHL,Sweden,SWE,0,0,12,0,12
2012,Cameroon,CMR,Sweden,SWE,5,0,22,0,27
2012,Congo,COG,Sweden,SWE,0,0,5,0,5
2012,Dem. Rep. of the Congo,COD,Sweden,SWE,5,5,74,11,95
2012,Colombia,COL,Sweden,SWE,0,0,11,5,16
2012,Cuba,CUB,Sweden,SWE,0,0,22,10,32
2012,Djibouti,DJI,Sweden,SWE,0,0,19,0,19
2012,Ecuador,ECU,Sweden,SWE,0,0,0,5,5
2012,Eritrea,ERI,Sweden,SWE,5,44,175,29,253
2012,Ethiopia,ETH,Sweden,SWE,18,0,222,18,258
2012,Gambia,GMB,Sweden,SWE,0,0,40,10,50
2012,Georgia,GEO,Sweden,SWE,0,0,132,20,152
2012,Ghana,GHA,Sweden,SWE,0,0,32,5,37
2012,Guinea,GIN,Sweden,SWE,10,0,25,0,35
2012,Honduras,HND,Sweden,SWE,0,0,5,0,5
2012,Croatia,HRV,Sweden,SWE,0,0,10,0,10
2012,Cote d'Ivoire,CIV,Sweden,SWE,0,0,24,0,24
2012,India,IND,Sweden,SWE,0,0,54,0,54
2012,Iran (Islamic Rep. of),IRN,Sweden,SWE,202,23,907,97,1229
2012,Iraq,IRQ,Sweden,SWE,108,21,1009,137,1275
2012,Israel,ISR,Sweden,SWE,0,0,13,0,13
2012,Jordan,JOR,Sweden,SWE,0,0,70,15,85
2012,Kazakhstan,KAZ,Sweden,SWE,0,0,243,41,284
2012,Kenya,KEN,Sweden,SWE,0,0,79,5,84
2012,Kyrgyzstan,KGZ,Sweden,SWE,10,0,331,34,375
2012,Dem. People's Rep. of Korea,PRK,Sweden,SWE,0,0,5,5,10
2012,Kuwait,KWT,Sweden,SWE,0,0,18,0,18
2012,Liberia,LBR,Sweden,SWE,0,0,5,5,10
2012,Libya,LBY,Sweden,SWE,0,0,241,31,272
2012,Lebanon,LBN,Sweden,SWE,5,0,194,26,225
2012,Sri Lanka,LKA,Sweden,SWE,0,0,16,5,21
2012,Mauritania,MRT,Sweden,SWE,0,0,5,0,5
2012,North Macedonia,MKD,Sweden,SWE,0,0,322,30,352
2012,Mexico,MEX,Sweden,SWE,0,0,5,0,5
2012,Mali,MLI,Sweden,SWE,0,0,5,0,5
2012,Mongolia,MNG,Sweden,SWE,5,0,668,56,729
2012,Morocco,MAR,Sweden,SWE,0,0,113,14,127
2012,Montenegro,MNE,Sweden,SWE,0,0,78,15,93
2012,Myanmar,MMR,Sweden,SWE,0,0,5,0,5
2012,Nepal,NPL,Sweden,SWE,0,0,20,5,25
2012,Niger,NER,Sweden,SWE,0,0,5,0,5
2012,Nicaragua,NIC,Sweden,SWE,0,0,12,0,12
2012,Nigeria,NGA,Sweden,SWE,5,0,260,19,284
2012,Pakistan,PAK,Sweden,SWE,15,0,130,18,163
2012,Peru,PER,Sweden,SWE,0,0,5,0,5
2012,Philippines,PHL,Sweden,SWE,0,0,5,5,10
2012,Romania,ROU,Sweden,SWE,0,0,5,0,5
2012,Russian Federation,RUS,Sweden,SWE,28,11,649,105,793
2012,Rwanda,RWA,Sweden,SWE,0,0,10,0,10
2012,El Salvador,SLV,Sweden,SWE,0,0,41,5,46
2012,Saudi Arabia,SAU,Sweden,SWE,0,0,11,0,11
2012,Serbia and Kosovo: S/RES/1244 (1999),SRB,Sweden,SWE,11,0,2250,265,2526
2012,Senegal,SEN,Sweden,SWE,0,0,12,0,12
2012,Sierra Leone,SLE,Sweden,SWE,5,0,20,0,25
2012,Somalia,SOM,Sweden,SWE,10,61,471,76,618
2012,Spain,ESP,Sweden,SWE,0,0,5,0,5
2012,Viet Nam,VNM,Sweden,SWE,0,0,39,5,44
2012,Sudan,SDN,Sweden,SWE,5,0,45,0,50
2012,Syrian Arab Rep.,SYR,Sweden,SWE,28,232,338,153,751
2012,United Rep. of Tanzania,TZA,Sweden,SWE,0,0,30,5,35
2012,Thailand,THA,Sweden,SWE,0,0,0,5,5
2012,Tajikistan,TJK,Sweden,SWE,0,0,24,5,29
2012,Turkmenistan,TKM,Sweden,SWE,0,0,5,0,5
2012,Togo,TGO,Sweden,SWE,0,0,5,0,5
2012,Tunisia,TUN,Sweden,SWE,0,0,69,12,81
2012,Turkey,TUR,Sweden,SWE,5,0,106,19,130
2012,Uganda,UGA,Sweden,SWE,5,0,74,5,84
2012,Ukraine,UKR,Sweden,SWE,0,0,146,19,165
2012,Uzbekistan,UZB,Sweden,SWE,10,5,317,27,359
2012,Venezuela (Bolivarian Republic of),VEN,Sweden,SWE,0,0,5,0,5
2012,Yemen,YEM,Sweden,SWE,5,5,88,10,108
2012,Zambia,ZMB,Sweden,SWE,0,0,0,5,5
2012,Zimbabwe,ZWE,Sweden,SWE,0,0,5,0,5
2012,Stateless,XXA,Sweden,SWE,25,36,543,75,679
2012,Afghanistan,AFG,Switzerland,CHE,0,0,0,0,319
2012,Albania,ALB,Switzerland,CHE,0,0,0,0,10
2012,Algeria,DZA,Switzerland,CHE,0,0,0,0,120
2012,Angola,AGO,Switzerland,CHE,0,0,0,0,44
2012,Egypt,EGY,Switzerland,CHE,0,0,0,0,23
2012,Armenia,ARM,Switzerland,CHE,0,0,0,0,67
2012,Azerbaijan,AZE,Switzerland,CHE,0,0,0,0,12
2012,Benin,BEN,Switzerland,CHE,0,0,0,0,5
2012,Bangladesh,BGD,Switzerland,CHE,0,0,0,0,22
2012,Burkina Faso,BFA,Switzerland,CHE,0,0,0,0,5
2012,Belarus,BLR,Switzerland,CHE,0,0,0,0,26
2012,Bosnia and Herzegovina,BIH,Switzerland,CHE,0,0,0,0,254
2012,Bulgaria,BGR,Switzerland,CHE,0,0,0,0,12
2012,Chad,TCD,Switzerland,CHE,0,0,0,0,15
2012,China,CHN,Switzerland,CHE,0,0,0,0,24
2012,Cameroon,CMR,Switzerland,CHE,0,0,0,0,41
2012,Congo,COG,Switzerland,CHE,0,0,0,0,5
2012,Dem. Rep. of the Congo,COD,Switzerland,CHE,0,0,0,0,158
2012,Colombia,COL,Switzerland,CHE,0,0,0,0,79
2012,Cuba,CUB,Switzerland,CHE,0,0,0,0,5
2012,Cyprus,CYP,Switzerland,CHE,0,0,0,0,5
2012,Czechia,CZE,Switzerland,CHE,0,0,0,0,10
2012,Ecuador,ECU,Switzerland,CHE,0,0,0,0,10
2012,Eritrea,ERI,Switzerland,CHE,0,0,0,0,558
2012,Ethiopia,ETH,Switzerland,CHE,0,0,0,0,130
2012,Gambia,GMB,Switzerland,CHE,0,0,0,0,30
2012,Palestinian,PSE,Switzerland,CHE,0,0,0,0,29
2012,Georgia,GEO,Switzerland,CHE,0,0,0,0,117
2012,Ghana,GHA,Switzerland,CHE,0,0,0,0,26
2012,Guinea-Bissau,GNB,Switzerland,CHE,0,0,0,0,16
2012,Greece,GRC,Switzerland,CHE,0,0,0,0,5
2012,Guinea,GIN,Switzerland,CHE,0,0,0,0,62
2012,Croatia,HRV,Switzerland,CHE,0,0,0,0,14
2012,Cote d'Ivoire,CIV,Switzerland,CHE,0,0,0,0,25
2012,India,IND,Switzerland,CHE,0,0,0,0,5
2012,Iran (Islamic Rep. of),IRN,Switzerland,CHE,0,0,0,0,158
2012,Iraq,IRQ,Switzerland,CHE,0,0,0,0,235
2012,Kyrgyzstan,KGZ,Switzerland,CHE,0,0,0,0,5
2012,Liberia,LBR,Switzerland,CHE,0,0,0,0,10
2012,Libya,LBY,Switzerland,CHE,0,0,0,0,17
2012,Sri Lanka,LKA,Switzerland,CHE,0,0,0,0,850
2012,Mauritania,MRT,Switzerland,CHE,0,0,0,0,5
2012,North Macedonia,MKD,Switzerland,CHE,0,0,0,0,429
2012,Rep. of Moldova,MDA,Switzerland,CHE,0,0,0,0,5
2012,Mali,MLI,Switzerland,CHE,0,0,0,0,5
2012,Mongolia,MNG,Switzerland,CHE,0,0,0,0,94
2012,Morocco,MAR,Switzerland,CHE,0,0,0,0,40
2012,Montenegro,MNE,Switzerland,CHE,0,0,0,0,34
2012,Nepal,NPL,Switzerland,CHE,0,0,0,0,12
2012,Niger,NER,Switzerland,CHE,0,0,0,0,12
2012,Nigeria,NGA,Switzerland,CHE,0,0,0,0,266
2012,Pakistan,PAK,Switzerland,CHE,0,0,0,0,84
2012,Romania,ROU,Switzerland,CHE,0,0,0,0,26
2012,South Africa,ZAF,Switzerland,CHE,0,0,0,0,5
2012,Russian Federation,RUS,Switzerland,CHE,0,0,0,0,177
2012,Rwanda,RWA,Switzerland,CHE,0,0,0,0,10
2012,Serbia and Kosovo: S/RES/1244 (1999),SRB,Switzerland,CHE,0,0,0,0,1577
2012,Senegal,SEN,Switzerland,CHE,0,0,0,0,22
2012,Sierra Leone,SLE,Switzerland,CHE,0,0,0,0,13
2012,Somalia,SOM,Switzerland,CHE,0,0,0,0,135
2012,Spain,ESP,Switzerland,CHE,0,0,0,0,5
2012,Sudan,SDN,Switzerland,CHE,0,0,0,0,20
2012,Suriname,SUR,Switzerland,CHE,0,0,0,0,10
2012,Sweden,SWE,Switzerland,CHE,0,0,0,0,5
2012,Switzerland,CHE,Switzerland,CHE,0,0,0,0,5
2012,Syrian Arab Rep.,SYR,Switzerland,CHE,0,0,0,0,293
2012,Togo,TGO,Switzerland,CHE,0,0,0,0,55
2012,Tunisia,TUN,Switzerland,CHE,0,0,0,0,114
2012,Turkey,TUR,Switzerland,CHE,0,0,0,0,322
2012,Ukraine,UKR,Switzerland,CHE,0,0,0,0,13
2012,United States of America,USA,Switzerland,CHE,0,0,0,0,5
2012,Uzbekistan,UZB,Switzerland,CHE,0,0,0,0,11
2012,Yemen,YEM,Switzerland,CHE,0,0,0,0,34
2012,Zimbabwe,ZWE,Switzerland,CHE,0,0,0,0,5
2012,Afghanistan,AFG,Ukraine,UKR,0,5,54,61,120
2012,Azerbaijan,AZE,Ukraine,UKR,5,0,0,0,5
2012,Cameroon,CMR,Ukraine,UKR,0,0,5,5,10
2012,Congo,COG,Ukraine,UKR,0,0,0,5,5
2012,Dem. Rep. of the Congo,COD,Ukraine,UKR,0,0,12,11,23
2012,Eritrea,ERI,Ukraine,UKR,0,0,0,5,5
2012,Ethiopia,ETH,Ukraine,UKR,0,0,0,5,5
2012,Palestinian,PSE,Ukraine,UKR,0,0,5,5,10
2012,Guinea,GIN,Ukraine,UKR,0,0,15,5,20
2012,Cote d'Ivoire,CIV,Ukraine,UKR,0,0,5,0,5
2012,India,IND,Ukraine,UKR,0,0,5,5,10
2012,Iran (Islamic Rep. of),IRN,Ukraine,UKR,0,0,0,5,5
2012,Iraq,IRQ,Ukraine,UKR,0,0,5,0,5
2012,Jordan,JOR,Ukraine,UKR,0,0,0,5,5
2012,Kyrgyzstan,KGZ,Ukraine,UKR,0,0,5,60,65
2012,Sri Lanka,LKA,Ukraine,UKR,0,0,0,5,5
2012,Nepal,NPL,Ukraine,UKR,0,0,5,0,5
2012,Nigeria,NGA,Ukraine,UKR,0,0,5,0,5
2012,Pakistan,PAK,Ukraine,UKR,0,0,0,11,11
2012,Russian Federation,RUS,Ukraine,UKR,0,0,0,5,5
2012,Somalia,SOM,Ukraine,UKR,0,23,5,28,56
2012,Sudan,SDN,Ukraine,UKR,0,0,0,5,5
2012,Syrian Arab Rep.,SYR,Ukraine,UKR,0,5,19,27,51
2012,Uzbekistan,UZB,Ukraine,UKR,0,5,0,5,10
2012,Stateless,XXA,Ukraine,UKR,0,0,0,5,5
2013,Cuba,CUB,Colombia,COL,0,0,14,0,14
2013,Venezuela (Bolivarian Republic of),VEN,Colombia,COL,0,0,5,0,5
2013,Colombia,COL,Costa Rica,CRI,0,0,110,0,110
2013,Cuba,CUB,Costa Rica,CRI,5,0,22,0,27
2013,Honduras,HND,Costa Rica,CRI,0,0,11,0,11
2013,Nepal,NPL,Costa Rica,CRI,0,0,10,0,10
2013,Nigeria,NGA,Costa Rica,CRI,5,0,0,0,5
2013,El Salvador,SLV,Costa Rica,CRI,5,0,16,0,21
2013,Venezuela (Bolivarian Republic of),VEN,Costa Rica,CRI,0,0,5,0,5
2013,Afghanistan,AFG,Cyprus,CYP,0,0,21,0,21
2013,Egypt,EGY,Cyprus,CYP,10,5,46,15,76
2013,Armenia,ARM,Cyprus,CYP,0,0,11,0,11
2013,Bangladesh,BGD,Cyprus,CYP,0,0,100,20,120
2013,Cameroon,CMR,Cyprus,CYP,0,0,10,0,10
2013,Dem. Rep. of the Congo,COD,Cyprus,CYP,0,0,14,0,14
2013,Palestinian,PSE,Cyprus,CYP,0,0,5,441,446
2013,Georgia,GEO,Cyprus,CYP,0,0,5,0,5
2013,Cote d'Ivoire,CIV,Cyprus,CYP,0,0,5,0,5
2013,India,IND,Cyprus,CYP,0,0,14,5,19
2013,Iran (Islamic Rep. of),IRN,Cyprus,CYP,0,10,38,21,69
2013,Iraq,IRQ,Cyprus,CYP,0,0,39,274,313
2013,Jordan,JOR,Cyprus,CYP,0,0,5,5,10
2013,Lebanon,LBN,Cyprus,CYP,0,0,14,0,14
2013,Sri Lanka,LKA,Cyprus,CYP,0,0,43,5,48
2013,Nepal,NPL,Cyprus,CYP,0,0,5,0,5
2013,Nigeria,NGA,Cyprus,CYP,0,0,5,0,5
2013,Pakistan,PAK,Cyprus,CYP,0,0,20,5,25
2013,Philippines,PHL,Cyprus,CYP,0,0,19,0,19
2013,Russian Federation,RUS,Cyprus,CYP,0,0,5,0,5
2013,Serbia and Kosovo: S/RES/1244 (1999),SRB,Cyprus,CYP,0,0,12,0,12
2013,Somalia,SOM,Cyprus,CYP,0,0,10,0,10
2013,Viet Nam,VNM,Cyprus,CYP,0,0,64,10,74
2013,Syrian Arab Rep.,SYR,Cyprus,CYP,0,55,5,43,103
2013,Turkey,TUR,Cyprus,CYP,0,5,30,0,35
2013,Ukraine,UKR,Cyprus,CYP,0,0,5,0,5
2013,Afghanistan,AFG,Denmark,DNK,31,100,253,0,384
2013,Albania,ALB,Denmark,DNK,0,0,10,0,10
2013,Algeria,DZA,Denmark,DNK,0,0,10,0,10
2013,Egypt,EGY,Denmark,DNK,0,0,5,0,5
2013,Armenia,ARM,Denmark,DNK,10,17,46,0,73
2013,Azerbaijan,AZE,Denmark,DNK,0,0,10,0,10
2013,Bangladesh,BGD,Denmark,DNK,0,0,48,0,48
2013,Belarus,BLR,Denmark,DNK,0,0,10,0,10
2013,China,CHN,Denmark,DNK,0,0,17,0,17
2013,Chile,CHL,Denmark,DNK,0,0,5,0,5
2013,Cameroon,CMR,Denmark,DNK,0,0,5,0,5
2013,Dem. Rep. of the Congo,COD,Denmark,DNK,5,0,12,0,17
2013,Eritrea,ERI,Denmark,DNK,0,11,0,0,11
2013,Gambia,GMB,Denmark,DNK,0,0,10,0,10
2013,Georgia,GEO,Denmark,DNK,0,0,10,0,10
2013,Ghana,GHA,Denmark,DNK,0,0,12,0,12
2013,Guinea-Bissau,GNB,Denmark,DNK,0,0,10,0,10
2013,Guinea,GIN,Denmark,DNK,0,0,5,0,5
2013,Cote d'Ivoire,CIV,Denmark,DNK,0,0,5,0,5
2013,India,IND,Denmark,DNK,0,0,13,0,13
2013,Iran (Islamic Rep. of),IRN,Denmark,DNK,108,17,55,0,180
2013,Iraq,IRQ,Denmark,DNK,5,0,69,0,74
2013,Kazakhstan,KAZ,Denmark,DNK,0,0,5,0,5
2013,Libya,LBY,Denmark,DNK,0,0,10,0,10
2013,Lebanon,LBN,Denmark,DNK,0,0,5,0,5
2013,Sri Lanka,LKA,Denmark,DNK,5,5,13,0,23
2013,Mali,MLI,Denmark,DNK,0,0,5,0,5
2013,Morocco,MAR,Denmark,DNK,0,0,10,0,10
2013,Myanmar,MMR,Denmark,DNK,5,0,16,0,21
2013,Nigeria,NGA,Denmark,DNK,0,0,48,0,48
2013,Pakistan,PAK,Denmark,DNK,5,0,31,0,36
2013,Russian Federation,RUS,Denmark,DNK,20,42,108,0,170
2013,Serbia and Kosovo: S/RES/1244 (1999),SRB,Denmark,DNK,0,0,5,0,5
2013,Somalia,SOM,Denmark,DNK,0,12,79,0,91
2013,Sudan,SDN,Denmark,DNK,0,5,10,0,15
2013,Slovakia,SVK,Denmark,DNK,0,0,5,0,5
2013,Syrian Arab Rep.,SYR,Denmark,DNK,41,44,37,0,122
2013,Tunisia,TUN,Denmark,DNK,0,0,16,0,16
2013,Turkey,TUR,Denmark,DNK,0,0,11,0,11
2013,Uganda,UGA,Denmark,DNK,5,0,18,0,23
2013,Ukraine,UKR,Denmark,DNK,5,0,0,0,5
2013,Uzbekistan,UZB,Denmark,DNK,0,0,5,0,5
2013,Stateless,XXA,Denmark,DNK,18,28,38,0,84
2013,Haiti,HTI,Dominican Rep.,DOM,0,0,27,0,27
2013,Afghanistan,AFG,France,FRA,38,152,78,10,278
2013,Albania,ALB,France,FRA,40,56,266,28,390
2013,Algeria,DZA,France,FRA,34,16,613,73,736
2013,Angola,AGO,France,FRA,65,10,515,18,608
2013,Egypt,EGY,France,FRA,102,5,153,5,265
2013,Armenia,ARM,France,FRA,116,109,2400,105,2730
2013,Azerbaijan,AZE,France,FRA,60,0,338,10,408
2013,Burundi,BDI,France,FRA,0,0,13,5,18
2013,Benin,BEN,France,FRA,0,0,10,0,10
2013,Bangladesh,BGD,France,FRA,451,42,2874,311,3678
2013,Bhutan,BTN,France,FRA,13,0,20,5,38
2013,Burkina Faso,BFA,France,FRA,5,0,13,5,23
2013,Belarus,BLR,France,FRA,12,0,30,0,42
2013,Bolivia (Plurinational State of),BOL,France,FRA,0,0,5,0,5
2013,Brazil,BRA,France,FRA,0,0,5,0,5
2013,Bosnia and Herzegovina,BIH,France,FRA,22,10,271,26,329
2013,Cambodia,KHM,France,FRA,0,0,15,0,15
2013,Central African Rep.,CAF,France,FRA,0,5,14,0,19
2013,Chad,TCD,France,FRA,17,0,105,10,132
2013,China,CHN,France,FRA,26,5,1724,176,1931
2013,Cameroon,CMR,France,FRA,22,5,131,5,163
2013,Congo,COG,France,FRA,30,12,436,28,506
2013,Dem. Rep. of the Congo,COD,France,FRA,472,67,3166,124,3829
2013,Comoros,COM,France,FRA,33,11,533,325,902
2013,Colombia,COL,France,FRA,0,5,42,10,57
2013,Cuba,CUB,France,FRA,5,0,0,0,5
2013,Djibouti,DJI,France,FRA,0,0,10,0,10
2013,Dominican Rep.,DOM,France,FRA,0,0,76,14,90
2013,Equatorial Guinea,GNQ,France,FRA,0,0,5,0,5
2013,Eritrea,ERI,France,FRA,133,10,191,20,354
2013,Ethiopia,ETH,France,FRA,20,0,40,0,60
2013,Gabon,GAB,France,FRA,5,0,5,0,10
2013,Gambia,GMB,France,FRA,5,0,46,0,51
2013,Palestinian,PSE,France,FRA,12,0,20,0,32
2013,Georgia,GEO,France,FRA,109,44,1370,64,1587
2013,Ghana,GHA,France,FRA,0,0,5,0,5
2013,Guinea-Bissau,GNB,France,FRA,0,0,82,5,87
2013,Guinea,GIN,France,FRA,195,58,1089,43,1385
2013,Haiti,HTI,France,FRA,31,19,1094,249,1393
2013,Croatia,HRV,France,FRA,0,0,5,0,5
2013,Cote d'Ivoire,CIV,France,FRA,63,16,819,42,940
2013,India,IND,France,FRA,5,5,16,0,26
2013,Iran (Islamic Rep. of),IRN,France,FRA,27,5,51,5,88
2013,Iraq,IRQ,France,FRA,5,10,19,5,39
2013,Israel,ISR,France,FRA,0,0,5,0,5
2013,Jamaica,JAM,France,FRA,0,0,5,0,5
2013,Jordan,JOR,France,FRA,0,0,0,5,5
2013,Kazakhstan,KAZ,France,FRA,18,5,68,0,91
2013,Kenya,KEN,France,FRA,0,0,14,0,14
2013,Kyrgyzstan,KGZ,France,FRA,14,5,28,5,52
2013,Dem. People's Rep. of Korea,PRK,France,FRA,5,0,19,0,24
2013,Lao People's Dem. Rep.,LAO,France,FRA,0,0,0,5,5
2013,Liberia,LBR,France,FRA,0,0,5,0,5
2013,Libya,LBY,France,FRA,10,0,36,0,46
2013,Lebanon,LBN,France,FRA,0,0,16,0,16
2013,Sri Lanka,LKA,France,FRA,551,26,2022,132,2731
2013,Madagascar,MDG,France,FRA,0,0,87,21,108
2013,Mauritania,MRT,France,FRA,134,10,1138,69,1351
2013,North Macedonia,MKD,France,FRA,0,14,299,29,342
2013,Rep. of Moldova,MDA,France,FRA,0,0,118,5,123
2013,Mali,MLI,France,FRA,17,12,263,23,315
2013,Mongolia,MNG,France,FRA,5,5,197,14,221
2013,Morocco,MAR,France,FRA,10,5,33,5,53
2013,Mozambique,MOZ,France,FRA,0,0,5,0,5
2013,Montenegro,MNE,France,FRA,5,5,119,14,143
2013,Mauritius,MUS,France,FRA,0,0,5,0,5
2013,Myanmar,MMR,France,FRA,36,0,158,5,199
2013,Nepal,NPL,France,FRA,26,0,129,10,165
2013,Niger,NER,France,FRA,0,0,5,0,5
2013,Nigeria,NGA,France,FRA,19,18,318,30,385
2013,Pakistan,PAK,France,FRA,94,21,1476,68,1659
2013,Peru,PER,France,FRA,5,0,52,0,57
2013,Romania,ROU,France,FRA,0,0,5,0,5
2013,South Africa,ZAF,France,FRA,0,5,0,0,5
2013,Russian Federation,RUS,France,FRA,537,81,1442,94,2154
2013,Rwanda,RWA,France,FRA,65,0,49,20,134
2013,Serbia and Kosovo: S/RES/1244 (1999),SRB,France,FRA,142,71,1430,139,1782
2013,Senegal,SEN,France,FRA,15,0,62,0,77
2013,Sierra Leone,SLE,France,FRA,0,0,53,5,58
2013,Somalia,SOM,France,FRA,31,117,168,19,335
2013,Viet Nam,VNM,France,FRA,0,0,14,0,14
2013,Sudan,SDN,France,FRA,104,71,399,35,609
2013,Suriname,SUR,France,FRA,0,0,20,0,20
2013,Syrian Arab Rep.,SYR,France,FRA,22,5,11,5,43
2013,Thailand,THA,France,FRA,0,0,16,0,16
2013,Tajikistan,TJK,France,FRA,0,0,5,0,5
2013,Togo,TGO,France,FRA,10,0,49,0,59
2013,Tunisia,TUN,France,FRA,5,0,56,5,66
2013,Turkey,TUR,France,FRA,191,12,1277,76,1556
2013,Uganda,UGA,France,FRA,0,0,10,0,10
2013,Ukraine,UKR,France,FRA,10,0,69,0,79
2013,Uzbekistan,UZB,France,FRA,5,5,18,0,28
2013,Venezuela (Bolivarian Republic of),VEN,France,FRA,0,0,5,0,5
2013,Western Sahara,ESH,France,FRA,13,0,36,0,49
2013,Yemen,YEM,France,FRA,0,0,5,0,5
2013,Afghanistan,AFG,Greece,GRC,49,142,161,147,499
2013,Albania,ALB,Greece,GRC,0,32,118,76,226
2013,Algeria,DZA,Greece,GRC,10,5,12,5,32
2013,Egypt,EGY,Greece,GRC,14,10,48,21,93
2013,Armenia,ARM,Greece,GRC,0,0,15,0,15
2013,Bangladesh,BGD,Greece,GRC,12,18,475,176,681
2013,Burkina Faso,BFA,Greece,GRC,0,5,0,0,5
2013,Belarus,BLR,Greece,GRC,0,5,0,0,5
2013,China,CHN,Greece,GRC,0,0,71,47,118
2013,Cameroon,CMR,Greece,GRC,0,5,15,0,20
2013,Congo,COG,Greece,GRC,0,0,5,0,5
2013,Dem. Rep. of the Congo,COD,Greece,GRC,5,0,0,0,5
2013,Comoros,COM,Greece,GRC,0,0,5,0,5
2013,Eritrea,ERI,Greece,GRC,5,0,0,0,5
2013,Ethiopia,ETH,Greece,GRC,17,22,5,0,44
2013,Gambia,GMB,Greece,GRC,0,0,27,0,27
2013,Georgia,GEO,Greece,GRC,5,44,276,359,684
2013,Ghana,GHA,Greece,GRC,0,11,68,5,84
2013,Guinea,GIN,Greece,GRC,0,5,19,5,29
2013,Cote d'Ivoire,CIV,Greece,GRC,5,0,20,0,25
2013,India,IND,Greece,GRC,0,5,20,5,30
2013,Indonesia,IDN,Greece,GRC,0,0,5,0,5
2013,Iran (Islamic Rep. of),IRN,Greece,GRC,21,28,0,19,68
2013,Iraq,IRQ,Greece,GRC,82,94,271,307,754
2013,Kenya,KEN,Greece,GRC,0,0,11,0,11
2013,Lebanon,LBN,Greece,GRC,0,0,0,5,5
2013,Sri Lanka,LKA,Greece,GRC,0,11,22,0,33
2013,Mauritania,MRT,Greece,GRC,5,0,0,0,5
2013,Rep. of Moldova,MDA,Greece,GRC,0,0,5,0,5
2013,Mali,MLI,Greece,GRC,0,0,5,0,5
2013,Morocco,MAR,Greece,GRC,5,0,26,0,31
2013,Nepal,NPL,Greece,GRC,0,0,5,0,5
2013,Nigeria,NGA,Greece,GRC,11,24,201,48,284
2013,Pakistan,PAK,Greece,GRC,17,33,988,484,1522
2013,Philippines,PHL,Greece,GRC,0,0,5,0,5
2013,Russian Federation,RUS,Greece,GRC,0,0,0,34,34
2013,Senegal,SEN,Greece,GRC,5,5,50,26,86
2013,Sierra Leone,SLE,Greece,GRC,0,0,5,0,5
2013,Somalia,SOM,Greece,GRC,5,21,10,5,41
2013,Viet Nam,VNM,Greece,GRC,0,0,5,0,5
2013,Sudan,SDN,Greece,GRC,18,5,0,5,28
2013,Syrian Arab Rep.,SYR,Greece,GRC,28,39,5,10,82
2013,United Rep. of Tanzania,TZA,Greece,GRC,0,0,5,0,5
2013,Tunisia,TUN,Greece,GRC,0,0,0,14,14
2013,Turkey,TUR,Greece,GRC,5,10,5,5,25
2013,Ukraine,UKR,Greece,GRC,0,5,0,0,5
2013,Croatia,HRV,Iceland,ISL,0,0,0,19,19
2013,North Macedonia,MKD,Iceland,ISL,0,5,0,0,5
2013,Afghanistan,AFG,Ireland,IRL,0,0,33,0,33
2013,Albania,ALB,Ireland,IRL,0,0,21,0,21
2013,Algeria,DZA,Ireland,IRL,0,0,21,0,21
2013,Egypt,EGY,Ireland,IRL,0,0,5,0,5
2013,Bangladesh,BGD,Ireland,IRL,0,0,10,0,10
2013,Belarus,BLR,Ireland,IRL,5,0,0,0,5
2013,China,CHN,Ireland,IRL,0,0,5,0,5
2013,Cameroon,CMR,Ireland,IRL,0,0,12,0,12
2013,Congo,COG,Ireland,IRL,0,0,5,0,5
2013,Dem. Rep. of the Congo,COD,Ireland,IRL,5,0,61,0,66
2013,Eritrea,ERI,Ireland,IRL,0,0,5,0,5
2013,Georgia,GEO,Ireland,IRL,0,0,14,0,14
2013,Ghana,GHA,Ireland,IRL,0,0,5,0,5
2013,Guinea,GIN,Ireland,IRL,0,0,5,0,5
2013,Cote d'Ivoire,CIV,Ireland,IRL,0,0,5,0,5
2013,Iran (Islamic Rep. of),IRN,Ireland,IRL,0,0,5,0,5
2013,Iraq,IRQ,Ireland,IRL,0,0,5,0,5
2013,Israel,ISR,Ireland,IRL,0,0,5,0,5
2013,Kuwait,KWT,Ireland,IRL,0,0,5,0,5
2013,Libya,LBY,Ireland,IRL,0,0,5,0,5
2013,Rep. of Moldova,MDA,Ireland,IRL,0,0,5,0,5
2013,Malawi,MWI,Ireland,IRL,0,0,16,0,16
2013,Morocco,MAR,Ireland,IRL,0,0,5,0,5
2013,Mauritius,MUS,Ireland,IRL,0,0,10,0,10
2013,Myanmar,MMR,Ireland,IRL,0,0,5,0,5
2013,Niger,NER,Ireland,IRL,0,0,5,0,5
2013,Nigeria,NGA,Ireland,IRL,5,0,93,5,103
2013,Pakistan,PAK,Ireland,IRL,10,0,62,5,77
2013,South Africa,ZAF,Ireland,IRL,0,0,5,0,5
2013,Rwanda,RWA,Ireland,IRL,0,0,5,0,5
2013,Serbia and Kosovo: S/RES/1244 (1999),SRB,Ireland,IRL,0,0,5,0,5
2013,Sierra Leone,SLE,Ireland,IRL,0,0,5,0,5
2013,Somalia,SOM,Ireland,IRL,5,0,5,0,10
2013,Viet Nam,VNM,Ireland,IRL,0,0,5,0,5
2013,Sudan,SDN,Ireland,IRL,0,0,11,0,11
2013,Syrian Arab Rep.,SYR,Ireland,IRL,0,0,5,0,5
2013,Togo,TGO,Ireland,IRL,0,0,5,0,5
2013,Ukraine,UKR,Ireland,IRL,0,0,5,0,5
2013,Zimbabwe,ZWE,Ireland,IRL,5,0,30,0,35
2013,Stateless,XXA,Ireland,IRL,0,0,5,0,5
2013,Burundi,BDI,Malawi,MWI,0,0,0,182,182
2013,Dem. Rep. of the Congo,COD,Malawi,MWI,0,0,0,5,5
2013,Rwanda,RWA,Malawi,MWI,0,0,0,223,223
2013,Dem. Rep. of the Congo,COD,Mozambique,MOZ,5,0,0,0,5
2013,Egypt,EGY,Malta,MLT,0,0,5,0,5
2013,Eritrea,ERI,Malta,MLT,0,0,13,0,13
2013,Ethiopia,ETH,Malta,MLT,0,0,5,0,5
2013,Palestinian,PSE,Malta,MLT,0,0,5,0,5
2013,Ghana,GHA,Malta,MLT,0,0,41,0,41
2013,Guinea,GIN,Malta,MLT,0,0,5,0,5
2013,India,IND,Malta,MLT,0,0,5,0,5
2013,Libya,LBY,Malta,MLT,0,0,5,0,5
2013,Mali,MLI,Malta,MLT,0,0,5,0,5
2013,Morocco,MAR,Malta,MLT,0,0,5,0,5
2013,Niger,NER,Malta,MLT,0,0,5,0,5
2013,Nigeria,NGA,Malta,MLT,0,0,51,0,51
2013,Pakistan,PAK,Malta,MLT,0,0,22,0,22
2013,Senegal,SEN,Malta,MLT,0,0,5,0,5
2013,Somalia,SOM,Malta,MLT,0,0,20,0,20
2013,Syrian Arab Rep.,SYR,Malta,MLT,5,0,0,0,5
2013,Togo,TGO,Malta,MLT,0,0,5,0,5
2013,Cote d'Ivoire,CIV,Niger,NER,16,0,10,0,26
2013,Afghanistan,AFG,Norway,NOR,38,110,1091,34,1273
2013,Albania,ALB,Norway,NOR,0,5,114,5,124
2013,Algeria,DZA,Norway,NOR,0,0,80,5,85
2013,Angola,AGO,Norway,NOR,5,0,15,0,20
2013,Egypt,EGY,Norway,NOR,0,0,34,0,34
2013,Armenia,ARM,Norway,NOR,0,0,37,5,42
2013,Azerbaijan,AZE,Norway,NOR,0,0,65,0,65
2013,Burundi,BDI,Norway,NOR,0,15,43,0,58
2013,Benin,BEN,Norway,NOR,0,0,5,0,5
2013,Bangladesh,BGD,Norway,NOR,0,0,199,22,221
2013,Bhutan,BTN,Norway,NOR,0,0,5,0,5
2013,Burkina Faso,BFA,Norway,NOR,0,0,10,0,10
2013,Belarus,BLR,Norway,NOR,0,0,40,5,45
2013,Brazil,BRA,Norway,NOR,0,0,5,0,5
2013,Bosnia and Herzegovina,BIH,Norway,NOR,0,0,30,0,30
2013,Bulgaria,BGR,Norway,NOR,0,0,5,0,5
2013,Chad,TCD,Norway,NOR,0,0,14,0,14
2013,China,CHN,Norway,NOR,0,0,34,0,34
2013,Cameroon,CMR,Norway,NOR,0,0,22,0,22
2013,Congo,COG,Norway,NOR,0,0,5,0,5
2013,Dem. Rep. of the Congo,COD,Norway,NOR,0,22,97,5,124
2013,Djibouti,DJI,Norway,NOR,0,0,10,0,10
2013,Eritrea,ERI,Norway,NOR,64,32,730,63,889
2013,Ethiopia,ETH,Norway,NOR,67,58,487,30,642
2013,Gabon,GAB,Norway,NOR,0,0,5,0,5
2013,Gambia,GMB,Norway,NOR,0,0,59,5,64
2013,Georgia,GEO,Norway,NOR,0,0,87,5,92
2013,Germany,DEU,Norway,NOR,0,0,5,0,5
2013,Ghana,GHA,Norway,NOR,0,0,43,0,43
2013,Guinea-Bissau,GNB,Norway,NOR,0,0,17,0,17
2013,Greece,GRC,Norway,NOR,0,0,5,0,5
2013,Guatemala,GTM,Norway,NOR,0,0,5,0,5
2013,Guinea,GIN,Norway,NOR,0,0,54,0,54
2013,Croatia,HRV,Norway,NOR,0,0,5,0,5
2013,Cote d'Ivoire,CIV,Norway,NOR,0,0,57,0,57
2013,India,IND,Norway,NOR,0,0,37,5,42
2013,Iran (Islamic Rep. of),IRN,Norway,NOR,70,88,833,29,1020
2013,Iraq,IRQ,Norway,NOR,18,35,579,48,680
2013,Israel,ISR,Norway,NOR,0,11,0,0,11
2013,Italy,ITA,Norway,NOR,0,0,5,0,5
2013,Jordan,JOR,Norway,NOR,0,0,37,0,37
2013,Kazakhstan,KAZ,Norway,NOR,0,0,24,0,24
2013,Kenya,KEN,Norway,NOR,0,0,16,0,16
2013,Kyrgyzstan,KGZ,Norway,NOR,0,10,23,10,43
2013,Rep. of Korea,KOR,Norway,NOR,0,5,0,0,5
2013,Liberia,LBR,Norway,NOR,0,5,32,0,37
2013,Libya,LBY,Norway,NOR,5,0,81,5,91
2013,Lebanon,LBN,Norway,NOR,0,5,31,0,36
2013,Sri Lanka,LKA,Norway,NOR,0,30,85,0,115
2013,Mauritania,MRT,Norway,NOR,0,0,10,0,10
2013,North Macedonia,MKD,Norway,NOR,0,0,12,0,12
2013,Rep. of Moldova,MDA,Norway,NOR,0,0,5,0,5
2013,Mexico,MEX,Norway,NOR,0,0,5,0,5
2013,Mali,MLI,Norway,NOR,0,0,28,5,33
2013,Malawi,MWI,Norway,NOR,0,0,5,0,5
2013,Mongolia,MNG,Norway,NOR,0,0,5,5,10
2013,Morocco,MAR,Norway,NOR,0,0,128,5,133
2013,Montenegro,MNE,Norway,NOR,0,0,5,0,5
2013,Myanmar,MMR,Norway,NOR,0,0,14,0,14
2013,Nepal,NPL,Norway,NOR,0,0,15,0,15
2013,Niger,NER,Norway,NOR,0,0,17,0,17
2013,Nigeria,NGA,Norway,NOR,5,18,565,10,598
2013,Norway,NOR,Norway,NOR,0,0,5,0,5
2013,Pakistan,PAK,Norway,NOR,0,5,133,12,150
2013,Peru,PER,Norway,NOR,0,0,5,0,5
2013,Poland,POL,Norway,NOR,0,0,5,0,5
2013,Romania,ROU,Norway,NOR,0,0,5,0,5
2013,South Africa,ZAF,Norway,NOR,0,0,5,0,5
2013,Russian Federation,RUS,Norway,NOR,64,69,444,75,652
2013,Rwanda,RWA,Norway,NOR,0,5,21,0,26
2013,El Salvador,SLV,Norway,NOR,0,0,17,0,17
2013,Serbia and Kosovo: S/RES/1244 (1999),SRB,Norway,NOR,0,5,182,27,214
2013,Senegal,SEN,Norway,NOR,0,0,29,0,29
2013,Sierra Leone,SLE,Norway,NOR,0,0,28,0,28
2013,Somalia,SOM,Norway,NOR,0,27,1182,81,1290
2013,Viet Nam,VNM,Norway,NOR,0,5,13,0,18
2013,Sudan,SDN,Norway,NOR,5,0,222,5,232
2013,South Sudan,SSD,Norway,NOR,0,0,5,0,5
2013,Syrian Arab Rep.,SYR,Norway,NOR,0,56,128,5,189
2013,United Rep. of Tanzania,TZA,Norway,NOR,0,0,10,0,10
2013,Thailand,THA,Norway,NOR,0,0,5,0,5
2013,Tajikistan,TJK,Norway,NOR,0,5,0,0,5
2013,Turkmenistan,TKM,Norway,NOR,0,0,5,0,5
2013,Togo,TGO,Norway,NOR,0,0,5,0,5
2013,Tunisia,TUN,Norway,NOR,0,0,49,5,54
2013,Turkey,TUR,Norway,NOR,0,0,82,10,92
2013,Uganda,UGA,Norway,NOR,0,10,39,5,54
2013,Ukraine,UKR,Norway,NOR,0,0,37,0,37
2013,United States of America,USA,Norway,NOR,0,0,5,0,5
2013,Uzbekistan,UZB,Norway,NOR,0,5,118,46,169
2013,Venezuela (Bolivarian Republic of),VEN,Norway,NOR,0,0,5,0,5
2013,Yemen,YEM,Norway,NOR,0,0,129,0,129
2013,Zimbabwe,ZWE,Norway,NOR,5,0,13,0,18
2013,Stateless,XXA,Norway,NOR,0,26,420,10,456
2013,Afghanistan,AFG,Poland,POL,0,0,12,0,12
2013,Armenia,ARM,Poland,POL,0,0,50,5,55
2013,Bangladesh,BGD,Poland,POL,0,0,5,0,5
2013,Belarus,BLR,Poland,POL,0,0,12,0,12
2013,Georgia,GEO,Poland,POL,0,0,177,25,202
2013,Iran (Islamic Rep. of),IRN,Poland,POL,0,0,5,0,5
2013,Iraq,IRQ,Poland,POL,0,0,5,0,5
2013,Kazakhstan,KAZ,Poland,POL,0,0,12,0,12
2013,Kyrgyzstan,KGZ,Poland,POL,0,0,13,0,13
2013,Nigeria,NGA,Poland,POL,0,0,5,0,5
2013,Pakistan,PAK,Poland,POL,0,0,11,0,11
2013,Russian Federation,RUS,Poland,POL,0,35,562,133,730
2013,Viet Nam,VNM,Poland,POL,0,0,10,0,10
2013,Syrian Arab Rep.,SYR,Poland,POL,5,0,0,0,5
2013,Turkey,TUR,Poland,POL,0,0,5,0,5
2013,Ukraine,UKR,Poland,POL,0,0,11,0,11
2013,Uzbekistan,UZB,Poland,POL,0,0,5,0,5
2013,Angola,AGO,South Africa,ZAF,0,0,36,0,36
2013,Egypt,EGY,South Africa,ZAF,0,0,5,5,10
2013,Burundi,BDI,South Africa,ZAF,0,0,25,5,30
2013,Bangladesh,BGD,South Africa,ZAF,0,0,122,163,285
2013,Cameroon,CMR,South Africa,ZAF,0,0,5,10,15
2013,Dem. Rep. of the Congo,COD,South Africa,ZAF,40,0,226,106,372
2013,Eritrea,ERI,South Africa,ZAF,0,0,10,5,15
2013,Ethiopia,ETH,South Africa,ZAF,5,0,554,201,760
2013,Ghana,GHA,South Africa,ZAF,0,0,11,0,11
2013,India,IND,South Africa,ZAF,0,0,45,65,110
2013,Iran (Islamic Rep. of),IRN,South Africa,ZAF,0,0,5,0,5
2013,Kenya,KEN,South Africa,ZAF,0,0,14,0,14
2013,Malawi,MWI,South Africa,ZAF,0,0,0,5,5
2013,Nepal,NPL,South Africa,ZAF,0,0,0,5,5
2013,Niger,NER,South Africa,ZAF,0,0,0,5,5
2013,Nigeria,NGA,South Africa,ZAF,0,0,37,56,93
2013,Pakistan,PAK,South Africa,ZAF,0,0,121,104,225
2013,Rwanda,RWA,South Africa,ZAF,0,0,0,5,5
2013,Senegal,SEN,South Africa,ZAF,0,0,11,0,11
2013,Somalia,SOM,South Africa,ZAF,5,0,41,13,59
2013,United Rep. of Tanzania,TZA,South Africa,ZAF,0,0,5,0,5
2013,Uganda,UGA,South Africa,ZAF,0,0,28,17,45
2013,Zimbabwe,ZWE,South Africa,ZAF,53,0,1302,773,2128
2013,Afghanistan,AFG,Sweden,SWE,89,160,1133,136,1518
2013,Albania,ALB,Sweden,SWE,0,22,761,82,865
2013,Algeria,DZA,Sweden,SWE,0,0,66,11,77
2013,Angola,AGO,Sweden,SWE,0,0,5,0,5
2013,Egypt,EGY,Sweden,SWE,5,0,103,12,120
2013,Armenia,ARM,Sweden,SWE,0,5,190,25,220
2013,Azerbaijan,AZE,Sweden,SWE,0,13,133,28,174
2013,Burundi,BDI,Sweden,SWE,0,0,14,0,14
2013,Bangladesh,BGD,Sweden,SWE,5,5,85,10,105
2013,Burkina Faso,BFA,Sweden,SWE,0,0,5,0,5
2013,Belarus,BLR,Sweden,SWE,0,0,149,27,176
2013,Bolivia (Plurinational State of),BOL,Sweden,SWE,0,5,37,0,42
2013,Bosnia and Herzegovina,BIH,Sweden,SWE,0,14,306,54,374
2013,Chad,TCD,Sweden,SWE,0,0,5,0,5
2013,China,CHN,Sweden,SWE,5,0,14,5,24
2013,Chile,CHL,Sweden,SWE,0,0,12,0,12
2013,Cameroon,CMR,Sweden,SWE,5,0,15,0,20
2013,Congo,COG,Sweden,SWE,0,0,11,0,11
2013,Dem. Rep. of the Congo,COD,Sweden,SWE,5,14,49,5,73
2013,Colombia,COL,Sweden,SWE,0,0,10,0,10
2013,Cuba,CUB,Sweden,SWE,5,0,36,0,41
2013,Djibouti,DJI,Sweden,SWE,0,0,12,0,12
2013,Ecuador,ECU,Sweden,SWE,0,0,14,0,14
2013,Eritrea,ERI,Sweden,SWE,10,36,183,23,252
2013,Ethiopia,ETH,Sweden,SWE,15,0,147,16,178
2013,France,FRA,Sweden,SWE,0,0,0,5,5
2013,Gambia,GMB,Sweden,SWE,10,5,47,5,67
2013,Georgia,GEO,Sweden,SWE,0,5,156,22,183
2013,Ghana,GHA,Sweden,SWE,0,0,34,0,34
2013,Guinea-Bissau,GNB,Sweden,SWE,0,0,5,0,5
2013,Greece,GRC,Sweden,SWE,0,0,0,13,13
2013,Guinea,GIN,Sweden,SWE,0,0,28,5,33
2013,Honduras,HND,Sweden,SWE,0,0,5,0,5
2013,Hungary,HUN,Sweden,SWE,0,0,5,0,5
2013,Cote d'Ivoire,CIV,Sweden,SWE,0,0,21,0,21
2013,India,IND,Sweden,SWE,0,5,34,0,39
2013,Iran (Islamic Rep. of),IRN,Sweden,SWE,219,17,605,106,947
2013,Iraq,IRQ,Sweden,SWE,56,24,598,93,771
2013,Israel,ISR,Sweden,SWE,0,0,5,5,10
2013,Italy,ITA,Sweden,SWE,0,0,5,0,5
2013,Jordan,JOR,Sweden,SWE,0,5,124,11,140
2013,Japan,JPN,Sweden,SWE,0,0,5,0,5
2013,Kazakhstan,KAZ,Sweden,SWE,0,5,234,34,273
2013,Kenya,KEN,Sweden,SWE,0,0,56,0,56
2013,Kyrgyzstan,KGZ,Sweden,SWE,10,0,220,26,256
2013,Rep. of Korea,KOR,Sweden,SWE,0,0,5,0,5
2013,Kuwait,KWT,Sweden,SWE,5,0,12,0,17
2013,Liberia,LBR,Sweden,SWE,0,0,5,0,5
2013,Libya,LBY,Sweden,SWE,0,0,110,10,120
2013,Lebanon,LBN,Sweden,SWE,5,15,241,20,281
2013,Sri Lanka,LKA,Sweden,SWE,0,0,21,0,21
2013,Latvia,LVA,Sweden,SWE,0,0,5,0,5
2013,Mauritania,MRT,Sweden,SWE,0,0,5,0,5
2013,North Macedonia,MKD,Sweden,SWE,0,0,299,17,316
2013,Rep. of Moldova,MDA,Sweden,SWE,0,0,10,0,10
2013,Mexico,MEX,Sweden,SWE,0,0,12,0,12
2013,Mali,MLI,Sweden,SWE,0,0,12,0,12
2013,Mongolia,MNG,Sweden,SWE,0,0,274,24,298
2013,Morocco,MAR,Sweden,SWE,0,5,143,23,171
2013,Montenegro,MNE,Sweden,SWE,0,0,48,0,48
2013,Nepal,NPL,Sweden,SWE,0,0,5,0,5
2013,Niger,NER,Sweden,SWE,0,0,5,0,5
2013,Nicaragua,NIC,Sweden,SWE,0,0,11,5,16
2013,Nigeria,NGA,Sweden,SWE,5,0,289,16,310
2013,Pakistan,PAK,Sweden,SWE,5,5,173,17,200
2013,Philippines,PHL,Sweden,SWE,0,0,0,5,5
2013,Poland,POL,Sweden,SWE,0,0,0,5,5
2013,Romania,ROU,Sweden,SWE,0,0,12,0,12
2013,Russian Federation,RUS,Sweden,SWE,5,12,394,41,452
2013,Rwanda,RWA,Sweden,SWE,0,0,11,0,11
2013,El Salvador,SLV,Sweden,SWE,0,5,39,0,44
2013,Serbia and Kosovo: S/RES/1244 (1999),SRB,Sweden,SWE,0,47,1488,206,1741
2013,Senegal,SEN,Sweden,SWE,0,0,16,5,21
2013,Sierra Leone,SLE,Sweden,SWE,0,0,12,0,12
2013,Somalia,SOM,Sweden,SWE,23,41,699,84,847
2013,Viet Nam,VNM,Sweden,SWE,0,0,19,5,24
2013,Sudan,SDN,Sweden,SWE,5,5,50,5,65
2013,Syrian Arab Rep.,SYR,Sweden,SWE,71,478,811,1107,2467
2013,United Rep. of Tanzania,TZA,Sweden,SWE,0,0,11,0,11
2013,Thailand,THA,Sweden,SWE,0,0,10,0,10
2013,Tajikistan,TJK,Sweden,SWE,0,0,22,0,22
2013,Turkmenistan,TKM,Sweden,SWE,0,0,5,5,10
2013,Tunisia,TUN,Sweden,SWE,0,5,48,5,58
2013,Turkey,TUR,Sweden,SWE,5,0,82,28,115
2013,Uganda,UGA,Sweden,SWE,10,5,53,5,73
2013,Ukraine,UKR,Sweden,SWE,0,0,78,10,88
2013,United States of America,USA,Sweden,SWE,0,0,5,0,5
2013,Uzbekistan,UZB,Sweden,SWE,10,13,228,17,268
2013,Venezuela (Bolivarian Republic of),VEN,Sweden,SWE,0,5,5,0,10
2013,Yemen,YEM,Sweden,SWE,11,5,154,20,190
2013,Stateless,XXA,Sweden,SWE,48,148,634,295,1125
2013,Afghanistan,AFG,Switzerland,CHE,0,59,168,101,328
2013,Albania,ALB,Switzerland,CHE,0,0,41,30,71
2013,Algeria,DZA,Switzerland,CHE,0,0,67,38,105
2013,Angola,AGO,Switzerland,CHE,0,0,15,17,32
2013,Egypt,EGY,Switzerland,CHE,0,0,35,10,45
2013,Armenia,ARM,Switzerland,CHE,0,16,82,34,132
2013,Azerbaijan,AZE,Switzerland,CHE,0,5,0,0,5
2013,Benin,BEN,Switzerland,CHE,0,0,5,10,15
2013,Bangladesh,BGD,Switzerland,CHE,0,0,26,5,31
2013,Burkina Faso,BFA,Switzerland,CHE,0,0,5,5,10
2013,Belarus,BLR,Switzerland,CHE,0,5,15,5,25
2013,Bosnia and Herzegovina,BIH,Switzerland,CHE,0,26,91,79,196
2013,China,CHN,Switzerland,CHE,0,5,27,12,44
2013,Cameroon,CMR,Switzerland,CHE,0,5,18,13,36
2013,Congo,COG,Switzerland,CHE,0,0,5,0,5
2013,Dem. Rep. of the Congo,COD,Switzerland,CHE,0,5,78,48,131
2013,Colombia,COL,Switzerland,CHE,0,5,27,34,66
2013,Cuba,CUB,Switzerland,CHE,0,0,5,0,5
2013,Eritrea,ERI,Switzerland,CHE,0,63,396,155,614
2013,Ethiopia,ETH,Switzerland,CHE,0,5,74,37,116
2013,France,FRA,Switzerland,CHE,0,0,5,0,5
2013,Gambia,GMB,Switzerland,CHE,0,0,29,11,40
2013,Georgia,GEO,Switzerland,CHE,0,0,65,22,87
2013,Ghana,GHA,Switzerland,CHE,0,0,13,10,23
2013,Guinea-Bissau,GNB,Switzerland,CHE,0,0,22,17,39
2013,Guinea,GIN,Switzerland,CHE,0,5,34,16,55
2013,Haiti,HTI,Switzerland,CHE,0,0,5,0,5
2013,Hungary,HUN,Switzerland,CHE,0,0,0,5,5
2013,Cote d'Ivoire,CIV,Switzerland,CHE,0,0,18,10,28
2013,India,IND,Switzerland,CHE,0,0,0,14,14
2013,Iran (Islamic Rep. of),IRN,Switzerland,CHE,0,18,90,34,142
2013,Iraq,IRQ,Switzerland,CHE,0,10,62,34,106
2013,Italy,ITA,Switzerland,CHE,0,0,5,0,5
2013,Jordan,JOR,Switzerland,CHE,0,0,5,5,10
2013,Kazakhstan,KAZ,Switzerland,CHE,0,0,14,0,14
2013,Kenya,KEN,Switzerland,CHE,0,0,0,5,5
2013,Kyrgyzstan,KGZ,Switzerland,CHE,0,5,14,0,19
2013,Liberia,LBR,Switzerland,CHE,0,0,5,0,5
2013,Libya,LBY,Switzerland,CHE,0,5,16,15,36
2013,Lebanon,LBN,Switzerland,CHE,0,0,17,0,17
2013,Sri Lanka,LKA,Switzerland,CHE,0,116,425,380,921
2013,Mauritania,MRT,Switzerland,CHE,0,0,5,0,5
2013,North Macedonia,MKD,Switzerland,CHE,0,0,77,87,164
2013,Rep. of Moldova,MDA,Switzerland,CHE,0,5,0,0,5
2013,Mali,MLI,Switzerland,CHE,0,0,5,13,18
2013,Mongolia,MNG,Switzerland,CHE,0,0,48,15,63
2013,Morocco,MAR,Switzerland,CHE,0,0,68,27,95
2013,Montenegro,MNE,Switzerland,CHE,0,0,42,5,47
2013,Nepal,NPL,Switzerland,CHE,0,0,17,0,17
2013,Niger,NER,Switzerland,CHE,0,0,5,5,10
2013,Nigeria,NGA,Switzerland,CHE,0,0,191,94,285
2013,Pakistan,PAK,Switzerland,CHE,0,0,51,47,98
2013,Poland,POL,Switzerland,CHE,0,0,5,5,10
2013,South Africa,ZAF,Switzerland,CHE,0,0,5,0,5
2013,Russian Federation,RUS,Switzerland,CHE,0,23,203,35,261
2013,Rwanda,RWA,Switzerland,CHE,0,0,5,0,5
2013,Serbia and Kosovo: S/RES/1244 (1999),SRB,Switzerland,CHE,0,59,570,361,990
2013,Senegal,SEN,Switzerland,CHE,0,0,36,15,51
2013,Somalia,SOM,Switzerland,CHE,0,30,69,58,157
2013,Spain,ESP,Switzerland,CHE,0,0,5,0,5
2013,Viet Nam,VNM,Switzerland,CHE,0,0,5,0,5
2013,Sudan,SDN,Switzerland,CHE,0,11,0,0,11
2013,Syrian Arab Rep.,SYR,Switzerland,CHE,0,34,140,86,260
2013,Togo,TGO,Switzerland,CHE,0,5,26,28,59
2013,Tunisia,TUN,Switzerland,CHE,0,5,84,31,120
2013,Turkey,TUR,Switzerland,CHE,0,31,200,110,341
2013,Uganda,UGA,Switzerland,CHE,0,0,5,0,5
2013,Ukraine,UKR,Switzerland,CHE,0,10,12,0,22
2013,Uzbekistan,UZB,Switzerland,CHE,0,0,0,5,5
2013,Venezuela (Bolivarian Republic of),VEN,Switzerland,CHE,0,0,0,5,5
2013,Western Sahara,ESH,Switzerland,CHE,0,0,5,0,5
2013,Yemen,YEM,Switzerland,CHE,0,5,5,5,15
2013,Afghanistan,AFG,Ukraine,UKR,10,0,79,5,94
2013,Azerbaijan,AZE,Ukraine,UKR,5,0,0,0,5
2013,Bangladesh,BGD,Ukraine,UKR,0,0,5,0,5
2013,Belarus,BLR,Ukraine,UKR,5,0,0,0,5
2013,Cameroon,CMR,Ukraine,UKR,0,0,10,0,10
2013,Congo,COG,Ukraine,UKR,0,0,5,0,5
2013,Dem. Rep. of the Congo,COD,Ukraine,UKR,0,0,12,0,12
2013,Palestinian,PSE,Ukraine,UKR,5,0,5,0,10
2013,Georgia,GEO,Ukraine,UKR,0,0,5,0,5
2013,Guinea,GIN,Ukraine,UKR,0,0,5,0,5
2013,Cote d'Ivoire,CIV,Ukraine,UKR,5,0,0,0,5
2013,Iran (Islamic Rep. of),IRN,Ukraine,UKR,13,0,15,0,28
2013,Iraq,IRQ,Ukraine,UKR,5,0,0,0,5
2013,Kyrgyzstan,KGZ,Ukraine,UKR,0,0,0,5,5
2013,Lebanon,LBN,Ukraine,UKR,0,0,5,0,5
2013,Sri Lanka,LKA,Ukraine,UKR,0,0,5,0,5
2013,Pakistan,PAK,Ukraine,UKR,0,0,14,0,14
2013,Russian Federation,RUS,Ukraine,UKR,5,0,14,5,24
2013,Somalia,SOM,Ukraine,UKR,0,0,5,0,5
2013,Sudan,SDN,Ukraine,UKR,0,0,5,0,5
2013,Syrian Arab Rep.,SYR,Ukraine,UKR,61,0,32,5,98
2013,Uzbekistan,UZB,Ukraine,UKR,10,0,11,5,26
2014,Dem. Rep. of the Congo,COD,Burundi,BDI,1540,0,1500,1137,4177
2014,Rwanda,RWA,Burundi,BDI,0,0,5,22,27
2014,Afghanistan,AFG,Canada,CAN,5,0,14,0,19
2014,Albania,ALB,Canada,CAN,0,0,41,0,41
2014,Algeria,DZA,Canada,CAN,0,0,34,0,34
2014,Angola,AGO,Canada,CAN,0,0,5,0,5
2014,Antigua and Barbuda,ATG,Canada,CAN,0,0,5,0,5
2014,Egypt,EGY,Canada,CAN,0,0,21,0,21
2014,Burundi,BDI,Canada,CAN,0,0,5,0,5
2014,Benin,BEN,Canada,CAN,0,0,5,0,5
2014,Bangladesh,BGD,Canada,CAN,0,0,34,0,34
2014,Belarus,BLR,Canada,CAN,5,0,0,0,5
2014,Bosnia and Herzegovina,BIH,Canada,CAN,0,0,5,0,5
2014,Cambodia,KHM,Canada,CAN,0,0,11,0,11
2014,China,CHN,Canada,CAN,14,0,205,5,224
2014,Cameroon,CMR,Canada,CAN,5,0,28,0,33
2014,Congo,COG,Canada,CAN,0,0,25,0,25
2014,Dem. Rep. of the Congo,COD,Canada,CAN,0,0,23,0,23
2014,Colombia,COL,Canada,CAN,0,0,35,5,40
2014,Cuba,CUB,Canada,CAN,5,0,22,0,27
2014,Dominican Rep.,DOM,Canada,CAN,0,0,5,0,5
2014,Eritrea,ERI,Canada,CAN,0,0,13,0,13
2014,Ethiopia,ETH,Canada,CAN,0,0,24,0,24
2014,Palestinian,PSE,Canada,CAN,5,0,0,0,5
2014,Georgia,GEO,Canada,CAN,0,0,10,0,10
2014,Ghana,GHA,Canada,CAN,0,0,16,0,16
2014,Guinea-Bissau,GNB,Canada,CAN,0,0,5,0,5
2014,Grenada,GRD,Canada,CAN,0,0,10,0,10
2014,Guatemala,GTM,Canada,CAN,0,0,10,0,10
2014,Guinea,GIN,Canada,CAN,0,0,19,0,19
2014,Guyana,GUY,Canada,CAN,0,0,13,0,13
2014,Haiti,HTI,Canada,CAN,5,0,36,0,41
2014,Honduras,HND,Canada,CAN,0,0,16,0,16
2014,Croatia,HRV,Canada,CAN,0,0,5,0,5
2014,Cote d'Ivoire,CIV,Canada,CAN,0,0,5,0,5
2014,India,IND,Canada,CAN,0,0,92,0,92
2014,Indonesia,IDN,Canada,CAN,0,0,5,0,5
2014,Iran (Islamic Rep. of),IRN,Canada,CAN,0,0,30,0,30
2014,Iraq,IRQ,Canada,CAN,0,0,17,5,22
2014,Italy,ITA,Canada,CAN,0,0,5,0,5
2014,Jamaica,JAM,Canada,CAN,5,0,42,0,47
2014,Jordan,JOR,Canada,CAN,0,0,10,0,10
2014,Kenya,KEN,Canada,CAN,0,0,10,0,10
2014,Dem. People's Rep. of Korea,PRK,Canada,CAN,0,0,5,0,5
2014,Lao People's Dem. Rep.,LAO,Canada,CAN,0,0,5,0,5
2014,Libya,LBY,Canada,CAN,0,0,5,0,5
2014,Saint Lucia,LCA,Canada,CAN,0,0,18,0,18
2014,Lebanon,LBN,Canada,CAN,0,0,44,5,49
2014,Sri Lanka,LKA,Canada,CAN,0,0,17,0,17
2014,Mauritania,MRT,Canada,CAN,0,0,5,0,5
2014,Mexico,MEX,Canada,CAN,0,0,11,0,11
2014,Mali,MLI,Canada,CAN,0,0,5,0,5
2014,Morocco,MAR,Canada,CAN,0,0,5,0,5
2014,Namibia,NAM,Canada,CAN,0,0,5,0,5
2014,Nigeria,NGA,Canada,CAN,5,0,171,0,176
2014,Pakistan,PAK,Canada,CAN,10,0,54,5,69
2014,Peru,PER,Canada,CAN,0,0,5,0,5
2014,Philippines,PHL,Canada,CAN,0,0,10,0,10
2014,Portugal,PRT,Canada,CAN,0,0,5,0,5
2014,Romania,ROU,Canada,CAN,0,0,5,0,5
2014,South Africa,ZAF,Canada,CAN,0,0,5,0,5
2014,Russian Federation,RUS,Canada,CAN,0,0,5,0,5
2014,Rwanda,RWA,Canada,CAN,0,0,5,0,5
2014,El Salvador,SLV,Canada,CAN,0,0,14,0,14
2014,Serbia and Kosovo: S/RES/1244 (1999),SRB,Canada,CAN,0,0,21,0,21
2014,Senegal,SEN,Canada,CAN,0,0,10,0,10
2014,Somalia,SOM,Canada,CAN,0,0,34,0,34
2014,Viet Nam,VNM,Canada,CAN,0,0,5,0,5
2014,Saint Kitts and Nevis,KNA,Canada,CAN,0,0,5,0,5
2014,Sudan,SDN,Canada,CAN,0,0,5,0,5
2014,Syrian Arab Rep.,SYR,Canada,CAN,0,0,12,0,12
2014,United Rep. of Tanzania,TZA,Canada,CAN,0,0,5,0,5
2014,Trinidad and Tobago,TTO,Canada,CAN,0,0,5,5,10
2014,Tunisia,TUN,Canada,CAN,0,0,10,0,10
2014,Turkey,TUR,Canada,CAN,0,0,23,0,23
2014,Uganda,UGA,Canada,CAN,0,0,5,0,5
2014,Ukraine,UKR,Canada,CAN,0,0,17,0,17
2014,United States of America,USA,Canada,CAN,0,0,5,0,5
2014,Saint Vincent and the Grenadines,VCT,Canada,CAN,0,0,24,0,24
2014,Yemen,YEM,Canada,CAN,0,0,10,0,10
2014,Zimbabwe,ZWE,Canada,CAN,0,0,5,0,5
2014,Cuba,CUB,Colombia,COL,0,0,14,0,14
2014,Colombia,COL,Costa Rica,CRI,5,0,99,22,126
2014,Cuba,CUB,Costa Rica,CRI,0,0,13,0,13
2014,Guatemala,GTM,Costa Rica,CRI,0,0,0,5,5
2014,Honduras,HND,Costa Rica,CRI,0,0,5,0,5
2014,El Salvador,SLV,Costa Rica,CRI,12,0,0,0,12
2014,Venezuela (Bolivarian Republic of),VEN,Costa Rica,CRI,0,0,0,5,5
2014,Afghanistan,AFG,Cyprus,CYP,0,0,0,5,5
2014,Algeria,DZA,Cyprus,CYP,0,0,0,5,5
2014,Egypt,EGY,Cyprus,CYP,0,0,43,0,43
2014,Bangladesh,BGD,Cyprus,CYP,0,0,20,10,30
2014,Dem. Rep. of the Congo,COD,Cyprus,CYP,0,0,5,0,5
2014,Palestinian,PSE,Cyprus,CYP,0,5,0,13,18
2014,Georgia,GEO,Cyprus,CYP,0,0,5,0,5
2014,India,IND,Cyprus,CYP,0,0,12,0,12
2014,Iran (Islamic Rep. of),IRN,Cyprus,CYP,5,0,14,0,19
2014,Iraq,IRQ,Cyprus,CYP,0,5,12,37,54
2014,Kazakhstan,KAZ,Cyprus,CYP,0,0,5,0,5
2014,Lebanon,LBN,Cyprus,CYP,0,0,5,0,5
2014,Sri Lanka,LKA,Cyprus,CYP,0,0,17,5,22
2014,Nigeria,NGA,Cyprus,CYP,0,0,10,0,10
2014,Pakistan,PAK,Cyprus,CYP,0,0,0,14,14
2014,Philippines,PHL,Cyprus,CYP,0,0,11,5,16
2014,Serbia and Kosovo: S/RES/1244 (1999),SRB,Cyprus,CYP,0,0,10,0,10
2014,Somalia,SOM,Cyprus,CYP,5,0,0,0,5
2014,Viet Nam,VNM,Cyprus,CYP,0,0,31,5,36
2014,Syrian Arab Rep.,SYR,Cyprus,CYP,0,197,0,0,197
2014,Turkey,TUR,Cyprus,CYP,0,0,5,0,5
2014,Afghanistan,AFG,Denmark,DNK,16,37,133,0,186
2014,Albania,ALB,Denmark,DNK,0,0,21,0,21
2014,Algeria,DZA,Denmark,DNK,0,0,11,0,11
2014,Egypt,EGY,Denmark,DNK,0,0,12,0,12
2014,Armenia,ARM,Denmark,DNK,0,10,48,0,58
2014,Azerbaijan,AZE,Denmark,DNK,0,5,5,0,10
2014,Bangladesh,BGD,Denmark,DNK,5,0,75,0,80
2014,Belarus,BLR,Denmark,DNK,0,0,5,0,5
2014,Bulgaria,BGR,Denmark,DNK,0,0,5,0,5
2014,Chad,TCD,Denmark,DNK,0,0,17,0,17
2014,China,CHN,Denmark,DNK,0,0,11,0,11
2014,Cameroon,CMR,Denmark,DNK,0,0,5,0,5
2014,Dem. Rep. of the Congo,COD,Denmark,DNK,11,0,10,0,21
2014,Eritrea,ERI,Denmark,DNK,5,0,5,0,10
2014,Ethiopia,ETH,Denmark,DNK,5,0,21,0,26
2014,Gambia,GMB,Denmark,DNK,0,0,5,0,5
2014,Georgia,GEO,Denmark,DNK,0,0,17,0,17
2014,Ghana,GHA,Denmark,DNK,0,0,17,0,17
2014,Guinea-Bissau,GNB,Denmark,DNK,0,0,5,0,5
2014,Guinea,GIN,Denmark,DNK,0,0,15,0,15
2014,Cote d'Ivoire,CIV,Denmark,DNK,0,0,5,0,5
2014,India,IND,Denmark,DNK,0,0,15,0,15
2014,Iran (Islamic Rep. of),IRN,Denmark,DNK,68,5,65,0,138
2014,Iraq,IRQ,Denmark,DNK,0,5,50,0,55
2014,Jordan,JOR,Denmark,DNK,0,0,11,0,11
2014,Kazakhstan,KAZ,Denmark,DNK,0,0,5,0,5
2014,Kenya,KEN,Denmark,DNK,0,0,10,0,10
2014,Kyrgyzstan,KGZ,Denmark,DNK,0,0,5,0,5
2014,Libya,LBY,Denmark,DNK,0,0,5,0,5
2014,Lebanon,LBN,Denmark,DNK,0,0,12,0,12
2014,Sri Lanka,LKA,Denmark,DNK,5,0,11,0,16
2014,Mali,MLI,Denmark,DNK,0,0,5,0,5
2014,Morocco,MAR,Denmark,DNK,0,0,11,0,11
2014,Myanmar,MMR,Denmark,DNK,0,0,24,0,24
2014,Nigeria,NGA,Denmark,DNK,0,0,49,0,49
2014,Pakistan,PAK,Denmark,DNK,5,0,37,0,42
2014,Russian Federation,RUS,Denmark,DNK,13,13,234,0,260
2014,Serbia and Kosovo: S/RES/1244 (1999),SRB,Denmark,DNK,0,0,5,0,5
2014,Somalia,SOM,Denmark,DNK,10,5,371,0,386
2014,Sudan,SDN,Denmark,DNK,5,0,11,0,16
2014,Syrian Arab Rep.,SYR,Denmark,DNK,5,10,39,0,54
2014,Tajikistan,TJK,Denmark,DNK,0,0,5,0,5
2014,Tunisia,TUN,Denmark,DNK,0,0,10,0,10
2014,Uganda,UGA,Denmark,DNK,0,0,14,0,14
2014,Ukraine,UKR,Denmark,DNK,0,0,18,0,18
2014,Uzbekistan,UZB,Denmark,DNK,0,0,24,0,24
2014,Stateless,XXA,Denmark,DNK,0,15,37,0,52
2014,Afghanistan,AFG,France,FRA,53,176,66,5,300
2014,Albania,ALB,France,FRA,52,273,2206,723,3254
2014,Algeria,DZA,France,FRA,20,17,720,344,1101
2014,Angola,AGO,France,FRA,37,18,347,36,438
2014,Egypt,EGY,France,FRA,118,0,127,13,258
2014,Armenia,ARM,France,FRA,95,81,1606,289,2071
2014,Azerbaijan,AZE,France,FRA,59,0,386,62,507
2014,Burundi,BDI,France,FRA,5,0,17,5,27
2014,Benin,BEN,France,FRA,0,0,10,0,10
2014,Bangladesh,BGD,France,FRA,374,28,3417,1308,5127
2014,Bhutan,BTN,France,FRA,5,0,14,5,24
2014,Burkina Faso,BFA,France,FRA,5,5,13,0,23
2014,Belarus,BLR,France,FRA,30,0,35,5,70
2014,Bosnia and Herzegovina,BIH,France,FRA,24,5,385,255,669
2014,Cambodia,KHM,France,FRA,0,0,13,5,18
2014,Central African Rep.,CAF,France,FRA,10,43,10,10,73
2014,Chad,TCD,France,FRA,42,5,229,21,297
2014,China,CHN,France,FRA,5,10,1875,2005,3895
2014,Cameroon,CMR,France,FRA,30,5,94,18,147
2014,Congo,COG,France,FRA,32,10,319,48,409
2014,Dem. Rep. of the Congo,COD,France,FRA,302,37,2097,275,2711
2014,Comoros,COM,France,FRA,0,0,32,163,195
2014,Colombia,COL,France,FRA,5,5,19,0,29
2014,Cuba,CUB,France,FRA,0,0,5,0,5
2014,Djibouti,DJI,France,FRA,5,0,5,5,15
2014,Dominican Rep.,DOM,France,FRA,0,0,74,62,136
2014,Equatorial Guinea,GNQ,France,FRA,0,0,5,0,5
2014,Eritrea,ERI,France,FRA,119,0,160,13,292
2014,Ethiopia,ETH,France,FRA,12,0,43,5,60
2014,Gambia,GMB,France,FRA,5,0,26,5,36
2014,Palestinian,PSE,France,FRA,0,0,13,0,13
2014,Georgia,GEO,France,FRA,72,40,1170,200,1482
2014,Ghana,GHA,France,FRA,5,0,10,0,15
2014,Guinea-Bissau,GNB,France,FRA,5,0,50,16,71
2014,Guinea,GIN,France,FRA,232,43,937,105,1317
2014,Haiti,HTI,France,FRA,22,32,1061,506,1621
2014,Croatia,HRV,France,FRA,0,0,0,5,5
2014,Cote d'Ivoire,CIV,France,FRA,77,22,536,73,708
2014,India,IND,France,FRA,5,0,14,0,19
2014,Iran (Islamic Rep. of),IRN,France,FRA,34,5,45,10,94
2014,Iraq,IRQ,France,FRA,5,10,11,5,31
2014,Jordan,JOR,France,FRA,0,0,5,0,5
2014,Kazakhstan,KAZ,France,FRA,11,5,74,14,104
2014,Kenya,KEN,France,FRA,5,5,16,0,26
2014,Kyrgyzstan,KGZ,France,FRA,22,0,22,5,49
2014,Dem. People's Rep. of Korea,PRK,France,FRA,0,0,24,0,24
2014,Liberia,LBR,France,FRA,0,0,11,0,11
2014,Libya,LBY,France,FRA,11,5,28,0,44
2014,Saint Lucia,LCA,France,FRA,0,0,0,5,5
2014,Lebanon,LBN,France,FRA,5,0,5,5,15
2014,Sri Lanka,LKA,France,FRA,590,25,1421,526,2562
2014,Madagascar,MDG,France,FRA,0,0,25,10,35
2014,Mauritania,MRT,France,FRA,111,11,826,204,1152
2014,North Macedonia,MKD,France,FRA,5,5,126,60,196
2014,Rep. of Moldova,MDA,France,FRA,5,0,20,5,30
2014,Mexico,MEX,France,FRA,0,0,5,0,5
2014,Mali,MLI,France,FRA,68,10,786,96,960
2014,Mongolia,MNG,France,FRA,0,5,107,47,159
2014,Morocco,MAR,France,FRA,5,0,27,5,37
2014,Montenegro,MNE,France,FRA,0,0,145,80,225
2014,Mauritius,MUS,France,FRA,0,0,5,0,5
2014,Myanmar,MMR,France,FRA,40,0,305,47,392
2014,Nepal,NPL,France,FRA,14,0,59,24,97
2014,Niger,NER,France,FRA,0,0,14,5,19
2014,Nigeria,NGA,France,FRA,56,34,802,70,962
2014,Pakistan,PAK,France,FRA,44,22,1441,634,2141
2014,Peru,PER,France,FRA,0,5,28,13,46
2014,Philippines,PHL,France,FRA,0,0,5,0,5
2014,Romania,ROU,France,FRA,0,0,5,0,5
2014,South Africa,ZAF,France,FRA,0,0,5,0,5
2014,Russian Federation,RUS,France,FRA,603,93,1632,303,2631
2014,Rwanda,RWA,France,FRA,59,5,55,16,135
2014,Serbia and Kosovo: S/RES/1244 (1999),SRB,France,FRA,260,171,2754,1052,4237
2014,Senegal,SEN,France,FRA,21,0,118,15,154
2014,Sierra Leone,SLE,France,FRA,5,5,76,5,91
2014,Somalia,SOM,France,FRA,35,152,185,23,395
2014,Viet Nam,VNM,France,FRA,5,0,10,5,20
2014,Sudan,SDN,France,FRA,124,115,446,42,727
2014,Suriname,SUR,France,FRA,0,0,5,17,22
2014,Syrian Arab Rep.,SYR,France,FRA,55,10,53,10,128
2014,Thailand,THA,France,FRA,0,0,5,5,10
2014,Tajikistan,TJK,France,FRA,0,0,5,0,5
2014,Togo,TGO,France,FRA,14,0,69,5,88
2014,Tunisia,TUN,France,FRA,5,0,34,5,44
2014,Turkey,TUR,France,FRA,150,10,1124,192,1476
2014,Uganda,UGA,France,FRA,0,0,11,0,11
2014,Ukraine,UKR,France,FRA,5,5,59,0,69
2014,United States of America,USA,France,FRA,0,0,5,0,5
2014,Uzbekistan,UZB,France,FRA,5,0,12,10,27
2014,Venezuela (Bolivarian Republic of),VEN,France,FRA,0,0,5,0,5
2014,Western Sahara,ESH,France,FRA,10,0,24,5,39
2014,Yemen,YEM,France,FRA,5,0,0,0,5
2014,Afghanistan,AFG,Greece,GRC,145,175,340,1010,1670
2014,Albania,ALB,Greece,GRC,11,66,553,205,835
2014,Algeria,DZA,Greece,GRC,5,5,63,88,161
2014,Angola,AGO,Greece,GRC,5,0,0,0,5
2014,Egypt,EGY,Greece,GRC,38,14,202,149,403
2014,Armenia,ARM,Greece,GRC,0,5,22,22,49
2014,Burundi,BDI,Greece,GRC,0,0,0,5,5
2014,Benin,BEN,Greece,GRC,0,0,0,5,5
2014,Bangladesh,BGD,Greece,GRC,38,63,572,1223,1896
2014,Burkina Faso,BFA,Greece,GRC,0,5,16,68,89
2014,China,CHN,Greece,GRC,5,15,83,141,244
2014,Cameroon,CMR,Greece,GRC,5,0,22,35,62
2014,Congo,COG,Greece,GRC,5,12,21,35,73
2014,Dem. Rep. of the Congo,COD,Greece,GRC,34,5,30,13,82
2014,Comoros,COM,Greece,GRC,0,0,5,13,18
2014,Cuba,CUB,Greece,GRC,0,0,5,0,5
2014,Dominican Rep.,DOM,Greece,GRC,0,0,53,22,75
2014,Eritrea,ERI,Greece,GRC,16,0,11,48,75
2014,Ethiopia,ETH,Greece,GRC,25,14,26,114,179
2014,Gambia,GMB,Greece,GRC,5,5,21,17,48
2014,Palestinian,PSE,Greece,GRC,10,5,13,89,117
2014,Georgia,GEO,Greece,GRC,0,167,415,966,1548
2014,Ghana,GHA,Greece,GRC,5,17,75,179,276
2014,Guinea,GIN,Greece,GRC,10,10,42,62,124
2014,Cote d'Ivoire,CIV,Greece,GRC,11,5,51,66,133
2014,India,IND,Greece,GRC,0,15,177,70,262
2014,Indonesia,IDN,Greece,GRC,5,5,68,22,100
2014,Iran (Islamic Rep. of),IRN,Greece,GRC,26,15,60,168,269
2014,Iraq,IRQ,Greece,GRC,76,65,338,1212,1691
2014,Kenya,KEN,Greece,GRC,10,0,15,32,57
2014,Liberia,LBR,Greece,GRC,0,0,14,0,14
2014,Libya,LBY,Greece,GRC,0,0,0,5,5
2014,Lebanon,LBN,Greece,GRC,0,0,5,0,5
2014,Sri Lanka,LKA,Greece,GRC,5,5,18,75,103
2014,Mauritania,MRT,Greece,GRC,5,10,22,47,84
2014,Rep. of Moldova,MDA,Greece,GRC,0,10,40,39,89
2014,Mali,MLI,Greece,GRC,0,0,15,18,33
2014,Morocco,MAR,Greece,GRC,10,5,49,79,143
2014,Myanmar,MMR,Greece,GRC,0,0,0,12,12
2014,Nepal,NPL,Greece,GRC,0,0,11,0,11
2014,Niger,NER,Greece,GRC,0,0,0,5,5
2014,Nigeria,NGA,Greece,GRC,28,30,192,496,746
2014,Pakistan,PAK,Greece,GRC,67,222,1628,3950,5867
2014,Philippines,PHL,Greece,GRC,0,0,10,32,42
2014,Russian Federation,RUS,Greece,GRC,0,0,11,40,51
2014,Rwanda,RWA,Greece,GRC,0,0,11,13,24
2014,El Salvador,SLV,Greece,GRC,5,0,0,0,5
2014,Serbia and Kosovo: S/RES/1244 (1999),SRB,Greece,GRC,0,20,0,0,20
2014,Senegal,SEN,Greece,GRC,10,21,127,290,448
2014,Sierra Leone,SLE,Greece,GRC,5,10,26,20,61
2014,Somalia,SOM,Greece,GRC,23,10,42,125,200
2014,Viet Nam,VNM,Greece,GRC,0,0,0,5,5
2014,Sudan,SDN,Greece,GRC,49,10,37,96,192
2014,Syrian Arab Rep.,SYR,Greece,GRC,98,25,44,571,738
2014,United Rep. of Tanzania,TZA,Greece,GRC,0,0,13,12,25
2014,Togo,TGO,Greece,GRC,0,0,5,5,10
2014,Tunisia,TUN,Greece,GRC,0,0,18,12,30
2014,Turkey,TUR,Greece,GRC,18,0,28,56,102
2014,Uganda,UGA,Greece,GRC,0,0,0,5,5
2014,Ukraine,UKR,Greece,GRC,0,0,27,14,41
2014,Zimbabwe,ZWE,Greece,GRC,0,0,0,5,5
2014,Stateless,XXA,Greece,GRC,0,0,10,0,10
2014,Afghanistan,AFG,Ireland,IRL,11,0,0,0,11
2014,Albania,ALB,Ireland,IRL,0,0,10,0,10
2014,Algeria,DZA,Ireland,IRL,0,0,5,0,5
2014,Armenia,ARM,Ireland,IRL,0,0,5,0,5
2014,Azerbaijan,AZE,Ireland,IRL,0,0,5,0,5
2014,Bangladesh,BGD,Ireland,IRL,5,0,0,0,5
2014,Belarus,BLR,Ireland,IRL,5,0,0,0,5
2014,Cameroon,CMR,Ireland,IRL,5,0,0,5,10
2014,Dem. Rep. of the Congo,COD,Ireland,IRL,5,0,0,0,5
2014,Georgia,GEO,Ireland,IRL,0,0,0,5,5
2014,Guinea,GIN,Ireland,IRL,5,0,0,0,5
2014,Cote d'Ivoire,CIV,Ireland,IRL,0,0,5,0,5
2014,Iran (Islamic Rep. of),IRN,Ireland,IRL,10,0,0,0,10
2014,Iraq,IRQ,Ireland,IRL,10,0,0,0,10
2014,Kenya,KEN,Ireland,IRL,0,0,0,5,5
2014,Malaysia,MYS,Ireland,IRL,0,0,0,10,10
2014,Malawi,MWI,Ireland,IRL,5,0,0,0,5
2014,Nigeria,NGA,Ireland,IRL,10,0,33,21,64
2014,Pakistan,PAK,Ireland,IRL,5,0,13,5,23
2014,South Africa,ZAF,Ireland,IRL,0,0,5,11,16
2014,Russian Federation,RUS,Ireland,IRL,0,0,0,5,5
2014,Somalia,SOM,Ireland,IRL,5,0,5,0,10
2014,Sudan,SDN,Ireland,IRL,5,0,0,5,10
2014,Syrian Arab Rep.,SYR,Ireland,IRL,5,0,0,0,5
2014,Togo,TGO,Ireland,IRL,5,0,0,0,5
2014,Turkey,TUR,Ireland,IRL,5,0,0,0,5
2014,Ukraine,UKR,Ireland,IRL,0,0,0,5,5
2014,Zimbabwe,ZWE,Ireland,IRL,5,0,15,0,20
2014,Bangladesh,BGD,Japan,JPN,0,0,74,21,95
2014,Cameroon,CMR,Japan,JPN,0,5,33,0,38
2014,India,IND,Japan,JPN,0,0,66,14,80
2014,Iran (Islamic Rep. of),IRN,Japan,JPN,0,0,0,10,10
2014,Sri Lanka,LKA,Japan,JPN,0,5,128,18,151
2014,Myanmar,MMR,Japan,JPN,0,24,212,66,302
2014,Nepal,NPL,Japan,JPN,0,0,187,34,221
2014,Nigeria,NGA,Japan,JPN,0,5,36,0,41
2014,Pakistan,PAK,Japan,JPN,0,5,120,48,173
2014,Turkey,TUR,Japan,JPN,0,0,125,68,193
2014,Afghanistan,AFG,Luxembourg,LUX,0,0,5,0,5
2014,Albania,ALB,Luxembourg,LUX,0,0,110,0,110
2014,Algeria,DZA,Luxembourg,LUX,0,0,5,0,5
2014,Benin,BEN,Luxembourg,LUX,0,0,5,0,5
2014,Belarus,BLR,Luxembourg,LUX,0,0,5,0,5
2014,Bosnia and Herzegovina,BIH,Luxembourg,LUX,0,0,104,5,109
2014,Cameroon,CMR,Luxembourg,LUX,0,0,5,0,5
2014,Dem. Rep. of the Congo,COD,Luxembourg,LUX,0,0,5,0,5
2014,Ethiopia,ETH,Luxembourg,LUX,0,0,5,0,5
2014,Cote d'Ivoire,CIV,Luxembourg,LUX,0,0,5,0,5
2014,Iran (Islamic Rep. of),IRN,Luxembourg,LUX,5,0,0,5,10
2014,Iraq,IRQ,Luxembourg,LUX,12,5,0,0,17
2014,Kazakhstan,KAZ,Luxembourg,LUX,0,0,0,5,5
2014,North Macedonia,MKD,Luxembourg,LUX,0,0,25,0,25
2014,Montenegro,MNE,Luxembourg,LUX,0,0,107,10,117
2014,Nigeria,NGA,Luxembourg,LUX,0,0,10,5,15
2014,Russian Federation,RUS,Luxembourg,LUX,0,0,0,5,5
2014,Serbia and Kosovo: S/RES/1244 (1999),SRB,Luxembourg,LUX,15,5,176,11,207
2014,Somalia,SOM,Luxembourg,LUX,0,0,5,0,5
2014,Syrian Arab Rep.,SYR,Luxembourg,LUX,0,0,0,5,5
2014,Tunisia,TUN,Luxembourg,LUX,0,0,12,0,12
2014,Turkey,TUR,Luxembourg,LUX,0,0,13,0,13
2014,Burundi,BDI,Malawi,MWI,16,0,0,19,35
2014,Dem. Rep. of the Congo,COD,Malawi,MWI,29,0,0,0,29
2014,Rwanda,RWA,Malawi,MWI,16,0,0,70,86
2014,Burundi,BDI,Mozambique,MOZ,0,0,0,114,114
2014,Congo,COG,Mozambique,MOZ,0,0,0,5,5
2014,Dem. Rep. of the Congo,COD,Mozambique,MOZ,0,0,0,490,490
2014,Rwanda,RWA,Mozambique,MOZ,0,0,0,19,19
2014,Egypt,EGY,Malta,MLT,0,5,0,0,5
2014,Ethiopia,ETH,Malta,MLT,0,0,0,5,5
2014,Gambia,GMB,Malta,MLT,0,0,31,5,36
2014,Palestinian,PSE,Malta,MLT,0,0,5,0,5
2014,Ghana,GHA,Malta,MLT,0,0,0,5,5
2014,Libya,LBY,Malta,MLT,14,0,0,0,14
2014,Mali,MLI,Malta,MLT,0,0,5,0,5
2014,Nigeria,NGA,Malta,MLT,0,0,13,12,25
2014,Pakistan,PAK,Malta,MLT,0,0,0,5,5
2014,Senegal,SEN,Malta,MLT,0,0,0,34,34
2014,Somalia,SOM,Malta,MLT,0,0,14,0,14
2014,Syrian Arab Rep.,SYR,Malta,MLT,0,0,11,0,11
2014,Tunisia,TUN,Malta,MLT,0,0,5,0,5
2014,Rwanda,RWA,Niger,NER,0,0,5,0,5
2014,Afghanistan,AFG,Norway,NOR,43,27,699,34,803
2014,Albania,ALB,Norway,NOR,0,0,206,5,211
2014,Algeria,DZA,Norway,NOR,0,0,88,0,88
2014,Angola,AGO,Norway,NOR,0,0,28,0,28
2014,Egypt,EGY,Norway,NOR,0,0,31,0,31
2014,Armenia,ARM,Norway,NOR,0,0,16,5,21
2014,Azerbaijan,AZE,Norway,NOR,0,0,37,5,42
2014,Burundi,BDI,Norway,NOR,0,0,30,0,30
2014,Bangladesh,BGD,Norway,NOR,0,0,74,18,92
2014,Brazil,BRA,Norway,NOR,0,0,5,0,5
2014,Bosnia and Herzegovina,BIH,Norway,NOR,0,0,35,0,35
2014,Chad,TCD,Norway,NOR,0,0,12,0,12
2014,China,CHN,Norway,NOR,0,0,25,0,25
2014,Cameroon,CMR,Norway,NOR,0,0,20,0,20
2014,Congo,COG,Norway,NOR,0,0,5,0,5
2014,Dem. Rep. of the Congo,COD,Norway,NOR,0,5,44,0,49
2014,Colombia,COL,Norway,NOR,0,0,5,0,5
2014,Cuba,CUB,Norway,NOR,0,0,10,0,10
2014,Djibouti,DJI,Norway,NOR,0,0,5,0,5
2014,Eritrea,ERI,Norway,NOR,28,0,785,10,823
2014,Ethiopia,ETH,Norway,NOR,39,0,527,14,580
2014,France,FRA,Norway,NOR,0,0,5,0,5
2014,Gambia,GMB,Norway,NOR,0,0,22,0,22
2014,Georgia,GEO,Norway,NOR,0,0,29,0,29
2014,Germany,DEU,Norway,NOR,0,0,5,0,5
2014,Ghana,GHA,Norway,NOR,0,0,31,0,31
2014,Guinea-Bissau,GNB,Norway,NOR,0,0,5,0,5
2014,Guinea,GIN,Norway,NOR,0,0,34,0,34
2014,Cote d'Ivoire,CIV,Norway,NOR,0,0,33,0,33
2014,India,IND,Norway,NOR,0,0,27,0,27
2014,Iran (Islamic Rep. of),IRN,Norway,NOR,67,0,549,11,627
2014,Iraq,IRQ,Norway,NOR,10,10,219,10,249
2014,Jordan,JOR,Norway,NOR,0,0,18,0,18
2014,Kazakhstan,KAZ,Norway,NOR,5,0,18,5,28
2014,Kenya,KEN,Norway,NOR,0,0,13,0,13
2014,Kyrgyzstan,KGZ,Norway,NOR,0,0,62,5,67
2014,Liberia,LBR,Norway,NOR,0,0,18,0,18
2014,Libya,LBY,Norway,NOR,0,0,45,5,50
2014,Lebanon,LBN,Norway,NOR,0,0,25,0,25
2014,Sri Lanka,LKA,Norway,NOR,0,0,44,0,44
2014,Lithuania,LTU,Norway,NOR,0,0,5,0,5
2014,Latvia,LVA,Norway,NOR,0,0,5,0,5
2014,Mauritania,MRT,Norway,NOR,0,0,10,0,10
2014,North Macedonia,MKD,Norway,NOR,0,0,28,0,28
2014,Mali,MLI,Norway,NOR,0,0,26,0,26
2014,Mongolia,MNG,Norway,NOR,0,0,5,0,5
2014,Morocco,MAR,Norway,NOR,0,0,84,0,84
2014,Montenegro,MNE,Norway,NOR,0,0,10,0,10
2014,Myanmar,MMR,Norway,NOR,0,0,20,0,20
2014,Nepal,NPL,Norway,NOR,0,0,12,0,12
2014,Niger,NER,Norway,NOR,0,0,19,0,19
2014,Nigeria,NGA,Norway,NOR,5,0,437,13,455
2014,Pakistan,PAK,Norway,NOR,0,0,165,13,178
2014,Philippines,PHL,Norway,NOR,0,0,5,0,5
2014,Romania,ROU,Norway,NOR,0,0,10,0,10
2014,South Africa,ZAF,Norway,NOR,0,0,5,0,5
2014,Russian Federation,RUS,Norway,NOR,21,5,445,27,498
2014,Rwanda,RWA,Norway,NOR,0,0,18,0,18
2014,El Salvador,SLV,Norway,NOR,0,0,10,0,10
2014,Serbia and Kosovo: S/RES/1244 (1999),SRB,Norway,NOR,0,0,222,5,227
2014,Senegal,SEN,Norway,NOR,0,0,10,0,10
2014,Sierra Leone,SLE,Norway,NOR,0,0,14,0,14
2014,Somalia,SOM,Norway,NOR,5,0,774,23,802
2014,Spain,ESP,Norway,NOR,0,0,5,0,5
2014,Viet Nam,VNM,Norway,NOR,0,0,16,0,16
2014,Sudan,SDN,Norway,NOR,5,0,292,5,302
2014,South Sudan,SSD,Norway,NOR,0,0,13,0,13
2014,Syrian Arab Rep.,SYR,Norway,NOR,0,50,158,22,230
2014,United Rep. of Tanzania,TZA,Norway,NOR,0,0,5,0,5
2014,Tajikistan,TJK,Norway,NOR,0,0,31,0,31
2014,Turkmenistan,TKM,Norway,NOR,0,0,0,5,5
2014,Togo,TGO,Norway,NOR,0,0,5,0,5
2014,Tunisia,TUN,Norway,NOR,0,0,56,0,56
2014,Turkey,TUR,Norway,NOR,0,0,38,5,43
2014,Uganda,UGA,Norway,NOR,5,0,40,0,45
2014,Ukraine,UKR,Norway,NOR,0,0,63,5,68
2014,Uzbekistan,UZB,Norway,NOR,0,0,171,33,204
2014,Yemen,YEM,Norway,NOR,5,0,71,0,76
2014,Zimbabwe,ZWE,Norway,NOR,0,0,5,0,5
2014,Stateless,XXA,Norway,NOR,0,5,269,5,279
2014,Iran (Islamic Rep. of),IRN,Nauru,NRU,14,0,0,0,14
2014,Pakistan,PAK,Nauru,NRU,0,0,5,0,5
2014,Afghanistan,AFG,Poland,POL,0,0,11,0,11
2014,Algeria,DZA,Poland,POL,0,0,5,0,5
2014,Armenia,ARM,Poland,POL,0,0,21,0,21
2014,Bangladesh,BGD,Poland,POL,0,0,10,0,10
2014,Belarus,BLR,Poland,POL,0,0,10,0,10
2014,Georgia,GEO,Poland,POL,0,0,109,5,114
2014,India,IND,Poland,POL,0,0,5,0,5
2014,Kazakhstan,KAZ,Poland,POL,0,0,13,5,18
2014,Kyrgyzstan,KGZ,Poland,POL,0,0,5,0,5
2014,Nepal,NPL,Poland,POL,0,0,5,0,5
2014,Pakistan,PAK,Poland,POL,0,0,10,0,10
2014,Russian Federation,RUS,Poland,POL,5,11,918,71,1005
2014,Viet Nam,VNM,Poland,POL,0,0,13,0,13
2014,Syrian Arab Rep.,SYR,Poland,POL,0,0,5,0,5
2014,Ukraine,UKR,Poland,POL,0,0,156,13,169
2014,Uzbekistan,UZB,Poland,POL,0,0,5,0,5
2014,Stateless,XXA,Poland,POL,0,0,5,0,5
2014,Algeria,DZA,South Africa,ZAF,0,0,10,0,10
2014,Egypt,EGY,South Africa,ZAF,0,0,115,17,132
2014,Burundi,BDI,South Africa,ZAF,0,0,130,53,183
2014,Benin,BEN,South Africa,ZAF,0,0,14,5,19
2014,Bangladesh,BGD,South Africa,ZAF,0,0,481,75,556
2014,Burkina Faso,BFA,South Africa,ZAF,0,0,5,0,5
2014,Botswana,BWA,South Africa,ZAF,0,0,5,0,5
2014,China,CHN,South Africa,ZAF,0,0,918,91,1009
2014,Cameroon,CMR,South Africa,ZAF,0,0,333,75,408
2014,Congo,COG,South Africa,ZAF,0,0,16,12,28
2014,Dem. Rep. of the Congo,COD,South Africa,ZAF,42,0,833,312,1187
2014,Eritrea,ERI,South Africa,ZAF,0,0,14,0,14
2014,Ethiopia,ETH,South Africa,ZAF,5,0,572,76,653
2014,Gabon,GAB,South Africa,ZAF,0,0,5,0,5
2014,Gambia,GMB,South Africa,ZAF,0,0,5,0,5
2014,Palestinian,PSE,South Africa,ZAF,5,0,5,0,10
2014,Ghana,GHA,South Africa,ZAF,0,0,751,89,840
2014,Guinea,GIN,South Africa,ZAF,0,0,0,5,5
2014,Cote d'Ivoire,CIV,South Africa,ZAF,0,0,5,5,10
2014,India,IND,South Africa,ZAF,0,0,311,68,379
2014,Kenya,KEN,South Africa,ZAF,0,0,192,51,243
2014,Liberia,LBR,South Africa,ZAF,0,0,5,5,10
2014,Lesotho,LSO,South Africa,ZAF,0,0,1044,39,1083
2014,Mali,MLI,South Africa,ZAF,0,0,5,0,5
2014,Malawi,MWI,South Africa,ZAF,0,0,1842,230,2072
2014,Mozambique,MOZ,South Africa,ZAF,0,0,719,59,778
2014,Nepal,NPL,South Africa,ZAF,0,0,5,0,5
2014,Nigeria,NGA,South Africa,ZAF,0,0,2058,216,2274
2014,Pakistan,PAK,South Africa,ZAF,0,0,412,69,481
2014,Russian Federation,RUS,South Africa,ZAF,0,0,40,5,45
2014,Rwanda,RWA,South Africa,ZAF,0,0,18,0,18
2014,Senegal,SEN,South Africa,ZAF,0,0,92,12,104
2014,Somalia,SOM,South Africa,ZAF,15,0,75,15,105
2014,Sudan,SDN,South Africa,ZAF,0,0,5,0,5
2014,Eswatini,SWZ,South Africa,ZAF,0,0,40,10,50
2014,United Rep. of Tanzania,TZA,South Africa,ZAF,0,0,306,73,379
2014,Thailand,THA,South Africa,ZAF,0,0,16,5,21
2014,Togo,TGO,South Africa,ZAF,0,0,5,5,10
2014,Uganda,UGA,South Africa,ZAF,0,0,355,64,419
2014,Ukraine,UKR,South Africa,ZAF,0,0,5,0,5
2014,Western Sahara,ESH,South Africa,ZAF,0,0,12,5,17
2014,Zambia,ZMB,South Africa,ZAF,0,0,126,10,136
2014,Zimbabwe,ZWE,South Africa,ZAF,0,0,12652,1236,13888
2014,Afghanistan,AFG,Sweden,SWE,86,135,837,36,1094
2014,Albania,ALB,Sweden,SWE,11,23,869,36,939
2014,Algeria,DZA,Sweden,SWE,0,0,91,5,96
2014,Angola,AGO,Sweden,SWE,0,0,15,5,20
2014,Egypt,EGY,Sweden,SWE,0,0,176,21,197
2014,Armenia,ARM,Sweden,SWE,5,20,272,5,302
2014,Azerbaijan,AZE,Sweden,SWE,5,14,170,10,199
2014,Burundi,BDI,Sweden,SWE,0,0,17,0,17
2014,Bangladesh,BGD,Sweden,SWE,0,5,79,12,96
2014,Burkina Faso,BFA,Sweden,SWE,0,0,5,0,5
2014,Belarus,BLR,Sweden,SWE,5,0,124,20,149
2014,Bolivia (Plurinational State of),BOL,Sweden,SWE,0,5,33,0,38
2014,Bosnia and Herzegovina,BIH,Sweden,SWE,0,0,254,41,295
2014,Bulgaria,BGR,Sweden,SWE,0,0,0,11,11
2014,Chad,TCD,Sweden,SWE,0,0,5,0,5
2014,China,CHN,Sweden,SWE,0,5,27,0,32
2014,Chile,CHL,Sweden,SWE,0,0,5,0,5
2014,Cameroon,CMR,Sweden,SWE,0,5,28,0,33
2014,Congo,COG,Sweden,SWE,0,0,13,0,13
2014,Dem. Rep. of the Congo,COD,Sweden,SWE,0,5,47,0,52
2014,Colombia,COL,Sweden,SWE,0,0,10,0,10
2014,Cuba,CUB,Sweden,SWE,0,5,33,5,43
2014,Djibouti,DJI,Sweden,SWE,0,0,31,0,31
2014,Equatorial Guinea,GNQ,Sweden,SWE,0,0,5,0,5
2014,Eritrea,ERI,Sweden,SWE,5,5,199,10,219
2014,Ethiopia,ETH,Sweden,SWE,16,5,209,5,235
2014,Gambia,GMB,Sweden,SWE,0,0,86,5,91
2014,Georgia,GEO,Sweden,SWE,0,5,272,18,295
2014,Ghana,GHA,Sweden,SWE,0,0,32,0,32
2014,Guinea-Bissau,GNB,Sweden,SWE,0,0,10,0,10
2014,Greece,GRC,Sweden,SWE,0,5,0,0,5
2014,Guatemala,GTM,Sweden,SWE,0,0,11,0,11
2014,Guinea,GIN,Sweden,SWE,0,0,31,0,31
2014,Honduras,HND,Sweden,SWE,0,0,5,0,5
2014,Croatia,HRV,Sweden,SWE,0,0,5,0,5
2014,Hungary,HUN,Sweden,SWE,0,0,5,0,5
2014,Cote d'Ivoire,CIV,Sweden,SWE,0,0,15,0,15
2014,India,IND,Sweden,SWE,0,0,29,0,29
2014,Iran (Islamic Rep. of),IRN,Sweden,SWE,121,96,474,12,703
2014,Iraq,IRQ,Sweden,SWE,36,44,617,32,729
2014,Israel,ISR,Sweden,SWE,0,0,12,0,12
2014,Jordan,JOR,Sweden,SWE,0,5,91,11,107
2014,Kazakhstan,KAZ,Sweden,SWE,5,15,173,13,206
2014,Kenya,KEN,Sweden,SWE,0,0,27,0,27
2014,Kyrgyzstan,KGZ,Sweden,SWE,0,5,179,10,194
2014,Dem. People's Rep. of Korea,PRK,Sweden,SWE,0,0,5,0,5
2014,Kuwait,KWT,Sweden,SWE,0,0,11,0,11
2014,Liberia,LBR,Sweden,SWE,0,0,19,0,19
2014,Libya,LBY,Sweden,SWE,5,0,136,5,146
2014,Lebanon,LBN,Sweden,SWE,0,19,265,12,296
2014,Sri Lanka,LKA,Sweden,SWE,0,0,29,0,29
2014,Latvia,LVA,Sweden,SWE,0,0,5,0,5
2014,Mauritania,MRT,Sweden,SWE,0,0,5,0,5
2014,North Macedonia,MKD,Sweden,SWE,0,0,229,10,239
2014,Rep. of Moldova,MDA,Sweden,SWE,0,0,5,5,10
2014,Mexico,MEX,Sweden,SWE,0,0,5,0,5
2014,Mali,MLI,Sweden,SWE,0,0,23,0,23
2014,Malaysia,MYS,Sweden,SWE,0,0,5,0,5
2014,Mongolia,MNG,Sweden,SWE,0,5,296,15,316
2014,Morocco,MAR,Sweden,SWE,0,10,246,10,266
2014,Mozambique,MOZ,Sweden,SWE,0,0,5,0,5
2014,Montenegro,MNE,Sweden,SWE,0,0,37,5,42
2014,Nepal,NPL,Sweden,SWE,0,0,5,5,10
2014,Niger,NER,Sweden,SWE,0,0,5,0,5
2014,Nicaragua,NIC,Sweden,SWE,0,0,10,0,10
2014,Nigeria,NGA,Sweden,SWE,11,15,268,10,304
2014,Pakistan,PAK,Sweden,SWE,5,10,182,10,207
2014,Peru,PER,Sweden,SWE,0,0,12,0,12
2014,Philippines,PHL,Sweden,SWE,0,0,5,0,5
2014,Poland,POL,Sweden,SWE,0,0,5,0,5
2014,Romania,ROU,Sweden,SWE,0,0,5,0,5
2014,South Africa,ZAF,Sweden,SWE,0,0,5,0,5
2014,Russian Federation,RUS,Sweden,SWE,19,11,474,23,527
2014,Rwanda,RWA,Sweden,SWE,0,0,12,0,12
2014,El Salvador,SLV,Sweden,SWE,0,0,24,0,24
2014,Serbia and Kosovo: S/RES/1244 (1999),SRB,Sweden,SWE,0,46,1341,114,1501
2014,Senegal,SEN,Sweden,SWE,0,0,19,0,19
2014,Sierra Leone,SLE,Sweden,SWE,0,0,19,0,19
2014,Somalia,SOM,Sweden,SWE,20,31,961,21,1033
2014,Viet Nam,VNM,Sweden,SWE,0,0,18,0,18
2014,Sudan,SDN,Sweden,SWE,5,0,72,5,82
2014,Slovakia,SVK,Sweden,SWE,0,0,5,0,5
2014,Eswatini,SWZ,Sweden,SWE,0,0,5,0,5
2014,Syrian Arab Rep.,SYR,Sweden,SWE,5,5,671,161,842
2014,United Rep. of Tanzania,TZA,Sweden,SWE,0,0,21,0,21
2014,Thailand,THA,Sweden,SWE,0,0,5,0,5
2014,Tajikistan,TJK,Sweden,SWE,0,0,33,5,38
2014,Togo,TGO,Sweden,SWE,0,0,11,0,11
2014,Tunisia,TUN,Sweden,SWE,0,0,48,10,58
2014,Turkey,TUR,Sweden,SWE,0,5,108,5,118
2014,Uganda,UGA,Sweden,SWE,5,0,57,0,62
2014,Ukraine,UKR,Sweden,SWE,0,0,109,16,125
2014,United States of America,USA,Sweden,SWE,0,0,14,0,14
2014,Uzbekistan,UZB,Sweden,SWE,5,10,195,15,225
2014,Venezuela (Bolivarian Republic of),VEN,Sweden,SWE,0,0,10,0,10
2014,Yemen,YEM,Sweden,SWE,5,5,86,0,96
2014,Zimbabwe,ZWE,Sweden,SWE,0,0,5,0,5
2014,Stateless,XXA,Sweden,SWE,14,32,769,45,860
2015,Dem. Rep. of the Congo,COD,Burundi,BDI,379,0,267,91,737
2015,Comoros,COM,Burundi,BDI,0,0,5,0,5
2015,Rwanda,RWA,Burundi,BDI,5,0,0,0,5
2015,Somalia,SOM,Burundi,BDI,0,0,5,0,5
2015,Afghanistan,AFG,Canada,CAN,10,0,15,0,25
2015,Albania,ALB,Canada,CAN,16,0,38,0,54
2015,Algeria,DZA,Canada,CAN,5,0,22,0,27
2015,Angola,AGO,Canada,CAN,5,0,5,0,10
2015,Egypt,EGY,Canada,CAN,11,0,10,0,21
2015,Argentina,ARG,Canada,CAN,0,0,5,0,5
2015,Armenia,ARM,Canada,CAN,0,0,5,0,5
2015,Barbados,BRB,Canada,CAN,0,0,5,0,5
2015,Burundi,BDI,Canada,CAN,14,0,0,0,14
2015,Benin,BEN,Canada,CAN,0,0,5,0,5
2015,Bangladesh,BGD,Canada,CAN,14,0,38,5,57
2015,Bahamas,BHS,Canada,CAN,0,0,5,0,5
2015,Burkina Faso,BFA,Canada,CAN,0,0,5,0,5
2015,Bolivia (Plurinational State of),BOL,Canada,CAN,0,0,5,0,5
2015,Brazil,BRA,Canada,CAN,0,0,5,0,5
2015,Bosnia and Herzegovina,BIH,Canada,CAN,0,0,5,0,5
2015,Cambodia,KHM,Canada,CAN,0,0,10,0,10
2015,Chad,TCD,Canada,CAN,5,0,11,0,16
2015,China,CHN,Canada,CAN,94,0,299,5,398
2015,Cameroon,CMR,Canada,CAN,15,0,41,0,56
2015,Congo,COG,Canada,CAN,0,0,13,0,13
2015,Dem. Rep. of the Congo,COD,Canada,CAN,19,0,62,0,81
2015,Colombia,COL,Canada,CAN,20,0,80,5,105
2015,Cuba,CUB,Canada,CAN,10,0,22,0,32
2015,Djibouti,DJI,Canada,CAN,5,0,0,0,5
2015,Dominican Rep.,DOM,Canada,CAN,5,0,5,0,10
2015,Ecuador,ECU,Canada,CAN,0,0,5,0,5
2015,Eritrea,ERI,Canada,CAN,5,0,16,0,21
2015,Ethiopia,ETH,Canada,CAN,30,0,28,0,58
2015,Gambia,GMB,Canada,CAN,0,0,5,0,5
2015,Palestinian,PSE,Canada,CAN,5,0,13,0,18
2015,Georgia,GEO,Canada,CAN,5,0,21,0,26
2015,Ghana,GHA,Canada,CAN,5,0,33,0,38
2015,Greece,GRC,Canada,CAN,5,0,0,0,5
2015,Grenada,GRD,Canada,CAN,0,0,10,0,10
2015,Guatemala,GTM,Canada,CAN,0,0,14,0,14
2015,Guinea,GIN,Canada,CAN,5,0,18,0,23
2015,Haiti,HTI,Canada,CAN,36,0,79,5,120
2015,Honduras,HND,Canada,CAN,0,0,23,0,23
2015,Croatia,HRV,Canada,CAN,0,0,16,0,16
2015,Hungary,HUN,Canada,CAN,0,0,27,10,37
2015,Cote d'Ivoire,CIV,Canada,CAN,0,0,12,0,12
2015,India,IND,Canada,CAN,11,0,101,0,112
2015,Indonesia,IDN,Canada,CAN,0,0,5,0,5
2015,Iran (Islamic Rep. of),IRN,Canada,CAN,19,0,17,0,36
2015,Iraq,IRQ,Canada,CAN,0,0,14,0,14
2015,Italy,ITA,Canada,CAN,0,0,10,0,10
2015,Jamaica,JAM,Canada,CAN,5,0,32,0,37
2015,Jordan,JOR,Canada,CAN,0,0,15,0,15
2015,Kenya,KEN,Canada,CAN,13,0,5,0,18
2015,Kyrgyzstan,KGZ,Canada,CAN,0,0,5,0,5
2015,Libya,LBY,Canada,CAN,12,0,10,5,27
2015,Saint Lucia,LCA,Canada,CAN,0,0,14,0,14
2015,Lebanon,LBN,Canada,CAN,5,0,44,0,49
2015,Sri Lanka,LKA,Canada,CAN,5,0,36,0,41
2015,Madagascar,MDG,Canada,CAN,0,0,5,0,5
2015,Mauritania,MRT,Canada,CAN,0,0,5,0,5
2015,Mexico,MEX,Canada,CAN,0,0,5,0,5
2015,Mali,MLI,Canada,CAN,5,0,12,0,17
2015,Mongolia,MNG,Canada,CAN,5,0,10,0,15
2015,Morocco,MAR,Canada,CAN,0,0,14,0,14
2015,Myanmar,MMR,Canada,CAN,5,0,0,0,5
2015,Nepal,NPL,Canada,CAN,0,0,5,0,5
2015,Nicaragua,NIC,Canada,CAN,0,0,5,0,5
2015,Nigeria,NGA,Canada,CAN,62,0,164,0,226
2015,Pakistan,PAK,Canada,CAN,22,0,89,5,116
2015,Peru,PER,Canada,CAN,0,0,10,0,10
2015,Philippines,PHL,Canada,CAN,0,0,10,0,10
2015,South Africa,ZAF,Canada,CAN,0,0,13,0,13
2015,Russian Federation,RUS,Canada,CAN,0,0,5,13,18
2015,Rwanda,RWA,Canada,CAN,0,0,12,0,12
2015,El Salvador,SLV,Canada,CAN,5,0,21,0,26
2015,Saudi Arabia,SAU,Canada,CAN,5,0,0,0,5
2015,Serbia and Kosovo: S/RES/1244 (1999),SRB,Canada,CAN,10,0,20,0,30
2015,Senegal,SEN,Canada,CAN,0,0,14,0,14
2015,Somalia,SOM,Canada,CAN,36,0,46,0,82
2015,Viet Nam,VNM,Canada,CAN,0,0,5,0,5
2015,Saint Kitts and Nevis,KNA,Canada,CAN,5,0,0,0,5
2015,Sudan,SDN,Canada,CAN,0,0,12,5,17
2015,Slovakia,SVK,Canada,CAN,0,0,5,0,5
2015,Syrian Arab Rep.,SYR,Canada,CAN,0,0,10,0,10
2015,United Rep. of Tanzania,TZA,Canada,CAN,5,0,0,0,5
2015,Togo,TGO,Canada,CAN,0,0,5,0,5
2015,Trinidad and Tobago,TTO,Canada,CAN,11,0,0,0,11
2015,Tunisia,TUN,Canada,CAN,5,0,13,0,18
2015,Turkey,TUR,Canada,CAN,13,0,30,0,43
2015,Uganda,UGA,Canada,CAN,12,0,0,0,12
2015,Ukraine,UKR,Canada,CAN,38,0,52,5,95
2015,Uruguay,URY,Canada,CAN,0,0,5,0,5
2015,United States of America,USA,Canada,CAN,0,0,5,0,5
2015,Uzbekistan,UZB,Canada,CAN,0,0,5,0,5
2015,Saint Vincent and the Grenadines,VCT,Canada,CAN,5,0,11,0,16
2015,Venezuela (Bolivarian Republic of),VEN,Canada,CAN,12,0,21,0,33
2015,Yemen,YEM,Canada,CAN,0,0,5,0,5
2015,Zimbabwe,ZWE,Canada,CAN,0,0,11,0,11
2015,Stateless,XXA,Canada,CAN,0,0,13,0,13
2015,Cuba,CUB,Colombia,COL,0,0,11,0,11
2015,Venezuela (Bolivarian Republic of),VEN,Colombia,COL,5,0,12,0,17
2015,Colombia,COL,Costa Rica,CRI,5,0,37,82,124
2015,Cuba,CUB,Costa Rica,CRI,0,0,5,5,10
2015,Honduras,HND,Costa Rica,CRI,0,0,0,5,5
2015,El Salvador,SLV,Costa Rica,CRI,5,0,0,5,10
2015,United States of America,USA,Costa Rica,CRI,0,0,0,5,5
2015,Afghanistan,AFG,Cyprus,CYP,0,0,5,0,5
2015,Algeria,DZA,Cyprus,CYP,5,0,0,0,5
2015,Egypt,EGY,Cyprus,CYP,0,0,20,21,41
2015,Bangladesh,BGD,Cyprus,CYP,0,0,35,0,35
2015,Cameroon,CMR,Cyprus,CYP,0,0,10,0,10
2015,Dem. Rep. of the Congo,COD,Cyprus,CYP,0,0,5,0,5
2015,Palestinian,PSE,Cyprus,CYP,0,5,0,0,5
2015,India,IND,Cyprus,CYP,0,0,29,5,34
2015,Iran (Islamic Rep. of),IRN,Cyprus,CYP,19,0,12,0,31
2015,Iraq,IRQ,Cyprus,CYP,0,43,0,19,62
2015,Jordan,JOR,Cyprus,CYP,0,12,0,0,12
2015,Lebanon,LBN,Cyprus,CYP,5,0,5,0,10
2015,Sri Lanka,LKA,Cyprus,CYP,0,0,44,10,54
2015,Nigeria,NGA,Cyprus,CYP,0,0,10,0,10
2015,Pakistan,PAK,Cyprus,CYP,0,0,22,10,32
2015,Philippines,PHL,Cyprus,CYP,0,0,32,5,37
2015,Viet Nam,VNM,Cyprus,CYP,0,0,68,14,82
2015,Syrian Arab Rep.,SYR,Cyprus,CYP,14,202,5,22,243
2015,Turkey,TUR,Cyprus,CYP,0,0,0,10,10
2015,Afghanistan,AFG,Denmark,DNK,32,17,90,0,139
2015,Albania,ALB,Denmark,DNK,0,0,5,0,5
2015,Egypt,EGY,Denmark,DNK,0,0,10,0,10
2015,Armenia,ARM,Denmark,DNK,5,0,43,0,48
2015,Azerbaijan,AZE,Denmark,DNK,5,0,14,0,19
2015,Burundi,BDI,Denmark,DNK,0,0,5,0,5
2015,Bangladesh,BGD,Denmark,DNK,0,0,10,0,10
2015,Belarus,BLR,Denmark,DNK,0,0,12,0,12
2015,Chad,TCD,Denmark,DNK,0,0,5,0,5
2015,China,CHN,Denmark,DNK,0,0,5,0,5
2015,Cameroon,CMR,Denmark,DNK,0,0,5,0,5
2015,Dem. Rep. of the Congo,COD,Denmark,DNK,0,0,14,0,14
2015,Eritrea,ERI,Denmark,DNK,13,0,34,0,47
2015,Ethiopia,ETH,Denmark,DNK,5,0,34,0,39
2015,Georgia,GEO,Denmark,DNK,0,0,11,0,11
2015,Ghana,GHA,Denmark,DNK,0,0,5,0,5
2015,India,IND,Denmark,DNK,0,0,5,0,5
2015,Iran (Islamic Rep. of),IRN,Denmark,DNK,56,5,40,0,101
2015,Iraq,IRQ,Denmark,DNK,5,0,35,0,40
2015,Jordan,JOR,Denmark,DNK,0,0,10,0,10
2015,Kenya,KEN,Denmark,DNK,0,0,10,0,10
2015,Rep. of Korea,KOR,Denmark,DNK,0,0,5,0,5
2015,Libya,LBY,Denmark,DNK,0,0,14,0,14
2015,Lebanon,LBN,Denmark,DNK,0,0,15,0,15
2015,Sri Lanka,LKA,Denmark,DNK,0,0,5,0,5
2015,Morocco,MAR,Denmark,DNK,0,0,10,0,10
2015,Myanmar,MMR,Denmark,DNK,0,0,29,0,29
2015,Nepal,NPL,Denmark,DNK,0,0,19,0,19
2015,Pakistan,PAK,Denmark,DNK,5,0,10,0,15
2015,Russian Federation,RUS,Denmark,DNK,14,21,160,0,195
2015,Serbia and Kosovo: S/RES/1244 (1999),SRB,Denmark,DNK,0,0,11,0,11
2015,Somalia,SOM,Denmark,DNK,0,17,124,0,141
2015,Sudan,SDN,Denmark,DNK,0,0,14,0,14
2015,Syrian Arab Rep.,SYR,Denmark,DNK,42,5,101,0,148
2015,Tunisia,TUN,Denmark,DNK,0,0,5,0,5
2015,Uganda,UGA,Denmark,DNK,12,0,0,0,12
2015,Ukraine,UKR,Denmark,DNK,0,5,30,0,35
2015,Uzbekistan,UZB,Denmark,DNK,0,0,5,0,5
2015,Stateless,XXA,Denmark,DNK,5,0,80,0,85
2015,Afghanistan,AFG,France,FRA,22,48,42,5,117
2015,Albania,ALB,France,FRA,62,295,2030,757,3144
2015,Algeria,DZA,France,FRA,25,21,662,471,1179
2015,Angola,AGO,France,FRA,36,13,266,17,332
2015,Egypt,EGY,France,FRA,69,0,113,5,187
2015,Armenia,ARM,France,FRA,21,63,1076,217,1377
2015,Azerbaijan,AZE,France,FRA,106,13,412,43,574
2015,Burundi,BDI,France,FRA,0,0,5,0,5
2015,Benin,BEN,France,FRA,0,0,11,0,11
2015,Bangladesh,BGD,France,FRA,355,42,2605,712,3714
2015,Bhutan,BTN,France,FRA,5,0,19,10,34
2015,Burkina Faso,BFA,France,FRA,5,0,18,0,23
2015,Belarus,BLR,France,FRA,12,0,22,5,39
2015,Bolivia (Plurinational State of),BOL,France,FRA,0,0,5,0,5
2015,Botswana,BWA,France,FRA,0,0,5,0,5
2015,Bosnia and Herzegovina,BIH,France,FRA,17,5,177,104,303
2015,Cambodia,KHM,France,FRA,0,0,39,5,44
2015,Central African Rep.,CAF,France,FRA,5,0,14,5,24
2015,Chad,TCD,France,FRA,18,5,97,5,125
2015,China,CHN,France,FRA,5,0,1519,1536,3060
2015,Cameroon,CMR,France,FRA,21,5,91,13,130
2015,Congo,COG,France,FRA,32,10,369,35,446
2015,Dem. Rep. of the Congo,COD,France,FRA,448,60,3087,263,3858
2015,Comoros,COM,France,FRA,5,0,145,53,203
2015,Colombia,COL,France,FRA,0,5,32,5,42
2015,Cuba,CUB,France,FRA,0,0,5,0,5
2015,Djibouti,DJI,France,FRA,13,0,0,0,13
2015,Dominican Rep.,DOM,France,FRA,0,0,129,114,243
2015,Eritrea,ERI,France,FRA,112,5,183,24,324
2015,Ethiopia,ETH,France,FRA,11,0,26,11,48
2015,Gabon,GAB,France,FRA,0,0,10,0,10
2015,Gambia,GMB,France,FRA,5,0,30,0,35
2015,Palestinian,PSE,France,FRA,5,0,12,0,17
2015,Georgia,GEO,France,FRA,73,49,1339,198,1659
2015,Ghana,GHA,France,FRA,0,0,12,0,12
2015,Guinea-Bissau,GNB,France,FRA,0,0,98,22,120
2015,Guinea,GIN,France,FRA,276,66,1254,110,1706
2015,Haiti,HTI,France,FRA,10,13,766,599,1388
2015,Honduras,HND,France,FRA,0,0,5,0,5
2015,Cote d'Ivoire,CIV,France,FRA,70,17,488,55,630
2015,India,IND,France,FRA,0,0,29,0,29
2015,Iran (Islamic Rep. of),IRN,France,FRA,15,5,32,10,62
2015,Iraq,IRQ,France,FRA,5,12,12,5,34
2015,Kazakhstan,KAZ,France,FRA,22,5,62,10,99
2015,Kenya,KEN,France,FRA,0,0,11,0,11
2015,Kyrgyzstan,KGZ,France,FRA,10,0,11,5,26
2015,Dem. People's Rep. of Korea,PRK,France,FRA,0,0,13,0,13
2015,Lao People's Dem. Rep.,LAO,France,FRA,0,0,0,5,5
2015,Liberia,LBR,France,FRA,0,0,5,0,5
2015,Libya,LBY,France,FRA,13,29,27,10,79
2015,Saint Lucia,LCA,France,FRA,0,0,0,5,5
2015,Lebanon,LBN,France,FRA,5,5,23,0,33
2015,Sri Lanka,LKA,France,FRA,386,13,1113,457,1969
2015,Madagascar,MDG,France,FRA,0,5,39,0,44
2015,Mauritania,MRT,France,FRA,72,5,466,133,676
2015,North Macedonia,MKD,France,FRA,0,0,112,54,166
2015,Rep. of Moldova,MDA,France,FRA,0,0,10,10,20
2015,Mali,MLI,France,FRA,29,16,785,81,911
2015,Mongolia,MNG,France,FRA,0,5,104,47,156
2015,Morocco,MAR,France,FRA,5,0,36,5,46
2015,Montenegro,MNE,France,FRA,0,5,68,42,115
2015,Myanmar,MMR,France,FRA,21,0,134,36,191
2015,Nepal,NPL,France,FRA,5,5,36,13,59
2015,Niger,NER,France,FRA,0,0,11,0,11
2015,Nigeria,NGA,France,FRA,96,42,773,73,984
2015,Pakistan,PAK,France,FRA,42,23,1418,818,2301
2015,Peru,PER,France,FRA,0,0,25,5,30
2015,Philippines,PHL,France,FRA,0,0,5,0,5
2015,South Africa,ZAF,France,FRA,0,0,5,0,5
2015,Russian Federation,RUS,France,FRA,465,86,1729,262,2542
2015,Rwanda,RWA,France,FRA,22,0,41,11,74
2015,Serbia and Kosovo: S/RES/1244 (1999),SRB,France,FRA,256,149,2274,943,3622
2015,Senegal,SEN,France,FRA,20,5,69,5,99
2015,Sierra Leone,SLE,France,FRA,11,5,58,5,79
2015,Somalia,SOM,France,FRA,19,108,125,19,271
2015,Viet Nam,VNM,France,FRA,0,5,18,0,23
2015,Sudan,SDN,France,FRA,153,231,530,51,965
2015,Suriname,SUR,France,FRA,0,0,0,12,12
2015,Syrian Arab Rep.,SYR,France,FRA,91,5,104,10,210
2015,United Rep. of Tanzania,TZA,France,FRA,0,0,0,5,5
2015,Thailand,THA,France,FRA,0,0,0,5,5
2015,Togo,TGO,France,FRA,10,0,96,5,111
2015,Tunisia,TUN,France,FRA,5,0,35,0,40
2015,Turkey,TUR,France,FRA,155,11,1182,145,1493
2015,Ukraine,UKR,France,FRA,33,21,226,22,302
2015,United States of America,USA,France,FRA,0,0,0,5,5
2015,Uzbekistan,UZB,France,FRA,0,0,14,0,14
2015,Venezuela (Bolivarian Republic of),VEN,France,FRA,0,0,5,0,5
2015,Western Sahara,ESH,France,FRA,22,0,95,10,127
2015,Yemen,YEM,France,FRA,0,5,0,0,5
2015,Zimbabwe,ZWE,France,FRA,0,0,5,0,5
2015,Afghanistan,AFG,Greece,GRC,52,80,71,5,208
2015,Albania,ALB,Greece,GRC,5,0,259,10,274
2015,Algeria,DZA,Greece,GRC,0,0,55,5,60
2015,Egypt,EGY,Greece,GRC,21,5,132,0,158
2015,Armenia,ARM,Greece,GRC,0,0,21,0,21
2015,Bangladesh,BGD,Greece,GRC,13,0,288,5,306
2015,Burkina Faso,BFA,Greece,GRC,0,0,5,0,5
2015,China,CHN,Greece,GRC,5,0,33,0,38
2015,Cameroon,CMR,Greece,GRC,24,0,47,0,71
2015,Congo,COG,Greece,GRC,0,0,5,0,5
2015,Dem. Rep. of the Congo,COD,Greece,GRC,22,5,17,0,44
2015,Comoros,COM,Greece,GRC,0,0,5,0,5
2015,Dominican Rep.,DOM,Greece,GRC,0,0,0,5,5
2015,Eritrea,ERI,Greece,GRC,14,0,15,0,29
2015,Ethiopia,ETH,Greece,GRC,13,0,12,0,25
2015,Gambia,GMB,Greece,GRC,0,0,5,0,5
2015,Palestinian,PSE,Greece,GRC,0,0,5,0,5
2015,Georgia,GEO,Greece,GRC,0,0,157,10,167
2015,Ghana,GHA,Greece,GRC,0,0,18,0,18
2015,Guinea,GIN,Greece,GRC,0,0,13,0,13
2015,Cote d'Ivoire,CIV,Greece,GRC,5,0,20,0,25
2015,India,IND,Greece,GRC,0,0,29,0,29
2015,Iran (Islamic Rep. of),IRN,Greece,GRC,22,0,47,0,69
2015,Iraq,IRQ,Greece,GRC,0,5,15,0,20
2015,Kenya,KEN,Greece,GRC,0,0,11,0,11
2015,Sri Lanka,LKA,Greece,GRC,0,0,12,0,12
2015,Mauritania,MRT,Greece,GRC,0,0,13,0,13
2015,Mali,MLI,Greece,GRC,0,0,13,0,13
2015,Morocco,MAR,Greece,GRC,5,0,39,5,49
2015,Nepal,NPL,Greece,GRC,0,0,5,0,5
2015,Nigeria,NGA,Greece,GRC,27,5,156,5,193
2015,Pakistan,PAK,Greece,GRC,43,5,764,13,825
2015,Philippines,PHL,Greece,GRC,0,0,5,0,5
2015,Russian Federation,RUS,Greece,GRC,0,0,16,0,16
2015,Senegal,SEN,Greece,GRC,5,0,41,0,46
2015,Sierra Leone,SLE,Greece,GRC,0,0,5,0,5
2015,Somalia,SOM,Greece,GRC,0,0,14,0,14
2015,Sudan,SDN,Greece,GRC,22,5,31,5,63
2015,Syrian Arab Rep.,SYR,Greece,GRC,5,0,0,0,5
2015,United Rep. of Tanzania,TZA,Greece,GRC,0,0,5,0,5
2015,Tunisia,TUN,Greece,GRC,0,0,24,0,24
2015,Turkey,TUR,Greece,GRC,0,0,5,0,5
2015,Uganda,UGA,Greece,GRC,0,0,5,0,5
2015,Ukraine,UKR,Greece,GRC,5,28,28,10,71
2015,Venezuela (Bolivarian Republic of),VEN,Greece,GRC,0,0,5,0,5
2015,Stateless,XXA,Greece,GRC,0,0,5,0,5
2015,Afghanistan,AFG,Ireland,IRL,11,0,5,5,21
2015,Albania,ALB,Ireland,IRL,5,0,18,10,33
2015,Algeria,DZA,Ireland,IRL,5,0,15,5,25
2015,Angola,AGO,Ireland,IRL,0,0,0,5,5
2015,Benin,BEN,Ireland,IRL,0,0,5,0,5
2015,Bangladesh,BGD,Ireland,IRL,0,0,5,5,10
2015,Brazil,BRA,Ireland,IRL,0,0,5,0,5
2015,China,CHN,Ireland,IRL,0,0,5,0,5
2015,Cameroon,CMR,Ireland,IRL,0,0,0,13,13
2015,Dem. Rep. of the Congo,COD,Ireland,IRL,34,0,14,12,60
2015,Ethiopia,ETH,Ireland,IRL,5,0,0,0,5
2015,Palestinian,PSE,Ireland,IRL,5,0,0,0,5
2015,Georgia,GEO,Ireland,IRL,0,0,11,0,11
2015,Ghana,GHA,Ireland,IRL,0,0,5,5,10
2015,Guinea,GIN,Ireland,IRL,5,0,0,0,5
2015,Cote d'Ivoire,CIV,Ireland,IRL,0,0,5,0,5
2015,Iran (Islamic Rep. of),IRN,Ireland,IRL,5,0,5,0,10
2015,Iraq,IRQ,Ireland,IRL,0,0,0,5,5
2015,Kenya,KEN,Ireland,IRL,5,0,0,5,10
2015,Liberia,LBR,Ireland,IRL,0,0,5,0,5
2015,Lebanon,LBN,Ireland,IRL,0,0,5,0,5
2015,Mali,MLI,Ireland,IRL,5,0,0,0,5
2015,Malawi,MWI,Ireland,IRL,0,0,18,5,23
2015,Mauritius,MUS,Ireland,IRL,0,0,5,0,5
2015,Myanmar,MMR,Ireland,IRL,5,0,0,0,5
2015,Niger,NER,Ireland,IRL,0,0,5,0,5
2015,Nigeria,NGA,Ireland,IRL,13,0,78,86,177
2015,Pakistan,PAK,Ireland,IRL,26,0,21,26,73
2015,South Africa,ZAF,Ireland,IRL,5,0,11,10,26
2015,Russian Federation,RUS,Ireland,IRL,0,0,5,0,5
2015,Rwanda,RWA,Ireland,IRL,0,0,5,0,5
2015,Serbia and Kosovo: S/RES/1244 (1999),SRB,Ireland,IRL,0,0,5,0,5
2015,Somalia,SOM,Ireland,IRL,5,0,0,0,5
2015,Sudan,SDN,Ireland,IRL,12,0,5,0,17
2015,Uganda,UGA,Ireland,IRL,5,0,0,0,5
2015,Ukraine,UKR,Ireland,IRL,5,0,5,0,10
2015,Yemen,YEM,Ireland,IRL,5,0,0,0,5
2015,Zimbabwe,ZWE,Ireland,IRL,12,0,26,10,48
2015,Sri Lanka,LKA,Japan,JPN,5,0,0,0,5
2015,Afghanistan,AFG,Kazakhstan,KAZ,0,0,0,14,14
2015,Syrian Arab Rep.,SYR,Kazakhstan,KAZ,0,0,0,10,10
2015,Ukraine,UKR,Kazakhstan,KAZ,0,0,0,12,12
2015,Uzbekistan,UZB,Kazakhstan,KAZ,0,0,0,5,5
2015,Albania,ALB,Luxembourg,LUX,0,0,53,5,58
2015,Algeria,DZA,Luxembourg,LUX,0,0,5,0,5
2015,Azerbaijan,AZE,Luxembourg,LUX,0,0,5,0,5
2015,Benin,BEN,Luxembourg,LUX,0,0,5,0,5
2015,Bosnia and Herzegovina,BIH,Luxembourg,LUX,0,0,95,5,100
2015,Cameroon,CMR,Luxembourg,LUX,0,0,0,5,5
2015,Dem. Rep. of the Congo,COD,Luxembourg,LUX,11,0,0,0,11
2015,Eritrea,ERI,Luxembourg,LUX,0,5,0,0,5
2015,Ethiopia,ETH,Luxembourg,LUX,5,0,0,0,5
2015,Gambia,GMB,Luxembourg,LUX,0,0,5,0,5
2015,Guinea,GIN,Luxembourg,LUX,0,0,5,0,5
2015,Iran (Islamic Rep. of),IRN,Luxembourg,LUX,0,0,5,0,5
2015,Libya,LBY,Luxembourg,LUX,0,0,5,0,5
2015,North Macedonia,MKD,Luxembourg,LUX,0,0,20,0,20
2015,Morocco,MAR,Luxembourg,LUX,0,0,5,0,5
2015,Montenegro,MNE,Luxembourg,LUX,0,0,75,10,85
2015,Niger,NER,Luxembourg,LUX,0,0,10,0,10
2015,Russian Federation,RUS,Luxembourg,LUX,0,0,5,0,5
2015,Serbia and Kosovo: S/RES/1244 (1999),SRB,Luxembourg,LUX,10,0,121,24,155
2015,Somalia,SOM,Luxembourg,LUX,0,0,5,0,5
2015,Syrian Arab Rep.,SYR,Luxembourg,LUX,0,0,0,10,10
2015,Tunisia,TUN,Luxembourg,LUX,0,0,14,0,14
2015,Turkey,TUR,Luxembourg,LUX,0,0,20,0,20
2015,Burundi,BDI,Malawi,MWI,0,0,0,15,15
2015,Rwanda,RWA,Malawi,MWI,0,0,427,0,427
2015,Eritrea,ERI,Malta,MLT,0,0,10,0,10
2015,Ethiopia,ETH,Malta,MLT,0,0,11,0,11
2015,Gambia,GMB,Malta,MLT,0,0,5,0,5
2015,Guinea,GIN,Malta,MLT,0,0,10,0,10
2015,Cote d'Ivoire,CIV,Malta,MLT,0,0,12,0,12
2015,Libya,LBY,Malta,MLT,0,0,11,0,11
2015,Mali,MLI,Malta,MLT,0,0,14,0,14
2015,Nigeria,NGA,Malta,MLT,0,0,18,0,18
2015,Senegal,SEN,Malta,MLT,0,0,25,0,25
2015,Somalia,SOM,Malta,MLT,0,0,10,0,10
2015,Syrian Arab Rep.,SYR,Malta,MLT,13,0,0,0,13
2015,Afghanistan,AFG,Norway,NOR,40,17,559,19,635
2015,Albania,ALB,Norway,NOR,0,0,213,10,223
2015,Algeria,DZA,Norway,NOR,0,0,68,0,68
2015,Angola,AGO,Norway,NOR,0,0,11,0,11
2015,Egypt,EGY,Norway,NOR,0,0,41,0,41
2015,Armenia,ARM,Norway,NOR,0,0,13,0,13
2015,Azerbaijan,AZE,Norway,NOR,0,0,17,5,22
2015,Burundi,BDI,Norway,NOR,0,0,12,0,12
2015,Bangladesh,BGD,Norway,NOR,0,0,60,11,71
2015,Belarus,BLR,Norway,NOR,0,0,13,0,13
2015,Bosnia and Herzegovina,BIH,Norway,NOR,0,0,23,0,23
2015,Chad,TCD,Norway,NOR,0,0,5,0,5
2015,China,CHN,Norway,NOR,0,0,12,0,12
2015,Cameroon,CMR,Norway,NOR,0,0,5,0,5
2015,Dem. Rep. of the Congo,COD,Norway,NOR,0,5,21,0,26
2015,Cuba,CUB,Norway,NOR,0,0,5,0,5
2015,Djibouti,DJI,Norway,NOR,0,0,10,0,10
2015,Eritrea,ERI,Norway,NOR,12,0,591,21,624
2015,Ethiopia,ETH,Norway,NOR,10,0,303,10,323
2015,France,FRA,Norway,NOR,0,0,5,0,5
2015,Gambia,GMB,Norway,NOR,0,0,17,0,17
2015,Georgia,GEO,Norway,NOR,0,0,25,0,25
2015,Ghana,GHA,Norway,NOR,0,0,22,5,27
2015,Guinea,GIN,Norway,NOR,0,0,29,0,29
2015,Hungary,HUN,Norway,NOR,0,0,5,0,5
2015,Cote d'Ivoire,CIV,Norway,NOR,0,0,14,0,14
2015,India,IND,Norway,NOR,0,0,10,0,10
2015,Iran (Islamic Rep. of),IRN,Norway,NOR,29,0,250,11,290
2015,Iraq,IRQ,Norway,NOR,18,10,424,27,479
2015,Israel,ISR,Norway,NOR,0,0,5,0,5
2015,Jordan,JOR,Norway,NOR,0,0,34,0,34
2015,Kazakhstan,KAZ,Norway,NOR,0,0,17,0,17
2015,Kenya,KEN,Norway,NOR,0,0,5,0,5
2015,Kyrgyzstan,KGZ,Norway,NOR,0,0,5,0,5
2015,Liberia,LBR,Norway,NOR,0,0,12,0,12
2015,Libya,LBY,Norway,NOR,0,0,41,0,41
2015,Lebanon,LBN,Norway,NOR,0,0,33,0,33
2015,Sri Lanka,LKA,Norway,NOR,0,0,33,0,33
2015,Mauritania,MRT,Norway,NOR,0,0,5,0,5
2015,North Macedonia,MKD,Norway,NOR,0,0,34,0,34
2015,Mali,MLI,Norway,NOR,0,0,10,0,10
2015,Mongolia,MNG,Norway,NOR,0,0,5,0,5
2015,Morocco,MAR,Norway,NOR,0,0,97,0,97
2015,Montenegro,MNE,Norway,NOR,0,0,15,0,15
2015,Myanmar,MMR,Norway,NOR,0,0,10,0,10
2015,Nepal,NPL,Norway,NOR,0,0,14,0,14
2015,Niger,NER,Norway,NOR,0,0,10,0,10
2015,Nigeria,NGA,Norway,NOR,5,0,222,13,240
2015,Pakistan,PAK,Norway,NOR,0,0,177,10,187
2015,Philippines,PHL,Norway,NOR,0,0,5,0,5
2015,Poland,POL,Norway,NOR,0,0,5,0,5
2015,Romania,ROU,Norway,NOR,0,0,10,0,10
2015,Russian Federation,RUS,Norway,NOR,5,0,150,13,168
2015,Rwanda,RWA,Norway,NOR,0,0,13,0,13
2015,El Salvador,SLV,Norway,NOR,0,0,12,0,12
2015,Serbia and Kosovo: S/RES/1244 (1999),SRB,Norway,NOR,0,0,174,18,192
2015,Senegal,SEN,Norway,NOR,0,0,11,0,11
2015,Sierra Leone,SLE,Norway,NOR,0,0,15,0,15
2015,Somalia,SOM,Norway,NOR,5,0,709,5,719
2015,Spain,ESP,Norway,NOR,0,0,5,0,5
2015,Viet Nam,VNM,Norway,NOR,0,0,13,0,13
2015,Sudan,SDN,Norway,NOR,5,0,142,5,152
2015,South Sudan,SSD,Norway,NOR,0,0,10,0,10
2015,Syrian Arab Rep.,SYR,Norway,NOR,5,15,235,10,265
2015,United Rep. of Tanzania,TZA,Norway,NOR,0,0,5,0,5
2015,Tajikistan,TJK,Norway,NOR,0,0,18,0,18
2015,Tunisia,TUN,Norway,NOR,0,0,41,0,41
2015,Turkey,TUR,Norway,NOR,0,0,39,10,49
2015,Uganda,UGA,Norway,NOR,5,0,36,0,41
2015,Ukraine,UKR,Norway,NOR,0,0,73,5,78
2015,Uzbekistan,UZB,Norway,NOR,39,0,29,10,78
2015,Venezuela (Bolivarian Republic of),VEN,Norway,NOR,0,0,5,0,5
2015,Yemen,YEM,Norway,NOR,0,49,21,0,70
2015,Stateless,XXA,Norway,NOR,13,10,209,10,242
2015,Algeria,DZA,South Africa,ZAF,0,0,0,12,12
2015,Egypt,EGY,South Africa,ZAF,0,0,38,42,80
2015,Burundi,BDI,South Africa,ZAF,5,0,89,88,182
2015,Benin,BEN,South Africa,ZAF,0,0,10,5,15
2015,Bangladesh,BGD,South Africa,ZAF,0,0,345,398,743
2015,Burkina Faso,BFA,South Africa,ZAF,0,0,5,0,5
2015,China,CHN,South Africa,ZAF,0,0,250,89,339
2015,Cameroon,CMR,South Africa,ZAF,0,0,215,62,277
2015,Congo,COG,South Africa,ZAF,0,0,12,36,48
2015,Dem. Rep. of the Congo,COD,South Africa,ZAF,82,0,606,586,1274
2015,Eritrea,ERI,South Africa,ZAF,5,0,0,11,16
2015,Ethiopia,ETH,South Africa,ZAF,10,0,501,841,1352
2015,Fiji,FJI,South Africa,ZAF,0,0,5,0,5
2015,Gabon,GAB,South Africa,ZAF,0,0,0,5,5
2015,Gambia,GMB,South Africa,ZAF,0,0,0,5,5
2015,Ghana,GHA,South Africa,ZAF,0,0,750,114,864
2015,Guinea,GIN,South Africa,ZAF,0,0,0,5,5
2015,Hungary,HUN,South Africa,ZAF,0,0,12,5,17
2015,Cote d'Ivoire,CIV,South Africa,ZAF,0,0,10,12,22
2015,India,IND,South Africa,ZAF,0,0,120,352,472
2015,Kenya,KEN,South Africa,ZAF,0,0,49,31,80
2015,Liberia,LBR,South Africa,ZAF,0,0,5,5,10
2015,Lesotho,LSO,South Africa,ZAF,0,0,341,5,346
2015,Sri Lanka,LKA,South Africa,ZAF,0,0,0,5,5
2015,Mali,MLI,South Africa,ZAF,0,0,5,5,10
2015,Malawi,MWI,South Africa,ZAF,0,0,1151,197,1348
2015,Mozambique,MOZ,South Africa,ZAF,0,0,339,91,430
2015,Nepal,NPL,South Africa,ZAF,0,0,18,12,30
2015,Niger,NER,South Africa,ZAF,0,0,20,0,20
2015,Nigeria,NGA,South Africa,ZAF,0,0,2895,385,3280
2015,Pakistan,PAK,South Africa,ZAF,0,0,381,453,834
2015,Russian Federation,RUS,South Africa,ZAF,0,0,0,5,5
2015,Rwanda,RWA,South Africa,ZAF,5,0,12,15,32
2015,Senegal,SEN,South Africa,ZAF,0,0,63,30,93
2015,Sierra Leone,SLE,South Africa,ZAF,0,0,10,0,10
2015,Somalia,SOM,South Africa,ZAF,11,0,94,115,220
2015,Sudan,SDN,South Africa,ZAF,0,0,0,5,5
2015,Eswatini,SWZ,South Africa,ZAF,0,0,16,5,21
2015,United Rep. of Tanzania,TZA,South Africa,ZAF,0,0,230,81,311
2015,Thailand,THA,South Africa,ZAF,0,0,10,0,10
2015,Togo,TGO,South Africa,ZAF,0,0,5,0,5
2015,Tunisia,TUN,South Africa,ZAF,0,0,13,0,13
2015,Uganda,UGA,South Africa,ZAF,0,0,242,130,372
2015,Zambia,ZMB,South Africa,ZAF,0,0,61,11,72
2015,Zimbabwe,ZWE,South Africa,ZAF,0,0,9323,595,9918
2015,Afghanistan,AFG,Sweden,SWE,40,47,552,45,684
2015,Albania,ALB,Sweden,SWE,5,5,1231,83,1324
2015,Algeria,DZA,Sweden,SWE,0,0,82,13,95
2015,Angola,AGO,Sweden,SWE,0,0,5,0,5
2015,Egypt,EGY,Sweden,SWE,0,5,121,24,150
2015,Armenia,ARM,Sweden,SWE,0,16,136,30,182
2015,Azerbaijan,AZE,Sweden,SWE,5,11,85,16,117
2015,Burundi,BDI,Sweden,SWE,0,0,5,5,10
2015,Bangladesh,BGD,Sweden,SWE,5,5,91,11,112
2015,Burkina Faso,BFA,Sweden,SWE,0,0,5,0,5
2015,Belarus,BLR,Sweden,SWE,0,0,50,11,61
2015,Bolivia (Plurinational State of),BOL,Sweden,SWE,0,0,22,0,22
2015,Brazil,BRA,Sweden,SWE,0,0,5,0,5
2015,Bosnia and Herzegovina,BIH,Sweden,SWE,0,0,208,43,251
2015,Bulgaria,BGR,Sweden,SWE,0,0,5,0,5
2015,Canada,CAN,Sweden,SWE,0,0,5,0,5
2015,Chad,TCD,Sweden,SWE,0,0,5,0,5
2015,China,CHN,Sweden,SWE,0,0,14,0,14
2015,Chile,CHL,Sweden,SWE,0,0,13,0,13
2015,Cameroon,CMR,Sweden,SWE,0,0,18,5,23
2015,Congo,COG,Sweden,SWE,0,0,10,0,10
2015,Dem. Rep. of the Congo,COD,Sweden,SWE,0,0,29,5,34
2015,Colombia,COL,Sweden,SWE,0,0,12,0,12
2015,Cuba,CUB,Sweden,SWE,0,0,18,5,23
2015,Djibouti,DJI,Sweden,SWE,0,0,19,0,19
2015,Ecuador,ECU,Sweden,SWE,0,0,5,0,5
2015,Eritrea,ERI,Sweden,SWE,0,0,173,25,198
2015,Ethiopia,ETH,Sweden,SWE,5,5,177,15,202
2015,Gambia,GMB,Sweden,SWE,0,0,66,5,71
2015,Palestinian,PSE,Sweden,SWE,5,5,79,17,106
2015,Georgia,GEO,Sweden,SWE,0,0,227,27,254
2015,Ghana,GHA,Sweden,SWE,0,0,20,0,20
2015,Guinea-Bissau,GNB,Sweden,SWE,0,0,5,0,5
2015,Guatemala,GTM,Sweden,SWE,0,0,5,0,5
2015,Guinea,GIN,Sweden,SWE,0,0,17,0,17
2015,Honduras,HND,Sweden,SWE,0,0,5,0,5
2015,Croatia,HRV,Sweden,SWE,0,0,10,0,10
2015,Cote d'Ivoire,CIV,Sweden,SWE,0,0,13,0,13
2015,India,IND,Sweden,SWE,0,0,14,0,14
2015,Iran (Islamic Rep. of),IRN,Sweden,SWE,32,10,168,18,228
2015,Iraq,IRQ,Sweden,SWE,42,31,549,59,681
2015,Israel,ISR,Sweden,SWE,0,0,10,0,10
2015,Jordan,JOR,Sweden,SWE,0,0,64,14,78
2015,Kazakhstan,KAZ,Sweden,SWE,0,10,94,5,109
2015,Kenya,KEN,Sweden,SWE,0,0,12,0,12
2015,Kyrgyzstan,KGZ,Sweden,SWE,0,0,53,5,58
2015,Kuwait,KWT,Sweden,SWE,0,0,5,0,5
2015,Liberia,LBR,Sweden,SWE,0,0,5,0,5
2015,Libya,LBY,Sweden,SWE,0,5,71,12,88
2015,Lebanon,LBN,Sweden,SWE,0,19,230,21,270
2015,Sri Lanka,LKA,Sweden,SWE,0,0,11,0,11
2015,Madagascar,MDG,Sweden,SWE,0,0,5,0,5
2015,Mauritania,MRT,Sweden,SWE,0,0,5,0,5
2015,North Macedonia,MKD,Sweden,SWE,0,5,201,22,228
2015,Rep. of Moldova,MDA,Sweden,SWE,0,0,12,0,12
2015,Mexico,MEX,Sweden,SWE,0,0,10,0,10
2015,Mali,MLI,Sweden,SWE,0,0,10,0,10
2015,Mongolia,MNG,Sweden,SWE,0,10,237,5,252
2015,Morocco,MAR,Sweden,SWE,0,0,206,26,232
2015,Montenegro,MNE,Sweden,SWE,0,0,63,5,68
2015,Nepal,NPL,Sweden,SWE,0,0,5,0,5
2015,Nicaragua,NIC,Sweden,SWE,0,0,5,0,5
2015,Nigeria,NGA,Sweden,SWE,0,0,158,18,176
2015,Pakistan,PAK,Sweden,SWE,0,0,115,14,129
2015,Peru,PER,Sweden,SWE,0,0,5,0,5
2015,Philippines,PHL,Sweden,SWE,0,0,11,0,11
2015,Poland,POL,Sweden,SWE,0,0,0,5,5
2015,Romania,ROU,Sweden,SWE,0,5,16,5,26
2015,South Africa,ZAF,Sweden,SWE,0,0,5,0,5
2015,Russian Federation,RUS,Sweden,SWE,13,12,244,16,285
2015,Rwanda,RWA,Sweden,SWE,0,0,5,0,5
2015,El Salvador,SLV,Sweden,SWE,0,10,31,0,41
2015,Serbia and Kosovo: S/RES/1244 (1999),SRB,Sweden,SWE,0,40,1535,154,1729
2015,Senegal,SEN,Sweden,SWE,0,0,21,0,21
2015,Sierra Leone,SLE,Sweden,SWE,0,0,11,0,11
2015,Somalia,SOM,Sweden,SWE,28,25,857,67,977
2015,Viet Nam,VNM,Sweden,SWE,0,0,17,5,22
2015,Sudan,SDN,Sweden,SWE,0,5,83,5,93
2015,Syrian Arab Rep.,SYR,Sweden,SWE,0,10,606,78,694
2015,United Rep. of Tanzania,TZA,Sweden,SWE,0,0,18,0,18
2015,Tajikistan,TJK,Sweden,SWE,0,0,13,0,13
2015,Togo,TGO,Sweden,SWE,0,0,5,0,5
2015,Tunisia,TUN,Sweden,SWE,0,0,54,0,54
2015,Turkey,TUR,Sweden,SWE,0,10,79,12,101
2015,United Arab Emirates,ARE,Sweden,SWE,0,0,5,0,5
2015,Uganda,UGA,Sweden,SWE,5,0,47,0,52
2015,Ukraine,UKR,Sweden,SWE,5,5,358,37,405
2015,United States of America,USA,Sweden,SWE,0,0,5,5,10
2015,Uzbekistan,UZB,Sweden,SWE,0,0,46,37,83
2015,Venezuela (Bolivarian Republic of),VEN,Sweden,SWE,0,0,15,5,20
2015,Yemen,YEM,Sweden,SWE,0,5,33,23,61
2015,Zambia,ZMB,Sweden,SWE,0,0,5,0,5
2015,Stateless,XXA,Sweden,SWE,10,36,405,86,537
2016,Afghanistan,AFG,Australia,AUS,43,0,21,0,64
2016,Albania,ALB,Australia,AUS,0,0,5,0,5
2016,Egypt,EGY,Australia,AUS,19,0,54,10,83
2016,Bangladesh,BGD,Australia,AUS,23,0,207,10,240
2016,Brazil,BRA,Australia,AUS,0,0,5,0,5
2016,Cambodia,KHM,Australia,AUS,0,0,5,0,5
2016,China,CHN,Australia,AUS,44,0,3535,51,3630
2016,Cameroon,CMR,Australia,AUS,0,0,5,0,5
2016,Dem. Rep. of the Congo,COD,Australia,AUS,5,0,0,0,5
2016,Colombia,COL,Australia,AUS,5,0,5,0,10
2016,Ethiopia,ETH,Australia,AUS,13,0,0,0,13
2016,Fiji,FJI,Australia,AUS,10,0,116,16,142
2016,Georgia,GEO,Australia,AUS,0,0,5,0,5
2016,Germany,DEU,Australia,AUS,0,0,5,0,5
2016,Ghana,GHA,Australia,AUS,0,0,5,0,5
2016,India,IND,Australia,AUS,16,0,244,62,322
2016,Indonesia,IDN,Australia,AUS,5,0,26,5,36
2016,Ireland,IRL,Australia,AUS,0,0,5,0,5
2016,Iran (Islamic Rep. of),IRN,Australia,AUS,90,0,73,10,173
2016,Iraq,IRQ,Australia,AUS,12,0,13,5,30
2016,Italy,ITA,Australia,AUS,5,0,0,0,5
2016,Jordan,JOR,Australia,AUS,10,0,15,0,25
2016,Kenya,KEN,Australia,AUS,0,0,14,0,14
2016,Rep. of Korea,KOR,Australia,AUS,0,0,14,5,19
2016,Libya,LBY,Australia,AUS,5,0,0,0,5
2016,Lebanon,LBN,Australia,AUS,16,0,73,16,105
2016,Sri Lanka,LKA,Australia,AUS,80,0,244,5,329
2016,Malaysia,MYS,Australia,AUS,22,0,904,275,1201
2016,Mongolia,MNG,Australia,AUS,0,0,12,0,12
2016,Myanmar,MMR,Australia,AUS,5,0,5,0,10
2016,Nepal,NPL,Australia,AUS,5,0,120,12,137
2016,Nigeria,NGA,Australia,AUS,10,0,17,0,27
2016,New Zealand,NZL,Australia,AUS,0,0,5,0,5
2016,Pakistan,PAK,Australia,AUS,84,0,221,38,343
2016,Peru,PER,Australia,AUS,0,0,5,0,5
2016,Philippines,PHL,Australia,AUS,0,0,12,5,17
2016,Papua New Guinea,PNG,Australia,AUS,12,0,18,0,30
2016,South Africa,ZAF,Australia,AUS,0,0,5,0,5
2016,Russian Federation,RUS,Australia,AUS,0,0,5,0,5
2016,Rwanda,RWA,Australia,AUS,5,0,0,0,5
2016,Saudi Arabia,SAU,Australia,AUS,0,0,5,0,5
2016,Solomon Islands,SLB,Australia,AUS,5,0,0,0,5
2016,Somalia,SOM,Australia,AUS,5,0,0,0,5
2016,Viet Nam,VNM,Australia,AUS,12,0,91,5,108
2016,Syrian Arab Rep.,SYR,Australia,AUS,5,0,0,0,5
2016,United Rep. of Tanzania,TZA,Australia,AUS,0,0,0,5,5
2016,Thailand,THA,Australia,AUS,0,0,0,5,5
2016,Tonga,TON,Australia,AUS,0,0,22,0,22
2016,Tunisia,TUN,Australia,AUS,5,0,0,0,5
2016,Turkey,TUR,Australia,AUS,10,0,10,5,25
2016,Uganda,UGA,Australia,AUS,5,0,0,0,5
2016,Ukraine,UKR,Australia,AUS,0,0,5,0,5
2016,Zambia,ZMB,Australia,AUS,0,0,5,0,5
2016,Zimbabwe,ZWE,Australia,AUS,10,0,15,0,25
2016,Stateless,XXA,Australia,AUS,18,0,14,0,32
2016,Afghanistan,AFG,Azerbaijan,AZE,12,0,0,0,12
2016,Dem. Rep. of the Congo,COD,Burundi,BDI,127,0,175,180,482
2016,Rwanda,RWA,Burundi,BDI,11,0,14,18,43
2016,Eritrea,ERI,Cambodia,KHM,0,0,0,5,5
2016,Venezuela (Bolivarian Republic of),VEN,Colombia,COL,0,0,5,0,5
2016,Colombia,COL,Costa Rica,CRI,25,0,345,136,506
2016,Cuba,CUB,Costa Rica,CRI,0,0,33,11,44
2016,Ecuador,ECU,Costa Rica,CRI,0,0,5,0,5
2016,Guatemala,GTM,Costa Rica,CRI,0,0,10,5,15
2016,Honduras,HND,Costa Rica,CRI,12,0,5,11,28
2016,Niger,NER,Costa Rica,CRI,0,0,10,0,10
2016,Nicaragua,NIC,Costa Rica,CRI,0,0,14,0,14
2016,Peru,PER,Costa Rica,CRI,0,0,5,0,5
2016,Russian Federation,RUS,Costa Rica,CRI,0,0,5,0,5
2016,El Salvador,SLV,Costa Rica,CRI,30,0,52,17,99
2016,Venezuela (Bolivarian Republic of),VEN,Costa Rica,CRI,5,0,19,5,29
2016,Egypt,EGY,Cyprus,CYP,0,0,10,13,23
2016,Bangladesh,BGD,Cyprus,CYP,0,0,10,5,15
2016,Palestinian,PSE,Cyprus,CYP,0,44,0,0,44
2016,India,IND,Cyprus,CYP,0,0,12,10,22
2016,Iraq,IRQ,Cyprus,CYP,0,16,5,147,168
2016,Lebanon,LBN,Cyprus,CYP,0,0,0,5,5
2016,Sri Lanka,LKA,Cyprus,CYP,0,0,10,5,15
2016,Nigeria,NGA,Cyprus,CYP,0,0,5,0,5
2016,Pakistan,PAK,Cyprus,CYP,0,0,10,23,33
2016,Philippines,PHL,Cyprus,CYP,0,0,5,0,5
2016,Sierra Leone,SLE,Cyprus,CYP,0,0,5,0,5
2016,Viet Nam,VNM,Cyprus,CYP,0,0,29,12,41
2016,Syrian Arab Rep.,SYR,Cyprus,CYP,14,5,0,10,29
2016,Afghanistan,AFG,Denmark,DNK,25,39,197,0,261
2016,Albania,ALB,Denmark,DNK,0,0,5,0,5
2016,Algeria,DZA,Denmark,DNK,0,0,5,0,5
2016,Egypt,EGY,Denmark,DNK,0,0,14,0,14
2016,Armenia,ARM,Denmark,DNK,0,5,66,0,71
2016,Azerbaijan,AZE,Denmark,DNK,0,0,12,0,12
2016,Burundi,BDI,Denmark,DNK,0,0,5,0,5
2016,Bangladesh,BGD,Denmark,DNK,0,0,14,0,14
2016,Belarus,BLR,Denmark,DNK,0,0,5,0,5
2016,China,CHN,Denmark,DNK,0,0,17,0,17
2016,Dem. Rep. of the Congo,COD,Denmark,DNK,0,0,5,0,5
2016,Eritrea,ERI,Denmark,DNK,5,0,21,0,26
2016,Ethiopia,ETH,Denmark,DNK,5,0,56,0,61
2016,Georgia,GEO,Denmark,DNK,0,0,11,0,11
2016,Ghana,GHA,Denmark,DNK,0,0,5,0,5
2016,Guinea,GIN,Denmark,DNK,0,0,5,0,5
2016,Haiti,HTI,Denmark,DNK,0,0,5,0,5
2016,India,IND,Denmark,DNK,0,0,5,0,5
2016,Iran (Islamic Rep. of),IRN,Denmark,DNK,75,5,109,0,189
2016,Iraq,IRQ,Denmark,DNK,0,10,75,0,85
2016,Kenya,KEN,Denmark,DNK,0,0,5,0,5
2016,Libya,LBY,Denmark,DNK,0,0,10,0,10
2016,Lebanon,LBN,Denmark,DNK,5,0,19,0,24
2016,Sri Lanka,LKA,Denmark,DNK,5,0,10,0,15
2016,North Macedonia,MKD,Denmark,DNK,0,0,10,0,10
2016,Morocco,MAR,Denmark,DNK,0,0,10,0,10
2016,Myanmar,MMR,Denmark,DNK,0,0,16,0,16
2016,Nepal,NPL,Denmark,DNK,0,0,5,0,5
2016,Nigeria,NGA,Denmark,DNK,0,0,24,0,24
2016,Pakistan,PAK,Denmark,DNK,0,0,17,0,17
2016,Russian Federation,RUS,Denmark,DNK,33,0,65,0,98
2016,El Salvador,SLV,Denmark,DNK,0,5,0,0,5
2016,Serbia and Kosovo: S/RES/1244 (1999),SRB,Denmark,DNK,0,0,5,0,5
2016,Somalia,SOM,Denmark,DNK,5,10,104,0,119
2016,Sudan,SDN,Denmark,DNK,5,0,37,0,42
2016,Syrian Arab Rep.,SYR,Denmark,DNK,13,0,18,0,31
2016,Tunisia,TUN,Denmark,DNK,0,0,5,0,5
2016,Turkey,TUR,Denmark,DNK,0,0,5,0,5
2016,Uganda,UGA,Denmark,DNK,0,0,16,0,16
2016,Ukraine,UKR,Denmark,DNK,10,0,33,0,43
2016,Uzbekistan,UZB,Denmark,DNK,0,0,5,0,5
2016,Zambia,ZMB,Denmark,DNK,0,0,5,0,5
2016,Stateless,XXA,Denmark,DNK,5,5,87,0,97
2016,Ukraine,UKR,Fiji,FJI,0,0,0,5,5
2016,Afghanistan,AFG,France,FRA,49,89,77,5,220
2016,Albania,ALB,France,FRA,58,146,1317,211,1732
2016,Algeria,DZA,France,FRA,31,25,428,667,1151
2016,Angola,AGO,France,FRA,42,18,273,5,338
2016,Egypt,EGY,France,FRA,48,0,93,0,141
2016,Armenia,ARM,France,FRA,45,44,732,63,884
2016,Azerbaijan,AZE,France,FRA,87,15,351,12,465
2016,Burundi,BDI,France,FRA,0,0,5,0,5
2016,Benin,BEN,France,FRA,0,0,10,0,10
2016,Bangladesh,BGD,France,FRA,450,74,1714,37,2275
2016,Bhutan,BTN,France,FRA,5,0,23,0,28
2016,Burkina Faso,BFA,France,FRA,0,5,32,0,37
2016,Belarus,BLR,France,FRA,5,0,18,0,23
2016,Brazil,BRA,France,FRA,0,0,5,0,5
2016,Bosnia and Herzegovina,BIH,France,FRA,12,5,93,32,142
2016,Cambodia,KHM,France,FRA,0,0,15,0,15
2016,Central African Rep.,CAF,France,FRA,5,5,38,10,58
2016,Chad,TCD,France,FRA,54,5,172,5,236
2016,China,CHN,France,FRA,22,5,203,1279,1509
2016,Cameroon,CMR,France,FRA,25,10,110,5,150
2016,Congo,COG,France,FRA,38,18,456,22,534
2016,Dem. Rep. of the Congo,COD,France,FRA,508,92,2769,64,3433
2016,Comoros,COM,France,FRA,0,0,62,59,121
2016,Colombia,COL,France,FRA,0,5,25,5,35
2016,Cuba,CUB,France,FRA,0,0,17,5,22
2016,Djibouti,DJI,France,FRA,14,5,0,0,19
2016,Dominican Rep.,DOM,France,FRA,0,5,57,126,188
2016,Eritrea,ERI,France,FRA,137,0,282,17,436
2016,Ethiopia,ETH,France,FRA,23,0,72,0,95
2016,Gabon,GAB,France,FRA,5,0,10,0,15
2016,Gambia,GMB,France,FRA,11,0,95,5,111
2016,Palestinian,PSE,France,FRA,11,0,20,0,31
2016,Georgia,GEO,France,FRA,51,36,800,34,921
2016,Germany,DEU,France,FRA,0,0,5,0,5
2016,Ghana,GHA,France,FRA,0,5,20,0,25
2016,Guinea-Bissau,GNB,France,FRA,0,5,96,11,112
2016,Guinea,GIN,France,FRA,315,86,1183,33,1617
2016,Haiti,HTI,France,FRA,13,32,1258,1642,2945
2016,Cote d'Ivoire,CIV,France,FRA,68,34,578,30,710
2016,India,IND,France,FRA,0,5,59,5,69
2016,Iran (Islamic Rep. of),IRN,France,FRA,14,5,10,0,29
2016,Iraq,IRQ,France,FRA,5,10,26,5,46
2016,Jamaica,JAM,France,FRA,0,0,5,0,5
2016,Kazakhstan,KAZ,France,FRA,17,5,51,0,73
2016,Kenya,KEN,France,FRA,5,0,0,0,5
2016,Kyrgyzstan,KGZ,France,FRA,5,0,27,0,32
2016,Dem. People's Rep. of Korea,PRK,France,FRA,0,0,12,0,12
2016,Liberia,LBR,France,FRA,0,0,11,0,11
2016,Libya,LBY,France,FRA,12,23,37,0,72
2016,Saint Lucia,LCA,France,FRA,0,0,0,5,5
2016,Lebanon,LBN,France,FRA,5,0,13,0,18
2016,Sri Lanka,LKA,France,FRA,317,27,896,47,1287
2016,Madagascar,MDG,France,FRA,0,5,76,5,86
2016,Mauritania,MRT,France,FRA,112,5,452,78,647
2016,North Macedonia,MKD,France,FRA,10,0,112,16,138
2016,Rep. of Moldova,MDA,France,FRA,0,0,16,0,16
2016,Mexico,MEX,France,FRA,0,0,5,0,5
2016,Mali,MLI,France,FRA,47,10,487,301,845
2016,Mongolia,MNG,France,FRA,0,5,64,12,81
2016,Morocco,MAR,France,FRA,31,0,96,5,132
2016,Montenegro,MNE,France,FRA,0,0,50,18,68
2016,Myanmar,MMR,France,FRA,10,0,11,0,21
2016,Nepal,NPL,France,FRA,5,5,63,0,73
2016,Niger,NER,France,FRA,0,0,12,0,12
2016,Nigeria,NGA,France,FRA,139,47,918,25,1129
2016,Pakistan,PAK,France,FRA,68,33,907,732,1740
2016,Peru,PER,France,FRA,0,0,30,5,35
2016,Romania,ROU,France,FRA,5,0,0,5,10
2016,South Africa,ZAF,France,FRA,0,0,5,0,5
2016,Russian Federation,RUS,France,FRA,433,114,1435,76,2058
2016,Rwanda,RWA,France,FRA,24,0,35,0,59
2016,El Salvador,SLV,France,FRA,0,10,0,0,10
2016,Serbia and Kosovo: S/RES/1244 (1999),SRB,France,FRA,176,177,1817,371,2541
2016,Senegal,SEN,France,FRA,39,5,166,17,227
2016,Sierra Leone,SLE,France,FRA,10,0,35,5,50
2016,Somalia,SOM,France,FRA,60,241,249,19,569
2016,Viet Nam,VNM,France,FRA,5,0,13,0,18
2016,Sudan,SDN,France,FRA,299,403,1127,48,1877
2016,Suriname,SUR,France,FRA,0,0,23,12,35
2016,Syrian Arab Rep.,SYR,France,FRA,138,11,168,13,330
2016,United Rep. of Tanzania,TZA,France,FRA,0,0,5,0,5
2016,Tajikistan,TJK,France,FRA,0,0,12,0,12
2016,Togo,TGO,France,FRA,12,5,97,5,119
2016,Tunisia,TUN,France,FRA,10,5,73,5,93
2016,Turkey,TUR,France,FRA,79,13,488,19,599
2016,Uganda,UGA,France,FRA,5,0,0,0,5
2016,Ukraine,UKR,France,FRA,89,13,642,44,788
2016,United States of America,USA,France,FRA,0,0,5,0,5
2016,Uzbekistan,UZB,France,FRA,0,0,11,0,11
2016,Venezuela (Bolivarian Republic of),VEN,France,FRA,0,0,12,0,12
2016,Western Sahara,ESH,France,FRA,20,0,87,11,118
2016,Yemen,YEM,France,FRA,0,0,5,0,5
2016,Afghanistan,AFG,Greece,GRC,5,15,22,0,42
2016,Albania,ALB,Greece,GRC,0,0,236,40,276
2016,Algeria,DZA,Greece,GRC,0,0,167,18,185
2016,Egypt,EGY,Greece,GRC,0,0,97,13,110
2016,Armenia,ARM,Greece,GRC,0,0,5,0,5
2016,Bangladesh,BGD,Greece,GRC,0,0,142,15,157
2016,Burkina Faso,BFA,Greece,GRC,0,0,5,0,5
2016,China,CHN,Greece,GRC,0,0,13,5,18
2016,Cameroon,CMR,Greece,GRC,5,0,12,5,22
2016,Dem. Rep. of the Congo,COD,Greece,GRC,0,0,5,0,5
2016,Dominican Rep.,DOM,Greece,GRC,0,0,5,0,5
2016,Eritrea,ERI,Greece,GRC,0,0,5,0,5
2016,Ethiopia,ETH,Greece,GRC,10,0,0,5,15
2016,Gambia,GMB,Greece,GRC,5,0,5,0,10
2016,Georgia,GEO,Greece,GRC,0,0,124,16,140
2016,Ghana,GHA,Greece,GRC,0,0,12,0,12
2016,Guinea,GIN,Greece,GRC,0,0,10,0,10
2016,Cote d'Ivoire,CIV,Greece,GRC,0,0,13,0,13
2016,India,IND,Greece,GRC,0,0,18,5,23
2016,Iran (Islamic Rep. of),IRN,Greece,GRC,0,0,14,0,14
2016,Iraq,IRQ,Greece,GRC,0,0,14,0,14
2016,Kenya,KEN,Greece,GRC,0,0,5,0,5
2016,Lebanon,LBN,Greece,GRC,0,0,5,0,5
2016,Rep. of Moldova,MDA,Greece,GRC,0,0,5,5,10
2016,Mali,MLI,Greece,GRC,0,5,5,0,10
2016,Morocco,MAR,Greece,GRC,0,0,64,15,79
2016,Nepal,NPL,Greece,GRC,0,0,5,0,5
2016,Nigeria,NGA,Greece,GRC,0,0,62,10,72
2016,Pakistan,PAK,Greece,GRC,15,0,768,42,825
2016,Philippines,PHL,Greece,GRC,0,0,5,0,5
2016,Russian Federation,RUS,Greece,GRC,0,0,5,0,5
2016,Senegal,SEN,Greece,GRC,0,0,13,5,18
2016,Sierra Leone,SLE,Greece,GRC,5,0,5,0,10
2016,Sudan,SDN,Greece,GRC,0,0,0,5,5
2016,Syrian Arab Rep.,SYR,Greece,GRC,200,0,0,5,205
2016,Tunisia,TUN,Greece,GRC,0,0,5,5,10
2016,Turkey,TUR,Greece,GRC,0,0,0,5,5
2016,Uganda,UGA,Greece,GRC,5,0,5,0,10
2016,Ukraine,UKR,Greece,GRC,0,5,28,10,43
2016,Stateless,XXA,Greece,GRC,0,0,5,0,5
2016,Afghanistan,AFG,Ireland,IRL,18,0,0,5,23
2016,Albania,ALB,Ireland,IRL,0,0,28,11,39
2016,Algeria,DZA,Ireland,IRL,0,0,28,10,38
2016,Egypt,EGY,Ireland,IRL,5,0,0,0,5
2016,Bangladesh,BGD,Ireland,IRL,11,0,13,5,29
2016,Bolivia (Plurinational State of),BOL,Ireland,IRL,0,0,5,0,5
2016,Botswana,BWA,Ireland,IRL,0,0,0,5,5
2016,Cameroon,CMR,Ireland,IRL,5,0,12,0,17
2016,Dem. Rep. of the Congo,COD,Ireland,IRL,25,0,14,0,39
2016,Ethiopia,ETH,Ireland,IRL,5,0,0,0,5
2016,Georgia,GEO,Ireland,IRL,5,0,0,0,5
2016,Ghana,GHA,Ireland,IRL,0,0,5,5,10
2016,"China, Hong Kong SAR",HKG,Ireland,IRL,5,0,0,0,5
2016,India,IND,Ireland,IRL,0,0,0,5,5
2016,Iran (Islamic Rep. of),IRN,Ireland,IRL,5,0,0,0,5
2016,Israel,ISR,Ireland,IRL,0,0,5,0,5
2016,Kenya,KEN,Ireland,IRL,0,0,5,0,5
2016,Rep. of Moldova,MDA,Ireland,IRL,5,0,0,0,5
2016,Malawi,MWI,Ireland,IRL,10,0,23,5,38
2016,Mauritius,MUS,Ireland,IRL,0,0,13,0,13
2016,Nigeria,NGA,Ireland,IRL,12,0,82,59,153
2016,Pakistan,PAK,Ireland,IRL,19,0,41,29,89
2016,South Africa,ZAF,Ireland,IRL,12,0,25,5,42
2016,Rwanda,RWA,Ireland,IRL,5,0,5,0,10
2016,Serbia and Kosovo: S/RES/1244 (1999),SRB,Ireland,IRL,5,0,5,0,10
2016,Sierra Leone,SLE,Ireland,IRL,0,0,5,0,5
2016,Somalia,SOM,Ireland,IRL,0,0,5,5,10
2016,Sudan,SDN,Ireland,IRL,10,0,0,0,10
2016,Eswatini,SWZ,Ireland,IRL,10,0,0,0,10
2016,Ukraine,UKR,Ireland,IRL,5,0,11,5,21
2016,Venezuela (Bolivarian Republic of),VEN,Ireland,IRL,5,0,11,0,16
2016,Zimbabwe,ZWE,Ireland,IRL,24,0,30,5,59
2016,Bangladesh,BGD,Japan,JPN,0,0,68,0,68
2016,Ghana,GHA,Japan,JPN,0,0,77,0,77
2016,Indonesia,IDN,Japan,JPN,0,0,290,0,290
2016,Myanmar,MMR,Japan,JPN,0,0,195,0,195
2016,Nepal,NPL,Japan,JPN,0,0,277,0,277
2016,Pakistan,PAK,Japan,JPN,0,0,84,0,84
2016,Philippines,PHL,Japan,JPN,0,0,124,0,124
2016,Viet Nam,VNM,Japan,JPN,0,0,175,0,175
2016,Turkey,TUR,Japan,JPN,0,0,373,0,373
2016,Afghanistan,AFG,Kazakhstan,KAZ,0,0,0,5,5
2016,Afghanistan,AFG,Luxembourg,LUX,0,0,5,0,5
2016,Albania,ALB,Luxembourg,LUX,0,0,66,11,77
2016,Algeria,DZA,Luxembourg,LUX,0,0,5,5,10
2016,Azerbaijan,AZE,Luxembourg,LUX,0,0,10,0,10
2016,Belarus,BLR,Luxembourg,LUX,0,0,5,0,5
2016,Bosnia and Herzegovina,BIH,Luxembourg,LUX,0,0,31,5,36
2016,Cameroon,CMR,Luxembourg,LUX,0,0,0,5,5
2016,Eritrea,ERI,Luxembourg,LUX,0,0,0,5,5
2016,Palestinian,PSE,Luxembourg,LUX,0,0,0,10,10
2016,Georgia,GEO,Luxembourg,LUX,0,0,5,0,5
2016,Guinea,GIN,Luxembourg,LUX,0,0,5,0,5
2016,Cote d'Ivoire,CIV,Luxembourg,LUX,0,0,5,0,5
2016,Iran (Islamic Rep. of),IRN,Luxembourg,LUX,5,0,0,0,5
2016,Iraq,IRQ,Luxembourg,LUX,5,0,0,17,22
2016,North Macedonia,MKD,Luxembourg,LUX,0,0,5,0,5
2016,Montenegro,MNE,Luxembourg,LUX,0,0,16,5,21
2016,Nigeria,NGA,Luxembourg,LUX,0,0,13,5,18
2016,Serbia and Kosovo: S/RES/1244 (1999),SRB,Luxembourg,LUX,0,0,124,27,151
2016,Somalia,SOM,Luxembourg,LUX,0,0,5,0,5
2016,Syrian Arab Rep.,SYR,Luxembourg,LUX,0,0,0,5,5
2016,Togo,TGO,Luxembourg,LUX,0,0,5,0,5
2016,Tunisia,TUN,Luxembourg,LUX,0,0,5,0,5
2016,Ukraine,UKR,Luxembourg,LUX,0,0,5,0,5
2016,Burundi,BDI,Malawi,MWI,0,0,38,99,137
2016,Dem. Rep. of the Congo,COD,Malawi,MWI,0,0,0,93,93
2016,Rwanda,RWA,Malawi,MWI,0,0,57,107,164
2016,Zambia,ZMB,Malawi,MWI,0,0,0,5,5
2016,Algeria,DZA,Malta,MLT,0,0,5,0,5
2016,Egypt,EGY,Malta,MLT,0,0,13,0,13
2016,Bangladesh,BGD,Malta,MLT,0,0,0,5,5
2016,Burkina Faso,BFA,Malta,MLT,0,0,5,0,5
2016,Comoros,COM,Malta,MLT,0,0,5,0,5
2016,Eritrea,ERI,Malta,MLT,0,5,5,28,38
2016,Ethiopia,ETH,Malta,MLT,0,5,0,21,26
2016,Gambia,GMB,Malta,MLT,0,5,5,14,24
2016,Palestinian,PSE,Malta,MLT,0,0,0,5,5
2016,Guinea,GIN,Malta,MLT,0,0,5,0,5
2016,Cote d'Ivoire,CIV,Malta,MLT,0,0,5,0,5
2016,Libya,LBY,Malta,MLT,5,0,5,14,24
2016,North Macedonia,MKD,Malta,MLT,0,0,5,0,5
2016,Mali,MLI,Malta,MLT,0,0,25,14,39
2016,Morocco,MAR,Malta,MLT,0,0,5,0,5
2016,Nepal,NPL,Malta,MLT,0,0,0,5,5
2016,Nigeria,NGA,Malta,MLT,5,0,14,5,24
2016,Pakistan,PAK,Malta,MLT,0,0,0,5,5
2016,Sierra Leone,SLE,Malta,MLT,0,5,0,0,5
2016,Somalia,SOM,Malta,MLT,5,5,19,15,44
2016,Sudan,SDN,Malta,MLT,0,0,0,12,12
2016,Syrian Arab Rep.,SYR,Malta,MLT,0,0,0,11,11
2016,Togo,TGO,Malta,MLT,0,0,5,0,5
2016,Tunisia,TUN,Malta,MLT,0,0,5,0,5
2016,United States of America,USA,Malta,MLT,0,0,0,5,5
2016,Venezuela (Bolivarian Republic of),VEN,Malta,MLT,0,0,5,0,5
2016,Central African Rep.,CAF,Niger,NER,5,0,0,0,5
2016,Afghanistan,AFG,Norway,NOR,24,0,2252,143,2419
2016,Albania,ALB,Norway,NOR,0,0,92,0,92
2016,Algeria,DZA,Norway,NOR,0,0,44,0,44
2016,Angola,AGO,Norway,NOR,0,0,5,0,5
2016,Egypt,EGY,Norway,NOR,0,0,103,5,108
2016,Armenia,ARM,Norway,NOR,0,0,14,0,14
2016,Azerbaijan,AZE,Norway,NOR,0,0,26,0,26
2016,Burundi,BDI,Norway,NOR,0,0,12,0,12
2016,Bangladesh,BGD,Norway,NOR,0,0,41,0,41
2016,Belarus,BLR,Norway,NOR,0,0,5,0,5
2016,Bosnia and Herzegovina,BIH,Norway,NOR,0,0,10,0,10
2016,China,CHN,Norway,NOR,0,0,17,0,17
2016,Cameroon,CMR,Norway,NOR,0,0,5,0,5
2016,Congo,COG,Norway,NOR,0,0,5,0,5
2016,Dem. Rep. of the Congo,COD,Norway,NOR,0,0,13,0,13
2016,Eritrea,ERI,Norway,NOR,11,0,325,5,341
2016,Ethiopia,ETH,Norway,NOR,5,0,238,5,248
2016,Gambia,GMB,Norway,NOR,0,0,29,0,29
2016,Ghana,GHA,Norway,NOR,0,0,11,0,11
2016,Greece,GRC,Norway,NOR,0,0,5,0,5
2016,Guinea,GIN,Norway,NOR,0,0,13,0,13
2016,Cote d'Ivoire,CIV,Norway,NOR,0,0,10,0,10
2016,India,IND,Norway,NOR,0,0,20,0,20
2016,Iran (Islamic Rep. of),IRN,Norway,NOR,18,0,340,21,379
2016,Iraq,IRQ,Norway,NOR,13,5,658,78,754
2016,Jordan,JOR,Norway,NOR,0,0,27,0,27
2016,Kazakhstan,KAZ,Norway,NOR,0,0,12,0,12
2016,Kyrgyzstan,KGZ,Norway,NOR,0,0,11,5,16
2016,Liberia,LBR,Norway,NOR,0,0,5,0,5
2016,Libya,LBY,Norway,NOR,0,0,11,0,11
2016,Lebanon,LBN,Norway,NOR,0,0,58,0,58
2016,Sri Lanka,LKA,Norway,NOR,0,0,30,0,30
2016,Mauritania,MRT,Norway,NOR,0,0,5,0,5
2016,North Macedonia,MKD,Norway,NOR,0,0,10,0,10
2016,Mali,MLI,Norway,NOR,0,0,5,0,5
2016,Morocco,MAR,Norway,NOR,0,0,49,0,49
2016,Myanmar,MMR,Norway,NOR,0,0,10,0,10
2016,Nepal,NPL,Norway,NOR,0,0,10,0,10
2016,Nigeria,NGA,Norway,NOR,0,0,68,5,73
2016,Pakistan,PAK,Norway,NOR,0,5,101,5,111
2016,Russian Federation,RUS,Norway,NOR,0,0,52,5,57
2016,Rwanda,RWA,Norway,NOR,0,0,5,0,5
2016,El Salvador,SLV,Norway,NOR,0,0,5,0,5
2016,Serbia and Kosovo: S/RES/1244 (1999),SRB,Norway,NOR,0,0,54,0,54
2016,Senegal,SEN,Norway,NOR,0,0,12,0,12
2016,Sierra Leone,SLE,Norway,NOR,0,0,5,0,5
2016,Somalia,SOM,Norway,NOR,0,0,229,19,248
2016,Viet Nam,VNM,Norway,NOR,0,35,5,0,40
2016,Sudan,SDN,Norway,NOR,0,0,104,5,109
2016,Syrian Arab Rep.,SYR,Norway,NOR,0,5,322,180,507
2016,Tajikistan,TJK,Norway,NOR,0,0,15,0,15
2016,Tunisia,TUN,Norway,NOR,0,0,15,0,15
2016,Turkey,TUR,Norway,NOR,0,0,34,5,39
2016,Uganda,UGA,Norway,NOR,0,0,11,5,16
2016,Ukraine,UKR,Norway,NOR,0,0,27,5,32
2016,United States of America,USA,Norway,NOR,0,0,5,0,5
2016,Uzbekistan,UZB,Norway,NOR,19,0,48,5,72
2016,Venezuela (Bolivarian Republic of),VEN,Norway,NOR,0,0,5,0,5
2016,Yemen,YEM,Norway,NOR,0,0,0,11,11
2016,Stateless,XXA,Norway,NOR,36,5,189,31,261
2016,Bangladesh,BGD,Papua New Guinea,PNG,0,0,5,0,5
2016,India,IND,Papua New Guinea,PNG,0,0,5,0,5
2016,Iran (Islamic Rep. of),IRN,Papua New Guinea,PNG,33,0,5,0,38
2016,Iraq,IRQ,Papua New Guinea,PNG,5,0,0,0,5
2016,Pakistan,PAK,Papua New Guinea,PNG,5,0,0,0,5
2016,Afghanistan,AFG,Poland,POL,0,0,5,0,5
2016,Armenia,ARM,Poland,POL,0,0,11,0,11
2016,Azerbaijan,AZE,Poland,POL,0,0,5,0,5
2016,Belarus,BLR,Poland,POL,0,0,5,0,5
2016,Georgia,GEO,Poland,POL,0,0,21,10,31
2016,India,IND,Poland,POL,0,0,5,0,5
2016,Iran (Islamic Rep. of),IRN,Poland,POL,0,0,5,5,10
2016,Iraq,IRQ,Poland,POL,0,0,5,0,5
2016,Kazakhstan,KAZ,Poland,POL,0,0,5,0,5
2016,Kyrgyzstan,KGZ,Poland,POL,0,5,14,0,19
2016,Nigeria,NGA,Poland,POL,0,0,5,0,5
2016,Pakistan,PAK,Poland,POL,0,0,11,0,11
2016,Russian Federation,RUS,Poland,POL,0,5,256,40,301
2016,Viet Nam,VNM,Poland,POL,0,0,23,5,28
2016,Turkey,TUR,Poland,POL,0,0,5,0,5
2016,Ukraine,UKR,Poland,POL,5,5,451,130,591
2016,Uzbekistan,UZB,Poland,POL,0,0,5,0,5
2016,Stateless,XXA,Poland,POL,0,0,5,0,5
2016,Afghanistan,AFG,South Africa,ZAF,0,0,0,5,5
2016,Algeria,DZA,South Africa,ZAF,0,0,0,201,201
2016,Angola,AGO,South Africa,ZAF,0,0,0,45,45
2016,Egypt,EGY,South Africa,ZAF,0,0,0,212,212
2016,Burundi,BDI,South Africa,ZAF,5,0,0,958,963
2016,Benin,BEN,South Africa,ZAF,0,0,0,48,48
2016,Bangladesh,BGD,South Africa,ZAF,0,0,129,7830,7959
2016,Burkina Faso,BFA,South Africa,ZAF,0,0,0,50,50
2016,Botswana,BWA,South Africa,ZAF,0,0,0,10,10
2016,Bulgaria,BGR,South Africa,ZAF,0,0,0,5,5
2016,China,CHN,South Africa,ZAF,0,0,0,655,655
2016,Cameroon,CMR,South Africa,ZAF,0,0,5,642,647
2016,Congo,COG,South Africa,ZAF,0,0,0,337,337
2016,Dem. Rep. of the Congo,COD,South Africa,ZAF,45,0,142,8429,8616
2016,Comoros,COM,South Africa,ZAF,0,0,0,11,11
2016,Czechia,CZE,South Africa,ZAF,0,0,0,5,5
2016,Eritrea,ERI,South Africa,ZAF,5,0,0,305,310
2016,Ethiopia,ETH,South Africa,ZAF,5,0,304,12167,12476
2016,Gabon,GAB,South Africa,ZAF,0,0,0,13,13
2016,Gambia,GMB,South Africa,ZAF,0,0,0,17,17
2016,Palestinian,PSE,South Africa,ZAF,0,0,0,5,5
2016,Ghana,GHA,South Africa,ZAF,0,0,10,1681,1691
2016,Guinea-Bissau,GNB,South Africa,ZAF,0,0,0,5,5
2016,Guinea,GIN,South Africa,ZAF,0,0,0,31,31
2016,Cote d'Ivoire,CIV,South Africa,ZAF,0,0,0,104,104
2016,India,IND,South Africa,ZAF,0,0,67,3863,3930
2016,Iran (Islamic Rep. of),IRN,South Africa,ZAF,0,0,0,5,5
2016,Iraq,IRQ,South Africa,ZAF,0,0,0,5,5
2016,Jamaica,JAM,South Africa,ZAF,0,0,0,5,5
2016,Kenya,KEN,South Africa,ZAF,0,0,10,445,455
2016,Liberia,LBR,South Africa,ZAF,0,0,0,24,24
2016,Libya,LBY,South Africa,ZAF,0,0,0,5,5
2016,Lesotho,LSO,South Africa,ZAF,0,0,0,399,399
2016,Sri Lanka,LKA,South Africa,ZAF,0,0,0,10,10
2016,Madagascar,MDG,South Africa,ZAF,0,0,0,5,5
2016,Mali,MLI,South Africa,ZAF,0,0,0,53,53
2016,Malawi,MWI,South Africa,ZAF,0,0,0,1954,1954
2016,Morocco,MAR,South Africa,ZAF,0,0,0,10,10
2016,Mozambique,MOZ,South Africa,ZAF,0,0,0,746,746
2016,Mauritius,MUS,South Africa,ZAF,0,0,0,5,5
2016,Myanmar,MMR,South Africa,ZAF,0,0,0,5,5
2016,Nepal,NPL,South Africa,ZAF,0,0,0,61,61
2016,Niger,NER,South Africa,ZAF,0,0,0,59,59
2016,Nigeria,NGA,South Africa,ZAF,0,0,37,7410,7447
2016,Pakistan,PAK,South Africa,ZAF,0,0,94,5337,5431
2016,Rwanda,RWA,South Africa,ZAF,0,0,0,199,199
2016,Senegal,SEN,South Africa,ZAF,0,0,5,473,478
2016,Sierra Leone,SLE,South Africa,ZAF,0,0,0,10,10
2016,Somalia,SOM,South Africa,ZAF,5,0,0,1082,1087
2016,Sudan,SDN,South Africa,ZAF,0,0,0,33,33
2016,Eswatini,SWZ,South Africa,ZAF,0,0,0,26,26
2016,Syrian Arab Rep.,SYR,South Africa,ZAF,0,0,0,5,5
2016,United Rep. of Tanzania,TZA,South Africa,ZAF,0,0,5,505,510
2016,Thailand,THA,South Africa,ZAF,0,0,0,21,21
2016,Togo,TGO,South Africa,ZAF,0,0,0,19,19
2016,Uganda,UGA,South Africa,ZAF,0,0,26,1528,1554
2016,Ukraine,UKR,South Africa,ZAF,0,0,0,5,5
2016,Zambia,ZMB,South Africa,ZAF,0,0,0,136,136
2016,Zimbabwe,ZWE,South Africa,ZAF,0,0,14,14726,14740
2016,Afghanistan,AFG,Sweden,SWE,42,95,1525,551,2213
2016,Albania,ALB,Sweden,SWE,5,17,798,78,898
2016,Algeria,DZA,Sweden,SWE,0,0,72,10,82
2016,Angola,AGO,Sweden,SWE,0,0,10,0,10
2016,Egypt,EGY,Sweden,SWE,5,5,122,41,173
2016,Armenia,ARM,Sweden,SWE,0,24,192,18,234
2016,Azerbaijan,AZE,Sweden,SWE,10,19,156,17,202
2016,Burundi,BDI,Sweden,SWE,0,5,14,0,19
2016,Benin,BEN,Sweden,SWE,0,5,0,0,5
2016,Bangladesh,BGD,Sweden,SWE,0,0,84,17,101
2016,Belarus,BLR,Sweden,SWE,0,0,76,13,89
2016,Bolivia (Plurinational State of),BOL,Sweden,SWE,0,5,13,0,18
2016,Brazil,BRA,Sweden,SWE,0,0,11,0,11
2016,Bosnia and Herzegovina,BIH,Sweden,SWE,0,0,138,28,166
2016,Bulgaria,BGR,Sweden,SWE,0,0,5,0,5
2016,Canada,CAN,Sweden,SWE,0,0,5,0,5
2016,Chad,TCD,Sweden,SWE,0,0,5,0,5
2016,China,CHN,Sweden,SWE,5,5,21,5,36
2016,Chile,CHL,Sweden,SWE,0,0,5,5,10
2016,Cameroon,CMR,Sweden,SWE,0,0,24,0,24
2016,Congo,COG,Sweden,SWE,0,0,10,0,10
2016,Dem. Rep. of the Congo,COD,Sweden,SWE,0,0,18,5,23
2016,Colombia,COL,Sweden,SWE,0,0,11,5,16
2016,Cuba,CUB,Sweden,SWE,0,0,35,5,40
2016,Djibouti,DJI,Sweden,SWE,0,0,13,5,18
2016,Ecuador,ECU,Sweden,SWE,0,0,5,0,5
2016,Eritrea,ERI,Sweden,SWE,5,10,197,46,258
2016,Ethiopia,ETH,Sweden,SWE,14,5,266,15,300
2016,Gambia,GMB,Sweden,SWE,0,5,65,5,75
2016,Palestinian,PSE,Sweden,SWE,12,24,168,41,245
2016,Georgia,GEO,Sweden,SWE,0,14,414,30,458
2016,Ghana,GHA,Sweden,SWE,0,0,23,5,28
2016,Guinea-Bissau,GNB,Sweden,SWE,0,0,5,0,5
2016,Greece,GRC,Sweden,SWE,0,0,0,5,5
2016,Guinea,GIN,Sweden,SWE,0,0,17,0,17
2016,Honduras,HND,Sweden,SWE,0,0,5,0,5
2016,Cote d'Ivoire,CIV,Sweden,SWE,0,0,16,0,16
2016,India,IND,Sweden,SWE,0,0,40,5,45
2016,Indonesia,IDN,Sweden,SWE,0,5,0,0,5
2016,Iran (Islamic Rep. of),IRN,Sweden,SWE,29,10,298,59,396
2016,Iraq,IRQ,Sweden,SWE,24,72,954,301,1351
2016,Israel,ISR,Sweden,SWE,0,0,10,0,10
2016,Italy,ITA,Sweden,SWE,0,0,0,5,5
2016,Jordan,JOR,Sweden,SWE,0,5,98,11,114
2016,Kazakhstan,KAZ,Sweden,SWE,0,18,117,13,148
2016,Kenya,KEN,Sweden,SWE,0,0,15,5,20
2016,Kyrgyzstan,KGZ,Sweden,SWE,0,0,68,14,82
2016,Rep. of Korea,KOR,Sweden,SWE,0,0,5,0,5
2016,Kuwait,KWT,Sweden,SWE,0,0,5,0,5
2016,Liberia,LBR,Sweden,SWE,0,0,5,0,5
2016,Libya,LBY,Sweden,SWE,11,0,94,5,110
2016,Lebanon,LBN,Sweden,SWE,0,11,164,19,194
2016,Sri Lanka,LKA,Sweden,SWE,0,0,14,0,14
2016,North Macedonia,MKD,Sweden,SWE,0,0,112,11,123
2016,Rep. of Moldova,MDA,Sweden,SWE,0,0,12,5,17
2016,Mexico,MEX,Sweden,SWE,0,0,5,0,5
2016,Mali,MLI,Sweden,SWE,0,0,5,0,5
2016,Mongolia,MNG,Sweden,SWE,0,11,669,85,765
2016,Morocco,MAR,Sweden,SWE,5,0,187,22,214
2016,Montenegro,MNE,Sweden,SWE,0,0,24,0,24
2016,Nepal,NPL,Sweden,SWE,0,0,12,5,17
2016,Nicaragua,NIC,Sweden,SWE,0,0,0,5,5
2016,Nigeria,NGA,Sweden,SWE,5,5,188,28,226
2016,Pakistan,PAK,Sweden,SWE,10,0,142,24,176
2016,Peru,PER,Sweden,SWE,0,0,5,0,5
2016,Philippines,PHL,Sweden,SWE,0,0,5,0,5
2016,Romania,ROU,Sweden,SWE,0,0,10,0,10
2016,Russian Federation,RUS,Sweden,SWE,5,19,198,30,252
2016,Rwanda,RWA,Sweden,SWE,0,0,10,0,10
2016,El Salvador,SLV,Sweden,SWE,0,0,91,5,96
2016,Saudi Arabia,SAU,Sweden,SWE,0,0,5,0,5
2016,Serbia and Kosovo: S/RES/1244 (1999),SRB,Sweden,SWE,0,10,624,59,693
2016,Senegal,SEN,Sweden,SWE,0,0,19,0,19
2016,Sierra Leone,SLE,Sweden,SWE,0,0,14,0,14
2016,Somalia,SOM,Sweden,SWE,33,21,788,92,934
2016,Spain,ESP,Sweden,SWE,0,0,5,0,5
2016,Viet Nam,VNM,Sweden,SWE,0,0,11,0,11
2016,Saint Kitts and Nevis,KNA,Sweden,SWE,0,0,5,0,5
2016,Sudan,SDN,Sweden,SWE,5,0,90,11,106
2016,Slovakia,SVK,Sweden,SWE,0,0,5,0,5
2016,Syrian Arab Rep.,SYR,Sweden,SWE,0,20,996,893,1909
2016,United Rep. of Tanzania,TZA,Sweden,SWE,0,0,17,0,17
2016,Thailand,THA,Sweden,SWE,0,0,10,0,10
2016,Tajikistan,TJK,Sweden,SWE,0,5,40,0,45
2016,Turkmenistan,TKM,Sweden,SWE,0,0,5,0,5
2016,Togo,TGO,Sweden,SWE,0,0,0,5,5
2016,Tunisia,TUN,Sweden,SWE,0,0,54,10,64
2016,Turkey,TUR,Sweden,SWE,0,0,90,12,102
2016,Uganda,UGA,Sweden,SWE,0,0,34,5,39
2016,Ukraine,UKR,Sweden,SWE,10,11,805,108,934
2016,United States of America,USA,Sweden,SWE,0,0,11,0,11
2016,Uzbekistan,UZB,Sweden,SWE,21,0,128,26,175
2016,Venezuela (Bolivarian Republic of),VEN,Sweden,SWE,0,0,20,5,25
2016,Yemen,YEM,Sweden,SWE,0,25,16,5,46
2016,Zambia,ZMB,Sweden,SWE,0,0,5,0,5
2016,Zimbabwe,ZWE,Sweden,SWE,0,0,5,0,5
2016,Stateless,XXA,Sweden,SWE,5,29,336,155,525
2017,Armenia,ARM,Argentina,ARG,0,0,5,0,5
2017,Bangladesh,BGD,Argentina,ARG,0,0,13,21,34
2017,China,CHN,Argentina,ARG,0,0,5,0,5
2017,Colombia,COL,Argentina,ARG,0,0,16,12,28
2017,Cuba,CUB,Argentina,ARG,0,0,81,15,96
2017,Dominican Rep.,DOM,Argentina,ARG,0,0,31,21,52
2017,Ghana,GHA,Argentina,ARG,0,0,5,5,10
2017,Haiti,HTI,Argentina,ARG,0,0,79,11,90
2017,India,IND,Argentina,ARG,0,0,14,10,24
2017,Nigeria,NGA,Argentina,ARG,0,0,20,13,33
2017,Peru,PER,Argentina,ARG,0,0,0,42,42
2017,Romania,ROU,Argentina,ARG,0,0,0,80,80
2017,South Africa,ZAF,Argentina,ARG,0,0,5,0,5
2017,Senegal,SEN,Argentina,ARG,0,0,841,0,841
2017,Stateless,XXA,Argentina,ARG,0,0,5,0,5
2017,Afghanistan,AFG,Australia,AUS,49,0,154,0,203
2017,Albania,ALB,Australia,AUS,0,0,10,0,10
2017,Algeria,DZA,Australia,AUS,0,0,5,0,5
2017,Egypt,EGY,Australia,AUS,21,0,44,5,70
2017,Bangladesh,BGD,Australia,AUS,18,0,108,14,140
2017,Brazil,BRA,Australia,AUS,0,0,5,0,5
2017,Cambodia,KHM,Australia,AUS,5,0,5,0,10
2017,China,CHN,Australia,AUS,28,0,222,114,364
2017,Cameroon,CMR,Australia,AUS,5,0,0,0,5
2017,Colombia,COL,Australia,AUS,0,0,0,5,5
2017,Ethiopia,ETH,Australia,AUS,24,0,0,0,24
2017,Fiji,FJI,Australia,AUS,5,0,42,21,68
2017,United Kingdom of Great Britain and Northern Ireland,GBR,Australia,AUS,0,0,5,0,5
2017,Ghana,GHA,Australia,AUS,0,0,12,5,17
2017,India,IND,Australia,AUS,12,0,138,59,209
2017,Indonesia,IDN,Australia,AUS,0,0,54,17,71
2017,Ireland,IRL,Australia,AUS,0,0,5,0,5
2017,Iran (Islamic Rep. of),IRN,Australia,AUS,131,0,267,10,408
2017,Iraq,IRQ,Australia,AUS,65,0,179,5,249
2017,Israel,ISR,Australia,AUS,0,0,5,0,5
2017,Italy,ITA,Australia,AUS,0,0,5,0,5
2017,Jordan,JOR,Australia,AUS,0,0,10,5,15
2017,Kenya,KEN,Australia,AUS,0,0,10,0,10
2017,Rep. of Korea,KOR,Australia,AUS,0,0,13,0,13
2017,Kuwait,KWT,Australia,AUS,0,0,5,0,5
2017,Liberia,LBR,Australia,AUS,5,0,0,0,5
2017,Libya,LBY,Australia,AUS,5,0,0,0,5
2017,Lebanon,LBN,Australia,AUS,10,0,60,13,83
2017,Sri Lanka,LKA,Australia,AUS,94,0,1018,14,1126
2017,Malaysia,MYS,Australia,AUS,60,0,2365,1222,3647
2017,Mongolia,MNG,Australia,AUS,0,0,5,0,5
2017,Myanmar,MMR,Australia,AUS,14,0,0,0,14
2017,Nepal,NPL,Australia,AUS,0,0,64,10,74
2017,Nigeria,NGA,Australia,AUS,5,0,10,10,25
2017,New Zealand,NZL,Australia,AUS,0,0,5,0,5
2017,Pakistan,PAK,Australia,AUS,60,0,137,29,226
2017,Philippines,PHL,Australia,AUS,5,0,10,0,15
2017,Papua New Guinea,PNG,Australia,AUS,5,0,26,5,36
2017,South Africa,ZAF,Australia,AUS,0,0,5,5,10
2017,Russian Federation,RUS,Australia,AUS,0,0,0,5,5
2017,Saudi Arabia,SAU,Australia,AUS,0,0,5,0,5
2017,Solomon Islands,SLB,Australia,AUS,0,0,5,0,5
2017,Viet Nam,VNM,Australia,AUS,15,0,179,30,224
2017,Sudan,SDN,Australia,AUS,0,0,10,0,10
2017,Thailand,THA,Australia,AUS,0,0,16,12,28
2017,Tonga,TON,Australia,AUS,0,0,13,0,13
2017,Turkey,TUR,Australia,AUS,5,0,13,0,18
2017,Uganda,UGA,Australia,AUS,5,0,0,0,5
2017,Ukraine,UKR,Australia,AUS,0,0,10,0,10
2017,United States of America,USA,Australia,AUS,0,0,0,5,5
2017,Zimbabwe,ZWE,Australia,AUS,5,0,11,5,21
2017,Stateless,XXA,Australia,AUS,10,0,13,0,23
2017,Dem. Rep. of the Congo,COD,Burundi,BDI,105,0,159,37,301
2017,Rwanda,RWA,Burundi,BDI,0,0,14,10,24
2017,Viet Nam,VNM,Cambodia,KHM,0,0,0,5,5
2017,Afghanistan,AFG,Canada,CAN,5,0,22,0,27
2017,Albania,ALB,Canada,CAN,5,0,27,10,42
2017,Algeria,DZA,Canada,CAN,0,0,10,0,10
2017,Angola,AGO,Canada,CAN,0,0,5,0,5
2017,Antigua and Barbuda,ATG,Canada,CAN,5,0,13,0,18
2017,Egypt,EGY,Canada,CAN,5,0,15,0,20
2017,Azerbaijan,AZE,Canada,CAN,0,0,10,0,10
2017,Barbados,BRB,Canada,CAN,0,0,5,0,5
2017,Burundi,BDI,Canada,CAN,5,0,5,0,10
2017,Belgium,BEL,Canada,CAN,5,0,5,0,10
2017,Bangladesh,BGD,Canada,CAN,0,0,28,0,28
2017,Bahamas,BHS,Canada,CAN,11,0,17,0,28
2017,Burkina Faso,BFA,Canada,CAN,0,0,5,0,5
2017,Botswana,BWA,Canada,CAN,0,0,5,0,5
2017,Brazil,BRA,Canada,CAN,0,0,10,0,10
2017,Chad,TCD,Canada,CAN,0,0,10,0,10
2017,China,CHN,Canada,CAN,5,0,238,5,248
2017,Chile,CHL,Canada,CAN,0,0,21,0,21
2017,Cameroon,CMR,Canada,CAN,0,0,14,0,14
2017,Congo,COG,Canada,CAN,0,0,5,0,5
2017,Dem. Rep. of the Congo,COD,Canada,CAN,5,0,37,0,42
2017,Colombia,COL,Canada,CAN,0,0,73,5,78
2017,Costa Rica,CRI,Canada,CAN,0,0,10,0,10
2017,Cuba,CUB,Canada,CAN,0,0,10,0,10
2017,Czechia,CZE,Canada,CAN,0,0,11,0,11
2017,Djibouti,DJI,Canada,CAN,0,0,20,0,20
2017,Dominican Rep.,DOM,Canada,CAN,5,0,0,0,5
2017,Ecuador,ECU,Canada,CAN,0,0,5,0,5
2017,Eritrea,ERI,Canada,CAN,12,0,27,0,39
2017,Ethiopia,ETH,Canada,CAN,10,0,46,5,61
2017,France,FRA,Canada,CAN,0,0,5,0,5
2017,Gabon,GAB,Canada,CAN,0,0,5,0,5
2017,Gambia,GMB,Canada,CAN,0,0,5,0,5
2017,Palestinian,PSE,Canada,CAN,0,0,15,0,15
2017,Georgia,GEO,Canada,CAN,0,0,12,0,12
2017,Ghana,GHA,Canada,CAN,0,0,23,5,28
2017,Grenada,GRD,Canada,CAN,0,0,5,0,5
2017,Guatemala,GTM,Canada,CAN,0,0,10,0,10
2017,Guinea,GIN,Canada,CAN,5,0,5,0,10
2017,Guyana,GUY,Canada,CAN,0,0,10,0,10
2017,Haiti,HTI,Canada,CAN,0,0,114,0,114
2017,Honduras,HND,Canada,CAN,0,0,12,0,12
2017,Croatia,HRV,Canada,CAN,0,0,10,0,10
2017,Hungary,HUN,Canada,CAN,5,0,81,10,96
2017,India,IND,Canada,CAN,5,0,94,0,99
2017,Iran (Islamic Rep. of),IRN,Canada,CAN,5,0,11,0,16
2017,Iraq,IRQ,Canada,CAN,17,0,35,5,57
2017,Israel,ISR,Canada,CAN,0,0,11,0,11
2017,Italy,ITA,Canada,CAN,0,0,18,0,18
2017,Jamaica,JAM,Canada,CAN,0,0,36,0,36
2017,Jordan,JOR,Canada,CAN,5,0,15,0,20
2017,Kenya,KEN,Canada,CAN,0,0,5,0,5
2017,Kyrgyzstan,KGZ,Canada,CAN,5,0,0,0,5
2017,Libya,LBY,Canada,CAN,17,0,16,0,33
2017,Lebanon,LBN,Canada,CAN,5,0,38,5,48
2017,Sri Lanka,LKA,Canada,CAN,5,0,15,0,20
2017,Mauritania,MRT,Canada,CAN,5,0,0,0,5
2017,Mexico,MEX,Canada,CAN,5,0,45,0,50
2017,Mali,MLI,Canada,CAN,5,0,13,0,18
2017,Mongolia,MNG,Canada,CAN,0,0,5,0,5
2017,Morocco,MAR,Canada,CAN,0,0,5,0,5
2017,Mozambique,MOZ,Canada,CAN,0,0,5,0,5
2017,Mauritius,MUS,Canada,CAN,0,0,5,0,5
2017,Nepal,NPL,Canada,CAN,0,0,17,0,17
2017,Niger,NER,Canada,CAN,0,0,5,0,5
2017,Nigeria,NGA,Canada,CAN,22,0,404,10,436
2017,Pakistan,PAK,Canada,CAN,5,0,69,5,79
2017,Peru,PER,Canada,CAN,0,0,5,0,5
2017,Philippines,PHL,Canada,CAN,0,0,5,0,5
2017,Portugal,PRT,Canada,CAN,0,0,5,0,5
2017,Romania,ROU,Canada,CAN,0,0,5,0,5
2017,South Africa,ZAF,Canada,CAN,0,0,0,5,5
2017,Rwanda,RWA,Canada,CAN,0,0,11,0,11
2017,El Salvador,SLV,Canada,CAN,10,0,22,0,32
2017,Saudi Arabia,SAU,Canada,CAN,0,0,13,0,13
2017,Serbia and Kosovo: S/RES/1244 (1999),SRB,Canada,CAN,0,0,15,0,15
2017,Senegal,SEN,Canada,CAN,0,0,5,0,5
2017,Somalia,SOM,Canada,CAN,38,0,57,0,95
2017,Sudan,SDN,Canada,CAN,5,0,5,0,10
2017,Slovakia,SVK,Canada,CAN,0,0,16,0,16
2017,Syrian Arab Rep.,SYR,Canada,CAN,0,0,10,0,10
2017,United Rep. of Tanzania,TZA,Canada,CAN,0,0,5,0,5
2017,Thailand,THA,Canada,CAN,0,0,5,0,5
2017,Togo,TGO,Canada,CAN,0,0,5,0,5
2017,Trinidad and Tobago,TTO,Canada,CAN,5,0,0,0,5
2017,Tunisia,TUN,Canada,CAN,0,0,12,0,12
2017,Turkey,TUR,Canada,CAN,30,0,37,5,72
2017,United Arab Emirates,ARE,Canada,CAN,0,0,5,0,5
2017,Uganda,UGA,Canada,CAN,5,0,19,0,24
2017,Ukraine,UKR,Canada,CAN,12,0,12,0,24
2017,United States of America,USA,Canada,CAN,0,0,16,5,21
2017,Saint Vincent and the Grenadines,VCT,Canada,CAN,0,0,11,0,11
2017,Venezuela (Bolivarian Republic of),VEN,Canada,CAN,13,0,45,0,58
2017,Yemen,YEM,Canada,CAN,0,0,10,0,10
2017,Zimbabwe,ZWE,Canada,CAN,5,0,20,0,25
2017,Stateless,XXA,Canada,CAN,0,0,12,0,12
2017,Albania,ALB,Costa Rica,CRI,0,0,0,5,5
2017,China,CHN,Costa Rica,CRI,0,0,0,5,5
2017,Colombia,COL,Costa Rica,CRI,12,0,326,29,367
2017,Cuba,CUB,Costa Rica,CRI,0,0,43,5,48
2017,Guatemala,GTM,Costa Rica,CRI,0,0,5,0,5
2017,Honduras,HND,Costa Rica,CRI,34,0,47,0,81
2017,Iran (Islamic Rep. of),IRN,Costa Rica,CRI,0,0,5,0,5
2017,Mexico,MEX,Costa Rica,CRI,0,0,10,0,10
2017,Nicaragua,NIC,Costa Rica,CRI,0,0,16,0,16
2017,Nigeria,NGA,Costa Rica,CRI,0,0,5,0,5
2017,Panama,PAN,Costa Rica,CRI,0,0,5,0,5
2017,El Salvador,SLV,Costa Rica,CRI,64,0,236,11,311
2017,United States of America,USA,Costa Rica,CRI,0,0,5,0,5
2017,Venezuela (Bolivarian Republic of),VEN,Costa Rica,CRI,5,0,106,5,116
2017,Albania,ALB,Cyprus,CYP,0,0,0,5,5
2017,Egypt,EGY,Cyprus,CYP,0,0,13,5,18
2017,Bangladesh,BGD,Cyprus,CYP,0,0,36,0,36
2017,Palestinian,PSE,Cyprus,CYP,5,13,5,5,28
2017,India,IND,Cyprus,CYP,0,0,76,30,106
2017,Iran (Islamic Rep. of),IRN,Cyprus,CYP,0,0,5,0,5
2017,Iraq,IRQ,Cyprus,CYP,0,5,0,5,10
2017,Jordan,JOR,Cyprus,CYP,5,0,5,0,10
2017,Sri Lanka,LKA,Cyprus,CYP,0,0,31,5,36
2017,Nepal,NPL,Cyprus,CYP,0,0,5,0,5
2017,Pakistan,PAK,Cyprus,CYP,0,0,41,20,61
2017,Philippines,PHL,Cyprus,CYP,0,0,11,5,16
2017,Russian Federation,RUS,Cyprus,CYP,5,0,0,0,5
2017,Senegal,SEN,Cyprus,CYP,0,0,5,0,5
2017,Somalia,SOM,Cyprus,CYP,0,0,0,5,5
2017,Viet Nam,VNM,Cyprus,CYP,0,0,87,12,99
2017,Syrian Arab Rep.,SYR,Cyprus,CYP,5,21,0,0,26
2017,Ukraine,UKR,Cyprus,CYP,0,0,0,5,5
2017,Afghanistan,AFG,Denmark,DNK,39,93,592,0,724
2017,Egypt,EGY,Denmark,DNK,0,0,10,0,10
2017,Armenia,ARM,Denmark,DNK,0,0,21,0,21
2017,Bangladesh,BGD,Denmark,DNK,0,0,5,0,5
2017,China,CHN,Denmark,DNK,0,0,5,0,5
2017,Cameroon,CMR,Denmark,DNK,0,0,5,0,5
2017,Dem. Rep. of the Congo,COD,Denmark,DNK,0,5,0,0,5
2017,Eritrea,ERI,Denmark,DNK,0,0,5,0,5
2017,Ethiopia,ETH,Denmark,DNK,0,0,14,0,14
2017,Georgia,GEO,Denmark,DNK,0,0,5,0,5
2017,Ghana,GHA,Denmark,DNK,0,0,5,0,5
2017,Iran (Islamic Rep. of),IRN,Denmark,DNK,166,10,360,0,536
2017,Iraq,IRQ,Denmark,DNK,10,13,401,0,424
2017,Kuwait,KWT,Denmark,DNK,0,0,5,0,5
2017,Libya,LBY,Denmark,DNK,0,0,5,0,5
2017,Lebanon,LBN,Denmark,DNK,0,0,5,0,5
2017,Sri Lanka,LKA,Denmark,DNK,0,0,5,0,5
2017,North Macedonia,MKD,Denmark,DNK,0,0,10,0,10
2017,Rep. of Moldova,MDA,Denmark,DNK,0,0,13,0,13
2017,Nigeria,NGA,Denmark,DNK,0,0,13,0,13
2017,Pakistan,PAK,Denmark,DNK,0,0,12,0,12
2017,Russian Federation,RUS,Denmark,DNK,0,5,31,0,36
2017,Rwanda,RWA,Denmark,DNK,5,0,0,0,5
2017,Somalia,SOM,Denmark,DNK,0,5,24,0,29
2017,Sudan,SDN,Denmark,DNK,5,0,11,0,16
2017,Syrian Arab Rep.,SYR,Denmark,DNK,5,5,13,0,23
2017,Uganda,UGA,Denmark,DNK,0,0,12,0,12
2017,Ukraine,UKR,Denmark,DNK,0,0,19,0,19
2017,Yemen,YEM,Denmark,DNK,0,0,5,0,5
2017,Stateless,XXA,Denmark,DNK,11,5,52,0,68
2017,Afghanistan,AFG,France,FRA,116,253,201,5,575
2017,Albania,ALB,France,FRA,121,378,3782,45,4326
2017,Algeria,DZA,France,FRA,74,37,299,5,415
2017,Angola,AGO,France,FRA,35,10,257,0,302
2017,Egypt,EGY,France,FRA,54,5,134,5,198
2017,Armenia,ARM,France,FRA,45,59,726,5,835
2017,Azerbaijan,AZE,France,FRA,54,10,171,5,240
2017,Burundi,BDI,France,FRA,5,0,0,0,5
2017,Benin,BEN,France,FRA,0,0,5,0,5
2017,Bangladesh,BGD,France,FRA,576,111,2135,10,2832
2017,Bhutan,BTN,France,FRA,0,0,5,0,5
2017,Burkina Faso,BFA,France,FRA,10,5,56,0,71
2017,Belarus,BLR,France,FRA,5,0,15,0,20
2017,Bosnia and Herzegovina,BIH,France,FRA,27,10,155,0,192
2017,Cambodia,KHM,France,FRA,0,0,19,0,19
2017,Central African Rep.,CAF,France,FRA,36,27,113,0,176
2017,Chad,TCD,France,FRA,50,12,196,0,258
2017,China,CHN,France,FRA,17,0,253,0,270
2017,Cameroon,CMR,France,FRA,86,22,211,5,324
2017,Congo,COG,France,FRA,46,14,312,10,382
2017,Dem. Rep. of the Congo,COD,France,FRA,439,100,2156,16,2711
2017,Comoros,COM,France,FRA,0,5,36,0,41
2017,Colombia,COL,France,FRA,5,10,28,0,43
2017,Cuba,CUB,France,FRA,0,0,16,0,16
2017,Djibouti,DJI,France,FRA,11,5,5,0,21
2017,Dominican Rep.,DOM,France,FRA,0,5,56,0,61
2017,Equatorial Guinea,GNQ,France,FRA,0,0,11,0,11
2017,Eritrea,ERI,France,FRA,88,0,182,0,270
2017,Ethiopia,ETH,France,FRA,33,0,71,0,104
2017,Gabon,GAB,France,FRA,5,0,39,0,44
2017,Gambia,GMB,France,FRA,15,5,100,0,120
2017,Palestinian,PSE,France,FRA,18,0,21,0,39
2017,Georgia,GEO,France,FRA,44,22,542,10,618
2017,Ghana,GHA,France,FRA,0,0,23,0,23
2017,Guinea-Bissau,GNB,France,FRA,0,5,46,0,51
2017,Guinea,GIN,France,FRA,335,62,1106,10,1513
2017,Haiti,HTI,France,FRA,16,14,501,19,550
2017,Cote d'Ivoire,CIV,France,FRA,141,42,740,13,936
2017,India,IND,France,FRA,5,5,79,0,89
2017,Iran (Islamic Rep. of),IRN,France,FRA,42,0,36,0,78
2017,Iraq,IRQ,France,FRA,19,42,113,0,174
2017,Israel,ISR,France,FRA,5,0,0,0,5
2017,Jordan,JOR,France,FRA,5,0,5,0,10
2017,Kazakhstan,KAZ,France,FRA,12,5,24,0,41
2017,Kenya,KEN,France,FRA,10,0,33,0,43
2017,Kyrgyzstan,KGZ,France,FRA,16,0,10,0,26
2017,Dem. People's Rep. of Korea,PRK,France,FRA,0,0,13,0,13
2017,Lao People's Dem. Rep.,LAO,France,FRA,0,0,5,0,5
2017,Liberia,LBR,France,FRA,0,0,18,0,18
2017,Libya,LBY,France,FRA,5,33,33,0,71
2017,Lebanon,LBN,France,FRA,0,0,30,0,30
2017,Sri Lanka,LKA,France,FRA,252,29,604,10,895
2017,Madagascar,MDG,France,FRA,5,5,40,0,50
2017,Mauritania,MRT,France,FRA,136,10,480,5,631
2017,North Macedonia,MKD,France,FRA,5,5,119,0,129
2017,Rep. of Moldova,MDA,France,FRA,0,0,5,0,5
2017,Mali,MLI,France,FRA,83,13,573,5,674
2017,Mongolia,MNG,France,FRA,5,10,67,0,82
2017,Morocco,MAR,France,FRA,37,5,118,0,160
2017,Montenegro,MNE,France,FRA,0,0,29,0,29
2017,Mauritius,MUS,France,FRA,0,0,10,0,10
2017,Myanmar,MMR,France,FRA,0,0,13,0,13
2017,Nepal,NPL,France,FRA,0,5,38,0,43
2017,Niger,NER,France,FRA,0,0,20,0,20
2017,Nigeria,NGA,France,FRA,228,85,1261,10,1584
2017,Pakistan,PAK,France,FRA,151,56,686,0,893
2017,Peru,PER,France,FRA,0,0,18,0,18
2017,Philippines,PHL,France,FRA,0,0,5,0,5
2017,South Africa,ZAF,France,FRA,0,0,5,0,5
2017,Russian Federation,RUS,France,FRA,288,91,937,15,1331
2017,Rwanda,RWA,France,FRA,15,0,23,0,38
2017,Serbia and Kosovo: S/RES/1244 (1999),SRB,France,FRA,190,161,1344,12,1707
2017,Senegal,SEN,France,FRA,37,10,252,0,299
2017,Sierra Leone,SLE,France,FRA,17,5,34,0,56
2017,Somalia,SOM,France,FRA,39,169,184,0,392
2017,Viet Nam,VNM,France,FRA,0,0,15,0,15
2017,Sudan,SDN,France,FRA,500,550,1354,15,2419
2017,Suriname,SUR,France,FRA,0,0,5,0,5
2017,Syrian Arab Rep.,SYR,France,FRA,438,26,419,5,888
2017,United Rep. of Tanzania,TZA,France,FRA,0,0,5,0,5
2017,Thailand,THA,France,FRA,0,0,5,0,5
2017,Tajikistan,TJK,France,FRA,0,0,10,0,10
2017,Togo,TGO,France,FRA,22,5,83,5,115
2017,Tunisia,TUN,France,FRA,5,5,74,0,84
2017,Turkey,TUR,France,FRA,199,18,571,5,793
2017,Uganda,UGA,France,FRA,11,0,0,0,11
2017,Ukraine,UKR,France,FRA,71,30,413,5,519
2017,Uzbekistan,UZB,France,FRA,0,0,10,0,10
2017,Venezuela (Bolivarian Republic of),VEN,France,FRA,0,0,24,5,29
2017,Western Sahara,ESH,France,FRA,29,5,208,0,242
2017,Yemen,YEM,France,FRA,5,5,5,0,15
2017,Zimbabwe,ZWE,France,FRA,5,0,5,0,10
2017,Afghanistan,AFG,Greece,GRC,11,13,75,11,110
2017,Albania,ALB,Greece,GRC,0,0,481,46,527
2017,Algeria,DZA,Greece,GRC,0,0,245,60,305
2017,Egypt,EGY,Greece,GRC,0,0,108,17,125
2017,Armenia,ARM,Greece,GRC,0,0,14,5,19
2017,Bangladesh,BGD,Greece,GRC,0,0,376,40,416
2017,Burkina Faso,BFA,Greece,GRC,0,0,5,0,5
2017,Central African Rep.,CAF,Greece,GRC,0,0,63,0,63
2017,China,CHN,Greece,GRC,0,0,10,5,15
2017,Cameroon,CMR,Greece,GRC,5,0,0,14,19
2017,Congo,COG,Greece,GRC,0,0,5,0,5
2017,Dem. Rep. of the Congo,COD,Greece,GRC,5,5,33,0,43
2017,Dominican Rep.,DOM,Greece,GRC,0,0,10,5,15
2017,Eritrea,ERI,Greece,GRC,0,0,5,0,5
2017,Ethiopia,ETH,Greece,GRC,5,0,5,0,10
2017,Gambia,GMB,Greece,GRC,0,0,12,0,12
2017,Palestinian,PSE,Greece,GRC,5,0,0,0,5
2017,Georgia,GEO,Greece,GRC,0,0,183,23,206
2017,Ghana,GHA,Greece,GRC,5,0,26,5,36
2017,Guinea,GIN,Greece,GRC,0,5,15,0,20
2017,Haiti,HTI,Greece,GRC,0,0,10,0,10
2017,Cote d'Ivoire,CIV,Greece,GRC,0,0,12,0,12
2017,India,IND,Greece,GRC,0,0,23,0,23
2017,Iran (Islamic Rep. of),IRN,Greece,GRC,5,5,55,12,77
2017,Iraq,IRQ,Greece,GRC,5,5,37,19,66
2017,Lebanon,LBN,Greece,GRC,0,0,23,0,23
2017,Mauritania,MRT,Greece,GRC,5,0,0,0,5
2017,Rep. of Moldova,MDA,Greece,GRC,0,0,12,0,12
2017,Mali,MLI,Greece,GRC,0,5,17,0,22
2017,Morocco,MAR,Greece,GRC,0,0,97,19,116
2017,Nepal,NPL,Greece,GRC,0,0,21,5,26
2017,Niger,NER,Greece,GRC,0,0,10,0,10
2017,Nigeria,NGA,Greece,GRC,5,0,71,20,96
2017,Pakistan,PAK,Greece,GRC,10,0,2062,167,2239
2017,Russian Federation,RUS,Greece,GRC,0,0,5,0,5
2017,Senegal,SEN,Greece,GRC,0,0,20,5,25
2017,Sierra Leone,SLE,Greece,GRC,0,0,10,0,10
2017,Sudan,SDN,Greece,GRC,0,0,5,0,5
2017,Syrian Arab Rep.,SYR,Greece,GRC,10,0,0,170,180
2017,United Rep. of Tanzania,TZA,Greece,GRC,0,0,5,0,5
2017,Tunisia,TUN,Greece,GRC,0,0,11,0,11
2017,Turkey,TUR,Greece,GRC,0,0,10,0,10
2017,Uganda,UGA,Greece,GRC,0,0,5,0,5
2017,Ukraine,UKR,Greece,GRC,0,5,12,5,22
2017,Venezuela (Bolivarian Republic of),VEN,Greece,GRC,0,0,5,0,5
2017,Zimbabwe,ZWE,Greece,GRC,0,0,5,0,5
2017,Afghanistan,AFG,Iceland,ISL,10,10,0,0,20
2017,Albania,ALB,Iceland,ISL,0,0,61,5,66
2017,Belarus,BLR,Iceland,ISL,0,0,5,0,5
2017,Eritrea,ERI,Iceland,ISL,0,5,0,0,5
2017,Georgia,GEO,Iceland,ISL,0,0,33,5,38
2017,Ghana,GHA,Iceland,ISL,0,0,50,0,50
2017,Iraq,IRQ,Iceland,ISL,16,0,5,5,26
2017,Israel,ISR,Iceland,ISL,0,0,12,0,12
2017,Kazakhstan,KAZ,Iceland,ISL,0,0,5,0,5
2017,North Macedonia,MKD,Iceland,ISL,0,0,107,11,118
2017,Morocco,MAR,Iceland,ISL,5,0,5,0,10
2017,Nigeria,NGA,Iceland,ISL,5,0,17,0,22
2017,Romania,ROU,Iceland,ISL,0,0,5,0,5
2017,Russian Federation,RUS,Iceland,ISL,0,0,5,0,5
2017,Serbia and Kosovo: S/RES/1244 (1999),SRB,Iceland,ISL,0,0,21,0,21
2017,Somalia,SOM,Iceland,ISL,5,0,0,0,5
2017,Syrian Arab Rep.,SYR,Iceland,ISL,5,5,0,0,10
2017,Ukraine,UKR,Iceland,ISL,0,0,11,0,11
2017,Afghanistan,AFG,Ireland,IRL,0,0,5,5,10
2017,Albania,ALB,Ireland,IRL,0,5,25,0,30
2017,Algeria,DZA,Ireland,IRL,0,5,13,0,18
2017,Benin,BEN,Ireland,IRL,0,0,5,0,5
2017,Bangladesh,BGD,Ireland,IRL,0,0,10,0,10
2017,China,CHN,Ireland,IRL,0,0,5,0,5
2017,Cameroon,CMR,Ireland,IRL,0,0,5,0,5
2017,Dem. Rep. of the Congo,COD,Ireland,IRL,0,0,14,5,19
2017,Cote d'Ivoire,CIV,Ireland,IRL,0,0,5,0,5
2017,India,IND,Ireland,IRL,0,0,0,5,5
2017,Kuwait,KWT,Ireland,IRL,0,0,0,5,5
2017,Lesotho,LSO,Ireland,IRL,0,0,5,0,5
2017,Malawi,MWI,Ireland,IRL,5,5,22,5,37
2017,Mauritius,MUS,Ireland,IRL,0,0,5,0,5
2017,Nigeria,NGA,Ireland,IRL,0,5,54,14,73
2017,Pakistan,PAK,Ireland,IRL,0,10,33,17,60
2017,South Africa,ZAF,Ireland,IRL,0,0,13,5,18
2017,Russian Federation,RUS,Ireland,IRL,0,5,0,0,5
2017,Rwanda,RWA,Ireland,IRL,0,5,0,0,5
2017,Sierra Leone,SLE,Ireland,IRL,0,0,5,0,5
2017,Viet Nam,VNM,Ireland,IRL,0,0,5,0,5
2017,Togo,TGO,Ireland,IRL,0,0,5,0,5
2017,Uganda,UGA,Ireland,IRL,0,5,0,0,5
2017,Ukraine,UKR,Ireland,IRL,0,0,5,0,5
2017,Venezuela (Bolivarian Republic of),VEN,Ireland,IRL,0,0,10,0,10
2017,Zimbabwe,ZWE,Ireland,IRL,10,10,29,0,49
2017,Egypt,EGY,Japan,JPN,0,0,0,5,5
2017,Bangladesh,BGD,Japan,JPN,0,0,47,37,84
2017,Cambodia,KHM,Japan,JPN,0,0,10,21,31
2017,China,CHN,Japan,JPN,0,0,14,0,14
2017,Cameroon,CMR,Japan,JPN,0,0,26,0,26
2017,Dem. Rep. of the Congo,COD,Japan,JPN,0,0,10,0,10
2017,Ethiopia,ETH,Japan,JPN,0,0,13,0,13
2017,Ghana,GHA,Japan,JPN,0,0,50,21,71
2017,India,IND,Japan,JPN,0,0,46,46,92
2017,Indonesia,IDN,Japan,JPN,0,0,797,142,939
2017,Iran (Islamic Rep. of),IRN,Japan,JPN,0,0,17,14,31
2017,Sri Lanka,LKA,Japan,JPN,0,0,128,110,238
2017,Myanmar,MMR,Japan,JPN,0,0,146,76,222
2017,Nepal,NPL,Japan,JPN,0,0,412,270,682
2017,Nigeria,NGA,Japan,JPN,0,0,36,31,67
2017,Pakistan,PAK,Japan,JPN,0,0,91,74,165
2017,Peru,PER,Japan,JPN,0,0,10,0,10
2017,Philippines,PHL,Japan,JPN,0,0,276,90,366
2017,Senegal,SEN,Japan,JPN,0,0,0,5,5
2017,Viet Nam,VNM,Japan,JPN,0,0,606,141,747
2017,Thailand,THA,Japan,JPN,0,0,24,18,42
2017,Tunisia,TUN,Japan,JPN,0,0,0,14,14
2017,Turkey,TUR,Japan,JPN,0,0,259,153,412
2017,Uganda,UGA,Japan,JPN,0,0,12,5,17
2017,Afghanistan,AFG,Kazakhstan,KAZ,0,0,0,80,80
2017,Ukraine,UKR,Kazakhstan,KAZ,0,0,0,18,18
2017,Albania,ALB,Luxembourg,LUX,0,5,90,0,95
2017,Algeria,DZA,Luxembourg,LUX,0,0,5,0,5
2017,Belarus,BLR,Luxembourg,LUX,0,0,5,0,5
2017,Bosnia and Herzegovina,BIH,Luxembourg,LUX,0,0,35,0,35
2017,Guinea,GIN,Luxembourg,LUX,0,0,5,0,5
2017,Cote d'Ivoire,CIV,Luxembourg,LUX,0,0,5,0,5
2017,Iraq,IRQ,Luxembourg,LUX,0,0,20,0,20
2017,North Macedonia,MKD,Luxembourg,LUX,0,0,15,0,15
2017,Montenegro,MNE,Luxembourg,LUX,0,0,15,0,15
2017,Nigeria,NGA,Luxembourg,LUX,0,0,5,0,5
2017,Serbia and Kosovo: S/RES/1244 (1999),SRB,Luxembourg,LUX,0,0,105,0,105
2017,Senegal,SEN,Luxembourg,LUX,0,0,5,0,5
2017,Dem. Rep. of the Congo,COD,Malawi,MWI,5,0,0,0,5
2017,Algeria,DZA,Malta,MLT,0,0,5,0,5
2017,Egypt,EGY,Malta,MLT,0,0,0,5,5
2017,Armenia,ARM,Malta,MLT,0,0,0,5,5
2017,Eritrea,ERI,Malta,MLT,0,0,0,23,23
2017,Ethiopia,ETH,Malta,MLT,0,0,0,18,18
2017,Gambia,GMB,Malta,MLT,0,0,0,5,5
2017,Iraq,IRQ,Malta,MLT,0,0,5,0,5
2017,Liberia,LBR,Malta,MLT,0,0,0,5,5
2017,Libya,LBY,Malta,MLT,0,0,0,11,11
2017,Mali,MLI,Malta,MLT,0,0,0,5,5
2017,Nigeria,NGA,Malta,MLT,0,0,0,14,14
2017,Pakistan,PAK,Malta,MLT,0,0,0,5,5
2017,Senegal,SEN,Malta,MLT,0,0,0,5,5
2017,Somalia,SOM,Malta,MLT,0,0,0,50,50
2017,Sudan,SDN,Malta,MLT,0,0,0,10,10
2017,Syrian Arab Rep.,SYR,Malta,MLT,0,0,0,74,74
2017,Tunisia,TUN,Malta,MLT,0,0,0,5,5
2017,Ukraine,UKR,Malta,MLT,0,0,0,5,5
2017,Central African Rep.,CAF,Niger,NER,0,0,0,10,10
2017,Cote d'Ivoire,CIV,Niger,NER,0,0,0,5,5
2017,Afghanistan,AFG,Norway,NOR,66,13,2061,34,2174
2017,Albania,ALB,Norway,NOR,5,0,44,0,49
2017,Algeria,DZA,Norway,NOR,0,0,18,0,18
2017,Angola,AGO,Norway,NOR,0,0,12,0,12
2017,Egypt,EGY,Norway,NOR,0,0,20,0,20
2017,Armenia,ARM,Norway,NOR,0,0,5,5,10
2017,Azerbaijan,AZE,Norway,NOR,0,0,10,0,10
2017,Burundi,BDI,Norway,NOR,0,0,10,0,10
2017,Bangladesh,BGD,Norway,NOR,0,0,30,0,30
2017,Belarus,BLR,Norway,NOR,0,0,5,0,5
2017,Brazil,BRA,Norway,NOR,0,0,5,0,5
2017,Bosnia and Herzegovina,BIH,Norway,NOR,0,0,5,0,5
2017,China,CHN,Norway,NOR,0,0,18,0,18
2017,Dem. Rep. of the Congo,COD,Norway,NOR,0,0,14,0,14
2017,Colombia,COL,Norway,NOR,0,0,11,5,16
2017,Djibouti,DJI,Norway,NOR,0,0,5,0,5
2017,Eritrea,ERI,Norway,NOR,5,0,252,5,262
2017,Ethiopia,ETH,Norway,NOR,10,0,372,5,387
2017,Gambia,GMB,Norway,NOR,0,0,10,0,10
2017,United Kingdom of Great Britain and Northern Ireland,GBR,Norway,NOR,0,0,5,0,5
2017,Georgia,GEO,Norway,NOR,0,0,15,0,15
2017,Germany,DEU,Norway,NOR,0,0,5,0,5
2017,Ghana,GHA,Norway,NOR,0,0,5,5,10
2017,Guinea,GIN,Norway,NOR,0,0,13,0,13
2017,Honduras,HND,Norway,NOR,0,0,5,0,5
2017,Cote d'Ivoire,CIV,Norway,NOR,0,0,17,0,17
2017,India,IND,Norway,NOR,0,0,5,0,5
2017,Iran (Islamic Rep. of),IRN,Norway,NOR,26,0,333,18,377
2017,Iraq,IRQ,Norway,NOR,17,51,743,79,890
2017,Israel,ISR,Norway,NOR,0,0,5,0,5
2017,Jordan,JOR,Norway,NOR,0,0,5,0,5
2017,Kazakhstan,KAZ,Norway,NOR,0,0,10,0,10
2017,Kenya,KEN,Norway,NOR,0,0,5,0,5
2017,Kyrgyzstan,KGZ,Norway,NOR,0,0,5,0,5
2017,Rep. of Korea,KOR,Norway,NOR,0,0,10,0,10
2017,Liberia,LBR,Norway,NOR,0,0,5,0,5
2017,Libya,LBY,Norway,NOR,0,0,19,0,19
2017,Lebanon,LBN,Norway,NOR,0,0,25,0,25
2017,Sri Lanka,LKA,Norway,NOR,0,0,18,0,18
2017,Mexico,MEX,Norway,NOR,0,0,5,0,5
2017,Morocco,MAR,Norway,NOR,0,0,49,0,49
2017,Myanmar,MMR,Norway,NOR,0,0,5,0,5
2017,Nigeria,NGA,Norway,NOR,0,0,55,5,60
2017,Pakistan,PAK,Norway,NOR,0,0,63,0,63
2017,Peru,PER,Norway,NOR,0,0,5,0,5
2017,Philippines,PHL,Norway,NOR,0,0,5,5,10
2017,Romania,ROU,Norway,NOR,0,0,5,0,5
2017,Russian Federation,RUS,Norway,NOR,5,0,75,11,91
2017,Rwanda,RWA,Norway,NOR,0,0,5,0,5
2017,El Salvador,SLV,Norway,NOR,0,0,12,0,12
2017,Saudi Arabia,SAU,Norway,NOR,0,0,5,0,5
2017,Serbia and Kosovo: S/RES/1244 (1999),SRB,Norway,NOR,0,0,22,0,22
2017,Senegal,SEN,Norway,NOR,0,0,5,0,5
2017,Sierra Leone,SLE,Norway,NOR,0,0,5,0,5
2017,Somalia,SOM,Norway,NOR,0,0,324,5,329
2017,Viet Nam,VNM,Norway,NOR,0,0,5,0,5
2017,Sudan,SDN,Norway,NOR,0,0,50,0,50
2017,Slovakia,SVK,Norway,NOR,0,0,10,0,10
2017,Syrian Arab Rep.,SYR,Norway,NOR,0,0,96,27,123
2017,Tajikistan,TJK,Norway,NOR,0,0,5,0,5
2017,Tunisia,TUN,Norway,NOR,0,0,5,0,5
2017,Turkey,TUR,Norway,NOR,0,0,26,5,31
2017,Uganda,UGA,Norway,NOR,0,0,10,0,10
2017,Ukraine,UKR,Norway,NOR,0,0,24,5,29
2017,United States of America,USA,Norway,NOR,0,0,5,0,5
2017,Uzbekistan,UZB,Norway,NOR,5,0,22,0,27
2017,Venezuela (Bolivarian Republic of),VEN,Norway,NOR,0,0,10,0,10
2017,Yemen,YEM,Norway,NOR,0,0,11,0,11
2017,Zambia,ZMB,Norway,NOR,0,0,5,0,5
2017,Zimbabwe,ZWE,Norway,NOR,0,0,5,0,5
2017,Stateless,XXA,Norway,NOR,5,0,111,5,121
2017,Afghanistan,AFG,Poland,POL,0,0,5,0,5
2017,Algeria,DZA,Poland,POL,0,0,5,0,5
2017,Armenia,ARM,Poland,POL,0,0,39,0,39
2017,Bangladesh,BGD,Poland,POL,0,0,5,0,5
2017,Belarus,BLR,Poland,POL,0,0,10,0,10
2017,Bulgaria,BGR,Poland,POL,0,0,5,0,5
2017,Georgia,GEO,Poland,POL,0,0,74,0,74
2017,India,IND,Poland,POL,0,0,5,0,5
2017,Iran (Islamic Rep. of),IRN,Poland,POL,0,0,5,0,5
2017,Kyrgyzstan,KGZ,Poland,POL,0,5,26,0,31
2017,Rep. of Moldova,MDA,Poland,POL,0,0,5,0,5
2017,Nigeria,NGA,Poland,POL,0,0,5,0,5
2017,Pakistan,PAK,Poland,POL,0,0,5,0,5
2017,Russian Federation,RUS,Poland,POL,0,0,1269,0,1269
2017,Viet Nam,VNM,Poland,POL,0,0,15,0,15
2017,Syrian Arab Rep.,SYR,Poland,POL,0,0,5,0,5
2017,Tajikistan,TJK,Poland,POL,0,0,107,0,107
2017,Ukraine,UKR,Poland,POL,0,22,489,0,511
2017,Uzbekistan,UZB,Poland,POL,0,0,12,0,12
2017,Stateless,XXA,Poland,POL,0,0,5,0,5
2017,Algeria,DZA,South Africa,ZAF,0,0,0,62,62
2017,Egypt,EGY,South Africa,ZAF,0,0,0,155,155
2017,Burundi,BDI,South Africa,ZAF,0,0,0,211,211
2017,Benin,BEN,South Africa,ZAF,0,0,0,25,25
2017,Bangladesh,BGD,South Africa,ZAF,0,0,45,1684,1729
2017,Burkina Faso,BFA,South Africa,ZAF,0,0,0,5,5
2017,Botswana,BWA,South Africa,ZAF,0,0,0,5,5
2017,China,CHN,South Africa,ZAF,0,0,0,88,88
2017,Cameroon,CMR,South Africa,ZAF,0,0,5,424,429
2017,Congo,COG,South Africa,ZAF,0,0,0,147,147
2017,Dem. Rep. of the Congo,COD,South Africa,ZAF,10,0,75,1947,2032
2017,Comoros,COM,South Africa,ZAF,0,0,0,5,5
2017,Eritrea,ERI,South Africa,ZAF,0,0,0,45,45
2017,Estonia,EST,South Africa,ZAF,0,0,0,5,5
2017,Ethiopia,ETH,South Africa,ZAF,5,0,134,2247,2386
2017,Gabon,GAB,South Africa,ZAF,0,0,0,5,5
2017,Gambia,GMB,South Africa,ZAF,0,0,0,10,10
2017,Palestinian,PSE,South Africa,ZAF,0,0,0,39,39
2017,Ghana,GHA,South Africa,ZAF,0,0,0,1906,1906
2017,Guinea-Bissau,GNB,South Africa,ZAF,0,0,0,10,10
2017,Guinea,GIN,South Africa,ZAF,0,0,0,5,5
2017,Cote d'Ivoire,CIV,South Africa,ZAF,0,0,0,21,21
2017,India,IND,South Africa,ZAF,0,0,82,515,597
2017,Kenya,KEN,South Africa,ZAF,0,0,0,133,133
2017,Liberia,LBR,South Africa,ZAF,0,0,0,15,15
2017,Lesotho,LSO,South Africa,ZAF,0,0,0,96,96
2017,Sri Lanka,LKA,South Africa,ZAF,0,0,0,5,5
2017,Mali,MLI,South Africa,ZAF,0,0,0,10,10
2017,Malawi,MWI,South Africa,ZAF,0,0,0,2639,2639
2017,Mozambique,MOZ,South Africa,ZAF,0,0,0,1011,1011
2017,Nepal,NPL,South Africa,ZAF,0,0,0,34,34
2017,Niger,NER,South Africa,ZAF,0,0,0,11,11
2017,Nigeria,NGA,South Africa,ZAF,0,0,5,4313,4318
2017,Pakistan,PAK,South Africa,ZAF,0,0,60,590,650
2017,Rwanda,RWA,South Africa,ZAF,0,0,0,26,26
2017,Senegal,SEN,South Africa,ZAF,0,0,0,181,181
2017,Sierra Leone,SLE,South Africa,ZAF,0,0,0,5,5
2017,Somalia,SOM,South Africa,ZAF,0,0,5,145,150
2017,Sudan,SDN,South Africa,ZAF,0,0,0,5,5
2017,Eswatini,SWZ,South Africa,ZAF,0,0,0,13,13
2017,Switzerland,CHE,South Africa,ZAF,0,0,0,10,10
2017,United Rep. of Tanzania,TZA,South Africa,ZAF,0,0,0,265,265
2017,Thailand,THA,South Africa,ZAF,0,0,0,36,36
2017,Togo,TGO,South Africa,ZAF,0,0,0,5,5
2017,Uganda,UGA,South Africa,ZAF,0,0,0,919,919
2017,Zambia,ZMB,South Africa,ZAF,0,0,0,98,98
2017,Zimbabwe,ZWE,South Africa,ZAF,0,0,34,17964,17998
2017,Stateless,XXA,South Africa,ZAF,0,0,0,41,41
2017,Afghanistan,AFG,Sweden,SWE,290,365,4814,929,6398
2017,Albania,ALB,Sweden,SWE,5,5,366,27,403
2017,Algeria,DZA,Sweden,SWE,0,0,74,10,84
2017,Angola,AGO,Sweden,SWE,0,0,10,0,10
2017,Egypt,EGY,Sweden,SWE,10,0,165,27,202
2017,Argentina,ARG,Sweden,SWE,0,0,5,0,5
2017,Armenia,ARM,Sweden,SWE,0,5,232,21,258
2017,Azerbaijan,AZE,Sweden,SWE,5,0,147,11,163
2017,Burundi,BDI,Sweden,SWE,5,0,17,5,27
2017,Bangladesh,BGD,Sweden,SWE,0,0,106,15,121
2017,Belarus,BLR,Sweden,SWE,0,0,86,10,96
2017,Bolivia (Plurinational State of),BOL,Sweden,SWE,0,0,23,0,23
2017,Brazil,BRA,Sweden,SWE,0,0,10,0,10
2017,Bosnia and Herzegovina,BIH,Sweden,SWE,0,0,95,12,107
2017,Chad,TCD,Sweden,SWE,0,0,5,0,5
2017,China,CHN,Sweden,SWE,5,0,28,5,38
2017,Chile,CHL,Sweden,SWE,0,0,17,0,17
2017,Cameroon,CMR,Sweden,SWE,0,0,28,0,28
2017,Congo,COG,Sweden,SWE,0,0,12,0,12
2017,Dem. Rep. of the Congo,COD,Sweden,SWE,0,0,17,5,22
2017,Colombia,COL,Sweden,SWE,0,0,81,5,86
2017,Cuba,CUB,Sweden,SWE,0,0,22,0,22
2017,Djibouti,DJI,Sweden,SWE,0,0,25,5,30
2017,Ecuador,ECU,Sweden,SWE,0,0,5,0,5
2017,Eritrea,ERI,Sweden,SWE,14,0,128,137,279
2017,Estonia,EST,Sweden,SWE,0,0,5,0,5
2017,Ethiopia,ETH,Sweden,SWE,38,0,291,45,374
2017,Gambia,GMB,Sweden,SWE,0,0,67,5,72
2017,Palestinian,PSE,Sweden,SWE,5,0,183,41,229
2017,Georgia,GEO,Sweden,SWE,0,0,558,76,634
2017,Ghana,GHA,Sweden,SWE,0,0,24,5,29
2017,Guinea,GIN,Sweden,SWE,0,0,11,5,16
2017,Honduras,HND,Sweden,SWE,0,0,11,5,16
2017,Croatia,HRV,Sweden,SWE,0,0,5,0,5
2017,Hungary,HUN,Sweden,SWE,0,0,5,0,5
2017,Cote d'Ivoire,CIV,Sweden,SWE,0,0,14,0,14
2017,India,IND,Sweden,SWE,0,0,39,10,49
2017,Iran (Islamic Rep. of),IRN,Sweden,SWE,77,5,330,75,487
2017,Iraq,IRQ,Sweden,SWE,217,186,2402,539,3344
2017,Israel,ISR,Sweden,SWE,0,0,17,0,17
2017,Jamaica,JAM,Sweden,SWE,0,0,5,0,5
2017,Jordan,JOR,Sweden,SWE,0,5,151,13,169
2017,Japan,JPN,Sweden,SWE,0,0,5,0,5
2017,Kazakhstan,KAZ,Sweden,SWE,0,0,167,14,181
2017,Kenya,KEN,Sweden,SWE,0,0,33,5,38
2017,Kyrgyzstan,KGZ,Sweden,SWE,5,5,101,17,128
2017,Kuwait,KWT,Sweden,SWE,0,0,14,0,14
2017,Libya,LBY,Sweden,SWE,5,0,81,10,96
2017,Lebanon,LBN,Sweden,SWE,0,0,216,33,249
2017,Sri Lanka,LKA,Sweden,SWE,0,0,18,5,23
2017,North Macedonia,MKD,Sweden,SWE,0,0,53,10,63
2017,Rep. of Moldova,MDA,Sweden,SWE,0,0,12,10,22
2017,Mexico,MEX,Sweden,SWE,0,0,5,0,5
2017,Mali,MLI,Sweden,SWE,0,0,5,0,5
2017,Malaysia,MYS,Sweden,SWE,5,0,0,0,5
2017,Mongolia,MNG,Sweden,SWE,0,0,678,46,724
2017,Morocco,MAR,Sweden,SWE,5,0,205,18,228
2017,Montenegro,MNE,Sweden,SWE,0,0,21,5,26
2017,Nepal,NPL,Sweden,SWE,0,0,25,0,25
2017,Nicaragua,NIC,Sweden,SWE,0,0,39,5,44
2017,Nigeria,NGA,Sweden,SWE,5,0,183,10,198
2017,Norway,NOR,Sweden,SWE,0,0,0,5,5
2017,Pakistan,PAK,Sweden,SWE,16,0,193,19,228
2017,Peru,PER,Sweden,SWE,0,0,19,0,19
2017,Philippines,PHL,Sweden,SWE,0,0,22,0,22
2017,Romania,ROU,Sweden,SWE,0,0,0,5,5
2017,Russian Federation,RUS,Sweden,SWE,10,5,278,19,312
2017,Rwanda,RWA,Sweden,SWE,0,0,5,0,5
2017,El Salvador,SLV,Sweden,SWE,0,0,174,10,184
2017,Serbia and Kosovo: S/RES/1244 (1999),SRB,Sweden,SWE,0,0,378,42,420
2017,Senegal,SEN,Sweden,SWE,0,0,19,0,19
2017,Sierra Leone,SLE,Sweden,SWE,0,0,10,0,10
2017,Somalia,SOM,Sweden,SWE,38,14,749,124,925
2017,Viet Nam,VNM,Sweden,SWE,0,0,21,0,21
2017,Sudan,SDN,Sweden,SWE,20,0,64,14,98
2017,Slovakia,SVK,Sweden,SWE,0,0,5,0,5
2017,Syrian Arab Rep.,SYR,Sweden,SWE,5,18,551,1433,2007
2017,United Rep. of Tanzania,TZA,Sweden,SWE,0,0,35,5,40
2017,Thailand,THA,Sweden,SWE,0,0,10,0,10
2017,Tajikistan,TJK,Sweden,SWE,0,0,21,5,26
2017,Turkmenistan,TKM,Sweden,SWE,5,0,0,0,5
2017,Tunisia,TUN,Sweden,SWE,5,0,54,5,64
2017,Turkey,TUR,Sweden,SWE,0,0,144,28,172
2017,United Arab Emirates,ARE,Sweden,SWE,0,0,5,0,5
2017,Uganda,UGA,Sweden,SWE,0,0,13,5,18
2017,Ukraine,UKR,Sweden,SWE,10,5,674,57,746
2017,Uruguay,URY,Sweden,SWE,0,0,5,0,5
2017,United States of America,USA,Sweden,SWE,0,0,5,0,5
2017,Uzbekistan,UZB,Sweden,SWE,5,0,159,21,185
2017,Venezuela (Bolivarian Republic of),VEN,Sweden,SWE,0,0,61,17,78
2017,Yemen,YEM,Sweden,SWE,0,0,13,31,44
2017,Zimbabwe,ZWE,Sweden,SWE,0,0,5,0,5
2017,Stateless,XXA,Sweden,SWE,46,5,353,131,535
2017,Afghanistan,AFG,United States of America,USA,5,0,0,5,10
2017,Albania,ALB,United States of America,USA,38,0,0,19,57
2017,Angola,AGO,United States of America,USA,5,0,0,0,5
2017,Egypt,EGY,United States of America,USA,105,0,5,59,169
2017,Armenia,ARM,United States of America,USA,15,0,5,18,38
2017,Azerbaijan,AZE,United States of America,USA,5,0,0,0,5
2017,Burundi,BDI,United States of America,USA,18,0,5,20,43
2017,Bangladesh,BGD,United States of America,USA,69,0,10,71,150
2017,Burkina Faso,BFA,United States of America,USA,58,0,5,28,91
2017,Belarus,BLR,United States of America,USA,21,0,0,5,26
2017,Bolivia (Plurinational State of),BOL,United States of America,USA,0,0,0,5,5
2017,Brazil,BRA,United States of America,USA,5,0,0,60,65
2017,Central African Rep.,CAF,United States of America,USA,5,0,0,0,5
2017,Chad,TCD,United States of America,USA,5,0,0,0,5
2017,China,CHN,United States of America,USA,1855,0,400,1309,3564
2017,Cameroon,CMR,United States of America,USA,40,0,5,21,66
2017,Congo,COG,United States of America,USA,19,0,0,10,29
2017,Dem. Rep. of the Congo,COD,United States of America,USA,12,0,0,0,12
2017,Colombia,COL,United States of America,USA,28,0,10,69,107
2017,Costa Rica,CRI,United States of America,USA,0,0,0,5,5
2017,Djibouti,DJI,United States of America,USA,5,0,0,0,5
2017,Dominican Rep.,DOM,United States of America,USA,0,0,0,10,10
2017,Ecuador,ECU,United States of America,USA,5,0,0,338,343
2017,Eritrea,ERI,United States of America,USA,10,0,0,11,21
2017,Ethiopia,ETH,United States of America,USA,98,0,5,26,129
2017,Gambia,GMB,United States of America,USA,18,0,0,23,41
2017,Palestinian,PSE,United States of America,USA,0,0,0,5,5
2017,United Kingdom of Great Britain and Northern Ireland,GBR,United States of America,USA,0,0,5,0,5
2017,Georgia,GEO,United States of America,USA,5,0,0,0,5
2017,Ghana,GHA,United States of America,USA,0,0,0,5,5
2017,Guatemala,GTM,United States of America,USA,5,0,37,419,461
2017,Guinea,GIN,United States of America,USA,14,0,5,23,42
2017,Guyana,GUY,United States of America,USA,0,0,0,5,5
2017,Haiti,HTI,United States of America,USA,5,0,40,104,149
2017,Honduras,HND,United States of America,USA,12,0,13,108,133
2017,Cote d'Ivoire,CIV,United States of America,USA,14,0,11,21,46
2017,India,IND,United States of America,USA,111,0,25,148,284
2017,Indonesia,IDN,United States of America,USA,10,0,10,29,49
2017,Iran (Islamic Rep. of),IRN,United States of America,USA,44,0,0,38,82
2017,Iraq,IRQ,United States of America,USA,41,0,18,67,126
2017,Jamaica,JAM,United States of America,USA,0,0,0,10,10
2017,Jordan,JOR,United States of America,USA,0,0,0,5,5
2017,Kazakhstan,KAZ,United States of America,USA,27,0,5,18,50
2017,Kenya,KEN,United States of America,USA,14,0,0,20,34
2017,Kyrgyzstan,KGZ,United States of America,USA,33,0,10,22,65
2017,Rep. of Korea,KOR,United States of America,USA,0,0,0,5,5
2017,Liberia,LBR,United States of America,USA,0,0,0,13,13
2017,Libya,LBY,United States of America,USA,5,0,0,10,15
2017,Lebanon,LBN,United States of America,USA,5,0,0,10,15
2017,Sri Lanka,LKA,United States of America,USA,31,0,0,34,65
2017,Mauritania,MRT,United States of America,USA,18,0,5,12,35
2017,Rep. of Moldova,MDA,United States of America,USA,34,0,5,35,74
2017,Mexico,MEX,United States of America,USA,17,0,47,2498,2562
2017,Marshall Islands,MHL,United States of America,USA,5,0,0,0,5
2017,Mali,MLI,United States of America,USA,28,0,0,39,67
2017,Malawi,MWI,United States of America,USA,0,0,0,5,5
2017,Mongolia,MNG,United States of America,USA,10,0,5,35,50
2017,Myanmar,MMR,United States of America,USA,5,0,0,5,10
2017,Nepal,NPL,United States of America,USA,159,0,28,143,330
2017,Nicaragua,NIC,United States of America,USA,0,0,0,10,10
2017,Nigeria,NGA,United States of America,USA,13,0,10,18,41
2017,Niue,NIU,United States of America,USA,0,0,0,5,5
2017,Pakistan,PAK,United States of America,USA,49,0,5,81,135
2017,Peru,PER,United States of America,USA,5,0,0,41,46
2017,Philippines,PHL,United States of America,USA,0,0,0,41,41
2017,Poland,POL,United States of America,USA,0,0,0,12,12
2017,Romania,ROU,United States of America,USA,0,0,0,13,13
2017,Russian Federation,RUS,United States of America,USA,50,0,10,52,112
2017,Rwanda,RWA,United States of America,USA,14,0,0,10,24
2017,El Salvador,SLV,United States of America,USA,17,0,25,278,320
2017,Saudi Arabia,SAU,United States of America,USA,0,0,0,5,5
2017,Serbia and Kosovo: S/RES/1244 (1999),SRB,United States of America,USA,18,0,0,5,23
2017,Senegal,SEN,United States of America,USA,5,0,0,16,21
2017,Sierra Leone,SLE,United States of America,USA,10,0,0,10,20
2017,Somalia,SOM,United States of America,USA,5,0,0,5,10
2017,Viet Nam,VNM,United States of America,USA,0,0,5,0,5
2017,Sudan,SDN,United States of America,USA,11,0,0,10,21
2017,Syrian Arab Rep.,SYR,United States of America,USA,62,0,5,43,110
2017,Tajikistan,TJK,United States of America,USA,10,0,5,0,15
2017,Turkmenistan,TKM,United States of America,USA,5,0,0,0,5
2017,Togo,TGO,United States of America,USA,0,0,0,14,14
2017,Trinidad and Tobago,TTO,United States of America,USA,0,0,0,5,5
2017,Uganda,UGA,United States of America,USA,14,0,0,0,14
2017,Ukraine,UKR,United States of America,USA,35,0,10,52,97
2017,Uzbekistan,UZB,United States of America,USA,23,0,0,22,45
2017,Venezuela (Bolivarian Republic of),VEN,United States of America,USA,26,0,10,34,70
2017,Yemen,YEM,United States of America,USA,0,0,0,5,5
2017,Zimbabwe,ZWE,United States of America,USA,0,0,5,10,15
2018,Armenia,ARM,Argentina,ARG,0,0,5,0,5
2018,Bangladesh,BGD,Argentina,ARG,0,0,10,0,10
2018,China,CHN,Argentina,ARG,0,0,0,5,5
2018,Cameroon,CMR,Argentina,ARG,0,0,5,0,5
2018,Colombia,COL,Argentina,ARG,0,0,5,0,5
2018,Cuba,CUB,Argentina,ARG,0,0,82,0,82
2018,Dominican Rep.,DOM,Argentina,ARG,0,0,46,5,51
2018,Ghana,GHA,Argentina,ARG,0,0,31,0,31
2018,Haiti,HTI,Argentina,ARG,0,0,125,14,139
2018,India,IND,Argentina,ARG,0,0,28,5,33
2018,Nigeria,NGA,Argentina,ARG,0,0,5,0,5
2018,Pakistan,PAK,Argentina,ARG,0,0,5,0,5
2018,Russian Federation,RUS,Argentina,ARG,0,0,5,0,5
2018,Senegal,SEN,Argentina,ARG,0,0,295,0,295
2018,Ukraine,UKR,Argentina,ARG,0,0,5,0,5
2018,Iran (Islamic Rep. of),IRN,Armenia,ARM,5,0,10,0,15
2018,Iraq,IRQ,Armenia,ARM,5,0,0,0,5
2018,Afghanistan,AFG,Australia,AUS,36,0,189,5,230
2018,Albania,ALB,Australia,AUS,0,0,12,5,17
2018,Algeria,DZA,Australia,AUS,0,0,5,0,5
2018,Egypt,EGY,Australia,AUS,5,0,18,0,23
2018,Bangladesh,BGD,Australia,AUS,18,0,153,27,198
2018,Brazil,BRA,Australia,AUS,0,0,5,0,5
2018,Cambodia,KHM,Australia,AUS,5,0,0,0,5
2018,China,CHN,Australia,AUS,40,0,424,210,674
2018,Dem. Rep. of the Congo,COD,Australia,AUS,10,0,0,0,10
2018,Colombia,COL,Australia,AUS,5,0,12,0,17
2018,Ethiopia,ETH,Australia,AUS,5,0,5,0,10
2018,Fiji,FJI,Australia,AUS,5,0,117,25,147
2018,Palestinian,PSE,Australia,AUS,0,0,5,0,5
2018,United Kingdom of Great Britain and Northern Ireland,GBR,Australia,AUS,0,0,0,11,11
2018,Germany,DEU,Australia,AUS,0,0,5,0,5
2018,Ghana,GHA,Australia,AUS,0,0,0,12,12
2018,India,IND,Australia,AUS,29,0,173,48,250
2018,Indonesia,IDN,Australia,AUS,10,0,35,38,83
2018,Iran (Islamic Rep. of),IRN,Australia,AUS,150,0,735,48,933
2018,Iraq,IRQ,Australia,AUS,84,0,164,47,295
2018,Israel,ISR,Australia,AUS,0,0,5,0,5
2018,Jordan,JOR,Australia,AUS,0,0,10,0,10
2018,Kenya,KEN,Australia,AUS,0,0,5,5,10
2018,Rep. of Korea,KOR,Australia,AUS,0,0,35,0,35
2018,Dem. People's Rep. of Korea,PRK,Australia,AUS,0,0,5,0,5
2018,Libya,LBY,Australia,AUS,31,0,0,0,31
2018,Lebanon,LBN,Australia,AUS,5,0,125,5,135
2018,Sri Lanka,LKA,Australia,AUS,60,0,1059,24,1143
2018,Malaysia,MYS,Australia,AUS,89,0,1318,1282,2689
2018,Malawi,MWI,Australia,AUS,0,0,5,0,5
2018,Mongolia,MNG,Australia,AUS,0,0,17,5,22
2018,Mauritius,MUS,Australia,AUS,0,0,5,0,5
2018,Myanmar,MMR,Australia,AUS,17,0,23,5,45
2018,Nepal,NPL,Australia,AUS,5,0,37,12,54
2018,Nigeria,NGA,Australia,AUS,0,0,12,5,17
2018,Pakistan,PAK,Australia,AUS,37,0,168,45,250
2018,Philippines,PHL,Australia,AUS,0,0,0,13,13
2018,Papua New Guinea,PNG,Australia,AUS,13,0,16,0,29
2018,South Africa,ZAF,Australia,AUS,0,0,0,13,13
2018,Russian Federation,RUS,Australia,AUS,5,0,5,0,10
2018,Rwanda,RWA,Australia,AUS,0,0,5,0,5
2018,Solomon Islands,SLB,Australia,AUS,0,0,5,0,5
2018,Somalia,SOM,Australia,AUS,10,0,0,0,10
2018,Viet Nam,VNM,Australia,AUS,10,0,218,125,353
2018,Sudan,SDN,Australia,AUS,5,0,11,0,16
2018,Thailand,THA,Australia,AUS,0,0,5,23,28
2018,Turkey,TUR,Australia,AUS,10,0,15,0,25
2018,Ukraine,UKR,Australia,AUS,0,0,11,0,11
2018,United States of America,USA,Australia,AUS,0,0,5,0,5
2018,Zambia,ZMB,Australia,AUS,0,0,5,0,5
2018,Zimbabwe,ZWE,Australia,AUS,13,0,0,0,13
2018,Stateless,XXA,Australia,AUS,27,0,10,5,42
2018,Dem. Rep. of the Congo,COD,Burundi,BDI,127,0,179,37,343
2018,Rwanda,RWA,Burundi,BDI,0,0,14,5,19
2018,Afghanistan,AFG,Canada,CAN,10,0,21,0,31
2018,Albania,ALB,Canada,CAN,14,0,34,5,53
2018,Algeria,DZA,Canada,CAN,0,0,14,0,14
2018,Angola,AGO,Canada,CAN,0,0,5,0,5
2018,Antigua and Barbuda,ATG,Canada,CAN,0,0,5,0,5
2018,Egypt,EGY,Canada,CAN,10,0,10,0,20
2018,Azerbaijan,AZE,Canada,CAN,10,0,34,5,49
2018,Burundi,BDI,Canada,CAN,13,0,5,0,18
2018,Bangladesh,BGD,Canada,CAN,0,0,35,0,35
2018,Bahamas,BHS,Canada,CAN,0,0,10,0,10
2018,Burkina Faso,BFA,Canada,CAN,0,0,5,0,5
2018,Brazil,BRA,Canada,CAN,5,0,34,0,39
2018,Chad,TCD,Canada,CAN,0,0,24,0,24
2018,China,CHN,Canada,CAN,10,0,241,5,256
2018,Chile,CHL,Canada,CAN,0,0,26,0,26
2018,Cameroon,CMR,Canada,CAN,13,0,51,0,64
2018,Congo,COG,Canada,CAN,5,0,5,0,10
2018,Dem. Rep. of the Congo,COD,Canada,CAN,5,0,64,0,69
2018,Colombia,COL,Canada,CAN,5,0,96,5,106
2018,Costa Rica,CRI,Canada,CAN,0,0,5,0,5
2018,Cuba,CUB,Canada,CAN,0,0,5,0,5
2018,Czechia,CZE,Canada,CAN,0,0,5,0,5
2018,Djibouti,DJI,Canada,CAN,5,0,21,0,26
2018,Dominican Rep.,DOM,Canada,CAN,0,0,5,5,10
2018,Ecuador,ECU,Canada,CAN,0,0,5,0,5
2018,Eritrea,ERI,Canada,CAN,13,0,10,0,23
2018,Ethiopia,ETH,Canada,CAN,5,0,24,0,29
2018,Gambia,GMB,Canada,CAN,0,0,5,0,5
2018,Palestinian,PSE,Canada,CAN,12,0,27,0,39
2018,Georgia,GEO,Canada,CAN,5,0,33,0,38
2018,Ghana,GHA,Canada,CAN,5,0,43,5,53
2018,Guatemala,GTM,Canada,CAN,0,0,17,0,17
2018,Guinea,GIN,Canada,CAN,0,0,13,0,13
2018,Guyana,GUY,Canada,CAN,0,0,18,0,18
2018,Haiti,HTI,Canada,CAN,24,0,533,5,562
2018,Honduras,HND,Canada,CAN,5,0,28,0,33
2018,Croatia,HRV,Canada,CAN,0,0,5,5,10
2018,Hungary,HUN,Canada,CAN,50,0,48,5,103
2018,Cote d'Ivoire,CIV,Canada,CAN,0,0,5,0,5
2018,India,IND,Canada,CAN,17,0,90,5,112
2018,Indonesia,IDN,Canada,CAN,0,0,5,0,5
2018,Iran (Islamic Rep. of),IRN,Canada,CAN,19,0,20,0,39
2018,Iraq,IRQ,Canada,CAN,12,0,61,5,78
2018,Italy,ITA,Canada,CAN,0,0,10,0,10
2018,Jamaica,JAM,Canada,CAN,5,0,25,0,30
2018,Jordan,JOR,Canada,CAN,0,0,12,5,17
2018,Kazakhstan,KAZ,Canada,CAN,0,0,5,0,5
2018,Kenya,KEN,Canada,CAN,5,0,10,0,15
2018,Kyrgyzstan,KGZ,Canada,CAN,0,0,5,0,5
2018,Liberia,LBR,Canada,CAN,0,0,5,0,5
2018,Libya,LBY,Canada,CAN,0,0,5,0,5
2018,Saint Lucia,LCA,Canada,CAN,0,0,5,0,5
2018,Lebanon,LBN,Canada,CAN,11,0,38,0,49
2018,Sri Lanka,LKA,Canada,CAN,0,0,39,0,39
2018,Lithuania,LTU,Canada,CAN,0,0,5,0,5
2018,Latvia,LVA,Canada,CAN,0,0,5,0,5
2018,Mauritania,MRT,Canada,CAN,0,0,5,0,5
2018,Mexico,MEX,Canada,CAN,5,0,86,10,101
2018,Mali,MLI,Canada,CAN,5,0,19,0,24
2018,Montenegro,MNE,Canada,CAN,0,0,5,0,5
2018,Namibia,NAM,Canada,CAN,0,0,5,0,5
2018,Nepal,NPL,Canada,CAN,5,0,15,0,20
2018,Nicaragua,NIC,Canada,CAN,5,0,0,0,5
2018,Nigeria,NGA,Canada,CAN,59,0,632,24,715
2018,Pakistan,PAK,Canada,CAN,5,0,77,12,94
2018,Peru,PER,Canada,CAN,0,0,10,0,10
2018,Philippines,PHL,Canada,CAN,0,0,10,0,10
2018,South Africa,ZAF,Canada,CAN,0,0,16,0,16
2018,Russian Federation,RUS,Canada,CAN,0,0,17,0,17
2018,Rwanda,RWA,Canada,CAN,5,0,13,0,18
2018,El Salvador,SLV,Canada,CAN,0,0,28,5,33
2018,Saudi Arabia,SAU,Canada,CAN,0,0,5,0,5
2018,Serbia and Kosovo: S/RES/1244 (1999),SRB,Canada,CAN,5,0,0,0,5
2018,Senegal,SEN,Canada,CAN,0,0,12,0,12
2018,Sierra Leone,SLE,Canada,CAN,0,0,5,0,5
2018,Somalia,SOM,Canada,CAN,20,0,101,5,126
2018,Spain,ESP,Canada,CAN,0,0,5,0,5
2018,Viet Nam,VNM,Canada,CAN,0,0,5,0,5
2018,Saint Kitts and Nevis,KNA,Canada,CAN,5,0,0,0,5
2018,Sudan,SDN,Canada,CAN,5,0,27,0,32
2018,Slovakia,SVK,Canada,CAN,0,0,5,0,5
2018,Syrian Arab Rep.,SYR,Canada,CAN,5,0,0,0,5
2018,United Rep. of Tanzania,TZA,Canada,CAN,0,0,5,0,5
2018,Togo,TGO,Canada,CAN,0,0,5,0,5
2018,Tunisia,TUN,Canada,CAN,0,0,5,0,5
2018,Turkey,TUR,Canada,CAN,47,0,48,5,100
2018,Uganda,UGA,Canada,CAN,5,0,18,0,23
2018,Ukraine,UKR,Canada,CAN,5,0,13,5,23
2018,United States of America,USA,Canada,CAN,0,0,108,5,113
2018,Uzbekistan,UZB,Canada,CAN,0,0,10,0,10
2018,Saint Vincent and the Grenadines,VCT,Canada,CAN,0,0,13,0,13
2018,Venezuela (Bolivarian Republic of),VEN,Canada,CAN,16,0,41,0,57
2018,Yemen,YEM,Canada,CAN,0,0,5,0,5
2018,Zambia,ZMB,Canada,CAN,0,0,5,0,5
2018,Zimbabwe,ZWE,Canada,CAN,0,0,13,0,13
2018,Stateless,XXA,Canada,CAN,0,0,17,0,17
2018,Colombia,COL,Costa Rica,CRI,0,0,275,12,287
2018,Cuba,CUB,Costa Rica,CRI,0,0,15,0,15
2018,France,FRA,Costa Rica,CRI,0,0,5,0,5
2018,Honduras,HND,Costa Rica,CRI,5,0,30,0,35
2018,Nicaragua,NIC,Costa Rica,CRI,0,0,10,0,10
2018,El Salvador,SLV,Costa Rica,CRI,12,0,404,12,428
2018,Viet Nam,VNM,Costa Rica,CRI,0,0,5,0,5
2018,Turkey,TUR,Costa Rica,CRI,0,0,13,0,13
2018,Venezuela (Bolivarian Republic of),VEN,Costa Rica,CRI,0,0,199,5,204
2018,Egypt,EGY,Cyprus,CYP,0,0,5,21,26
2018,Bangladesh,BGD,Cyprus,CYP,0,0,70,21,91
2018,Palestinian,PSE,Cyprus,CYP,0,0,5,0,5
2018,India,IND,Cyprus,CYP,0,0,164,25,189
2018,Iraq,IRQ,Cyprus,CYP,0,13,0,0,13
2018,Sri Lanka,LKA,Cyprus,CYP,0,0,19,5,24
2018,Nepal,NPL,Cyprus,CYP,0,0,0,5,5
2018,Nigeria,NGA,Cyprus,CYP,5,0,0,0,5
2018,Pakistan,PAK,Cyprus,CYP,0,0,51,19,70
2018,Philippines,PHL,Cyprus,CYP,0,0,11,10,21
2018,Somalia,SOM,Cyprus,CYP,0,0,0,5,5
2018,Viet Nam,VNM,Cyprus,CYP,0,0,115,36,151
2018,Syrian Arab Rep.,SYR,Cyprus,CYP,0,5,5,0,10
2018,Ukraine,UKR,Cyprus,CYP,0,0,0,10,10
2018,Afghanistan,AFG,Denmark,DNK,32,89,380,0,501
2018,Algeria,DZA,Denmark,DNK,0,0,5,0,5
2018,Egypt,EGY,Denmark,DNK,0,0,5,0,5
2018,Armenia,ARM,Denmark,DNK,0,0,17,0,17
2018,Bangladesh,BGD,Denmark,DNK,0,0,10,0,10
2018,China,CHN,Denmark,DNK,5,0,5,0,10
2018,Dem. Rep. of the Congo,COD,Denmark,DNK,0,0,5,0,5
2018,Eritrea,ERI,Denmark,DNK,0,0,5,0,5
2018,Ethiopia,ETH,Denmark,DNK,0,0,14,0,14
2018,Gambia,GMB,Denmark,DNK,0,0,5,0,5
2018,Georgia,GEO,Denmark,DNK,0,0,5,0,5
2018,Iran (Islamic Rep. of),IRN,Denmark,DNK,148,18,460,0,626
2018,Iraq,IRQ,Denmark,DNK,5,12,180,0,197
2018,Libya,LBY,Denmark,DNK,0,0,5,0,5
2018,Lebanon,LBN,Denmark,DNK,0,0,17,0,17
2018,Sri Lanka,LKA,Denmark,DNK,0,0,5,0,5
2018,Morocco,MAR,Denmark,DNK,0,0,5,0,5
2018,Nigeria,NGA,Denmark,DNK,0,0,5,0,5
2018,Pakistan,PAK,Denmark,DNK,0,0,11,0,11
2018,Somalia,SOM,Denmark,DNK,5,5,37,0,47
2018,Syrian Arab Rep.,SYR,Denmark,DNK,0,5,23,0,28
2018,Turkey,TUR,Denmark,DNK,0,0,5,0,5
2018,Uganda,UGA,Denmark,DNK,0,0,11,0,11
2018,Ukraine,UKR,Denmark,DNK,0,0,5,0,5
2018,Stateless,XXA,Denmark,DNK,0,0,245,0,245
2018,Afghanistan,AFG,France,FRA,218,353,215,44,830
2018,Albania,ALB,France,FRA,155,398,2762,2718,6033
2018,Algeria,DZA,France,FRA,34,49,239,1296,1618
2018,Angola,AGO,France,FRA,70,29,391,31,521
2018,Egypt,EGY,France,FRA,117,5,149,42,313
2018,Armenia,ARM,France,FRA,43,56,742,596,1437
2018,Azerbaijan,AZE,France,FRA,44,5,135,35,219
2018,Benin,BEN,France,FRA,5,5,22,5,37
2018,Bangladesh,BGD,France,FRA,457,125,1482,771,2835
2018,Bhutan,BTN,France,FRA,10,0,0,0,10
2018,Burkina Faso,BFA,France,FRA,10,5,59,5,79
2018,Belarus,BLR,France,FRA,0,0,13,0,13
2018,Bosnia and Herzegovina,BIH,France,FRA,16,10,129,169,324
2018,Cambodia,KHM,France,FRA,0,0,12,5,17
2018,Central African Rep.,CAF,France,FRA,36,58,137,28,259
2018,Chad,TCD,France,FRA,85,11,148,26,270
2018,China,CHN,France,FRA,44,0,101,1020,1165
2018,Cameroon,CMR,France,FRA,70,15,181,26,292
2018,Congo,COG,France,FRA,111,22,497,59,689
2018,Dem. Rep. of the Congo,COD,France,FRA,426,77,1673,295,2471
2018,Comoros,COM,France,FRA,0,0,62,37,99
2018,Colombia,COL,France,FRA,5,13,28,10,56
2018,Cuba,CUB,France,FRA,0,0,18,5,23
2018,Djibouti,DJI,France,FRA,28,5,13,0,46
2018,Equatorial Guinea,GNQ,France,FRA,0,0,0,5,5
2018,Eritrea,ERI,France,FRA,92,0,128,5,225
2018,Ethiopia,ETH,France,FRA,39,5,75,12,131
2018,Gabon,GAB,France,FRA,21,17,98,11,147
2018,Gambia,GMB,France,FRA,12,0,103,16,131
2018,Palestinian,PSE,France,FRA,18,0,14,5,37
2018,Georgia,GEO,France,FRA,31,34,567,619,1251
2018,Guinea-Bissau,GNB,France,FRA,0,5,48,13,66
2018,Guinea,GIN,France,FRA,479,127,1616,148,2370
2018,Haiti,HTI,France,FRA,26,14,486,3657,4183
2018,Cote d'Ivoire,CIV,France,FRA,163,60,1015,135,1373
2018,India,IND,France,FRA,5,5,29,25,64
2018,Iran (Islamic Rep. of),IRN,France,FRA,132,10,59,5,206
2018,Iraq,IRQ,France,FRA,34,45,75,24,178
2018,Kazakhstan,KAZ,France,FRA,14,5,37,19,75
2018,Kenya,KEN,France,FRA,5,0,13,5,23
2018,Kyrgyzstan,KGZ,France,FRA,11,0,0,0,11
2018,Dem. People's Rep. of Korea,PRK,France,FRA,5,0,0,0,5
2018,Liberia,LBR,France,FRA,5,0,19,0,24
2018,Libya,LBY,France,FRA,19,43,44,10,116
2018,Lebanon,LBN,France,FRA,5,0,20,5,30
2018,Sri Lanka,LKA,France,FRA,233,24,510,550,1317
2018,Madagascar,MDG,France,FRA,0,0,52,5,57
2018,Mauritania,MRT,France,FRA,102,5,265,180,552
2018,North Macedonia,MKD,France,FRA,5,0,184,283,472
2018,Mali,MLI,France,FRA,56,11,355,519,941
2018,Mongolia,MNG,France,FRA,10,5,61,30,106
2018,Morocco,MAR,France,FRA,42,13,219,32,306
2018,Mozambique,MOZ,France,FRA,0,0,5,0,5
2018,Montenegro,MNE,France,FRA,0,0,21,59,80
2018,Mauritius,MUS,France,FRA,0,0,5,0,5
2018,Myanmar,MMR,France,FRA,5,0,12,21,38
2018,Nepal,NPL,France,FRA,10,5,52,5,72
2018,Niger,NER,France,FRA,5,0,33,5,43
2018,Nigeria,NGA,France,FRA,239,33,1062,143,1477
2018,Pakistan,PAK,France,FRA,210,41,683,740,1674
2018,Peru,PER,France,FRA,0,5,10,10,25
2018,Russian Federation,RUS,France,FRA,200,48,567,289,1104
2018,Rwanda,RWA,France,FRA,16,0,34,18,68
2018,El Salvador,SLV,France,FRA,0,5,0,5,10
2018,Serbia and Kosovo: S/RES/1244 (1999),SRB,France,FRA,186,155,1117,1119,2577
2018,Senegal,SEN,France,FRA,94,14,458,225,791
2018,Sierra Leone,SLE,France,FRA,25,10,52,0,87
2018,Somalia,SOM,France,FRA,85,235,153,37,510
2018,Viet Nam,VNM,France,FRA,5,0,14,5,24
2018,Sudan,SDN,France,FRA,539,407,682,53,1681
2018,Syrian Arab Rep.,SYR,France,FRA,455,22,274,42,793
2018,United Rep. of Tanzania,TZA,France,FRA,0,0,0,5,5
2018,Togo,TGO,France,FRA,14,5,70,17,106
2018,Tunisia,TUN,France,FRA,5,0,67,13,85
2018,Turkey,TUR,France,FRA,294,12,476,101,883
2018,Uganda,UGA,France,FRA,5,0,5,0,10
2018,Ukraine,UKR,France,FRA,28,10,191,66,295
2018,Uzbekistan,UZB,France,FRA,0,0,5,5,10
2018,Venezuela (Bolivarian Republic of),VEN,France,FRA,11,10,37,10,68
2018,Western Sahara,ESH,France,FRA,41,5,272,121,439
2018,Yemen,YEM,France,FRA,0,0,5,0,5
2018,Afghanistan,AFG,Greece,GRC,21,54,106,52,233
2018,Albania,ALB,Greece,GRC,0,0,1052,37,1089
2018,Algeria,DZA,Greece,GRC,0,0,76,24,100
2018,Egypt,EGY,Greece,GRC,5,0,187,13,205
2018,Armenia,ARM,Greece,GRC,0,0,23,0,23
2018,Bangladesh,BGD,Greece,GRC,0,0,456,18,474
2018,Burkina Faso,BFA,Greece,GRC,0,0,5,0,5
2018,China,CHN,Greece,GRC,5,0,36,5,46
2018,Cameroon,CMR,Greece,GRC,0,0,18,24,42
2018,Congo,COG,Greece,GRC,0,0,5,10,15
2018,Dem. Rep. of the Congo,COD,Greece,GRC,17,10,58,34,119
2018,Comoros,COM,Greece,GRC,0,0,0,5,5
2018,Dominican Rep.,DOM,Greece,GRC,0,0,5,0,5
2018,Eritrea,ERI,Greece,GRC,11,0,0,0,11
2018,Ethiopia,ETH,Greece,GRC,0,0,22,0,22
2018,Gambia,GMB,Greece,GRC,0,0,11,0,11
2018,Palestinian,PSE,Greece,GRC,0,0,0,5,5
2018,Georgia,GEO,Greece,GRC,0,0,279,5,284
2018,Ghana,GHA,Greece,GRC,0,0,15,0,15
2018,Guinea,GIN,Greece,GRC,5,0,11,0,16
2018,Haiti,HTI,Greece,GRC,0,0,0,5,5
2018,Cote d'Ivoire,CIV,Greece,GRC,0,0,10,0,10
2018,India,IND,Greece,GRC,0,0,29,0,29
2018,Iran (Islamic Rep. of),IRN,Greece,GRC,20,0,49,24,93
2018,Iraq,IRQ,Greece,GRC,24,12,154,52,242
2018,Lebanon,LBN,Greece,GRC,0,0,10,0,10
2018,Rep. of Moldova,MDA,Greece,GRC,0,0,15,5,20
2018,Mali,MLI,Greece,GRC,0,0,17,0,17
2018,Morocco,MAR,Greece,GRC,5,0,48,15,68
2018,Myanmar,MMR,Greece,GRC,0,0,5,0,5
2018,Nepal,NPL,Greece,GRC,0,0,5,0,5
2018,Nigeria,NGA,Greece,GRC,5,0,43,5,53
2018,Pakistan,PAK,Greece,GRC,15,5,2772,257,3049
2018,Russian Federation,RUS,Greece,GRC,0,0,5,0,5
2018,Serbia and Kosovo: S/RES/1244 (1999),SRB,Greece,GRC,0,0,5,0,5
2018,Senegal,SEN,Greece,GRC,0,0,14,0,14
2018,Sierra Leone,SLE,Greece,GRC,0,0,13,0,13
2018,Somalia,SOM,Greece,GRC,0,0,0,5,5
2018,Sudan,SDN,Greece,GRC,0,0,0,12,12
2018,Syrian Arab Rep.,SYR,Greece,GRC,32,5,0,90,127
2018,Togo,TGO,Greece,GRC,5,0,0,0,5
2018,Tunisia,TUN,Greece,GRC,0,0,12,5,17
2018,Turkey,TUR,Greece,GRC,14,0,5,10,29
2018,Uganda,UGA,Greece,GRC,0,0,5,0,5
2018,Ukraine,UKR,Greece,GRC,0,5,19,0,24
2018,Venezuela (Bolivarian Republic of),VEN,Greece,GRC,0,0,5,0,5
2018,Afghanistan,AFG,Iceland,ISL,0,10,0,17,27
2018,Albania,ALB,Iceland,ISL,0,0,66,10,76
2018,Algeria,DZA,Iceland,ISL,0,0,5,0,5
2018,Egypt,EGY,Iceland,ISL,0,0,5,0,5
2018,Azerbaijan,AZE,Iceland,ISL,0,0,5,5,10
2018,Bangladesh,BGD,Iceland,ISL,0,0,0,5,5
2018,Bosnia and Herzegovina,BIH,Iceland,ISL,0,0,0,11,11
2018,Colombia,COL,Iceland,ISL,0,0,5,0,5
2018,Palestinian,PSE,Iceland,ISL,0,0,0,5,5
2018,Georgia,GEO,Iceland,ISL,0,0,81,5,86
2018,Ghana,GHA,Iceland,ISL,0,0,14,0,14
2018,India,IND,Iceland,ISL,0,0,0,10,10
2018,Iran (Islamic Rep. of),IRN,Iceland,ISL,11,0,0,5,16
2018,Iraq,IRQ,Iceland,ISL,11,0,17,68,96
2018,Libya,LBY,Iceland,ISL,0,0,0,5,5
2018,Sri Lanka,LKA,Iceland,ISL,0,0,0,5,5
2018,North Macedonia,MKD,Iceland,ISL,0,0,22,0,22
2018,Mongolia,MNG,Iceland,ISL,0,0,5,0,5
2018,Morocco,MAR,Iceland,ISL,0,0,11,0,11
2018,Nigeria,NGA,Iceland,ISL,0,0,5,5,10
2018,Pakistan,PAK,Iceland,ISL,0,0,10,17,27
2018,Russian Federation,RUS,Iceland,ISL,0,0,5,5,10
2018,Serbia and Kosovo: S/RES/1244 (1999),SRB,Iceland,ISL,0,0,12,5,17
2018,Senegal,SEN,Iceland,ISL,0,0,5,0,5
2018,Somalia,SOM,Iceland,ISL,5,5,5,21,36
2018,Sudan,SDN,Iceland,ISL,5,0,0,0,5
2018,Syrian Arab Rep.,SYR,Iceland,ISL,0,0,0,12,12
2018,Ukraine,UKR,Iceland,ISL,0,0,13,0,13
2018,Stateless,XXA,Iceland,ISL,0,0,0,10,10
2018,Afghanistan,AFG,Ireland,IRL,5,5,0,14,24
2018,Albania,ALB,Ireland,IRL,22,5,53,15,95
2018,Algeria,DZA,Ireland,IRL,0,0,35,10,45
2018,Egypt,EGY,Ireland,IRL,0,0,5,0,5
2018,Burundi,BDI,Ireland,IRL,0,0,0,5,5
2018,Bangladesh,BGD,Ireland,IRL,11,0,45,0,56
2018,Brazil,BRA,Ireland,IRL,0,0,5,0,5
2018,China,CHN,Ireland,IRL,0,0,5,5,10
2018,Cameroon,CMR,Ireland,IRL,5,5,0,0,10
2018,Dem. Rep. of the Congo,COD,Ireland,IRL,17,0,13,21,51
2018,Palestinian,PSE,Ireland,IRL,0,0,5,0,5
2018,Georgia,GEO,Ireland,IRL,11,0,83,25,119
2018,Ghana,GHA,Ireland,IRL,0,0,14,0,14
2018,India,IND,Ireland,IRL,0,0,17,5,22
2018,Iraq,IRQ,Ireland,IRL,5,0,5,0,10
2018,Kenya,KEN,Ireland,IRL,5,0,0,0,5
2018,Kuwait,KWT,Ireland,IRL,0,0,5,0,5
2018,Liberia,LBR,Ireland,IRL,0,0,5,0,5
2018,Sri Lanka,LKA,Ireland,IRL,0,0,0,5,5
2018,Rep. of Moldova,MDA,Ireland,IRL,0,0,0,5,5
2018,Malaysia,MYS,Ireland,IRL,0,0,0,5,5
2018,Malawi,MWI,Ireland,IRL,11,0,29,14,54
2018,Mauritius,MUS,Ireland,IRL,0,0,0,14,14
2018,Nepal,NPL,Ireland,IRL,0,0,10,0,10
2018,Nigeria,NGA,Ireland,IRL,21,5,95,16,137
2018,Pakistan,PAK,Ireland,IRL,36,11,152,38,237
2018,South Africa,ZAF,Ireland,IRL,12,5,40,5,62
2018,Russian Federation,RUS,Ireland,IRL,5,0,0,0,5
2018,Rwanda,RWA,Ireland,IRL,5,0,0,0,5
2018,Serbia and Kosovo: S/RES/1244 (1999),SRB,Ireland,IRL,5,0,0,5,10
2018,Senegal,SEN,Ireland,IRL,5,0,0,0,5
2018,Sierra Leone,SLE,Ireland,IRL,0,0,5,0,5
2018,Somalia,SOM,Ireland,IRL,5,0,0,0,5
2018,Sudan,SDN,Ireland,IRL,5,0,0,0,5
2018,Eswatini,SWZ,Ireland,IRL,0,0,5,0,5
2018,Ukraine,UKR,Ireland,IRL,13,0,0,0,13
2018,Venezuela (Bolivarian Republic of),VEN,Ireland,IRL,0,0,0,10,10
2018,Zimbabwe,ZWE,Ireland,IRL,56,0,39,21,116
2018,Bangladesh,BGD,Japan,JPN,0,0,82,0,82
2018,India,IND,Japan,JPN,0,0,58,0,58
2018,Indonesia,IDN,Japan,JPN,0,0,1057,0,1057
2018,Sri Lanka,LKA,Japan,JPN,0,0,181,0,181
2018,Myanmar,MMR,Japan,JPN,0,0,167,0,167
2018,Nepal,NPL,Japan,JPN,0,0,545,0,545
2018,Pakistan,PAK,Japan,JPN,0,0,75,0,75
2018,Philippines,PHL,Japan,JPN,0,0,1403,0,1403
2018,Viet Nam,VNM,Japan,JPN,0,0,1933,0,1933
2018,Turkey,TUR,Japan,JPN,0,0,241,0,241
2018,Burundi,BDI,Kenya,KEN,0,0,0,38,38
2018,Dem. Rep. of the Congo,COD,Kenya,KEN,0,0,0,100,100
2018,Eritrea,ERI,Kenya,KEN,0,0,0,11,11
2018,Ethiopia,ETH,Kenya,KEN,0,0,0,589,589
2018,Rwanda,RWA,Kenya,KEN,0,0,0,38,38
2018,Somalia,SOM,Kenya,KEN,0,0,0,21,21
2018,Sudan,SDN,Kenya,KEN,0,0,0,15,15
2018,Uganda,UGA,Kenya,KEN,0,0,0,5,5
2018,Albania,ALB,Luxembourg,LUX,5,0,45,0,50
2018,Algeria,DZA,Luxembourg,LUX,0,0,5,0,5
2018,Bosnia and Herzegovina,BIH,Luxembourg,LUX,0,0,5,0,5
2018,Cameroon,CMR,Luxembourg,LUX,0,0,5,0,5
2018,Dem. Rep. of the Congo,COD,Luxembourg,LUX,0,0,5,0,5
2018,Georgia,GEO,Luxembourg,LUX,0,0,5,0,5
2018,Guinea,GIN,Luxembourg,LUX,0,0,5,0,5
2018,Iraq,IRQ,Luxembourg,LUX,0,0,40,0,40
2018,North Macedonia,MKD,Luxembourg,LUX,0,0,10,0,10
2018,Morocco,MAR,Luxembourg,LUX,0,0,10,0,10
2018,Montenegro,MNE,Luxembourg,LUX,0,0,5,0,5
2018,Nigeria,NGA,Luxembourg,LUX,0,0,5,0,5
2018,Burundi,BDI,Malawi,MWI,0,0,0,21,21
2018,Dem. Rep. of the Congo,COD,Malawi,MWI,0,0,0,11,11
2018,Rwanda,RWA,Malawi,MWI,0,0,0,17,17
2018,Algeria,DZA,Malta,MLT,0,0,5,0,5
2018,Egypt,EGY,Malta,MLT,0,0,0,11,11
2018,Comoros,COM,Malta,MLT,0,0,0,5,5
2018,Eritrea,ERI,Malta,MLT,0,0,0,53,53
2018,Ethiopia,ETH,Malta,MLT,0,0,0,21,21
2018,Gambia,GMB,Malta,MLT,0,0,0,5,5
2018,Iraq,IRQ,Malta,MLT,0,0,0,12,12
2018,Libya,LBY,Malta,MLT,0,0,0,18,18
2018,Mali,MLI,Malta,MLT,0,0,0,5,5
2018,Niger,NER,Malta,MLT,0,0,0,5,5
2018,Nigeria,NGA,Malta,MLT,0,0,0,12,12
2018,Pakistan,PAK,Malta,MLT,0,0,0,5,5
2018,Senegal,SEN,Malta,MLT,0,0,0,5,5
2018,Somalia,SOM,Malta,MLT,0,0,0,350,350
2018,Syrian Arab Rep.,SYR,Malta,MLT,0,0,0,129,129
2018,Tunisia,TUN,Malta,MLT,0,0,0,5,5
2018,Turkey,TUR,Malta,MLT,0,0,0,5,5
2018,Ukraine,UKR,Malta,MLT,0,5,0,20,25
2018,Afghanistan,AFG,Norway,NOR,34,5,608,11,658
2018,Albania,ALB,Norway,NOR,0,0,29,0,29
2018,Algeria,DZA,Norway,NOR,0,0,5,0,5
2018,Angola,AGO,Norway,NOR,0,0,18,0,18
2018,Egypt,EGY,Norway,NOR,0,0,11,0,11
2018,Armenia,ARM,Norway,NOR,0,0,5,0,5
2018,Azerbaijan,AZE,Norway,NOR,0,0,10,0,10
2018,Burundi,BDI,Norway,NOR,0,0,5,0,5
2018,Bangladesh,BGD,Norway,NOR,0,0,15,0,15
2018,China,CHN,Norway,NOR,0,0,15,0,15
2018,Dem. Rep. of the Congo,COD,Norway,NOR,0,0,13,0,13
2018,Eritrea,ERI,Norway,NOR,11,0,162,5,178
2018,Ethiopia,ETH,Norway,NOR,5,0,252,0,257
2018,Gambia,GMB,Norway,NOR,0,0,5,0,5
2018,Georgia,GEO,Norway,NOR,0,0,14,0,14
2018,Guinea,GIN,Norway,NOR,0,0,5,0,5
2018,Cote d'Ivoire,CIV,Norway,NOR,0,0,5,0,5
2018,India,IND,Norway,NOR,0,0,5,0,5
2018,Iran (Islamic Rep. of),IRN,Norway,NOR,30,0,298,5,333
2018,Iraq,IRQ,Norway,NOR,13,5,312,16,346
2018,Jordan,JOR,Norway,NOR,0,0,5,0,5
2018,Kazakhstan,KAZ,Norway,NOR,0,0,5,0,5
2018,Kyrgyzstan,KGZ,Norway,NOR,0,0,5,0,5
2018,Libya,LBY,Norway,NOR,0,0,13,0,13
2018,Lebanon,LBN,Norway,NOR,0,0,10,0,10
2018,Sri Lanka,LKA,Norway,NOR,0,0,14,0,14
2018,Rep. of Moldova,MDA,Norway,NOR,0,0,5,0,5
2018,Mongolia,MNG,Norway,NOR,0,0,5,0,5
2018,Morocco,MAR,Norway,NOR,0,0,25,0,25
2018,Myanmar,MMR,Norway,NOR,0,0,5,0,5
2018,Nigeria,NGA,Norway,NOR,0,0,36,0,36
2018,Pakistan,PAK,Norway,NOR,0,0,39,5,44
2018,Romania,ROU,Norway,NOR,0,0,5,0,5
2018,Russian Federation,RUS,Norway,NOR,5,0,41,0,46
2018,Rwanda,RWA,Norway,NOR,5,0,0,0,5
2018,Saudi Arabia,SAU,Norway,NOR,0,0,5,0,5
2018,Serbia and Kosovo: S/RES/1244 (1999),SRB,Norway,NOR,0,0,24,0,24
2018,Somalia,SOM,Norway,NOR,0,0,111,5,116
2018,Sudan,SDN,Norway,NOR,0,0,18,0,18
2018,Syrian Arab Rep.,SYR,Norway,NOR,5,0,44,14,63
2018,Tajikistan,TJK,Norway,NOR,0,0,5,0,5
2018,Tunisia,TUN,Norway,NOR,0,0,5,0,5
2018,Turkey,TUR,Norway,NOR,0,0,28,0,28
2018,Ukraine,UKR,Norway,NOR,5,0,17,0,22
2018,United States of America,USA,Norway,NOR,0,0,5,0,5
2018,Uzbekistan,UZB,Norway,NOR,0,0,12,0,12
2018,Venezuela (Bolivarian Republic of),VEN,Norway,NOR,5,0,0,0,5
2018,Yemen,YEM,Norway,NOR,0,0,13,0,13
2018,Stateless,XXA,Norway,NOR,0,0,74,5,79
2018,Afghanistan,AFG,Poland,POL,0,0,5,0,5
2018,Algeria,DZA,Poland,POL,0,0,10,0,10
2018,Egypt,EGY,Poland,POL,0,0,5,0,5
2018,Armenia,ARM,Poland,POL,0,0,44,0,44
2018,Azerbaijan,AZE,Poland,POL,0,0,13,5,18
2018,Bangladesh,BGD,Poland,POL,0,0,15,0,15
2018,Belarus,BLR,Poland,POL,0,0,19,0,19
2018,Dem. Rep. of the Congo,COD,Poland,POL,0,0,5,0,5
2018,Cuba,CUB,Poland,POL,0,0,0,5,5
2018,Ethiopia,ETH,Poland,POL,0,0,5,0,5
2018,Georgia,GEO,Poland,POL,0,0,30,5,35
2018,India,IND,Poland,POL,0,0,5,0,5
2018,Iran (Islamic Rep. of),IRN,Poland,POL,0,0,11,0,11
2018,Iraq,IRQ,Poland,POL,0,0,5,0,5
2018,Kazakhstan,KAZ,Poland,POL,5,5,12,0,22
2018,Kyrgyzstan,KGZ,Poland,POL,10,0,37,0,47
2018,Rep. of Moldova,MDA,Poland,POL,0,0,5,0,5
2018,Nigeria,NGA,Poland,POL,0,0,5,0,5
2018,Pakistan,PAK,Poland,POL,0,0,11,0,11
2018,Russian Federation,RUS,Poland,POL,0,10,1039,46,1095
2018,Viet Nam,VNM,Poland,POL,0,0,5,0,5
2018,Tajikistan,TJK,Poland,POL,0,0,104,5,109
2018,Turkey,TUR,Poland,POL,0,0,12,0,12
2018,Ukraine,UKR,Poland,POL,0,10,277,13,300
2018,Uzbekistan,UZB,Poland,POL,0,11,0,0,11
2018,Stateless,XXA,Poland,POL,0,0,5,0,5
2018,Burundi,BDI,South Africa,ZAF,0,0,0,60,60
2018,Bangladesh,BGD,South Africa,ZAF,0,0,0,1165,1165
2018,China,CHN,South Africa,ZAF,0,0,0,38,38
2018,Cameroon,CMR,South Africa,ZAF,0,0,0,219,219
2018,Congo,COG,South Africa,ZAF,0,0,5,97,102
2018,Dem. Rep. of the Congo,COD,South Africa,ZAF,20,0,34,682,736
2018,Eritrea,ERI,South Africa,ZAF,0,0,0,13,13
2018,Ethiopia,ETH,South Africa,ZAF,0,0,34,1331,1365
2018,Ghana,GHA,South Africa,ZAF,0,0,0,618,618
2018,India,IND,South Africa,ZAF,0,0,5,275,280
2018,Kenya,KEN,South Africa,ZAF,0,0,0,50,50
2018,Malawi,MWI,South Africa,ZAF,0,0,0,635,635
2018,Mozambique,MOZ,South Africa,ZAF,0,0,0,241,241
2018,Niger,NER,South Africa,ZAF,0,0,0,66,66
2018,Nigeria,NGA,South Africa,ZAF,0,0,0,1530,1530
2018,Pakistan,PAK,South Africa,ZAF,0,0,5,527,532
2018,Rwanda,RWA,South Africa,ZAF,0,0,0,10,10
2018,Senegal,SEN,South Africa,ZAF,0,0,0,70,70
2018,Somalia,SOM,South Africa,ZAF,0,0,5,295,300
2018,United Rep. of Tanzania,TZA,South Africa,ZAF,0,0,0,82,82
2018,Uganda,UGA,South Africa,ZAF,0,0,0,324,324
2018,Zimbabwe,ZWE,South Africa,ZAF,0,0,0,5734,5734
2018,Dem. Rep. of the Congo,COD,Uganda,UGA,10,0,0,0,10
2018,Eritrea,ERI,Uganda,UGA,112,0,226,0,338
2018,Ethiopia,ETH,Uganda,UGA,12,0,10,0,22
2018,Rwanda,RWA,Uganda,UGA,0,0,5,0,5
2018,Afghanistan,AFG,United States of America,USA,12,0,0,14,26
2018,Albania,ALB,United States of America,USA,45,0,10,27,82
2018,Angola,AGO,United States of America,USA,22,0,0,0,22
2018,Egypt,EGY,United States of America,USA,120,0,32,87,239
2018,Argentina,ARG,United States of America,USA,0,0,0,10,10
2018,Armenia,ARM,United States of America,USA,18,0,5,24,47
2018,Azerbaijan,AZE,United States of America,USA,12,0,0,0,12
2018,Burundi,BDI,United States of America,USA,18,0,0,11,29
2018,Bangladesh,BGD,United States of America,USA,103,0,46,79,228
2018,Bhutan,BTN,United States of America,USA,0,0,0,12,12
2018,Burkina Faso,BFA,United States of America,USA,64,0,15,53,132
2018,Belarus,BLR,United States of America,USA,30,0,5,0,35
2018,Bolivia (Plurinational State of),BOL,United States of America,USA,0,0,0,15,15
2018,Brazil,BRA,United States of America,USA,0,0,5,98,103
2018,Bulgaria,BGR,United States of America,USA,5,0,0,0,5
2018,Central African Rep.,CAF,United States of America,USA,10,0,0,0,10
2018,Chad,TCD,United States of America,USA,5,0,0,0,5
2018,China,CHN,United States of America,USA,2039,0,670,1343,4052
2018,Cameroon,CMR,United States of America,USA,32,0,5,31,68
2018,Congo,COG,United States of America,USA,16,0,5,25,46
2018,Dem. Rep. of the Congo,COD,United States of America,USA,12,0,5,10,27
2018,Colombia,COL,United States of America,USA,10,0,22,91,123
2018,Costa Rica,CRI,United States of America,USA,0,0,0,5,5
2018,Djibouti,DJI,United States of America,USA,5,0,0,0,5
2018,Dominican Rep.,DOM,United States of America,USA,0,0,0,5,5
2018,Ecuador,ECU,United States of America,USA,0,0,32,741,773
2018,Eritrea,ERI,United States of America,USA,35,0,0,16,51
2018,Ethiopia,ETH,United States of America,USA,96,0,10,44,150
2018,Gambia,GMB,United States of America,USA,20,0,5,36,61
2018,Palestinian,PSE,United States of America,USA,0,0,0,5,5
2018,Georgia,GEO,United States of America,USA,5,0,5,0,10
2018,Ghana,GHA,United States of America,USA,13,0,0,0,13
2018,Guatemala,GTM,United States of America,USA,48,0,71,513,632
2018,Guinea,GIN,United States of America,USA,35,0,12,28,75
2018,Guyana,GUY,United States of America,USA,0,0,0,5,5
2018,Haiti,HTI,United States of America,USA,10,0,42,113,165
2018,Honduras,HND,United States of America,USA,42,0,43,158,243
2018,Cote d'Ivoire,CIV,United States of America,USA,22,0,14,32,68
2018,India,IND,United States of America,USA,236,0,77,224,537
2018,Indonesia,IDN,United States of America,USA,20,0,5,51,76
2018,Iran (Islamic Rep. of),IRN,United States of America,USA,49,0,5,36,90
2018,Iraq,IRQ,United States of America,USA,64,0,5,105,174
2018,Israel,ISR,United States of America,USA,0,0,0,11,11
2018,Jamaica,JAM,United States of America,USA,0,0,0,5,5
2018,Jordan,JOR,United States of America,USA,17,0,0,16,33
2018,Kazakhstan,KAZ,United States of America,USA,26,0,5,19,50
2018,Kenya,KEN,United States of America,USA,19,0,5,21,45
2018,Kyrgyzstan,KGZ,United States of America,USA,49,0,12,43,104
2018,Lao People's Dem. Rep.,LAO,United States of America,USA,0,0,0,5,5
2018,Liberia,LBR,United States of America,USA,11,0,0,22,33
2018,Libya,LBY,United States of America,USA,10,0,0,5,15
2018,Lebanon,LBN,United States of America,USA,14,0,0,10,24
2018,Sri Lanka,LKA,United States of America,USA,32,0,15,23,70
2018,Mauritania,MRT,United States of America,USA,17,0,5,26,48
2018,Rep. of Moldova,MDA,United States of America,USA,46,0,14,13,73
2018,Mexico,MEX,United States of America,USA,25,0,154,2277,2456
2018,Mali,MLI,United States of America,USA,27,0,11,41,79
2018,Malaysia,MYS,United States of America,USA,0,0,5,16,21
2018,Mongolia,MNG,United States of America,USA,22,0,10,14,46
2018,Myanmar,MMR,United States of America,USA,10,0,0,10,20
2018,Nepal,NPL,United States of America,USA,204,0,50,94,348
2018,Niger,NER,United States of America,USA,0,0,0,11,11
2018,Nicaragua,NIC,United States of America,USA,0,0,5,15,20
2018,Nigeria,NGA,United States of America,USA,20,0,15,83,118
2018,Pakistan,PAK,United States of America,USA,108,0,36,88,232
2018,Peru,PER,United States of America,USA,0,0,5,60,65
2018,Philippines,PHL,United States of America,USA,5,0,10,55,70
2018,Poland,POL,United States of America,USA,0,0,0,49,49
2018,Romania,ROU,United States of America,USA,0,0,0,37,37
2018,Russian Federation,RUS,United States of America,USA,72,0,15,98,185
2018,Rwanda,RWA,United States of America,USA,34,0,5,5,44
2018,El Salvador,SLV,United States of America,USA,27,0,50,436,513
2018,Saudi Arabia,SAU,United States of America,USA,5,0,0,33,38
2018,Serbia and Kosovo: S/RES/1244 (1999),SRB,United States of America,USA,34,0,0,5,39
2018,Senegal,SEN,United States of America,USA,5,0,10,27,42
2018,Sierra Leone,SLE,United States of America,USA,5,0,0,12,17
2018,Somalia,SOM,United States of America,USA,0,0,0,5,5
2018,Sudan,SDN,United States of America,USA,20,0,0,13,33
2018,Syrian Arab Rep.,SYR,United States of America,USA,80,0,12,70,162
2018,Tajikistan,TJK,United States of America,USA,13,0,0,5,18
2018,Turkmenistan,TKM,United States of America,USA,14,0,0,0,14
2018,Togo,TGO,United States of America,USA,5,0,0,5,10
2018,Trinidad and Tobago,TTO,United States of America,USA,0,0,0,12,12
2018,Turkey,TUR,United States of America,USA,0,0,0,20,20
2018,United Arab Emirates,ARE,United States of America,USA,5,0,0,0,5
2018,Uganda,UGA,United States of America,USA,14,0,10,17,41
2018,Ukraine,UKR,United States of America,USA,70,0,19,70,159
2018,Uzbekistan,UZB,United States of America,USA,39,0,10,29,78
2018,Venezuela (Bolivarian Republic of),VEN,United States of America,USA,67,0,25,283,375
2018,Yemen,YEM,United States of America,USA,14,0,0,23,37
2018,Zimbabwe,ZWE,United States of America,USA,5,0,5,5,15
2019,Bangladesh,BGD,Argentina,ARG,0,0,0,5,5
2019,Colombia,COL,Argentina,ARG,0,0,14,0,14
2019,Cuba,CUB,Argentina,ARG,0,0,10,0,10
2019,Dominican Rep.,DOM,Argentina,ARG,0,0,11,0,11
2019,Ghana,GHA,Argentina,ARG,0,0,10,0,10
2019,Haiti,HTI,Argentina,ARG,0,0,23,0,23
2019,India,IND,Argentina,ARG,0,0,5,0,5
2019,Russian Federation,RUS,Argentina,ARG,0,0,10,0,10
2019,Senegal,SEN,Argentina,ARG,0,0,203,0,203
2019,Afghanistan,AFG,Armenia,ARM,5,0,0,0,5
2019,Afghanistan,AFG,Australia,AUS,36,0,77,0,113
2019,Albania,ALB,Australia,AUS,0,0,10,0,10
2019,Egypt,EGY,Australia,AUS,12,0,10,5,27
2019,Bangladesh,BGD,Australia,AUS,14,0,196,10,220
2019,Cambodia,KHM,Australia,AUS,13,0,5,0,18
2019,Canada,CAN,Australia,AUS,0,0,5,0,5
2019,China,CHN,Australia,AUS,54,0,771,171,996
2019,Cameroon,CMR,Australia,AUS,5,0,0,0,5
2019,Dem. Rep. of the Congo,COD,Australia,AUS,5,0,0,0,5
2019,Ethiopia,ETH,Australia,AUS,5,0,12,0,17
2019,Fiji,FJI,Australia,AUS,5,0,57,14,76
2019,Gambia,GMB,Australia,AUS,0,0,5,0,5
2019,United Kingdom of Great Britain and Northern Ireland,GBR,Australia,AUS,0,0,5,5,10
2019,Ghana,GHA,Australia,AUS,0,0,5,12,17
2019,Guinea,GIN,Australia,AUS,0,0,5,0,5
2019,Honduras,HND,Australia,AUS,0,0,5,0,5
2019,India,IND,Australia,AUS,37,0,280,38,355
2019,Indonesia,IDN,Australia,AUS,0,0,72,20,92
2019,Ireland,IRL,Australia,AUS,0,0,5,0,5
2019,Iran (Islamic Rep. of),IRN,Australia,AUS,73,0,456,11,540
2019,Iraq,IRQ,Australia,AUS,37,0,113,17,167
2019,Italy,ITA,Australia,AUS,0,0,10,0,10
2019,Jordan,JOR,Australia,AUS,0,0,13,0,13
2019,Kenya,KEN,Australia,AUS,0,0,5,0,5
2019,Rep. of Korea,KOR,Australia,AUS,5,0,29,5,39
2019,Liberia,LBR,Australia,AUS,0,0,5,0,5
2019,Libya,LBY,Australia,AUS,23,0,0,0,23
2019,Lebanon,LBN,Australia,AUS,0,0,101,5,106
2019,Sri Lanka,LKA,Australia,AUS,51,0,592,11,654
2019,Latvia,LVA,Australia,AUS,0,0,5,0,5
2019,Mexico,MEX,Australia,AUS,5,0,0,0,5
2019,Malaysia,MYS,Australia,AUS,30,0,1200,542,1772
2019,Mongolia,MNG,Australia,AUS,5,0,0,0,5
2019,Mauritius,MUS,Australia,AUS,0,0,5,0,5
2019,Myanmar,MMR,Australia,AUS,10,0,34,0,44
2019,Nepal,NPL,Australia,AUS,0,0,58,19,77
2019,Netherlands,NLD,Australia,AUS,0,0,5,0,5
2019,Nigeria,NGA,Australia,AUS,12,0,28,5,45
2019,Pakistan,PAK,Australia,AUS,101,0,336,17,454
2019,Peru,PER,Australia,AUS,5,0,5,0,10
2019,Philippines,PHL,Australia,AUS,5,0,0,0,5
2019,Papua New Guinea,PNG,Australia,AUS,11,0,10,5,26
2019,South Africa,ZAF,Australia,AUS,5,0,5,0,10
2019,Russian Federation,RUS,Australia,AUS,0,0,5,0,5
2019,Rwanda,RWA,Australia,AUS,13,0,5,0,18
2019,El Salvador,SLV,Australia,AUS,0,0,5,0,5
2019,Saudi Arabia,SAU,Australia,AUS,10,0,0,0,10
2019,Singapore,SGP,Australia,AUS,0,0,5,0,5
2019,Somalia,SOM,Australia,AUS,0,0,5,0,5
2019,Viet Nam,VNM,Australia,AUS,12,0,188,54,254
2019,Sudan,SDN,Australia,AUS,0,0,13,5,18
2019,Thailand,THA,Australia,AUS,0,0,19,31,50
2019,Tonga,TON,Australia,AUS,0,0,5,0,5
2019,Turkey,TUR,Australia,AUS,25,0,16,0,41
2019,Uganda,UGA,Australia,AUS,5,0,0,0,5
2019,Ukraine,UKR,Australia,AUS,0,0,14,0,14
2019,Venezuela (Bolivarian Republic of),VEN,Australia,AUS,5,0,0,0,5
2019,Samoa,WSM,Australia,AUS,0,0,5,0,5
2019,Zimbabwe,ZWE,Australia,AUS,0,0,14,5,19
2019,Stateless,XXA,Australia,AUS,30,0,20,0,50
2019,Dem. Rep. of the Congo,COD,Burundi,BDI,197,0,119,0,316
2019,Rwanda,RWA,Burundi,BDI,20,0,10,0,30
2019,Afghanistan,AFG,Canada,CAN,10,0,46,0,56
2019,Albania,ALB,Canada,CAN,15,0,26,0,41
2019,Algeria,DZA,Canada,CAN,13,0,51,0,64
2019,Angola,AGO,Canada,CAN,5,0,53,0,58
2019,Antigua and Barbuda,ATG,Canada,CAN,0,0,5,0,5
2019,Egypt,EGY,Canada,CAN,19,0,35,0,54
2019,Argentina,ARG,Canada,CAN,0,0,10,0,10
2019,Azerbaijan,AZE,Canada,CAN,14,0,37,10,61
2019,Barbados,BRB,Canada,CAN,5,0,0,0,5
2019,Burundi,BDI,Canada,CAN,0,0,5,0,5
2019,Belgium,BEL,Canada,CAN,0,0,5,0,5
2019,Benin,BEN,Canada,CAN,0,0,5,0,5
2019,Bangladesh,BGD,Canada,CAN,43,0,92,0,135
2019,Bahamas,BHS,Canada,CAN,5,0,15,0,20
2019,Burkina Faso,BFA,Canada,CAN,5,0,5,0,10
2019,Botswana,BWA,Canada,CAN,0,0,10,0,10
2019,Brazil,BRA,Canada,CAN,5,0,93,0,98
2019,Cambodia,KHM,Canada,CAN,0,0,15,0,15
2019,Chad,TCD,Canada,CAN,10,0,37,0,47
2019,China,CHN,Canada,CAN,85,0,311,5,401
2019,Chile,CHL,Canada,CAN,14,0,24,0,38
2019,Cameroon,CMR,Canada,CAN,5,0,12,0,17
2019,Congo,COG,Canada,CAN,5,0,5,0,10
2019,Dem. Rep. of the Congo,COD,Canada,CAN,23,0,75,10,108
2019,Colombia,COL,Canada,CAN,49,0,265,5,319
2019,Cuba,CUB,Canada,CAN,0,0,18,0,18
2019,Czechia,CZE,Canada,CAN,5,0,15,0,20
2019,Djibouti,DJI,Canada,CAN,25,0,33,0,58
2019,Dominican Rep.,DOM,Canada,CAN,0,0,10,0,10
2019,Ecuador,ECU,Canada,CAN,0,0,10,0,10
2019,Eritrea,ERI,Canada,CAN,13,0,26,0,39
2019,Ethiopia,ETH,Canada,CAN,36,0,65,5,106
2019,France,FRA,Canada,CAN,0,0,5,0,5
2019,Gambia,GMB,Canada,CAN,0,0,5,0,5
2019,Palestinian,PSE,Canada,CAN,15,0,33,0,48
2019,Georgia,GEO,Canada,CAN,10,0,25,5,40
2019,Germany,DEU,Canada,CAN,0,0,5,0,5
2019,Ghana,GHA,Canada,CAN,18,0,74,0,92
2019,Guinea-Bissau,GNB,Canada,CAN,0,0,5,0,5
2019,Greece,GRC,Canada,CAN,5,0,0,0,5
2019,Guatemala,GTM,Canada,CAN,10,0,21,0,31
2019,Guinea,GIN,Canada,CAN,0,0,15,0,15
2019,Guyana,GUY,Canada,CAN,10,0,19,0,29
2019,Haiti,HTI,Canada,CAN,140,0,1371,18,1529
2019,Honduras,HND,Canada,CAN,10,0,24,0,34
2019,Hungary,HUN,Canada,CAN,57,0,52,5,114
2019,Cote d'Ivoire,CIV,Canada,CAN,0,0,10,0,10
2019,India,IND,Canada,CAN,78,0,383,5,466
2019,Indonesia,IDN,Canada,CAN,0,0,5,0,5
2019,Ireland,IRL,Canada,CAN,0,0,5,0,5
2019,Iran (Islamic Rep. of),IRN,Canada,CAN,57,0,37,5,99
2019,Iraq,IRQ,Canada,CAN,25,0,22,5,52
2019,Israel,ISR,Canada,CAN,5,0,5,0,10
2019,Italy,ITA,Canada,CAN,5,0,19,0,24
2019,Jamaica,JAM,Canada,CAN,5,0,36,0,41
2019,Jordan,JOR,Canada,CAN,16,0,56,0,72
2019,Kenya,KEN,Canada,CAN,5,0,11,0,16
2019,Rep. of Korea,KOR,Canada,CAN,0,0,5,0,5
2019,Dem. People's Rep. of Korea,PRK,Canada,CAN,0,0,35,0,35
2019,Libya,LBY,Canada,CAN,0,0,13,5,18
2019,Saint Lucia,LCA,Canada,CAN,0,0,10,0,10
2019,Lebanon,LBN,Canada,CAN,26,0,58,0,84
2019,Sri Lanka,LKA,Canada,CAN,23,0,42,0,65
2019,Lithuania,LTU,Canada,CAN,0,0,5,0,5
2019,Luxembourg,LUX,Canada,CAN,0,0,5,0,5
2019,Mauritania,MRT,Canada,CAN,10,0,0,0,10
2019,Mexico,MEX,Canada,CAN,97,0,430,16,543
2019,Mali,MLI,Canada,CAN,10,0,12,0,22
2019,Malawi,MWI,Canada,CAN,0,0,5,0,5
2019,Morocco,MAR,Canada,CAN,0,0,12,0,12
2019,Namibia,NAM,Canada,CAN,0,0,15,0,15
2019,Nepal,NPL,Canada,CAN,5,0,16,0,21
2019,Netherlands,NLD,Canada,CAN,0,0,5,0,5
2019,Niger,NER,Canada,CAN,5,0,0,0,5
2019,Nigeria,NGA,Canada,CAN,498,0,1936,46,2480
2019,Pakistan,PAK,Canada,CAN,52,0,216,5,273
2019,Panama,PAN,Canada,CAN,0,0,5,0,5
2019,Peru,PER,Canada,CAN,0,0,19,0,19
2019,Philippines,PHL,Canada,CAN,5,0,17,0,22
2019,Poland,POL,Canada,CAN,10,0,5,0,15
2019,Portugal,PRT,Canada,CAN,0,0,10,0,10
2019,Romania,ROU,Canada,CAN,24,0,18,0,42
2019,South Africa,ZAF,Canada,CAN,5,0,36,5,46
2019,Russian Federation,RUS,Canada,CAN,0,0,5,0,5
2019,Rwanda,RWA,Canada,CAN,5,0,27,0,32
2019,El Salvador,SLV,Canada,CAN,19,0,78,0,97
2019,Saudi Arabia,SAU,Canada,CAN,10,0,21,0,31
2019,Serbia and Kosovo: S/RES/1244 (1999),SRB,Canada,CAN,0,0,5,0,5
2019,Senegal,SEN,Canada,CAN,0,0,10,0,10
2019,Somalia,SOM,Canada,CAN,59,0,49,0,108
2019,Spain,ESP,Canada,CAN,0,0,13,0,13
2019,Viet Nam,VNM,Canada,CAN,0,0,13,0,13
2019,Sudan,SDN,Canada,CAN,40,0,30,0,70
2019,Slovakia,SVK,Canada,CAN,11,0,0,5,16
2019,Syrian Arab Rep.,SYR,Canada,CAN,5,0,5,0,10
2019,United Rep. of Tanzania,TZA,Canada,CAN,5,0,5,0,10
2019,Thailand,THA,Canada,CAN,0,0,5,0,5
2019,Togo,TGO,Canada,CAN,0,0,5,0,5
2019,Trinidad and Tobago,TTO,Canada,CAN,0,0,5,0,5
2019,Tunisia,TUN,Canada,CAN,0,0,5,5,10
2019,Turkey,TUR,Canada,CAN,45,0,32,0,77
2019,Uganda,UGA,Canada,CAN,12,0,21,0,33
2019,Ukraine,UKR,Canada,CAN,10,0,16,0,26
2019,United States of America,USA,Canada,CAN,16,0,393,13,422
2019,Uzbekistan,UZB,Canada,CAN,5,0,0,0,5
2019,Saint Vincent and the Grenadines,VCT,Canada,CAN,0,0,15,0,15
2019,Venezuela (Bolivarian Republic of),VEN,Canada,CAN,38,0,83,0,121
2019,Yemen,YEM,Canada,CAN,14,0,0,0,14
2019,Zimbabwe,ZWE,Canada,CAN,0,0,15,0,15
2019,Angola,AGO,Costa Rica,CRI,0,0,5,0,5
2019,Colombia,COL,Costa Rica,CRI,0,0,110,38,148
2019,Cuba,CUB,Costa Rica,CRI,0,0,10,5,15
2019,Ghana,GHA,Costa Rica,CRI,0,0,0,5,5
2019,Guatemala,GTM,Costa Rica,CRI,0,0,5,0,5
2019,Haiti,HTI,Costa Rica,CRI,0,0,5,0,5
2019,Honduras,HND,Costa Rica,CRI,5,0,10,5,20
2019,India,IND,Costa Rica,CRI,0,0,5,0,5
2019,Nicaragua,NIC,Costa Rica,CRI,0,0,26,5,31
2019,El Salvador,SLV,Costa Rica,CRI,30,0,165,14,209
2019,Venezuela (Bolivarian Republic of),VEN,Costa Rica,CRI,0,0,203,23,226
2019,Egypt,EGY,Cyprus,CYP,0,0,0,19,19
2019,Bangladesh,BGD,Cyprus,CYP,0,0,220,11,231
2019,Cameroon,CMR,Cyprus,CYP,0,0,5,0,5
2019,Dem. Rep. of the Congo,COD,Cyprus,CYP,0,0,0,5,5
2019,Gambia,GMB,Cyprus,CYP,0,0,5,0,5
2019,Palestinian,PSE,Cyprus,CYP,0,0,11,5,16
2019,Georgia,GEO,Cyprus,CYP,0,0,5,5,10
2019,India,IND,Cyprus,CYP,0,0,198,31,229
2019,Iraq,IRQ,Cyprus,CYP,0,0,0,33,33
2019,Sri Lanka,LKA,Cyprus,CYP,0,0,37,15,52
2019,Nepal,NPL,Cyprus,CYP,0,0,0,13,13
2019,Nigeria,NGA,Cyprus,CYP,0,0,0,5,5
2019,Pakistan,PAK,Cyprus,CYP,0,0,50,13,63
2019,Philippines,PHL,Cyprus,CYP,0,0,10,0,10
2019,Somalia,SOM,Cyprus,CYP,5,0,0,0,5
2019,Viet Nam,VNM,Cyprus,CYP,0,0,201,25,226
2019,Turkey,TUR,Cyprus,CYP,10,0,0,0,10
2019,Ukraine,UKR,Cyprus,CYP,0,0,0,5,5
2019,Afghanistan,AFG,Denmark,DNK,11,57,178,0,246
2019,Algeria,DZA,Denmark,DNK,0,0,5,0,5
2019,Egypt,EGY,Denmark,DNK,0,0,5,0,5
2019,Armenia,ARM,Denmark,DNK,0,5,16,0,21
2019,Azerbaijan,AZE,Denmark,DNK,5,0,5,0,10
2019,Burundi,BDI,Denmark,DNK,0,0,5,0,5
2019,Bangladesh,BGD,Denmark,DNK,0,0,5,0,5
2019,Belarus,BLR,Denmark,DNK,0,0,5,0,5
2019,Cameroon,CMR,Denmark,DNK,0,0,14,0,14
2019,Dem. Rep. of the Congo,COD,Denmark,DNK,0,0,10,0,10
2019,Colombia,COL,Denmark,DNK,0,0,16,0,16
2019,Eritrea,ERI,Denmark,DNK,11,0,0,0,11
2019,Ethiopia,ETH,Denmark,DNK,0,0,17,0,17
2019,Gambia,GMB,Denmark,DNK,0,0,5,0,5
2019,Georgia,GEO,Denmark,DNK,0,0,49,0,49
2019,Ghana,GHA,Denmark,DNK,0,0,5,0,5
2019,Guinea,GIN,Denmark,DNK,0,0,5,0,5
2019,India,IND,Denmark,DNK,0,0,5,0,5
2019,Indonesia,IDN,Denmark,DNK,0,0,10,0,10
2019,Iran (Islamic Rep. of),IRN,Denmark,DNK,71,10,126,0,207
2019,Iraq,IRQ,Denmark,DNK,0,0,139,0,139
2019,Jordan,JOR,Denmark,DNK,0,0,14,0,14
2019,Kenya,KEN,Denmark,DNK,0,0,10,0,10
2019,Lebanon,LBN,Denmark,DNK,0,0,5,0,5
2019,Sri Lanka,LKA,Denmark,DNK,0,0,16,0,16
2019,Morocco,MAR,Denmark,DNK,0,0,17,0,17
2019,Myanmar,MMR,Denmark,DNK,0,0,5,0,5
2019,Nigeria,NGA,Denmark,DNK,0,0,29,0,29
2019,Pakistan,PAK,Denmark,DNK,0,0,5,0,5
2019,Russian Federation,RUS,Denmark,DNK,5,0,39,0,44
2019,El Salvador,SLV,Denmark,DNK,0,0,5,0,5
2019,Sierra Leone,SLE,Denmark,DNK,0,0,5,0,5
2019,Somalia,SOM,Denmark,DNK,0,0,71,0,71
2019,Viet Nam,VNM,Denmark,DNK,0,0,5,0,5
2019,Syrian Arab Rep.,SYR,Denmark,DNK,5,5,12,0,22
2019,Tunisia,TUN,Denmark,DNK,0,0,5,0,5
2019,Turkey,TUR,Denmark,DNK,0,0,18,0,18
2019,Uganda,UGA,Denmark,DNK,0,0,17,0,17
2019,Ukraine,UKR,Denmark,DNK,5,0,19,0,24
2019,Venezuela (Bolivarian Republic of),VEN,Denmark,DNK,0,0,11,0,11
2019,Stateless,XXA,Denmark,DNK,0,0,84,0,84
2019,Afghanistan,AFG,France,FRA,521,1208,506,10,2245
2019,Albania,ALB,France,FRA,118,277,1572,18,1985
2019,Algeria,DZA,France,FRA,66,45,249,10,370
2019,Angola,AGO,France,FRA,73,49,481,0,603
2019,Egypt,EGY,France,FRA,128,5,209,0,342
2019,Argentina,ARG,France,FRA,0,0,5,0,5
2019,Armenia,ARM,France,FRA,22,71,712,10,815
2019,Azerbaijan,AZE,France,FRA,88,10,136,0,234
2019,Burundi,BDI,France,FRA,12,0,45,0,57
2019,Benin,BEN,France,FRA,5,5,59,0,69
2019,Bangladesh,BGD,France,FRA,483,174,1703,5,2365
2019,Bhutan,BTN,France,FRA,5,0,0,0,5
2019,Burkina Faso,BFA,France,FRA,23,10,105,0,138
2019,Belarus,BLR,France,FRA,10,0,28,0,38
2019,Bolivia (Plurinational State of),BOL,France,FRA,0,0,5,0,5
2019,Brazil,BRA,France,FRA,0,0,27,0,27
2019,Bosnia and Herzegovina,BIH,France,FRA,14,5,93,0,112
2019,Cambodia,KHM,France,FRA,5,5,29,0,39
2019,Central African Rep.,CAF,France,FRA,99,106,356,5,566
2019,Chad,TCD,France,FRA,136,39,337,5,517
2019,China,CHN,France,FRA,20,0,51,0,71
2019,Cameroon,CMR,France,FRA,148,49,381,5,583
2019,Congo,COG,France,FRA,105,31,590,15,741
2019,Dem. Rep. of the Congo,COD,France,FRA,443,125,1950,12,2530
2019,Comoros,COM,France,FRA,5,0,144,0,149
2019,Colombia,COL,France,FRA,13,19,55,5,92
2019,Cuba,CUB,France,FRA,10,0,29,0,39
2019,Djibouti,DJI,France,FRA,29,10,19,0,58
2019,Dominican Rep.,DOM,France,FRA,0,0,53,5,58
2019,Equatorial Guinea,GNQ,France,FRA,5,0,13,0,18
2019,Eritrea,ERI,France,FRA,216,5,155,5,381
2019,Ethiopia,ETH,France,FRA,80,5,148,0,233
2019,Gabon,GAB,France,FRA,43,15,185,5,248
2019,Gambia,GMB,France,FRA,21,5,150,0,176
2019,Palestinian,PSE,France,FRA,35,10,24,0,69
2019,Georgia,GEO,France,FRA,83,89,1391,28,1591
2019,Ghana,GHA,France,FRA,5,0,47,0,52
2019,Guinea-Bissau,GNB,France,FRA,10,0,88,0,98
2019,Guinea,GIN,France,FRA,801,153,2312,13,3279
2019,Haiti,HTI,France,FRA,35,18,391,5,449
2019,Honduras,HND,France,FRA,5,5,5,0,15
2019,Cote d'Ivoire,CIV,France,FRA,607,149,2866,18,3640
2019,India,IND,France,FRA,5,0,112,0,117
2019,Iran (Islamic Rep. of),IRN,France,FRA,169,5,106,0,280
2019,Iraq,IRQ,France,FRA,79,49,208,5,341
2019,Kazakhstan,KAZ,France,FRA,19,5,69,0,93
2019,Kenya,KEN,France,FRA,10,0,18,0,28
2019,Kyrgyzstan,KGZ,France,FRA,0,0,14,0,14
2019,Rep. of Korea,KOR,France,FRA,0,0,5,0,5
2019,Dem. People's Rep. of Korea,PRK,France,FRA,5,0,0,0,5
2019,Kuwait,KWT,France,FRA,18,0,5,0,23
2019,Lao People's Dem. Rep.,LAO,France,FRA,0,0,10,0,10
2019,Liberia,LBR,France,FRA,5,0,30,0,35
2019,Libya,LBY,France,FRA,53,109,77,5,244
2019,Lebanon,LBN,France,FRA,5,0,32,0,37
2019,Sri Lanka,LKA,France,FRA,288,29,535,5,857
2019,Madagascar,MDG,France,FRA,0,10,42,0,52
2019,Mauritania,MRT,France,FRA,191,10,393,0,594
2019,North Macedonia,MKD,France,FRA,15,11,181,0,207
2019,Rep. of Moldova,MDA,France,FRA,0,0,22,0,22
2019,Mexico,MEX,France,FRA,0,0,5,0,5
2019,Mali,MLI,France,FRA,145,40,792,5,982
2019,Mongolia,MNG,France,FRA,11,5,85,0,101
2019,Morocco,MAR,France,FRA,58,17,278,0,353
2019,Mozambique,MOZ,France,FRA,0,0,5,0,5
2019,Montenegro,MNE,France,FRA,5,0,22,0,27
2019,Mauritius,MUS,France,FRA,0,0,5,0,5
2019,Myanmar,MMR,France,FRA,13,0,18,0,31
2019,Nepal,NPL,France,FRA,5,10,76,0,91
2019,Niger,NER,France,FRA,13,5,32,0,50
2019,Nicaragua,NIC,France,FRA,0,0,10,0,10
2019,Nigeria,NGA,France,FRA,445,63,1764,5,2277
2019,Pakistan,PAK,France,FRA,171,47,734,0,952
2019,Peru,PER,France,FRA,5,5,24,0,34
2019,South Africa,ZAF,France,FRA,0,0,5,0,5
2019,Russian Federation,RUS,France,FRA,376,81,721,11,1189
2019,Rwanda,RWA,France,FRA,35,5,70,5,115
2019,El Salvador,SLV,France,FRA,0,0,13,0,13
2019,Serbia and Kosovo: S/RES/1244 (1999),SRB,France,FRA,172,123,835,16,1146
2019,Senegal,SEN,France,FRA,177,32,786,5,1000
2019,Sierra Leone,SLE,France,FRA,47,10,97,0,154
2019,Somalia,SOM,France,FRA,133,406,205,10,754
2019,Viet Nam,VNM,France,FRA,11,0,22,0,33
2019,Sudan,SDN,France,FRA,743,635,884,23,2285
2019,Suriname,SUR,France,FRA,0,0,10,0,10
2019,South Sudan,SSD,France,FRA,0,13,0,0,13
2019,Syrian Arab Rep.,SYR,France,FRA,646,90,406,20,1162
2019,United Rep. of Tanzania,TZA,France,FRA,0,0,5,0,5
2019,Tajikistan,TJK,France,FRA,12,0,0,0,12
2019,Togo,TGO,France,FRA,31,5,152,0,188
2019,Tunisia,TUN,France,FRA,14,10,131,0,155
2019,Turkey,TUR,France,FRA,496,5,765,0,1266
2019,Uganda,UGA,France,FRA,11,0,10,0,21
2019,Ukraine,UKR,France,FRA,53,30,201,5,289
2019,United States of America,USA,France,FRA,0,0,5,0,5
2019,Uzbekistan,UZB,France,FRA,0,0,5,0,5
2019,Venezuela (Bolivarian Republic of),VEN,France,FRA,25,11,102,0,138
2019,Western Sahara,ESH,France,FRA,115,25,892,5,1037
2019,Yemen,YEM,France,FRA,19,24,12,0,55
2019,Zimbabwe,ZWE,France,FRA,5,0,5,0,10
2019,Afghanistan,AFG,Iceland,ISL,0,14,0,56,70
2019,Albania,ALB,Iceland,ISL,0,0,19,5,24
2019,Algeria,DZA,Iceland,ISL,0,0,0,5,5
2019,Egypt,EGY,Iceland,ISL,0,0,5,5,10
2019,Cameroon,CMR,Iceland,ISL,0,0,0,5,5
2019,Colombia,COL,Iceland,ISL,0,0,13,0,13
2019,Eritrea,ERI,Iceland,ISL,0,0,0,5,5
2019,Ethiopia,ETH,Iceland,ISL,0,0,0,5,5
2019,Palestinian,PSE,Iceland,ISL,0,11,0,0,11
2019,Georgia,GEO,Iceland,ISL,0,0,12,0,12
2019,Ghana,GHA,Iceland,ISL,0,0,5,5,10
2019,Cote d'Ivoire,CIV,Iceland,ISL,0,0,0,5,5
2019,Iran (Islamic Rep. of),IRN,Iceland,ISL,5,0,0,30,35
2019,Iraq,IRQ,Iceland,ISL,10,10,63,55,138
2019,Libya,LBY,Iceland,ISL,0,5,0,12,17
2019,North Macedonia,MKD,Iceland,ISL,0,0,5,0,5
2019,Rep. of Moldova,MDA,Iceland,ISL,0,0,30,0,30
2019,Morocco,MAR,Iceland,ISL,0,0,5,15,20
2019,Mozambique,MOZ,Iceland,ISL,0,0,0,5,5
2019,Myanmar,MMR,Iceland,ISL,0,0,5,0,5
2019,Nigeria,NGA,Iceland,ISL,0,0,14,43,57
2019,Pakistan,PAK,Iceland,ISL,0,0,13,13,26
2019,Russian Federation,RUS,Iceland,ISL,5,0,0,5,10
2019,Serbia and Kosovo: S/RES/1244 (1999),SRB,Iceland,ISL,0,0,22,0,22
2019,Somalia,SOM,Iceland,ISL,0,0,5,31,36
2019,Sudan,SDN,Iceland,ISL,0,0,0,5,5
2019,Syrian Arab Rep.,SYR,Iceland,ISL,0,5,0,17,22
2019,Tunisia,TUN,Iceland,ISL,0,0,0,13,13
2019,Ukraine,UKR,Iceland,ISL,0,0,16,5,21
2019,Afghanistan,AFG,Ireland,IRL,14,0,0,5,19
2019,Albania,ALB,Ireland,IRL,54,5,250,35,344
2019,Algeria,DZA,Ireland,IRL,5,0,48,5,58
2019,Angola,AGO,Ireland,IRL,0,0,5,0,5
2019,Egypt,EGY,Ireland,IRL,11,0,5,5,21
2019,Burundi,BDI,Ireland,IRL,5,0,0,0,5
2019,Benin,BEN,Ireland,IRL,0,0,5,0,5
2019,Bangladesh,BGD,Ireland,IRL,21,0,98,5,124
2019,Botswana,BWA,Ireland,IRL,11,0,0,0,11
2019,Brazil,BRA,Ireland,IRL,5,0,22,10,37
2019,China,CHN,Ireland,IRL,5,0,5,0,10
2019,Cameroon,CMR,Ireland,IRL,5,0,10,0,15
2019,Congo,COG,Ireland,IRL,0,0,5,0,5
2019,Dem. Rep. of the Congo,COD,Ireland,IRL,24,5,24,14,67
2019,Ethiopia,ETH,Ireland,IRL,5,0,0,0,5
2019,Georgia,GEO,Ireland,IRL,35,5,128,10,178
2019,Ghana,GHA,Ireland,IRL,0,0,19,0,19
2019,India,IND,Ireland,IRL,5,0,26,5,36
2019,Iran (Islamic Rep. of),IRN,Ireland,IRL,5,0,0,0,5
2019,Iraq,IRQ,Ireland,IRL,14,5,5,0,24
2019,Kuwait,KWT,Ireland,IRL,5,0,0,0,5
2019,Libya,LBY,Ireland,IRL,5,0,0,0,5
2019,Sri Lanka,LKA,Ireland,IRL,0,0,5,0,5
2019,Mexico,MEX,Ireland,IRL,5,0,0,0,5
2019,Malawi,MWI,Ireland,IRL,10,0,34,14,58
2019,Mongolia,MNG,Ireland,IRL,0,0,5,0,5
2019,Morocco,MAR,Ireland,IRL,5,0,5,0,10
2019,Mauritius,MUS,Ireland,IRL,0,0,10,0,10
2019,Nepal,NPL,Ireland,IRL,0,0,5,0,5
2019,Nigeria,NGA,Ireland,IRL,24,5,120,26,175
2019,Pakistan,PAK,Ireland,IRL,60,10,207,41,318
2019,Philippines,PHL,Ireland,IRL,0,0,5,0,5
2019,South Africa,ZAF,Ireland,IRL,34,5,42,5,86
2019,Russian Federation,RUS,Ireland,IRL,0,0,5,0,5
2019,Serbia and Kosovo: S/RES/1244 (1999),SRB,Ireland,IRL,0,0,13,0,13
2019,Sierra Leone,SLE,Ireland,IRL,5,0,5,0,10
2019,Somalia,SOM,Ireland,IRL,0,0,0,5,5
2019,Viet Nam,VNM,Ireland,IRL,0,0,5,0,5
2019,Sudan,SDN,Ireland,IRL,11,0,0,0,11
2019,Eswatini,SWZ,Ireland,IRL,0,0,5,0,5
2019,Tunisia,TUN,Ireland,IRL,5,0,5,0,10
2019,Turkey,TUR,Ireland,IRL,5,0,0,0,5
2019,Ukraine,UKR,Ireland,IRL,5,0,11,5,21
2019,Venezuela (Bolivarian Republic of),VEN,Ireland,IRL,5,0,0,0,5
2019,Zimbabwe,ZWE,Ireland,IRL,66,5,90,26,187
2019,China,CHN,Japan,JPN,0,0,55,0,0
2019,India,IND,Japan,JPN,0,0,80,0,0
2019,Indonesia,IDN,Japan,JPN,0,0,596,0,0
2019,Sri Lanka,LKA,Japan,JPN,0,0,403,0,0
2019,Myanmar,MMR,Japan,JPN,0,0,116,0,0
2019,Nepal,NPL,Japan,JPN,0,0,1606,0,0
2019,Pakistan,PAK,Japan,JPN,0,0,80,0,0
2019,Philippines,PHL,Japan,JPN,0,0,2076,0,0
2019,Turkey,TUR,Japan,JPN,0,0,435,0,0
2019,Afghanistan,AFG,Kazakhstan,KAZ,0,0,103,25,128
2019,China,CHN,Kazakhstan,KAZ,0,0,0,5,5
2019,Burundi,BDI,Kenya,KEN,0,0,0,53,53
2019,Dem. Rep. of the Congo,COD,Kenya,KEN,20,0,0,65,85
2019,Eritrea,ERI,Kenya,KEN,0,0,0,12,12
2019,Ethiopia,ETH,Kenya,KEN,20,0,0,441,461
2019,Rwanda,RWA,Kenya,KEN,0,0,0,69,69
2019,Somalia,SOM,Kenya,KEN,0,0,0,16,16
2019,Uganda,UGA,Kenya,KEN,0,0,0,39,39
2019,Burundi,BDI,Malawi,MWI,0,0,0,11,11
2019,Rwanda,RWA,Malawi,MWI,0,0,0,10,10
2019,Egypt,EGY,Malta,MLT,0,0,5,0,5
2019,Bangladesh,BGD,Malta,MLT,0,0,89,5,94
2019,Comoros,COM,Malta,MLT,0,0,0,5,5
2019,Eritrea,ERI,Malta,MLT,0,0,0,22,22
2019,Ethiopia,ETH,Malta,MLT,0,0,0,5,5
2019,Gambia,GMB,Malta,MLT,0,0,0,28,28
2019,Palestinian,PSE,Malta,MLT,0,0,0,5,5
2019,Guinea,GIN,Malta,MLT,0,0,0,5,5
2019,Cote d'Ivoire,CIV,Malta,MLT,0,0,0,5,5
2019,India,IND,Malta,MLT,0,0,0,5,5
2019,Iraq,IRQ,Malta,MLT,0,5,0,5,10
2019,Libya,LBY,Malta,MLT,5,5,5,23,38
2019,Mali,MLI,Malta,MLT,0,0,0,5,5
2019,Morocco,MAR,Malta,MLT,0,5,0,0,5
2019,Nigeria,NGA,Malta,MLT,0,0,10,12,22
2019,Pakistan,PAK,Malta,MLT,0,0,0,11,11
2019,Senegal,SEN,Malta,MLT,0,0,0,5,5
2019,Somalia,SOM,Malta,MLT,0,0,13,204,217
2019,Sudan,SDN,Malta,MLT,5,0,0,5,10
2019,Syrian Arab Rep.,SYR,Malta,MLT,0,0,0,51,51
2019,Ukraine,UKR,Malta,MLT,0,0,0,10,10
2019,Venezuela (Bolivarian Republic of),VEN,Malta,MLT,0,0,5,11,16
2019,Afghanistan,AFG,Norway,NOR,18,0,156,10,184
2019,Albania,ALB,Norway,NOR,0,5,45,0,50
2019,Algeria,DZA,Norway,NOR,0,0,0,5,5
2019,Angola,AGO,Norway,NOR,0,0,0,10,10
2019,Egypt,EGY,Norway,NOR,0,0,0,5,5
2019,Armenia,ARM,Norway,NOR,0,0,5,0,5
2019,Azerbaijan,AZE,Norway,NOR,0,0,0,5,5
2019,Burundi,BDI,Norway,NOR,0,0,5,0,5
2019,Bangladesh,BGD,Norway,NOR,0,0,17,0,17
2019,Belarus,BLR,Norway,NOR,5,0,0,0,5
2019,Brazil,BRA,Norway,NOR,0,0,5,0,5
2019,China,CHN,Norway,NOR,0,0,10,5,15
2019,Cameroon,CMR,Norway,NOR,0,0,5,0,5
2019,Dem. Rep. of the Congo,COD,Norway,NOR,0,0,5,5,10
2019,Colombia,COL,Norway,NOR,0,0,5,0,5
2019,Djibouti,DJI,Norway,NOR,0,0,5,0,5
2019,Eritrea,ERI,Norway,NOR,10,0,75,20,105
2019,Ethiopia,ETH,Norway,NOR,0,0,83,12,95
2019,Gambia,GMB,Norway,NOR,0,0,5,0,5
2019,Georgia,GEO,Norway,NOR,0,0,10,0,10
2019,Ghana,GHA,Norway,NOR,0,0,5,5,10
2019,Guinea,GIN,Norway,NOR,0,0,5,5,10
2019,India,IND,Norway,NOR,0,0,5,0,5
2019,Iran (Islamic Rep. of),IRN,Norway,NOR,28,0,124,20,172
2019,Iraq,IRQ,Norway,NOR,5,12,94,21,132
2019,Jordan,JOR,Norway,NOR,0,0,0,5,5
2019,Kazakhstan,KAZ,Norway,NOR,0,0,5,0,5
2019,Kenya,KEN,Norway,NOR,0,0,0,5,5
2019,Liberia,LBR,Norway,NOR,0,0,0,5,5
2019,Libya,LBY,Norway,NOR,0,5,0,5,10
2019,Lebanon,LBN,Norway,NOR,0,0,5,0,5
2019,Sri Lanka,LKA,Norway,NOR,0,0,5,0,5
2019,North Macedonia,MKD,Norway,NOR,0,0,5,0,5
2019,Mongolia,MNG,Norway,NOR,0,0,5,0,5
2019,Morocco,MAR,Norway,NOR,0,0,0,14,14
2019,Myanmar,MMR,Norway,NOR,0,0,5,0,5
2019,Nigeria,NGA,Norway,NOR,0,0,12,0,12
2019,Pakistan,PAK,Norway,NOR,0,0,0,11,11
2019,Philippines,PHL,Norway,NOR,0,0,5,0,5
2019,Russian Federation,RUS,Norway,NOR,5,0,28,20,53
2019,Rwanda,RWA,Norway,NOR,0,0,5,0,5
2019,Saudi Arabia,SAU,Norway,NOR,0,0,0,5,5
2019,Serbia and Kosovo: S/RES/1244 (1999),SRB,Norway,NOR,0,0,16,0,16
2019,Somalia,SOM,Norway,NOR,0,0,72,13,85
2019,Sudan,SDN,Norway,NOR,0,0,10,5,15
2019,Syrian Arab Rep.,SYR,Norway,NOR,5,0,11,43,59
2019,United Rep. of Tanzania,TZA,Norway,NOR,0,0,5,0,5
2019,Tajikistan,TJK,Norway,NOR,0,0,0,5,5
2019,Tunisia,TUN,Norway,NOR,0,0,10,0,10
2019,Turkey,TUR,Norway,NOR,0,0,24,13,37
2019,Uganda,UGA,Norway,NOR,0,0,5,0,5
2019,Ukraine,UKR,Norway,NOR,0,0,19,0,19
2019,United States of America,USA,Norway,NOR,0,0,5,0,5
2019,Uzbekistan,UZB,Norway,NOR,0,0,14,0,14
2019,Venezuela (Bolivarian Republic of),VEN,Norway,NOR,0,0,5,0,5
2019,Yemen,YEM,Norway,NOR,0,5,0,5,10
2019,Stateless,XXA,Norway,NOR,0,0,36,12,48
2019,Syrian Arab Rep.,SYR,Paraguay,PRY,5,0,0,0,5
2019,Afghanistan,AFG,Poland,POL,0,0,5,0,5
2019,Egypt,EGY,Poland,POL,0,0,5,0,5
2019,Armenia,ARM,Poland,POL,0,0,19,0,19
2019,Azerbaijan,AZE,Poland,POL,0,0,12,0,12
2019,Bangladesh,BGD,Poland,POL,0,0,5,0,5
2019,Belarus,BLR,Poland,POL,0,0,10,0,10
2019,Georgia,GEO,Poland,POL,0,0,19,0,19
2019,India,IND,Poland,POL,0,0,5,0,5
2019,Iran (Islamic Rep. of),IRN,Poland,POL,0,0,12,0,12
2019,Iraq,IRQ,Poland,POL,0,0,10,0,10
2019,Kazakhstan,KAZ,Poland,POL,0,0,5,0,5
2019,Kyrgyzstan,KGZ,Poland,POL,0,0,5,0,5
2019,Lebanon,LBN,Poland,POL,0,0,5,0,5
2019,Mongolia,MNG,Poland,POL,0,0,5,0,5
2019,Pakistan,PAK,Poland,POL,0,0,17,0,17
2019,Russian Federation,RUS,Poland,POL,0,5,474,0,479
2019,Viet Nam,VNM,Poland,POL,0,0,16,0,16
2019,Tajikistan,TJK,Poland,POL,0,0,27,0,27
2019,Turkey,TUR,Poland,POL,0,0,5,0,5
2019,Ukraine,UKR,Poland,POL,5,0,143,0,148
2019,Uzbekistan,UZB,Poland,POL,0,0,5,0,5
2019,Afghanistan,AFG,South Africa,ZAF,0,0,0,5,5
2019,Algeria,DZA,South Africa,ZAF,0,0,0,70,70
2019,Angola,AGO,South Africa,ZAF,0,0,0,5,5
2019,Egypt,EGY,South Africa,ZAF,0,0,0,32,32
2019,Bahrain,BHR,South Africa,ZAF,0,0,0,5,5
2019,Burundi,BDI,South Africa,ZAF,0,0,0,100,100
2019,Benin,BEN,South Africa,ZAF,0,0,0,17,17
2019,Bangladesh,BGD,South Africa,ZAF,0,0,5,3843,3848
2019,Burkina Faso,BFA,South Africa,ZAF,0,0,0,5,5
2019,Botswana,BWA,South Africa,ZAF,0,0,0,5,5
2019,China,CHN,South Africa,ZAF,0,0,0,75,75
2019,Cameroon,CMR,South Africa,ZAF,0,0,0,407,408
2019,Congo,COG,South Africa,ZAF,0,0,0,115,115
2019,Dem. Rep. of the Congo,COD,South Africa,ZAF,36,0,5,1373,1414
2019,Comoros,COM,South Africa,ZAF,0,0,0,5,5
2019,Eritrea,ERI,South Africa,ZAF,0,0,0,77,77
2019,Ethiopia,ETH,South Africa,ZAF,13,0,16,3652,3681
2019,Gambia,GMB,South Africa,ZAF,0,0,0,5,5
2019,Palestinian,PSE,South Africa,ZAF,0,0,0,5,5
2019,Ghana,GHA,South Africa,ZAF,0,0,0,899,899
2019,Guinea,GIN,South Africa,ZAF,0,0,0,5,5
2019,Cote d'Ivoire,CIV,South Africa,ZAF,0,0,0,22,22
2019,India,IND,South Africa,ZAF,0,0,5,727,732
2019,Kenya,KEN,South Africa,ZAF,0,0,0,78,78
2019,Liberia,LBR,South Africa,ZAF,0,0,0,5,5
2019,Lesotho,LSO,South Africa,ZAF,0,0,0,73,73
2019,Mali,MLI,South Africa,ZAF,0,0,0,12,12
2019,Malawi,MWI,South Africa,ZAF,0,0,0,645,645
2019,Morocco,MAR,South Africa,ZAF,0,0,0,5,5
2019,Mozambique,MOZ,South Africa,ZAF,0,0,0,194,194
2019,Nepal,NPL,South Africa,ZAF,0,0,0,21,21
2019,Niger,NER,South Africa,ZAF,0,0,0,58,58
2019,Nigeria,NGA,South Africa,ZAF,0,0,5,2189,2194
2019,Pakistan,PAK,South Africa,ZAF,0,0,0,1566,1566
2019,Rwanda,RWA,South Africa,ZAF,0,0,0,32,32
2019,Senegal,SEN,South Africa,ZAF,0,0,0,175,175
2019,Sierra Leone,SLE,South Africa,ZAF,0,0,0,5,5
2019,Somalia,SOM,South Africa,ZAF,10,0,0,640,650
2019,Eswatini,SWZ,South Africa,ZAF,0,0,0,5,5
2019,United Rep. of Tanzania,TZA,South Africa,ZAF,0,0,0,110,110
2019,Thailand,THA,South Africa,ZAF,0,0,0,14,14
2019,Turkey,TUR,South Africa,ZAF,0,0,0,5,5
2019,Uganda,UGA,South Africa,ZAF,0,0,0,530,530
2019,Venezuela (Bolivarian Republic of),VEN,South Africa,ZAF,0,0,0,5,5
2019,Yemen,YEM,South Africa,ZAF,0,0,0,5,5
2019,Zambia,ZMB,South Africa,ZAF,0,0,0,43,43
2019,Zimbabwe,ZWE,South Africa,ZAF,0,0,5,4266,4271
2019,Afghanistan,AFG,Sweden,SWE,364,107,5312,420,6203
2019,Albania,ALB,Sweden,SWE,0,0,362,54,416
2019,Algeria,DZA,Sweden,SWE,0,0,52,5,57
2019,Angola,AGO,Sweden,SWE,0,0,28,0,28
2019,Egypt,EGY,Sweden,SWE,0,0,229,57,286
2019,Argentina,ARG,Sweden,SWE,0,0,10,0,10
2019,Armenia,ARM,Sweden,SWE,0,0,169,12,181
2019,Azerbaijan,AZE,Sweden,SWE,5,0,216,70,291
2019,Burundi,BDI,Sweden,SWE,0,0,31,5,36
2019,Bangladesh,BGD,Sweden,SWE,5,0,112,37,154
2019,Belarus,BLR,Sweden,SWE,0,0,69,11,80
2019,Bolivia (Plurinational State of),BOL,Sweden,SWE,0,0,37,5,42
2019,Brazil,BRA,Sweden,SWE,0,0,12,0,12
2019,Bosnia and Herzegovina,BIH,Sweden,SWE,0,0,50,5,55
2019,Canada,CAN,Sweden,SWE,0,0,10,0,10
2019,China,CHN,Sweden,SWE,0,0,25,0,25
2019,Chile,CHL,Sweden,SWE,0,0,33,0,33
2019,Cameroon,CMR,Sweden,SWE,0,0,54,13,67
2019,Congo,COG,Sweden,SWE,0,0,5,0,5
2019,Dem. Rep. of the Congo,COD,Sweden,SWE,0,0,45,0,45
2019,Colombia,COL,Sweden,SWE,0,0,307,33,340
2019,Cuba,CUB,Sweden,SWE,0,0,23,0,23
2019,Djibouti,DJI,Sweden,SWE,0,0,10,0,10
2019,Ecuador,ECU,Sweden,SWE,0,0,10,0,10
2019,Eritrea,ERI,Sweden,SWE,10,0,121,24,155
2019,Ethiopia,ETH,Sweden,SWE,10,0,411,41,462
2019,Gabon,GAB,Sweden,SWE,0,0,5,0,5
2019,Gambia,GMB,Sweden,SWE,5,0,103,5,113
2019,Palestinian,PSE,Sweden,SWE,5,0,125,40,170
2019,Georgia,GEO,Sweden,SWE,0,0,970,89,1059
2019,Ghana,GHA,Sweden,SWE,0,0,34,5,39
2019,Guinea-Bissau,GNB,Sweden,SWE,0,0,5,0,5
2019,Guatemala,GTM,Sweden,SWE,0,0,5,0,5
2019,Guinea,GIN,Sweden,SWE,0,0,34,0,34
2019,Honduras,HND,Sweden,SWE,5,0,11,0,16
2019,Cote d'Ivoire,CIV,Sweden,SWE,0,0,12,0,12
2019,India,IND,Sweden,SWE,0,0,56,5,61
2019,Iran (Islamic Rep. of),IRN,Sweden,SWE,161,5,773,163,1102
2019,Iraq,IRQ,Sweden,SWE,149,36,2318,407,2910
2019,Israel,ISR,Sweden,SWE,0,0,5,0,5
2019,Italy,ITA,Sweden,SWE,0,0,0,5,5
2019,Jordan,JOR,Sweden,SWE,0,0,80,24,104
2019,Kazakhstan,KAZ,Sweden,SWE,0,0,222,13,235
2019,Kenya,KEN,Sweden,SWE,0,0,28,0,28
2019,Kyrgyzstan,KGZ,Sweden,SWE,0,0,177,20,197
2019,Dem. People's Rep. of Korea,PRK,Sweden,SWE,0,0,5,0,5
2019,Kuwait,KWT,Sweden,SWE,5,0,18,0,23
2019,Liberia,LBR,Sweden,SWE,0,0,10,0,10
2019,Libya,LBY,Sweden,SWE,0,0,44,10,54
2019,Lebanon,LBN,Sweden,SWE,5,5,224,25,259
2019,Sri Lanka,LKA,Sweden,SWE,0,0,19,0,19
2019,North Macedonia,MKD,Sweden,SWE,0,0,49,0,49
2019,Rep. of Moldova,MDA,Sweden,SWE,0,0,0,5,5
2019,Mexico,MEX,Sweden,SWE,0,0,11,0,11
2019,Mali,MLI,Sweden,SWE,0,0,5,0,5
2019,Mongolia,MNG,Sweden,SWE,0,0,409,31,440
2019,Morocco,MAR,Sweden,SWE,0,0,202,21,223
2019,Montenegro,MNE,Sweden,SWE,0,0,11,5,16
2019,Nepal,NPL,Sweden,SWE,0,0,15,5,20
2019,Nicaragua,NIC,Sweden,SWE,0,0,261,10,271
2019,Nigeria,NGA,Sweden,SWE,15,0,203,29,247
2019,Pakistan,PAK,Sweden,SWE,11,0,164,42,217
2019,Peru,PER,Sweden,SWE,0,0,177,5,182
2019,Philippines,PHL,Sweden,SWE,0,0,17,0,17
2019,South Africa,ZAF,Sweden,SWE,0,0,10,0,10
2019,Russian Federation,RUS,Sweden,SWE,5,5,260,33,303
2019,Rwanda,RWA,Sweden,SWE,0,0,15,5,20
2019,El Salvador,SLV,Sweden,SWE,11,0,232,10,253
2019,Saudi Arabia,SAU,Sweden,SWE,0,0,5,0,5
2019,Serbia and Kosovo: S/RES/1244 (1999),SRB,Sweden,SWE,0,0,253,30,283
2019,Senegal,SEN,Sweden,SWE,0,0,15,0,15
2019,Sierra Leone,SLE,Sweden,SWE,0,0,14,0,14
2019,Somalia,SOM,Sweden,SWE,56,0,697,55,808
2019,Viet Nam,VNM,Sweden,SWE,0,0,43,0,43
2019,Sudan,SDN,Sweden,SWE,14,0,41,12,67
2019,Syrian Arab Rep.,SYR,Sweden,SWE,0,0,240,95,335
2019,United Rep. of Tanzania,TZA,Sweden,SWE,0,0,22,5,27
2019,Thailand,THA,Sweden,SWE,0,0,13,5,18
2019,Tajikistan,TJK,Sweden,SWE,0,0,53,0,53
2019,Tunisia,TUN,Sweden,SWE,0,0,85,14,99
2019,Turkey,TUR,Sweden,SWE,53,0,199,107,359
2019,Uganda,UGA,Sweden,SWE,5,0,18,5,28
2019,Ukraine,UKR,Sweden,SWE,0,0,502,60,562
2019,United States of America,USA,Sweden,SWE,0,0,19,5,24
2019,Uzbekistan,UZB,Sweden,SWE,0,0,235,40,275
2019,Venezuela (Bolivarian Republic of),VEN,Sweden,SWE,0,0,88,15,103
2019,Yemen,YEM,Sweden,SWE,0,0,17,5,22
2019,Zimbabwe,ZWE,Sweden,SWE,0,0,10,0,10
2019,Stateless,XXA,Sweden,SWE,38,0,366,62,466
2019,Eritrea,ERI,Uganda,UGA,12,0,0,0,12
2019,Afghanistan,AFG,United States of America,USA,14,0,5,12,31
2019,Albania,ALB,United States of America,USA,33,0,17,14,64
2019,Algeria,DZA,United States of America,USA,0,0,0,5,5
2019,Angola,AGO,United States of America,USA,11,0,11,17,39
2019,Egypt,EGY,United States of America,USA,145,0,18,47,210
2019,Argentina,ARG,United States of America,USA,0,0,0,10,10
2019,Armenia,ARM,United States of America,USA,14,0,0,28,42
2019,Azerbaijan,AZE,United States of America,USA,22,0,0,5,27
2019,Burundi,BDI,United States of America,USA,36,0,5,0,41
2019,Belgium,BEL,United States of America,USA,0,0,5,0,5
2019,Bangladesh,BGD,United States of America,USA,133,0,33,48,214
2019,Bhutan,BTN,United States of America,USA,5,0,0,5,10
2019,Burkina Faso,BFA,United States of America,USA,70,0,19,23,112
2019,Belarus,BLR,United States of America,USA,23,0,5,19,47
2019,Bolivia (Plurinational State of),BOL,United States of America,USA,10,0,0,0,10
2019,Brazil,BRA,United States of America,USA,13,0,19,90,122
2019,Bosnia and Herzegovina,BIH,United States of America,USA,0,0,11,0,11
2019,Bulgaria,BGR,United States of America,USA,5,0,0,0,5
2019,Chad,TCD,United States of America,USA,5,0,0,0,5
2019,China,CHN,United States of America,USA,1930,0,521,980,3431
2019,Cameroon,CMR,United States of America,USA,35,0,5,21,61
2019,Congo,COG,United States of America,USA,17,0,10,10,37
2019,Dem. Rep. of the Congo,COD,United States of America,USA,28,0,14,18,60
2019,Colombia,COL,United States of America,USA,34,0,49,155,238
2019,Costa Rica,CRI,United States of America,USA,0,0,0,5,5
2019,Cuba,CUB,United States of America,USA,0,0,0,5,5
2019,Djibouti,DJI,United States of America,USA,11,0,0,0,11
2019,Dominican Rep.,DOM,United States of America,USA,0,0,0,13,13
2019,Ecuador,ECU,United States of America,USA,5,0,58,427,490
2019,Eritrea,ERI,United States of America,USA,63,0,0,15,78
2019,Ethiopia,ETH,United States of America,USA,131,0,13,40,184
2019,Fiji,FJI,United States of America,USA,11,0,0,0,11
2019,Gambia,GMB,United States of America,USA,18,0,5,16,39
2019,Palestinian,PSE,United States of America,USA,0,0,0,14,14
2019,Georgia,GEO,United States of America,USA,14,0,0,0,14
2019,Guatemala,GTM,United States of America,USA,41,0,180,418,639
2019,Guinea,GIN,United States of America,USA,45,0,16,17,78
2019,Guyana,GUY,United States of America,USA,0,0,11,0,11
2019,Haiti,HTI,United States of America,USA,23,0,86,100,209
2019,Honduras,HND,United States of America,USA,11,0,85,187,283
2019,Cote d'Ivoire,CIV,United States of America,USA,20,0,10,18,48
2019,India,IND,United States of America,USA,402,0,115,178,695
2019,Indonesia,IDN,United States of America,USA,33,0,10,30,73
2019,Iran (Islamic Rep. of),IRN,United States of America,USA,88,0,5,28,121
2019,Iraq,IRQ,United States of America,USA,109,0,20,71,200
2019,Israel,ISR,United States of America,USA,0,0,0,10,10
2019,Jamaica,JAM,United States of America,USA,0,0,0,5,5
2019,Jordan,JOR,United States of America,USA,15,0,5,33,53
2019,Kazakhstan,KAZ,United States of America,USA,26,0,5,16,47
2019,Kenya,KEN,United States of America,USA,35,0,13,13,61
2019,Kyrgyzstan,KGZ,United States of America,USA,63,0,10,19,92
2019,Rep. of Korea,KOR,United States of America,USA,0,0,0,5,5
2019,Lao People's Dem. Rep.,LAO,United States of America,USA,0,0,0,5,5
2019,Liberia,LBR,United States of America,USA,14,0,5,12,31
2019,Libya,LBY,United States of America,USA,0,0,5,39,44
2019,Lebanon,LBN,United States of America,USA,14,0,5,18,37
2019,Sri Lanka,LKA,United States of America,USA,43,0,18,20,81
2019,Mauritania,MRT,United States of America,USA,19,0,5,18,42
2019,Rep. of Moldova,MDA,United States of America,USA,68,0,5,18,91
2019,Mexico,MEX,United States of America,USA,21,0,277,1847,2145
2019,Mali,MLI,United States of America,USA,23,0,5,15,43
2019,Malaysia,MYS,United States of America,USA,0,0,0,5,5
2019,Malawi,MWI,United States of America,USA,0,0,0,5,5
2019,Mongolia,MNG,United States of America,USA,22,0,12,24,58
2019,Montenegro,MNE,United States of America,USA,0,0,0,5,5
2019,Myanmar,MMR,United States of America,USA,18,0,5,5,28
2019,Nepal,NPL,United States of America,USA,214,0,50,72,336
2019,Niger,NER,United States of America,USA,0,0,0,5,5
2019,Nicaragua,NIC,United States of America,USA,5,0,10,23,38
2019,Nigeria,NGA,United States of America,USA,148,0,25,109,282
2019,Pakistan,PAK,United States of America,USA,101,0,46,78,225
2019,Peru,PER,United States of America,USA,0,0,10,37,47
2019,Philippines,PHL,United States of America,USA,5,0,26,41,72
2019,Poland,POL,United States of America,USA,0,0,0,22,22
2019,Qatar,QAT,United States of America,USA,5,0,0,0,5
2019,Romania,ROU,United States of America,USA,0,0,10,34,44
2019,South Africa,ZAF,United States of America,USA,5,0,0,0,5
2019,Russian Federation,RUS,United States of America,USA,156,0,37,77,270
2019,Rwanda,RWA,United States of America,USA,17,0,10,18,45
2019,El Salvador,SLV,United States of America,USA,27,0,97,355,479
2019,Saudi Arabia,SAU,United States of America,USA,0,0,0,13,13
2019,Serbia and Kosovo: S/RES/1244 (1999),SRB,United States of America,USA,21,0,5,5,31
2019,Senegal,SEN,United States of America,USA,11,0,5,21,37
2019,Sierra Leone,SLE,United States of America,USA,10,0,0,0,10
2019,Viet Nam,VNM,United States of America,USA,10,0,0,0,10
2019,Sudan,SDN,United States of America,USA,17,0,5,17,39
2019,Syrian Arab Rep.,SYR,United States of America,USA,64,0,10,41,115
2019,Thailand,THA,United States of America,USA,0,0,0,11,11
2019,Tajikistan,TJK,United States of America,USA,11,0,0,0,11
2019,Togo,TGO,United States of America,USA,0,0,5,0,5
2019,Trinidad and Tobago,TTO,United States of America,USA,0,0,0,5,5
2019,Turkey,TUR,United States of America,USA,10,0,5,10,25
2019,United Arab Emirates,ARE,United States of America,USA,10,0,0,0,10
2019,Uganda,UGA,United States of America,USA,40,0,5,17,62
2019,Ukraine,UKR,United States of America,USA,83,0,42,75,200
2019,Uruguay,URY,United States of America,USA,0,0,0,5,5
2019,Uzbekistan,UZB,United States of America,USA,15,0,12,34,61
2019,Venezuela (Bolivarian Republic of),VEN,United States of America,USA,376,0,168,460,1004
2019,Yemen,YEM,United States of America,USA,14,0,0,10,24
2019,Zimbabwe,ZWE,United States of America,USA,5,0,0,5,10
2020,Iran (Islamic Rep. of),IRN,Armenia,ARM,0,0,5,0,5
2020,Afghanistan,AFG,Australia,AUS,19,0,51,10,80
2020,Albania,ALB,Australia,AUS,5,0,5,0,10
2020,Egypt,EGY,Australia,AUS,11,0,16,10,37
2020,Bangladesh,BGD,Australia,AUS,5,0,110,20,135
2020,Brazil,BRA,Australia,AUS,5,0,0,0,5
2020,Cambodia,KHM,Australia,AUS,5,0,0,0,5
2020,China,CHN,Australia,AUS,39,0,1023,303,1365
2020,Dem. Rep. of the Congo,COD,Australia,AUS,5,0,0,0,5
2020,Colombia,COL,Australia,AUS,5,0,5,0,10
2020,Ethiopia,ETH,Australia,AUS,0,0,11,0,11
2020,Fiji,FJI,Australia,AUS,10,0,47,83,140
2020,United Kingdom of Great Britain and Northern Ireland,GBR,Australia,AUS,0,0,21,0,21
2020,Germany,DEU,Australia,AUS,5,0,0,0,5
2020,Ghana,GHA,Australia,AUS,5,0,14,0,19
2020,India,IND,Australia,AUS,10,0,145,59,214
2020,Indonesia,IDN,Australia,AUS,0,0,78,29,107
2020,Iran (Islamic Rep. of),IRN,Australia,AUS,78,0,323,11,412
2020,Iraq,IRQ,Australia,AUS,44,0,91,30,165
2020,Jordan,JOR,Australia,AUS,0,0,11,0,11
2020,Kenya,KEN,Australia,AUS,14,0,0,0,14
2020,Rep. of Korea,KOR,Australia,AUS,0,0,20,5,25
2020,Liberia,LBR,Australia,AUS,0,0,5,0,5
2020,Libya,LBY,Australia,AUS,11,0,5,0,16
2020,Lebanon,LBN,Australia,AUS,15,0,45,12,72
2020,Sri Lanka,LKA,Australia,AUS,26,0,355,5,386
2020,Malaysia,MYS,Australia,AUS,65,0,1957,887,2909
2020,Mauritius,MUS,Australia,AUS,5,0,0,0,5
2020,Myanmar,MMR,Australia,AUS,5,0,21,5,31
2020,Nepal,NPL,Australia,AUS,0,0,42,10,52
2020,Nigeria,NGA,Australia,AUS,0,0,12,5,17
2020,Pakistan,PAK,Australia,AUS,25,0,385,35,445
2020,Philippines,PHL,Australia,AUS,0,0,0,5,5
2020,Papua New Guinea,PNG,Australia,AUS,5,0,15,0,20
2020,Portugal,PRT,Australia,AUS,0,0,5,0,5
2020,South Africa,ZAF,Australia,AUS,0,0,0,12,12
2020,Russian Federation,RUS,Australia,AUS,5,0,0,0,5
2020,Rwanda,RWA,Australia,AUS,0,0,5,0,5
2020,Saudi Arabia,SAU,Australia,AUS,0,0,0,5,5
2020,Sierra Leone,SLE,Australia,AUS,0,0,0,10,10
2020,Viet Nam,VNM,Australia,AUS,12,0,102,117,231
2020,Sudan,SDN,Australia,AUS,5,0,5,0,10
2020,Syrian Arab Rep.,SYR,Australia,AUS,11,0,0,0,11
2020,Thailand,THA,Australia,AUS,0,0,217,92,309
2020,Tonga,TON,Australia,AUS,0,0,0,5,5
2020,Turkey,TUR,Australia,AUS,0,0,12,5,17
2020,Uganda,UGA,Australia,AUS,0,0,14,0,14
2020,Ukraine,UKR,Australia,AUS,0,0,10,0,10
2020,Venezuela (Bolivarian Republic of),VEN,Australia,AUS,0,0,5,0,5
2020,Zambia,ZMB,Australia,AUS,5,0,0,0,5
2020,Zimbabwe,ZWE,Australia,AUS,10,0,5,0,15
2020,Stateless,XXA,Australia,AUS,11,0,13,5,29
2020,Afghanistan,AFG,Canada,CAN,22,0,44,0,83
2020,Albania,ALB,Canada,CAN,28,0,10,5,80
2020,Algeria,DZA,Canada,CAN,0,0,29,5,37
2020,Angola,AGO,Canada,CAN,0,0,38,0,43
2020,Egypt,EGY,Canada,CAN,0,0,36,20,73
2020,Argentina,ARG,Canada,CAN,0,0,0,5,5
2020,Azerbaijan,AZE,Canada,CAN,0,0,5,0,32
2020,Burundi,BDI,Canada,CAN,0,0,0,5,5
2020,Bangladesh,BGD,Canada,CAN,28,0,80,12,124
2020,Bahamas,BHS,Canada,CAN,0,0,27,0,39
2020,Botswana,BWA,Canada,CAN,0,0,5,0,5
2020,Brazil,BRA,Canada,CAN,0,0,62,0,68
2020,Cambodia,KHM,Canada,CAN,13,0,0,0,13
2020,Chad,TCD,Canada,CAN,24,0,0,5,50
2020,China,CHN,Canada,CAN,188,0,607,110,907
2020,Chile,CHL,Canada,CAN,0,0,13,0,37
2020,Cameroon,CMR,Canada,CAN,0,0,57,0,69
2020,Dem. Rep. of the Congo,COD,Canada,CAN,0,0,106,0,140
2020,Colombia,COL,Canada,CAN,65,0,251,42,358
2020,Cuba,CUB,Canada,CAN,0,0,11,0,11
2020,Czechia,CZE,Canada,CAN,0,0,0,13,13
2020,Djibouti,DJI,Canada,CAN,36,0,10,12,78
2020,Dominican Rep.,DOM,Canada,CAN,0,0,0,5,5
2020,Ecuador,ECU,Canada,CAN,0,0,5,0,5
2020,Eritrea,ERI,Canada,CAN,0,0,15,0,55
2020,Ethiopia,ETH,Canada,CAN,78,0,96,10,201
2020,Gambia,GMB,Canada,CAN,0,0,5,0,5
2020,Palestinian,PSE,Canada,CAN,30,0,43,0,86
2020,Georgia,GEO,Canada,CAN,0,0,28,0,40
2020,Germany,DEU,Canada,CAN,0,0,0,5,5
2020,Ghana,GHA,Canada,CAN,0,0,46,5,65
2020,Guatemala,GTM,Canada,CAN,0,0,28,5,35
2020,Guinea,GIN,Canada,CAN,0,0,5,5,10
2020,Guyana,GUY,Canada,CAN,0,0,5,0,5
2020,Haiti,HTI,Canada,CAN,58,0,904,78,1057
2020,Honduras,HND,Canada,CAN,0,0,0,5,31
2020,Croatia,HRV,Canada,CAN,0,0,5,0,5
2020,Hungary,HUN,Canada,CAN,43,0,12,10,80
2020,India,IND,Canada,CAN,87,0,393,11,515
2020,Iran (Islamic Rep. of),IRN,Canada,CAN,100,0,78,5,199
2020,Iraq,IRQ,Canada,CAN,39,0,46,0,95
2020,Israel,ISR,Canada,CAN,0,0,0,5,5
2020,Italy,ITA,Canada,CAN,0,0,13,0,13
2020,Jamaica,JAM,Canada,CAN,0,0,64,5,80
2020,Jordan,JOR,Canada,CAN,23,0,50,0,82
2020,Kenya,KEN,Canada,CAN,22,0,30,0,54
2020,Rep. of Korea,KOR,Canada,CAN,0,0,5,5,10
2020,Dem. People's Rep. of Korea,PRK,Canada,CAN,0,0,18,24,42
2020,Kuwait,KWT,Canada,CAN,0,0,5,0,5
2020,Liberia,LBR,Canada,CAN,0,0,5,0,5
2020,Libya,LBY,Canada,CAN,0,0,5,0,5
2020,Saint Lucia,LCA,Canada,CAN,0,0,12,0,12
2020,Lebanon,LBN,Canada,CAN,0,0,54,12,89
2020,Sri Lanka,LKA,Canada,CAN,86,0,75,22,191
2020,Lithuania,LTU,Canada,CAN,0,0,0,5,5
2020,Mexico,MEX,Canada,CAN,116,0,551,142,809
2020,Malaysia,MYS,Canada,CAN,0,0,0,5,5
2020,Mongolia,MNG,Canada,CAN,0,0,5,0,5
2020,Morocco,MAR,Canada,CAN,0,0,0,5,5
2020,Namibia,NAM,Canada,CAN,0,0,5,5,10
2020,Nepal,NPL,Canada,CAN,0,0,25,0,34
2020,Nigeria,NGA,Canada,CAN,616,0,1954,109,2884
2020,Pakistan,PAK,Canada,CAN,92,0,287,20,436
2020,Peru,PER,Canada,CAN,0,0,0,0,21
2020,Philippines,PHL,Canada,CAN,0,0,13,0,13
2020,Romania,ROU,Canada,CAN,0,0,5,0,42
2020,South Africa,ZAF,Canada,CAN,0,0,0,5,26
2020,Russian Federation,RUS,Canada,CAN,0,0,5,0,5
2020,El Salvador,SLV,Canada,CAN,0,0,59,13,93
2020,Saudi Arabia,SAU,Canada,CAN,0,0,13,10,23
2020,Senegal,SEN,Canada,CAN,0,0,0,5,5
2020,Singapore,SGP,Canada,CAN,0,0,5,0,5
2020,Somalia,SOM,Canada,CAN,42,0,86,0,167
2020,Sudan,SDN,Canada,CAN,0,0,5,0,5
2020,Syrian Arab Rep.,SYR,Canada,CAN,25,0,0,5,40
2020,United Rep. of Tanzania,TZA,Canada,CAN,15,0,21,0,43
2020,Thailand,THA,Canada,CAN,0,0,5,0,5
2020,Trinidad and Tobago,TTO,Canada,CAN,0,0,5,0,5
2020,Tunisia,TUN,Canada,CAN,0,0,0,5,5
2020,Turkey,TUR,Canada,CAN,55,0,49,13,143
2020,United Arab Emirates,ARE,Canada,CAN,0,0,0,5,5
2020,Uganda,UGA,Canada,CAN,19,0,5,5,63
2020,Ukraine,UKR,Canada,CAN,0,0,5,5,46
2020,United States of America,USA,Canada,CAN,12,0,376,25,433
2020,Saint Vincent and the Grenadines,VCT,Canada,CAN,0,0,13,5,18
2020,Venezuela (Bolivarian Republic of),VEN,Canada,CAN,22,0,57,5,91
2020,Zimbabwe,ZWE,Canada,CAN,0,0,15,10,47
2020,Cuba,CUB,Cayman Islands,CYM,0,0,0,5,5
2020,Colombia,COL,Chile,CHL,0,0,0,58,58
2020,Dominican Rep.,DOM,Chile,CHL,0,0,0,5,5
2020,Colombia,COL,Costa Rica,CRI,0,0,43,5,48
2020,Cuba,CUB,Costa Rica,CRI,0,0,50,0,50
2020,Dominican Rep.,DOM,Costa Rica,CRI,0,0,5,0,5
2020,Ghana,GHA,Costa Rica,CRI,0,0,5,0,5
2020,Haiti,HTI,Costa Rica,CRI,0,0,5,0,5
2020,Nicaragua,NIC,Costa Rica,CRI,0,0,552,10,562
2020,El Salvador,SLV,Costa Rica,CRI,5,0,173,10,188
2020,United States of America,USA,Costa Rica,CRI,0,0,5,0,5
2020,Venezuela (Bolivarian Republic of),VEN,Costa Rica,CRI,5,0,233,16,254
2020,Egypt,EGY,Cyprus,CYP,0,0,74,31,105
2020,Bangladesh,BGD,Cyprus,CYP,0,0,135,12,147
2020,Cameroon,CMR,Cyprus,CYP,0,0,5,0,5
2020,Dem. Rep. of the Congo,COD,Cyprus,CYP,0,0,5,0,5
2020,Gambia,GMB,Cyprus,CYP,0,0,14,5,19
2020,Palestinian,PSE,Cyprus,CYP,0,0,18,39,57
2020,Georgia,GEO,Cyprus,CYP,0,0,10,0,10
2020,India,IND,Cyprus,CYP,0,0,97,0,97
2020,Iraq,IRQ,Cyprus,CYP,22,5,0,71,98
2020,Lebanon,LBN,Cyprus,CYP,0,0,11,0,11
2020,Sri Lanka,LKA,Cyprus,CYP,0,0,74,0,74
2020,Nepal,NPL,Cyprus,CYP,0,0,98,10,108
2020,Nigeria,NGA,Cyprus,CYP,0,0,10,5,15
2020,Pakistan,PAK,Cyprus,CYP,0,0,109,33,142
2020,Philippines,PHL,Cyprus,CYP,0,0,26,0,26
2020,Somalia,SOM,Cyprus,CYP,0,0,0,5,5
2020,Viet Nam,VNM,Cyprus,CYP,0,0,53,0,53
2020,Syrian Arab Rep.,SYR,Cyprus,CYP,0,10,0,0,10
2020,Afghanistan,AFG,Denmark,DNK,5,5,32,0,42
2020,Egypt,EGY,Denmark,DNK,0,0,5,0,5
2020,Armenia,ARM,Denmark,DNK,0,12,0,0,12
2020,Burundi,BDI,Denmark,DNK,0,0,5,0,5
2020,Belarus,BLR,Denmark,DNK,0,0,5,0,5
2020,Cameroon,CMR,Denmark,DNK,0,0,5,0,5
2020,Dem. Rep. of the Congo,COD,Denmark,DNK,0,0,14,0,14
2020,Colombia,COL,Denmark,DNK,0,0,14,0,14
2020,Eritrea,ERI,Denmark,DNK,5,0,14,0,19
2020,Georgia,GEO,Denmark,DNK,0,0,36,0,36
2020,India,IND,Denmark,DNK,0,0,5,0,5
2020,Iran (Islamic Rep. of),IRN,Denmark,DNK,53,5,55,0,113
2020,Iraq,IRQ,Denmark,DNK,5,5,46,0,56
2020,Jordan,JOR,Denmark,DNK,0,0,5,0,5
2020,Kenya,KEN,Denmark,DNK,0,0,5,0,5
2020,Lebanon,LBN,Denmark,DNK,0,5,5,0,10
2020,Sri Lanka,LKA,Denmark,DNK,0,0,10,0,10
2020,Morocco,MAR,Denmark,DNK,0,0,13,0,13
2020,Myanmar,MMR,Denmark,DNK,0,0,10,0,10
2020,Nicaragua,NIC,Denmark,DNK,5,0,18,0,23
2020,Nigeria,NGA,Denmark,DNK,0,0,5,0,5
2020,Pakistan,PAK,Denmark,DNK,0,0,13,0,13
2020,Russian Federation,RUS,Denmark,DNK,5,0,24,0,29
2020,El Salvador,SLV,Denmark,DNK,0,0,5,0,5
2020,Somalia,SOM,Denmark,DNK,15,5,76,0,96
2020,Sudan,SDN,Denmark,DNK,0,0,5,0,5
2020,Syrian Arab Rep.,SYR,Denmark,DNK,10,0,18,0,28
2020,Tunisia,TUN,Denmark,DNK,0,0,5,0,5
2020,Turkey,TUR,Denmark,DNK,5,0,10,0,15
2020,Uganda,UGA,Denmark,DNK,0,0,5,0,5
2020,Ukraine,UKR,Denmark,DNK,0,0,11,0,11
2020,Venezuela (Bolivarian Republic of),VEN,Denmark,DNK,0,0,11,0,11
2020,Yemen,YEM,Denmark,DNK,0,0,5,0,5
2020,Stateless,XXA,Denmark,DNK,0,0,82,0,82
2020,Afghanistan,AFG,France,FRA,501,2029,584,25,3139
2020,Albania,ALB,France,FRA,49,81,2382,11,2523
2020,Algeria,DZA,France,FRA,20,20,617,0,657
2020,Angola,AGO,France,FRA,36,18,306,0,360
2020,Egypt,EGY,France,FRA,45,0,92,5,142
2020,Armenia,ARM,France,FRA,18,22,843,10,893
2020,Azerbaijan,AZE,France,FRA,39,0,84,5,128
2020,Burundi,BDI,France,FRA,5,0,32,0,37
2020,Benin,BEN,France,FRA,0,5,29,0,34
2020,Bangladesh,BGD,France,FRA,293,126,1696,5,2120
2020,Burkina Faso,BFA,France,FRA,12,5,54,0,71
2020,Belarus,BLR,France,FRA,14,0,10,0,24
2020,Bolivia (Plurinational State of),BOL,France,FRA,0,0,5,0,5
2020,Brazil,BRA,France,FRA,0,0,12,0,12
2020,Bosnia and Herzegovina,BIH,France,FRA,5,0,182,0,187
2020,Cambodia,KHM,France,FRA,5,0,22,0,27
2020,Central African Rep.,CAF,France,FRA,27,30,116,0,173
2020,Chad,TCD,France,FRA,123,38,356,0,517
2020,China,CHN,France,FRA,5,0,443,5,453
2020,Chile,CHL,France,FRA,0,0,5,0,5
2020,Cameroon,CMR,France,FRA,53,19,186,5,263
2020,Congo,COG,France,FRA,46,14,306,0,366
2020,Dem. Rep. of the Congo,COD,France,FRA,198,68,1030,5,1301
2020,Comoros,COM,France,FRA,0,0,129,0,129
2020,Colombia,COL,France,FRA,5,16,37,0,58
2020,Cuba,CUB,France,FRA,5,0,21,0,26
2020,Djibouti,DJI,France,FRA,5,5,20,0,30
2020,Dominican Rep.,DOM,France,FRA,0,0,71,0,71
2020,Equatorial Guinea,GNQ,France,FRA,0,0,10,0,10
2020,Eritrea,ERI,France,FRA,98,5,66,0,169
2020,Ethiopia,ETH,France,FRA,109,10,162,0,281
2020,Gabon,GAB,France,FRA,14,5,54,0,73
2020,Gambia,GMB,France,FRA,0,5,62,0,67
2020,Palestinian,PSE,France,FRA,37,0,38,0,75
2020,Georgia,GEO,France,FRA,30,20,2519,17,2586
2020,Ghana,GHA,France,FRA,0,0,41,0,41
2020,Guinea-Bissau,GNB,France,FRA,0,0,27,0,27
2020,Guinea,GIN,France,FRA,823,143,3195,24,4185
2020,Haiti,HTI,France,FRA,22,10,1929,0,1961
2020,Honduras,HND,France,FRA,0,5,12,0,17
2020,Cote d'Ivoire,CIV,France,FRA,281,75,1419,16,1791
2020,India,IND,France,FRA,5,0,149,0,154
2020,Iran (Islamic Rep. of),IRN,France,FRA,104,5,71,5,185
2020,Iraq,IRQ,France,FRA,51,22,89,5,167
2020,Jordan,JOR,France,FRA,0,0,5,0,5
2020,Kazakhstan,KAZ,France,FRA,11,0,62,5,78
2020,Kenya,KEN,France,FRA,0,0,13,0,13
2020,Kyrgyzstan,KGZ,France,FRA,0,0,5,0,5
2020,Rep. of Korea,KOR,France,FRA,0,0,5,0,5
2020,Kuwait,KWT,France,FRA,19,0,11,0,30
2020,Lao People's Dem. Rep.,LAO,France,FRA,0,0,5,0,5
2020,Liberia,LBR,France,FRA,5,0,14,0,19
2020,Libya,LBY,France,FRA,29,106,70,0,205
2020,Lebanon,LBN,France,FRA,10,0,37,0,47
2020,Sri Lanka,LKA,France,FRA,252,26,737,10,1025
2020,Madagascar,MDG,France,FRA,0,0,22,0,22
2020,Mauritania,MRT,France,FRA,114,10,638,0,762
2020,North Macedonia,MKD,France,FRA,5,5,151,0,161
2020,Rep. of Moldova,MDA,France,FRA,0,5,126,0,131
2020,Mali,MLI,France,FRA,75,37,1591,5,1708
2020,Malaysia,MYS,France,FRA,5,0,0,0,5
2020,Mongolia,MNG,France,FRA,0,5,65,0,70
2020,Morocco,MAR,France,FRA,26,5,128,5,164
2020,Myanmar,MMR,France,FRA,0,0,10,0,10
2020,Nepal,NPL,France,FRA,10,0,26,0,36
2020,Niger,NER,France,FRA,5,0,28,0,33
2020,Nicaragua,NIC,France,FRA,0,0,5,0,5
2020,Nigeria,NGA,France,FRA,294,45,1594,5,1938
2020,Pakistan,PAK,France,FRA,120,26,1513,5,1664
2020,Peru,PER,France,FRA,0,5,11,0,16
2020,South Africa,ZAF,France,FRA,0,0,11,0,11
2020,Russian Federation,RUS,France,FRA,181,40,656,10,887
2020,Rwanda,RWA,France,FRA,20,0,39,0,59
2020,El Salvador,SLV,France,FRA,0,5,5,0,10
2020,Saudi Arabia,SAU,France,FRA,5,0,0,0,5
2020,Serbia and Kosovo: S/RES/1244 (1999),SRB,France,FRA,47,50,982,5,1084
2020,Senegal,SEN,France,FRA,96,14,737,5,852
2020,Sierra Leone,SLE,France,FRA,33,5,90,0,128
2020,Somalia,SOM,France,FRA,288,488,431,5,1212
2020,Viet Nam,VNM,France,FRA,0,0,13,0,13
2020,Sudan,SDN,France,FRA,440,244,661,13,1358
2020,Suriname,SUR,France,FRA,0,0,5,0,5
2020,South Sudan,SSD,France,FRA,0,12,5,0,17
2020,Syrian Arab Rep.,SYR,France,FRA,459,136,314,10,919
2020,United Rep. of Tanzania,TZA,France,FRA,0,0,5,0,5
2020,Tajikistan,TJK,France,FRA,0,5,21,0,26
2020,Turkmenistan,TKM,France,FRA,0,0,5,0,5
2020,Togo,TGO,France,FRA,14,5,39,0,58
2020,Tunisia,TUN,France,FRA,5,5,53,0,63
2020,Turkey,TUR,France,FRA,395,10,733,5,1143
2020,Uganda,UGA,France,FRA,5,0,5,0,10
2020,Ukraine,UKR,France,FRA,27,5,122,0,154
2020,United States of America,USA,France,FRA,0,0,5,0,5
2020,Uzbekistan,UZB,France,FRA,0,0,5,0,5
2020,Venezuela (Bolivarian Republic of),VEN,France,FRA,5,5,45,0,55
2020,Western Sahara,ESH,France,FRA,18,0,139,0,157
2020,Yemen,YEM,France,FRA,20,30,5,5,60
2020,Zimbabwe,ZWE,France,FRA,0,0,5,0,5
2020,Afghanistan,AFG,Greece,GRC,80,364,2068,159,2671
2020,Albania,ALB,Greece,GRC,0,5,2546,305,2856
2020,Algeria,DZA,Greece,GRC,0,5,235,59,299
2020,Angola,AGO,Greece,GRC,0,0,12,0,12
2020,Egypt,EGY,Greece,GRC,0,0,779,119,898
2020,Armenia,ARM,Greece,GRC,0,0,65,10,75
2020,Burundi,BDI,Greece,GRC,0,0,10,0,10
2020,Bangladesh,BGD,Greece,GRC,5,0,1564,182,1751
2020,Burkina Faso,BFA,Greece,GRC,0,0,23,5,28
2020,Belarus,BLR,Greece,GRC,0,0,12,0,12
2020,China,CHN,Greece,GRC,5,0,192,28,225
2020,Cameroon,CMR,Greece,GRC,25,10,222,13,270
2020,Congo,COG,Greece,GRC,0,0,24,5,29
2020,Dem. Rep. of the Congo,COD,Greece,GRC,46,16,718,39,819
2020,Comoros,COM,Greece,GRC,0,0,5,0,5
2020,Colombia,COL,Greece,GRC,0,0,5,0,5
2020,Cuba,CUB,Greece,GRC,0,0,5,5,10
2020,Dominican Rep.,DOM,Greece,GRC,0,0,5,0,5
2020,Eritrea,ERI,Greece,GRC,5,0,15,0,20
2020,Ethiopia,ETH,Greece,GRC,10,0,70,17,97
2020,Gambia,GMB,Greece,GRC,0,0,79,15,94
2020,Palestinian,PSE,Greece,GRC,5,0,24,0,29
2020,Georgia,GEO,Greece,GRC,0,0,1037,117,1154
2020,Ghana,GHA,Greece,GRC,0,0,102,11,113
2020,Guinea,GIN,Greece,GRC,5,0,55,10,70
2020,Haiti,HTI,Greece,GRC,0,5,13,0,18
2020,Cote d'Ivoire,CIV,Greece,GRC,0,0,20,5,25
2020,India,IND,Greece,GRC,0,0,149,14,163
2020,Indonesia,IDN,Greece,GRC,0,0,14,5,19
2020,Iran (Islamic Rep. of),IRN,Greece,GRC,53,0,347,39,439
2020,Iraq,IRQ,Greece,GRC,102,58,1775,96,2031
2020,Jordan,JOR,Greece,GRC,0,0,10,0,10
2020,Kazakhstan,KAZ,Greece,GRC,0,0,5,0,5
2020,Kenya,KEN,Greece,GRC,0,0,5,5,10
2020,Liberia,LBR,Greece,GRC,0,0,0,5,5
2020,Libya,LBY,Greece,GRC,0,5,5,0,10
2020,Lebanon,LBN,Greece,GRC,0,0,42,5,47
2020,Sri Lanka,LKA,Greece,GRC,0,0,21,0,21
2020,Mauritania,MRT,Greece,GRC,0,0,0,5,5
2020,North Macedonia,MKD,Greece,GRC,0,0,5,0,5
2020,Rep. of Moldova,MDA,Greece,GRC,0,0,20,0,20
2020,Mali,MLI,Greece,GRC,0,10,26,5,41
2020,Morocco,MAR,Greece,GRC,5,0,151,21,177
2020,Myanmar,MMR,Greece,GRC,5,0,10,0,15
2020,Nepal,NPL,Greece,GRC,0,0,64,0,64
2020,Niger,NER,Greece,GRC,0,0,5,5,10
2020,Nigeria,NGA,Greece,GRC,13,5,138,40,196
2020,Pakistan,PAK,Greece,GRC,18,5,5898,784,6705
2020,Paraguay,PRY,Greece,GRC,0,0,5,0,5
2020,Philippines,PHL,Greece,GRC,0,0,5,0,5
2020,Russian Federation,RUS,Greece,GRC,0,0,28,0,28
2020,Rwanda,RWA,Greece,GRC,0,0,5,0,5
2020,El Salvador,SLV,Greece,GRC,0,0,5,0,5
2020,Serbia and Kosovo: S/RES/1244 (1999),SRB,Greece,GRC,0,0,5,5,10
2020,Senegal,SEN,Greece,GRC,0,0,49,12,61
2020,Sierra Leone,SLE,Greece,GRC,0,5,36,5,46
2020,Somalia,SOM,Greece,GRC,5,5,44,0,54
2020,Viet Nam,VNM,Greece,GRC,0,0,5,0,5
2020,Sudan,SDN,Greece,GRC,0,0,29,0,29
2020,Syrian Arab Rep.,SYR,Greece,GRC,74,56,172,1398,1700
2020,United Rep. of Tanzania,TZA,Greece,GRC,0,0,5,0,5
2020,Togo,TGO,Greece,GRC,5,0,49,5,59
2020,Tunisia,TUN,Greece,GRC,0,0,21,5,26
2020,Turkey,TUR,Greece,GRC,5,0,49,5,59
2020,Uganda,UGA,Greece,GRC,5,0,23,0,28
2020,Ukraine,UKR,Greece,GRC,0,0,91,5,96
2020,Uzbekistan,UZB,Greece,GRC,0,0,5,0,5
2020,Venezuela (Bolivarian Republic of),VEN,Greece,GRC,0,0,12,0,12
2020,Yemen,YEM,Greece,GRC,0,0,5,0,5
2020,Zimbabwe,ZWE,Greece,GRC,0,0,11,0,11
2020,Stateless,XXA,Greece,GRC,5,0,12,0,17
2020,Afghanistan,AFG,Iceland,ISL,0,0,5,27,32
2020,Albania,ALB,Iceland,ISL,0,0,13,0,13
2020,Algeria,DZA,Iceland,ISL,0,0,5,0,5
2020,Egypt,EGY,Iceland,ISL,5,0,11,0,16
2020,Azerbaijan,AZE,Iceland,ISL,0,0,0,5,5
2020,Belarus,BLR,Iceland,ISL,0,0,5,0,5
2020,China,CHN,Iceland,ISL,0,0,0,5,5
2020,Chile,CHL,Iceland,ISL,0,0,5,0,5
2020,Dem. Rep. of the Congo,COD,Iceland,ISL,0,0,0,5,5
2020,Colombia,COL,Iceland,ISL,0,0,10,0,10
2020,Palestinian,PSE,Iceland,ISL,0,0,0,10,10
2020,Ghana,GHA,Iceland,ISL,0,0,12,0,12
2020,Iran (Islamic Rep. of),IRN,Iceland,ISL,0,0,0,10,10
2020,Iraq,IRQ,Iceland,ISL,0,0,14,103,117
2020,Libya,LBY,Iceland,ISL,0,0,0,5,5
2020,North Macedonia,MKD,Iceland,ISL,0,0,5,0,5
2020,Rep. of Moldova,MDA,Iceland,ISL,0,0,5,0,5
2020,Morocco,MAR,Iceland,ISL,0,0,10,0,10
2020,Nigeria,NGA,Iceland,ISL,0,0,29,35,64
2020,Pakistan,PAK,Iceland,ISL,0,0,15,5,20
2020,Romania,ROU,Iceland,ISL,0,0,0,5,5
2020,Russian Federation,RUS,Iceland,ISL,5,0,5,0,10
2020,Somalia,SOM,Iceland,ISL,0,0,5,11,16
2020,Syrian Arab Rep.,SYR,Iceland,ISL,0,0,0,16,16
2020,Tunisia,TUN,Iceland,ISL,0,0,5,0,5
2020,Turkey,TUR,Iceland,ISL,0,0,5,0,5
2020,Ukraine,UKR,Iceland,ISL,0,0,10,0,10
2020,Afghanistan,AFG,Ireland,IRL,5,0,0,5,10
2020,Albania,ALB,Ireland,IRL,28,5,84,21,138
2020,Algeria,DZA,Ireland,IRL,0,0,33,5,38
2020,Angola,AGO,Ireland,IRL,5,0,5,0,10
2020,Egypt,EGY,Ireland,IRL,0,0,12,0,12
2020,Bangladesh,BGD,Ireland,IRL,14,0,24,0,38
2020,Botswana,BWA,Ireland,IRL,5,0,0,0,5
2020,Brazil,BRA,Ireland,IRL,5,0,17,0,22
2020,Cameroon,CMR,Ireland,IRL,5,0,0,0,5
2020,Dem. Rep. of the Congo,COD,Ireland,IRL,24,0,21,5,50
2020,Georgia,GEO,Ireland,IRL,10,0,101,10,121
2020,Ghana,GHA,Ireland,IRL,0,0,10,0,10
2020,India,IND,Ireland,IRL,0,0,13,5,18
2020,Iran (Islamic Rep. of),IRN,Ireland,IRL,5,0,0,0,5
2020,Iraq,IRQ,Ireland,IRL,5,0,0,0,5
2020,Lebanon,LBN,Ireland,IRL,0,0,5,0,5
2020,Malaysia,MYS,Ireland,IRL,0,0,5,0,5
2020,Malawi,MWI,Ireland,IRL,12,0,20,0,32
2020,Morocco,MAR,Ireland,IRL,0,0,5,0,5
2020,Mauritius,MUS,Ireland,IRL,5,0,5,0,10
2020,Nepal,NPL,Ireland,IRL,0,0,5,0,5
2020,Nigeria,NGA,Ireland,IRL,24,0,40,11,75
2020,Pakistan,PAK,Ireland,IRL,33,0,95,15,143
2020,South Africa,ZAF,Ireland,IRL,14,0,59,10,83
2020,Russian Federation,RUS,Ireland,IRL,5,0,0,0,5
2020,Sierra Leone,SLE,Ireland,IRL,5,0,0,0,5
2020,Viet Nam,VNM,Ireland,IRL,0,0,5,0,5
2020,Eswatini,SWZ,Ireland,IRL,0,0,5,0,5
2020,Uganda,UGA,Ireland,IRL,5,0,0,0,5
2020,Ukraine,UKR,Ireland,IRL,13,0,0,0,13
2020,Zimbabwe,ZWE,Ireland,IRL,53,0,54,5,112
2020,Afghanistan,AFG,Kazakhstan,KAZ,0,0,49,0,49
2020,Burundi,BDI,Kenya,KEN,0,0,0,19,19
2020,Dem. Rep. of the Congo,COD,Kenya,KEN,5,0,0,37,42
2020,Eritrea,ERI,Kenya,KEN,0,0,0,5,5
2020,Ethiopia,ETH,Kenya,KEN,0,0,0,275,275
2020,Rwanda,RWA,Kenya,KEN,0,0,0,25,25
2020,Somalia,SOM,Kenya,KEN,0,0,0,275,275
2020,Sudan,SDN,Kenya,KEN,0,0,0,10,10
2020,South Sudan,SSD,Kenya,KEN,0,0,0,32,32
2020,United Rep. of Tanzania,TZA,Kenya,KEN,0,0,0,5,5
2020,Uganda,UGA,Kenya,KEN,0,0,0,10,10
2020,Albania,ALB,Luxembourg,LUX,0,0,10,0,10
2020,Algeria,DZA,Luxembourg,LUX,0,0,10,0,10
2020,Georgia,GEO,Luxembourg,LUX,0,0,10,0,10
2020,Morocco,MAR,Luxembourg,LUX,0,0,5,0,5
2020,Serbia and Kosovo: S/RES/1244 (1999),SRB,Luxembourg,LUX,0,0,5,0,5
2020,Tunisia,TUN,Luxembourg,LUX,0,0,5,0,5
2020,Rwanda,RWA,Malawi,MWI,0,0,0,5,5
2020,Cameroon,CMR,Niger,NER,0,0,5,5,10
2020,Dem. Rep. of the Congo,COD,Niger,NER,0,0,11,0,11
2020,Guinea,GIN,Niger,NER,0,0,0,10,10
2020,Cote d'Ivoire,CIV,Niger,NER,0,0,5,0,5
2020,Nigeria,NGA,Niger,NER,0,0,5,5,10
2020,Sudan,SDN,Niger,NER,5,0,0,0,5
2020,Togo,TGO,Niger,NER,0,0,5,0,5
2020,Afghanistan,AFG,Norway,NOR,5,0,61,5,71
2020,Albania,ALB,Norway,NOR,0,0,23,0,23
2020,Angola,AGO,Norway,NOR,0,0,5,5,10
2020,Egypt,EGY,Norway,NOR,0,0,0,5,5
2020,Azerbaijan,AZE,Norway,NOR,0,0,5,0,5
2020,China,CHN,Norway,NOR,0,0,5,5,10
2020,Cameroon,CMR,Norway,NOR,5,0,0,0,5
2020,Dem. Rep. of the Congo,COD,Norway,NOR,0,0,5,0,5
2020,Colombia,COL,Norway,NOR,0,0,22,0,22
2020,Eritrea,ERI,Norway,NOR,5,0,33,17,55
2020,Ethiopia,ETH,Norway,NOR,0,0,64,5,69
2020,Gambia,GMB,Norway,NOR,0,0,5,0,5
2020,Georgia,GEO,Norway,NOR,0,0,16,0,16
2020,Ghana,GHA,Norway,NOR,0,0,5,0,5
2020,Greece,GRC,Norway,NOR,0,0,5,0,5
2020,Guinea,GIN,Norway,NOR,0,0,0,5,5
2020,Iran (Islamic Rep. of),IRN,Norway,NOR,19,0,135,10,164
2020,Iraq,IRQ,Norway,NOR,10,0,82,5,97
2020,Jordan,JOR,Norway,NOR,0,0,5,0,5
2020,Kyrgyzstan,KGZ,Norway,NOR,0,0,5,0,5
2020,Sri Lanka,LKA,Norway,NOR,0,0,10,0,10
2020,Mexico,MEX,Norway,NOR,0,0,5,0,5
2020,Malaysia,MYS,Norway,NOR,0,0,5,0,5
2020,Morocco,MAR,Norway,NOR,0,0,5,5,10
2020,Myanmar,MMR,Norway,NOR,0,0,5,0,5
2020,Nicaragua,NIC,Norway,NOR,0,0,15,0,15
2020,Nigeria,NGA,Norway,NOR,0,0,5,0,5
2020,Pakistan,PAK,Norway,NOR,0,0,18,14,32
2020,Peru,PER,Norway,NOR,0,0,14,0,14
2020,Poland,POL,Norway,NOR,0,0,5,0,5
2020,Russian Federation,RUS,Norway,NOR,0,0,59,5,64
2020,Serbia and Kosovo: S/RES/1244 (1999),SRB,Norway,NOR,0,0,15,0,15
2020,Somalia,SOM,Norway,NOR,0,0,36,5,41
2020,Viet Nam,VNM,Norway,NOR,0,0,5,0,5
2020,Sudan,SDN,Norway,NOR,0,0,5,0,5
2020,Syrian Arab Rep.,SYR,Norway,NOR,0,0,5,24,29
2020,Tunisia,TUN,Norway,NOR,0,0,5,0,5
2020,Turkey,TUR,Norway,NOR,5,0,23,0,28
2020,Ukraine,UKR,Norway,NOR,0,0,24,0,24
2020,Uzbekistan,UZB,Norway,NOR,0,0,5,0,5
2020,Venezuela (Bolivarian Republic of),VEN,Norway,NOR,0,0,14,5,19
2020,Yemen,YEM,Norway,NOR,0,5,0,0,5
2020,Zimbabwe,ZWE,Norway,NOR,0,0,5,0,5
2020,Stateless,XXA,Norway,NOR,0,0,83,14,97
2020,Afghanistan,AFG,Poland,POL,0,0,5,0,5
2020,Algeria,DZA,Poland,POL,0,0,10,0,10
2020,Angola,AGO,Poland,POL,0,0,5,0,5
2020,Egypt,EGY,Poland,POL,0,0,5,0,5
2020,Armenia,ARM,Poland,POL,0,0,20,0,20
2020,Azerbaijan,AZE,Poland,POL,0,0,18,0,18
2020,Bangladesh,BGD,Poland,POL,0,0,13,0,13
2020,Belarus,BLR,Poland,POL,0,0,32,0,32
2020,China,CHN,Poland,POL,0,0,5,0,5
2020,Cuba,CUB,Poland,POL,0,0,10,0,10
2020,Ethiopia,ETH,Poland,POL,0,0,5,0,5
2020,Gambia,GMB,Poland,POL,0,0,5,0,5
2020,Georgia,GEO,Poland,POL,0,0,40,0,40
2020,Guinea,GIN,Poland,POL,0,0,5,0,5
2020,India,IND,Poland,POL,0,0,16,0,16
2020,Iran (Islamic Rep. of),IRN,Poland,POL,0,0,10,0,10
2020,Iraq,IRQ,Poland,POL,0,0,10,0,10
2020,Kazakhstan,KAZ,Poland,POL,0,0,41,0,41
2020,Kyrgyzstan,KGZ,Poland,POL,0,0,49,0,49
2020,Lebanon,LBN,Poland,POL,0,5,0,0,5
2020,Rep. of Moldova,MDA,Poland,POL,0,0,5,0,5
2020,Nigeria,NGA,Poland,POL,0,0,10,0,10
2020,Pakistan,PAK,Poland,POL,0,0,5,0,5
2020,Russian Federation,RUS,Poland,POL,0,0,997,0,997
2020,Viet Nam,VNM,Poland,POL,0,0,5,0,5
2020,Tajikistan,TJK,Poland,POL,0,0,48,0,48
2020,Tunisia,TUN,Poland,POL,0,0,5,0,5
2020,Turkey,TUR,Poland,POL,0,0,10,0,10
2020,Uganda,UGA,Poland,POL,0,0,5,0,5
2020,Ukraine,UKR,Poland,POL,0,5,302,0,307
2020,Uzbekistan,UZB,Poland,POL,0,0,5,0,5
2020,Stateless,XXA,Poland,POL,0,0,5,0,5
2020,Afghanistan,AFG,South Africa,ZAF,5,0,0,0,5
2020,Algeria,DZA,South Africa,ZAF,47,0,0,0,47
2020,Angola,AGO,South Africa,ZAF,5,0,0,0,5
2020,Egypt,EGY,South Africa,ZAF,24,0,10,15,49
2020,Burundi,BDI,South Africa,ZAF,129,0,69,138,336
2020,Benin,BEN,South Africa,ZAF,13,0,0,0,13
2020,Bangladesh,BGD,South Africa,ZAF,2115,0,262,1402,3779
2020,Bahamas,BHS,South Africa,ZAF,5,0,0,0,5
2020,China,CHN,South Africa,ZAF,13,0,0,0,13
2020,Cameroon,CMR,South Africa,ZAF,175,0,16,29,220
2020,Congo,COG,South Africa,ZAF,52,0,27,46,125
2020,Dem. Rep. of the Congo,COD,South Africa,ZAF,724,0,207,499,1430
2020,Comoros,COM,South Africa,ZAF,5,0,0,0,5
2020,Eritrea,ERI,South Africa,ZAF,22,0,5,43,70
2020,Estonia,EST,South Africa,ZAF,5,0,0,0,5
2020,Ethiopia,ETH,South Africa,ZAF,2071,0,384,1704,4159
2020,Ghana,GHA,South Africa,ZAF,394,0,30,33,457
2020,Guinea,GIN,South Africa,ZAF,5,0,0,0,5
2020,Cote d'Ivoire,CIV,South Africa,ZAF,5,0,0,5,10
2020,India,IND,South Africa,ZAF,456,0,49,142,647
2020,Jordan,JOR,South Africa,ZAF,5,0,0,0,5
2020,Kenya,KEN,South Africa,ZAF,43,0,5,5,53
2020,Liberia,LBR,South Africa,ZAF,10,0,5,0,15
2020,Lesotho,LSO,South Africa,ZAF,10,0,0,0,10
2020,Mali,MLI,South Africa,ZAF,10,0,0,0,10
2020,Malawi,MWI,South Africa,ZAF,489,0,17,23,529
2020,Mozambique,MOZ,South Africa,ZAF,115,0,12,0,127
2020,Nepal,NPL,South Africa,ZAF,52,0,5,0,57
2020,Niger,NER,South Africa,ZAF,31,0,5,0,36
2020,Nigeria,NGA,South Africa,ZAF,1073,0,63,64,1200
2020,Pakistan,PAK,South Africa,ZAF,1154,0,115,308,1577
2020,Rwanda,RWA,South Africa,ZAF,13,0,13,26,52
2020,Senegal,SEN,South Africa,ZAF,78,0,24,23,125
2020,Somalia,SOM,South Africa,ZAF,176,0,68,205,449
2020,Eswatini,SWZ,South Africa,ZAF,10,0,0,0,10
2020,United Rep. of Tanzania,TZA,South Africa,ZAF,57,0,5,5,67
2020,Thailand,THA,South Africa,ZAF,5,0,0,0,5
2020,Togo,TGO,South Africa,ZAF,5,0,0,0,5
2020,Uganda,UGA,South Africa,ZAF,316,0,25,33,374
2020,Zambia,ZMB,South Africa,ZAF,21,0,5,0,26
2020,Zimbabwe,ZWE,South Africa,ZAF,2050,0,120,53,2223
2020,Yemen,YEM,Sudan,SDN,0,0,0,11,11
2020,Afghanistan,AFG,Sweden,SWE,161,41,1639,126,1967
2020,Albania,ALB,Sweden,SWE,0,0,358,35,393
2020,Algeria,DZA,Sweden,SWE,0,0,31,10,41
2020,Angola,AGO,Sweden,SWE,0,0,10,0,10
2020,Egypt,EGY,Sweden,SWE,5,0,280,47,332
2020,Argentina,ARG,Sweden,SWE,0,0,13,0,13
2020,Armenia,ARM,Sweden,SWE,0,12,128,11,151
2020,Australia,AUS,Sweden,SWE,0,0,5,0,5
2020,Azerbaijan,AZE,Sweden,SWE,0,0,229,68,297
2020,Bahrain,BHR,Sweden,SWE,0,0,0,5,5
2020,Burundi,BDI,Sweden,SWE,0,0,33,0,33
2020,Bangladesh,BGD,Sweden,SWE,0,0,108,38,146
2020,Burkina Faso,BFA,Sweden,SWE,0,0,5,0,5
2020,Belarus,BLR,Sweden,SWE,5,0,43,5,53
2020,Bolivia (Plurinational State of),BOL,Sweden,SWE,0,0,18,5,23
2020,Brazil,BRA,Sweden,SWE,0,0,5,0,5
2020,Bosnia and Herzegovina,BIH,Sweden,SWE,0,0,35,5,40
2020,Bulgaria,BGR,Sweden,SWE,0,0,0,5,5
2020,Chad,TCD,Sweden,SWE,0,0,5,0,5
2020,China,CHN,Sweden,SWE,0,0,20,0,20
2020,Chile,CHL,Sweden,SWE,0,0,54,5,59
2020,Cameroon,CMR,Sweden,SWE,0,0,68,17,85
2020,Congo,COG,Sweden,SWE,0,0,13,0,13
2020,Dem. Rep. of the Congo,COD,Sweden,SWE,0,5,49,5,59
2020,Colombia,COL,Sweden,SWE,0,0,356,27,383
2020,Costa Rica,CRI,Sweden,SWE,0,0,5,0,5
2020,Cuba,CUB,Sweden,SWE,0,0,21,0,21
2020,Djibouti,DJI,Sweden,SWE,0,0,15,0,15
2020,Ecuador,ECU,Sweden,SWE,0,0,18,0,18
2020,Eritrea,ERI,Sweden,SWE,0,0,130,12,142
2020,Ethiopia,ETH,Sweden,SWE,0,0,274,40,314
2020,Gambia,GMB,Sweden,SWE,0,0,81,5,86
2020,Palestinian,PSE,Sweden,SWE,0,0,252,63,315
2020,United Kingdom of Great Britain and Northern Ireland,GBR,Sweden,SWE,0,0,5,0,5
2020,Georgia,GEO,Sweden,SWE,0,0,389,28,417
2020,Ghana,GHA,Sweden,SWE,0,0,50,0,50
2020,Guinea-Bissau,GNB,Sweden,SWE,0,0,5,5,10
2020,Guatemala,GTM,Sweden,SWE,0,0,10,0,10
2020,Guinea,GIN,Sweden,SWE,0,0,19,0,19
2020,Honduras,HND,Sweden,SWE,0,10,31,0,41
2020,Cote d'Ivoire,CIV,Sweden,SWE,0,0,10,0,10
2020,India,IND,Sweden,SWE,0,0,60,11,71
2020,Iran (Islamic Rep. of),IRN,Sweden,SWE,150,5,548,178,881
2020,Iraq,IRQ,Sweden,SWE,69,18,1620,194,1901
2020,Israel,ISR,Sweden,SWE,0,0,10,0,10
2020,Jamaica,JAM,Sweden,SWE,0,0,5,0,5
2020,Jordan,JOR,Sweden,SWE,0,0,141,35,176
2020,Kazakhstan,KAZ,Sweden,SWE,0,0,231,10,241
2020,Kenya,KEN,Sweden,SWE,0,0,32,0,32
2020,Kyrgyzstan,KGZ,Sweden,SWE,0,0,115,5,120
2020,Kuwait,KWT,Sweden,SWE,0,0,0,5,5
2020,Liberia,LBR,Sweden,SWE,0,0,5,0,5
2020,Libya,LBY,Sweden,SWE,0,0,34,10,44
2020,Lebanon,LBN,Sweden,SWE,0,0,244,26,270
2020,Sri Lanka,LKA,Sweden,SWE,0,0,25,5,30
2020,Mauritania,MRT,Sweden,SWE,0,0,5,0,5
2020,North Macedonia,MKD,Sweden,SWE,0,0,59,11,70
2020,Rep. of Moldova,MDA,Sweden,SWE,0,0,10,0,10
2020,Mexico,MEX,Sweden,SWE,0,0,5,0,5
2020,Mali,MLI,Sweden,SWE,0,0,10,0,10
2020,Malaysia,MYS,Sweden,SWE,0,0,0,5,5
2020,Mongolia,MNG,Sweden,SWE,0,0,272,10,282
2020,Morocco,MAR,Sweden,SWE,0,0,148,27,175
2020,Mozambique,MOZ,Sweden,SWE,0,0,5,0,5
2020,Montenegro,MNE,Sweden,SWE,0,0,11,0,11
2020,Nepal,NPL,Sweden,SWE,0,0,11,0,11
2020,Nicaragua,NIC,Sweden,SWE,0,0,277,11,288
2020,Nigeria,NGA,Sweden,SWE,0,0,258,34,292
2020,Pakistan,PAK,Sweden,SWE,5,0,210,28,243
2020,Peru,PER,Sweden,SWE,0,0,153,10,163
2020,Philippines,PHL,Sweden,SWE,0,0,17,0,17
2020,South Africa,ZAF,Sweden,SWE,0,0,10,0,10
2020,Russian Federation,RUS,Sweden,SWE,5,5,263,28,301
2020,Rwanda,RWA,Sweden,SWE,0,0,20,5,25
2020,El Salvador,SLV,Sweden,SWE,5,5,222,5,237
2020,Saudi Arabia,SAU,Sweden,SWE,0,0,0,5,5
2020,Serbia and Kosovo: S/RES/1244 (1999),SRB,Sweden,SWE,0,0,181,45,226
2020,Senegal,SEN,Sweden,SWE,0,0,12,0,12
2020,Sierra Leone,SLE,Sweden,SWE,0,0,15,0,15
2020,Somalia,SOM,Sweden,SWE,19,0,480,32,531
2020,Viet Nam,VNM,Sweden,SWE,0,0,28,5,33
2020,Sudan,SDN,Sweden,SWE,0,0,66,13,79
2020,Syrian Arab Rep.,SYR,Sweden,SWE,5,5,254,82,346
2020,United Rep. of Tanzania,TZA,Sweden,SWE,0,0,38,5,43
2020,Thailand,THA,Sweden,SWE,0,0,10,0,10
2020,Tajikistan,TJK,Sweden,SWE,0,0,53,5,58
2020,Turkmenistan,TKM,Sweden,SWE,5,0,0,0,5
2020,Tunisia,TUN,Sweden,SWE,5,0,55,0,60
2020,Turkey,TUR,Sweden,SWE,19,5,174,51,249
2020,Uganda,UGA,Sweden,SWE,5,0,34,5,44
2020,Ukraine,UKR,Sweden,SWE,5,0,460,52,517
2020,United States of America,USA,Sweden,SWE,0,0,14,5,19
2020,Uzbekistan,UZB,Sweden,SWE,0,0,385,92,477
2020,Venezuela (Bolivarian Republic of),VEN,Sweden,SWE,0,0,153,22,175
2020,Yemen,YEM,Sweden,SWE,0,0,20,11,31
2020,Zambia,ZMB,Sweden,SWE,0,0,5,0,5
2020,Stateless,XXA,Sweden,SWE,13,11,341,78,443
2020,Afghanistan,AFG,United States of America,USA,5,0,0,0,5
2020,Albania,ALB,United States of America,USA,27,0,5,12,44
2020,Angola,AGO,United States of America,USA,12,0,23,0,35
2020,Egypt,EGY,United States of America,USA,48,0,16,31,95
2020,Argentina,ARG,United States of America,USA,0,0,0,5,5
2020,Armenia,ARM,United States of America,USA,0,0,0,12,12
2020,Azerbaijan,AZE,United States of America,USA,11,0,0,0,11
2020,Burundi,BDI,United States of America,USA,12,0,5,0,17
2020,Benin,BEN,United States of America,USA,0,0,5,0,5
2020,Bangladesh,BGD,United States of America,USA,63,0,19,43,125
2020,Burkina Faso,BFA,United States of America,USA,27,0,5,0,32
2020,Belarus,BLR,United States of America,USA,13,0,0,11,24
2020,Bolivia (Plurinational State of),BOL,United States of America,USA,0,0,0,10,10
2020,Brazil,BRA,United States of America,USA,0,0,15,68,83
2020,Cambodia,KHM,United States of America,USA,5,0,0,0,5
2020,China,CHN,United States of America,USA,738,0,217,399,1354
2020,Cameroon,CMR,United States of America,USA,16,0,10,24,50
2020,Congo,COG,United States of America,USA,11,0,5,11,27
2020,Dem. Rep. of the Congo,COD,United States of America,USA,10,0,0,19,29
2020,Colombia,COL,United States of America,USA,40,0,44,67,151
2020,Costa Rica,CRI,United States of America,USA,0,0,0,10,10
2020,Dominican Rep.,DOM,United States of America,USA,5,0,0,0,5
2020,Ecuador,ECU,United States of America,USA,5,0,55,475,535
2020,Eritrea,ERI,United States of America,USA,14,0,0,5,19
2020,Ethiopia,ETH,United States of America,USA,31,0,12,20,63
2020,Fiji,FJI,United States of America,USA,0,0,5,0,5
2020,Gabon,GAB,United States of America,USA,5,0,0,0,5
2020,Gambia,GMB,United States of America,USA,5,0,5,13,23
2020,Palestinian,PSE,United States of America,USA,5,0,0,0,5
2020,Georgia,GEO,United States of America,USA,10,0,5,10,25
2020,Guatemala,GTM,United States of America,USA,17,0,111,314,442
2020,Guinea,GIN,United States of America,USA,10,0,0,5,15
2020,Guyana,GUY,United States of America,USA,0,0,0,11,11
2020,Haiti,HTI,United States of America,USA,12,0,33,48,93
2020,Honduras,HND,United States of America,USA,11,0,49,103,163
2020,Cote d'Ivoire,CIV,United States of America,USA,12,0,5,5,22
2020,India,IND,United States of America,USA,183,0,77,88,348
2020,Indonesia,IDN,United States of America,USA,10,0,12,22,44
2020,Iran (Islamic Rep. of),IRN,United States of America,USA,23,0,0,10,33
2020,Iraq,IRQ,United States of America,USA,61,0,10,37,108
2020,Jamaica,JAM,United States of America,USA,0,0,0,5,5
2020,Jordan,JOR,United States of America,USA,0,0,5,13,18
2020,Kazakhstan,KAZ,United States of America,USA,11,0,5,11,27
2020,Kenya,KEN,United States of America,USA,13,0,0,5,18
2020,Kyrgyzstan,KGZ,United States of America,USA,29,0,10,0,39
2020,Kuwait,KWT,United States of America,USA,0,0,5,0,5
2020,Lao People's Dem. Rep.,LAO,United States of America,USA,0,0,0,5,5
2020,Liberia,LBR,United States of America,USA,13,0,0,26,39
2020,Libya,LBY,United States of America,USA,12,0,10,10,32
2020,Sri Lanka,LKA,United States of America,USA,20,0,5,5,30
2020,Rep. of Moldova,MDA,United States of America,USA,18,0,10,5,33
2020,Mexico,MEX,United States of America,USA,11,0,165,1149,1325
2020,Mali,MLI,United States of America,USA,13,0,0,0,13
2020,Malaysia,MYS,United States of America,USA,0,0,0,5,5
2020,Mongolia,MNG,United States of America,USA,5,0,0,11,16
2020,Morocco,MAR,United States of America,USA,0,0,0,5,5
2020,Myanmar,MMR,United States of America,USA,10,0,0,0,10
2020,Nepal,NPL,United States of America,USA,86,0,17,30,133
2020,Nicaragua,NIC,United States of America,USA,5,0,10,5,20
2020,Nigeria,NGA,United States of America,USA,111,0,33,48,192
2020,Oman,OMN,United States of America,USA,5,0,0,0,5
2020,Pakistan,PAK,United States of America,USA,30,0,19,44,93
2020,Peru,PER,United States of America,USA,0,0,10,41,51
2020,Philippines,PHL,United States of America,USA,5,0,5,35,45
2020,Poland,POL,United States of America,USA,0,0,0,23,23
2020,Romania,ROU,United States of America,USA,5,0,5,11,21
2020,South Africa,ZAF,United States of America,USA,0,0,10,0,10
2020,Russian Federation,RUS,United States of America,USA,63,0,13,40,116
2020,Rwanda,RWA,United States of America,USA,22,0,10,0,32
2020,El Salvador,SLV,United States of America,USA,19,0,87,338,444
2020,Saudi Arabia,SAU,United States of America,USA,14,0,0,0,14
2020,Serbia and Kosovo: S/RES/1244 (1999),SRB,United States of America,USA,14,0,5,0,19
2020,Senegal,SEN,United States of America,USA,0,0,0,11,11
2020,Sierra Leone,SLE,United States of America,USA,5,0,0,0,5
2020,Somalia,SOM,United States of America,USA,0,0,0,5,5
2020,Sudan,SDN,United States of America,USA,5,0,0,0,5
2020,Syrian Arab Rep.,SYR,United States of America,USA,28,0,0,10,38
2020,Tajikistan,TJK,United States of America,USA,5,0,0,0,5
2020,Turkey,TUR,United States of America,USA,5,0,0,0,5
2020,United Arab Emirates,ARE,United States of America,USA,0,0,0,5,5
2020,Uganda,UGA,United States of America,USA,24,0,5,17,46
2020,Ukraine,UKR,United States of America,USA,49,0,13,46,108
2020,Uzbekistan,UZB,United States of America,USA,23,0,5,5,33
2020,Venezuela (Bolivarian Republic of),VEN,United States of America,USA,265,0,160,171,596
2020,Yemen,YEM,United States of America,USA,14,0,0,0,14
2020,Zimbabwe,ZWE,United States of America,USA,5,0,0,0,5
2021,Haiti,HTI,Argentina,ARG,0,0,5,0,5
2021,Senegal,SEN,Argentina,ARG,0,0,19,0,19
2021,Cuba,CUB,Armenia,ARM,0,0,0,15,15
2021,Iran (Islamic Rep. of),IRN,Armenia,ARM,0,0,12,0,12
2021,Turkey,TUR,Armenia,ARM,0,0,10,0,10
2021,Afghanistan,AFG,Australia,AUS,48,0,28,5,81
2021,Albania,ALB,Australia,AUS,0,0,5,0,5
2021,Egypt,EGY,Australia,AUS,21,0,24,10,55
2021,Bangladesh,BGD,Australia,AUS,22,0,70,5,97
2021,Cambodia,KHM,Australia,AUS,0,0,5,10,15
2021,China,CHN,Australia,AUS,38,0,1714,528,2280
2021,Cameroon,CMR,Australia,AUS,0,0,0,5,5
2021,Dem. Rep. of the Congo,COD,Australia,AUS,5,0,5,0,10
2021,Colombia,COL,Australia,AUS,0,0,13,0,13
2021,Ethiopia,ETH,Australia,AUS,33,0,15,0,48
2021,Fiji,FJI,Australia,AUS,5,0,21,44,70
2021,United Kingdom of Great Britain and Northern Ireland,GBR,Australia,AUS,0,0,5,0,5
2021,Ghana,GHA,Australia,AUS,0,0,5,5,10
2021,India,IND,Australia,AUS,15,0,91,121,227
2021,Indonesia,IDN,Australia,AUS,0,0,42,64,106
2021,Iran (Islamic Rep. of),IRN,Australia,AUS,103,0,370,19,492
2021,Iraq,IRQ,Australia,AUS,41,0,109,56,206
2021,Israel,ISR,Australia,AUS,0,0,0,5,5
2021,Jordan,JOR,Australia,AUS,5,0,13,0,18
2021,Kenya,KEN,Australia,AUS,0,0,0,11,11
2021,Rep. of Korea,KOR,Australia,AUS,0,0,14,0,14
2021,Liberia,LBR,Australia,AUS,0,0,0,5,5
2021,Libya,LBY,Australia,AUS,19,0,0,0,19
2021,Lebanon,LBN,Australia,AUS,11,0,23,10,44
2021,Sri Lanka,LKA,Australia,AUS,24,0,481,10,515
2021,Malaysia,MYS,Australia,AUS,35,0,949,914,1898
2021,Mauritius,MUS,Australia,AUS,0,0,5,5,10
2021,Myanmar,MMR,Australia,AUS,29,0,0,5,34
2021,Nepal,NPL,Australia,AUS,5,0,31,5,41
2021,Nigeria,NGA,Australia,AUS,5,0,20,17,42
2021,Pakistan,PAK,Australia,AUS,78,0,337,40,455
2021,Peru,PER,Australia,AUS,0,0,5,0,5
2021,Philippines,PHL,Australia,AUS,0,0,10,20,30
2021,Papua New Guinea,PNG,Australia,AUS,32,0,10,0,42
2021,South Africa,ZAF,Australia,AUS,0,0,5,0,5
2021,El Salvador,SLV,Australia,AUS,5,0,0,0,5
2021,Saudi Arabia,SAU,Australia,AUS,5,0,0,5,10
2021,Serbia and Kosovo: S/RES/1244 (1999),SRB,Australia,AUS,0,0,5,0,5
2021,Sierra Leone,SLE,Australia,AUS,5,0,0,5,10
2021,Viet Nam,VNM,Australia,AUS,5,0,202,139,346
2021,Sudan,SDN,Australia,AUS,0,0,5,0,5
2021,Thailand,THA,Australia,AUS,0,0,899,318,1217
2021,Tonga,TON,Australia,AUS,0,0,19,0,19
2021,Turkey,TUR,Australia,AUS,27,0,10,5,42
2021,Uganda,UGA,Australia,AUS,10,0,0,0,10
2021,Venezuela (Bolivarian Republic of),VEN,Australia,AUS,12,0,0,0,12
2021,Samoa,WSM,Australia,AUS,5,0,0,0,5
2021,Zambia,ZMB,Australia,AUS,5,0,0,0,5
2021,Zimbabwe,ZWE,Australia,AUS,11,0,5,5,21
2021,Stateless,XXA,Australia,AUS,34,0,5,0,39
2021,Dem. Rep. of the Congo,COD,Burundi,BDI,0,0,0,95,95
2021,Rwanda,RWA,Burundi,BDI,0,0,5,0,5
2021,Afghanistan,AFG,Canada,CAN,32,0,39,0,71
2021,Albania,ALB,Canada,CAN,31,0,29,5,65
2021,Algeria,DZA,Canada,CAN,52,0,87,0,139
2021,Angola,AGO,Canada,CAN,38,0,180,0,218
2021,Antigua and Barbuda,ATG,Canada,CAN,5,0,0,0,5
2021,Egypt,EGY,Canada,CAN,40,0,87,0,127
2021,Argentina,ARG,Canada,CAN,5,0,5,0,10
2021,Armenia,ARM,Canada,CAN,0,0,5,0,5
2021,Austria,AUT,Canada,CAN,0,0,5,0,5
2021,Azerbaijan,AZE,Canada,CAN,16,0,15,5,36
2021,Barbados,BRB,Canada,CAN,0,0,17,0,17
2021,Burundi,BDI,Canada,CAN,0,0,12,0,12
2021,Belgium,BEL,Canada,CAN,5,0,5,0,10
2021,Benin,BEN,Canada,CAN,0,0,10,0,10
2021,Bangladesh,BGD,Canada,CAN,108,0,60,0,168
2021,Bahamas,BHS,Canada,CAN,5,0,32,5,42
2021,Burkina Faso,BFA,Canada,CAN,0,0,5,0,5
2021,Botswana,BWA,Canada,CAN,0,0,5,0,5
2021,Brazil,BRA,Canada,CAN,10,0,56,10,76
2021,Chad,TCD,Canada,CAN,15,0,5,5,25
2021,China,CHN,Canada,CAN,181,0,336,36,553
2021,Chile,CHL,Canada,CAN,10,0,30,0,40
2021,Cameroon,CMR,Canada,CAN,11,0,41,10,62
2021,Congo,COG,Canada,CAN,5,0,12,0,17
2021,Dem. Rep. of the Congo,COD,Canada,CAN,53,0,182,13,248
2021,Colombia,COL,Canada,CAN,96,0,291,26,413
2021,Costa Rica,CRI,Canada,CAN,0,0,12,0,12
2021,Cuba,CUB,Canada,CAN,0,0,5,0,5
2021,Czechia,CZE,Canada,CAN,5,0,0,0,5
2021,Djibouti,DJI,Canada,CAN,13,0,10,5,28
2021,Dominica,DMA,Canada,CAN,5,0,0,0,5
2021,Dominican Rep.,DOM,Canada,CAN,0,0,12,0,12
2021,Ecuador,ECU,Canada,CAN,10,0,16,0,26
2021,Eritrea,ERI,Canada,CAN,15,0,20,0,35
2021,Ethiopia,ETH,Canada,CAN,79,0,40,0,119
2021,Fiji,FJI,Canada,CAN,0,0,5,0,5
2021,France,FRA,Canada,CAN,0,0,0,5,5
2021,Gabon,GAB,Canada,CAN,5,0,0,0,5
2021,Gambia,GMB,Canada,CAN,5,0,13,0,18
2021,Palestinian,PSE,Canada,CAN,38,0,27,0,65
2021,United Kingdom of Great Britain and Northern Ireland,GBR,Canada,CAN,0,0,5,0,5
2021,Georgia,GEO,Canada,CAN,20,0,28,0,48
2021,Ghana,GHA,Canada,CAN,35,0,59,0,94
2021,Guatemala,GTM,Canada,CAN,5,0,16,0,21
2021,Guinea,GIN,Canada,CAN,0,0,12,0,12
2021,Guyana,GUY,Canada,CAN,5,0,13,0,18
2021,Haiti,HTI,Canada,CAN,127,0,441,95,663
2021,Honduras,HND,Canada,CAN,10,0,18,0,28
2021,Hungary,HUN,Canada,CAN,5,0,11,5,21
2021,Cote d'Ivoire,CIV,Canada,CAN,5,0,21,0,26
2021,India,IND,Canada,CAN,291,0,821,25,1137
2021,Indonesia,IDN,Canada,CAN,0,0,5,5,10
2021,Ireland,IRL,Canada,CAN,0,0,13,0,13
2021,Iran (Islamic Rep. of),IRN,Canada,CAN,62,0,55,5,122
2021,Iraq,IRQ,Canada,CAN,25,0,44,5,74
2021,Israel,ISR,Canada,CAN,0,0,15,0,15
2021,Italy,ITA,Canada,CAN,0,0,21,0,21
2021,Jamaica,JAM,Canada,CAN,24,0,46,5,75
2021,Jordan,JOR,Canada,CAN,45,0,80,15,140
2021,Kenya,KEN,Canada,CAN,48,0,64,5,117
2021,Kyrgyzstan,KGZ,Canada,CAN,5,0,0,0,5
2021,Rep. of Korea,KOR,Canada,CAN,10,0,0,0,10
2021,Dem. People's Rep. of Korea,PRK,Canada,CAN,0,0,11,0,11
2021,Kuwait,KWT,Canada,CAN,0,0,0,5,5
2021,Liberia,LBR,Canada,CAN,5,0,11,0,16
2021,Libya,LBY,Canada,CAN,15,0,10,0,25
2021,Saint Lucia,LCA,Canada,CAN,5,0,10,0,15
2021,Lebanon,LBN,Canada,CAN,24,0,65,15,104
2021,Sri Lanka,LKA,Canada,CAN,64,0,50,5,119
2021,Madagascar,MDG,Canada,CAN,5,0,0,0,5
2021,Mauritania,MRT,Canada,CAN,5,0,0,0,5
2021,Rep. of Moldova,MDA,Canada,CAN,0,0,5,0,5
2021,Mexico,MEX,Canada,CAN,465,0,1218,62,1745
2021,Mali,MLI,Canada,CAN,0,0,12,0,12
2021,Malaysia,MYS,Canada,CAN,0,0,5,0,5
2021,Malawi,MWI,Canada,CAN,13,0,0,0,13
2021,Morocco,MAR,Canada,CAN,0,0,5,0,5
2021,Namibia,NAM,Canada,CAN,0,0,5,0,5
2021,Nepal,NPL,Canada,CAN,12,0,26,5,43
2021,Netherlands,NLD,Canada,CAN,0,0,5,5,10
2021,Niger,NER,Canada,CAN,5,0,0,0,5
2021,Nicaragua,NIC,Canada,CAN,5,0,0,0,5
2021,Nigeria,NGA,Canada,CAN,869,0,1582,533,2984
2021,Pakistan,PAK,Canada,CAN,260,0,384,27,671
2021,Panama,PAN,Canada,CAN,5,0,0,0,5
2021,Peru,PER,Canada,CAN,5,0,13,0,18
2021,Philippines,PHL,Canada,CAN,5,0,38,0,43
2021,Poland,POL,Canada,CAN,0,0,5,0,5
2021,Portugal,PRT,Canada,CAN,0,0,5,0,5
2021,Romania,ROU,Canada,CAN,21,0,13,0,34
2021,South Africa,ZAF,Canada,CAN,26,0,26,0,52
2021,Russian Federation,RUS,Canada,CAN,5,0,12,5,22
2021,Rwanda,RWA,Canada,CAN,20,0,50,5,75
2021,El Salvador,SLV,Canada,CAN,17,0,28,10,55
2021,Saudi Arabia,SAU,Canada,CAN,13,0,10,0,23
2021,Serbia and Kosovo: S/RES/1244 (1999),SRB,Canada,CAN,0,0,13,0,13
2021,Senegal,SEN,Canada,CAN,10,0,70,5,85
2021,Sierra Leone,SLE,Canada,CAN,0,0,5,0,5
2021,Somalia,SOM,Canada,CAN,42,0,36,0,78
2021,Spain,ESP,Canada,CAN,0,0,5,0,5
2021,Viet Nam,VNM,Canada,CAN,5,0,20,0,25
2021,Sudan,SDN,Canada,CAN,13,0,14,0,27
2021,South Sudan,SSD,Canada,CAN,5,0,0,0,5
2021,Sweden,SWE,Canada,CAN,0,0,5,0,5
2021,Syrian Arab Rep.,SYR,Canada,CAN,5,0,5,0,10
2021,United Rep. of Tanzania,TZA,Canada,CAN,5,0,14,0,19
2021,Trinidad and Tobago,TTO,Canada,CAN,0,0,11,0,11
2021,Tunisia,TUN,Canada,CAN,0,0,14,0,14
2021,Turkey,TUR,Canada,CAN,25,0,20,5,50
2021,United Arab Emirates,ARE,Canada,CAN,0,0,5,5,10
2021,Uganda,UGA,Canada,CAN,23,0,33,15,71
2021,Ukraine,UKR,Canada,CAN,12,0,12,0,24
2021,Uruguay,URY,Canada,CAN,0,0,5,0,5
2021,United States of America,USA,Canada,CAN,15,0,268,45,328
2021,Uzbekistan,UZB,Canada,CAN,5,0,0,0,5
2021,Saint Vincent and the Grenadines,VCT,Canada,CAN,5,0,5,0,10
2021,Venezuela (Bolivarian Republic of),VEN,Canada,CAN,43,0,40,10,93
2021,Yemen,YEM,Canada,CAN,5,0,0,0,5
2021,Zimbabwe,ZWE,Canada,CAN,21,0,28,10,59
2021,Stateless,XXA,Canada,CAN,0,0,5,0,5
2021,Colombia,COL,Costa Rica,CRI,0,0,36,0,36
2021,Cuba,CUB,Costa Rica,CRI,0,0,28,0,28
2021,Ghana,GHA,Costa Rica,CRI,0,0,5,0,5
2021,Honduras,HND,Costa Rica,CRI,0,0,5,0,5
2021,Nicaragua,NIC,Costa Rica,CRI,0,0,298,18,316
2021,El Salvador,SLV,Costa Rica,CRI,45,0,163,0,208
2021,Venezuela (Bolivarian Republic of),VEN,Costa Rica,CRI,13,0,223,47,283
2021,Afghanistan,AFG,Denmark,DNK,5,10,27,0,42
2021,Albania,ALB,Denmark,DNK,0,0,10,0,10
2021,Algeria,DZA,Denmark,DNK,0,0,5,0,5
2021,Egypt,EGY,Denmark,DNK,0,0,5,0,5
2021,Armenia,ARM,Denmark,DNK,0,0,5,0,5
2021,Bangladesh,BGD,Denmark,DNK,5,0,0,0,5
2021,China,CHN,Denmark,DNK,0,0,5,0,5
2021,Cameroon,CMR,Denmark,DNK,0,0,5,0,5
2021,Dem. Rep. of the Congo,COD,Denmark,DNK,0,0,5,0,5
2021,Colombia,COL,Denmark,DNK,0,0,14,0,14
2021,Eritrea,ERI,Denmark,DNK,18,0,0,0,18
2021,Ethiopia,ETH,Denmark,DNK,0,0,5,0,5
2021,Georgia,GEO,Denmark,DNK,0,0,22,0,22
2021,India,IND,Denmark,DNK,0,0,10,0,10
2021,Iran (Islamic Rep. of),IRN,Denmark,DNK,30,0,33,0,63
2021,Iraq,IRQ,Denmark,DNK,0,5,17,0,22
2021,Jordan,JOR,Denmark,DNK,0,0,5,0,5
2021,Lebanon,LBN,Denmark,DNK,0,0,5,0,5
2021,North Macedonia,MKD,Denmark,DNK,0,0,5,0,5
2021,Morocco,MAR,Denmark,DNK,0,0,11,0,11
2021,Nicaragua,NIC,Denmark,DNK,5,0,0,0,5
2021,Nigeria,NGA,Denmark,DNK,0,0,5,0,5
2021,Pakistan,PAK,Denmark,DNK,0,0,13,0,13
2021,Russian Federation,RUS,Denmark,DNK,0,0,10,0,10
2021,Somalia,SOM,Denmark,DNK,16,5,35,0,56
2021,Syrian Arab Rep.,SYR,Denmark,DNK,16,0,28,0,44
2021,Turkey,TUR,Denmark,DNK,12,0,0,0,12
2021,Uganda,UGA,Denmark,DNK,0,0,5,0,5
2021,Ukraine,UKR,Denmark,DNK,0,0,5,0,5
2021,Venezuela (Bolivarian Republic of),VEN,Denmark,DNK,0,0,10,0,10
2021,Stateless,XXA,Denmark,DNK,5,0,47,0,52
2021,Afghanistan,AFG,France,FRA,958,2037,1349,132,4476
2021,Albania,ALB,France,FRA,30,104,297,1234,1665
2021,Algeria,DZA,France,FRA,42,19,118,839,1018
2021,Angola,AGO,France,FRA,51,106,831,59,1047
2021,Egypt,EGY,France,FRA,96,5,110,33,244
2021,Armenia,ARM,France,FRA,21,33,393,723,1170
2021,Azerbaijan,AZE,France,FRA,96,5,179,78,358
2021,Burundi,BDI,France,FRA,15,0,42,13,70
2021,Benin,BEN,France,FRA,5,10,37,5,57
2021,Bangladesh,BGD,France,FRA,666,330,4018,3136,8150
2021,Bhutan,BTN,France,FRA,5,0,0,0,5
2021,Burkina Faso,BFA,France,FRA,27,12,104,11,154
2021,Belarus,BLR,France,FRA,21,0,47,5,73
2021,Bolivia (Plurinational State of),BOL,France,FRA,0,0,5,0,5
2021,Brazil,BRA,France,FRA,0,0,16,11,27
2021,Bosnia and Herzegovina,BIH,France,FRA,5,0,57,232,294
2021,Cambodia,KHM,France,FRA,0,0,30,5,35
2021,Central African Rep.,CAF,France,FRA,31,46,120,22,219
2021,Chad,TCD,France,FRA,90,19,268,68,445
2021,China,CHN,France,FRA,10,0,16,50,76
2021,Chile,CHL,France,FRA,0,0,10,0,10
2021,Cameroon,CMR,France,FRA,144,40,389,38,611
2021,Congo,COG,France,FRA,57,27,452,64,600
2021,Dem. Rep. of the Congo,COD,France,FRA,384,170,1869,250,2673
2021,Comoros,COM,France,FRA,22,5,185,992,1204
2021,Colombia,COL,France,FRA,19,59,243,23,344
2021,Cuba,CUB,France,FRA,5,0,63,19,87
2021,Djibouti,DJI,France,FRA,15,0,15,11,41
2021,Dominican Rep.,DOM,France,FRA,0,0,63,26,89
2021,Ecuador,ECU,France,FRA,0,0,5,0,5
2021,Equatorial Guinea,GNQ,France,FRA,0,0,5,0,5
2021,Eritrea,ERI,France,FRA,210,10,282,15,517
2021,Ethiopia,ETH,France,FRA,159,29,381,38,607
2021,Gabon,GAB,France,FRA,12,10,69,10,101
2021,Gambia,GMB,France,FRA,16,10,212,16,254
2021,Palestinian,PSE,France,FRA,60,0,28,0,88
2021,Georgia,GEO,France,FRA,21,26,229,1328,1604
2021,Ghana,GHA,France,FRA,0,5,39,16,60
2021,Guinea-Bissau,GNB,France,FRA,0,0,54,13,67
2021,Guinea,GIN,France,FRA,1016,192,3283,1770,6261
2021,Haiti,HTI,France,FRA,26,13,153,1844,2036
2021,Honduras,HND,France,FRA,0,0,5,0,5
2021,Croatia,HRV,France,FRA,0,0,0,5,5
2021,Cote d'Ivoire,CIV,France,FRA,670,188,2893,368,4119
2021,India,IND,France,FRA,0,5,89,177,271
2021,Iran (Islamic Rep. of),IRN,France,FRA,202,10,152,24,388
2021,Iraq,IRQ,France,FRA,102,86,200,33,421
2021,Jamaica,JAM,France,FRA,0,0,5,0,5
2021,Jordan,JOR,France,FRA,0,0,5,0,5
2021,Kazakhstan,KAZ,France,FRA,24,18,95,10,147
2021,Kenya,KEN,France,FRA,5,0,17,5,27
2021,Kyrgyzstan,KGZ,France,FRA,5,5,14,5,29
2021,Rep. of Korea,KOR,France,FRA,0,0,5,0,5
2021,Kuwait,KWT,France,FRA,69,0,28,0,97
2021,Lao People's Dem. Rep.,LAO,France,FRA,0,0,10,0,10
2021,Liberia,LBR,France,FRA,10,0,38,5,53
2021,Libya,LBY,France,FRA,46,110,142,15,313
2021,Lebanon,LBN,France,FRA,14,10,56,41,121
2021,Sri Lanka,LKA,France,FRA,450,60,1054,686,2250
2021,Madagascar,MDG,France,FRA,12,5,63,14,94
2021,Mauritania,MRT,France,FRA,169,12,391,639,1211
2021,North Macedonia,MKD,France,FRA,5,5,34,82,126
2021,Rep. of Moldova,MDA,France,FRA,0,0,35,358,393
2021,Mexico,MEX,France,FRA,0,0,5,5,10
2021,Mali,MLI,France,FRA,125,56,596,778,1555
2021,Mongolia,MNG,France,FRA,5,5,64,66,140
2021,Morocco,MAR,France,FRA,48,23,237,49,357
2021,Mozambique,MOZ,France,FRA,0,0,5,0,5
2021,Montenegro,MNE,France,FRA,0,0,10,17,27
2021,Mauritius,MUS,France,FRA,0,0,0,5,5
2021,Myanmar,MMR,France,FRA,5,0,10,5,20
2021,Nepal,NPL,France,FRA,5,5,96,0,106
2021,Niger,NER,France,FRA,10,15,45,10,80
2021,Nicaragua,NIC,France,FRA,11,0,5,0,16
2021,Nigeria,NGA,France,FRA,501,76,2651,460,3688
2021,Pakistan,PAK,France,FRA,163,28,943,1929,3063
2021,Peru,PER,France,FRA,5,10,44,5,64
2021,Philippines,PHL,France,FRA,0,0,5,0,5
2021,South Africa,ZAF,France,FRA,0,0,11,0,11
2021,Russian Federation,RUS,France,FRA,319,89,888,290,1586
2021,Rwanda,RWA,France,FRA,37,0,46,19,102
2021,El Salvador,SLV,France,FRA,0,0,12,0,12
2021,Saudi Arabia,SAU,France,FRA,5,0,5,0,10
2021,Serbia and Kosovo: S/RES/1244 (1999),SRB,France,FRA,40,32,283,893,1248
2021,Senegal,SEN,France,FRA,166,23,623,441,1253
2021,Sierra Leone,SLE,France,FRA,39,10,108,19,176
2021,Somalia,SOM,France,FRA,258,449,603,123,1433
2021,Viet Nam,VNM,France,FRA,5,0,21,11,37
2021,Sudan,SDN,France,FRA,334,138,415,107,994
2021,Suriname,SUR,France,FRA,0,0,5,0,5
2021,South Sudan,SSD,France,FRA,0,0,14,0,14
2021,Syrian Arab Rep.,SYR,France,FRA,765,121,373,45,1304
2021,United Rep. of Tanzania,TZA,France,FRA,0,0,11,0,11
2021,Thailand,THA,France,FRA,0,5,0,0,5
2021,Tajikistan,TJK,France,FRA,15,0,17,0,32
2021,Togo,TGO,France,FRA,14,5,69,10,98
2021,Tunisia,TUN,France,FRA,20,14,152,18,204
2021,Turkey,TUR,France,FRA,861,20,1475,339,2695
2021,Uganda,UGA,France,FRA,5,0,11,0,16
2021,Ukraine,UKR,France,FRA,42,33,263,52,390
2021,United States of America,USA,France,FRA,0,0,5,0,5
2021,Uzbekistan,UZB,France,FRA,0,0,11,5,16
2021,Venezuela (Bolivarian Republic of),VEN,France,FRA,60,26,159,29,274
2021,Western Sahara,ESH,France,FRA,22,5,113,138,278
2021,Yemen,YEM,France,FRA,13,40,17,5,75
2021,Zimbabwe,ZWE,France,FRA,0,0,5,0,5
2021,Afghanistan,AFG,Greece,GRC,274,901,1458,687,3320
2021,Albania,ALB,Greece,GRC,0,5,766,301,1072
2021,Algeria,DZA,Greece,GRC,0,0,78,44,122
2021,Angola,AGO,Greece,GRC,0,0,10,0,10
2021,Egypt,EGY,Greece,GRC,5,0,356,140,501
2021,Armenia,ARM,Greece,GRC,0,0,18,5,23
2021,Burundi,BDI,Greece,GRC,0,0,5,5,10
2021,Benin,BEN,Greece,GRC,0,0,0,5,5
2021,Bangladesh,BGD,Greece,GRC,0,0,584,310,894
2021,Burkina Faso,BFA,Greece,GRC,0,0,17,5,22
2021,Belarus,BLR,Greece,GRC,0,0,0,5,5
2021,Bosnia and Herzegovina,BIH,Greece,GRC,0,0,5,0,5
2021,Chad,TCD,Greece,GRC,0,0,5,0,5
2021,China,CHN,Greece,GRC,0,0,38,5,43
2021,Cameroon,CMR,Greece,GRC,26,5,159,38,228
2021,Congo,COG,Greece,GRC,0,0,23,5,28
2021,Dem. Rep. of the Congo,COD,Greece,GRC,50,22,966,147,1185
2021,Cuba,CUB,Greece,GRC,0,0,10,0,10
2021,Dominican Rep.,DOM,Greece,GRC,0,0,5,0,5
2021,Eritrea,ERI,Greece,GRC,0,0,5,0,5
2021,Ethiopia,ETH,Greece,GRC,0,0,17,5,22
2021,Gabon,GAB,Greece,GRC,0,0,5,0,5
2021,Gambia,GMB,Greece,GRC,5,0,101,10,116
2021,Palestinian,PSE,Greece,GRC,0,0,14,0,14
2021,Georgia,GEO,Greece,GRC,0,0,254,90,344
2021,Ghana,GHA,Greece,GRC,0,0,88,16,104
2021,Guinea,GIN,Greece,GRC,5,0,56,16,77
2021,Haiti,HTI,Greece,GRC,0,0,11,0,11
2021,Cote d'Ivoire,CIV,Greece,GRC,0,0,22,5,27
2021,India,IND,Greece,GRC,0,0,84,22,106
2021,Indonesia,IDN,Greece,GRC,0,0,10,0,10
2021,Iran (Islamic Rep. of),IRN,Greece,GRC,41,5,179,81,306
2021,Iraq,IRQ,Greece,GRC,60,81,811,262,1214
2021,Jordan,JOR,Greece,GRC,0,0,5,0,5
2021,Kazakhstan,KAZ,Greece,GRC,0,0,5,0,5
2021,Libya,LBY,Greece,GRC,0,0,5,0,5
2021,Lebanon,LBN,Greece,GRC,0,0,19,5,24
2021,Sri Lanka,LKA,Greece,GRC,0,0,10,0,10
2021,Mauritania,MRT,Greece,GRC,0,0,5,0,5
2021,Rep. of Moldova,MDA,Greece,GRC,0,0,0,5,5
2021,Mali,MLI,Greece,GRC,0,5,24,5,34
2021,Morocco,MAR,Greece,GRC,0,0,75,22,97
2021,Myanmar,MMR,Greece,GRC,0,0,5,5,10
2021,Nepal,NPL,Greece,GRC,5,0,23,5,33
2021,Niger,NER,Greece,GRC,0,0,11,5,16
2021,Nigeria,NGA,Greece,GRC,5,5,74,28,112
2021,Pakistan,PAK,Greece,GRC,15,5,2152,1162,3334
2021,Philippines,PHL,Greece,GRC,0,0,5,0,5
2021,Russian Federation,RUS,Greece,GRC,5,0,23,0,28
2021,Serbia and Kosovo: S/RES/1244 (1999),SRB,Greece,GRC,0,0,5,0,5
2021,Senegal,SEN,Greece,GRC,0,0,38,5,43
2021,Sierra Leone,SLE,Greece,GRC,10,0,51,5,66
2021,Somalia,SOM,Greece,GRC,17,27,258,76,378
2021,Sudan,SDN,Greece,GRC,0,5,35,5,45
2021,South Sudan,SSD,Greece,GRC,0,0,5,0,5
2021,Syrian Arab Rep.,SYR,Greece,GRC,179,66,31,1327,1603
2021,United Rep. of Tanzania,TZA,Greece,GRC,0,0,5,0,5
2021,Togo,TGO,Greece,GRC,5,0,54,5,64
2021,Tunisia,TUN,Greece,GRC,0,0,10,5,15
2021,Turkey,TUR,Greece,GRC,11,0,49,10,70
2021,Uganda,UGA,Greece,GRC,0,0,10,0,10
2021,Ukraine,UKR,Greece,GRC,0,0,31,5,36
2021,Venezuela (Bolivarian Republic of),VEN,Greece,GRC,0,0,0,5,5
2021,Stateless,XXA,Greece,GRC,0,0,10,0,10
2021,Afghanistan,AFG,Iceland,ISL,0,0,0,13,13
2021,Albania,ALB,Iceland,ISL,0,0,5,0,5
2021,Algeria,DZA,Iceland,ISL,0,0,5,0,5
2021,Azerbaijan,AZE,Iceland,ISL,0,0,5,0,5
2021,Bangladesh,BGD,Iceland,ISL,0,0,0,5,5
2021,Bosnia and Herzegovina,BIH,Iceland,ISL,0,0,5,0,5
2021,China,CHN,Iceland,ISL,0,0,0,5,5
2021,Colombia,COL,Iceland,ISL,0,0,5,0,5
2021,Palestinian,PSE,Iceland,ISL,0,0,0,101,101
2021,Ghana,GHA,Iceland,ISL,0,0,0,5,5
2021,Guinea,GIN,Iceland,ISL,0,0,5,0,5
2021,Cote d'Ivoire,CIV,Iceland,ISL,0,0,0,5,5
2021,Iran (Islamic Rep. of),IRN,Iceland,ISL,0,0,0,15,15
2021,Iraq,IRQ,Iceland,ISL,5,5,16,57,83
2021,Lebanon,LBN,Iceland,ISL,0,0,0,5,5
2021,North Macedonia,MKD,Iceland,ISL,0,0,5,0,5
2021,Morocco,MAR,Iceland,ISL,0,5,0,0,5
2021,Nigeria,NGA,Iceland,ISL,0,5,31,39,75
2021,Pakistan,PAK,Iceland,ISL,0,0,0,12,12
2021,Russian Federation,RUS,Iceland,ISL,5,0,0,0,5
2021,Senegal,SEN,Iceland,ISL,0,0,5,0,5
2021,Somalia,SOM,Iceland,ISL,5,0,0,27,32
2021,Sudan,SDN,Iceland,ISL,0,0,0,5,5
2021,Syrian Arab Rep.,SYR,Iceland,ISL,0,0,0,31,31
2021,Ukraine,UKR,Iceland,ISL,0,5,0,0,5
2021,Venezuela (Bolivarian Republic of),VEN,Iceland,ISL,5,0,0,16,21
2021,Afghanistan,AFG,Ireland,IRL,5,0,0,0,5
2021,Albania,ALB,Ireland,IRL,21,5,64,5,95
2021,Algeria,DZA,Ireland,IRL,5,0,20,5,30
2021,Angola,AGO,Ireland,IRL,0,0,5,0,5
2021,Egypt,EGY,Ireland,IRL,0,0,5,0,5
2021,Bangladesh,BGD,Ireland,IRL,10,0,13,5,28
2021,Bolivia (Plurinational State of),BOL,Ireland,IRL,0,0,5,0,5
2021,Botswana,BWA,Ireland,IRL,0,0,5,0,5
2021,Brazil,BRA,Ireland,IRL,0,5,31,0,36
2021,China,CHN,Ireland,IRL,0,0,5,0,5
2021,Cameroon,CMR,Ireland,IRL,5,0,0,0,5
2021,Dem. Rep. of the Congo,COD,Ireland,IRL,21,0,17,5,43
2021,Palestinian,PSE,Ireland,IRL,0,0,5,0,5
2021,Georgia,GEO,Ireland,IRL,20,0,94,15,129
2021,Ghana,GHA,Ireland,IRL,5,0,5,0,10
2021,Guyana,GUY,Ireland,IRL,0,0,5,0,5
2021,India,IND,Ireland,IRL,0,0,14,5,19
2021,Jordan,JOR,Ireland,IRL,5,0,0,0,5
2021,Sri Lanka,LKA,Ireland,IRL,5,0,0,0,5
2021,Malaysia,MYS,Ireland,IRL,5,0,0,0,5
2021,Malawi,MWI,Ireland,IRL,10,0,26,0,36
2021,Mongolia,MNG,Ireland,IRL,5,0,0,0,5
2021,Morocco,MAR,Ireland,IRL,0,0,11,5,16
2021,Mauritius,MUS,Ireland,IRL,0,0,0,5,5
2021,Myanmar,MMR,Ireland,IRL,5,0,0,0,5
2021,Nepal,NPL,Ireland,IRL,0,0,5,0,5
2021,Nigeria,NGA,Ireland,IRL,33,5,52,10,100
2021,Pakistan,PAK,Ireland,IRL,37,5,60,23,125
2021,South Africa,ZAF,Ireland,IRL,34,5,66,0,105
2021,Serbia and Kosovo: S/RES/1244 (1999),SRB,Ireland,IRL,0,0,5,0,5
2021,Sierra Leone,SLE,Ireland,IRL,5,0,5,0,10
2021,Somalia,SOM,Ireland,IRL,0,0,0,5,5
2021,Viet Nam,VNM,Ireland,IRL,0,0,5,0,5
2021,Syrian Arab Rep.,SYR,Ireland,IRL,5,0,0,0,5
2021,Venezuela (Bolivarian Republic of),VEN,Ireland,IRL,5,0,0,0,5
2021,Zambia,ZMB,Ireland,IRL,5,0,0,0,5
2021,Zimbabwe,ZWE,Ireland,IRL,88,0,73,12,173
2021,Afghanistan,AFG,Kazakhstan,KAZ,0,0,119,0,119
2021,Syrian Arab Rep.,SYR,Kazakhstan,KAZ,0,0,10,0,10
2021,Burundi,BDI,Kenya,KEN,0,0,0,5,5
2021,Dem. Rep. of the Congo,COD,Kenya,KEN,0,0,0,5,5
2021,Ethiopia,ETH,Kenya,KEN,0,0,0,116,116
2021,Somalia,SOM,Kenya,KEN,0,0,0,5,5
2021,United Rep. of Tanzania,TZA,Kenya,KEN,0,0,0,5,5
2021,Afghanistan,AFG,Luxembourg,LUX,0,0,5,5,10
2021,Algeria,DZA,Luxembourg,LUX,0,0,5,5,10
2021,Russian Federation,RUS,Luxembourg,LUX,0,0,5,5,10
2021,Serbia and Kosovo: S/RES/1244 (1999),SRB,Luxembourg,LUX,0,0,5,5,10
2021,Sudan,SDN,Luxembourg,LUX,0,0,5,5,10
2021,Syrian Arab Rep.,SYR,Luxembourg,LUX,0,0,5,5,10
2021,Burundi,BDI,Malawi,MWI,10,0,0,5,15
2021,Dem. Rep. of the Congo,COD,Malawi,MWI,5,0,0,0,5
2021,Rwanda,RWA,Malawi,MWI,0,0,0,5,5
2021,Algeria,DZA,Malta,MLT,0,0,0,5,5
2021,Egypt,EGY,Malta,MLT,0,0,13,11,24
2021,Bangladesh,BGD,Malta,MLT,0,0,18,10,28
2021,Colombia,COL,Malta,MLT,0,0,5,0,5
2021,Eritrea,ERI,Malta,MLT,0,0,5,0,5
2021,Ethiopia,ETH,Malta,MLT,0,0,5,5,10
2021,Gambia,GMB,Malta,MLT,0,0,64,0,64
2021,Palestinian,PSE,Malta,MLT,0,0,0,5,5
2021,Ghana,GHA,Malta,MLT,0,0,5,0,5
2021,Guinea,GIN,Malta,MLT,0,0,5,5,10
2021,Cote d'Ivoire,CIV,Malta,MLT,0,0,5,0,5
2021,Iraq,IRQ,Malta,MLT,0,0,5,0,5
2021,Libya,LBY,Malta,MLT,0,0,31,10,41
2021,Mali,MLI,Malta,MLT,0,0,0,5,5
2021,Morocco,MAR,Malta,MLT,0,0,13,5,18
2021,Nigeria,NGA,Malta,MLT,0,0,12,11,23
2021,Pakistan,PAK,Malta,MLT,0,0,5,5,10
2021,Senegal,SEN,Malta,MLT,0,0,10,0,10
2021,Sierra Leone,SLE,Malta,MLT,0,0,5,0,5
2021,Somalia,SOM,Malta,MLT,0,0,14,24,38
2021,Sudan,SDN,Malta,MLT,0,0,5,0,5
2021,Syrian Arab Rep.,SYR,Malta,MLT,0,0,10,30,40
2021,Ukraine,UKR,Malta,MLT,0,0,13,0,13
2021,Venezuela (Bolivarian Republic of),VEN,Malta,MLT,0,0,5,5,10
2021,Chad,TCD,Niger,NER,0,0,0,5,5
2021,Dem. Rep. of the Congo,COD,Niger,NER,0,0,0,5,5
2021,Liberia,LBR,Nigeria,NGA,0,0,5,0,5
2021,Afghanistan,AFG,Norway,NOR,10,0,49,10,69
2021,Albania,ALB,Norway,NOR,0,0,21,0,21
2021,Algeria,DZA,Norway,NOR,0,0,5,0,5
2021,Angola,AGO,Norway,NOR,0,0,0,5,5
2021,Bangladesh,BGD,Norway,NOR,0,0,0,5,5
2021,Belarus,BLR,Norway,NOR,0,0,0,5,5
2021,China,CHN,Norway,NOR,0,0,0,5,5
2021,Dem. Rep. of the Congo,COD,Norway,NOR,0,0,5,0,5
2021,Colombia,COL,Norway,NOR,0,0,16,0,16
2021,Cuba,CUB,Norway,NOR,0,0,5,0,5
2021,Eritrea,ERI,Norway,NOR,0,0,57,19,76
2021,Ethiopia,ETH,Norway,NOR,0,0,66,0,66
2021,United Kingdom of Great Britain and Northern Ireland,GBR,Norway,NOR,0,0,5,0,5
2021,Cote d'Ivoire,CIV,Norway,NOR,0,0,0,5,5
2021,Iran (Islamic Rep. of),IRN,Norway,NOR,29,0,97,5,131
2021,Iraq,IRQ,Norway,NOR,5,0,54,14,73
2021,Kenya,KEN,Norway,NOR,0,0,5,0,5
2021,Kyrgyzstan,KGZ,Norway,NOR,0,0,5,0,5
2021,Libya,LBY,Norway,NOR,0,0,0,5,5
2021,Sri Lanka,LKA,Norway,NOR,0,0,5,0,5
2021,Morocco,MAR,Norway,NOR,0,0,5,0,5
2021,Myanmar,MMR,Norway,NOR,5,0,0,0,5
2021,Nicaragua,NIC,Norway,NOR,5,0,5,0,10
2021,Nigeria,NGA,Norway,NOR,0,0,0,12,12
2021,Pakistan,PAK,Norway,NOR,0,0,14,0,14
2021,Peru,PER,Norway,NOR,0,0,5,0,5
2021,Poland,POL,Norway,NOR,0,0,5,0,5
2021,Russian Federation,RUS,Norway,NOR,0,0,19,10,29
2021,El Salvador,SLV,Norway,NOR,0,0,0,5,5
2021,Serbia and Kosovo: S/RES/1244 (1999),SRB,Norway,NOR,0,0,10,0,10
2021,Somalia,SOM,Norway,NOR,0,0,32,5,37
2021,Viet Nam,VNM,Norway,NOR,0,0,5,0,5
2021,Sudan,SDN,Norway,NOR,0,0,13,0,13
2021,Syrian Arab Rep.,SYR,Norway,NOR,5,0,5,32,42
2021,Turkey,TUR,Norway,NOR,10,0,13,5,28
2021,Uganda,UGA,Norway,NOR,0,0,5,0,5
2021,Ukraine,UKR,Norway,NOR,0,0,11,0,11
2021,Uzbekistan,UZB,Norway,NOR,0,0,5,0,5
2021,Venezuela (Bolivarian Republic of),VEN,Norway,NOR,0,0,12,0,12
2021,Stateless,XXA,Norway,NOR,0,0,20,15,35
2021,Algeria,DZA,South Africa,ZAF,0,0,18,5,23
2021,Egypt,EGY,South Africa,ZAF,0,0,22,16,38
2021,Burundi,BDI,South Africa,ZAF,31,0,140,362,533
2021,Benin,BEN,South Africa,ZAF,0,0,0,5,5
2021,Bangladesh,BGD,South Africa,ZAF,0,0,648,1443,2091
2021,Burkina Faso,BFA,South Africa,ZAF,0,0,5,0,5
2021,China,CHN,South Africa,ZAF,0,0,73,20,93
2021,Cameroon,CMR,South Africa,ZAF,0,0,152,205,357
2021,Congo,COG,South Africa,ZAF,18,0,44,146,208
2021,Dem. Rep. of the Congo,COD,South Africa,ZAF,62,0,737,1511,2310
2021,Eritrea,ERI,South Africa,ZAF,5,0,15,59,79
2021,Ethiopia,ETH,South Africa,ZAF,28,0,503,2670,3201
2021,Gabon,GAB,South Africa,ZAF,0,0,0,5,5
2021,Ghana,GHA,South Africa,ZAF,0,0,164,65,229
2021,Guinea,GIN,South Africa,ZAF,0,0,0,5,5
2021,Cote d'Ivoire,CIV,South Africa,ZAF,0,0,0,5,5
2021,India,IND,South Africa,ZAF,0,0,124,210,334
2021,Kenya,KEN,South Africa,ZAF,5,0,33,24,62
2021,Liberia,LBR,South Africa,ZAF,0,0,5,0,5
2021,Lesotho,LSO,South Africa,ZAF,0,0,5,0,5
2021,Mali,MLI,South Africa,ZAF,0,0,5,5,10
2021,Malawi,MWI,South Africa,ZAF,0,0,212,23,235
2021,Morocco,MAR,South Africa,ZAF,0,0,5,0,5
2021,Mozambique,MOZ,South Africa,ZAF,0,0,89,5,94
2021,Nepal,NPL,South Africa,ZAF,0,0,12,5,17
2021,Niger,NER,South Africa,ZAF,0,0,20,5,25
2021,Nigeria,NGA,South Africa,ZAF,0,0,465,171,636
2021,Pakistan,PAK,South Africa,ZAF,0,0,318,417,735
2021,Rwanda,RWA,South Africa,ZAF,0,0,17,29,46
2021,Senegal,SEN,South Africa,ZAF,0,0,51,47,98
2021,Sierra Leone,SLE,South Africa,ZAF,0,0,0,5,5
2021,Somalia,SOM,South Africa,ZAF,27,0,184,805,1016
2021,Sudan,SDN,South Africa,ZAF,0,0,0,5,5
2021,United Rep. of Tanzania,TZA,South Africa,ZAF,0,0,67,14,81
2021,Thailand,THA,South Africa,ZAF,0,0,5,10,15
2021,Uganda,UGA,South Africa,ZAF,0,0,187,162,349
2021,Zambia,ZMB,South Africa,ZAF,0,0,13,5,18
2021,Zimbabwe,ZWE,South Africa,ZAF,13,0,737,207,957
2021,Jordan,JOR,Serbia and Kosovo: S/RES/1244 (1999),SRB,0,0,5,0,5
2021,Eritrea,ERI,Sudan,SDN,0,0,0,10,10
2021,Ethiopia,ETH,Sudan,SDN,0,0,0,5,5
2021,Afghanistan,AFG,Sweden,SWE,70,5,467,114,656
2021,Albania,ALB,Sweden,SWE,0,0,154,23,177
2021,Algeria,DZA,Sweden,SWE,0,0,33,5,38
2021,Angola,AGO,Sweden,SWE,0,0,20,0,20
2021,Egypt,EGY,Sweden,SWE,0,10,184,29,223
2021,Armenia,ARM,Sweden,SWE,0,5,103,13,121
2021,Australia,AUS,Sweden,SWE,0,0,5,0,5
2021,Azerbaijan,AZE,Sweden,SWE,5,5,148,42,200
2021,Bahrain,BHR,Sweden,SWE,0,0,0,5,5
2021,Burundi,BDI,Sweden,SWE,5,0,41,5,51
2021,Bangladesh,BGD,Sweden,SWE,0,5,160,26,191
2021,Belarus,BLR,Sweden,SWE,0,5,66,5,76
2021,Bolivia (Plurinational State of),BOL,Sweden,SWE,0,0,10,0,10
2021,Brazil,BRA,Sweden,SWE,0,0,10,0,10
2021,Bosnia and Herzegovina,BIH,Sweden,SWE,0,0,35,5,40
2021,China,CHN,Sweden,SWE,0,0,16,10,26
2021,Chile,CHL,Sweden,SWE,0,0,21,5,26
2021,Cameroon,CMR,Sweden,SWE,5,0,116,10,131
2021,Congo,COG,Sweden,SWE,0,0,5,0,5
2021,Dem. Rep. of the Congo,COD,Sweden,SWE,0,0,54,5,59
2021,Colombia,COL,Sweden,SWE,0,0,90,5,95
2021,Cuba,CUB,Sweden,SWE,0,0,15,5,20
2021,Djibouti,DJI,Sweden,SWE,0,0,14,0,14
2021,Equatorial Guinea,GNQ,Sweden,SWE,0,0,10,0,10
2021,Eritrea,ERI,Sweden,SWE,5,0,132,24,161
2021,Ethiopia,ETH,Sweden,SWE,14,0,272,38,324
2021,Gabon,GAB,Sweden,SWE,0,0,5,0,5
2021,Gambia,GMB,Sweden,SWE,5,0,87,5,97
2021,Palestinian,PSE,Sweden,SWE,12,5,352,70,439
2021,Georgia,GEO,Sweden,SWE,0,0,272,29,301
2021,Germany,DEU,Sweden,SWE,0,0,5,0,5
2021,Ghana,GHA,Sweden,SWE,0,0,45,5,50
2021,Guatemala,GTM,Sweden,SWE,0,0,0,5,5
2021,Guinea,GIN,Sweden,SWE,0,0,11,5,16
2021,Honduras,HND,Sweden,SWE,0,0,14,0,14
2021,Cote d'Ivoire,CIV,Sweden,SWE,0,0,10,0,10
2021,India,IND,Sweden,SWE,0,0,48,10,58
2021,Iran (Islamic Rep. of),IRN,Sweden,SWE,219,5,693,160,1077
2021,Iraq,IRQ,Sweden,SWE,37,5,808,154,1004
2021,Israel,ISR,Sweden,SWE,0,0,10,0,10
2021,Jordan,JOR,Sweden,SWE,0,0,104,19,123
2021,Kazakhstan,KAZ,Sweden,SWE,0,0,148,10,158
2021,Kenya,KEN,Sweden,SWE,5,0,28,0,33
2021,Kyrgyzstan,KGZ,Sweden,SWE,0,0,132,10,142
2021,Rep. of Korea,KOR,Sweden,SWE,0,0,5,0,5
2021,Kuwait,KWT,Sweden,SWE,0,0,5,0,5
2021,Liberia,LBR,Sweden,SWE,0,0,10,0,10
2021,Libya,LBY,Sweden,SWE,0,5,35,10,50
2021,Lebanon,LBN,Sweden,SWE,0,5,138,29,172
2021,Sri Lanka,LKA,Sweden,SWE,0,0,33,0,33
2021,North Macedonia,MKD,Sweden,SWE,0,0,29,0,29
2021,Rep. of Moldova,MDA,Sweden,SWE,0,0,5,0,5
2021,Mexico,MEX,Sweden,SWE,0,0,5,0,5
2021,Malaysia,MYS,Sweden,SWE,0,0,5,0,5
2021,Mongolia,MNG,Sweden,SWE,0,0,319,25,344
2021,Morocco,MAR,Sweden,SWE,0,0,88,13,101
2021,Mozambique,MOZ,Sweden,SWE,0,0,5,0,5
2021,Montenegro,MNE,Sweden,SWE,0,0,5,0,5
2021,Myanmar,MMR,Sweden,SWE,0,0,10,0,10
2021,Namibia,NAM,Sweden,SWE,0,0,5,0,5
2021,Nepal,NPL,Sweden,SWE,0,0,11,5,16
2021,Niger,NER,Sweden,SWE,0,0,5,0,5
2021,Nicaragua,NIC,Sweden,SWE,0,0,66,5,71
2021,Nigeria,NGA,Sweden,SWE,5,0,244,27,276
2021,Pakistan,PAK,Sweden,SWE,10,0,210,57,277
2021,Peru,PER,Sweden,SWE,0,0,34,5,39
2021,Philippines,PHL,Sweden,SWE,0,0,14,0,14
2021,South Africa,ZAF,Sweden,SWE,0,0,0,5,5
2021,Russian Federation,RUS,Sweden,SWE,5,0,193,19,217
2021,Rwanda,RWA,Sweden,SWE,0,0,37,5,42
2021,El Salvador,SLV,Sweden,SWE,0,0,68,5,73
2021,Saudi Arabia,SAU,Sweden,SWE,0,0,5,0,5
2021,Serbia and Kosovo: S/RES/1244 (1999),SRB,Sweden,SWE,0,5,127,18,150
2021,Senegal,SEN,Sweden,SWE,0,0,19,0,19
2021,Sierra Leone,SLE,Sweden,SWE,0,0,11,0,11
2021,Somalia,SOM,Sweden,SWE,14,0,350,29,393
2021,Spain,ESP,Sweden,SWE,0,0,0,5,5
2021,Viet Nam,VNM,Sweden,SWE,0,0,22,0,22
2021,Sudan,SDN,Sweden,SWE,0,0,76,11,87
2021,Slovakia,SVK,Sweden,SWE,0,0,5,0,5
2021,Eswatini,SWZ,Sweden,SWE,0,0,5,0,5
2021,Syrian Arab Rep.,SYR,Sweden,SWE,87,10,274,73,444
2021,United Rep. of Tanzania,TZA,Sweden,SWE,5,0,26,5,36
2021,Thailand,THA,Sweden,SWE,0,0,12,0,12
2021,Tajikistan,TJK,Sweden,SWE,0,0,64,13,77
2021,Turkmenistan,TKM,Sweden,SWE,5,0,0,0,5
2021,Togo,TGO,Sweden,SWE,0,0,5,0,5
2021,Tunisia,TUN,Sweden,SWE,0,0,36,10,46
2021,Turkey,TUR,Sweden,SWE,29,0,170,92,291
2021,Uganda,UGA,Sweden,SWE,5,0,53,13,71
2021,Ukraine,UKR,Sweden,SWE,0,0,370,68,438
2021,United States of America,USA,Sweden,SWE,0,0,11,0,11
2021,Uzbekistan,UZB,Sweden,SWE,0,5,1023,170,1198
2021,Venezuela (Bolivarian Republic of),VEN,Sweden,SWE,5,0,66,10,81
2021,Yemen,YEM,Sweden,SWE,0,5,13,5,23
2021,Zimbabwe,ZWE,Sweden,SWE,0,0,11,0,11
2021,Stateless,XXA,Sweden,SWE,15,5,264,48,332
2021,Burundi,BDI,Uganda,UGA,36,0,18,0,54
2021,Dem. Rep. of the Congo,COD,Uganda,UGA,80,0,76,0,156
2021,Eritrea,ERI,Uganda,UGA,79,0,75,0,154
2021,Ethiopia,ETH,Uganda,UGA,12,0,0,0,12
2021,Rwanda,RWA,Uganda,UGA,43,0,73,0,116
2021,Afghanistan,AFG,United States of America,USA,13,0,0,10,23
2021,Albania,ALB,United States of America,USA,38,0,5,15,58
2021,Algeria,DZA,United States of America,USA,5,0,5,0,10
2021,Angola,AGO,United States of America,USA,25,0,10,5,40
2021,Egypt,EGY,United States of America,USA,90,0,19,54,163
2021,Argentina,ARG,United States of America,USA,0,0,0,10,10
2021,Armenia,ARM,United States of America,USA,22,0,10,21,53
2021,Azerbaijan,AZE,United States of America,USA,16,0,0,5,21
2021,Burundi,BDI,United States of America,USA,10,0,0,11,21
2021,Bangladesh,BGD,United States of America,USA,90,0,15,44,149
2021,Burkina Faso,BFA,United States of America,USA,33,0,18,31,82
2021,Belarus,BLR,United States of America,USA,48,0,0,19,67
2021,Bolivia (Plurinational State of),BOL,United States of America,USA,0,0,0,5,5
2021,Brazil,BRA,United States of America,USA,0,0,10,92,102
2021,Belize,BLZ,United States of America,USA,0,0,0,5,5
2021,China,CHN,United States of America,USA,939,0,191,694,1824
2021,Chile,CHL,United States of America,USA,0,0,0,5,5
2021,Cameroon,CMR,United States of America,USA,16,0,0,39,55
2021,Congo,COG,United States of America,USA,28,0,0,27,55
2021,Dem. Rep. of the Congo,COD,United States of America,USA,20,0,5,5,30
2021,Colombia,COL,United States of America,USA,27,0,68,133,228
2021,Costa Rica,CRI,United States of America,USA,0,0,0,19,19
2021,Cuba,CUB,United States of America,USA,0,0,0,5,5
2021,Djibouti,DJI,United States of America,USA,10,0,0,0,10
2021,Dominican Rep.,DOM,United States of America,USA,0,0,0,5,5
2021,Ecuador,ECU,United States of America,USA,0,0,30,555,585
2021,Eritrea,ERI,United States of America,USA,33,0,0,10,43
2021,Ethiopia,ETH,United States of America,USA,72,0,5,27,104
2021,Gambia,GMB,United States of America,USA,5,0,5,21,31
2021,Georgia,GEO,United States of America,USA,12,0,0,11,23
2021,Ghana,GHA,United States of America,USA,0,0,5,5,10
2021,Guatemala,GTM,United States of America,USA,27,0,106,541,674
2021,Guinea,GIN,United States of America,USA,15,0,10,13,38
2021,Guyana,GUY,United States of America,USA,0,0,0,10,10
2021,Haiti,HTI,United States of America,USA,10,0,10,93,113
2021,Honduras,HND,United States of America,USA,19,0,40,211,270
2021,Cote d'Ivoire,CIV,United States of America,USA,5,0,0,16,21
2021,India,IND,United States of America,USA,204,0,74,197,475
2021,Indonesia,IDN,United States of America,USA,11,0,11,46,68
2021,Iran (Islamic Rep. of),IRN,United States of America,USA,27,0,5,34,66
2021,Iraq,IRQ,United States of America,USA,86,0,12,42,140
2021,Israel,ISR,United States of America,USA,0,0,0,12,12
2021,Jamaica,JAM,United States of America,USA,0,0,0,13,13
2021,Jordan,JOR,United States of America,USA,11,0,5,31,47
2021,Kazakhstan,KAZ,United States of America,USA,33,0,5,16,54
2021,Kenya,KEN,United States of America,USA,10,0,10,44,64
2021,Kyrgyzstan,KGZ,United States of America,USA,17,0,11,26,54
2021,Kuwait,KWT,United States of America,USA,0,0,0,5,5
2021,Lao People's Dem. Rep.,LAO,United States of America,USA,0,0,0,5,5
2021,Liberia,LBR,United States of America,USA,5,0,5,59,69
2021,Libya,LBY,United States of America,USA,11,0,0,0,11
2021,Lebanon,LBN,United States of America,USA,15,0,5,11,31
2021,Sri Lanka,LKA,United States of America,USA,10,0,12,19,41
2021,Mauritania,MRT,United States of America,USA,11,0,5,18,34
2021,North Macedonia,MKD,United States of America,USA,0,0,0,5,5
2021,Rep. of Moldova,MDA,United States of America,USA,30,0,13,37,80
2021,Mexico,MEX,United States of America,USA,21,0,153,2443,2617
2021,Mali,MLI,United States of America,USA,5,0,0,16,21
2021,Malaysia,MYS,United States of America,USA,0,0,0,14,14
2021,Mongolia,MNG,United States of America,USA,13,0,0,20,33
2021,Montenegro,MNE,United States of America,USA,5,0,0,5,10
2021,Myanmar,MMR,United States of America,USA,24,0,5,5,34
2021,Nepal,NPL,United States of America,USA,107,0,17,81,205
2021,Niger,NER,United States of America,USA,5,0,0,0,5
2021,Nicaragua,NIC,United States of America,USA,12,0,10,15,37
2021,Nigeria,NGA,United States of America,USA,144,0,41,56,241
2021,Pakistan,PAK,United States of America,USA,41,0,10,68,119
2021,Paraguay,PRY,United States of America,USA,0,0,0,5,5
2021,Peru,PER,United States of America,USA,0,0,0,79,79
2021,Philippines,PHL,United States of America,USA,5,0,5,54,64
2021,Poland,POL,United States of America,USA,0,0,0,29,29
2021,Romania,ROU,United States of America,USA,0,0,0,17,17
2021,South Africa,ZAF,United States of America,USA,11,0,0,5,16
2021,Russian Federation,RUS,United States of America,USA,98,0,13,93,204
2021,Rwanda,RWA,United States of America,USA,25,0,11,5,41
2021,El Salvador,SLV,United States of America,USA,27,0,65,618,710
2021,Saudi Arabia,SAU,United States of America,USA,10,0,0,5,15
2021,Serbia and Kosovo: S/RES/1244 (1999),SRB,United States of America,USA,20,0,5,10,35
2021,Senegal,SEN,United States of America,USA,0,0,5,19,24
2021,Sierra Leone,SLE,United States of America,USA,0,0,0,14,14
2021,Viet Nam,VNM,United States of America,USA,0,0,0,5,5
2021,Sudan,SDN,United States of America,USA,11,0,0,10,21
2021,Slovakia,SVK,United States of America,USA,0,0,0,5,5
2021,Syrian Arab Rep.,SYR,United States of America,USA,42,0,0,49,91
2021,Thailand,THA,United States of America,USA,0,0,0,5,5
2021,Tajikistan,TJK,United States of America,USA,5,0,0,0,5
2021,Turkmenistan,TKM,United States of America,USA,0,0,0,5,5
2021,Togo,TGO,United States of America,USA,11,0,0,0,11
2021,Trinidad and Tobago,TTO,United States of America,USA,0,0,0,10,10
2021,Tunisia,TUN,United States of America,USA,0,0,0,5,5
2021,Turkey,TUR,United States of America,USA,14,0,10,10,34
2021,Uganda,UGA,United States of America,USA,26,0,0,10,36
2021,Ukraine,UKR,United States of America,USA,59,0,13,92,164
2021,Uzbekistan,UZB,United States of America,USA,20,0,0,31,51
2021,Venezuela (Bolivarian Republic of),VEN,United States of America,USA,261,0,98,494,853
2021,Yemen,YEM,United States of America,USA,5,0,0,19,24
2021,Zimbabwe,ZWE,United States of America,USA,0,0,5,16,21
2007,Afghanistan,AFG,Italy,ITA,5,10,0,20,35
2007,Albania,ALB,Italy,ITA,0,18,5,10,33
2007,Algeria,DZA,Italy,ITA,0,0,0,5,5
2007,Angola,AGO,Italy,ITA,0,5,0,0,5
2007,Egypt,EGY,Italy,ITA,0,5,0,0,5
2007,Armenia,ARM,Italy,ITA,0,0,5,0,5
2007,Azerbaijan,AZE,Italy,ITA,5,0,0,5,10
2007,Burundi,BDI,Italy,ITA,5,0,0,0,5
2007,Bangladesh,BGD,Italy,ITA,0,231,65,162,458
2007,Burkina Faso,BFA,Italy,ITA,0,5,0,0,5
2007,Belarus,BLR,Italy,ITA,0,11,0,5,16
2007,Bosnia and Herzegovina,BIH,Italy,ITA,0,13,0,0,13
2007,Central African Rep.,CAF,Italy,ITA,0,5,0,0,5
2007,China,CHN,Italy,ITA,0,11,0,16,27
2007,Cameroon,CMR,Italy,ITA,5,23,0,10,38
2007,Congo,COG,Italy,ITA,0,13,0,5,18
2007,Dem. Rep. of the Congo,COD,Italy,ITA,0,5,0,13,18
2007,Colombia,COL,Italy,ITA,0,18,5,21,44
2007,Cuba,CUB,Italy,ITA,0,0,0,5,5
2007,Ecuador,ECU,Italy,ITA,0,0,5,0,5
2007,Eritrea,ERI,Italy,ITA,19,117,5,386,527
2007,Ethiopia,ETH,Italy,ITA,10,60,0,70,140
2007,Gambia,GMB,Italy,ITA,0,5,0,25,30
2007,Palestinian,PSE,Italy,ITA,0,5,5,81,91
2007,Georgia,GEO,Italy,ITA,0,5,0,17,22
2007,Ghana,GHA,Italy,ITA,0,110,5,34,149
2007,Guinea,GIN,Italy,ITA,0,5,0,0,5
2007,Cote d'Ivoire,CIV,Italy,ITA,5,80,5,27,117
2007,India,IND,Italy,ITA,0,16,11,59,86
2007,Iran (Islamic Rep. of),IRN,Italy,ITA,5,10,0,21,36
2007,Iraq,IRQ,Italy,ITA,5,10,0,102,117
2007,Liberia,LBR,Italy,ITA,0,395,46,111,552
2007,Libya,LBY,Italy,ITA,0,0,0,5,5
2007,Lebanon,LBN,Italy,ITA,0,0,5,0,5
2007,Sri Lanka,LKA,Italy,ITA,0,51,0,166,217
2007,Mauritania,MRT,Italy,ITA,5,0,0,0,5
2007,North Macedonia,MKD,Italy,ITA,0,136,30,65,231
2007,Rep. of Moldova,MDA,Italy,ITA,0,40,10,20,70
2007,Mali,MLI,Italy,ITA,0,5,0,0,5
2007,Morocco,MAR,Italy,ITA,0,0,0,13,13
2007,Niger,NER,Italy,ITA,0,0,0,5,5
2007,Nigeria,NGA,Italy,ITA,0,318,156,307,781
2007,Pakistan,PAK,Italy,ITA,0,168,35,491,694
2007,Romania,ROU,Italy,ITA,0,0,0,5,5
2007,South Africa,ZAF,Italy,ITA,0,0,0,5,5
2007,Russian Federation,RUS,Italy,ITA,0,14,10,16,40
2007,Rwanda,RWA,Italy,ITA,0,0,0,5,5
2007,Serbia and Kosovo: S/RES/1244 (1999),SRB,Italy,ITA,5,1607,103,417,2132
2007,Senegal,SEN,Italy,ITA,0,11,0,14,25
2007,Sierra Leone,SLE,Italy,ITA,0,54,23,43,120
2007,Somalia,SOM,Italy,ITA,5,28,0,461,494
2007,Viet Nam,VNM,Italy,ITA,0,5,0,0,5
2007,Sudan,SDN,Italy,ITA,13,175,16,141,345
2007,Syrian Arab Rep.,SYR,Italy,ITA,5,0,0,0,5
2007,Togo,TGO,Italy,ITA,5,25,0,5,35
2007,Tunisia,TUN,Italy,ITA,0,0,0,5,5
2007,Turkey,TUR,Italy,ITA,5,156,15,66,242
2007,Ukraine,UKR,Italy,ITA,0,33,5,42,80
2007,Uruguay,URY,Italy,ITA,0,0,0,5,5
2007,Zimbabwe,ZWE,Italy,ITA,0,5,0,0,5
2001,Afghanistan,AFG,Switzerland,CHE,0,41,0,0,41
2001,Albania,ALB,Switzerland,CHE,0,15,0,0,15
2001,Algeria,DZA,Switzerland,CHE,0,61,0,0,61
2001,Angola,AGO,Switzerland,CHE,0,194,0,0,194
2001,Armenia,ARM,Switzerland,CHE,0,12,0,0,12
2001,Bangladesh,BGD,Switzerland,CHE,0,30,0,0,30
2001,Bosnia and Herzegovina,BIH,Switzerland,CHE,0,549,0,0,549
2001,Dem. Rep. of the Congo,COD,Switzerland,CHE,0,133,0,0,133
2001,Colombia,COL,Switzerland,CHE,0,15,0,0,15
2001,Eritrea,ERI,Switzerland,CHE,0,111,0,0,111
2001,Ethiopia,ETH,Switzerland,CHE,0,92,0,0,92
2001,Guinea,GIN,Switzerland,CHE,0,5,0,0,5
2001,India,IND,Switzerland,CHE,0,18,0,0,18
2001,Iran (Islamic Rep. of),IRN,Switzerland,CHE,0,55,0,0,55
2001,Iraq,IRQ,Switzerland,CHE,0,30,0,0,30
2001,Lebanon,LBN,Switzerland,CHE,0,20,0,0,20
2001,Sri Lanka,LKA,Switzerland,CHE,0,6457,0,0,6457
2001,Pakistan,PAK,Switzerland,CHE,0,20,0,0,20
2001,Russian Federation,RUS,Switzerland,CHE,0,11,0,0,11
2001,Serbia and Kosovo: S/RES/1244 (1999),SRB,Switzerland,CHE,0,2262,0,0,2262
2001,Sierra Leone,SLE,Switzerland,CHE,0,5,0,0,5
2001,Somalia,SOM,Switzerland,CHE,0,164,0,0,164
2001,Syrian Arab Rep.,SYR,Switzerland,CHE,0,15,0,0,15
2001,Turkey,TUR,Switzerland,CHE,0,395,0,0,395
2002,Afghanistan,AFG,Switzerland,CHE,0,45,0,0,45
2002,Albania,ALB,Switzerland,CHE,0,10,0,0,10
2002,Algeria,DZA,Switzerland,CHE,0,56,0,0,56
2002,Angola,AGO,Switzerland,CHE,0,192,0,0,192
2002,Bangladesh,BGD,Switzerland,CHE,0,43,0,0,43
2002,Bosnia and Herzegovina,BIH,Switzerland,CHE,0,629,0,0,629
2002,Dem. Rep. of the Congo,COD,Switzerland,CHE,0,163,0,0,163
2002,Colombia,COL,Switzerland,CHE,0,5,0,0,5
2002,Eritrea,ERI,Switzerland,CHE,0,115,0,0,115
2002,Ethiopia,ETH,Switzerland,CHE,0,79,0,0,79
2002,Georgia,GEO,Switzerland,CHE,0,5,0,0,5
2002,Guinea,GIN,Switzerland,CHE,0,5,0,0,5
2002,India,IND,Switzerland,CHE,0,17,0,0,17
2002,Iran (Islamic Rep. of),IRN,Switzerland,CHE,0,78,0,0,78
2002,Iraq,IRQ,Switzerland,CHE,0,82,0,0,82
2002,Lebanon,LBN,Switzerland,CHE,0,14,0,0,14
2002,Sri Lanka,LKA,Switzerland,CHE,0,4157,0,0,4157
2002,Pakistan,PAK,Switzerland,CHE,0,37,0,0,37
2002,Russian Federation,RUS,Switzerland,CHE,0,10,0,0,10
2002,Serbia and Kosovo: S/RES/1244 (1999),SRB,Switzerland,CHE,0,1999,0,0,1999
2002,Sierra Leone,SLE,Switzerland,CHE,0,10,0,0,10
2002,Somalia,SOM,Switzerland,CHE,0,262,0,0,262
2002,Syrian Arab Rep.,SYR,Switzerland,CHE,0,27,0,0,27
2002,Turkey,TUR,Switzerland,CHE,0,346,0,0,346
2003,Afghanistan,AFG,Switzerland,CHE,0,42,0,0,42
2003,Albania,ALB,Switzerland,CHE,0,11,0,0,11
2003,Algeria,DZA,Switzerland,CHE,0,63,0,0,63
2003,Angola,AGO,Switzerland,CHE,0,294,0,0,294
2003,Armenia,ARM,Switzerland,CHE,0,13,0,0,13
2003,Bangladesh,BGD,Switzerland,CHE,0,99,0,0,99
2003,Bosnia and Herzegovina,BIH,Switzerland,CHE,0,514,0,0,514
2003,Dem. Rep. of the Congo,COD,Switzerland,CHE,0,142,0,0,142
2003,Colombia,COL,Switzerland,CHE,0,13,0,0,13
2003,Eritrea,ERI,Switzerland,CHE,0,46,0,0,46
2003,Ethiopia,ETH,Switzerland,CHE,0,71,0,0,71
2003,Guinea,GIN,Switzerland,CHE,0,20,0,0,20
2003,India,IND,Switzerland,CHE,0,5,0,0,5
2003,Iran (Islamic Rep. of),IRN,Switzerland,CHE,0,59,0,0,59
2003,Iraq,IRQ,Switzerland,CHE,0,72,0,0,72
2003,Lebanon,LBN,Switzerland,CHE,0,20,0,0,20
2003,Sri Lanka,LKA,Switzerland,CHE,0,1655,0,0,1655
2003,Pakistan,PAK,Switzerland,CHE,0,37,0,0,37
2003,Russian Federation,RUS,Switzerland,CHE,0,10,0,0,10
2003,Serbia and Kosovo: S/RES/1244 (1999),SRB,Switzerland,CHE,0,1629,0,0,1629
2003,Sierra Leone,SLE,Switzerland,CHE,0,10,0,0,10
2003,Somalia,SOM,Switzerland,CHE,0,223,0,0,223
2003,Syrian Arab Rep.,SYR,Switzerland,CHE,0,23,0,0,23
2003,Turkey,TUR,Switzerland,CHE,0,308,0,0,308
2004,Afghanistan,AFG,Switzerland,CHE,0,83,0,0,83
2004,Albania,ALB,Switzerland,CHE,0,16,0,0,16
2004,Algeria,DZA,Switzerland,CHE,0,52,0,0,52
2004,Angola,AGO,Switzerland,CHE,0,254,0,0,254
2004,Armenia,ARM,Switzerland,CHE,0,12,0,0,12
2004,Azerbaijan,AZE,Switzerland,CHE,0,5,0,0,5
2004,Burundi,BDI,Switzerland,CHE,0,15,0,0,15
2004,Benin,BEN,Switzerland,CHE,0,5,0,0,5
2004,Bangladesh,BGD,Switzerland,CHE,0,117,0,0,117
2004,Burkina Faso,BFA,Switzerland,CHE,0,14,0,0,14
2004,Bosnia and Herzegovina,BIH,Switzerland,CHE,0,545,0,0,545
2004,Chad,TCD,Switzerland,CHE,0,5,0,0,5
2004,Cameroon,CMR,Switzerland,CHE,0,59,0,0,59
2004,Congo,COG,Switzerland,CHE,0,5,0,0,5
2004,Dem. Rep. of the Congo,COD,Switzerland,CHE,0,145,0,0,145
2004,Colombia,COL,Switzerland,CHE,0,5,0,0,5
2004,Cuba,CUB,Switzerland,CHE,0,5,0,0,5
2004,Ecuador,ECU,Switzerland,CHE,0,5,0,0,5
2004,Eritrea,ERI,Switzerland,CHE,0,22,0,0,22
2004,Ethiopia,ETH,Switzerland,CHE,0,70,0,0,70
2004,Gambia,GMB,Switzerland,CHE,0,5,0,0,5
2004,Georgia,GEO,Switzerland,CHE,0,5,0,0,5
2004,Ghana,GHA,Switzerland,CHE,0,5,0,0,5
2004,Guinea,GIN,Switzerland,CHE,0,34,0,0,34
2004,Croatia,HRV,Switzerland,CHE,0,14,0,0,14
2004,Cote d'Ivoire,CIV,Switzerland,CHE,0,21,0,0,21
2004,India,IND,Switzerland,CHE,0,5,0,0,5
2004,Iran (Islamic Rep. of),IRN,Switzerland,CHE,0,41,0,0,41
2004,Iraq,IRQ,Switzerland,CHE,0,93,0,0,93
2004,Jordan,JOR,Switzerland,CHE,0,5,0,0,5
2004,Kyrgyzstan,KGZ,Switzerland,CHE,0,5,0,0,5
2004,Kuwait,KWT,Switzerland,CHE,0,5,0,0,5
2004,Lao People's Dem. Rep.,LAO,Switzerland,CHE,0,5,0,0,5
2004,Liberia,LBR,Switzerland,CHE,0,5,0,0,5
2004,Libya,LBY,Switzerland,CHE,0,5,0,0,5
2004,Lebanon,LBN,Switzerland,CHE,0,34,0,0,34
2004,Sri Lanka,LKA,Switzerland,CHE,0,815,0,0,815
2004,North Macedonia,MKD,Switzerland,CHE,0,35,0,0,35
2004,Rep. of Moldova,MDA,Switzerland,CHE,0,5,0,0,5
2004,Nigeria,NGA,Switzerland,CHE,0,89,0,0,89
2004,Pakistan,PAK,Switzerland,CHE,0,62,0,0,62
2004,Russian Federation,RUS,Switzerland,CHE,0,34,0,0,34
2004,Rwanda,RWA,Switzerland,CHE,0,16,0,0,16
2004,Serbia and Kosovo: S/RES/1244 (1999),SRB,Switzerland,CHE,0,1300,0,0,1300
2004,Senegal,SEN,Switzerland,CHE,0,5,0,0,5
2004,Sierra Leone,SLE,Switzerland,CHE,0,5,0,0,5
2004,Somalia,SOM,Switzerland,CHE,0,250,0,0,250
2004,Viet Nam,VNM,Switzerland,CHE,0,10,0,0,10
2004,Sudan,SDN,Switzerland,CHE,0,22,0,0,22
2004,Syrian Arab Rep.,SYR,Switzerland,CHE,0,29,0,0,29
2004,Togo,TGO,Switzerland,CHE,0,25,0,0,25
2004,Tunisia,TUN,Switzerland,CHE,0,16,0,0,16
2004,Turkey,TUR,Switzerland,CHE,0,300,0,0,300
2004,Yemen,YEM,Switzerland,CHE,0,5,0,0,5
2004,Stateless,XXA,Switzerland,CHE,0,24,0,0,24
2001,Afghanistan,AFG,United States of America,USA,129,0,27,91,247
2001,Albania,ALB,United States of America,USA,498,0,520,405,1423
2001,Algeria,DZA,United States of America,USA,26,0,24,22,72
2001,Angola,AGO,United States of America,USA,10,0,11,21,42
2001,Egypt,EGY,United States of America,USA,193,0,76,123,392
2001,Argentina,ARG,United States of America,USA,5,0,14,47,66
2001,Armenia,ARM,United States of America,USA,203,0,241,435,879
2001,Australia,AUS,United States of America,USA,0,0,0,5,5
2001,Azerbaijan,AZE,United States of America,USA,31,0,31,116,178
2001,Bahrain,BHR,United States of America,USA,5,0,0,5,10
2001,Burundi,BDI,United States of America,USA,11,0,21,28,60
2001,Belgium,BEL,United States of America,USA,0,0,5,5,10
2001,Benin,BEN,United States of America,USA,5,0,0,0,5
2001,Bangladesh,BGD,United States of America,USA,121,0,194,226,541
2001,Bahamas,BHS,United States of America,USA,0,0,5,5,10
2001,Bhutan,BTN,United States of America,USA,0,0,0,5,5
2001,Burkina Faso,BFA,United States of America,USA,11,0,0,0,11
2001,Belarus,BLR,United States of America,USA,19,0,14,24,57
2001,Bolivia (Plurinational State of),BOL,United States of America,USA,10,0,5,21,36
2001,Brazil,BRA,United States of America,USA,10,0,37,203,250
2001,Bosnia and Herzegovina,BIH,United States of America,USA,5,0,5,18,28
2001,Bulgaria,BGR,United States of America,USA,60,0,57,94,211
2001,Belize,BLZ,United States of America,USA,0,0,0,10,10
2001,Cambodia,KHM,United States of America,USA,21,0,34,72,127
2001,Canada,CAN,United States of America,USA,0,0,5,5,10
2001,Central African Rep.,CAF,United States of America,USA,5,0,0,0,5
2001,Chad,TCD,United States of America,USA,0,0,14,0,14
2001,China,CHN,United States of America,USA,661,0,3403,2004,6068
2001,Chile,CHL,United States of America,USA,10,0,10,11,31
2001,Cameroon,CMR,United States of America,USA,129,0,113,53,295
2001,Congo,COG,United States of America,USA,124,0,96,113,333
2001,Dem. Rep. of the Congo,COD,United States of America,USA,30,0,19,22,71
2001,Colombia,COL,United States of America,USA,379,0,618,570,1567
2001,Costa Rica,CRI,United States of America,USA,0,0,0,12,12
2001,Cuba,CUB,United States of America,USA,73,0,149,819,1041
2001,Cabo Verde,CPV,United States of America,USA,0,0,0,5,5
2001,Czechia,CZE,United States of America,USA,5,0,11,13,29
2001,Dominica,DMA,United States of America,USA,0,0,0,5,5
2001,Dominican Rep.,DOM,United States of America,USA,5,0,23,34,62
2001,Ecuador,ECU,United States of America,USA,5,0,29,69,103
2001,Eritrea,ERI,United States of America,USA,59,0,50,32,141
2001,Estonia,EST,United States of America,USA,11,0,10,10,31
2001,Ethiopia,ETH,United States of America,USA,215,0,214,172,601
2001,Fiji,FJI,United States of America,USA,115,0,25,67,207
2001,Finland,FIN,United States of America,USA,0,0,0,5,5
2001,France,FRA,United States of America,USA,5,0,0,14,19
2001,Gabon,GAB,United States of America,USA,0,0,5,0,5
2001,Gambia,GMB,United States of America,USA,17,0,25,40,82
2001,United Kingdom of Great Britain and Northern Ireland,GBR,United States of America,USA,13,0,11,22,46
2001,Georgia,GEO,United States of America,USA,55,0,46,64,165
2001,Germany,DEU,United States of America,USA,10,0,10,18,38
2001,Ghana,GHA,United States of America,USA,17,0,75,80,172
2001,Guinea-Bissau,GNB,United States of America,USA,0,0,0,5,5
2001,Guatemala,GTM,United States of America,USA,135,0,749,1373,2257
2001,Guinea,GIN,United States of America,USA,63,0,97,95,255
2001,Guyana,GUY,United States of America,USA,10,0,19,39,68
2001,Haiti,HTI,United States of America,USA,357,0,2547,1135,4039
2001,"China, Hong Kong SAR",HKG,United States of America,USA,0,0,5,5,10
2001,Honduras,HND,United States of America,USA,22,0,119,347,488
2001,Croatia,HRV,United States of America,USA,10,0,5,14,29
2001,Hungary,HUN,United States of America,USA,0,0,0,12,12
2001,Cote d'Ivoire,CIV,United States of America,USA,10,0,29,36,75
2001,India,IND,United States of America,USA,495,0,503,708,1706
2001,Indonesia,IDN,United States of America,USA,176,0,170,230,576
2001,Iran (Islamic Rep. of),IRN,United States of America,USA,228,0,182,306,716
2001,Iraq,IRQ,United States of America,USA,186,0,69,97,352
2001,Israel,ISR,United States of America,USA,5,0,13,29,47
2001,Italy,ITA,United States of America,USA,0,0,0,5,5
2001,Jamaica,JAM,United States of America,USA,5,0,36,79,120
2001,Jordan,JOR,United States of America,USA,18,0,53,65,136
2001,Kazakhstan,KAZ,United States of America,USA,21,0,25,26,72
2001,Kenya,KEN,United States of America,USA,42,0,37,30,109
2001,Kyrgyzstan,KGZ,United States of America,USA,10,0,0,5,15
2001,Rep. of Korea,KOR,United States of America,USA,0,0,0,14,14
2001,Kuwait,KWT,United States of America,USA,5,0,11,5,21
2001,Lao People's Dem. Rep.,LAO,United States of America,USA,11,0,50,111,172
2001,Liberia,LBR,United States of America,USA,129,0,84,253,466
2001,Libya,LBY,United States of America,USA,5,0,5,0,10
2001,Saint Lucia,LCA,United States of America,USA,0,0,0,10,10
2001,Lebanon,LBN,United States of America,USA,55,0,49,74,178
2001,Sri Lanka,LKA,United States of America,USA,214,0,88,145,447
2001,Lithuania,LTU,United States of America,USA,5,0,12,14,31
2001,Latvia,LVA,United States of America,USA,5,0,10,14,29
2001,Mauritania,MRT,United States of America,USA,88,0,215,167,470
2001,North Macedonia,MKD,United States of America,USA,15,0,48,41,104
2001,Rep. of Moldova,MDA,United States of America,USA,10,0,11,11,32
2001,Mexico,MEX,United States of America,USA,45,0,446,4028,4519
2001,Mali,MLI,United States of America,USA,5,0,10,17,32
2001,Malaysia,MYS,United States of America,USA,5,0,5,14,24
2001,Mongolia,MNG,United States of America,USA,0,0,0,5,5
2001,Morocco,MAR,United States of America,USA,0,0,15,10,25
2001,Myanmar,MMR,United States of America,USA,120,0,25,93,238
2001,Nepal,NPL,United States of America,USA,31,0,22,19,72
2001,Netherlands,NLD,United States of America,USA,0,0,0,5,5
2001,Niger,NER,United States of America,USA,0,0,0,14,14
2001,Nicaragua,NIC,United States of America,USA,10,0,72,89,171
2001,Nigeria,NGA,United States of America,USA,72,0,180,193,445
2001,Oman,OMN,United States of America,USA,5,0,0,0,5
2001,Pakistan,PAK,United States of America,USA,154,0,271,304,729
2001,Panama,PAN,United States of America,USA,5,0,5,21,31
2001,Paraguay,PRY,United States of America,USA,0,0,0,5,5
2001,Peru,PER,United States of America,USA,128,0,143,244,515
2001,Philippines,PHL,United States of America,USA,37,0,89,268,394
2001,Poland,POL,United States of America,USA,5,0,13,54,72
2001,Portugal,PRT,United States of America,USA,0,0,0,10,10
2001,Romania,ROU,United States of America,USA,58,0,52,120,230
2001,South Africa,ZAF,United States of America,USA,5,0,17,10,32
2001,Russian Federation,RUS,United States of America,USA,349,0,221,442,1012
2001,Rwanda,RWA,United States of America,USA,24,0,13,16,53
2001,El Salvador,SLV,United States of America,USA,86,0,500,2435,3021
2001,Saudi Arabia,SAU,United States of America,USA,0,0,14,0,14
2001,Serbia and Kosovo: S/RES/1244 (1999),SRB,United States of America,USA,186,0,233,306,725
2001,Senegal,SEN,United States of America,USA,10,0,27,32,69
2001,Seychelles,SYC,United States of America,USA,10,0,13,5,28
2001,Singapore,SGP,United States of America,USA,0,0,5,0,5
2001,Sierra Leone,SLE,United States of America,USA,89,0,104,172,365
2001,Somalia,SOM,United States of America,USA,349,0,377,469,1195
2001,Spain,ESP,United States of America,USA,0,0,5,5,10
2001,Viet Nam,VNM,United States of America,USA,15,0,85,161,261
2001,Saint Kitts and Nevis,KNA,United States of America,USA,0,0,0,5,5
2001,Sudan,SDN,United States of America,USA,77,0,71,85,233
2001,Suriname,SUR,United States of America,USA,5,0,5,13,23
2001,Slovakia,SVK,United States of America,USA,0,0,0,12,12
2001,Slovenia,SVN,United States of America,USA,0,0,0,5,5
2001,Sweden,SWE,United States of America,USA,0,0,5,0,5
2001,Syrian Arab Rep.,SYR,United States of America,USA,17,0,28,40,85
2001,United Rep. of Tanzania,TZA,United States of America,USA,0,0,5,13,18
2001,Thailand,THA,United States of America,USA,0,0,10,30,40
2001,Tajikistan,TJK,United States of America,USA,0,0,0,5,5
2001,Turkmenistan,TKM,United States of America,USA,5,0,0,0,5
2001,Togo,TGO,United States of America,USA,28,0,22,17,67
2001,Trinidad and Tobago,TTO,United States of America,USA,0,0,5,20,25
2001,Tunisia,TUN,United States of America,USA,0,0,5,5,10
2001,Turkey,TUR,United States of America,USA,17,0,22,36,75
2001,Uganda,UGA,United States of America,USA,50,0,47,44,141
2001,Ukraine,UKR,United States of America,USA,86,0,90,125,301
2001,Uzbekistan,UZB,United States of America,USA,29,0,20,28,77
2001,Venezuela (Bolivarian Republic of),VEN,United States of America,USA,5,0,10,29,44
2001,Yemen,YEM,United States of America,USA,19,0,35,26,80
2001,Zambia,ZMB,United States of America,USA,0,0,5,5,10
2001,Zimbabwe,ZWE,United States of America,USA,0,0,5,15,20
2001,Stateless,XXA,United States of America,USA,15,0,15,35,65
2002,Afghanistan,AFG,United States of America,USA,74,0,57,85,216
2002,Albania,ALB,United States of America,USA,515,0,807,468,1790
2002,Algeria,DZA,United States of America,USA,15,0,30,29,74
2002,Andorra,AND,United States of America,USA,0,0,5,0,5
2002,Angola,AGO,United States of America,USA,5,0,23,13,41
2002,Egypt,EGY,United States of America,USA,228,0,138,166,532
2002,Argentina,ARG,United States of America,USA,13,0,25,73,111
2002,Armenia,ARM,United States of America,USA,322,0,437,579,1338
2002,Australia,AUS,United States of America,USA,0,0,5,0,5
2002,Austria,AUT,United States of America,USA,0,0,0,5,5
2002,Azerbaijan,AZE,United States of America,USA,38,0,36,168,242
2002,Bahrain,BHR,United States of America,USA,0,0,0,5,5
2002,Burundi,BDI,United States of America,USA,10,0,18,19,47
2002,Belgium,BEL,United States of America,USA,0,0,0,5,5
2002,Benin,BEN,United States of America,USA,5,0,0,5,10
2002,Bermuda,BMU,United States of America,USA,0,0,0,5,5
2002,Bangladesh,BGD,United States of America,USA,104,0,134,173,411
2002,Bahamas,BHS,United States of America,USA,0,0,5,11,16
2002,Bhutan,BTN,United States of America,USA,0,0,0,13,13
2002,Burkina Faso,BFA,United States of America,USA,0,0,5,5,10
2002,Belarus,BLR,United States of America,USA,17,0,18,40,75
2002,Bolivia (Plurinational State of),BOL,United States of America,USA,0,0,10,25,35
2002,Brazil,BRA,United States of America,USA,10,0,42,77,129
2002,Bosnia and Herzegovina,BIH,United States of America,USA,23,0,10,20,53
2002,Bulgaria,BGR,United States of America,USA,47,0,76,84,207
2002,Belize,BLZ,United States of America,USA,0,0,0,14,14
2002,Cambodia,KHM,United States of America,USA,10,0,41,52,103
2002,Canada,CAN,United States of America,USA,0,0,0,11,11
2002,Central African Rep.,CAF,United States of America,USA,5,0,0,5,10
2002,Chad,TCD,United States of America,USA,0,0,11,0,11
2002,China,CHN,United States of America,USA,808,0,4239,2688,7735
2002,Chile,CHL,United States of America,USA,0,0,10,11,21
2002,Cameroon,CMR,United States of America,USA,116,0,152,92,360
2002,Congo,COG,United States of America,USA,129,0,125,119,373
2002,Dem. Rep. of the Congo,COD,United States of America,USA,36,0,40,32,108
2002,Colombia,COL,United States of America,USA,1019,0,1723,1173,3915
2002,Costa Rica,CRI,United States of America,USA,0,0,0,11,11
2002,Cuba,CUB,United States of America,USA,23,0,140,666,829
2002,Cabo Verde,CPV,United States of America,USA,0,0,0,10,10
2002,Czechia,CZE,United States of America,USA,5,0,10,11,26
2002,Djibouti,DJI,United States of America,USA,0,0,0,10,10
2002,Dominican Rep.,DOM,United States of America,USA,5,0,25,39,69
2002,Ecuador,ECU,United States of America,USA,0,0,30,63,93
2002,Equatorial Guinea,GNQ,United States of America,USA,0,0,0,5,5
2002,Eritrea,ERI,United States of America,USA,42,0,89,43,174
2002,Estonia,EST,United States of America,USA,5,0,10,17,32
2002,Ethiopia,ETH,United States of America,USA,232,0,339,216,787
2002,Fiji,FJI,United States of America,USA,89,0,93,85,267
2002,Finland,FIN,United States of America,USA,0,0,0,5,5
2002,France,FRA,United States of America,USA,0,0,12,5,17
2002,Gabon,GAB,United States of America,USA,0,0,0,5,5
2002,Gambia,GMB,United States of America,USA,18,0,25,27,70
2002,Palestinian,PSE,United States of America,USA,0,0,13,0,13
2002,United Kingdom of Great Britain and Northern Ireland,GBR,United States of America,USA,14,0,15,25,54
2002,Georgia,GEO,United States of America,USA,66,0,60,61,187
2002,Germany,DEU,United States of America,USA,0,0,13,12,25
2002,Ghana,GHA,United States of America,USA,10,0,44,52,106
2002,Guinea-Bissau,GNB,United States of America,USA,0,0,0,5,5
2002,Greece,GRC,United States of America,USA,0,0,5,13,18
2002,Grenada,GRD,United States of America,USA,0,0,0,5,5
2002,Guatemala,GTM,United States of America,USA,113,0,727,1156,1996
2002,Guinea,GIN,United States of America,USA,94,0,144,174,412
2002,Guyana,GUY,United States of America,USA,5,0,22,47,74
2002,Haiti,HTI,United States of America,USA,479,0,2408,985,3872
2002,"China, Hong Kong SAR",HKG,United States of America,USA,5,0,0,5,10
2002,Honduras,HND,United States of America,USA,16,0,137,271,424
2002,Croatia,HRV,United States of America,USA,5,0,10,12,27
2002,Hungary,HUN,United States of America,USA,0,0,12,0,12
2002,Cote d'Ivoire,CIV,United States of America,USA,13,0,34,41,88
2002,India,IND,United States of America,USA,493,0,556,749,1798
2002,Indonesia,IDN,United States of America,USA,283,0,546,444,1273
2002,Iran (Islamic Rep. of),IRN,United States of America,USA,210,0,191,325,726
2002,Iraq,IRQ,United States of America,USA,280,0,135,115,530
2002,Israel,ISR,United States of America,USA,5,0,16,36,57
2002,Italy,ITA,United States of America,USA,0,0,0,13,13
2002,Jamaica,JAM,United States of America,USA,5,0,46,83,134
2002,Jordan,JOR,United States of America,USA,14,0,57,76,147
2002,Japan,JPN,United States of America,USA,0,0,0,12,12
2002,Kazakhstan,KAZ,United States of America,USA,28,0,30,39,97
2002,Kenya,KEN,United States of America,USA,30,0,35,40,105
2002,Kyrgyzstan,KGZ,United States of America,USA,5,0,13,16,34
2002,Rep. of Korea,KOR,United States of America,USA,0,0,5,24,29
2002,Dem. People's Rep. of Korea,PRK,United States of America,USA,5,0,0,0,5
2002,Kuwait,KWT,United States of America,USA,5,0,10,5,20
2002,Lao People's Dem. Rep.,LAO,United States of America,USA,12,0,38,105,155
2002,Liberia,LBR,United States of America,USA,141,0,92,333,566
2002,Libya,LBY,United States of America,USA,5,0,0,5,10
2002,Lebanon,LBN,United States of America,USA,53,0,80,80,213
2002,Sri Lanka,LKA,United States of America,USA,140,0,134,183,457
2002,Lithuania,LTU,United States of America,USA,0,0,16,14,30
2002,Latvia,LVA,United States of America,USA,5,0,22,13,40
2002,Madagascar,MDG,United States of America,USA,5,0,0,0,5
2002,Mauritania,MRT,United States of America,USA,118,0,183,221,522
2002,North Macedonia,MKD,United States of America,USA,18,0,41,34,93
2002,Rep. of Moldova,MDA,United States of America,USA,10,0,5,15,30
2002,Mexico,MEX,United States of America,USA,37,0,546,6814,7397
2002,Mali,MLI,United States of America,USA,5,0,5,20,30
2002,Malaysia,MYS,United States of America,USA,0,0,5,13,18
2002,Malawi,MWI,United States of America,USA,5,0,0,0,5
2002,Mongolia,MNG,United States of America,USA,0,0,5,5,10
2002,Morocco,MAR,United States of America,USA,0,0,5,13,18
2002,Myanmar,MMR,United States of America,USA,126,0,39,68,233
2002,Nepal,NPL,United States of America,USA,37,0,24,25,86
2002,Niger,NER,United States of America,USA,5,0,24,5,34
2002,Nicaragua,NIC,United States of America,USA,5,0,66,66,137
2002,Nigeria,NGA,United States of America,USA,43,0,178,176,397
2002,Niue,NIU,United States of America,USA,5,0,0,0,5
2002,Pakistan,PAK,United States of America,USA,180,0,237,355,772
2002,Panama,PAN,United States of America,USA,0,0,5,5,10
2002,Paraguay,PRY,United States of America,USA,0,0,5,5,10
2002,Peru,PER,United States of America,USA,88,0,107,218,413
2002,Philippines,PHL,United States of America,USA,22,0,78,238,338
2002,Poland,POL,United States of America,USA,10,0,55,45,110
2002,Portugal,PRT,United States of America,USA,0,0,0,5,5
2002,Romania,ROU,United States of America,USA,49,0,66,93,208
2002,South Africa,ZAF,United States of America,USA,16,0,13,14,43
2002,Russian Federation,RUS,United States of America,USA,314,0,203,440,957
2002,Rwanda,RWA,United States of America,USA,17,0,19,23,59
2002,El Salvador,SLV,United States of America,USA,41,0,288,2340,2669
2002,Saudi Arabia,SAU,United States of America,USA,0,0,13,0,13
2002,Serbia and Kosovo: S/RES/1244 (1999),SRB,United States of America,USA,176,0,316,269,761
2002,Senegal,SEN,United States of America,USA,5,0,21,18,44
2002,Seychelles,SYC,United States of America,USA,13,0,10,0,23
2002,Singapore,SGP,United States of America,USA,5,0,5,0,10
2002,Sierra Leone,SLE,United States of America,USA,110,0,155,171,436
2002,Somalia,SOM,United States of America,USA,236,0,248,472,956
2002,Spain,ESP,United States of America,USA,0,0,5,0,5
2002,Viet Nam,VNM,United States of America,USA,10,0,76,116,202
2002,Sudan,SDN,United States of America,USA,86,0,95,118,299
2002,Suriname,SUR,United States of America,USA,0,0,5,11,16
2002,Slovakia,SVK,United States of America,USA,0,0,5,16,21
2002,Slovenia,SVN,United States of America,USA,0,0,5,0,5
2002,Switzerland,CHE,United States of America,USA,0,0,5,0,5
2002,Syrian Arab Rep.,SYR,United States of America,USA,10,0,27,61,98
2002,United Rep. of Tanzania,TZA,United States of America,USA,5,0,11,12,28
2002,Thailand,THA,United States of America,USA,0,0,12,20,32
2002,Tajikistan,TJK,United States of America,USA,0,0,5,5,10
2002,Turkmenistan,TKM,United States of America,USA,5,0,5,0,10
2002,Togo,TGO,United States of America,USA,43,0,35,42,120
2002,Tonga,TON,United States of America,USA,0,0,0,5,5
2002,Trinidad and Tobago,TTO,United States of America,USA,0,0,11,22,33
2002,Tunisia,TUN,United States of America,USA,5,0,10,0,15
2002,Turkey,TUR,United States of America,USA,23,0,54,49,126
2002,Uganda,UGA,United States of America,USA,40,0,63,44,147
2002,Ukraine,UKR,United States of America,USA,96,0,134,172,402
2002,Uruguay,URY,United States of America,USA,0,0,0,11,11
2002,Uzbekistan,UZB,United States of America,USA,45,0,24,66,135
2002,Venezuela (Bolivarian Republic of),VEN,United States of America,USA,24,0,34,33,91
2002,Yemen,YEM,United States of America,USA,10,0,44,34,88
2002,Zambia,ZMB,United States of America,USA,5,0,0,14,19
2002,Zimbabwe,ZWE,United States of America,USA,21,0,25,15,61
2002,Stateless,XXA,United States of America,USA,21,0,29,45,95
2003,Afghanistan,AFG,United States of America,USA,70,0,51,61,182
2003,Albania,ALB,United States of America,USA,717,0,787,559,2063
2003,Algeria,DZA,United States of America,USA,15,0,34,22,71
2003,Angola,AGO,United States of America,USA,5,0,22,12,39
2003,Egypt,EGY,United States of America,USA,277,0,162,177,616
2003,Argentina,ARG,United States of America,USA,10,0,56,95,161
2003,Armenia,ARM,United States of America,USA,412,0,575,562,1549
2003,Australia,AUS,United States of America,USA,0,0,5,5,10
2003,Austria,AUT,United States of America,USA,0,0,0,5,5
2003,Azerbaijan,AZE,United States of America,USA,46,0,24,102,172
2003,Bahrain,BHR,United States of America,USA,5,0,0,5,10
2003,Burundi,BDI,United States of America,USA,19,0,16,10,45
2003,Belgium,BEL,United States of America,USA,5,0,15,0,20
2003,Benin,BEN,United States of America,USA,0,0,5,5,10
2003,Bangladesh,BGD,United States of America,USA,107,0,93,210,410
2003,Bahamas,BHS,United States of America,USA,0,0,5,5,10
2003,Bhutan,BTN,United States of America,USA,5,0,0,0,5
2003,Burkina Faso,BFA,United States of America,USA,5,0,14,0,19
2003,Belarus,BLR,United States of America,USA,47,0,24,71,142
2003,Bolivia (Plurinational State of),BOL,United States of America,USA,5,0,10,37,52
2003,Brazil,BRA,United States of America,USA,19,0,61,178,258
2003,Bosnia and Herzegovina,BIH,United States of America,USA,10,0,13,14,37
2003,Bulgaria,BGR,United States of America,USA,47,0,53,88,188
2003,Belize,BLZ,United States of America,USA,0,0,5,11,16
2003,Cambodia,KHM,United States of America,USA,28,0,88,73,189
2003,Canada,CAN,United States of America,USA,0,0,11,5,16
2003,Central African Rep.,CAF,United States of America,USA,10,0,13,14,37
2003,Chad,TCD,United States of America,USA,5,0,11,0,16
2003,China,CHN,United States of America,USA,1140,0,4597,2910,8647
2003,Chile,CHL,United States of America,USA,5,0,10,22,37
2003,Cameroon,CMR,United States of America,USA,186,0,260,187,633
2003,Congo,COG,United States of America,USA,125,0,156,120,401
2003,Dem. Rep. of the Congo,COD,United States of America,USA,38,0,69,25,132
2003,Colombia,COL,United States of America,USA,1589,0,3062,1799,6450
2003,Costa Rica,CRI,United States of America,USA,0,0,0,5,5
2003,Cuba,CUB,United States of America,USA,37,0,167,465,669
2003,Cabo Verde,CPV,United States of America,USA,0,0,0,5,5
2003,Czechia,CZE,United States of America,USA,5,0,12,29,46
2003,Denmark,DNK,United States of America,USA,0,0,0,5,5
2003,Djibouti,DJI,United States of America,USA,0,0,0,5,5
2003,Dominica,DMA,United States of America,USA,0,0,0,5,5
2003,Dominican Rep.,DOM,United States of America,USA,0,0,46,43,89
2003,Ecuador,ECU,United States of America,USA,13,0,53,99,165
2003,Eritrea,ERI,United States of America,USA,66,0,65,36,167
2003,Estonia,EST,United States of America,USA,10,0,11,14,35
2003,Ethiopia,ETH,United States of America,USA,239,0,269,187,695
2003,Fiji,FJI,United States of America,USA,97,0,151,192,440
2003,Finland,FIN,United States of America,USA,0,0,0,5,5
2003,France,FRA,United States of America,USA,5,0,10,21,36
2003,Gabon,GAB,United States of America,USA,0,0,0,5,5
2003,Gambia,GMB,United States of America,USA,30,0,33,38,101
2003,Palestinian,PSE,United States of America,USA,0,0,5,5,10
2003,United Kingdom of Great Britain and Northern Ireland,GBR,United States of America,USA,10,0,15,25,50
2003,Georgia,GEO,United States of America,USA,58,0,84,103,245
2003,Germany,DEU,United States of America,USA,5,0,5,11,21
2003,Ghana,GHA,United States of America,USA,10,0,36,43,89
2003,Guinea-Bissau,GNB,United States of America,USA,5,0,5,0,10
2003,Greece,GRC,United States of America,USA,0,0,0,5,5
2003,Guatemala,GTM,United States of America,USA,162,0,762,1317,2241
2003,Guinea,GIN,United States of America,USA,155,0,234,159,548
2003,Guyana,GUY,United States of America,USA,5,0,118,92,215
2003,Haiti,HTI,United States of America,USA,566,0,2433,1130,4129
2003,"China, Hong Kong SAR",HKG,United States of America,USA,0,0,0,5,5
2003,Honduras,HND,United States of America,USA,34,0,202,354,590
2003,Croatia,HRV,United States of America,USA,0,0,5,13,18
2003,Hungary,HUN,United States of America,USA,0,0,12,14,26
2003,Cote d'Ivoire,CIV,United States of America,USA,38,0,56,41,135
2003,India,IND,United States of America,USA,595,0,951,974,2520
2003,Indonesia,IDN,United States of America,USA,366,0,809,508,1683
2003,Ireland,IRL,United States of America,USA,0,0,0,5,5
2003,Iran (Islamic Rep. of),IRN,United States of America,USA,212,0,187,317,716
2003,Iraq,IRQ,United States of America,USA,197,0,206,125,528
2003,Israel,ISR,United States of America,USA,11,0,32,44,87
2003,Italy,ITA,United States of America,USA,0,0,11,5,16
2003,Jamaica,JAM,United States of America,USA,5,0,50,67,122
2003,Jordan,JOR,United States of America,USA,33,0,74,102,209
2003,Japan,JPN,United States of America,USA,0,0,5,11,16
2003,Kazakhstan,KAZ,United States of America,USA,39,0,13,16,68
2003,Kenya,KEN,United States of America,USA,47,0,95,71,213
2003,Kyrgyzstan,KGZ,United States of America,USA,11,0,5,10,26
2003,Rep. of Korea,KOR,United States of America,USA,0,0,11,15,26
2003,Dem. People's Rep. of Korea,PRK,United States of America,USA,5,0,0,0,5
2003,Kuwait,KWT,United States of America,USA,0,0,5,15,20
2003,Lao People's Dem. Rep.,LAO,United States of America,USA,10,0,46,206,262
2003,Liberia,LBR,United States of America,USA,146,0,98,346,590
2003,Libya,LBY,United States of America,USA,0,0,0,11,11
2003,Saint Lucia,LCA,United States of America,USA,0,0,0,5,5
2003,Lebanon,LBN,United States of America,USA,38,0,55,85,178
2003,Lesotho,LSO,United States of America,USA,0,0,5,0,5
2003,Sri Lanka,LKA,United States of America,USA,55,0,131,113,299
2003,Lithuania,LTU,United States of America,USA,11,0,21,35,67
2003,Latvia,LVA,United States of America,USA,12,0,14,26,52
2003,"China, Macao SAR",MAC,United States of America,USA,0,0,5,0,5
2003,Mauritania,MRT,United States of America,USA,181,0,237,292,710
2003,North Macedonia,MKD,United States of America,USA,22,0,51,42,115
2003,Rep. of Moldova,MDA,United States of America,USA,14,0,19,19,52
2003,Mexico,MEX,United States of America,USA,64,0,612,11699,12375
2003,Mali,MLI,United States of America,USA,5,0,10,25,40
2003,Malaysia,MYS,United States of America,USA,10,0,10,13,33
2003,Malawi,MWI,United States of America,USA,0,0,5,0,5
2003,Mongolia,MNG,United States of America,USA,5,0,0,14,19
2003,Morocco,MAR,United States of America,USA,10,0,14,13,37
2003,Myanmar,MMR,United States of America,USA,118,0,70,95,283
2003,Nepal,NPL,United States of America,USA,57,0,34,46,137
2003,Niger,NER,United States of America,USA,13,0,15,14,42
2003,Nicaragua,NIC,United States of America,USA,5,0,105,88,198
2003,Nigeria,NGA,United States of America,USA,50,0,172,158,380
2003,Niue,NIU,United States of America,USA,0,0,5,0,5
2003,Pakistan,PAK,United States of America,USA,227,0,270,393,890
2003,Panama,PAN,United States of America,USA,0,0,10,12,22
2003,Paraguay,PRY,United States of America,USA,0,0,11,0,11
2003,Peru,PER,United States of America,USA,117,0,222,246,585
2003,Philippines,PHL,United States of America,USA,26,0,128,345,499
2003,Poland,POL,United States of America,USA,10,0,23,49,82
2003,Portugal,PRT,United States of America,USA,0,0,12,5,17
2003,Qatar,QAT,United States of America,USA,0,0,0,5,5
2003,Romania,ROU,United States of America,USA,79,0,71,122,272
2003,South Africa,ZAF,United States of America,USA,5,0,33,34,72
2003,Russian Federation,RUS,United States of America,USA,401,0,248,540,1189
2003,Rwanda,RWA,United States of America,USA,23,0,13,12,48
2003,El Salvador,SLV,United States of America,USA,30,0,485,1645,2160
2003,Saudi Arabia,SAU,United States of America,USA,5,0,5,11,21
2003,Serbia and Kosovo: S/RES/1244 (1999),SRB,United States of America,USA,179,0,316,202,697
2003,Senegal,SEN,United States of America,USA,13,0,36,28,77
2003,Seychelles,SYC,United States of America,USA,0,0,5,0,5
2003,Singapore,SGP,United States of America,USA,5,0,0,0,5
2003,Sierra Leone,SLE,United States of America,USA,116,0,189,156,461
2003,Somalia,SOM,United States of America,USA,149,0,164,277,590
2003,Spain,ESP,United States of America,USA,0,0,0,5,5
2003,Viet Nam,VNM,United States of America,USA,10,0,82,124,216
2003,Sudan,SDN,United States of America,USA,96,0,114,69,279
2003,Suriname,SUR,United States of America,USA,0,0,0,14,14
2003,Slovakia,SVK,United States of America,USA,0,0,11,0,11
2003,Slovenia,SVN,United States of America,USA,0,0,14,0,14
2003,Sweden,SWE,United States of America,USA,0,0,0,13,13
2003,Syrian Arab Rep.,SYR,United States of America,USA,25,0,29,57,111
2003,United Rep. of Tanzania,TZA,United States of America,USA,5,0,24,17,46
2003,Turks and Caicos Islands,TCA,United States of America,USA,0,0,0,5,5
2003,Thailand,THA,United States of America,USA,0,0,11,26,37
2003,Tajikistan,TJK,United States of America,USA,13,0,0,0,13
2003,Turkmenistan,TKM,United States of America,USA,5,0,0,12,17
2003,Togo,TGO,United States of America,USA,62,0,58,44,164
2003,Tonga,TON,United States of America,USA,0,0,0,5,5
2003,Trinidad and Tobago,TTO,United States of America,USA,5,0,5,20,30
2003,Tunisia,TUN,United States of America,USA,5,0,15,15,35
2003,Turkey,TUR,United States of America,USA,36,0,61,41,138
2003,United Arab Emirates,ARE,United States of America,USA,0,0,0,10,10
2003,Uganda,UGA,United States of America,USA,53,0,48,45,146
2003,Ukraine,UKR,United States of America,USA,106,0,110,154,370
2003,Uruguay,URY,United States of America,USA,0,0,0,13,13
2003,Uzbekistan,UZB,United States of America,USA,91,0,42,70,203
2003,Venezuela (Bolivarian Republic of),VEN,United States of America,USA,35,0,67,69,171
2003,Yemen,YEM,United States of America,USA,26,0,41,42,109
2003,Zambia,ZMB,United States of America,USA,5,0,13,10,28
2003,Zimbabwe,ZWE,United States of America,USA,54,0,72,42,168
2003,Stateless,XXA,United States of America,USA,30,0,25,54,109
2004,Afghanistan,AFG,United States of America,USA,58,0,35,75,168
2004,Albania,ALB,United States of America,USA,726,0,629,450,1805
2004,Algeria,DZA,United States of America,USA,13,0,36,42,91
2004,Angola,AGO,United States of America,USA,10,0,17,16,43
2004,Egypt,EGY,United States of America,USA,268,0,166,158,592
2004,Argentina,ARG,United States of America,USA,18,0,304,215,537
2004,Armenia,ARM,United States of America,USA,305,0,391,452,1148
2004,Australia,AUS,United States of America,USA,0,0,5,0,5
2004,Austria,AUT,United States of America,USA,0,0,12,0,12
2004,Azerbaijan,AZE,United States of America,USA,31,0,21,73,125
2004,Bahrain,BHR,United States of America,USA,5,0,0,0,5
2004,Burundi,BDI,United States of America,USA,13,0,19,21,53
2004,Belgium,BEL,United States of America,USA,0,0,5,5,10
2004,Benin,BEN,United States of America,USA,5,0,5,0,10
2004,Bangladesh,BGD,United States of America,USA,149,0,162,198,509
2004,Bahamas,BHS,United States of America,USA,0,0,0,13,13
2004,Bhutan,BTN,United States of America,USA,0,0,0,5,5
2004,Burkina Faso,BFA,United States of America,USA,5,0,10,10,25
2004,Belarus,BLR,United States of America,USA,56,0,23,89,168
2004,Bolivia (Plurinational State of),BOL,United States of America,USA,5,0,21,16,42
2004,Botswana,BWA,United States of America,USA,0,0,0,5,5
2004,Brazil,BRA,United States of America,USA,33,0,80,321,434
2004,Bosnia and Herzegovina,BIH,United States of America,USA,5,0,18,19,42
2004,Bulgaria,BGR,United States of America,USA,43,0,52,88,183
2004,Belize,BLZ,United States of America,USA,5,0,5,5,15
2004,Cambodia,KHM,United States of America,USA,31,0,62,75,168
2004,Canada,CAN,United States of America,USA,5,0,0,5,10
2004,Central African Rep.,CAF,United States of America,USA,0,0,22,16,38
2004,Chad,TCD,United States of America,USA,5,0,10,5,20
2004,China,CHN,United States of America,USA,1256,0,3070,2055,6381
2004,Chile,CHL,United States of America,USA,5,0,12,20,37
2004,Cameroon,CMR,United States of America,USA,273,0,299,229,801
2004,Congo,COG,United States of America,USA,130,0,122,114,366
2004,Dem. Rep. of the Congo,COD,United States of America,USA,24,0,27,48,99
2004,Colombia,COL,United States of America,USA,1476,0,3082,2076,6634
2004,Costa Rica,CRI,United States of America,USA,5,0,12,5,22
2004,Cuba,CUB,United States of America,USA,32,0,104,424,560
2004,Cabo Verde,CPV,United States of America,USA,0,0,0,5,5
2004,Czechia,CZE,United States of America,USA,5,0,16,22,43
2004,Denmark,DNK,United States of America,USA,0,0,5,0,5
2004,Dominica,DMA,United States of America,USA,0,0,0,5,5
2004,Dominican Rep.,DOM,United States of America,USA,5,0,23,55,83
2004,Ecuador,ECU,United States of America,USA,5,0,34,81,120
2004,Eritrea,ERI,United States of America,USA,61,0,35,38,134
2004,Estonia,EST,United States of America,USA,10,0,5,19,34
2004,Ethiopia,ETH,United States of America,USA,260,0,233,258,751
2004,Fiji,FJI,United States of America,USA,95,0,135,327,557
2004,France,FRA,United States of America,USA,5,0,0,34,39
2004,Micronesia (Federated States of),FSM,United States of America,USA,0,0,0,5,5
2004,Gabon,GAB,United States of America,USA,5,0,0,5,10
2004,Gambia,GMB,United States of America,USA,17,0,36,41,94
2004,Palestinian,PSE,United States of America,USA,0,0,12,0,12
2004,United Kingdom of Great Britain and Northern Ireland,GBR,United States of America,USA,5,0,16,24,45
2004,Georgia,GEO,United States of America,USA,66,0,80,106,252
2004,Germany,DEU,United States of America,USA,0,0,11,11,22
2004,Ghana,GHA,United States of America,USA,5,0,32,30,67
2004,Guinea-Bissau,GNB,United States of America,USA,0,0,0,14,14
2004,Greece,GRC,United States of America,USA,0,0,13,0,13
2004,Grenada,GRD,United States of America,USA,0,0,0,5,5
2004,Guatemala,GTM,United States of America,USA,177,0,869,2140,3186
2004,Guinea,GIN,United States of America,USA,259,0,221,143,623
2004,Guyana,GUY,United States of America,USA,32,0,152,87,271
2004,Haiti,HTI,United States of America,USA,535,0,2382,1170,4087
2004,"China, Hong Kong SAR",HKG,United States of America,USA,0,0,0,5,5
2004,Honduras,HND,United States of America,USA,46,0,238,347,631
2004,Croatia,HRV,United States of America,USA,5,0,0,5,10
2004,Hungary,HUN,United States of America,USA,5,0,5,13,23
2004,Iceland,ISL,United States of America,USA,0,0,0,5,5
2004,Cote d'Ivoire,CIV,United States of America,USA,78,0,94,74,246
2004,India,IND,United States of America,USA,451,0,621,1000,2072
2004,Indonesia,IDN,United States of America,USA,429,0,1226,733,2388
2004,Iran (Islamic Rep. of),IRN,United States of America,USA,203,0,162,345,710
2004,Iraq,IRQ,United States of America,USA,115,0,206,99,420
2004,Israel,ISR,United States of America,USA,10,0,40,31,81
2004,Italy,ITA,United States of America,USA,0,0,10,5,15
2004,Jamaica,JAM,United States of America,USA,5,0,45,63,113
2004,Jordan,JOR,United States of America,USA,28,0,49,91,168
2004,Japan,JPN,United States of America,USA,0,0,10,13,23
2004,Kazakhstan,KAZ,United States of America,USA,28,0,27,27,82
2004,Kenya,KEN,United States of America,USA,62,0,86,123,271
2004,Kyrgyzstan,KGZ,United States of America,USA,15,0,10,10,35
2004,Rep. of Korea,KOR,United States of America,USA,0,0,5,13,18
2004,Dem. People's Rep. of Korea,PRK,United States of America,USA,0,0,0,5,5
2004,Kuwait,KWT,United States of America,USA,10,0,10,17,37
2004,Lao People's Dem. Rep.,LAO,United States of America,USA,5,0,45,294,344
2004,Liberia,LBR,United States of America,USA,91,0,103,328,522
2004,Libya,LBY,United States of America,USA,0,0,0,5,5
2004,Lebanon,LBN,United States of America,USA,41,0,85,108,234
2004,Sri Lanka,LKA,United States of America,USA,63,0,65,116,244
2004,Lithuania,LTU,United States of America,USA,10,0,16,37,63
2004,Latvia,LVA,United States of America,USA,17,0,12,21,50
2004,Madagascar,MDG,United States of America,USA,0,0,0,5,5
2004,Mauritania,MRT,United States of America,USA,219,0,211,477,907
2004,North Macedonia,MKD,United States of America,USA,14,0,52,43,109
2004,Rep. of Moldova,MDA,United States of America,USA,13,0,17,21,51
2004,Mexico,MEX,United States of America,USA,68,0,594,10271,10933
2004,Mali,MLI,United States of America,USA,10,0,16,22,48
2004,Malaysia,MYS,United States of America,USA,5,0,10,12,27
2004,Malawi,MWI,United States of America,USA,11,0,0,0,11
2004,Mongolia,MNG,United States of America,USA,13,0,28,13,54
2004,Morocco,MAR,United States of America,USA,0,0,19,19,38
2004,Malta,MLT,United States of America,USA,0,0,0,5,5
2004,Myanmar,MMR,United States of America,USA,138,0,70,73,281
2004,Nepal,NPL,United States of America,USA,93,0,48,41,182
2004,Netherlands,NLD,United States of America,USA,0,0,11,0,11
2004,Niger,NER,United States of America,USA,5,0,20,22,47
2004,Nicaragua,NIC,United States of America,USA,5,0,94,92,191
2004,Nigeria,NGA,United States of America,USA,50,0,132,140,322
2004,New Zealand,NZL,United States of America,USA,0,0,0,5,5
2004,Pakistan,PAK,United States of America,USA,164,0,367,450,981
2004,Panama,PAN,United States of America,USA,10,0,5,12,27
2004,Paraguay,PRY,United States of America,USA,0,0,5,5,10
2004,Peru,PER,United States of America,USA,111,0,214,282,607
2004,Philippines,PHL,United States of America,USA,29,0,117,352,498
2004,Poland,POL,United States of America,USA,5,0,19,43,67
2004,Portugal,PRT,United States of America,USA,0,0,0,14,14
2004,Qatar,QAT,United States of America,USA,0,0,0,5,5
2004,Romania,ROU,United States of America,USA,61,0,69,85,215
2004,South Africa,ZAF,United States of America,USA,5,0,23,23,51
2004,Russian Federation,RUS,United States of America,USA,407,0,268,666,1341
2004,Rwanda,RWA,United States of America,USA,28,0,10,16,54
2004,El Salvador,SLV,United States of America,USA,42,0,609,1606,2257
2004,Saudi Arabia,SAU,United States of America,USA,5,0,12,0,17
2004,Serbia and Kosovo: S/RES/1244 (1999),SRB,United States of America,USA,210,0,202,169,581
2004,Senegal,SEN,United States of America,USA,17,0,34,30,81
2004,Seychelles,SYC,United States of America,USA,14,0,0,0,14
2004,Singapore,SGP,United States of America,USA,5,0,5,5,15
2004,Sierra Leone,SLE,United States of America,USA,122,0,170,185,477
2004,Somalia,SOM,United States of America,USA,89,0,61,221,371
2004,Spain,ESP,United States of America,USA,0,0,5,12,17
2004,Viet Nam,VNM,United States of America,USA,5,0,95,110,210
2004,Sudan,SDN,United States of America,USA,67,0,58,56,181
2004,Suriname,SUR,United States of America,USA,0,0,0,11,11
2004,Slovakia,SVK,United States of America,USA,0,0,13,0,13
2004,Slovenia,SVN,United States of America,USA,0,0,5,0,5
2004,Syrian Arab Rep.,SYR,United States of America,USA,10,0,50,48,108
2004,United Rep. of Tanzania,TZA,United States of America,USA,0,0,19,14,33
2004,Thailand,THA,United States of America,USA,0,0,12,35,47
2004,Tajikistan,TJK,United States of America,USA,5,0,0,5,10
2004,Turkmenistan,TKM,United States of America,USA,17,0,0,11,28
2004,Togo,TGO,United States of America,USA,67,0,128,86,281
2004,Tonga,TON,United States of America,USA,0,0,5,5,10
2004,Trinidad and Tobago,TTO,United States of America,USA,0,0,10,23,33
2004,Tunisia,TUN,United States of America,USA,0,0,13,13,26
2004,Turkey,TUR,United States of America,USA,27,0,41,40,108
2004,United Arab Emirates,ARE,United States of America,USA,5,0,5,5,15
2004,Uganda,UGA,United States of America,USA,50,0,49,39,138
2004,Ukraine,UKR,United States of America,USA,90,0,101,147,338
2004,Uruguay,URY,United States of America,USA,5,0,19,28,52
2004,Uzbekistan,UZB,United States of America,USA,76,0,43,106,225
2004,Venezuela (Bolivarian Republic of),VEN,United States of America,USA,57,0,252,229,538
2004,Samoa,WSM,United States of America,USA,0,0,0,5,5
2004,Yemen,YEM,United States of America,USA,10,0,43,43,96
2004,Zambia,ZMB,United States of America,USA,5,0,13,12,30
2004,Zimbabwe,ZWE,United States of America,USA,71,0,48,71,190
2004,Stateless,XXA,United States of America,USA,59,0,38,51,148
2005,Afghanistan,AFG,United States of America,USA,33,0,30,39,102
2005,Albania,ALB,United States of America,USA,609,0,514,442,1565
2005,Algeria,DZA,United States of America,USA,23,0,37,26,86
2005,Andorra,AND,United States of America,USA,0,0,0,5,5
2005,Angola,AGO,United States of America,USA,5,0,22,29,56
2005,Egypt,EGY,United States of America,USA,195,0,101,167,463
2005,Argentina,ARG,United States of America,USA,10,0,230,184,424
2005,Armenia,ARM,United States of America,USA,268,0,325,332,925
2005,Australia,AUS,United States of America,USA,0,0,0,5,5
2005,Austria,AUT,United States of America,USA,5,0,0,0,5
2005,Azerbaijan,AZE,United States of America,USA,30,0,25,38,93
2005,Bahrain,BHR,United States of America,USA,0,0,5,0,5
2005,Barbados,BRB,United States of America,USA,0,0,0,5,5
2005,Burundi,BDI,United States of America,USA,11,0,16,14,41
2005,Belgium,BEL,United States of America,USA,5,0,0,13,18
2005,Benin,BEN,United States of America,USA,0,0,13,0,13
2005,Bangladesh,BGD,United States of America,USA,121,0,118,198,437
2005,Bahamas,BHS,United States of America,USA,5,0,11,5,21
2005,Bhutan,BTN,United States of America,USA,5,0,0,0,5
2005,Burkina Faso,BFA,United States of America,USA,5,0,12,10,27
2005,Belarus,BLR,United States of America,USA,89,0,32,94,215
2005,Bolivia (Plurinational State of),BOL,United States of America,USA,5,0,14,16,35
2005,Brazil,BRA,United States of America,USA,24,0,74,532,630
2005,Bosnia and Herzegovina,BIH,United States of America,USA,10,0,10,20,40
2005,Bulgaria,BGR,United States of America,USA,77,0,40,82,199
2005,Belize,BLZ,United States of America,USA,0,0,0,11,11
2005,Cambodia,KHM,United States of America,USA,30,0,68,55,153
2005,Canada,CAN,United States of America,USA,5,0,5,14,24
2005,Central African Rep.,CAF,United States of America,USA,18,0,14,19,51
2005,Chad,TCD,United States of America,USA,10,0,0,10,20
2005,China,CHN,United States of America,USA,1458,0,2592,1777,5827
2005,Chile,CHL,United States of America,USA,5,0,16,16,37
2005,Cameroon,CMR,United States of America,USA,264,0,244,266,774
2005,Congo,COG,United States of America,USA,76,0,75,85,236
2005,Dem. Rep. of the Congo,COD,United States of America,USA,38,0,49,45,132
2005,Colombia,COL,United States of America,USA,1155,0,2312,2481,5948
2005,Costa Rica,CRI,United States of America,USA,0,0,0,12,12
2005,Cuba,CUB,United States of America,USA,21,0,100,441,562
2005,Czechia,CZE,United States of America,USA,5,0,10,25,40
2005,Dominican Rep.,DOM,United States of America,USA,0,0,37,51,88
2005,Ecuador,ECU,United States of America,USA,11,0,34,68,113
2005,Eritrea,ERI,United States of America,USA,68,0,35,46,149
2005,Estonia,EST,United States of America,USA,5,0,10,29,44
2005,Ethiopia,ETH,United States of America,USA,264,0,189,178,631
2005,Fiji,FJI,United States of America,USA,35,0,94,118,247
2005,Finland,FIN,United States of America,USA,0,0,0,5,5
2005,France,FRA,United States of America,USA,5,0,10,26,41
2005,Micronesia (Federated States of),FSM,United States of America,USA,0,0,5,0,5
2005,Gabon,GAB,United States of America,USA,0,0,13,0,13
2005,Gambia,GMB,United States of America,USA,30,0,46,97,173
2005,Palestinian,PSE,United States of America,USA,0,0,0,14,14
2005,United Kingdom of Great Britain and Northern Ireland,GBR,United States of America,USA,10,0,18,13,41
2005,Georgia,GEO,United States of America,USA,64,0,70,76,210
2005,Germany,DEU,United States of America,USA,5,0,18,13,36
2005,Ghana,GHA,United States of America,USA,5,0,23,32,60
2005,Guinea-Bissau,GNB,United States of America,USA,0,0,12,0,12
2005,Greece,GRC,United States of America,USA,14,0,0,0,14
2005,Guatemala,GTM,United States of America,USA,142,0,824,1865,2831
2005,Guinea,GIN,United States of America,USA,258,0,215,170,643
2005,Guyana,GUY,United States of America,USA,30,0,104,82,216
2005,Haiti,HTI,United States of America,USA,656,0,2788,1359,4803
2005,"China, Hong Kong SAR",HKG,United States of America,USA,0,0,5,0,5
2005,Honduras,HND,United States of America,USA,66,0,334,350,750
2005,Croatia,HRV,United States of America,USA,0,0,13,5,18
2005,Hungary,HUN,United States of America,USA,0,0,5,5,10
2005,Cote d'Ivoire,CIV,United States of America,USA,109,0,84,90,283
2005,India,IND,United States of America,USA,311,0,510,622,1443
2005,Indonesia,IDN,United States of America,USA,374,0,1276,786,2436
2005,Ireland,IRL,United States of America,USA,0,0,0,5,5
2005,Iran (Islamic Rep. of),IRN,United States of America,USA,143,0,133,181,457
2005,Iraq,IRQ,United States of America,USA,96,0,121,95,312
2005,Israel,ISR,United States of America,USA,17,0,37,47,101
2005,Italy,ITA,United States of America,USA,0,0,5,12,17
2005,Jamaica,JAM,United States of America,USA,0,0,53,96,149
2005,Jordan,JOR,United States of America,USA,21,0,63,94,178
2005,Japan,JPN,United States of America,USA,0,0,14,20,34
2005,Kazakhstan,KAZ,United States of America,USA,13,0,13,13,39
2005,Kenya,KEN,United States of America,USA,54,0,85,156,295
2005,Kyrgyzstan,KGZ,United States of America,USA,12,0,5,17,34
2005,Rep. of Korea,KOR,United States of America,USA,0,0,16,18,34
2005,Dem. People's Rep. of Korea,PRK,United States of America,USA,0,0,5,0,5
2005,Kuwait,KWT,United States of America,USA,0,0,5,12,17
2005,Lao People's Dem. Rep.,LAO,United States of America,USA,19,0,43,82,144
2005,Liberia,LBR,United States of America,USA,70,0,68,195,333
2005,Lebanon,LBN,United States of America,USA,23,0,66,93,182
2005,Sri Lanka,LKA,United States of America,USA,74,0,64,135,273
2005,Lithuania,LTU,United States of America,USA,5,0,22,37,64
2005,Latvia,LVA,United States of America,USA,5,0,10,23,38
2005,Madagascar,MDG,United States of America,USA,0,0,0,5,5
2005,Mauritania,MRT,United States of America,USA,193,0,308,426,927
2005,North Macedonia,MKD,United States of America,USA,22,0,44,32,98
2005,Rep. of Moldova,MDA,United States of America,USA,5,0,10,17,32
2005,Mexico,MEX,United States of America,USA,34,0,360,8348,8742
2005,Mali,MLI,United States of America,USA,18,0,19,34,71
2005,Malaysia,MYS,United States of America,USA,5,0,10,11,26
2005,Malawi,MWI,United States of America,USA,0,0,5,0,5
2005,Mongolia,MNG,United States of America,USA,25,0,43,33,101
2005,Morocco,MAR,United States of America,USA,5,0,16,26,47
2005,Myanmar,MMR,United States of America,USA,165,0,47,67,279
2005,Nepal,NPL,United States of America,USA,85,0,60,78,223
2005,Netherlands,NLD,United States of America,USA,0,0,12,0,12
2005,Niger,NER,United States of America,USA,5,0,12,27,44
2005,Nicaragua,NIC,United States of America,USA,16,0,79,323,418
2005,Nigeria,NGA,United States of America,USA,34,0,138,131,303
2005,Oman,OMN,United States of America,USA,0,0,0,5,5
2005,Pakistan,PAK,United States of America,USA,140,0,328,350,818
2005,Panama,PAN,United States of America,USA,5,0,5,13,23
2005,Paraguay,PRY,United States of America,USA,0,0,0,12,12
2005,Peru,PER,United States of America,USA,59,0,178,212,449
2005,Philippines,PHL,United States of America,USA,27,0,62,216,305
2005,Poland,POL,United States of America,USA,5,0,30,85,120
2005,Portugal,PRT,United States of America,USA,0,0,5,21,26
2005,Romania,ROU,United States of America,USA,18,0,45,67,130
2005,South Africa,ZAF,United States of America,USA,5,0,13,28,46
2005,Russian Federation,RUS,United States of America,USA,422,0,295,596,1313
2005,Rwanda,RWA,United States of America,USA,19,0,18,13,50
2005,El Salvador,SLV,United States of America,USA,64,0,698,1638,2400
2005,Saudi Arabia,SAU,United States of America,USA,5,0,5,19,29
2005,Serbia and Kosovo: S/RES/1244 (1999),SRB,United States of America,USA,228,0,198,152,578
2005,Senegal,SEN,United States of America,USA,26,0,41,45,112
2005,Seychelles,SYC,United States of America,USA,5,0,0,0,5
2005,Singapore,SGP,United States of America,USA,0,0,5,0,5
2005,Sierra Leone,SLE,United States of America,USA,81,0,147,199,427
2005,Somalia,SOM,United States of America,USA,89,0,68,276,433
2005,Spain,ESP,United States of America,USA,0,0,10,13,23
2005,Viet Nam,VNM,United States of America,USA,10,0,54,83,147
2005,Saint Kitts and Nevis,KNA,United States of America,USA,0,0,5,0,5
2005,Sudan,SDN,United States of America,USA,55,0,36,73,164
2005,Suriname,SUR,United States of America,USA,0,0,5,5,10
2005,Slovakia,SVK,United States of America,USA,5,0,5,11,21
2005,Slovenia,SVN,United States of America,USA,0,0,0,5,5
2005,Sweden,SWE,United States of America,USA,0,0,0,5,5
2005,Syrian Arab Rep.,SYR,United States of America,USA,11,0,43,52,106
2005,United Rep. of Tanzania,TZA,United States of America,USA,5,0,15,30,50
2005,Turks and Caicos Islands,TCA,United States of America,USA,0,0,5,0,5
2005,Thailand,THA,United States of America,USA,0,0,10,18,28
2005,Tajikistan,TJK,United States of America,USA,14,0,0,5,19
2005,Turkmenistan,TKM,United States of America,USA,13,0,5,10,28
2005,Togo,TGO,United States of America,USA,102,0,78,106,286
2005,Tonga,TON,United States of America,USA,0,0,0,10,10
2005,Trinidad and Tobago,TTO,United States of America,USA,5,0,10,27,42
2005,Tunisia,TUN,United States of America,USA,5,0,13,17,35
2005,Turkey,TUR,United States of America,USA,12,0,44,60,116
2005,Uganda,UGA,United States of America,USA,53,0,28,45,126
2005,Ukraine,UKR,United States of America,USA,69,0,101,115,285
2005,Uruguay,URY,United States of America,USA,0,0,15,17,32
2005,Uzbekistan,UZB,United States of America,USA,94,0,55,96,245
2005,Venezuela (Bolivarian Republic of),VEN,United States of America,USA,154,0,506,399,1059
2005,Samoa,WSM,United States of America,USA,0,0,0,5,5
2005,Yemen,YEM,United States of America,USA,10,0,41,22,73
2005,Zambia,ZMB,United States of America,USA,11,0,12,5,28
2005,Zimbabwe,ZWE,United States of America,USA,58,0,85,117,260
2005,Stateless,XXA,United States of America,USA,71,0,28,48,147
2006,Afghanistan,AFG,United States of America,USA,24,0,10,25,59
2006,Albania,ALB,United States of America,USA,506,0,391,310,1207
2006,Algeria,DZA,United States of America,USA,13,0,22,20,55
2006,Angola,AGO,United States of America,USA,17,0,20,5,42
2006,Egypt,EGY,United States of America,USA,240,0,62,145,447
2006,Argentina,ARG,United States of America,USA,10,0,144,122,276
2006,Armenia,ARM,United States of America,USA,286,0,161,285,732
2006,Azerbaijan,AZE,United States of America,USA,27,0,11,21,59
2006,Bahrain,BHR,United States of America,USA,0,0,13,0,13
2006,Barbados,BRB,United States of America,USA,0,0,0,5,5
2006,Burundi,BDI,United States of America,USA,12,0,5,10,27
2006,Belgium,BEL,United States of America,USA,5,0,0,14,19
2006,Benin,BEN,United States of America,USA,0,0,5,5,10
2006,Bangladesh,BGD,United States of America,USA,114,0,83,193,390
2006,Bahamas,BHS,United States of America,USA,0,0,0,5,5
2006,Burkina Faso,BFA,United States of America,USA,12,0,10,19,41
2006,Belarus,BLR,United States of America,USA,105,0,47,94,246
2006,Bolivia (Plurinational State of),BOL,United States of America,USA,5,0,0,13,18
2006,Brazil,BRA,United States of America,USA,32,0,93,125,250
2006,Bosnia and Herzegovina,BIH,United States of America,USA,5,0,17,17,39
2006,Bulgaria,BGR,United States of America,USA,72,0,39,66,177
2006,Belize,BLZ,United States of America,USA,0,0,5,12,17
2006,Cambodia,KHM,United States of America,USA,20,0,56,40,116
2006,Canada,CAN,United States of America,USA,5,0,5,10,20
2006,Central African Rep.,CAF,United States of America,USA,10,0,20,16,46
2006,Chad,TCD,United States of America,USA,16,0,5,11,32
2006,China,CHN,United States of America,USA,4060,0,2119,2079,8258
2006,Chile,CHL,United States of America,USA,0,0,5,12,17
2006,Cameroon,CMR,United States of America,USA,358,0,165,187,710
2006,Congo,COG,United States of America,USA,89,0,46,79,214
2006,Dem. Rep. of the Congo,COD,United States of America,USA,27,0,36,35,98
2006,Colombia,COL,United States of America,USA,775,0,1644,1926,4345
2006,Costa Rica,CRI,United States of America,USA,0,0,0,13,13
2006,Cuba,CUB,United States of America,USA,26,0,79,535,640
2006,Cabo Verde,CPV,United States of America,USA,0,0,0,5,5
2006,Czechia,CZE,United States of America,USA,5,0,10,31,46
2006,Dominica,DMA,United States of America,USA,0,0,0,5,5
2006,Dominican Rep.,DOM,United States of America,USA,0,0,17,53,70
2006,Ecuador,ECU,United States of America,USA,11,0,29,66,106
2006,Eritrea,ERI,United States of America,USA,93,0,29,86,208
2006,Estonia,EST,United States of America,USA,5,0,5,17,27
2006,Ethiopia,ETH,United States of America,USA,342,0,168,153,663
2006,Fiji,FJI,United States of America,USA,45,0,50,97,192
2006,France,FRA,United States of America,USA,0,0,5,11,16
2006,Gabon,GAB,United States of America,USA,5,0,0,5,10
2006,Gambia,GMB,United States of America,USA,46,0,34,142,222
2006,Palestinian,PSE,United States of America,USA,0,0,0,14,14
2006,United Kingdom of Great Britain and Northern Ireland,GBR,United States of America,USA,0,0,10,23,33
2006,Georgia,GEO,United States of America,USA,58,0,44,53,155
2006,Germany,DEU,United States of America,USA,12,0,0,5,17
2006,Ghana,GHA,United States of America,USA,5,0,20,29,54
2006,Guinea-Bissau,GNB,United States of America,USA,0,0,5,5,10
2006,Greece,GRC,United States of America,USA,5,0,0,0,5
2006,Guatemala,GTM,United States of America,USA,157,0,886,2169,3212
2006,Guinea,GIN,United States of America,USA,356,0,202,163,721
2006,Guyana,GUY,United States of America,USA,16,0,76,86,178
2006,Haiti,HTI,United States of America,USA,570,0,2517,2260,5347
2006,"China, Hong Kong SAR",HKG,United States of America,USA,0,0,5,0,5
2006,Honduras,HND,United States of America,USA,66,0,421,391,878
2006,Croatia,HRV,United States of America,USA,0,0,5,5,10
2006,Hungary,HUN,United States of America,USA,0,0,0,11,11
2006,Cote d'Ivoire,CIV,United States of America,USA,159,0,81,97,337
2006,India,IND,United States of America,USA,450,0,458,491,1399
2006,Indonesia,IDN,United States of America,USA,314,0,1088,705,2107
2006,Iran (Islamic Rep. of),IRN,United States of America,USA,118,0,85,176,379
2006,Iraq,IRQ,United States of America,USA,190,0,125,91,406
2006,Israel,ISR,United States of America,USA,17,0,21,43,81
2006,Italy,ITA,United States of America,USA,5,0,10,5,20
2006,Jamaica,JAM,United States of America,USA,5,0,43,86,134
2006,Jordan,JOR,United States of America,USA,27,0,45,65,137
2006,Japan,JPN,United States of America,USA,5,0,5,12,22
2006,Kazakhstan,KAZ,United States of America,USA,22,0,12,25,59
2006,Kenya,KEN,United States of America,USA,55,0,117,129,301
2006,Kyrgyzstan,KGZ,United States of America,USA,19,0,10,12,41
2006,Rep. of Korea,KOR,United States of America,USA,0,0,5,13,18
2006,Dem. People's Rep. of Korea,PRK,United States of America,USA,5,0,0,0,5
2006,Kuwait,KWT,United States of America,USA,0,0,5,11,16
2006,Lao People's Dem. Rep.,LAO,United States of America,USA,11,0,35,54,100
2006,Liberia,LBR,United States of America,USA,59,0,63,143,265
2006,Libya,LBY,United States of America,USA,0,0,5,0,5
2006,Lebanon,LBN,United States of America,USA,26,0,47,110,183
2006,Lesotho,LSO,United States of America,USA,0,0,0,5,5
2006,Sri Lanka,LKA,United States of America,USA,81,0,47,75,203
2006,Lithuania,LTU,United States of America,USA,18,0,18,54,90
2006,Latvia,LVA,United States of America,USA,13,0,5,18,36
2006,Madagascar,MDG,United States of America,USA,0,0,0,5,5
2006,Mauritania,MRT,United States of America,USA,218,0,194,271,683
2006,North Macedonia,MKD,United States of America,USA,20,0,22,21,63
2006,Rep. of Moldova,MDA,United States of America,USA,5,0,5,20,30
2006,Mexico,MEX,United States of America,USA,48,0,295,4927,5270
2006,Mali,MLI,United States of America,USA,61,0,36,72,169
2006,Malaysia,MYS,United States of America,USA,5,0,5,5,15
2006,Malawi,MWI,United States of America,USA,0,0,0,5,5
2006,Mongolia,MNG,United States of America,USA,38,0,26,24,88
2006,Morocco,MAR,United States of America,USA,10,0,21,16,47
2006,Mauritius,MUS,United States of America,USA,0,0,0,5,5
2006,Myanmar,MMR,United States of America,USA,153,0,40,65,258
2006,Nepal,NPL,United States of America,USA,163,0,67,68,298
2006,Niger,NER,United States of America,USA,10,0,23,25,58
2006,Nicaragua,NIC,United States of America,USA,15,0,110,1036,1161
2006,Nigeria,NGA,United States of America,USA,27,0,89,104,220
2006,Pakistan,PAK,United States of America,USA,174,0,250,364,788
2006,Panama,PAN,United States of America,USA,13,0,0,0,13
2006,Paraguay,PRY,United States of America,USA,0,0,0,12,12
2006,Peru,PER,United States of America,USA,82,0,126,193,401
2006,Philippines,PHL,United States of America,USA,17,0,65,167,249
2006,Poland,POL,United States of America,USA,5,0,21,231,257
2006,Portugal,PRT,United States of America,USA,5,0,5,25,35
2006,Romania,ROU,United States of America,USA,43,0,33,84,160
2006,South Africa,ZAF,United States of America,USA,20,0,15,36,71
2006,Russian Federation,RUS,United States of America,USA,391,0,201,503,1095
2006,Rwanda,RWA,United States of America,USA,21,0,10,5,36
2006,El Salvador,SLV,United States of America,USA,95,0,1003,2914,4012
2006,Saudi Arabia,SAU,United States of America,USA,14,0,0,11,25
2006,Serbia and Kosovo: S/RES/1244 (1999),SRB,United States of America,USA,185,0,99,121,405
2006,Senegal,SEN,United States of America,USA,15,0,41,35,91
2006,Seychelles,SYC,United States of America,USA,0,0,11,0,11
2006,Singapore,SGP,United States of America,USA,5,0,0,5,10
2006,Sierra Leone,SLE,United States of America,USA,78,0,108,146,332
2006,Somalia,SOM,United States of America,USA,111,0,60,174,345
2006,Spain,ESP,United States of America,USA,0,0,11,0,11
2006,Viet Nam,VNM,United States of America,USA,10,0,38,58,106
2006,Sudan,SDN,United States of America,USA,44,0,27,53,124
2006,Suriname,SUR,United States of America,USA,5,0,0,5,10
2006,Slovakia,SVK,United States of America,USA,0,0,0,22,22
2006,Slovenia,SVN,United States of America,USA,0,0,0,5,5
2006,Sweden,SWE,United States of America,USA,0,0,0,5,5
2006,Syrian Arab Rep.,SYR,United States of America,USA,19,0,31,36,86
2006,United Rep. of Tanzania,TZA,United States of America,USA,17,0,15,19,51
2006,Thailand,THA,United States of America,USA,0,0,5,10,15
2006,Tajikistan,TJK,United States of America,USA,5,0,0,5,10
2006,Turkmenistan,TKM,United States of America,USA,21,0,10,14,45
2006,Togo,TGO,United States of America,USA,146,0,74,109,329
2006,Tonga,TON,United States of America,USA,0,0,0,5,5
2006,Trinidad and Tobago,TTO,United States of America,USA,5,0,0,32,37
2006,Tunisia,TUN,United States of America,USA,0,0,5,15,20
2006,Turkey,TUR,United States of America,USA,33,0,24,45,102
2006,United Arab Emirates,ARE,United States of America,USA,5,0,0,5,10
2006,Uganda,UGA,United States of America,USA,36,0,32,39,107
2006,Ukraine,UKR,United States of America,USA,44,0,91,136,271
2006,Uruguay,URY,United States of America,USA,0,0,15,14,29
2006,Uzbekistan,UZB,United States of America,USA,95,0,62,95,252
2006,Venezuela (Bolivarian Republic of),VEN,United States of America,USA,274,0,586,433,1293
2006,Yemen,YEM,United States of America,USA,10,0,28,52,90
2006,Zambia,ZMB,United States of America,USA,10,0,5,22,37
2006,Zimbabwe,ZWE,United States of America,USA,62,0,69,101,232
2006,Stateless,XXA,United States of America,USA,86,0,26,46,158
2007,Afghanistan,AFG,United States of America,USA,10,0,5,19,34
2007,Albania,ALB,United States of America,USA,283,0,146,160,589
2007,Algeria,DZA,United States of America,USA,0,0,0,14,14
2007,Angola,AGO,United States of America,USA,5,0,0,5,10
2007,Egypt,EGY,United States of America,USA,198,0,40,101,339
2007,Argentina,ARG,United States of America,USA,10,0,5,41,56
2007,Armenia,ARM,United States of America,USA,149,0,79,152,380
2007,Azerbaijan,AZE,United States of America,USA,11,0,0,10,21
2007,Burundi,BDI,United States of America,USA,0,0,5,0,5
2007,Bangladesh,BGD,United States of America,USA,62,0,29,93,184
2007,Bahamas,BHS,United States of America,USA,0,0,0,5,5
2007,Burkina Faso,BFA,United States of America,USA,15,0,10,15,40
2007,Belarus,BLR,United States of America,USA,51,0,16,41,108
2007,Bolivia (Plurinational State of),BOL,United States of America,USA,0,0,5,0,5
2007,Brazil,BRA,United States of America,USA,24,0,15,70,109
2007,Bosnia and Herzegovina,BIH,United States of America,USA,10,0,0,0,10
2007,Bulgaria,BGR,United States of America,USA,34,0,25,47,106
2007,Cambodia,KHM,United States of America,USA,10,0,17,24,51
2007,Canada,CAN,United States of America,USA,0,0,0,5,5
2007,Central African Rep.,CAF,United States of America,USA,5,0,0,5,10
2007,Chad,TCD,United States of America,USA,15,0,5,10,30
2007,China,CHN,United States of America,USA,2298,0,687,1183,4168
2007,Chile,CHL,United States of America,USA,0,0,0,10,10
2007,Cameroon,CMR,United States of America,USA,174,0,115,101,390
2007,Congo,COG,United States of America,USA,57,0,25,44,126
2007,Dem. Rep. of the Congo,COD,United States of America,USA,17,0,5,10,32
2007,Colombia,COL,United States of America,USA,583,0,1001,1269,2853
2007,Costa Rica,CRI,United States of America,USA,0,0,0,10,10
2007,Cuba,CUB,United States of America,USA,0,0,0,161,161
2007,Cabo Verde,CPV,United States of America,USA,0,0,0,5,5
2007,Czechia,CZE,United States of America,USA,0,0,0,12,12
2007,Dominican Rep.,DOM,United States of America,USA,0,0,5,5,10
2007,Ecuador,ECU,United States of America,USA,5,0,13,41,59
2007,Eritrea,ERI,United States of America,USA,38,0,12,17,67
2007,Estonia,EST,United States of America,USA,14,0,5,5,24
2007,Ethiopia,ETH,United States of America,USA,183,0,101,96,380
2007,Fiji,FJI,United States of America,USA,22,0,15,45,82
2007,France,FRA,United States of America,USA,0,0,5,5,10
2007,Gambia,GMB,United States of America,USA,50,0,37,135,222
2007,United Kingdom of Great Britain and Northern Ireland,GBR,United States of America,USA,0,0,0,13,13
2007,Georgia,GEO,United States of America,USA,19,0,23,43,85
2007,Germany,DEU,United States of America,USA,0,0,5,0,5
2007,Ghana,GHA,United States of America,USA,5,0,5,10,20
2007,Guinea-Bissau,GNB,United States of America,USA,5,0,0,5,10
2007,Greece,GRC,United States of America,USA,5,0,0,0,5
2007,Guatemala,GTM,United States of America,USA,62,0,710,2671,3443
2007,Guinea,GIN,United States of America,USA,279,0,126,135,540
2007,Guyana,GUY,United States of America,USA,5,0,0,14,19
2007,Haiti,HTI,United States of America,USA,414,0,1530,2828,4772
2007,Honduras,HND,United States of America,USA,5,0,10,149,164
2007,Croatia,HRV,United States of America,USA,0,0,0,5,5
2007,Hungary,HUN,United States of America,USA,0,0,0,5,5
2007,Cote d'Ivoire,CIV,United States of America,USA,114,0,71,117,302
2007,India,IND,United States of America,USA,314,0,253,322,889
2007,Indonesia,IDN,United States of America,USA,180,0,388,268,836
2007,Iran (Islamic Rep. of),IRN,United States of America,USA,82,0,30,65,177
2007,Iraq,IRQ,United States of America,USA,63,0,35,39,137
2007,Israel,ISR,United States of America,USA,5,0,10,14,29
2007,Jamaica,JAM,United States of America,USA,0,0,0,32,32
2007,Jordan,JOR,United States of America,USA,5,0,18,18,41
2007,Japan,JPN,United States of America,USA,0,0,0,12,12
2007,Kazakhstan,KAZ,United States of America,USA,24,0,5,10,39
2007,Kenya,KEN,United States of America,USA,48,0,63,100,211
2007,Kyrgyzstan,KGZ,United States of America,USA,0,0,0,5,5
2007,Rep. of Korea,KOR,United States of America,USA,0,0,0,5,5
2007,Lao People's Dem. Rep.,LAO,United States of America,USA,5,0,10,26,41
2007,Liberia,LBR,United States of America,USA,36,0,32,101,169
2007,Lebanon,LBN,United States of America,USA,15,0,13,27,55
2007,Sri Lanka,LKA,United States of America,USA,65,0,16,14,95
2007,Lithuania,LTU,United States of America,USA,0,0,10,63,73
2007,Latvia,LVA,United States of America,USA,0,0,5,5,10
2007,Mauritania,MRT,United States of America,USA,157,0,129,135,421
2007,North Macedonia,MKD,United States of America,USA,13,0,5,5,23
2007,Rep. of Moldova,MDA,United States of America,USA,0,0,0,13,13
2007,Mexico,MEX,United States of America,USA,25,0,105,2657,2787
2007,Mali,MLI,United States of America,USA,51,0,30,76,157
2007,Malaysia,MYS,United States of America,USA,5,0,10,0,15
2007,Mongolia,MNG,United States of America,USA,43,0,28,13,84
2007,Morocco,MAR,United States of America,USA,5,0,0,5,10
2007,Myanmar,MMR,United States of America,USA,47,0,17,28,92
2007,Nepal,NPL,United States of America,USA,116,0,54,64,234
2007,Niger,NER,United States of America,USA,5,0,0,12,17
2007,Nicaragua,NIC,United States of America,USA,5,0,29,1424,1458
2007,Nigeria,NGA,United States of America,USA,18,0,17,59,94
2007,Pakistan,PAK,United States of America,USA,73,0,52,117,242
2007,Panama,PAN,United States of America,USA,0,0,5,0,5
2007,Paraguay,PRY,United States of America,USA,0,0,0,5,5
2007,Peru,PER,United States of America,USA,40,0,98,132,270
2007,Philippines,PHL,United States of America,USA,5,0,27,76,108
2007,Poland,POL,United States of America,USA,5,0,5,39,49
2007,Portugal,PRT,United States of America,USA,0,0,0,5,5
2007,Romania,ROU,United States of America,USA,12,0,5,163,180
2007,South Africa,ZAF,United States of America,USA,5,0,5,0,10
2007,Russian Federation,RUS,United States of America,USA,205,0,117,285,607
2007,Rwanda,RWA,United States of America,USA,0,0,0,13,13
2007,El Salvador,SLV,United States of America,USA,21,0,250,3458,3729
2007,Saudi Arabia,SAU,United States of America,USA,0,0,0,5,5
2007,Serbia and Kosovo: S/RES/1244 (1999),SRB,United States of America,USA,104,0,32,72,208
2007,Senegal,SEN,United States of America,USA,17,0,13,25,55
2007,Sierra Leone,SLE,United States of America,USA,42,0,47,69,158
2007,Somalia,SOM,United States of America,USA,42,0,32,60,134
2007,Spain,ESP,United States of America,USA,0,0,0,5,5
2007,Viet Nam,VNM,United States of America,USA,5,0,0,12,17
2007,Sudan,SDN,United States of America,USA,10,0,5,24,39
2007,Slovakia,SVK,United States of America,USA,0,0,0,5,5
2007,Sweden,SWE,United States of America,USA,0,0,0,5,5
2007,Syrian Arab Rep.,SYR,United States of America,USA,10,0,10,12,32
2007,United Rep. of Tanzania,TZA,United States of America,USA,5,0,10,10,25
2007,Thailand,THA,United States of America,USA,5,0,0,5,10
2007,Tajikistan,TJK,United States of America,USA,5,0,0,0,5
2007,Turkmenistan,TKM,United States of America,USA,12,0,5,5,22
2007,Togo,TGO,United States of America,USA,57,0,33,36,126
2007,Trinidad and Tobago,TTO,United States of America,USA,0,0,5,17,22
2007,Tunisia,TUN,United States of America,USA,0,0,0,5,5
2007,Turkey,TUR,United States of America,USA,14,0,0,10,24
2007,Uganda,UGA,United States of America,USA,30,0,11,19,60
2007,Ukraine,UKR,United States of America,USA,31,0,22,100,153
2007,Uruguay,URY,United States of America,USA,0,0,0,16,16
2007,Uzbekistan,UZB,United States of America,USA,59,0,32,72,163
2007,Venezuela (Bolivarian Republic of),VEN,United States of America,USA,269,0,407,434,1110
2007,Yemen,YEM,United States of America,USA,5,0,10,5,20
2007,Zambia,ZMB,United States of America,USA,0,0,0,5,5
2007,Zimbabwe,ZWE,United States of America,USA,50,0,40,45,135
2007,Stateless,XXA,United States of America,USA,60,0,14,20,94
2008,Afghanistan,AFG,United States of America,USA,10,0,0,5,15
2008,Albania,ALB,United States of America,USA,200,0,89,94,383
2008,Algeria,DZA,United States of America,USA,5,0,0,0,5
2008,Angola,AGO,United States of America,USA,5,0,0,0,5
2008,Egypt,EGY,United States of America,USA,153,0,29,61,243
2008,Argentina,ARG,United States of America,USA,5,0,10,22,37
2008,Armenia,ARM,United States of America,USA,115,0,66,126,307
2008,Azerbaijan,AZE,United States of America,USA,0,0,0,14,14
2008,Burundi,BDI,United States of America,USA,0,0,0,5,5
2008,Belgium,BEL,United States of America,USA,5,0,0,5,10
2008,Bangladesh,BGD,United States of America,USA,45,0,10,44,99
2008,Bahamas,BHS,United States of America,USA,0,0,0,5,5
2008,Burkina Faso,BFA,United States of America,USA,20,0,10,21,51
2008,Belarus,BLR,United States of America,USA,52,0,13,22,87
2008,Bolivia (Plurinational State of),BOL,United States of America,USA,0,0,0,13,13
2008,Brazil,BRA,United States of America,USA,18,0,19,64,101
2008,Bosnia and Herzegovina,BIH,United States of America,USA,5,0,0,5,10
2008,Bulgaria,BGR,United States of America,USA,35,0,10,27,72
2008,Cambodia,KHM,United States of America,USA,5,0,10,21,36
2008,Canada,CAN,United States of America,USA,0,0,0,11,11
2008,Central African Rep.,CAF,United States of America,USA,14,0,0,0,14
2008,Chad,TCD,United States of America,USA,15,0,5,5,25
2008,China,CHN,United States of America,USA,2132,0,966,1066,4164
2008,Chile,CHL,United States of America,USA,0,0,0,5,5
2008,Cameroon,CMR,United States of America,USA,117,0,78,99,294
2008,Congo,COG,United States of America,USA,46,0,22,32,100
2008,Dem. Rep. of the Congo,COD,United States of America,USA,11,0,10,5,26
2008,Colombia,COL,United States of America,USA,467,0,666,843,1976
2008,Costa Rica,CRI,United States of America,USA,0,0,0,10,10
2008,Cuba,CUB,United States of America,USA,0,0,5,67,72
2008,Czechia,CZE,United States of America,USA,5,0,0,18,23
2008,Dominican Rep.,DOM,United States of America,USA,0,0,0,5,5
2008,Ecuador,ECU,United States of America,USA,5,0,11,27,43
2008,Eritrea,ERI,United States of America,USA,34,0,11,14,59
2008,Estonia,EST,United States of America,USA,0,0,0,14,14
2008,Ethiopia,ETH,United States of America,USA,214,0,99,79,392
2008,Fiji,FJI,United States of America,USA,17,0,10,43,70
2008,France,FRA,United States of America,USA,0,0,0,5,5
2008,Gambia,GMB,United States of America,USA,43,0,39,85,167
2008,United Kingdom of Great Britain and Northern Ireland,GBR,United States of America,USA,5,0,5,12,22
2008,Georgia,GEO,United States of America,USA,17,0,17,16,50
2008,Ghana,GHA,United States of America,USA,5,0,5,14,24
2008,Guinea-Bissau,GNB,United States of America,USA,5,0,0,0,5
2008,Guatemala,GTM,United States of America,USA,89,0,684,2242,3015
2008,Guinea,GIN,United States of America,USA,208,0,117,113,438
2008,Guyana,GUY,United States of America,USA,0,0,5,13,18
2008,Haiti,HTI,United States of America,USA,375,0,1402,1917,3694
2008,Honduras,HND,United States of America,USA,5,0,22,112,139
2008,Hungary,HUN,United States of America,USA,0,0,0,10,10
2008,Cote d'Ivoire,CIV,United States of America,USA,83,0,61,95,239
2008,India,IND,United States of America,USA,225,0,189,222,636
2008,Indonesia,IDN,United States of America,USA,171,0,311,204,686
2008,Iran (Islamic Rep. of),IRN,United States of America,USA,51,0,14,57,122
2008,Iraq,IRQ,United States of America,USA,92,0,16,32,140
2008,Israel,ISR,United States of America,USA,14,0,5,10,29
2008,Jamaica,JAM,United States of America,USA,0,0,5,14,19
2008,Jordan,JOR,United States of America,USA,13,0,17,22,52
2008,Japan,JPN,United States of America,USA,0,0,0,10,10
2008,Kazakhstan,KAZ,United States of America,USA,13,0,5,5,23
2008,Kenya,KEN,United States of America,USA,48,0,39,95,182
2008,Kyrgyzstan,KGZ,United States of America,USA,5,0,0,0,5
2008,Dem. People's Rep. of Korea,PRK,United States of America,USA,5,0,0,5,10
2008,Lao People's Dem. Rep.,LAO,United States of America,USA,5,0,5,13,23
2008,Liberia,LBR,United States of America,USA,26,0,15,53,94
2008,Lebanon,LBN,United States of America,USA,12,0,20,26,58
2008,Sri Lanka,LKA,United States of America,USA,58,0,19,26,103
2008,Lithuania,LTU,United States of America,USA,0,0,10,21,31
2008,Latvia,LVA,United States of America,USA,0,0,0,11,11
2008,Mauritania,MRT,United States of America,USA,76,0,91,61,228
2008,North Macedonia,MKD,United States of America,USA,5,0,5,5,15
2008,Rep. of Moldova,MDA,United States of America,USA,13,0,5,24,42
2008,Mexico,MEX,United States of America,USA,38,0,69,2004,2111
2008,Mali,MLI,United States of America,USA,23,0,43,71,137
2008,Malaysia,MYS,United States of America,USA,0,0,5,0,5
2008,Malawi,MWI,United States of America,USA,0,0,0,5,5
2008,Mongolia,MNG,United States of America,USA,33,0,15,25,73
2008,Morocco,MAR,United States of America,USA,14,0,5,10,29
2008,Myanmar,MMR,United States of America,USA,26,0,10,10,46
2008,Nepal,NPL,United States of America,USA,128,0,53,45,226
2008,Niger,NER,United States of America,USA,0,0,5,11,16
2008,Nicaragua,NIC,United States of America,USA,5,0,32,274,311
2008,Nigeria,NGA,United States of America,USA,14,0,22,45,81
2008,Pakistan,PAK,United States of America,USA,70,0,32,83,185
2008,Paraguay,PRY,United States of America,USA,0,0,0,5,5
2008,Peru,PER,United States of America,USA,38,0,44,107,189
2008,Philippines,PHL,United States of America,USA,11,0,5,56,72
2008,Poland,POL,United States of America,USA,5,0,5,42,52
2008,Portugal,PRT,United States of America,USA,0,0,0,5,5
2008,Romania,ROU,United States of America,USA,18,0,5,32,55
2008,South Africa,ZAF,United States of America,USA,0,0,12,5,17
2008,Russian Federation,RUS,United States of America,USA,319,0,110,318,747
2008,Rwanda,RWA,United States of America,USA,14,0,0,0,14
2008,El Salvador,SLV,United States of America,USA,33,0,274,3147,3454
2008,Serbia and Kosovo: S/RES/1244 (1999),SRB,United States of America,USA,117,0,30,66,213
2008,Senegal,SEN,United States of America,USA,10,0,16,20,46
2008,Sierra Leone,SLE,United States of America,USA,43,0,47,39,129
2008,Somalia,SOM,United States of America,USA,24,0,23,52,99
2008,Viet Nam,VNM,United States of America,USA,5,0,5,15,25
2008,Sudan,SDN,United States of America,USA,17,0,10,20,47
2008,Slovakia,SVK,United States of America,USA,0,0,0,5,5
2008,Syrian Arab Rep.,SYR,United States of America,USA,5,0,10,12,27
2008,United Rep. of Tanzania,TZA,United States of America,USA,0,0,14,0,14
2008,Turkmenistan,TKM,United States of America,USA,10,0,0,0,10
2008,Togo,TGO,United States of America,USA,41,0,22,19,82
2008,Tonga,TON,United States of America,USA,0,0,0,5,5
2008,Trinidad and Tobago,TTO,United States of America,USA,0,0,0,5,5
2008,Turkey,TUR,United States of America,USA,5,0,0,10,15
2008,Uganda,UGA,United States of America,USA,17,0,5,16,38
2008,Ukraine,UKR,United States of America,USA,46,0,22,67,135
2008,Uruguay,URY,United States of America,USA,0,0,0,5,5
2008,Uzbekistan,UZB,United States of America,USA,51,0,31,52,134
2008,Venezuela (Bolivarian Republic of),VEN,United States of America,USA,260,0,315,287,862
2008,Yemen,YEM,United States of America,USA,5,0,12,5,22
2008,Zambia,ZMB,United States of America,USA,0,0,5,0,5
2008,Zimbabwe,ZWE,United States of America,USA,40,0,31,54,125
2008,Stateless,XXA,United States of America,USA,37,0,17,20,74
2009,Afghanistan,AFG,United States of America,USA,10,0,5,20,35
2009,Albania,ALB,United States of America,USA,211,0,121,122,454
2009,Algeria,DZA,United States of America,USA,5,0,13,18,36
2009,Angola,AGO,United States of America,USA,5,0,5,17,27
2009,Egypt,EGY,United States of America,USA,173,0,58,111,342
2009,Argentina,ARG,United States of America,USA,10,0,13,47,70
2009,Armenia,ARM,United States of America,USA,196,0,98,224,518
2009,Azerbaijan,AZE,United States of America,USA,14,0,5,23,42
2009,Burundi,BDI,United States of America,USA,16,0,10,5,31
2009,Belgium,BEL,United States of America,USA,5,0,5,12,22
2009,Benin,BEN,United States of America,USA,5,0,5,5,15
2009,Bangladesh,BGD,United States of America,USA,47,0,52,111,210
2009,Bahamas,BHS,United States of America,USA,0,0,5,5,10
2009,Bhutan,BTN,United States of America,USA,5,0,0,5,10
2009,Burkina Faso,BFA,United States of America,USA,40,0,5,30,75
2009,Belarus,BLR,United States of America,USA,73,0,18,61,152
2009,Bolivia (Plurinational State of),BOL,United States of America,USA,0,0,10,15,25
2009,Brazil,BRA,United States of America,USA,22,0,65,95,182
2009,Bosnia and Herzegovina,BIH,United States of America,USA,17,0,12,28,57
2009,Bulgaria,BGR,United States of America,USA,42,0,21,59,122
2009,Belize,BLZ,United States of America,USA,0,0,14,0,14
2009,Cambodia,KHM,United States of America,USA,12,0,30,22,64
2009,Canada,CAN,United States of America,USA,11,0,5,11,27
2009,Central African Rep.,CAF,United States of America,USA,15,0,10,18,43
2009,Chad,TCD,United States of America,USA,40,0,10,30,80
2009,China,CHN,United States of America,USA,3419,0,1660,2094,7173
2009,Chile,CHL,United States of America,USA,5,0,5,10,20
2009,Cameroon,CMR,United States of America,USA,203,0,84,144,431
2009,Congo,COG,United States of America,USA,48,0,24,74,146
2009,Dem. Rep. of the Congo,COD,United States of America,USA,19,0,13,10,42
2009,Colombia,COL,United States of America,USA,356,0,506,714,1576
2009,Costa Rica,CRI,United States of America,USA,0,0,5,13,18
2009,Cuba,CUB,United States of America,USA,15,0,99,226,340
2009,Czechia,CZE,United States of America,USA,0,0,5,13,18
2009,Djibouti,DJI,United States of America,USA,5,0,0,5,10
2009,Dominica,DMA,United States of America,USA,0,0,0,5,5
2009,Dominican Rep.,DOM,United States of America,USA,5,0,26,30,61
2009,Ecuador,ECU,United States of America,USA,5,0,28,95,128
2009,Eritrea,ERI,United States of America,USA,196,0,23,57,276
2009,Estonia,EST,United States of America,USA,10,0,10,23,43
2009,Ethiopia,ETH,United States of America,USA,409,0,112,171,692
2009,Fiji,FJI,United States of America,USA,29,0,24,28,81
2009,Finland,FIN,United States of America,USA,0,0,0,11,11
2009,France,FRA,United States of America,USA,0,0,5,13,18
2009,Gambia,GMB,United States of America,USA,49,0,53,95,197
2009,United Kingdom of Great Britain and Northern Ireland,GBR,United States of America,USA,5,0,15,17,37
2009,Georgia,GEO,United States of America,USA,24,0,28,56,108
2009,Germany,DEU,United States of America,USA,0,0,12,13,25
2009,Ghana,GHA,United States of America,USA,10,0,27,31,68
2009,Guinea-Bissau,GNB,United States of America,USA,5,0,0,5,10
2009,Grenada,GRD,United States of America,USA,0,0,0,5,5
2009,Guatemala,GTM,United States of America,USA,155,0,1156,3417,4728
2009,Guinea,GIN,United States of America,USA,193,0,98,152,443
2009,Guyana,GUY,United States of America,USA,0,0,23,40,63
2009,Haiti,HTI,United States of America,USA,406,0,1589,1262,3257
2009,"China, Hong Kong SAR",HKG,United States of America,USA,0,0,5,0,5
2009,Honduras,HND,United States of America,USA,46,0,400,425,871
2009,Croatia,HRV,United States of America,USA,0,0,5,5,10
2009,Hungary,HUN,United States of America,USA,0,0,0,13,13
2009,Cote d'Ivoire,CIV,United States of America,USA,96,0,66,160,322
2009,India,IND,United States of America,USA,260,0,232,372,864
2009,Indonesia,IDN,United States of America,USA,155,0,335,346,836
2009,Iran (Islamic Rep. of),IRN,United States of America,USA,91,0,48,136,275
2009,Iraq,IRQ,United States of America,USA,364,0,49,93,506
2009,Israel,ISR,United States of America,USA,17,0,18,40,75
2009,Italy,ITA,United States of America,USA,0,0,10,10,20
2009,Jamaica,JAM,United States of America,USA,0,0,81,64,145
2009,Jordan,JOR,United States of America,USA,20,0,38,61,119
2009,Japan,JPN,United States of America,USA,0,0,0,14,14
2009,Kazakhstan,KAZ,United States of America,USA,20,0,10,24,54
2009,Kenya,KEN,United States of America,USA,94,0,94,125,313
2009,Kyrgyzstan,KGZ,United States of America,USA,5,0,5,23,33
2009,Rep. of Korea,KOR,United States of America,USA,0,0,5,26,31
2009,Dem. People's Rep. of Korea,PRK,United States of America,USA,0,0,5,5,10
2009,Kuwait,KWT,United States of America,USA,5,0,0,13,18
2009,Lao People's Dem. Rep.,LAO,United States of America,USA,13,0,26,38,77
2009,Liberia,LBR,United States of America,USA,31,0,55,110,196
2009,Libya,LBY,United States of America,USA,5,0,0,5,10
2009,Lebanon,LBN,United States of America,USA,10,0,45,67,122
2009,Sri Lanka,LKA,United States of America,USA,112,0,61,98,271
2009,Lithuania,LTU,United States of America,USA,0,0,5,20,25
2009,Latvia,LVA,United States of America,USA,5,0,0,12,17
2009,Madagascar,MDG,United States of America,USA,5,0,0,0,5
2009,Mauritania,MRT,United States of America,USA,94,0,44,242,380
2009,North Macedonia,MKD,United States of America,USA,15,0,15,10,40
2009,Rep. of Moldova,MDA,United States of America,USA,22,0,17,81,120
2009,Mexico,MEX,United States of America,USA,62,0,366,2974,3402
2009,Mali,MLI,United States of America,USA,71,0,64,136,271
2009,Malaysia,MYS,United States of America,USA,0,0,12,14,26
2009,Malawi,MWI,United States of America,USA,0,0,5,12,17
2009,Mongolia,MNG,United States of America,USA,28,0,43,55,126
2009,Morocco,MAR,United States of America,USA,5,0,12,23,40
2009,Montenegro,MNE,United States of America,USA,47,0,15,16,78
2009,Myanmar,MMR,United States of America,USA,108,0,23,42,173
2009,Namibia,NAM,United States of America,USA,0,0,5,0,5
2009,Nepal,NPL,United States of America,USA,171,0,81,82,334
2009,Netherlands,NLD,United States of America,USA,0,0,5,0,5
2009,Niger,NER,United States of America,USA,14,0,14,39,67
2009,Nicaragua,NIC,United States of America,USA,19,0,135,196,350
2009,Nigeria,NGA,United States of America,USA,29,0,73,92,194
2009,Oman,OMN,United States of America,USA,0,0,0,5,5
2009,Pakistan,PAK,United States of America,USA,99,0,114,242,455
2009,Panama,PAN,United States of America,USA,0,0,0,12,12
2009,Paraguay,PRY,United States of America,USA,5,0,0,5,10
2009,Peru,PER,United States of America,USA,39,0,82,94,215
2009,Philippines,PHL,United States of America,USA,13,0,57,91,161
2009,Poland,POL,United States of America,USA,5,0,17,48,70
2009,Portugal,PRT,United States of America,USA,0,0,0,5,5
2009,Romania,ROU,United States of America,USA,30,0,31,57,118
2009,South Africa,ZAF,United States of America,USA,0,0,11,12,23
2009,Russian Federation,RUS,United States of America,USA,280,0,150,502,932
2009,Rwanda,RWA,United States of America,USA,24,0,5,24,53
2009,El Salvador,SLV,United States of America,USA,117,0,1236,4426,5779
2009,Saudi Arabia,SAU,United States of America,USA,5,0,0,0,5
2009,Serbia and Kosovo: S/RES/1244 (1999),SRB,United States of America,USA,108,0,41,47,196
2009,Senegal,SEN,United States of America,USA,24,0,30,70,124
2009,Singapore,SGP,United States of America,USA,5,0,0,0,5
2009,Sierra Leone,SLE,United States of America,USA,29,0,38,103,170
2009,Somalia,SOM,United States of America,USA,167,0,40,94,301
2009,Spain,ESP,United States of America,USA,0,0,0,5,5
2009,Viet Nam,VNM,United States of America,USA,10,0,31,39,80
2009,Sudan,SDN,United States of America,USA,40,0,33,53,126
2009,Slovakia,SVK,United States of America,USA,0,0,0,13,13
2009,Slovenia,SVN,United States of America,USA,0,0,0,5,5
2009,Sweden,SWE,United States of America,USA,5,0,0,5,10
2009,Syrian Arab Rep.,SYR,United States of America,USA,15,0,12,44,71
2009,United Rep. of Tanzania,TZA,United States of America,USA,5,0,10,19,34
2009,Thailand,THA,United States of America,USA,0,0,10,11,21
2009,Tajikistan,TJK,United States of America,USA,5,0,0,15,20
2009,Turkmenistan,TKM,United States of America,USA,14,0,5,17,36
2009,Togo,TGO,United States of America,USA,39,0,23,90,152
2009,Tonga,TON,United States of America,USA,0,0,0,5,5
2009,Trinidad and Tobago,TTO,United States of America,USA,0,0,18,18,36
2009,Tunisia,TUN,United States of America,USA,0,0,5,12,17
2009,Turkey,TUR,United States of America,USA,17,0,10,28,55
2009,United Arab Emirates,ARE,United States of America,USA,0,0,0,5,5
2009,Uganda,UGA,United States of America,USA,28,0,21,25,74
2009,Ukraine,UKR,United States of America,USA,26,0,56,126,208
2009,Uruguay,URY,United States of America,USA,0,0,0,10,10
2009,Uzbekistan,UZB,United States of America,USA,64,0,48,95,207
2009,Saint Vincent and the Grenadines,VCT,United States of America,USA,0,0,5,0,5
2009,Venezuela (Bolivarian Republic of),VEN,United States of America,USA,191,0,295,356,842
2009,Yemen,YEM,United States of America,USA,5,0,10,23,38
2009,Zambia,ZMB,United States of America,USA,5,0,11,0,16
2009,Zimbabwe,ZWE,United States of America,USA,69,0,51,90,210
2009,Stateless,XXA,United States of America,USA,82,0,20,74,176
2010,Afghanistan,AFG,United States of America,USA,5,0,10,24,39
2010,Albania,ALB,United States of America,USA,148,0,104,94,346
2010,Algeria,DZA,United States of America,USA,0,0,0,13,13
2010,Angola,AGO,United States of America,USA,0,0,11,5,16
2010,Egypt,EGY,United States of America,USA,216,0,40,146,402
2010,Argentina,ARG,United States of America,USA,10,0,13,33,56
2010,Armenia,ARM,United States of America,USA,206,0,99,226,531
2010,Australia,AUS,United States of America,USA,0,0,5,5,10
2010,Austria,AUT,United States of America,USA,0,0,0,5,5
2010,Azerbaijan,AZE,United States of America,USA,10,0,10,22,42
2010,Bahrain,BHR,United States of America,USA,0,0,0,11,11
2010,Burundi,BDI,United States of America,USA,5,0,0,13,18
2010,Belgium,BEL,United States of America,USA,5,0,5,11,21
2010,Benin,BEN,United States of America,USA,0,0,0,13,13
2010,Bangladesh,BGD,United States of America,USA,48,0,27,121,196
2010,Bahamas,BHS,United States of America,USA,0,0,5,13,18
2010,Bhutan,BTN,United States of America,USA,0,0,0,5,5
2010,Burkina Faso,BFA,United States of America,USA,49,0,15,27,91
2010,Belarus,BLR,United States of America,USA,67,0,27,58,152
2010,Bolivia (Plurinational State of),BOL,United States of America,USA,10,0,5,18,33
2010,Brazil,BRA,United States of America,USA,17,0,58,94,169
2010,Bosnia and Herzegovina,BIH,United States of America,USA,5,0,16,14,35
2010,Bulgaria,BGR,United States of America,USA,20,0,16,36,72
2010,Belize,BLZ,United States of America,USA,0,0,14,11,25
2010,Cambodia,KHM,United States of America,USA,13,0,15,34,62
2010,Canada,CAN,United States of America,USA,5,0,5,12,22
2010,Central African Rep.,CAF,United States of America,USA,10,0,5,5,20
2010,Chad,TCD,United States of America,USA,28,0,5,12,45
2010,China,CHN,United States of America,USA,3796,0,1523,2079,7398
2010,Chile,CHL,United States of America,USA,0,0,5,15,20
2010,Cameroon,CMR,United States of America,USA,196,0,57,128,381
2010,Congo,COG,United States of America,USA,56,0,25,38,119
2010,Dem. Rep. of the Congo,COD,United States of America,USA,16,0,29,26,71
2010,Comoros,COM,United States of America,USA,0,0,5,0,5
2010,Colombia,COL,United States of America,USA,234,0,380,581,1195
2010,Costa Rica,CRI,United States of America,USA,0,0,5,11,16
2010,Cuba,CUB,United States of America,USA,10,0,105,221,336
2010,Czechia,CZE,United States of America,USA,0,0,12,5,17
2010,Djibouti,DJI,United States of America,USA,0,0,5,5,10
2010,Dominica,DMA,United States of America,USA,0,0,0,5,5
2010,Dominican Rep.,DOM,United States of America,USA,11,0,30,36,77
2010,Ecuador,ECU,United States of America,USA,5,0,64,92,161
2010,Eritrea,ERI,United States of America,USA,179,0,29,57,265
2010,Estonia,EST,United States of America,USA,0,0,12,0,12
2010,Ethiopia,ETH,United States of America,USA,407,0,106,159,672
2010,Fiji,FJI,United States of America,USA,18,0,15,32,65
2010,France,FRA,United States of America,USA,0,0,0,15,15
2010,Gabon,GAB,United States of America,USA,0,0,0,5,5
2010,Gambia,GMB,United States of America,USA,42,0,41,90,173
2010,Palestinian,PSE,United States of America,USA,0,0,5,0,5
2010,United Kingdom of Great Britain and Northern Ireland,GBR,United States of America,USA,0,0,5,20,25
2010,Georgia,GEO,United States of America,USA,32,0,17,36,85
2010,Germany,DEU,United States of America,USA,11,0,15,23,49
2010,Ghana,GHA,United States of America,USA,10,0,30,28,68
2010,Guinea-Bissau,GNB,United States of America,USA,0,0,5,0,5
2010,Greece,GRC,United States of America,USA,0,0,5,5,10
2010,Guatemala,GTM,United States of America,USA,166,0,1004,2527,3697
2010,Guinea,GIN,United States of America,USA,186,0,76,143,405
2010,Guyana,GUY,United States of America,USA,5,0,12,42,59
2010,Haiti,HTI,United States of America,USA,167,0,496,2717,3380
2010,Honduras,HND,United States of America,USA,65,0,364,416,845
2010,Croatia,HRV,United States of America,USA,5,0,0,0,5
2010,Hungary,HUN,United States of America,USA,0,0,10,17,27
2010,Cote d'Ivoire,CIV,United States of America,USA,66,0,44,92,202
2010,India,IND,United States of America,USA,241,0,224,385,850
2010,Indonesia,IDN,United States of America,USA,116,0,293,315,724
2010,Ireland,IRL,United States of America,USA,0,0,0,5,5
2010,Iran (Islamic Rep. of),IRN,United States of America,USA,83,0,46,130,259
2010,Iraq,IRQ,United States of America,USA,149,0,46,64,259
2010,Israel,ISR,United States of America,USA,10,0,17,19,46
2010,Italy,ITA,United States of America,USA,5,0,14,0,19
2010,Jamaica,JAM,United States of America,USA,5,0,79,69,153
2010,Jordan,JOR,United States of America,USA,19,0,30,55,104
2010,Japan,JPN,United States of America,USA,0,0,5,0,5
2010,Kazakhstan,KAZ,United States of America,USA,17,0,12,28,57
2010,Kenya,KEN,United States of America,USA,90,0,116,135,341
2010,Kyrgyzstan,KGZ,United States of America,USA,10,0,5,23,38
2010,Rep. of Korea,KOR,United States of America,USA,5,0,15,28,48
2010,Dem. People's Rep. of Korea,PRK,United States of America,USA,0,0,0,5,5
2010,Kuwait,KWT,United States of America,USA,0,0,5,12,17
2010,Lao People's Dem. Rep.,LAO,United States of America,USA,5,0,18,38,61
2010,Liberia,LBR,United States of America,USA,25,0,45,95,165
2010,Libya,LBY,United States of America,USA,5,0,0,5,10
2010,Saint Lucia,LCA,United States of America,USA,0,0,0,5,5
2010,Lebanon,LBN,United States of America,USA,26,0,41,55,122
2010,Sri Lanka,LKA,United States of America,USA,111,0,51,65,227
2010,Lithuania,LTU,United States of America,USA,0,0,10,18,28
2010,Latvia,LVA,United States of America,USA,0,0,5,0,5
2010,Mauritania,MRT,United States of America,USA,59,0,47,75,181
2010,North Macedonia,MKD,United States of America,USA,11,0,5,15,31
2010,Rep. of Moldova,MDA,United States of America,USA,46,0,34,119,199
2010,Mexico,MEX,United States of America,USA,49,0,508,2516,3073
2010,Mali,MLI,United States of America,USA,74,0,50,97,221
2010,Malaysia,MYS,United States of America,USA,12,0,5,5,22
2010,Mongolia,MNG,United States of America,USA,50,0,33,59,142
2010,Morocco,MAR,United States of America,USA,5,0,18,20,43
2010,Myanmar,MMR,United States of America,USA,80,0,20,55,155
2010,Namibia,NAM,United States of America,USA,0,0,0,10,10
2010,Nepal,NPL,United States of America,USA,230,0,109,103,442
2010,Netherlands,NLD,United States of America,USA,11,0,0,0,11
2010,Niger,NER,United States of America,USA,5,0,13,21,39
2010,Nicaragua,NIC,United States of America,USA,15,0,106,145,266
2010,Nigeria,NGA,United States of America,USA,35,0,70,84,189
2010,Niue,NIU,United States of America,USA,0,0,0,5,5
2010,Norway,NOR,United States of America,USA,0,0,5,0,5
2010,New Zealand,NZL,United States of America,USA,0,0,5,0,5
2010,Pakistan,PAK,United States of America,USA,113,0,123,207,443
2010,Panama,PAN,United States of America,USA,0,0,0,5,5
2010,Paraguay,PRY,United States of America,USA,0,0,5,5,10
2010,Peru,PER,United States of America,USA,25,0,93,124,242
2010,Philippines,PHL,United States of America,USA,5,0,48,134,187
2010,Poland,POL,United States of America,USA,0,0,21,34,55
2010,Portugal,PRT,United States of America,USA,0,0,5,5,10
2010,Romania,ROU,United States of America,USA,27,0,20,47,94
2010,South Africa,ZAF,United States of America,USA,0,0,14,12,26
2010,Russian Federation,RUS,United States of America,USA,335,0,147,420,902
2010,Rwanda,RWA,United States of America,USA,25,0,5,17,47
2010,El Salvador,SLV,United States of America,USA,146,0,1103,3138,4387
2010,Saudi Arabia,SAU,United States of America,USA,5,0,0,0,5
2010,Serbia and Kosovo: S/RES/1244 (1999),SRB,United States of America,USA,114,0,39,57,210
2010,Senegal,SEN,United States of America,USA,18,0,28,61,107
2010,Seychelles,SYC,United States of America,USA,0,0,0,5,5
2010,Singapore,SGP,United States of America,USA,0,0,0,5,5
2010,Sierra Leone,SLE,United States of America,USA,27,0,48,49,124
2010,Somalia,SOM,United States of America,USA,208,0,57,117,382
2010,Spain,ESP,United States of America,USA,0,0,5,5,10
2010,Viet Nam,VNM,United States of America,USA,10,0,27,62,99
2010,Saint Kitts and Nevis,KNA,United States of America,USA,0,0,0,5,5
2010,Sudan,SDN,United States of America,USA,35,0,25,42,102
2010,Suriname,SUR,United States of America,USA,0,0,0,10,10
2010,Slovakia,SVK,United States of America,USA,0,0,5,5,10
2010,Slovenia,SVN,United States of America,USA,0,0,0,5,5
2010,Sweden,SWE,United States of America,USA,0,0,0,5,5
2010,Switzerland,CHE,United States of America,USA,0,0,5,0,5
2010,Syrian Arab Rep.,SYR,United States of America,USA,13,0,17,41,71
2010,United Rep. of Tanzania,TZA,United States of America,USA,5,0,10,11,26
2010,Thailand,THA,United States of America,USA,5,0,0,24,29
2010,Tajikistan,TJK,United States of America,USA,10,0,5,13,28
2010,Turkmenistan,TKM,United States of America,USA,5,0,5,5,15
2010,Togo,TGO,United States of America,USA,45,0,20,47,112
2010,Tonga,TON,United States of America,USA,0,0,5,18,23
2010,Trinidad and Tobago,TTO,United States of America,USA,0,0,10,28,38
2010,Tunisia,TUN,United States of America,USA,0,0,0,12,12
2010,Turkey,TUR,United States of America,USA,12,0,30,29,71
2010,Uganda,UGA,United States of America,USA,26,0,22,18,66
2010,Ukraine,UKR,United States of America,USA,62,0,64,116,242
2010,Uruguay,URY,United States of America,USA,0,0,0,17,17
2010,Uzbekistan,UZB,United States of America,USA,54,0,54,101,209
2010,Saint Vincent and the Grenadines,VCT,United States of America,USA,0,0,0,5,5
2010,Venezuela (Bolivarian Republic of),VEN,United States of America,USA,181,0,207,290,678
2010,Samoa,WSM,United States of America,USA,0,0,0,5,5
2010,Yemen,YEM,United States of America,USA,5,0,12,28,45
2010,Zambia,ZMB,United States of America,USA,5,0,0,13,18
2010,Zimbabwe,ZWE,United States of America,USA,52,0,48,54,154
2010,Stateless,XXA,United States of America,USA,85,0,22,48,155
2011,Afghanistan,AFG,United States of America,USA,19,0,25,29,73
2011,Albania,ALB,United States of America,USA,136,0,67,78,281
2011,Algeria,DZA,United States of America,USA,5,0,15,10,30
2011,Angola,AGO,United States of America,USA,0,0,0,13,13
2011,Antigua and Barbuda,ATG,United States of America,USA,0,0,0,5,5
2011,Egypt,EGY,United States of America,USA,335,0,43,121,499
2011,Argentina,ARG,United States of America,USA,10,0,5,27,42
2011,Armenia,ARM,United States of America,USA,143,0,63,158,364
2011,Australia,AUS,United States of America,USA,0,0,0,5,5
2011,Azerbaijan,AZE,United States of America,USA,12,0,10,25,47
2011,Barbados,BRB,United States of America,USA,0,0,0,5,5
2011,Burundi,BDI,United States of America,USA,10,0,10,5,25
2011,Belgium,BEL,United States of America,USA,5,0,0,14,19
2011,Benin,BEN,United States of America,USA,12,0,0,0,12
2011,Bangladesh,BGD,United States of America,USA,47,0,50,159,256
2011,Bahamas,BHS,United States of America,USA,0,0,14,10,24
2011,Bhutan,BTN,United States of America,USA,0,0,0,14,14
2011,Burkina Faso,BFA,United States of America,USA,40,0,17,27,84
2011,Belarus,BLR,United States of America,USA,86,0,17,50,153
2011,Bolivia (Plurinational State of),BOL,United States of America,USA,11,0,5,24,40
2011,Botswana,BWA,United States of America,USA,0,0,0,5,5
2011,Brazil,BRA,United States of America,USA,22,0,60,118,200
2011,Bosnia and Herzegovina,BIH,United States of America,USA,5,0,19,21,45
2011,Bulgaria,BGR,United States of America,USA,23,0,16,41,80
2011,Belize,BLZ,United States of America,USA,5,0,15,5,25
2011,Cambodia,KHM,United States of America,USA,10,0,13,18,41
2011,Canada,CAN,United States of America,USA,11,0,12,12,35
2011,Central African Rep.,CAF,United States of America,USA,5,0,10,11,26
2011,Chad,TCD,United States of America,USA,19,0,5,10,34
2011,China,CHN,United States of America,USA,5084,0,1820,2225,9129
2011,Chile,CHL,United States of America,USA,0,0,11,5,16
2011,Cameroon,CMR,United States of America,USA,198,0,47,127,372
2011,Congo,COG,United States of America,USA,60,0,22,42,124
2011,Dem. Rep. of the Congo,COD,United States of America,USA,13,0,16,21,50
2011,Colombia,COL,United States of America,USA,193,0,217,401,811
2011,Costa Rica,CRI,United States of America,USA,0,0,14,0,14
2011,Cuba,CUB,United States of America,USA,13,0,82,187,282
2011,Czechia,CZE,United States of America,USA,0,0,0,12,12
2011,Djibouti,DJI,United States of America,USA,5,0,0,14,19
2011,Dominica,DMA,United States of America,USA,0,0,5,0,5
2011,Dominican Rep.,DOM,United States of America,USA,10,0,52,88,150
2011,Ecuador,ECU,United States of America,USA,19,0,55,180,254
2011,Equatorial Guinea,GNQ,United States of America,USA,0,0,0,5,5
2011,Eritrea,ERI,United States of America,USA,508,0,64,113,685
2011,Estonia,EST,United States of America,USA,0,0,0,10,10
2011,Ethiopia,ETH,United States of America,USA,522,0,87,137,746
2011,Fiji,FJI,United States of America,USA,5,0,21,27,53
2011,France,FRA,United States of America,USA,5,0,0,13,18
2011,Gabon,GAB,United States of America,USA,5,0,5,10,20
2011,Gambia,GMB,United States of America,USA,58,0,46,85,189
2011,Palestinian,PSE,United States of America,USA,0,0,0,5,5
2011,United Kingdom of Great Britain and Northern Ireland,GBR,United States of America,USA,5,0,11,22,38
2011,Georgia,GEO,United States of America,USA,31,0,14,29,74
2011,Germany,DEU,United States of America,USA,5,0,14,26,45
2011,Ghana,GHA,United States of America,USA,10,0,27,31,68
2011,Guinea-Bissau,GNB,United States of America,USA,0,0,5,5,10
2011,Greece,GRC,United States of America,USA,0,0,11,0,11
2011,Guatemala,GTM,United States of America,USA,182,0,985,2119,3286
2011,Guinea,GIN,United States of America,USA,176,0,105,161,442
2011,Guyana,GUY,United States of America,USA,5,0,32,35,72
2011,Haiti,HTI,United States of America,USA,61,0,158,845,1064
2011,"China, Hong Kong SAR",HKG,United States of America,USA,0,0,0,5,5
2011,Honduras,HND,United States of America,USA,83,0,474,523,1080
2011,Croatia,HRV,United States of America,USA,5,0,0,12,17
2011,Hungary,HUN,United States of America,USA,5,0,5,30,40
2011,Cote d'Ivoire,CIV,United States of America,USA,78,0,77,128,283
2011,India,IND,United States of America,USA,287,0,353,1070,1710
2011,Indonesia,IDN,United States of America,USA,107,0,197,218,522
2011,Ireland,IRL,United States of America,USA,0,0,0,5,5
2011,Iran (Islamic Rep. of),IRN,United States of America,USA,112,0,51,114,277
2011,Iraq,IRQ,United States of America,USA,115,0,55,60,230
2011,Israel,ISR,United States of America,USA,15,0,11,32,58
2011,Italy,ITA,United States of America,USA,11,0,5,0,16
2011,Jamaica,JAM,United States of America,USA,10,0,169,132,311
2011,Jordan,JOR,United States of America,USA,12,0,23,43,78
2011,Japan,JPN,United States of America,USA,0,0,0,5,5
2011,Kazakhstan,KAZ,United States of America,USA,15,0,14,31,60
2011,Kenya,KEN,United States of America,USA,90,0,115,107,312
2011,Kyrgyzstan,KGZ,United States of America,USA,24,0,19,47,90
2011,Rep. of Korea,KOR,United States of America,USA,5,0,14,29,48
2011,Kuwait,KWT,United States of America,USA,12,0,0,0,12
2011,Lao People's Dem. Rep.,LAO,United States of America,USA,0,0,20,20,40
2011,Liberia,LBR,United States of America,USA,22,0,46,123,191
2011,Libya,LBY,United States of America,USA,0,0,0,17,17
2011,Lebanon,LBN,United States of America,USA,32,0,29,47,108
2011,Sri Lanka,LKA,United States of America,USA,89,0,81,116,286
2011,Lithuania,LTU,United States of America,USA,11,0,0,0,11
2011,Latvia,LVA,United States of America,USA,5,0,5,12,22
2011,Mauritania,MRT,United States of America,USA,55,0,53,72,180
2011,North Macedonia,MKD,United States of America,USA,10,0,5,10,25
2011,Monaco,MCO,United States of America,USA,5,0,0,0,5
2011,Rep. of Moldova,MDA,United States of America,USA,69,0,63,94,226
2011,Mexico,MEX,United States of America,USA,107,0,1210,2961,4278
2011,Mali,MLI,United States of America,USA,85,0,38,100,223
2011,Malaysia,MYS,United States of America,USA,0,0,5,15,20
2011,Malawi,MWI,United States of America,USA,0,0,0,5,5
2011,Mongolia,MNG,United States of America,USA,51,0,88,98,237
2011,Morocco,MAR,United States of America,USA,5,0,10,26,41
2011,Mauritius,MUS,United States of America,USA,0,0,0,5,5
2011,Myanmar,MMR,United States of America,USA,72,0,22,29,123
2011,Namibia,NAM,United States of America,USA,0,0,0,5,5
2011,Nepal,NPL,United States of America,USA,372,0,178,170,720
2011,Netherlands,NLD,United States of America,USA,0,0,5,0,5
2011,Niger,NER,United States of America,USA,5,0,20,28,53
2011,Nicaragua,NIC,United States of America,USA,21,0,106,146,273
2011,Nigeria,NGA,United States of America,USA,32,0,82,92,206
2011,Niue,NIU,United States of America,USA,13,0,0,0,13
2011,New Zealand,NZL,United States of America,USA,0,0,5,0,5
2011,Pakistan,PAK,United States of America,USA,169,0,113,229,511
2011,Panama,PAN,United States of America,USA,0,0,0,5,5
2011,Paraguay,PRY,United States of America,USA,5,0,0,0,5
2011,Peru,PER,United States of America,USA,23,0,51,99,173
2011,Philippines,PHL,United States of America,USA,5,0,55,101,161
2011,Poland,POL,United States of America,USA,5,0,10,31,46
2011,Portugal,PRT,United States of America,USA,0,0,0,5,5
2011,Qatar,QAT,United States of America,USA,5,0,0,0,5
2011,Romania,ROU,United States of America,USA,17,0,21,81,119
2011,South Africa,ZAF,United States of America,USA,5,0,5,20,30
2011,Russian Federation,RUS,United States of America,USA,188,0,103,291,582
2011,Rwanda,RWA,United States of America,USA,19,0,13,15,47
2011,El Salvador,SLV,United States of America,USA,180,0,1336,2669,4185
2011,Saudi Arabia,SAU,United States of America,USA,10,0,10,5,25
2011,Serbia and Kosovo: S/RES/1244 (1999),SRB,United States of America,USA,20,0,14,19,53
2011,Senegal,SEN,United States of America,USA,26,0,39,64,129
2011,Singapore,SGP,United States of America,USA,5,0,5,0,10
2011,Sierra Leone,SLE,United States of America,USA,28,0,38,53,119
2011,Somalia,SOM,United States of America,USA,173,0,90,92,355
2011,Spain,ESP,United States of America,USA,0,0,0,25,25
2011,Viet Nam,VNM,United States of America,USA,14,0,27,38,79
2011,Saint Kitts and Nevis,KNA,United States of America,USA,0,0,5,0,5
2011,Sudan,SDN,United States of America,USA,42,0,44,48,134
2011,Suriname,SUR,United States of America,USA,0,0,0,12,12
2011,Slovakia,SVK,United States of America,USA,0,0,5,5,10
2011,Slovenia,SVN,United States of America,USA,0,0,0,5,5
2011,Sweden,SWE,United States of America,USA,0,0,5,0,5
2011,Switzerland,CHE,United States of America,USA,0,0,0,5,5
2011,Syrian Arab Rep.,SYR,United States of America,USA,16,0,19,30,65
2011,United Rep. of Tanzania,TZA,United States of America,USA,10,0,10,23,43
2011,Thailand,THA,United States of America,USA,0,0,13,11,24
2011,Tajikistan,TJK,United States of America,USA,14,0,10,17,41
2011,Turkmenistan,TKM,United States of America,USA,14,0,0,5,19
2011,Togo,TGO,United States of America,USA,20,0,11,39,70
2011,Tonga,TON,United States of America,USA,0,0,0,5,5
2011,Trinidad and Tobago,TTO,United States of America,USA,0,0,31,22,53
2011,Tunisia,TUN,United States of America,USA,0,0,5,12,17
2011,Turkey,TUR,United States of America,USA,18,0,20,28,66
2011,United Arab Emirates,ARE,United States of America,USA,0,0,0,5,5
2011,Uganda,UGA,United States of America,USA,32,0,17,24,73
2011,Ukraine,UKR,United States of America,USA,56,0,82,114,252
2011,Uruguay,URY,United States of America,USA,0,0,0,5,5
2011,Uzbekistan,UZB,United States of America,USA,70,0,35,75,180
2011,Saint Vincent and the Grenadines,VCT,United States of America,USA,0,0,0,5,5
2011,Venezuela (Bolivarian Republic of),VEN,United States of America,USA,201,0,159,237,597
2011,Yemen,YEM,United States of America,USA,35,0,10,34,79
2011,Zambia,ZMB,United States of America,USA,0,0,13,5,18
2011,Zimbabwe,ZWE,United States of America,USA,44,0,34,50,128
2012,Afghanistan,AFG,United States of America,USA,30,0,13,37,80
2012,Albania,ALB,United States of America,USA,76,0,55,69,200
2012,Algeria,DZA,United States of America,USA,10,0,0,13,23
2012,Angola,AGO,United States of America,USA,0,0,10,5,15
2012,Antigua and Barbuda,ATG,United States of America,USA,0,0,5,0,5
2012,Egypt,EGY,United States of America,USA,268,0,45,151,464
2012,Argentina,ARG,United States of America,USA,5,0,5,48,58
2012,Armenia,ARM,United States of America,USA,93,0,63,145,301
2012,Australia,AUS,United States of America,USA,0,0,5,0,5
2012,Azerbaijan,AZE,United States of America,USA,16,0,5,22,43
2012,Bahrain,BHR,United States of America,USA,0,0,0,5,5
2012,Burundi,BDI,United States of America,USA,87,0,57,217,361
2012,Belgium,BEL,United States of America,USA,13,0,0,0,13
2012,Benin,BEN,United States of America,USA,0,0,5,5,10
2012,Bahamas,BHS,United States of America,USA,0,0,5,12,17
2012,Bhutan,BTN,United States of America,USA,5,0,0,0,5
2012,Burkina Faso,BFA,United States of America,USA,58,0,14,21,93
2012,Belarus,BLR,United States of America,USA,78,0,10,46,134
2012,Bolivia (Plurinational State of),BOL,United States of America,USA,5,0,13,39,57
2012,Brazil,BRA,United States of America,USA,25,0,49,214,288
2012,Bosnia and Herzegovina,BIH,United States of America,USA,0,0,21,20,41
2012,Bulgaria,BGR,United States of America,USA,17,0,20,27,64
2012,Belize,BLZ,United States of America,USA,5,0,10,13,28
2012,Cambodia,KHM,United States of America,USA,10,0,12,11,33
2012,Canada,CAN,United States of America,USA,5,0,10,15,30
2012,Central African Rep.,CAF,United States of America,USA,5,0,0,12,17
2012,Chad,TCD,United States of America,USA,15,0,5,13,33
2012,China,CHN,United States of America,USA,5131,0,1487,2768,9386
2012,Chile,CHL,United States of America,USA,0,0,14,0,14
2012,Cameroon,CMR,United States of America,USA,176,0,69,110,355
2012,Congo,COG,United States of America,USA,64,0,30,62,156
2012,Dem. Rep. of the Congo,COD,United States of America,USA,12,0,10,24,46
2012,Colombia,COL,United States of America,USA,125,0,124,389,638
2012,Costa Rica,CRI,United States of America,USA,0,0,5,14,19
2012,Cuba,CUB,United States of America,USA,5,0,60,118,183
2012,Czechia,CZE,United States of America,USA,0,0,5,10,15
2012,Djibouti,DJI,United States of America,USA,5,0,5,0,10
2012,Dominica,DMA,United States of America,USA,0,0,0,5,5
2012,Dominican Rep.,DOM,United States of America,USA,10,0,62,135,207
2012,Ecuador,ECU,United States of America,USA,15,0,41,256,312
2012,Eritrea,ERI,United States of America,USA,311,0,47,47,405
2012,Ethiopia,ETH,United States of America,USA,441,0,73,125,639
2012,Fiji,FJI,United States of America,USA,14,0,13,26,53
2012,France,FRA,United States of America,USA,0,0,5,13,18
2012,Gabon,GAB,United States of America,USA,0,0,0,10,10
2012,Gambia,GMB,United States of America,USA,72,0,45,87,204
2012,Palestinian,PSE,United States of America,USA,0,0,5,5,10
2012,United Kingdom of Great Britain and Northern Ireland,GBR,United States of America,USA,10,0,10,13,33
2012,Georgia,GEO,United States of America,USA,17,0,15,45,77
2012,Germany,DEU,United States of America,USA,0,0,15,21,36
2012,Ghana,GHA,United States of America,USA,5,0,41,54,100
2012,Guinea-Bissau,GNB,United States of America,USA,0,0,0,5,5
2012,Grenada,GRD,United States of America,USA,5,0,0,5,10
2012,Guatemala,GTM,United States of America,USA,214,0,903,3188,4305
2012,Guinea,GIN,United States of America,USA,156,0,64,169,389
2012,Guyana,GUY,United States of America,USA,5,0,18,43,66
2012,Haiti,HTI,United States of America,USA,55,0,177,587,819
2012,Honduras,HND,United States of America,USA,83,0,455,828,1366
2012,Croatia,HRV,United States of America,USA,0,0,0,5,5
2012,Hungary,HUN,United States of America,USA,0,0,5,18,23
2012,Cote d'Ivoire,CIV,United States of America,USA,61,0,41,113,215
2012,India,IND,United States of America,USA,103,0,186,415,704
2012,Indonesia,IDN,United States of America,USA,116,0,151,336,603
2012,Iran (Islamic Rep. of),IRN,United States of America,USA,90,0,39,118,247
2012,Iraq,IRQ,United States of America,USA,109,0,58,73,240
2012,Israel,ISR,United States of America,USA,5,0,10,23,38
2012,Italy,ITA,United States of America,USA,0,0,0,13,13
2012,Jamaica,JAM,United States of America,USA,13,0,110,110,233
2012,Jordan,JOR,United States of America,USA,16,0,27,46,89
2012,Japan,JPN,United States of America,USA,0,0,0,12,12
2012,Kazakhstan,KAZ,United States of America,USA,16,0,10,33,59
2012,Kenya,KEN,United States of America,USA,72,0,85,168,325
2012,Kyrgyzstan,KGZ,United States of America,USA,30,0,19,31,80
2012,Rep. of Korea,KOR,United States of America,USA,0,0,25,43,68
2012,Dem. People's Rep. of Korea,PRK,United States of America,USA,0,0,0,13,13
2012,Kuwait,KWT,United States of America,USA,13,0,0,0,13
2012,Lao People's Dem. Rep.,LAO,United States of America,USA,0,0,31,24,55
2012,Liberia,LBR,United States of America,USA,5,0,27,38,70
2012,Libya,LBY,United States of America,USA,5,0,5,37,47
2012,Saint Lucia,LCA,United States of America,USA,0,0,0,13,13
2012,Lebanon,LBN,United States of America,USA,19,0,30,58,107
2012,Sri Lanka,LKA,United States of America,USA,109,0,38,96,243
2012,Lithuania,LTU,United States of America,USA,0,0,5,11,16
2012,Latvia,LVA,United States of America,USA,5,0,0,0,5
2012,"China, Macao SAR",MAC,United States of America,USA,0,0,0,5,5
2012,Mauritania,MRT,United States of America,USA,44,0,27,49,120
2012,North Macedonia,MKD,United States of America,USA,0,0,5,14,19
2012,Rep. of Moldova,MDA,United States of America,USA,96,0,41,109,246
2012,Mexico,MEX,United States of America,USA,148,0,1437,5415,7000
2012,Marshall Islands,MHL,United States of America,USA,5,0,0,0,5
2012,Mali,MLI,United States of America,USA,78,0,36,97,211
2012,Malaysia,MYS,United States of America,USA,5,0,5,18,28
2012,Malawi,MWI,United States of America,USA,5,0,5,0,10
2012,Morocco,MAR,United States of America,USA,10,0,10,16,36
2012,Montenegro,MNE,United States of America,USA,39,0,66,120,225
2012,Mauritius,MUS,United States of America,USA,0,0,0,5,5
2012,Myanmar,MMR,United States of America,USA,54,0,21,37,112
2012,Nepal,NPL,United States of America,USA,72,0,34,59,165
2012,Netherlands,NLD,United States of America,USA,0,0,5,5,10
2012,Niger,NER,United States of America,USA,10,0,12,28,50
2012,Nicaragua,NIC,United States of America,USA,15,0,86,184,285
2012,Nigeria,NGA,United States of America,USA,39,0,104,119,262
2012,Niue,NIU,United States of America,USA,0,0,0,12,12
2012,Norway,NOR,United States of America,USA,0,0,0,5,5
2012,Pakistan,PAK,United States of America,USA,185,0,98,261,544
2012,Panama,PAN,United States of America,USA,0,0,5,15,20
2012,Paraguay,PRY,United States of America,USA,0,0,0,5,5
2012,Peru,PER,United States of America,USA,21,0,52,196,269
2012,Philippines,PHL,United States of America,USA,10,0,47,194,251
2012,Poland,POL,United States of America,USA,0,0,17,20,37
2012,Portugal,PRT,United States of America,USA,5,0,0,5,10
2012,Romania,ROU,United States of America,USA,21,0,11,79,111
2012,South Africa,ZAF,United States of America,USA,0,0,11,11,22
2012,Russian Federation,RUS,United States of America,USA,182,0,116,252,550
2012,Rwanda,RWA,United States of America,USA,21,0,12,24,57
2012,El Salvador,SLV,United States of America,USA,186,0,1131,3097,4414
2012,Saudi Arabia,SAU,United States of America,USA,5,0,0,11,16
2012,Serbia and Kosovo: S/RES/1244 (1999),SRB,United States of America,USA,32,0,19,21,72
2012,Senegal,SEN,United States of America,USA,26,0,19,108,153
2012,Seychelles,SYC,United States of America,USA,0,0,0,5,5
2012,Singapore,SGP,United States of America,USA,5,0,0,0,5
2012,Sierra Leone,SLE,United States of America,USA,29,0,23,53,105
2012,Somalia,SOM,United States of America,USA,108,0,57,146,311
2012,Spain,ESP,United States of America,USA,5,0,0,15,20
2012,Viet Nam,VNM,United States of America,USA,10,0,35,54,99
2012,Sudan,SDN,United States of America,USA,48,0,30,39,117
2012,Suriname,SUR,United States of America,USA,0,0,0,13,13
2012,Slovakia,SVK,United States of America,USA,0,0,0,10,10
2012,Slovenia,SVN,United States of America,USA,5,0,0,0,5
2012,Sweden,SWE,United States of America,USA,0,0,0,5,5
2012,Syrian Arab Rep.,SYR,United States of America,USA,46,0,13,53,112
2012,United Rep. of Tanzania,TZA,United States of America,USA,10,0,15,14,39
2012,Thailand,THA,United States of America,USA,5,0,10,13,28
2012,Tajikistan,TJK,United States of America,USA,5,0,5,25,35
2012,Turkmenistan,TKM,United States of America,USA,5,0,5,14,24
2012,Togo,TGO,United States of America,USA,27,0,18,31,76
2012,Tonga,TON,United States of America,USA,0,0,0,5,5
2012,Trinidad and Tobago,TTO,United States of America,USA,5,0,13,52,70
2012,Tunisia,TUN,United States of America,USA,0,0,5,11,16
2012,Turkey,TUR,United States of America,USA,18,0,13,39,70
2012,United Arab Emirates,ARE,United States of America,USA,0,0,0,10,10
2012,Uganda,UGA,United States of America,USA,24,0,16,38,78
2012,Ukraine,UKR,United States of America,USA,36,0,22,72,130
2012,Uruguay,URY,United States of America,USA,0,0,0,20,20
2012,Uzbekistan,UZB,United States of America,USA,53,0,33,79,165
2012,Saint Vincent and the Grenadines,VCT,United States of America,USA,0,0,5,0,5
2012,Venezuela (Bolivarian Republic of),VEN,United States of America,USA,101,0,108,261,470
2012,Yemen,YEM,United States of America,USA,11,0,12,22,45
2012,Zambia,ZMB,United States of America,USA,5,0,5,5,15
2012,Zimbabwe,ZWE,United States of America,USA,34,0,25,70,129
2013,Afghanistan,AFG,United States of America,USA,16,0,10,12,38
2013,Albania,ALB,United States of America,USA,70,0,25,49,144
2013,Algeria,DZA,United States of America,USA,0,0,0,5,5
2013,Andorra,AND,United States of America,USA,0,0,5,0,5
2013,Angola,AGO,United States of America,USA,0,0,5,5,10
2013,Egypt,EGY,United States of America,USA,304,0,27,99,430
2013,Argentina,ARG,United States of America,USA,0,0,10,34,44
2013,Armenia,ARM,United States of America,USA,47,0,41,109,197
2013,Azerbaijan,AZE,United States of America,USA,0,0,0,5,5
2013,Bahrain,BHR,United States of America,USA,0,0,0,5,5
2013,Burundi,BDI,United States of America,USA,18,0,5,5,28
2013,Belgium,BEL,United States of America,USA,13,0,0,0,13
2013,Benin,BEN,United States of America,USA,14,0,0,0,14
2013,Bangladesh,BGD,United States of America,USA,69,0,29,103,201
2013,Bahamas,BHS,United States of America,USA,0,0,5,0,5
2013,Burkina Faso,BFA,United States of America,USA,53,0,11,17,81
2013,Belarus,BLR,United States of America,USA,58,0,12,33,103
2013,Bolivia (Plurinational State of),BOL,United States of America,USA,0,0,0,31,31
2013,Brazil,BRA,United States of America,USA,5,0,35,135,175
2013,Bosnia and Herzegovina,BIH,United States of America,USA,0,0,10,5,15
2013,Bulgaria,BGR,United States of America,USA,5,0,10,13,28
2013,Belize,BLZ,United States of America,USA,0,0,19,15,34
2013,Cambodia,KHM,United States of America,USA,40,0,21,10,71
2013,Canada,CAN,United States of America,USA,0,0,0,5,5
2013,Central African Rep.,CAF,United States of America,USA,0,0,0,12,12
2013,Cayman Islands,CYM,United States of America,USA,5,0,0,0,5
2013,Chad,TCD,United States of America,USA,5,0,0,0,5
2013,China,CHN,United States of America,USA,4395,0,1182,1609,7186
2013,Chile,CHL,United States of America,USA,0,0,5,12,17
2013,Cameroon,CMR,United States of America,USA,96,0,22,49,167
2013,Congo,COG,United States of America,USA,43,0,21,30,94
2013,Dem. Rep. of the Congo,COD,United States of America,USA,14,0,10,11,35
2013,Colombia,COL,United States of America,USA,60,0,124,336,520
2013,Costa Rica,CRI,United States of America,USA,0,0,5,0,5
2013,Cuba,CUB,United States of America,USA,5,0,51,72,128
2013,Czechia,CZE,United States of America,USA,0,0,0,10,10
2013,Djibouti,DJI,United States of America,USA,5,0,5,0,10
2013,Dominican Rep.,DOM,United States of America,USA,5,0,66,85,156
2013,Ecuador,ECU,United States of America,USA,28,0,68,305,401
2013,Eritrea,ERI,United States of America,USA,225,0,16,10,251
2013,Ethiopia,ETH,United States of America,USA,379,0,68,74,521
2013,Fiji,FJI,United States of America,USA,0,0,10,12,22
2013,France,FRA,United States of America,USA,0,0,0,10,10
2013,Gambia,GMB,United States of America,USA,81,0,32,69,182
2013,United Kingdom of Great Britain and Northern Ireland,GBR,United States of America,USA,10,0,0,18,28
2013,Georgia,GEO,United States of America,USA,10,0,0,17,27
2013,Germany,DEU,United States of America,USA,0,0,15,30,45
2013,Ghana,GHA,United States of America,USA,12,0,20,29,61
2013,Guatemala,GTM,United States of America,USA,164,0,833,2338,3335
2013,Guinea,GIN,United States of America,USA,97,0,50,101,248
2013,Guyana,GUY,United States of America,USA,5,0,16,5,26
2013,Haiti,HTI,United States of America,USA,42,0,270,185,497
2013,Honduras,HND,United States of America,USA,104,0,662,701,1467
2013,Croatia,HRV,United States of America,USA,5,0,0,0,5
2013,Cote d'Ivoire,CIV,United States of America,USA,64,0,35,74,173
2013,India,IND,United States of America,USA,342,0,265,383,990
2013,Indonesia,IDN,United States of America,USA,68,0,73,308,449
2013,Iran (Islamic Rep. of),IRN,United States of America,USA,67,0,36,72,175
2013,Iraq,IRQ,United States of America,USA,52,0,34,62,148
2013,Israel,ISR,United States of America,USA,0,0,10,24,34
2013,Italy,ITA,United States of America,USA,0,0,5,0,5
2013,Jamaica,JAM,United States of America,USA,0,0,97,72,169
2013,Jordan,JOR,United States of America,USA,10,0,10,41,61
2013,Japan,JPN,United States of America,USA,0,0,0,10,10
2013,Kazakhstan,KAZ,United States of America,USA,33,0,0,25,58
2013,Kenya,KEN,United States of America,USA,43,0,58,109,210
2013,Kyrgyzstan,KGZ,United States of America,USA,32,0,12,13,57
2013,Rep. of Korea,KOR,United States of America,USA,0,0,15,24,39
2013,Lao People's Dem. Rep.,LAO,United States of America,USA,0,0,10,10,20
2013,Liberia,LBR,United States of America,USA,10,0,18,49,77
2013,Libya,LBY,United States of America,USA,0,0,0,13,13
2013,Lebanon,LBN,United States of America,USA,5,0,16,41,62
2013,Sri Lanka,LKA,United States of America,USA,102,0,30,52,184
2013,Lithuania,LTU,United States of America,USA,0,0,11,5,16
2013,Mauritania,MRT,United States of America,USA,35,0,21,18,74
2013,North Macedonia,MKD,United States of America,USA,5,0,5,10,20
2013,Rep. of Moldova,MDA,United States of America,USA,66,0,24,40,130
2013,Mexico,MEX,United States of America,USA,146,0,1676,5819,7641
2013,Mali,MLI,United States of America,USA,74,0,24,89,187
2013,Malaysia,MYS,United States of America,USA,0,0,0,12,12
2013,Malawi,MWI,United States of America,USA,0,0,0,10,10
2013,Mongolia,MNG,United States of America,USA,26,0,38,89,153
2013,Morocco,MAR,United States of America,USA,5,0,10,17,32
2013,Myanmar,MMR,United States of America,USA,37,0,5,21,63
2013,Nepal,NPL,United States of America,USA,366,0,119,132,617
2013,Netherlands,NLD,United States of America,USA,0,0,5,0,5
2013,Niger,NER,United States of America,USA,0,0,10,17,27
2013,Nicaragua,NIC,United States of America,USA,13,0,83,101,197
2013,Nigeria,NGA,United States of America,USA,31,0,57,55,143
2013,Niue,NIU,United States of America,USA,5,0,0,0,5
2013,New Zealand,NZL,United States of America,USA,0,0,0,5,5
2013,Oman,OMN,United States of America,USA,0,0,0,5,5
2013,Pakistan,PAK,United States of America,USA,97,0,50,206,353
2013,Panama,PAN,United States of America,USA,0,0,5,0,5
2013,Peru,PER,United States of America,USA,5,0,49,130,184
2013,Philippines,PHL,United States of America,USA,5,0,27,157,189
2013,Poland,POL,United States of America,USA,0,0,0,20,20
2013,Romania,ROU,United States of America,USA,28,0,24,62,114
2013,South Africa,ZAF,United States of America,USA,0,0,5,5,10
2013,Russian Federation,RUS,United States of America,USA,169,0,70,167,406
2013,Rwanda,RWA,United States of America,USA,28,0,12,10,50
2013,El Salvador,SLV,United States of America,USA,186,0,1270,2137,3593
2013,Saudi Arabia,SAU,United States of America,USA,5,0,0,5,10
2013,Serbia and Kosovo: S/RES/1244 (1999),SRB,United States of America,USA,40,0,12,5,57
2013,Senegal,SEN,United States of America,USA,18,0,23,72,113
2013,Sierra Leone,SLE,United States of America,USA,10,0,15,21,46
2013,Somalia,SOM,United States of America,USA,90,0,87,50,227
2013,Spain,ESP,United States of America,USA,0,0,14,0,14
2013,Viet Nam,VNM,United States of America,USA,0,0,22,29,51
2013,Sudan,SDN,United States of America,USA,25,0,30,30,85
2013,Syrian Arab Rep.,SYR,United States of America,USA,52,0,5,108,165
2013,United Rep. of Tanzania,TZA,United States of America,USA,0,0,5,0,5
2013,Thailand,THA,United States of America,USA,0,0,10,0,10
2013,Tajikistan,TJK,United States of America,USA,11,0,0,12,23
2013,Turkmenistan,TKM,United States of America,USA,0,0,0,5,5
2013,Togo,TGO,United States of America,USA,5,0,13,19,37
2013,Trinidad and Tobago,TTO,United States of America,USA,0,0,10,29,39
2013,Turkey,TUR,United States of America,USA,0,0,17,18,35
2013,Uganda,UGA,United States of America,USA,28,0,12,20,60
2013,Ukraine,UKR,United States of America,USA,53,0,40,71,164
2013,Uzbekistan,UZB,United States of America,USA,39,0,20,26,85
2013,Venezuela (Bolivarian Republic of),VEN,United States of America,USA,79,0,79,185,343
2013,Yemen,YEM,United States of America,USA,11,0,24,16,51
2013,Zimbabwe,ZWE,United States of America,USA,19,0,18,34,71
2014,Afghanistan,AFG,United States of America,USA,18,0,5,5,28
2014,Albania,ALB,United States of America,USA,74,10,34,62,180
2014,Angola,AGO,United States of America,USA,0,0,5,0,5
2014,Egypt,EGY,United States of America,USA,247,23,23,95,388
2014,Argentina,ARG,United States of America,USA,0,0,0,12,12
2014,Armenia,ARM,United States of America,USA,36,0,20,106,162
2014,Azerbaijan,AZE,United States of America,USA,13,0,0,5,18
2014,Burundi,BDI,United States of America,USA,27,0,12,0,39
2014,Belgium,BEL,United States of America,USA,0,0,5,0,5
2014,Benin,BEN,United States of America,USA,5,0,0,5,10
2014,Bangladesh,BGD,United States of America,USA,67,10,42,118,237
2014,Bahamas,BHS,United States of America,USA,0,0,5,0,5
2014,Bhutan,BTN,United States of America,USA,0,0,5,0,5
2014,Burkina Faso,BFA,United States of America,USA,65,10,12,21,108
2014,Belarus,BLR,United States of America,USA,35,0,5,12,52
2014,Bolivia (Plurinational State of),BOL,United States of America,USA,0,0,10,18,28
2014,Brazil,BRA,United States of America,USA,5,10,24,152,191
2014,Bosnia and Herzegovina,BIH,United States of America,USA,0,0,0,10,10
2014,Bulgaria,BGR,United States of America,USA,5,0,0,0,5
2014,Belize,BLZ,United States of America,USA,0,0,13,10,23
2014,Cambodia,KHM,United States of America,USA,0,0,0,14,14
2014,China,CHN,United States of America,USA,4173,370,1119,1760,7422
2014,Chile,CHL,United States of America,USA,0,0,0,14,14
2014,Cameroon,CMR,United States of America,USA,109,5,23,46,183
2014,Congo,COG,United States of America,USA,15,0,5,21,41
2014,Dem. Rep. of the Congo,COD,United States of America,USA,5,5,11,0,21
2014,Colombia,COL,United States of America,USA,66,25,116,205,412
2014,Costa Rica,CRI,United States of America,USA,0,0,0,13,13
2014,Cuba,CUB,United States of America,USA,10,12,42,58,122
2014,Czechia,CZE,United States of America,USA,0,0,5,0,5
2014,Djibouti,DJI,United States of America,USA,10,0,0,0,10
2014,Dominican Rep.,DOM,United States of America,USA,14,5,49,89,157
2014,Ecuador,ECU,United States of America,USA,23,25,110,509,667
2014,Eritrea,ERI,United States of America,USA,153,14,34,5,206
2014,Ethiopia,ETH,United States of America,USA,312,28,71,55,466
2014,Fiji,FJI,United States of America,USA,5,0,5,0,10
2014,Gambia,GMB,United States of America,USA,68,16,20,62,166
2014,United Kingdom of Great Britain and Northern Ireland,GBR,United States of America,USA,5,0,5,12,22
2014,Georgia,GEO,United States of America,USA,11,0,0,10,21
2014,Germany,DEU,United States of America,USA,0,0,0,5,5
2014,Ghana,GHA,United States of America,USA,14,5,35,31,85
2014,Greece,GRC,United States of America,USA,12,0,0,0,12
2014,Guatemala,GTM,United States of America,USA,202,116,981,2157,3456
2014,Guinea,GIN,United States of America,USA,54,17,23,76,170
2014,Guyana,GUY,United States of America,USA,0,0,10,18,28
2014,Haiti,HTI,United States of America,USA,72,30,350,183,635
2014,Honduras,HND,United States of America,USA,184,119,1047,963,2313
2014,Hungary,HUN,United States of America,USA,5,0,5,15,25
2014,Cote d'Ivoire,CIV,United States of America,USA,50,13,21,68,152
2014,India,IND,United States of America,USA,373,52,281,439,1145
2014,Indonesia,IDN,United States of America,USA,47,14,36,214,311
2014,Ireland,IRL,United States of America,USA,0,0,5,0,5
2014,Iran (Islamic Rep. of),IRN,United States of America,USA,58,13,21,54,146
2014,Iraq,IRQ,United States of America,USA,66,20,36,59,181
2014,Israel,ISR,United States of America,USA,0,0,5,19,24
2014,Jamaica,JAM,United States of America,USA,5,13,69,61,148
2014,Jordan,JOR,United States of America,USA,5,0,10,23,38
2014,Kazakhstan,KAZ,United States of America,USA,19,5,12,20,56
2014,Kenya,KEN,United States of America,USA,35,21,43,121,220
2014,Kyrgyzstan,KGZ,United States of America,USA,41,0,5,22,68
2014,Rep. of Korea,KOR,United States of America,USA,0,0,5,20,25
2014,Lao People's Dem. Rep.,LAO,United States of America,USA,0,0,5,19,24
2014,Liberia,LBR,United States of America,USA,11,5,16,35,67
2014,Libya,LBY,United States of America,USA,0,5,0,5,10
2014,Lebanon,LBN,United States of America,USA,0,0,5,16,21
2014,Sri Lanka,LKA,United States of America,USA,58,0,19,45,122
2014,Mauritania,MRT,United States of America,USA,25,0,14,17,56
2014,North Macedonia,MKD,United States of America,USA,0,0,0,5,5
2014,Rep. of Moldova,MDA,United States of America,USA,58,5,18,36,117
2014,Mexico,MEX,United States of America,USA,123,130,1820,5801,7874
2014,Mali,MLI,United States of America,USA,54,17,19,71,161
2014,Malaysia,MYS,United States of America,USA,5,0,0,20,25
2014,Mongolia,MNG,United States of America,USA,24,5,17,63,109
2014,Morocco,MAR,United States of America,USA,0,0,10,12,22
2014,Mauritius,MUS,United States of America,USA,5,0,0,0,5
2014,Myanmar,MMR,United States of America,USA,29,5,10,5,49
2014,Nepal,NPL,United States of America,USA,299,62,114,131,606
2014,Niger,NER,United States of America,USA,13,0,0,5,18
2014,Nicaragua,NIC,United States of America,USA,25,16,66,117,224
2014,Nigeria,NGA,United States of America,USA,58,14,71,92,235
2014,Niue,NIU,United States of America,USA,5,0,0,0,5
2014,Pakistan,PAK,United States of America,USA,102,17,48,161,328
2014,Peru,PER,United States of America,USA,20,5,33,137,195
2014,Philippines,PHL,United States of America,USA,0,0,33,136,169
2014,Poland,POL,United States of America,USA,0,0,0,10,10
2014,Romania,ROU,United States of America,USA,26,10,16,43,95
2014,South Africa,ZAF,United States of America,USA,0,0,0,5,5
2014,Russian Federation,RUS,United States of America,USA,111,21,50,112,294
2014,Rwanda,RWA,United States of America,USA,42,5,5,0,52
2014,El Salvador,SLV,United States of America,USA,247,126,1430,2254,4057
2014,Saudi Arabia,SAU,United States of America,USA,13,0,0,0,13
2014,Serbia and Kosovo: S/RES/1244 (1999),SRB,United States of America,USA,23,5,0,15,43
2014,Senegal,SEN,United States of America,USA,21,5,18,48,92
2014,Sierra Leone,SLE,United States of America,USA,10,11,17,27,65
2014,Somalia,SOM,United States of America,USA,121,14,169,38,342
2014,Spain,ESP,United States of America,USA,0,0,0,11,11
2014,Viet Nam,VNM,United States of America,USA,0,5,25,24,54
2014,Sudan,SDN,United States of America,USA,20,5,30,24,79
2014,Slovakia,SVK,United States of America,USA,0,0,0,5,5
2014,Syrian Arab Rep.,SYR,United States of America,USA,60,5,13,83,161
2014,Tajikistan,TJK,United States of America,USA,10,5,10,10,35
2014,Turkmenistan,TKM,United States of America,USA,0,0,0,13,13
2014,Togo,TGO,United States of America,USA,12,0,0,5,17
2014,Trinidad and Tobago,TTO,United States of America,USA,0,5,10,24,39
2014,Tunisia,TUN,United States of America,USA,0,0,10,0,10
2014,Turkey,TUR,United States of America,USA,5,5,0,31,41
2014,Uganda,UGA,United States of America,USA,21,5,5,17,48
2014,Ukraine,UKR,United States of America,USA,43,11,30,63,147
2014,Uzbekistan,UZB,United States of America,USA,43,5,10,26,84
2014,Venezuela (Bolivarian Republic of),VEN,United States of America,USA,98,27,58,120,303
2014,Yemen,YEM,United States of America,USA,14,5,5,13,37
2014,Zimbabwe,ZWE,United States of America,USA,5,5,11,24,45
2014,Guadeloupe,GLP,United States of America,USA,0,0,5,0,5
2015,Afghanistan,AFG,United States of America,USA,13,0,16,14,43
2015,Albania,ALB,United States of America,USA,84,0,26,59,169
2015,Egypt,EGY,United States of America,USA,141,0,25,120,286
2015,Argentina,ARG,United States of America,USA,0,0,0,22,22
2015,Armenia,ARM,United States of America,USA,26,0,15,131,172
2015,Azerbaijan,AZE,United States of America,USA,10,0,0,10,20
2015,Burundi,BDI,United States of America,USA,25,0,16,5,46
2015,Belgium,BEL,United States of America,USA,0,0,0,5,5
2015,Benin,BEN,United States of America,USA,5,0,0,5,10
2015,Bangladesh,BGD,United States of America,USA,91,0,220,107,418
2015,Bahamas,BHS,United States of America,USA,0,0,5,5,10
2015,Burkina Faso,BFA,United States of America,USA,59,0,10,19,88
2015,Belarus,BLR,United States of America,USA,33,10,0,23,66
2015,Bolivia (Plurinational State of),BOL,United States of America,USA,0,0,0,15,15
2015,Brazil,BRA,United States of America,USA,0,0,18,112,130
2015,Bosnia and Herzegovina,BIH,United States of America,USA,0,0,5,0,5
2015,Bulgaria,BGR,United States of America,USA,0,0,0,5,5
2015,Belize,BLZ,United States of America,USA,0,0,5,13,18
2015,Cambodia,KHM,United States of America,USA,0,0,5,0,5
2015,Canada,CAN,United States of America,USA,0,0,0,5,5
2015,Chad,TCD,United States of America,USA,0,0,0,10,10
2015,China,CHN,United States of America,USA,3333,0,710,3287,7330
2015,Chile,CHL,United States of America,USA,0,0,5,5,10
2015,Cameroon,CMR,United States of America,USA,91,0,33,66,190
2015,Congo,COG,United States of America,USA,17,0,10,20,47
2015,Dem. Rep. of the Congo,COD,United States of America,USA,11,0,10,10,31
2015,Colombia,COL,United States of America,USA,55,0,51,188,294
2015,Costa Rica,CRI,United States of America,USA,0,0,0,5,5
2015,Cuba,CUB,United States of America,USA,10,0,48,58,116
2015,Czechia,CZE,United States of America,USA,0,0,0,5,5
2015,Djibouti,DJI,United States of America,USA,0,0,0,12,12
2015,Dominican Rep.,DOM,United States of America,USA,5,14,43,89,151
2015,Ecuador,ECU,United States of America,USA,38,0,72,788,898
2015,Eritrea,ERI,United States of America,USA,131,0,63,12,206
2015,Ethiopia,ETH,United States of America,USA,242,0,53,74,369
2015,Fiji,FJI,United States of America,USA,0,0,0,14,14
2015,France,FRA,United States of America,USA,0,0,0,5,5
2015,Micronesia (Federated States of),FSM,United States of America,USA,0,0,5,0,5
2015,Gambia,GMB,United States of America,USA,58,0,5,52,115
2015,United Kingdom of Great Britain and Northern Ireland,GBR,United States of America,USA,0,0,11,0,11
2015,Georgia,GEO,United States of America,USA,5,0,0,12,17
2015,Germany,DEU,United States of America,USA,0,0,16,5,21
2015,Ghana,GHA,United States of America,USA,42,5,107,47,201
2015,Guatemala,GTM,United States of America,USA,440,0,1023,3372,4835
2015,Guinea,GIN,United States of America,USA,37,40,26,66,169
2015,Guyana,GUY,United States of America,USA,0,0,10,21,31
2015,Haiti,HTI,United States of America,USA,43,0,140,500,683
2015,Honduras,HND,United States of America,USA,372,84,1358,2304,4118
2015,Hungary,HUN,United States of America,USA,0,0,0,5,5
2015,Cote d'Ivoire,CIV,United States of America,USA,22,0,10,66,98
2015,India,IND,United States of America,USA,292,0,199,703,1194
2015,Indonesia,IDN,United States of America,USA,16,0,12,263,291
2015,Iran (Islamic Rep. of),IRN,United States of America,USA,40,0,10,65,115
2015,Iraq,IRQ,United States of America,USA,60,0,20,87,167
2015,Israel,ISR,United States of America,USA,0,0,0,17,17
2015,Jamaica,JAM,United States of America,USA,5,29,55,59,148
2015,Jordan,JOR,United States of America,USA,0,0,5,28,33
2015,Kazakhstan,KAZ,United States of America,USA,13,0,0,20,33
2015,Kenya,KEN,United States of America,USA,22,0,20,81,123
2015,Kyrgyzstan,KGZ,United States of America,USA,45,0,10,33,88
2015,Rep. of Korea,KOR,United States of America,USA,0,0,0,18,18
2015,Lao People's Dem. Rep.,LAO,United States of America,USA,0,0,11,5,16
2015,Liberia,LBR,United States of America,USA,5,0,10,33,48
2015,Libya,LBY,United States of America,USA,0,0,0,5,5
2015,Lebanon,LBN,United States of America,USA,10,0,5,13,28
2015,Sri Lanka,LKA,United States of America,USA,43,0,25,78,146
2015,Mauritania,MRT,United States of America,USA,15,0,5,37,57
2015,North Macedonia,MKD,United States of America,USA,0,0,0,5,5
2015,Rep. of Moldova,MDA,United States of America,USA,33,0,10,42,85
2015,Mexico,MEX,United States of America,USA,268,96,1846,5686,7896
2015,Mali,MLI,United States of America,USA,21,0,13,59,93
2015,Malaysia,MYS,United States of America,USA,0,0,0,17,17
2015,Mongolia,MNG,United States of America,USA,5,0,10,85,100
2015,Morocco,MAR,United States of America,USA,5,0,5,0,10
2015,Myanmar,MMR,United States of America,USA,18,0,12,20,50
2015,Namibia,NAM,United States of America,USA,5,0,0,0,5
2015,Nepal,NPL,United States of America,USA,239,0,79,172,490
2015,Netherlands,NLD,United States of America,USA,0,0,5,0,5
2015,Niger,NER,United States of America,USA,0,0,5,11,16
2015,Nicaragua,NIC,United States of America,USA,13,0,55,102,170
2015,Nigeria,NGA,United States of America,USA,72,0,65,77,214
2015,Niue,NIU,United States of America,USA,0,0,0,5,5
2015,Pakistan,PAK,United States of America,USA,58,0,48,168,274
2015,Peru,PER,United States of America,USA,17,0,25,119,161
2015,Philippines,PHL,United States of America,USA,0,0,13,125,138
2015,Poland,POL,United States of America,USA,0,0,0,10,10
2015,Portugal,PRT,United States of America,USA,0,0,0,5,5
2015,Romania,ROU,United States of America,USA,23,0,20,134,177
2015,South Africa,ZAF,United States of America,USA,0,0,0,16,16
2015,Russian Federation,RUS,United States of America,USA,106,0,22,164,292
2015,Rwanda,RWA,United States of America,USA,16,0,0,14,30
2015,El Salvador,SLV,United States of America,USA,371,80,1668,4473,6592
2015,Saudi Arabia,SAU,United States of America,USA,5,0,0,0,5
2015,Serbia and Kosovo: S/RES/1244 (1999),SRB,United States of America,USA,18,0,0,10,28
2015,Senegal,SEN,United States of America,USA,14,0,5,52,71
2015,Sierra Leone,SLE,United States of America,USA,5,0,5,22,32
2015,Somalia,SOM,United States of America,USA,178,0,357,38,573
2015,Spain,ESP,United States of America,USA,0,0,0,14,14
2015,Viet Nam,VNM,United States of America,USA,0,0,17,31,48
2015,Sudan,SDN,United States of America,USA,17,0,10,12,39
2015,Syrian Arab Rep.,SYR,United States of America,USA,104,0,26,62,192
2015,Thailand,THA,United States of America,USA,0,0,5,0,5
2015,Tajikistan,TJK,United States of America,USA,14,0,0,0,14
2015,Turkmenistan,TKM,United States of America,USA,5,0,0,0,5
2015,Togo,TGO,United States of America,USA,5,0,5,14,24
2015,Trinidad and Tobago,TTO,United States of America,USA,0,0,0,13,13
2015,Turkey,TUR,United States of America,USA,10,0,5,26,41
2015,Uganda,UGA,United States of America,USA,10,0,0,15,25
2015,Ukraine,UKR,United States of America,USA,36,0,16,102,154
2015,Uzbekistan,UZB,United States of America,USA,15,0,0,56,71
2015,Saint Vincent and the Grenadines,VCT,United States of America,USA,27,0,0,20,47
2015,Venezuela (Bolivarian Republic of),VEN,United States of America,USA,22,0,34,122,178
2015,Yemen,YEM,United States of America,USA,5,0,5,11,21
2015,Zimbabwe,ZWE,United States of America,USA,0,0,0,17,17
2016,Afghanistan,AFG,United States of America,USA,27,0,10,38,75
2016,Albania,ALB,United States of America,USA,102,0,33,136,271
2016,Algeria,DZA,United States of America,USA,0,0,0,10,10
2016,Angola,AGO,United States of America,USA,5,0,0,17,22
2016,Egypt,EGY,United States of America,USA,149,0,19,146,314
2016,Argentina,ARG,United States of America,USA,0,0,0,24,24
2016,Armenia,ARM,United States of America,USA,22,0,16,134,172
2016,Azerbaijan,AZE,United States of America,USA,10,0,0,12,22
2016,Burundi,BDI,United States of America,USA,24,0,0,16,40
2016,Benin,BEN,United States of America,USA,0,0,0,5,5
2016,Bangladesh,BGD,United States of America,USA,91,0,119,187,397
2016,Bhutan,BTN,United States of America,USA,5,0,0,10,15
2016,Burkina Faso,BFA,United States of America,USA,75,0,23,55,153
2016,Belarus,BLR,United States of America,USA,23,0,0,29,52
2016,Bolivia (Plurinational State of),BOL,United States of America,USA,0,0,5,30,35
2016,Brazil,BRA,United States of America,USA,5,0,46,192,243
2016,Bosnia and Herzegovina,BIH,United States of America,USA,0,0,5,24,29
2016,Bulgaria,BGR,United States of America,USA,5,0,0,16,21
2016,Belize,BLZ,United States of America,USA,0,0,11,15,26
2016,Cambodia,KHM,United States of America,USA,0,0,5,0,5
2016,Canada,CAN,United States of America,USA,5,0,0,0,5
2016,Chad,TCD,United States of America,USA,5,0,0,5,10
2016,China,CHN,United States of America,USA,3131,0,563,4221,7915
2016,Chile,CHL,United States of America,USA,0,0,0,12,12
2016,Cameroon,CMR,United States of America,USA,137,0,48,70,255
2016,Congo,COG,United States of America,USA,28,0,12,22,62
2016,Dem. Rep. of the Congo,COD,United States of America,USA,10,0,5,16,31
2016,Colombia,COL,United States of America,USA,28,0,62,292,382
2016,Costa Rica,CRI,United States of America,USA,0,0,5,22,27
2016,Cuba,CUB,United States of America,USA,10,0,56,47,113
2016,Dominican Rep.,DOM,United States of America,USA,5,0,48,118,171
2016,Ecuador,ECU,United States of America,USA,51,0,95,1431,1577
2016,Eritrea,ERI,United States of America,USA,163,0,90,12,265
2016,Ethiopia,ETH,United States of America,USA,176,0,40,86,302
2016,Fiji,FJI,United States of America,USA,0,0,0,5,5
2016,Gambia,GMB,United States of America,USA,42,0,26,68,136
2016,United Kingdom of Great Britain and Northern Ireland,GBR,United States of America,USA,0,0,0,5,5
2016,Georgia,GEO,United States of America,USA,5,0,0,13,18
2016,Ghana,GHA,United States of America,USA,80,0,193,80,353
2016,Guinea-Bissau,GNB,United States of America,USA,0,0,0,5,5
2016,Guatemala,GTM,United States of America,USA,696,0,1666,3956,6318
2016,Guinea,GIN,United States of America,USA,48,0,57,73,178
2016,Guyana,GUY,United States of America,USA,0,0,5,25,30
2016,Haiti,HTI,United States of America,USA,30,0,159,503,692
2016,Honduras,HND,United States of America,USA,707,0,2109,3030,5846
2016,Cote d'Ivoire,CIV,United States of America,USA,15,0,21,84,120
2016,India,IND,United States of America,USA,331,0,223,950,1504
2016,Indonesia,IDN,United States of America,USA,14,0,5,211,230
2016,Iran (Islamic Rep. of),IRN,United States of America,USA,52,0,19,114,185
2016,Iraq,IRQ,United States of America,USA,30,0,36,97,163
2016,Israel,ISR,United States of America,USA,0,0,5,17,22
2016,Italy,ITA,United States of America,USA,0,0,0,5,5
2016,Jamaica,JAM,United States of America,USA,0,0,70,71,141
2016,Jordan,JOR,United States of America,USA,0,0,5,35,40
2016,Kazakhstan,KAZ,United States of America,USA,22,0,5,27,54
2016,Kenya,KEN,United States of America,USA,10,0,13,73,96
2016,Kyrgyzstan,KGZ,United States of America,USA,48,0,10,52,110
2016,Rep. of Korea,KOR,United States of America,USA,5,0,5,22,32
2016,Lao People's Dem. Rep.,LAO,United States of America,USA,0,0,5,0,5
2016,Liberia,LBR,United States of America,USA,11,0,10,26,47
2016,Lebanon,LBN,United States of America,USA,0,0,12,30,42
2016,Sri Lanka,LKA,United States of America,USA,38,0,22,81,141
2016,Mauritania,MRT,United States of America,USA,11,0,5,32,48
2016,North Macedonia,MKD,United States of America,USA,0,0,0,5,5
2016,Rep. of Moldova,MDA,United States of America,USA,24,0,0,57,81
2016,Mexico,MEX,United States of America,USA,502,0,2796,8531,11829
2016,Mali,MLI,United States of America,USA,27,0,22,78,127
2016,Malaysia,MYS,United States of America,USA,0,0,0,29,29
2016,Mongolia,MNG,United States of America,USA,5,0,0,69,74
2016,Morocco,MAR,United States of America,USA,5,0,0,11,16
2016,Myanmar,MMR,United States of America,USA,11,0,10,16,37
2016,Nepal,NPL,United States of America,USA,265,0,66,267,598
2016,Niger,NER,United States of America,USA,0,0,10,13,23
2016,Nicaragua,NIC,United States of America,USA,14,0,60,147,221
2016,Nigeria,NGA,United States of America,USA,53,0,57,99,209
2016,Pakistan,PAK,United States of America,USA,83,0,47,224,354
2016,Peru,PER,United States of America,USA,12,0,30,166,208
2016,Philippines,PHL,United States of America,USA,0,0,25,129,154
2016,Poland,POL,United States of America,USA,0,0,0,20,20
2016,Romania,ROU,United States of America,USA,35,0,26,174,235
2016,South Africa,ZAF,United States of America,USA,0,0,0,5,5
2016,Russian Federation,RUS,United States of America,USA,66,0,18,167,251
2016,Rwanda,RWA,United States of America,USA,20,0,0,17,37
2016,El Salvador,SLV,United States of America,USA,924,0,2636,5432,8992
2016,Saudi Arabia,SAU,United States of America,USA,5,0,5,5,15
2016,Serbia and Kosovo: S/RES/1244 (1999),SRB,United States of America,USA,24,0,0,22,46
2016,Senegal,SEN,United States of America,USA,11,0,33,103,147
2016,Sierra Leone,SLE,United States of America,USA,10,0,10,14,34
2016,Somalia,SOM,United States of America,USA,123,0,278,50,451
2016,Viet Nam,VNM,United States of America,USA,0,0,12,29,41
2016,Sudan,SDN,United States of America,USA,26,0,11,5,42
2016,Syrian Arab Rep.,SYR,United States of America,USA,77,0,16,91,184
2016,United Rep. of Tanzania,TZA,United States of America,USA,0,0,5,0,5
2016,Thailand,THA,United States of America,USA,0,0,0,5,5
2016,Tajikistan,TJK,United States of America,USA,0,0,5,12,17
2016,Turkmenistan,TKM,United States of America,USA,0,0,0,5,5
2016,Togo,TGO,United States of America,USA,0,0,14,5,19
2016,Trinidad and Tobago,TTO,United States of America,USA,0,0,10,24,34
2016,Tunisia,TUN,United States of America,USA,5,0,0,5,10
2016,Turkey,TUR,United States of America,USA,0,0,12,26,38
2016,Uganda,UGA,United States of America,USA,16,0,0,22,38
2016,Ukraine,UKR,United States of America,USA,54,0,21,109,184
2016,Uruguay,URY,United States of America,USA,0,0,0,10,10
2016,Uzbekistan,UZB,United States of America,USA,24,0,0,88,112
2016,Saint Vincent and the Grenadines,VCT,United States of America,USA,0,0,0,5,5
2016,Venezuela (Bolivarian Republic of),VEN,United States of America,USA,35,0,55,147,237
2016,Yemen,YEM,United States of America,USA,5,0,0,20,25
2016,Zimbabwe,ZWE,United States of America,USA,5,0,5,21,31
2017,Afghanistan,AFG,United States of America,USA,24,0,15,10,49
2017,Albania,ALB,United States of America,USA,88,0,37,35,160
2017,Angola,AGO,United States of America,USA,5,0,19,0,24
2017,Egypt,EGY,United States of America,USA,53,0,15,10,78
2017,Argentina,ARG,United States of America,USA,5,0,5,5,15
2017,Armenia,ARM,United States of America,USA,21,0,25,23,69
2017,Burundi,BDI,United States of America,USA,0,0,12,0,12
2017,Benin,BEN,United States of America,USA,0,0,5,0,5
2017,Bangladesh,BGD,United States of America,USA,91,0,80,35,206
2017,Bahamas,BHS,United States of America,USA,0,0,5,0,5
2017,Bhutan,BTN,United States of America,USA,0,0,5,0,5
2017,Burkina Faso,BFA,United States of America,USA,5,0,19,0,24
2017,Belarus,BLR,United States of America,USA,5,0,0,0,5
2017,Bolivia (Plurinational State of),BOL,United States of America,USA,0,0,5,5,10
2017,Brazil,BRA,United States of America,USA,11,0,81,85,177
2017,Bosnia and Herzegovina,BIH,United States of America,USA,0,0,16,5,21
2017,Belize,BLZ,United States of America,USA,0,0,13,5,18
2017,Cambodia,KHM,United States of America,USA,0,0,10,0,10
2017,Canada,CAN,United States of America,USA,0,0,5,0,5
2017,Chad,TCD,United States of America,USA,5,0,5,0,10
2017,China,CHN,United States of America,USA,740,0,256,233,1229
2017,Chile,CHL,United States of America,USA,0,0,5,0,5
2017,Cameroon,CMR,United States of America,USA,217,0,87,18,322
2017,Congo,COG,United States of America,USA,18,0,31,10,59
2017,Dem. Rep. of the Congo,COD,United States of America,USA,16,0,32,0,48
2017,Colombia,COL,United States of America,USA,21,0,72,70,163
2017,Costa Rica,CRI,United States of America,USA,0,0,5,0,5
2017,Cuba,CUB,United States of America,USA,75,0,220,76,371
2017,Cabo Verde,CPV,United States of America,USA,0,0,5,0,5
2017,Czechia,CZE,United States of America,USA,5,0,0,0,5
2017,Dominican Rep.,DOM,United States of America,USA,5,0,67,103,175
2017,Ecuador,ECU,United States of America,USA,86,0,156,318,560
2017,Eritrea,ERI,United States of America,USA,254,0,255,23,532
2017,Ethiopia,ETH,United States of America,USA,46,0,35,27,108
2017,Micronesia (Federated States of),FSM,United States of America,USA,0,0,5,0,5
2017,Gambia,GMB,United States of America,USA,17,0,54,0,71
2017,Georgia,GEO,United States of America,USA,5,0,10,0,15
2017,Ghana,GHA,United States of America,USA,57,0,115,41,213
2017,Guinea-Bissau,GNB,United States of America,USA,0,0,5,0,5
2017,Guatemala,GTM,United States of America,USA,987,0,2762,2144,5893
2017,Guinea,GIN,United States of America,USA,86,0,115,13,214
2017,Guyana,GUY,United States of America,USA,0,0,5,5,10
2017,Haiti,HTI,United States of America,USA,85,0,1112,405,1602
2017,Honduras,HND,United States of America,USA,996,0,3322,1917,6235
2017,Hungary,HUN,United States of America,USA,0,0,11,0,11
2017,Cote d'Ivoire,CIV,United States of America,USA,0,0,18,0,18
2017,India,IND,United States of America,USA,436,0,296,271,1003
2017,Indonesia,IDN,United States of America,USA,0,0,0,10,10
2017,Iran (Islamic Rep. of),IRN,United States of America,USA,10,0,22,23,55
2017,Iraq,IRQ,United States of America,USA,15,0,41,21,77
2017,Israel,ISR,United States of America,USA,0,0,10,0,10
2017,Jamaica,JAM,United States of America,USA,10,0,67,40,117
2017,Jordan,JOR,United States of America,USA,5,0,18,11,34
2017,Kenya,KEN,United States of America,USA,5,0,28,13,46
2017,Rep. of Korea,KOR,United States of America,USA,0,0,5,0,5
2017,Dem. People's Rep. of Korea,PRK,United States of America,USA,0,0,0,5,5
2017,Lao People's Dem. Rep.,LAO,United States of America,USA,0,0,5,10,15
2017,Liberia,LBR,United States of America,USA,0,0,32,21,53
2017,Lebanon,LBN,United States of America,USA,0,0,5,0,5
2017,Sri Lanka,LKA,United States of America,USA,18,0,10,14,42
2017,Lithuania,LTU,United States of America,USA,0,0,5,0,5
2017,North Macedonia,MKD,United States of America,USA,5,0,0,0,5
2017,Rep. of Moldova,MDA,United States of America,USA,0,0,10,0,10
2017,Mexico,MEX,United States of America,USA,573,0,3221,2667,6461
2017,Mali,MLI,United States of America,USA,5,0,24,0,29
2017,Mongolia,MNG,United States of America,USA,0,0,5,0,5
2017,Myanmar,MMR,United States of America,USA,5,0,14,0,19
2017,Nepal,NPL,United States of America,USA,185,0,81,42,308
2017,Netherlands,NLD,United States of America,USA,0,0,5,0,5
2017,Niger,NER,United States of America,USA,0,0,5,0,5
2017,Nicaragua,NIC,United States of America,USA,30,0,97,93,220
2017,Nigeria,NGA,United States of America,USA,62,0,84,39,185
2017,New Zealand,NZL,United States of America,USA,0,0,0,5,5
2017,Pakistan,PAK,United States of America,USA,44,0,76,40,160
2017,Peru,PER,United States of America,USA,22,0,58,68,148
2017,Philippines,PHL,United States of America,USA,0,0,41,28,69
2017,Portugal,PRT,United States of America,USA,0,0,0,5,5
2017,Romania,ROU,United States of America,USA,43,0,67,167,277
2017,South Africa,ZAF,United States of America,USA,0,0,5,0,5
2017,Russian Federation,RUS,United States of America,USA,23,0,29,11,63
2017,El Salvador,SLV,United States of America,USA,1439,0,4278,2756,8473
2017,Saudi Arabia,SAU,United States of America,USA,5,0,0,0,5
2017,Serbia and Kosovo: S/RES/1244 (1999),SRB,United States of America,USA,5,0,5,0,10
2017,Senegal,SEN,United States of America,USA,14,0,82,5,101
2017,Sierra Leone,SLE,United States of America,USA,5,0,26,16,47
2017,Somalia,SOM,United States of America,USA,86,0,130,49,265
2017,Spain,ESP,United States of America,USA,0,0,5,12,17
2017,Viet Nam,VNM,United States of America,USA,0,0,21,15,36
2017,Sudan,SDN,United States of America,USA,12,0,19,17,48
2017,South Sudan,SSD,United States of America,USA,0,0,5,0,5
2017,Syrian Arab Rep.,SYR,United States of America,USA,94,0,23,16,133
2017,United Rep. of Tanzania,TZA,United States of America,USA,5,0,0,0,5
2017,Thailand,THA,United States of America,USA,0,0,12,0,12
2017,Tajikistan,TJK,United States of America,USA,0,0,0,5,5
2017,Togo,TGO,United States of America,USA,11,0,22,0,33
2017,Trinidad and Tobago,TTO,United States of America,USA,0,0,12,10,22
2017,Tunisia,TUN,United States of America,USA,0,0,5,0,5
2017,Turkey,TUR,United States of America,USA,15,0,13,15,43
2017,Uganda,UGA,United States of America,USA,10,0,0,0,10
2017,Ukraine,UKR,United States of America,USA,38,0,33,27,98
2017,Uzbekistan,UZB,United States of America,USA,5,0,10,11,26
2017,Venezuela (Bolivarian Republic of),VEN,United States of America,USA,41,0,58,37,136
2017,Yemen,YEM,United States of America,USA,5,0,5,13,23
2017,Zimbabwe,ZWE,United States of America,USA,5,0,5,0,10
2017,Guadeloupe,GLP,United States of America,USA,0,0,5,0,5
2018,Afghanistan,AFG,United States of America,USA,17,0,18,5,40
2018,Albania,ALB,United States of America,USA,142,0,46,16,204
2018,Angola,AGO,United States of America,USA,10,0,28,0,38
2018,Egypt,EGY,United States of America,USA,32,0,15,21,68
2018,Argentina,ARG,United States of America,USA,0,0,13,0,13
2018,Armenia,ARM,United States of America,USA,71,0,34,29,134
2018,Austria,AUT,United States of America,USA,10,0,0,0,10
2018,Azerbaijan,AZE,United States of America,USA,10,0,0,0,10
2018,Burundi,BDI,United States of America,USA,5,0,12,0,17
2018,Benin,BEN,United States of America,USA,0,0,5,0,5
2018,Bangladesh,BGD,United States of America,USA,218,0,143,31,392
2018,Bahamas,BHS,United States of America,USA,0,0,5,0,5
2018,Bhutan,BTN,United States of America,USA,0,0,5,0,5
2018,Burkina Faso,BFA,United States of America,USA,13,0,5,0,18
2018,Belarus,BLR,United States of America,USA,14,0,0,0,14
2018,Bolivia (Plurinational State of),BOL,United States of America,USA,0,0,12,0,12
2018,Brazil,BRA,United States of America,USA,22,0,179,149,350
2018,Bosnia and Herzegovina,BIH,United States of America,USA,0,0,14,0,14
2018,Belize,BLZ,United States of America,USA,0,0,23,0,23
2018,Cambodia,KHM,United States of America,USA,0,0,5,5,10
2018,Chad,TCD,United States of America,USA,0,0,5,0,5
2018,China,CHN,United States of America,USA,1388,0,552,193,2133
2018,Chile,CHL,United States of America,USA,0,0,5,5,10
2018,Cameroon,CMR,United States of America,USA,341,0,135,25,501
2018,Dem. Rep. of the Congo,COD,United States of America,USA,45,0,81,10,136
2018,Colombia,COL,United States of America,USA,22,0,105,58,185
2018,Costa Rica,CRI,United States of America,USA,0,0,5,14,19
2018,Cuba,CUB,United States of America,USA,249,0,332,177,758
2018,Dominican Rep.,DOM,United States of America,USA,5,0,66,84,155
2018,Ecuador,ECU,United States of America,USA,111,0,410,304,825
2018,Eritrea,ERI,United States of America,USA,264,0,204,13,481
2018,Ethiopia,ETH,United States of America,USA,52,0,48,13,113
2018,Fiji,FJI,United States of America,USA,0,0,5,0,5
2018,France,FRA,United States of America,USA,0,0,5,0,5
2018,Micronesia (Federated States of),FSM,United States of America,USA,0,0,5,0,5
2018,Gambia,GMB,United States of America,USA,5,0,24,10,39
2018,United Kingdom of Great Britain and Northern Ireland,GBR,United States of America,USA,0,0,5,0,5
2018,Georgia,GEO,United States of America,USA,13,0,12,0,25
2018,Germany,DEU,United States of America,USA,0,0,0,5,5
2018,Ghana,GHA,United States of America,USA,26,0,50,50,126
2018,Greece,GRC,United States of America,USA,0,0,0,5,5
2018,Guatemala,GTM,United States of America,USA,983,0,5483,2655,9121
2018,Guinea,GIN,United States of America,USA,39,0,45,5,89
2018,Guyana,GUY,United States of America,USA,0,0,10,5,15
2018,Haiti,HTI,United States of America,USA,43,0,840,316,1199
2018,Honduras,HND,United States of America,USA,1109,0,5424,2427,8960
2018,Hungary,HUN,United States of America,USA,0,0,11,12,23
2018,Cote d'Ivoire,CIV,United States of America,USA,5,0,18,0,23
2018,India,IND,United States of America,USA,1022,0,716,248,1986
2018,Indonesia,IDN,United States of America,USA,0,0,15,0,15
2018,Iran (Islamic Rep. of),IRN,United States of America,USA,22,0,25,17,64
2018,Iraq,IRQ,United States of America,USA,13,0,38,20,71
2018,Israel,ISR,United States of America,USA,0,0,5,0,5
2018,Italy,ITA,United States of America,USA,0,0,10,0,10
2018,Jamaica,JAM,United States of America,USA,10,0,109,36,155
2018,Jordan,JOR,United States of America,USA,5,0,13,5,23
2018,Kazakhstan,KAZ,United States of America,USA,0,0,5,0,5
2018,Kenya,KEN,United States of America,USA,5,0,32,18,55
2018,Kyrgyzstan,KGZ,United States of America,USA,14,0,15,0,29
2018,Rep. of Korea,KOR,United States of America,USA,0,0,16,5,21
2018,Lao People's Dem. Rep.,LAO,United States of America,USA,0,0,16,0,16
2018,Liberia,LBR,United States of America,USA,0,0,28,5,33
2018,Libya,LBY,United States of America,USA,0,0,5,0,5
2018,Lebanon,LBN,United States of America,USA,0,0,0,12,12
2018,Sri Lanka,LKA,United States of America,USA,29,0,32,10,71
2018,Latvia,LVA,United States of America,USA,5,0,0,0,5
2018,Mauritania,MRT,United States of America,USA,0,0,5,0,5
2018,Rep. of Moldova,MDA,United States of America,USA,0,0,12,0,12
2018,Mexico,MEX,United States of America,USA,624,0,4808,3192,8624
2018,Mali,MLI,United States of America,USA,5,0,14,5,24
2018,Mongolia,MNG,United States of America,USA,0,0,11,0,11
2018,Morocco,MAR,United States of America,USA,0,0,5,0,5
2018,Myanmar,MMR,United States of America,USA,5,0,18,0,23
2018,Nepal,NPL,United States of America,USA,352,0,141,28,521
2018,Niger,NER,United States of America,USA,0,0,5,0,5
2018,Nicaragua,NIC,United States of America,USA,57,0,202,139,398
2018,Nigeria,NGA,United States of America,USA,53,0,121,44,218
2018,New Zealand,NZL,United States of America,USA,0,0,0,5,5
2018,Pakistan,PAK,United States of America,USA,61,0,78,68,207
2018,Panama,PAN,United States of America,USA,0,0,10,0,10
2018,Peru,PER,United States of America,USA,24,0,83,76,183
2018,Philippines,PHL,United States of America,USA,5,0,27,16,48
2018,Portugal,PRT,United States of America,USA,0,0,0,5,5
2018,Romania,ROU,United States of America,USA,41,0,126,223,390
2018,South Africa,ZAF,United States of America,USA,0,0,0,5,5
2018,Russian Federation,RUS,United States of America,USA,64,0,58,31,153
2018,Rwanda,RWA,United States of America,USA,10,0,0,0,10
2018,El Salvador,SLV,United States of America,USA,1797,0,7079,3145,12021
2018,Saudi Arabia,SAU,United States of America,USA,0,0,5,0,5
2018,Serbia and Kosovo: S/RES/1244 (1999),SRB,United States of America,USA,13,0,0,0,13
2018,Senegal,SEN,United States of America,USA,5,0,17,5,27
2018,Sierra Leone,SLE,United States of America,USA,10,0,14,0,24
2018,Somalia,SOM,United States of America,USA,35,0,80,55,170
2018,Spain,ESP,United States of America,USA,0,0,12,0,12
2018,Viet Nam,VNM,United States of America,USA,5,0,31,24,60
2018,Sudan,SDN,United States of America,USA,14,0,24,11,49
2018,South Sudan,SSD,United States of America,USA,0,0,14,0,14
2018,Syrian Arab Rep.,SYR,United States of America,USA,66,0,10,17,93
2018,United Rep. of Tanzania,TZA,United States of America,USA,0,0,10,0,10
2018,Thailand,THA,United States of America,USA,0,0,10,0,10
2018,Tajikistan,TJK,United States of America,USA,5,0,0,0,5
2018,Turkmenistan,TKM,United States of America,USA,10,0,0,0,10
2018,Togo,TGO,United States of America,USA,0,0,14,0,14
2018,Trinidad and Tobago,TTO,United States of America,USA,0,0,12,10,22
2018,Tunisia,TUN,United States of America,USA,5,0,5,0,10
2018,Turkey,TUR,United States of America,USA,24,0,15,18,57
2018,Uganda,UGA,United States of America,USA,24,0,14,0,38
2018,Ukraine,UKR,United States of America,USA,53,0,38,23,114
2018,Uruguay,URY,United States of America,USA,0,0,0,5,5
2018,Uzbekistan,UZB,United States of America,USA,18,0,21,12,51
2018,Venezuela (Bolivarian Republic of),VEN,United States of America,USA,80,0,115,88,283
2018,Zambia,ZMB,United States of America,USA,0,0,18,0,18
2019,Afghanistan,AFG,United States of America,USA,18,0,5,0,23
2019,Albania,ALB,United States of America,USA,84,0,36,10,130
2019,Algeria,DZA,United States of America,USA,0,0,5,0,5
2019,Angola,AGO,United States of America,USA,13,0,16,22,51
2019,Egypt,EGY,United States of America,USA,28,0,19,18,65
2019,Argentina,ARG,United States of America,USA,0,0,11,0,11
2019,Armenia,ARM,United States of America,USA,67,0,49,36,152
2019,Azerbaijan,AZE,United States of America,USA,11,0,5,0,16
2019,Burundi,BDI,United States of America,USA,12,0,5,5,22
2019,Benin,BEN,United States of America,USA,0,0,5,0,5
2019,Bangladesh,BGD,United States of America,USA,259,0,311,26,596
2019,Bahamas,BHS,United States of America,USA,0,0,5,0,5
2019,Bhutan,BTN,United States of America,USA,0,0,14,0,14
2019,Burkina Faso,BFA,United States of America,USA,12,0,11,0,23
2019,Belarus,BLR,United States of America,USA,17,0,0,0,17
2019,Bolivia (Plurinational State of),BOL,United States of America,USA,0,0,5,0,5
2019,Brazil,BRA,United States of America,USA,42,0,454,182,678
2019,Bosnia and Herzegovina,BIH,United States of America,USA,5,0,12,5,22
2019,Belize,BLZ,United States of America,USA,0,0,19,5,24
2019,Cambodia,KHM,United States of America,USA,0,0,5,0,5
2019,Canada,CAN,United States of America,USA,0,0,5,0,5
2019,Chad,TCD,United States of America,USA,10,0,0,0,10
2019,China,CHN,United States of America,USA,1469,0,535,170,2174
2019,Chile,CHL,United States of America,USA,0,0,5,10,15
2019,Cameroon,CMR,United States of America,USA,672,0,173,17,862
2019,Congo,COG,United States of America,USA,10,0,16,10,36
2019,Dem. Rep. of the Congo,COD,United States of America,USA,38,0,40,0,78
2019,Colombia,COL,United States of America,USA,14,0,149,90,253
2019,Costa Rica,CRI,United States of America,USA,0,0,10,0,10
2019,Cuba,CUB,United States of America,USA,1031,0,1419,420,2870
2019,Czechia,CZE,United States of America,USA,0,0,5,0,5
2019,Dominican Rep.,DOM,United States of America,USA,11,0,111,82,204
2019,Ecuador,ECU,United States of America,USA,125,0,623,333,1081
2019,Eritrea,ERI,United States of America,USA,217,0,137,18,372
2019,Ethiopia,ETH,United States of America,USA,35,0,30,5,70
2019,Fiji,FJI,United States of America,USA,0,0,5,0,5
2019,France,FRA,United States of America,USA,0,0,0,5,5
2019,Micronesia (Federated States of),FSM,United States of America,USA,0,0,5,0,5
2019,Gambia,GMB,United States of America,USA,5,0,12,0,17
2019,United Kingdom of Great Britain and Northern Ireland,GBR,United States of America,USA,0,0,10,0,10
2019,Georgia,GEO,United States of America,USA,21,0,26,0,47
2019,Ghana,GHA,United States of America,USA,52,0,56,49,157
2019,Greece,GRC,United States of America,USA,0,0,11,0,11
2019,Guatemala,GTM,United States of America,USA,1811,0,11756,3361,16928
2019,Guinea,GIN,United States of America,USA,39,0,26,0,65
2019,Guyana,GUY,United States of America,USA,0,0,14,0,14
2019,Haiti,HTI,United States of America,USA,63,0,992,256,1311
2019,Honduras,HND,United States of America,USA,1448,0,10578,3091,15117
2019,Hungary,HUN,United States of America,USA,0,0,12,5,17
2019,Cote d'Ivoire,CIV,United States of America,USA,5,0,11,5,21
2019,India,IND,United States of America,USA,1604,0,1173,306,3083
2019,Indonesia,IDN,United States of America,USA,0,0,5,5,10
2019,Iran (Islamic Rep. of),IRN,United States of America,USA,18,0,20,12,50
2019,Iraq,IRQ,United States of America,USA,22,0,36,26,84
2019,Israel,ISR,United States of America,USA,0,0,0,5,5
2019,Italy,ITA,United States of America,USA,0,0,0,12,12
2019,Jamaica,JAM,United States of America,USA,12,0,90,43,145
2019,Jordan,JOR,United States of America,USA,5,0,10,10,25
2019,Japan,JPN,United States of America,USA,0,0,5,0,5
2019,Kazakhstan,KAZ,United States of America,USA,0,0,14,0,14
2019,Kenya,KEN,United States of America,USA,10,0,27,17,54
2019,Kyrgyzstan,KGZ,United States of America,USA,33,0,10,5,48
2019,Rep. of Korea,KOR,United States of America,USA,0,0,10,11,21
2019,Lao People's Dem. Rep.,LAO,United States of America,USA,0,0,10,0,10
2019,Liberia,LBR,United States of America,USA,0,0,28,5,33
2019,Libya,LBY,United States of America,USA,0,0,5,0,5
2019,Lebanon,LBN,United States of America,USA,5,0,10,0,15
2019,Sri Lanka,LKA,United States of America,USA,32,0,63,28,123
2019,Lithuania,LTU,United States of America,USA,5,0,0,0,5
2019,Mauritania,MRT,United States of America,USA,11,0,5,0,16
2019,North Macedonia,MKD,United States of America,USA,0,0,0,5,5
2019,Rep. of Moldova,MDA,United States of America,USA,10,0,0,0,10
2019,Mexico,MEX,United States of America,USA,916,0,6980,2607,10503
2019,Mali,MLI,United States of America,USA,0,0,10,0,10
2019,Mongolia,MNG,United States of America,USA,11,0,0,5,16
2019,Morocco,MAR,United States of America,USA,0,0,5,5,10
2019,Myanmar,MMR,United States of America,USA,5,0,16,5,26
2019,Nepal,NPL,United States of America,USA,348,0,173,21,542
2019,Nicaragua,NIC,United States of America,USA,509,0,837,244,1590
2019,Nigeria,NGA,United States of America,USA,45,0,98,48,191
2019,Pakistan,PAK,United States of America,USA,69,0,78,32,179
2019,Peru,PER,United States of America,USA,47,0,163,67,277
2019,Philippines,PHL,United States of America,USA,0,0,24,16,40
2019,Poland,POL,United States of America,USA,0,0,5,0,5
2019,Portugal,PRT,United States of America,USA,0,0,0,12,12
2019,Romania,ROU,United States of America,USA,43,0,152,210,405
2019,South Africa,ZAF,United States of America,USA,0,0,5,0,5
2019,Russian Federation,RUS,United States of America,USA,223,0,114,16,353
2019,Rwanda,RWA,United States of America,USA,10,0,0,0,10
2019,El Salvador,SLV,United States of America,USA,2585,0,12071,2740,17396
2019,Saudi Arabia,SAU,United States of America,USA,0,0,13,0,13
2019,Serbia and Kosovo: S/RES/1244 (1999),SRB,United States of America,USA,12,0,10,0,22
2019,Senegal,SEN,United States of America,USA,5,0,12,0,17
2019,Sierra Leone,SLE,United States of America,USA,13,0,20,0,33
2019,Somalia,SOM,United States of America,USA,27,0,46,32,105
2019,Spain,ESP,United States of America,USA,0,0,5,15,20
2019,Viet Nam,VNM,United States of America,USA,75,0,50,10,135
2019,Sudan,SDN,United States of America,USA,14,0,19,10,43
2019,South Sudan,SSD,United States of America,USA,0,0,10,0,10
2019,Syrian Arab Rep.,SYR,United States of America,USA,62,0,5,5,72
2019,United Rep. of Tanzania,TZA,United States of America,USA,0,0,5,0,5
2019,Thailand,THA,United States of America,USA,0,0,5,0,5
2019,Tajikistan,TJK,United States of America,USA,5,0,0,0,5
2019,Togo,TGO,United States of America,USA,10,0,12,0,22
2019,Trinidad and Tobago,TTO,United States of America,USA,0,0,18,5,23
2019,Tunisia,TUN,United States of America,USA,0,0,5,0,5
2019,Turkey,TUR,United States of America,USA,81,0,23,20,124
2019,Uganda,UGA,United States of America,USA,30,0,16,0,46
2019,Ukraine,UKR,United States of America,USA,68,0,55,15,138
2019,Uzbekistan,UZB,United States of America,USA,92,0,62,5,159
2019,Venezuela (Bolivarian Republic of),VEN,United States of America,USA,444,0,268,156,868
2019,Yemen,YEM,United States of America,USA,10,0,15,5,30
2019,Zimbabwe,ZWE,United States of America,USA,0,0,13,0,13
2020,Afghanistan,AFG,United States of America,USA,13,0,5,0,18
2020,Albania,ALB,United States of America,USA,18,0,21,0,39
2020,Angola,AGO,United States of America,USA,5,0,27,0,32
2020,Egypt,EGY,United States of America,USA,12,0,14,5,31
2020,Argentina,ARG,United States of America,USA,0,0,10,0,10
2020,Armenia,ARM,United States of America,USA,49,0,29,21,99
2020,Azerbaijan,AZE,United States of America,USA,5,0,0,0,5
2020,Burundi,BDI,United States of America,USA,0,0,5,0,5
2020,Bangladesh,BGD,United States of America,USA,118,0,88,23,229
2020,Bahamas,BHS,United States of America,USA,0,0,5,0,5
2020,Burkina Faso,BFA,United States of America,USA,10,0,10,0,20
2020,Belarus,BLR,United States of America,USA,0,0,0,12,12
2020,Bolivia (Plurinational State of),BOL,United States of America,USA,0,0,10,0,10
2020,Brazil,BRA,United States of America,USA,39,0,266,111,416
2020,Bosnia and Herzegovina,BIH,United States of America,USA,0,0,5,0,5
2020,Belize,BLZ,United States of America,USA,0,0,5,0,5
2020,Cambodia,KHM,United States of America,USA,0,0,5,0,5
2020,China,CHN,United States of America,USA,403,0,190,110,703
2020,Chile,CHL,United States of America,USA,0,0,13,5,18
2020,Cameroon,CMR,United States of America,USA,434,0,635,34,1103
2020,Congo,COG,United States of America,USA,5,0,24,5,34
2020,Dem. Rep. of the Congo,COD,United States of America,USA,24,0,60,0,84
2020,Colombia,COL,United States of America,USA,12,0,58,37,107
2020,Costa Rica,CRI,United States of America,USA,0,0,5,0,5
2020,Cuba,CUB,United States of America,USA,844,0,1651,1218,3713
2020,Czechia,CZE,United States of America,USA,0,0,10,0,10
2020,Dominican Rep.,DOM,United States of America,USA,10,0,78,69,157
2020,Ecuador,ECU,United States of America,USA,68,0,325,180,573
2020,Eritrea,ERI,United States of America,USA,70,0,91,10,171
2020,Ethiopia,ETH,United States of America,USA,26,0,16,5,47
2020,France,FRA,United States of America,USA,0,0,0,5,5
2020,Micronesia (Federated States of),FSM,United States of America,USA,0,0,5,0,5
2020,Gambia,GMB,United States of America,USA,0,0,14,0,14
2020,United Kingdom of Great Britain and Northern Ireland,GBR,United States of America,USA,0,0,5,0,5
2020,Georgia,GEO,United States of America,USA,16,0,43,5,64
2020,Germany,DEU,United States of America,USA,0,0,13,0,13
2020,Ghana,GHA,United States of America,USA,18,0,30,30,78
2020,Guatemala,GTM,United States of America,USA,1026,0,6362,2051,9439
2020,Guinea,GIN,United States of America,USA,18,0,20,5,43
2020,Guyana,GUY,United States of America,USA,0,0,14,0,14
2020,Haiti,HTI,United States of America,USA,26,0,372,198,596
2020,Honduras,HND,United States of America,USA,700,0,5502,1784,7986
2020,Hungary,HUN,United States of America,USA,0,0,5,10,15
2020,Cote d'Ivoire,CIV,United States of America,USA,0,0,12,0,12
2020,India,IND,United States of America,USA,584,0,412,169,1165
2020,Indonesia,IDN,United States of America,USA,5,0,5,0,10
2020,Iran (Islamic Rep. of),IRN,United States of America,USA,14,0,5,0,19
2020,Iraq,IRQ,United States of America,USA,5,0,23,17,45
2020,Israel,ISR,United States of America,USA,0,0,5,0,5
2020,Italy,ITA,United States of America,USA,0,0,11,0,11
2020,Jamaica,JAM,United States of America,USA,0,0,82,32,114
2020,Jordan,JOR,United States of America,USA,0,0,17,0,17
2020,Kazakhstan,KAZ,United States of America,USA,13,0,0,5,18
2020,Kenya,KEN,United States of America,USA,5,0,20,11,36
2020,Kyrgyzstan,KGZ,United States of America,USA,5,0,10,5,20
2020,Rep. of Korea,KOR,United States of America,USA,0,0,10,10,20
2020,Lao People's Dem. Rep.,LAO,United States of America,USA,0,0,11,10,21
2020,Liberia,LBR,United States of America,USA,0,0,28,10,38
2020,Lebanon,LBN,United States of America,USA,0,0,5,0,5
2020,Sri Lanka,LKA,United States of America,USA,21,0,50,5,76
2020,Mauritania,MRT,United States of America,USA,16,0,24,0,40
2020,Rep. of Moldova,MDA,United States of America,USA,5,0,5,0,10
2020,Mexico,MEX,United States of America,USA,469,0,3427,1450,5346
2020,Mali,MLI,United States of America,USA,0,0,11,0,11
2020,Myanmar,MMR,United States of America,USA,0,0,14,5,19
2020,Nepal,NPL,United States of America,USA,100,0,49,10,159
2020,Nicaragua,NIC,United States of America,USA,211,0,433,147,791
2020,Nigeria,NGA,United States of America,USA,26,0,47,36,109
2020,Pakistan,PAK,United States of America,USA,29,0,56,19,104
2020,Panama,PAN,United States of America,USA,0,0,5,5,10
2020,Peru,PER,United States of America,USA,11,0,77,39,127
2020,Philippines,PHL,United States of America,USA,0,0,20,5,25
2020,Romania,ROU,United States of America,USA,11,0,67,71,149
2020,Russian Federation,RUS,United States of America,USA,78,0,79,19,176
2020,Rwanda,RWA,United States of America,USA,0,0,5,0,5
2020,El Salvador,SLV,United States of America,USA,1226,0,5888,1468,8582
2020,Saudi Arabia,SAU,United States of America,USA,0,0,5,0,5
2020,Serbia and Kosovo: S/RES/1244 (1999),SRB,United States of America,USA,0,0,5,0,5
2020,Senegal,SEN,United States of America,USA,5,0,11,0,16
2020,Sierra Leone,SLE,United States of America,USA,0,0,10,0,10
2020,Somalia,SOM,United States of America,USA,13,0,29,23,65
2020,Spain,ESP,United States of America,USA,0,0,0,5,5
2020,Viet Nam,VNM,United States of America,USA,59,0,37,16,112
2020,Sudan,SDN,United States of America,USA,5,0,25,12,42
2020,South Sudan,SSD,United States of America,USA,0,0,13,0,13
2020,Syrian Arab Rep.,SYR,United States of America,USA,30,0,5,11,46
2020,United Rep. of Tanzania,TZA,United States of America,USA,0,0,5,0,5
2020,Thailand,THA,United States of America,USA,0,0,5,0,5
2020,Tajikistan,TJK,United States of America,USA,0,0,5,0,5
2020,Togo,TGO,United States of America,USA,0,0,11,0,11
2020,Trinidad and Tobago,TTO,United States of America,USA,0,0,5,5,10
2020,Tunisia,TUN,United States of America,USA,0,0,5,0,5
2020,Turkey,TUR,United States of America,USA,22,0,18,22,62
2020,Uganda,UGA,United States of America,USA,15,0,16,0,31
2020,Ukraine,UKR,United States of America,USA,5,0,21,24,50
2020,Uzbekistan,UZB,United States of America,USA,33,0,27,0,60
2020,Venezuela (Bolivarian Republic of),VEN,United States of America,USA,379,0,586,101,1066
2020,Yemen,YEM,United States of America,USA,11,0,12,0,23
2021,Afghanistan,AFG,United States of America,USA,5,0,5,0,10
2021,Albania,ALB,United States of America,USA,35,0,10,22,67
2021,Angola,AGO,United States of America,USA,0,0,14,0,14
2021,Egypt,EGY,United States of America,USA,27,0,11,5,43
2021,Argentina,ARG,United States of America,USA,0,0,0,5,5
2021,Armenia,ARM,United States of America,USA,40,0,22,37,99
2021,Barbados,BRB,United States of America,USA,0,0,5,0,5
2021,Bangladesh,BGD,United States of America,USA,126,0,38,34,198
2021,Bhutan,BTN,United States of America,USA,0,0,5,0,5
2021,Burkina Faso,BFA,United States of America,USA,0,0,5,0,5
2021,Belarus,BLR,United States of America,USA,11,0,5,0,16
2021,Brazil,BRA,United States of America,USA,27,0,224,277,528
2021,Bosnia and Herzegovina,BIH,United States of America,USA,0,0,5,0,5
2021,Bulgaria,BGR,United States of America,USA,5,0,0,0,5
2021,Belize,BLZ,United States of America,USA,13,0,0,5,18
2021,Cambodia,KHM,United States of America,USA,0,0,5,5,10
2021,China,CHN,United States of America,USA,393,0,98,121,612
2021,Chile,CHL,United States of America,USA,0,0,0,12,12
2021,Cameroon,CMR,United States of America,USA,123,0,21,22,166
2021,Congo,COG,United States of America,USA,0,0,0,13,13
2021,Dem. Rep. of the Congo,COD,United States of America,USA,18,0,11,5,34
2021,Colombia,COL,United States of America,USA,5,0,52,50,107
2021,Costa Rica,CRI,United States of America,USA,0,0,5,5,10
2021,Cuba,CUB,United States of America,USA,68,0,144,1266,1478
2021,Dominican Rep.,DOM,United States of America,USA,0,0,72,35,107
2021,Ecuador,ECU,United States of America,USA,67,0,188,260,515
2021,Eritrea,ERI,United States of America,USA,68,0,10,0,78
2021,Ethiopia,ETH,United States of America,USA,13,0,11,11,35
2021,France,FRA,United States of America,USA,0,0,0,5,5
2021,Micronesia (Federated States of),FSM,United States of America,USA,0,0,5,0,5
2021,Gambia,GMB,United States of America,USA,0,0,0,10,10
2021,Georgia,GEO,United States of America,USA,17,0,5,0,22
2021,Germany,DEU,United States of America,USA,0,0,10,0,10
2021,Ghana,GHA,United States of America,USA,15,0,10,72,97
2021,Guatemala,GTM,United States of America,USA,1114,0,3078,5623,9815
2021,Guinea,GIN,United States of America,USA,17,0,5,15,37
2021,Guyana,GUY,United States of America,USA,0,0,0,13,13
2021,Haiti,HTI,United States of America,USA,14,0,148,279,441
2021,Honduras,HND,United States of America,USA,786,0,2292,3422,6500
2021,Hungary,HUN,United States of America,USA,0,0,5,5,10
2021,Cote d'Ivoire,CIV,United States of America,USA,0,0,5,5,10
2021,India,IND,United States of America,USA,681,0,306,230,1217
2021,Indonesia,IDN,United States of America,USA,0,0,0,14,14
2021,Iran (Islamic Rep. of),IRN,United States of America,USA,14,0,0,20,34
2021,Iraq,IRQ,United States of America,USA,5,0,13,14,32
2021,Israel,ISR,United States of America,USA,0,0,0,22,22
2021,Jamaica,JAM,United States of America,USA,10,0,47,39,96
2021,Jordan,JOR,United States of America,USA,0,0,5,14,19
2021,Kazakhstan,KAZ,United States of America,USA,11,0,0,0,11
2021,Kenya,KEN,United States of America,USA,11,0,16,14,41
2021,Kyrgyzstan,KGZ,United States of America,USA,17,0,5,5,27
2021,Rep. of Korea,KOR,United States of America,USA,0,0,5,0,5
2021,Lao People's Dem. Rep.,LAO,United States of America,USA,0,0,5,0,5
2021,Liberia,LBR,United States of America,USA,0,0,19,10,29
2021,Lebanon,LBN,United States of America,USA,5,0,0,5,10
2021,Sri Lanka,LKA,United States of America,USA,10,0,11,0,21
2021,Mauritania,MRT,United States of America,USA,0,0,0,5,5
2021,Rep. of Moldova,MDA,United States of America,USA,0,0,0,5,5
2021,Mexico,MEX,United States of America,USA,407,0,2055,2644,5106
2021,Mali,MLI,United States of America,USA,0,0,0,5,5
2021,Morocco,MAR,United States of America,USA,5,0,0,5,10
2021,Myanmar,MMR,United States of America,USA,10,0,16,5,31
2021,Nepal,NPL,United States of America,USA,119,0,33,14,166
2021,Nicaragua,NIC,United States of America,USA,226,0,337,179,742
2021,Nigeria,NGA,United States of America,USA,20,0,28,45,93
2021,Pakistan,PAK,United States of America,USA,37,0,19,31,87
2021,Panama,PAN,United States of America,USA,0,0,0,5,5
2021,Peru,PER,United States of America,USA,17,0,43,64,124
2021,Philippines,PHL,United States of America,USA,0,0,12,19,31
2021,Romania,ROU,United States of America,USA,23,0,52,53,128
2021,Russian Federation,RUS,United States of America,USA,140,0,16,30,186
2021,Rwanda,RWA,United States of America,USA,0,0,5,0,5
2021,El Salvador,SLV,United States of America,USA,1290,0,2967,4610,8867
2021,Serbia and Kosovo: S/RES/1244 (1999),SRB,United States of America,USA,5,0,5,0,10
2021,Senegal,SEN,United States of America,USA,15,0,5,5,25
2021,Sierra Leone,SLE,United States of America,USA,0,0,14,0,14
2021,Somalia,SOM,United States of America,USA,11,0,23,22,56
2021,Spain,ESP,United States of America,USA,0,0,0,5,5
2021,Viet Nam,VNM,United States of America,USA,31,0,16,5,52
2021,Sudan,SDN,United States of America,USA,11,0,12,12,35
2021,South Sudan,SSD,United States of America,USA,0,0,5,0,5
2021,Syrian Arab Rep.,SYR,United States of America,USA,10,0,0,17,27
2021,Thailand,THA,United States of America,USA,0,0,5,0,5
2021,Togo,TGO,United States of America,USA,5,0,0,0,5
2021,Trinidad and Tobago,TTO,United States of America,USA,0,0,5,0,5
2021,Turkey,TUR,United States of America,USA,55,0,12,22,89
2021,Uganda,UGA,United States of America,USA,0,0,0,5,5
2021,Ukraine,UKR,United States of America,USA,37,0,15,22,74
2021,Uzbekistan,UZB,United States of America,USA,37,0,13,10,60
2021,Venezuela (Bolivarian Republic of),VEN,United States of America,USA,260,0,118,172,550
2021,Yemen,YEM,United States of America,USA,0,0,14,0,14
2005,Burundi,BDI,Israel,ISR,0,0,0,5,5
2005,Cameroon,CMR,Israel,ISR,0,0,0,5,5
2005,Congo,COG,Israel,ISR,0,0,0,5,5
2005,Dem. Rep. of the Congo,COD,Israel,ISR,0,10,0,5,15
2005,Colombia,COL,Israel,ISR,0,0,0,5,5
2005,Ecuador,ECU,Israel,ISR,0,0,0,5,5
2005,Eritrea,ERI,Israel,ISR,0,0,0,5,5
2005,Ethiopia,ETH,Israel,ISR,0,0,0,222,222
2005,Ghana,GHA,Israel,ISR,0,0,0,21,21
2005,Guinea,GIN,Israel,ISR,0,0,0,32,32
2005,Cote d'Ivoire,CIV,Israel,ISR,0,36,0,0,36
2005,India,IND,Israel,ISR,0,0,0,5,5
2005,Kenya,KEN,Israel,ISR,0,0,0,5,5
2005,Liberia,LBR,Israel,ISR,0,10,0,0,10
2005,Sri Lanka,LKA,Israel,ISR,0,0,0,19,19
2005,Morocco,MAR,Israel,ISR,0,0,0,5,5
2005,Myanmar,MMR,Israel,ISR,0,0,0,5,5
2005,Nigeria,NGA,Israel,ISR,0,0,31,85,116
2005,Philippines,PHL,Israel,ISR,0,0,0,5,5
2005,Sierra Leone,SLE,Israel,ISR,5,0,0,0,5
2005,Somalia,SOM,Israel,ISR,0,0,0,5,5
2005,Sudan,SDN,Israel,ISR,0,0,0,16,16
2005,Togo,TGO,Israel,ISR,0,0,5,15,20
2005,Turkey,TUR,Israel,ISR,0,0,27,20,47
2005,Zimbabwe,ZWE,Israel,ISR,0,0,5,0,5
2005,Burundi,BDI,Zambia,ZMB,14,0,0,0,14
2005,Dem. Rep. of the Congo,COD,Zambia,ZMB,45,0,22,0,67
2005,Rwanda,RWA,Zambia,ZMB,0,0,11,0,11
2005,Somalia,SOM,Zambia,ZMB,0,0,5,0,5
2006,Central African Rep.,CAF,Chad,TCD,0,0,5,0,5
2006,Congo,COG,Chad,TCD,0,0,10,0,10
2006,Dem. Rep. of the Congo,COD,Chad,TCD,0,5,63,0,68
2006,Eritrea,ERI,Chad,TCD,0,0,0,5,5
2006,Liberia,LBR,Chad,TCD,0,0,5,0,5
2006,Rwanda,RWA,Chad,TCD,0,0,5,0,5
2006,Sudan,SDN,Chad,TCD,0,0,43,0,43
2006,Togo,TGO,Chad,TCD,0,0,17,0,17
2006,Burundi,BDI,Zambia,ZMB,0,0,5,0,5
2006,Dem. Rep. of the Congo,COD,Zambia,ZMB,11,0,5,0,16
2006,Rwanda,RWA,Zambia,ZMB,5,0,5,0,10
2007,Congo,COG,Chad,TCD,0,0,5,0,5
2007,Dem. Rep. of the Congo,COD,Chad,TCD,0,0,10,0,10
2007,Liberia,LBR,Chad,TCD,0,0,5,0,5
2007,Sudan,SDN,Chad,TCD,0,0,15,0,15
2007,Burundi,BDI,Zambia,ZMB,5,0,12,0,17
2007,Dem. Rep. of the Congo,COD,Zambia,ZMB,33,5,26,22,86
2007,Rwanda,RWA,Zambia,ZMB,0,0,12,0,12
2007,Somalia,SOM,Zambia,ZMB,14,0,5,0,19
2008,Cote d'Ivoire,CIV,Liberia,LBR,37,0,0,12,49
2008,Nigeria,NGA,Liberia,LBR,0,0,0,5,5
2008,Sierra Leone,SLE,Liberia,LBR,0,0,0,5,5
2008,Burundi,BDI,Zambia,ZMB,0,0,16,16,32
2008,Dem. Rep. of the Congo,COD,Zambia,ZMB,0,49,16,23,88
2008,Ethiopia,ETH,Zambia,ZMB,0,0,5,0,5
2008,Rwanda,RWA,Zambia,ZMB,0,5,0,0,5
2008,Somalia,SOM,Zambia,ZMB,0,16,20,0,36
2008,Zimbabwe,ZWE,Zambia,ZMB,10,0,0,17,27
2009,Sri Lanka,LKA,Timor-Leste,TLS,0,0,0,10,10
2014,Central African Rep.,CAF,Senegal,SEN,0,0,10,0,10
2014,Chad,TCD,Senegal,SEN,0,0,5,0,5
2014,Dem. Rep. of the Congo,COD,Senegal,SEN,0,0,13,0,13
2014,Gambia,GMB,Senegal,SEN,27,0,13,0,40
2014,Cote d'Ivoire,CIV,Senegal,SEN,0,0,10,0,10
2014,Mali,MLI,Senegal,SEN,0,0,5,0,5
2014,Togo,TGO,Senegal,SEN,0,0,5,0,5
2015,Central African Rep.,CAF,Senegal,SEN,97,0,0,0,97
2015,Gambia,GMB,Senegal,SEN,38,0,0,0,38
2001,Afghanistan,AFG,Austria,AUT,432,0,335,0,767
2001,Albania,ALB,Austria,AUT,20,0,38,0,58
2001,Algeria,DZA,Austria,AUT,0,0,37,0,37
2001,Angola,AGO,Austria,AUT,10,0,14,0,24
2001,Egypt,EGY,Austria,AUT,0,0,5,0,5
2001,Armenia,ARM,Austria,AUT,5,0,109,0,114
2001,Azerbaijan,AZE,Austria,AUT,0,0,13,0,13
2001,Burundi,BDI,Austria,AUT,5,0,0,0,5
2001,Benin,BEN,Austria,AUT,0,0,5,0,5
2001,Bangladesh,BGD,Austria,AUT,0,0,63,0,63
2001,Belarus,BLR,Austria,AUT,0,0,5,0,5
2001,Bosnia and Herzegovina,BIH,Austria,AUT,5,0,51,0,56
2001,Bulgaria,BGR,Austria,AUT,0,0,5,0,5
2001,China,CHN,Austria,AUT,0,0,43,0,43
2001,Cameroon,CMR,Austria,AUT,5,0,12,0,17
2001,Congo,COG,Austria,AUT,5,0,5,0,10
2001,Dem. Rep. of the Congo,COD,Austria,AUT,25,0,25,0,50
2001,Ethiopia,ETH,Austria,AUT,5,0,10,0,15
2001,Gabon,GAB,Austria,AUT,0,0,5,0,5
2001,Gambia,GMB,Austria,AUT,0,0,70,0,70
2001,Georgia,GEO,Austria,AUT,5,0,58,0,63
2001,Ghana,GHA,Austria,AUT,0,0,28,0,28
2001,Guinea,GIN,Austria,AUT,0,0,5,0,5
2001,Croatia,HRV,Austria,AUT,0,0,5,0,5
2001,Cote d'Ivoire,CIV,Austria,AUT,0,0,5,0,5
2001,India,IND,Austria,AUT,0,0,296,0,296
2001,Iran (Islamic Rep. of),IRN,Austria,AUT,134,0,334,0,468
2001,Iraq,IRQ,Austria,AUT,87,0,239,0,326
2001,Israel,ISR,Austria,AUT,0,0,10,0,10
2001,Jordan,JOR,Austria,AUT,0,0,5,0,5
2001,Kazakhstan,KAZ,Austria,AUT,0,0,5,0,5
2001,Kyrgyzstan,KGZ,Austria,AUT,17,0,0,0,17
2001,Liberia,LBR,Austria,AUT,0,0,26,0,26
2001,Libya,LBY,Austria,AUT,0,0,5,0,5
2001,Lebanon,LBN,Austria,AUT,0,0,10,0,10
2001,Sri Lanka,LKA,Austria,AUT,0,0,24,0,24
2001,Lithuania,LTU,Austria,AUT,0,0,5,0,5
2001,Mauritania,MRT,Austria,AUT,0,0,5,0,5
2001,North Macedonia,MKD,Austria,AUT,0,0,71,0,71
2001,Rep. of Moldova,MDA,Austria,AUT,5,0,39,0,44
2001,Mongolia,MNG,Austria,AUT,0,0,5,0,5
2001,Morocco,MAR,Austria,AUT,0,0,5,0,5
2001,Nigeria,NGA,Austria,AUT,0,0,218,0,218
2001,Pakistan,PAK,Austria,AUT,5,0,91,0,96
2001,Romania,ROU,Austria,AUT,5,0,10,0,15
2001,Russian Federation,RUS,Austria,AUT,18,0,84,0,102
2001,Rwanda,RWA,Austria,AUT,17,0,0,0,17
2001,Serbia and Kosovo: S/RES/1244 (1999),SRB,Austria,AUT,206,0,692,0,898
2001,Senegal,SEN,Austria,AUT,0,0,17,0,17
2001,Sierra Leone,SLE,Austria,AUT,5,0,113,0,118
2001,Somalia,SOM,Austria,AUT,5,0,44,0,49
2001,Viet Nam,VNM,Austria,AUT,11,0,0,0,11
2001,Sudan,SDN,Austria,AUT,5,0,24,0,29
2001,Syrian Arab Rep.,SYR,Austria,AUT,11,0,32,0,43
2001,Tunisia,TUN,Austria,AUT,5,0,13,0,18
2001,Turkey,TUR,Austria,AUT,49,0,284,0,333
2001,Uganda,UGA,Austria,AUT,0,0,35,0,35
2001,Ukraine,UKR,Austria,AUT,5,0,42,0,47
2001,Uzbekistan,UZB,Austria,AUT,0,0,5,0,5
2001,Stateless,XXA,Austria,AUT,13,0,31,0,44
2001,Afghanistan,AFG,Italy,ITA,82,0,374,0,456
2001,Albania,ALB,Italy,ITA,22,36,92,0,150
2001,Algeria,DZA,Italy,ITA,5,5,16,0,26
2001,Angola,AGO,Italy,ITA,16,5,5,0,26
2001,Bangladesh,BGD,Italy,ITA,11,0,50,0,61
2001,Bosnia and Herzegovina,BIH,Italy,ITA,15,15,15,0,45
2001,Cameroon,CMR,Italy,ITA,24,0,5,0,29
2001,Congo,COG,Italy,ITA,73,17,0,0,90
2001,Dem. Rep. of the Congo,COD,Italy,ITA,86,0,26,0,112
2001,Colombia,COL,Italy,ITA,27,20,13,0,60
2001,Eritrea,ERI,Italy,ITA,20,5,20,0,45
2001,Ethiopia,ETH,Italy,ITA,64,10,19,0,93
2001,Gambia,GMB,Italy,ITA,13,0,5,0,18
2001,Palestinian,PSE,Italy,ITA,5,0,23,0,28
2001,Iran (Islamic Rep. of),IRN,Italy,ITA,90,0,93,0,183
2001,Iraq,IRQ,Italy,ITA,189,81,4312,0,4582
2001,Lebanon,LBN,Italy,ITA,10,0,10,0,20
2001,Sri Lanka,LKA,Italy,ITA,10,5,95,0,110
2001,North Macedonia,MKD,Italy,ITA,0,18,5,0,23
2001,Rep. of Moldova,MDA,Italy,ITA,5,0,34,0,39
2001,Nigeria,NGA,Italy,ITA,10,0,89,0,99
2001,Pakistan,PAK,Italy,ITA,10,0,50,0,60
2001,Romania,ROU,Italy,ITA,14,15,239,0,268
2001,Russian Federation,RUS,Italy,ITA,106,11,56,0,173
2001,Rwanda,RWA,Italy,ITA,21,0,0,0,21
2001,Serbia and Kosovo: S/RES/1244 (1999),SRB,Italy,ITA,649,198,1583,0,2430
2001,Sierra Leone,SLE,Italy,ITA,52,16,96,0,164
2001,Somalia,SOM,Italy,ITA,22,10,60,0,92
2001,Sudan,SDN,Italy,ITA,23,5,11,0,39
2001,Togo,TGO,Italy,ITA,22,0,5,0,27
2001,Tunisia,TUN,Italy,ITA,14,0,12,0,26
2001,Turkey,TUR,Italy,ITA,313,55,2984,0,3352
2001,Ukraine,UKR,Italy,ITA,5,5,28,0,38
2002,Afghanistan,AFG,Austria,AUT,263,0,308,5229,5800
2002,Albania,ALB,Austria,AUT,25,0,22,37,84
2002,Algeria,DZA,Austria,AUT,0,0,37,154,191
2002,Angola,AGO,Austria,AUT,14,0,17,5,36
2002,Egypt,EGY,Austria,AUT,0,0,11,29,40
2002,Armenia,ARM,Austria,AUT,10,0,205,1684,1899
2002,Azerbaijan,AZE,Austria,AUT,5,0,18,84,107
2002,Burundi,BDI,Austria,AUT,0,0,0,5,5
2002,Benin,BEN,Austria,AUT,0,0,0,5,5
2002,Bangladesh,BGD,Austria,AUT,0,0,52,823,875
2002,Burkina Faso,BFA,Austria,AUT,0,0,0,5,5
2002,Belarus,BLR,Austria,AUT,0,0,18,71,89
2002,Bosnia and Herzegovina,BIH,Austria,AUT,5,0,47,70,122
2002,Bulgaria,BGR,Austria,AUT,0,0,5,43,48
2002,Chad,TCD,Austria,AUT,5,0,0,0,5
2002,China,CHN,Austria,AUT,0,0,66,324,390
2002,Cameroon,CMR,Austria,AUT,13,0,5,21,39
2002,Congo,COG,Austria,AUT,11,0,0,5,16
2002,Dem. Rep. of the Congo,COD,Austria,AUT,27,0,18,29,74
2002,Colombia,COL,Austria,AUT,0,0,14,0,14
2002,Czechia,CZE,Austria,AUT,0,0,0,14,14
2002,Eritrea,ERI,Austria,AUT,5,0,0,0,5
2002,Ethiopia,ETH,Austria,AUT,5,0,10,16,31
2002,Gambia,GMB,Austria,AUT,5,0,17,48,70
2002,Georgia,GEO,Austria,AUT,13,0,136,1324,1473
2002,Ghana,GHA,Austria,AUT,0,0,25,35,60
2002,Guinea-Bissau,GNB,Austria,AUT,0,0,0,5,5
2002,Guinea,GIN,Austria,AUT,0,0,17,34,51
2002,Croatia,HRV,Austria,AUT,0,0,0,10,10
2002,Hungary,HUN,Austria,AUT,0,0,0,13,13
2002,Cote d'Ivoire,CIV,Austria,AUT,0,0,0,14,14
2002,India,IND,Austria,AUT,0,0,192,2328,2520
2002,Iran (Islamic Rep. of),IRN,Austria,AUT,160,0,136,391,687
2002,Iraq,IRQ,Austria,AUT,117,0,159,3946,4222
2002,Israel,ISR,Austria,AUT,0,0,0,17,17
2002,Jordan,JOR,Austria,AUT,0,0,0,5,5
2002,Kazakhstan,KAZ,Austria,AUT,0,0,0,11,11
2002,Kyrgyzstan,KGZ,Austria,AUT,0,0,16,14,30
2002,Liberia,LBR,Austria,AUT,0,0,5,80,85
2002,Lebanon,LBN,Austria,AUT,0,0,5,29,34
2002,Sri Lanka,LKA,Austria,AUT,0,0,5,59,64
2002,Lithuania,LTU,Austria,AUT,0,0,5,23,28
2002,Latvia,LVA,Austria,AUT,0,0,0,5,5
2002,Mauritania,MRT,Austria,AUT,0,0,5,5,10
2002,North Macedonia,MKD,Austria,AUT,0,0,235,382,617
2002,Rep. of Moldova,MDA,Austria,AUT,0,0,77,517,594
2002,Mali,MLI,Austria,AUT,0,0,0,5,5
2002,Malawi,MWI,Austria,AUT,0,0,5,0,5
2002,Mongolia,MNG,Austria,AUT,0,0,19,45,64
2002,Morocco,MAR,Austria,AUT,0,0,5,13,18
2002,Nepal,NPL,Austria,AUT,0,0,5,76,81
2002,Niger,NER,Austria,AUT,0,0,0,5,5
2002,Nigeria,NGA,Austria,AUT,5,0,322,389,716
2002,Pakistan,PAK,Austria,AUT,5,0,48,281,334
2002,Romania,ROU,Austria,AUT,5,0,5,54,64
2002,Russian Federation,RUS,Austria,AUT,36,0,91,953,1080
2002,Rwanda,RWA,Austria,AUT,0,0,0,5,5
2002,Serbia and Kosovo: S/RES/1244 (1999),SRB,Austria,AUT,191,0,1249,1547,2987
2002,Senegal,SEN,Austria,AUT,0,0,12,21,33
2002,Sierra Leone,SLE,Austria,AUT,11,0,48,73,132
2002,Somalia,SOM,Austria,AUT,15,0,20,189,224
2002,Viet Nam,VNM,Austria,AUT,5,0,5,14,24
2002,Sudan,SDN,Austria,AUT,10,0,17,70,97
2002,Slovakia,SVK,Austria,AUT,5,0,0,41,46
2002,Slovenia,SVN,Austria,AUT,0,0,0,5,5
2002,Syrian Arab Rep.,SYR,Austria,AUT,10,0,5,79,94
2002,Tajikistan,TJK,Austria,AUT,0,0,0,13,13
2002,Togo,TGO,Austria,AUT,5,0,0,5,10
2002,Tunisia,TUN,Austria,AUT,0,0,10,28,38
2002,Turkey,TUR,Austria,AUT,68,0,352,1950,2370
2002,Uganda,UGA,Austria,AUT,0,0,16,19,35
2002,Ukraine,UKR,Austria,AUT,10,0,66,195,271
2002,Uzbekistan,UZB,Austria,AUT,0,0,0,5,5
2002,Zimbabwe,ZWE,Austria,AUT,0,0,0,5,5
2002,Stateless,XXA,Austria,AUT,5,0,30,376,411
2002,Afghanistan,AFG,Italy,ITA,10,31,367,0,408
2002,Albania,ALB,Italy,ITA,5,5,52,0,62
2002,Angola,AGO,Italy,ITA,10,12,15,0,37
2002,Bangladesh,BGD,Italy,ITA,5,0,213,0,218
2002,Bosnia and Herzegovina,BIH,Italy,ITA,0,11,41,0,52
2002,Cameroon,CMR,Italy,ITA,10,5,17,0,32
2002,Congo,COG,Italy,ITA,32,10,18,0,60
2002,Dem. Rep. of the Congo,COD,Italy,ITA,35,14,27,0,76
2002,Colombia,COL,Italy,ITA,20,14,60,0,94
2002,Eritrea,ERI,Italy,ITA,25,29,101,0,155
2002,Ethiopia,ETH,Italy,ITA,47,12,53,0,112
2002,Palestinian,PSE,Italy,ITA,0,10,33,0,43
2002,Georgia,GEO,Italy,ITA,5,0,13,0,18
2002,Ghana,GHA,Italy,ITA,0,0,5,0,5
2002,Cote d'Ivoire,CIV,Italy,ITA,0,0,5,0,5
2002,India,IND,Italy,ITA,5,0,11,0,16
2002,Iran (Islamic Rep. of),IRN,Italy,ITA,40,10,57,0,107
2002,Iraq,IRQ,Italy,ITA,124,63,5796,0,5983
2002,Liberia,LBR,Italy,ITA,0,0,5,0,5
2002,Sri Lanka,LKA,Italy,ITA,344,81,810,0,1235
2002,North Macedonia,MKD,Italy,ITA,10,5,117,0,132
2002,Rep. of Moldova,MDA,Italy,ITA,5,0,44,0,49
2002,Nigeria,NGA,Italy,ITA,14,15,379,0,408
2002,Pakistan,PAK,Italy,ITA,5,0,83,0,88
2002,Romania,ROU,Italy,ITA,0,5,354,0,359
2002,Russian Federation,RUS,Italy,ITA,5,10,93,0,108
2002,Serbia and Kosovo: S/RES/1244 (1999),SRB,Italy,ITA,94,198,915,0,1207
2002,Sierra Leone,SLE,Italy,ITA,11,42,71,0,124
2002,Somalia,SOM,Italy,ITA,5,13,62,0,80
2002,Sudan,SDN,Italy,ITA,28,25,56,0,109
2002,Syrian Arab Rep.,SYR,Italy,ITA,18,0,41,0,59
2002,Togo,TGO,Italy,ITA,26,5,20,0,51
2002,Turkey,TUR,Italy,ITA,138,50,2705,0,2893
2002,Stateless,XXA,Italy,ITA,0,0,5,0,5
2003,Afghanistan,AFG,Austria,AUT,339,0,168,0,507
2003,Albania,ALB,Austria,AUT,30,0,21,0,51
2003,Algeria,DZA,Austria,AUT,0,0,63,0,63
2003,Angola,AGO,Austria,AUT,21,0,12,0,33
2003,Egypt,EGY,Austria,AUT,0,0,13,0,13
2003,Armenia,ARM,Austria,AUT,26,0,126,0,152
2003,Azerbaijan,AZE,Austria,AUT,13,0,17,0,30
2003,Benin,BEN,Austria,AUT,0,0,5,0,5
2003,Bangladesh,BGD,Austria,AUT,0,0,85,0,85
2003,Burkina Faso,BFA,Austria,AUT,0,0,5,0,5
2003,Belarus,BLR,Austria,AUT,0,0,20,0,20
2003,Bolivia (Plurinational State of),BOL,Austria,AUT,5,0,0,0,5
2003,Bosnia and Herzegovina,BIH,Austria,AUT,14,0,53,0,67
2003,Bulgaria,BGR,Austria,AUT,0,0,5,0,5
2003,China,CHN,Austria,AUT,10,0,149,0,159
2003,Cameroon,CMR,Austria,AUT,12,0,5,0,17
2003,Congo,COG,Austria,AUT,10,0,0,0,10
2003,Dem. Rep. of the Congo,COD,Austria,AUT,28,0,5,0,33
2003,Czechia,CZE,Austria,AUT,0,0,5,0,5
2003,Eritrea,ERI,Austria,AUT,5,0,0,0,5
2003,Ethiopia,ETH,Austria,AUT,14,0,0,0,14
2003,Gambia,GMB,Austria,AUT,0,0,44,0,44
2003,Georgia,GEO,Austria,AUT,60,0,233,0,293
2003,Ghana,GHA,Austria,AUT,0,0,18,0,18
2003,Guinea-Bissau,GNB,Austria,AUT,0,0,5,0,5
2003,Guinea,GIN,Austria,AUT,5,0,12,0,17
2003,Croatia,HRV,Austria,AUT,0,0,5,0,5
2003,Cote d'Ivoire,CIV,Austria,AUT,0,0,13,0,13
2003,India,IND,Austria,AUT,0,0,694,0,694
2003,Iran (Islamic Rep. of),IRN,Austria,AUT,164,0,101,0,265
2003,Iraq,IRQ,Austria,AUT,143,0,49,0,192
2003,Kazakhstan,KAZ,Austria,AUT,10,0,0,0,10
2003,Kyrgyzstan,KGZ,Austria,AUT,5,0,0,0,5
2003,Liberia,LBR,Austria,AUT,0,0,16,0,16
2003,Lebanon,LBN,Austria,AUT,0,0,5,0,5
2003,Sri Lanka,LKA,Austria,AUT,0,0,5,0,5
2003,North Macedonia,MKD,Austria,AUT,5,0,263,0,268
2003,Rep. of Moldova,MDA,Austria,AUT,0,0,175,0,175
2003,Mongolia,MNG,Austria,AUT,0,0,23,0,23
2003,Morocco,MAR,Austria,AUT,0,0,10,0,10
2003,Nepal,NPL,Austria,AUT,0,0,5,0,5
2003,Nigeria,NGA,Austria,AUT,5,0,369,0,374
2003,Pakistan,PAK,Austria,AUT,0,0,85,0,85
2003,Romania,ROU,Austria,AUT,0,0,10,0,10
2003,Russian Federation,RUS,Austria,AUT,788,0,237,0,1025
2003,Rwanda,RWA,Austria,AUT,15,0,0,0,15
2003,Serbia and Kosovo: S/RES/1244 (1999),SRB,Austria,AUT,162,0,1090,0,1252
2003,Senegal,SEN,Austria,AUT,0,0,10,0,10
2003,Sierra Leone,SLE,Austria,AUT,5,0,29,0,34
2003,Somalia,SOM,Austria,AUT,24,0,11,0,35
2003,Viet Nam,VNM,Austria,AUT,0,0,10,0,10
2003,Sudan,SDN,Austria,AUT,16,0,11,0,27
2003,Syrian Arab Rep.,SYR,Austria,AUT,18,0,14,0,32
2003,Tajikistan,TJK,Austria,AUT,0,0,5,0,5
2003,Turkmenistan,TKM,Austria,AUT,10,0,0,0,10
2003,Tunisia,TUN,Austria,AUT,0,0,5,0,5
2003,Turkey,TUR,Austria,AUT,73,0,424,0,497
2003,Uganda,UGA,Austria,AUT,0,0,5,0,5
2003,Ukraine,UKR,Austria,AUT,10,0,91,0,101
2003,Uzbekistan,UZB,Austria,AUT,0,0,10,0,10
2003,Stateless,XXA,Austria,AUT,24,0,51,0,75
2003,Afghanistan,AFG,Italy,ITA,5,0,179,0,184
2003,Albania,ALB,Italy,ITA,0,0,41,5,46
2003,Angola,AGO,Italy,ITA,10,0,28,0,38
2003,Bangladesh,BGD,Italy,ITA,0,0,206,0,206
2003,Cameroon,CMR,Italy,ITA,18,0,34,0,52
2003,Congo,COG,Italy,ITA,54,0,64,5,123
2003,Dem. Rep. of the Congo,COD,Italy,ITA,51,0,57,0,108
2003,Colombia,COL,Italy,ITA,11,0,32,0,43
2003,Eritrea,ERI,Italy,ITA,83,0,289,0,372
2003,Ethiopia,ETH,Italy,ITA,63,0,56,0,119
2003,Palestinian,PSE,Italy,ITA,5,0,117,0,122
2003,Georgia,GEO,Italy,ITA,5,0,22,0,27
2003,Ghana,GHA,Italy,ITA,5,0,144,0,149
2003,Cote d'Ivoire,CIV,Italy,ITA,5,0,42,0,47
2003,India,IND,Italy,ITA,0,0,63,0,63
2003,Iran (Islamic Rep. of),IRN,Italy,ITA,20,0,27,0,47
2003,Iraq,IRQ,Italy,ITA,23,0,1417,0,1440
2003,Liberia,LBR,Italy,ITA,23,0,564,0,587
2003,Sri Lanka,LKA,Italy,ITA,5,0,833,0,838
2003,North Macedonia,MKD,Italy,ITA,0,0,138,0,138
2003,Rep. of Moldova,MDA,Italy,ITA,0,0,56,0,56
2003,Nigeria,NGA,Italy,ITA,18,0,414,0,432
2003,Pakistan,PAK,Italy,ITA,0,0,601,0,601
2003,Romania,ROU,Italy,ITA,5,0,312,0,317
2003,Russian Federation,RUS,Italy,ITA,10,0,53,0,63
2003,Serbia and Kosovo: S/RES/1244 (1999),SRB,Italy,ITA,25,0,1132,5,1162
2003,Sierra Leone,SLE,Italy,ITA,18,0,260,0,278
2003,Somalia,SOM,Italy,ITA,23,0,514,0,537
2003,Sudan,SDN,Italy,ITA,44,0,450,0,494
2003,Togo,TGO,Italy,ITA,68,0,50,0,118
2003,Turkey,TUR,Italy,ITA,80,0,1942,0,2022
2003,Ukraine,UKR,Italy,ITA,5,0,29,0,34
2004,Congo,COG,Angola,AGO,14,0,0,0,14
2004,Dem. Rep. of the Congo,COD,Angola,AGO,20,0,22,0,42
2004,Guinea-Bissau,GNB,Angola,AGO,0,0,5,0,5
2004,Cote d'Ivoire,CIV,Angola,AGO,19,0,12,0,31
2004,Liberia,LBR,Angola,AGO,22,0,30,0,52
2004,Rwanda,RWA,Angola,AGO,27,0,5,0,32
2004,Sierra Leone,SLE,Angola,AGO,11,0,15,0,26
2004,Afghanistan,AFG,Austria,AUT,744,158,110,5397,6409
2004,Albania,ALB,Austria,AUT,16,5,18,18,57
2004,Algeria,DZA,Austria,AUT,0,0,60,135,195
2004,Angola,AGO,Austria,AUT,20,5,10,11,46
2004,Egypt,EGY,Austria,AUT,5,0,0,13,18
2004,Armenia,ARM,Austria,AUT,35,12,80,182,309
2004,Azerbaijan,AZE,Austria,AUT,23,5,12,29,69
2004,Burundi,BDI,Austria,AUT,0,0,12,0,12
2004,Benin,BEN,Austria,AUT,0,0,5,0,5
2004,Bangladesh,BGD,Austria,AUT,0,0,98,302,400
2004,Belarus,BLR,Austria,AUT,5,0,19,72,96
2004,Bolivia (Plurinational State of),BOL,Austria,AUT,0,0,0,5,5
2004,Brazil,BRA,Austria,AUT,0,0,0,5,5
2004,Bosnia and Herzegovina,BIH,Austria,AUT,11,5,56,83,155
2004,Bulgaria,BGR,Austria,AUT,0,0,5,11,16
2004,Canada,CAN,Austria,AUT,0,0,0,5,5
2004,China,CHN,Austria,AUT,5,0,88,354,447
2004,Cameroon,CMR,Austria,AUT,10,0,15,20,45
2004,Congo,COG,Austria,AUT,0,0,0,13,13
2004,Dem. Rep. of the Congo,COD,Austria,AUT,47,5,15,24,91
2004,Colombia,COL,Austria,AUT,0,0,5,0,5
2004,Cuba,CUB,Austria,AUT,0,0,0,5,5
2004,Czechia,CZE,Austria,AUT,0,0,5,5,10
2004,Eritrea,ERI,Austria,AUT,5,0,0,5,10
2004,Estonia,EST,Austria,AUT,0,0,5,0,5
2004,Ethiopia,ETH,Austria,AUT,13,5,0,10,28
2004,Gambia,GMB,Austria,AUT,5,0,66,58,129
2004,Georgia,GEO,Austria,AUT,53,18,398,750,1219
2004,Germany,DEU,Austria,AUT,0,0,0,5,5
2004,Ghana,GHA,Austria,AUT,5,0,41,29,75
2004,Guinea-Bissau,GNB,Austria,AUT,0,0,23,29,52
2004,Guinea,GIN,Austria,AUT,5,0,13,46,64
2004,Croatia,HRV,Austria,AUT,0,0,0,13,13
2004,Cote d'Ivoire,CIV,Austria,AUT,0,0,5,13,18
2004,India,IND,Austria,AUT,0,0,491,1243,1734
2004,Iran (Islamic Rep. of),IRN,Austria,AUT,414,10,114,304,842
2004,Iraq,IRQ,Austria,AUT,128,251,80,244,703
2004,Israel,ISR,Austria,AUT,0,0,5,33,38
2004,Jordan,JOR,Austria,AUT,0,0,5,5,10
2004,Kazakhstan,KAZ,Austria,AUT,5,0,11,5,21
2004,Kyrgyzstan,KGZ,Austria,AUT,5,0,5,15,25
2004,Liberia,LBR,Austria,AUT,0,5,49,40,94
2004,Libya,LBY,Austria,AUT,0,0,0,5,5
2004,Lebanon,LBN,Austria,AUT,0,0,5,36,41
2004,Sri Lanka,LKA,Austria,AUT,0,0,13,74,87
2004,Lithuania,LTU,Austria,AUT,0,0,0,12,12
2004,Latvia,LVA,Austria,AUT,0,0,0,5,5
2004,Mauritania,MRT,Austria,AUT,0,0,5,5,10
2004,North Macedonia,MKD,Austria,AUT,5,11,209,133,358
2004,Rep. of Moldova,MDA,Austria,AUT,10,5,223,1074,1312
2004,Mali,MLI,Austria,AUT,0,0,5,13,18
2004,Mongolia,MNG,Austria,AUT,5,0,51,134,190
2004,Morocco,MAR,Austria,AUT,0,0,11,18,29
2004,Nepal,NPL,Austria,AUT,0,0,5,24,29
2004,Niger,NER,Austria,AUT,0,0,0,5,5
2004,Nigeria,NGA,Austria,AUT,5,5,451,541,1002
2004,Pakistan,PAK,Austria,AUT,5,0,119,425,549
2004,Philippines,PHL,Austria,AUT,0,0,0,5,5
2004,Poland,POL,Austria,AUT,0,0,0,5,5
2004,Romania,ROU,Austria,AUT,5,0,36,83,124
2004,Russian Federation,RUS,Austria,AUT,2905,348,193,848,4294
2004,Rwanda,RWA,Austria,AUT,0,0,0,11,11
2004,Serbia and Kosovo: S/RES/1244 (1999),SRB,Austria,AUT,419,60,919,859,2257
2004,Senegal,SEN,Austria,AUT,0,0,5,16,21
2004,Sierra Leone,SLE,Austria,AUT,5,0,23,49,77
2004,Somalia,SOM,Austria,AUT,13,10,0,27,50
2004,Viet Nam,VNM,Austria,AUT,0,0,14,18,32
2004,Sudan,SDN,Austria,AUT,21,0,19,35,75
2004,Slovakia,SVK,Austria,AUT,0,0,0,5,5
2004,Slovenia,SVN,Austria,AUT,0,0,5,0,5
2004,Syrian Arab Rep.,SYR,Austria,AUT,22,0,14,55,91
2004,United Rep. of Tanzania,TZA,Austria,AUT,0,0,5,0,5
2004,Tajikistan,TJK,Austria,AUT,0,0,0,10,10
2004,Turkmenistan,TKM,Austria,AUT,0,0,0,5,5
2004,Togo,TGO,Austria,AUT,5,0,0,0,5
2004,Tunisia,TUN,Austria,AUT,5,0,5,10,20
2004,Turkey,TUR,Austria,AUT,94,24,643,800,1561
2004,Uganda,UGA,Austria,AUT,0,0,0,11,11
2004,Ukraine,UKR,Austria,AUT,18,10,75,139,242
2004,Uzbekistan,UZB,Austria,AUT,11,0,5,19,35
2004,Yemen,YEM,Austria,AUT,0,0,0,5,5
2004,Zimbabwe,ZWE,Austria,AUT,0,0,5,5,10
2004,Stateless,XXA,Austria,AUT,10,5,25,141,181
2004,Colombia,COL,Costa Rica,CRI,712,0,572,0,1284
2004,Cuba,CUB,Costa Rica,CRI,65,0,0,0,65
2004,Nicaragua,NIC,Costa Rica,CRI,37,0,0,0,37
2004,Venezuela (Bolivarian Republic of),VEN,Costa Rica,CRI,13,0,0,0,13
2004,Burundi,BDI,Ethiopia,ETH,10,0,0,0,10
2004,Dem. Rep. of the Congo,COD,Ethiopia,ETH,5,0,5,0,10
2004,Eritrea,ERI,Ethiopia,ETH,2187,0,0,0,2187
2004,Somalia,SOM,Ethiopia,ETH,5,0,0,0,5
2004,Sudan,SDN,Ethiopia,ETH,39,0,0,0,39
2004,Afghanistan,AFG,Finland,FIN,0,33,0,5,38
2004,Albania,ALB,Finland,FIN,0,5,14,5,24
2004,Algeria,DZA,Finland,FIN,0,0,18,14,32
2004,Angola,AGO,Finland,FIN,0,46,10,5,61
2004,Armenia,ARM,Finland,FIN,0,5,5,16,26
2004,Azerbaijan,AZE,Finland,FIN,5,15,5,10,35
2004,Bangladesh,BGD,Finland,FIN,0,5,19,5,29
2004,Belarus,BLR,Finland,FIN,0,0,12,14,26
2004,Bosnia and Herzegovina,BIH,Finland,FIN,0,20,13,5,38
2004,Bulgaria,BGR,Finland,FIN,0,0,0,10,10
2004,China,CHN,Finland,FIN,0,15,5,26,46
2004,Cameroon,CMR,Finland,FIN,0,11,5,0,16
2004,Congo,COG,Finland,FIN,0,5,5,0,10
2004,Dem. Rep. of the Congo,COD,Finland,FIN,0,28,45,5,78
2004,Cuba,CUB,Finland,FIN,0,0,5,0,5
2004,Ecuador,ECU,Finland,FIN,0,0,0,5,5
2004,Ethiopia,ETH,Finland,FIN,0,5,11,0,16
2004,Georgia,GEO,Finland,FIN,0,0,5,14,19
2004,Ghana,GHA,Finland,FIN,0,0,5,0,5
2004,Guinea,GIN,Finland,FIN,0,0,5,0,5
2004,Croatia,HRV,Finland,FIN,0,0,0,10,10
2004,Hungary,HUN,Finland,FIN,0,0,0,5,5
2004,India,IND,Finland,FIN,0,0,5,0,5
2004,Iran (Islamic Rep. of),IRN,Finland,FIN,0,37,59,10,106
2004,Iraq,IRQ,Finland,FIN,0,208,0,18,226
2004,Kazakhstan,KAZ,Finland,FIN,0,0,5,5,10
2004,Kyrgyzstan,KGZ,Finland,FIN,0,5,0,0,5
2004,Liberia,LBR,Finland,FIN,0,5,5,0,10
2004,Libya,LBY,Finland,FIN,0,0,5,5,10
2004,Sri Lanka,LKA,Finland,FIN,0,0,13,0,13
2004,North Macedonia,MKD,Finland,FIN,0,0,33,56,89
2004,Rep. of Moldova,MDA,Finland,FIN,0,5,0,27,32
2004,Morocco,MAR,Finland,FIN,0,5,0,0,5
2004,Nepal,NPL,Finland,FIN,0,5,0,0,5
2004,Nigeria,NGA,Finland,FIN,0,14,67,5,86
2004,Romania,ROU,Finland,FIN,0,0,0,27,27
2004,Russian Federation,RUS,Finland,FIN,10,51,23,41,125
2004,Rwanda,RWA,Finland,FIN,0,0,5,0,5
2004,Serbia and Kosovo: S/RES/1244 (1999),SRB,Finland,FIN,0,79,138,153,370
2004,Senegal,SEN,Finland,FIN,0,0,5,0,5
2004,Sierra Leone,SLE,Finland,FIN,0,11,5,0,16
2004,Somalia,SOM,Finland,FIN,0,87,0,0,87
2004,Slovakia,SVK,Finland,FIN,0,0,5,10,15
2004,Syrian Arab Rep.,SYR,Finland,FIN,0,11,15,0,26
2004,Tajikistan,TJK,Finland,FIN,5,0,0,0,5
2004,Togo,TGO,Finland,FIN,0,0,5,0,5
2004,Turkey,TUR,Finland,FIN,0,36,115,10,161
2004,Ukraine,UKR,Finland,FIN,0,0,15,0,15
2004,Uzbekistan,UZB,Finland,FIN,0,0,5,0,5
2004,Zimbabwe,ZWE,Finland,FIN,0,0,5,0,5
2004,Stateless,XXA,Finland,FIN,0,10,17,0,27
2004,Burkina Faso,BFA,Ghana,GHA,0,0,0,5,5
2004,Dem. Rep. of the Congo,COD,Ghana,GHA,0,0,14,0,14
2004,Cote d'Ivoire,CIV,Ghana,GHA,11,0,0,97,108
2004,Mali,MLI,Ghana,GHA,0,0,0,5,5
2004,Rwanda,RWA,Ghana,GHA,5,0,5,0,10
2004,Seychelles,SYC,Ghana,GHA,0,0,5,0,5
2004,Sudan,SDN,Ghana,GHA,10,0,0,0,10
2004,Togo,TGO,Ghana,GHA,0,0,0,24,24
2004,Afghanistan,AFG,Italy,ITA,14,50,38,0,102
2004,Albania,ALB,Italy,ITA,10,0,27,5,42
2004,Algeria,DZA,Italy,ITA,5,0,10,0,15
2004,Angola,AGO,Italy,ITA,10,10,20,0,40
2004,Egypt,EGY,Italy,ITA,0,0,5,0,5
2004,Armenia,ARM,Italy,ITA,5,0,5,0,10
2004,Azerbaijan,AZE,Italy,ITA,0,0,5,0,5
2004,Benin,BEN,Italy,ITA,0,0,5,0,5
2004,Bangladesh,BGD,Italy,ITA,0,5,86,0,91
2004,Burkina Faso,BFA,Italy,ITA,5,0,5,0,10
2004,Belarus,BLR,Italy,ITA,0,0,5,0,5
2004,Bosnia and Herzegovina,BIH,Italy,ITA,0,0,10,0,10
2004,Bulgaria,BGR,Italy,ITA,0,0,5,0,5
2004,Central African Rep.,CAF,Italy,ITA,5,0,0,0,5
2004,Chad,TCD,Italy,ITA,5,5,15,0,25
2004,China,CHN,Italy,ITA,5,0,18,0,23
2004,Cameroon,CMR,Italy,ITA,29,12,37,0,78
2004,Congo,COG,Italy,ITA,47,30,78,0,155
2004,Dem. Rep. of the Congo,COD,Italy,ITA,26,19,29,0,74
2004,Colombia,COL,Italy,ITA,5,0,10,5,20
2004,Cuba,CUB,Italy,ITA,5,0,5,0,10
2004,Ecuador,ECU,Italy,ITA,0,0,5,0,5
2004,Eritrea,ERI,Italy,ITA,190,418,250,0,858
2004,Ethiopia,ETH,Italy,ITA,74,81,77,0,232
2004,Gambia,GMB,Italy,ITA,0,5,18,0,23
2004,Palestinian,PSE,Italy,ITA,5,5,126,0,136
2004,Georgia,GEO,Italy,ITA,5,0,31,0,36
2004,Ghana,GHA,Italy,ITA,0,55,115,0,170
2004,Guinea-Bissau,GNB,Italy,ITA,5,0,5,0,10
2004,Guinea,GIN,Italy,ITA,5,0,0,0,5
2004,Cote d'Ivoire,CIV,Italy,ITA,12,88,80,0,180
2004,India,IND,Italy,ITA,0,0,16,0,16
2004,Iran (Islamic Rep. of),IRN,Italy,ITA,33,5,33,0,71
2004,Iraq,IRQ,Italy,ITA,22,63,388,0,473
2004,Liberia,LBR,Italy,ITA,23,631,774,0,1428
2004,Libya,LBY,Italy,ITA,0,0,5,0,5
2004,Lebanon,LBN,Italy,ITA,0,0,5,0,5
2004,Sri Lanka,LKA,Italy,ITA,0,5,141,14,160
2004,Mauritania,MRT,Italy,ITA,5,0,15,0,20
2004,North Macedonia,MKD,Italy,ITA,5,5,59,0,69
2004,Rep. of Moldova,MDA,Italy,ITA,5,0,46,0,51
2004,Mali,MLI,Italy,ITA,0,0,15,0,15
2004,Morocco,MAR,Italy,ITA,0,0,11,0,11
2004,Niger,NER,Italy,ITA,0,0,16,0,16
2004,Nigeria,NGA,Italy,ITA,15,29,573,0,617
2004,Pakistan,PAK,Italy,ITA,0,5,229,0,234
2004,Peru,PER,Italy,ITA,0,0,5,0,5
2004,Romania,ROU,Italy,ITA,5,11,505,0,521
2004,Russian Federation,RUS,Italy,ITA,5,0,43,0,48
2004,Rwanda,RWA,Italy,ITA,11,0,0,0,11
2004,Serbia and Kosovo: S/RES/1244 (1999),SRB,Italy,ITA,28,65,597,5,695
2004,Senegal,SEN,Italy,ITA,0,0,12,0,12
2004,Sierra Leone,SLE,Italy,ITA,13,29,202,0,244
2004,Somalia,SOM,Italy,ITA,53,454,134,0,641
2004,Sudan,SDN,Italy,ITA,39,180,424,0,643
2004,Slovakia,SVK,Italy,ITA,0,0,0,5,5
2004,Syrian Arab Rep.,SYR,Italy,ITA,11,0,0,0,11
2004,Togo,TGO,Italy,ITA,49,44,72,0,165
2004,Tunisia,TUN,Italy,ITA,0,0,5,0,5
2004,Turkey,TUR,Italy,ITA,19,16,293,5,333
2004,Uganda,UGA,Italy,ITA,0,5,5,0,10
2004,Ukraine,UKR,Italy,ITA,5,0,22,0,27
2004,Zimbabwe,ZWE,Italy,ITA,0,0,5,0,5
2004,Afghanistan,AFG,Rep. of Korea,KOR,0,0,0,5,5
2004,Bangladesh,BGD,Rep. of Korea,KOR,13,0,0,0,13
2004,China,CHN,Rep. of Korea,KOR,0,0,5,0,5
2004,Iran (Islamic Rep. of),IRN,Rep. of Korea,KOR,0,0,0,5,5
2004,Liberia,LBR,Rep. of Korea,KOR,0,0,0,5,5
2004,Egypt,EGY,Latvia,LVA,0,0,5,0,5
2004,Burundi,BDI,Mozambique,MOZ,83,0,0,0,83
2004,Congo,COG,Mozambique,MOZ,0,0,0,5,5
2004,Dem. Rep. of the Congo,COD,Mozambique,MOZ,174,0,0,0,174
2004,Ethiopia,ETH,Mozambique,MOZ,5,0,0,0,5
2004,Liberia,LBR,Mozambique,MOZ,0,0,0,15,15
2004,Rwanda,RWA,Mozambique,MOZ,36,0,0,0,36
2004,Somalia,SOM,Mozambique,MOZ,10,0,0,0,10
2004,Uganda,UGA,Mozambique,MOZ,0,0,0,23,23
2004,Burundi,BDI,Namibia,NAM,0,0,0,10,10
2004,Dem. Rep. of the Congo,COD,Namibia,NAM,27,0,0,33,60
2004,Rwanda,RWA,Namibia,NAM,0,0,0,114,114
2004,Colombia,COL,Nicaragua,NIC,14,0,0,0,14
2004,Cuba,CUB,Nicaragua,NIC,5,0,0,0,5
2004,Peru,PER,Nicaragua,NIC,5,0,0,0,5
2004,Egypt,EGY,Romania,ROU,0,5,0,0,5
2004,Bangladesh,BGD,Romania,ROU,0,0,14,0,14
2004,China,CHN,Romania,ROU,0,0,86,26,112
2004,Cameroon,CMR,Romania,ROU,0,0,5,0,5
2004,Congo,COG,Romania,ROU,0,0,13,0,13
2004,Dem. Rep. of the Congo,COD,Romania,ROU,0,0,5,0,5
2004,Ethiopia,ETH,Romania,ROU,5,0,5,0,10
2004,Palestinian,PSE,Romania,ROU,5,0,5,0,10
2004,Georgia,GEO,Romania,ROU,0,0,13,0,13
2004,India,IND,Romania,ROU,0,0,65,0,65
2004,Iran (Islamic Rep. of),IRN,Romania,ROU,10,5,14,0,29
2004,Iraq,IRQ,Romania,ROU,30,22,37,14,103
2004,Israel,ISR,Romania,ROU,0,0,0,5,5
2004,Jordan,JOR,Romania,ROU,0,0,5,0,5
2004,Liberia,LBR,Romania,ROU,0,0,5,0,5
2004,Lebanon,LBN,Romania,ROU,0,0,5,0,5
2004,Rep. of Moldova,MDA,Romania,ROU,0,0,5,0,5
2004,Nigeria,NGA,Romania,ROU,0,0,5,0,5
2004,Pakistan,PAK,Romania,ROU,0,0,16,0,16
2004,Russian Federation,RUS,Romania,ROU,0,0,5,0,5
2004,Serbia and Kosovo: S/RES/1244 (1999),SRB,Romania,ROU,5,0,0,10,15
2004,Somalia,SOM,Romania,ROU,27,0,5,0,32
2004,Sudan,SDN,Romania,ROU,0,0,10,0,10
2004,Syrian Arab Rep.,SYR,Romania,ROU,0,5,17,0,22
2004,Turkey,TUR,Romania,ROU,11,0,30,5,46
2004,Eritrea,ERI,Sudan,SDN,6430,0,266,0,6696
2004,Ethiopia,ETH,Sudan,SDN,28,0,38,0,66
2005,Congo,COG,Angola,AGO,0,0,5,0,5
2005,Dem. Rep. of the Congo,COD,Angola,AGO,14,0,0,0,14
2005,Guinea,GIN,Angola,AGO,0,0,5,0,5
2005,Cote d'Ivoire,CIV,Angola,AGO,32,0,19,0,51
2005,Liberia,LBR,Angola,AGO,14,0,5,0,19
2005,Malawi,MWI,Angola,AGO,0,0,5,0,5
2005,Sierra Leone,SLE,Angola,AGO,10,0,5,0,15
2005,Somalia,SOM,Angola,AGO,5,0,0,0,5
2005,Afghanistan,AFG,Austria,AUT,517,164,139,204,1024
2005,Albania,ALB,Austria,AUT,10,10,31,16,67
2005,Algeria,DZA,Austria,AUT,0,0,59,115,174
2005,Angola,AGO,Austria,AUT,13,10,5,10,38
2005,Egypt,EGY,Austria,AUT,5,0,10,10,25
2005,Armenia,ARM,Austria,AUT,39,36,98,85,258
2005,Azerbaijan,AZE,Austria,AUT,26,5,18,20,69
2005,Burundi,BDI,Austria,AUT,0,0,5,5,10
2005,Benin,BEN,Austria,AUT,0,0,0,5,5
2005,Bangladesh,BGD,Austria,AUT,0,0,112,455,567
2005,Belarus,BLR,Austria,AUT,10,0,63,170,243
2005,Bosnia and Herzegovina,BIH,Austria,AUT,34,12,77,35,158
2005,Bulgaria,BGR,Austria,AUT,0,5,13,22,40
2005,China,CHN,Austria,AUT,12,0,126,245,383
2005,Cameroon,CMR,Austria,AUT,24,0,16,18,58
2005,Congo,COG,Austria,AUT,10,0,0,0,10
2005,Dem. Rep. of the Congo,COD,Austria,AUT,70,0,17,11,98
2005,Colombia,COL,Austria,AUT,14,0,0,0,14
2005,Cuba,CUB,Austria,AUT,5,0,0,0,5
2005,Czechia,CZE,Austria,AUT,0,0,5,0,5
2005,Eritrea,ERI,Austria,AUT,10,0,0,0,10
2005,Ethiopia,ETH,Austria,AUT,14,0,0,5,19
2005,Gambia,GMB,Austria,AUT,0,0,95,75,170
2005,Georgia,GEO,Austria,AUT,58,33,475,536,1102
2005,Germany,DEU,Austria,AUT,0,0,0,5,5
2005,Ghana,GHA,Austria,AUT,0,0,44,19,63
2005,Guinea-Bissau,GNB,Austria,AUT,0,0,20,47,67
2005,Guinea,GIN,Austria,AUT,5,0,14,58,77
2005,Croatia,HRV,Austria,AUT,0,0,0,11,11
2005,Hungary,HUN,Austria,AUT,0,0,0,5,5
2005,Cote d'Ivoire,CIV,Austria,AUT,0,0,11,17,28
2005,India,IND,Austria,AUT,0,0,353,976,1329
2005,Iran (Islamic Rep. of),IRN,Austria,AUT,247,19,40,302,608
2005,Iraq,IRQ,Austria,AUT,130,56,49,163,398
2005,Israel,ISR,Austria,AUT,0,0,5,19,24
2005,Jordan,JOR,Austria,AUT,0,0,0,13,13
2005,Kazakhstan,KAZ,Austria,AUT,0,0,5,12,17
2005,Kenya,KEN,Austria,AUT,0,0,5,0,5
2005,Kyrgyzstan,KGZ,Austria,AUT,27,5,5,29,66
2005,Liberia,LBR,Austria,AUT,0,0,34,19,53
2005,Libya,LBY,Austria,AUT,0,0,0,5,5
2005,Lebanon,LBN,Austria,AUT,0,0,18,31,49
2005,Sri Lanka,LKA,Austria,AUT,0,0,5,46,51
2005,Lithuania,LTU,Austria,AUT,0,0,14,0,14
2005,Mauritania,MRT,Austria,AUT,0,0,0,5,5
2005,North Macedonia,MKD,Austria,AUT,10,5,166,114,295
2005,Rep. of Moldova,MDA,Austria,AUT,5,12,214,1098,1329
2005,Mali,MLI,Austria,AUT,0,0,10,10,20
2005,Mongolia,MNG,Austria,AUT,5,5,53,279,342
2005,Morocco,MAR,Austria,AUT,0,0,12,11,23
2005,Nepal,NPL,Austria,AUT,0,0,12,20,32
2005,Nigeria,NGA,Austria,AUT,5,10,631,484,1130
2005,Pakistan,PAK,Austria,AUT,10,0,95,366,471
2005,Poland,POL,Austria,AUT,0,0,0,13,13
2005,Romania,ROU,Austria,AUT,13,0,38,58,109
2005,Russian Federation,RUS,Austria,AUT,2427,216,251,597,3491
2005,Rwanda,RWA,Austria,AUT,0,0,0,5,5
2005,Serbia and Kosovo: S/RES/1244 (1999),SRB,Austria,AUT,462,91,1013,829,2395
2005,Senegal,SEN,Austria,AUT,0,0,10,16,26
2005,Sierra Leone,SLE,Austria,AUT,5,0,14,46,65
2005,Somalia,SOM,Austria,AUT,58,5,5,10,78
2005,Viet Nam,VNM,Austria,AUT,5,0,12,5,22
2005,Sudan,SDN,Austria,AUT,30,0,21,35,86
2005,Slovakia,SVK,Austria,AUT,0,0,5,0,5
2005,Syrian Arab Rep.,SYR,Austria,AUT,53,5,14,24,96
2005,Tajikistan,TJK,Austria,AUT,5,0,0,18,23
2005,Togo,TGO,Austria,AUT,11,0,5,5,21
2005,Tunisia,TUN,Austria,AUT,0,0,0,10,10
2005,Turkey,TUR,Austria,AUT,70,14,592,373,1049
2005,Uganda,UGA,Austria,AUT,5,0,5,0,10
2005,Ukraine,UKR,Austria,AUT,32,13,138,152,335
2005,United States of America,USA,Austria,AUT,0,0,0,5,5
2005,Uzbekistan,UZB,Austria,AUT,0,0,0,14,14
2005,Zimbabwe,ZWE,Austria,AUT,0,0,11,0,11
2005,Stateless,XXA,Austria,AUT,32,24,52,203,311
2005,Angola,AGO,Brazil,BRA,11,0,35,88,134
2005,Argentina,ARG,Brazil,BRA,0,0,5,0,5
2005,Burundi,BDI,Brazil,BRA,10,0,5,14,29
2005,Bolivia (Plurinational State of),BOL,Brazil,BRA,0,0,5,0,5
2005,Chile,CHL,Brazil,BRA,0,0,5,0,5
2005,Cameroon,CMR,Brazil,BRA,0,0,0,10,10
2005,Dem. Rep. of the Congo,COD,Brazil,BRA,23,0,37,38,98
2005,Colombia,COL,Brazil,BRA,74,0,24,5,103
2005,Cuba,CUB,Brazil,BRA,0,0,29,33,62
2005,Ecuador,ECU,Brazil,BRA,0,0,5,0,5
2005,Ethiopia,ETH,Brazil,BRA,5,0,0,5,10
2005,Palestinian,PSE,Brazil,BRA,0,0,0,5,5
2005,Guinea-Bissau,GNB,Brazil,BRA,0,0,10,30,40
2005,Cote d'Ivoire,CIV,Brazil,BRA,14,0,0,0,14
2005,India,IND,Brazil,BRA,0,0,0,13,13
2005,Iran (Islamic Rep. of),IRN,Brazil,BRA,0,0,0,5,5
2005,Iraq,IRQ,Brazil,BRA,12,0,5,5,22
2005,Kenya,KEN,Brazil,BRA,0,0,0,5,5
2005,Liberia,LBR,Brazil,BRA,0,0,5,27,32
2005,Nigeria,NGA,Brazil,BRA,0,0,10,23,33
2005,Pakistan,PAK,Brazil,BRA,0,0,0,5,5
2005,Peru,PER,Brazil,BRA,0,0,31,37,68
2005,Romania,ROU,Brazil,BRA,0,0,5,19,24
2005,South Africa,ZAF,Brazil,BRA,0,0,0,5,5
2005,Rwanda,RWA,Brazil,BRA,5,0,0,5,10
2005,Senegal,SEN,Brazil,BRA,0,0,0,5,5
2005,Sierra Leone,SLE,Brazil,BRA,0,0,0,12,12
2005,Somalia,SOM,Brazil,BRA,5,0,0,5,10
2005,Sudan,SDN,Brazil,BRA,5,0,0,5,10
2005,United Rep. of Tanzania,TZA,Brazil,BRA,0,0,0,14,14
2005,Tunisia,TUN,Brazil,BRA,0,0,0,5,5
2005,Bangladesh,BGD,Bosnia and Herzegovina,BIH,0,0,0,11,11
2005,North Macedonia,MKD,Bosnia and Herzegovina,BIH,0,0,0,17,17
2005,Pakistan,PAK,Bosnia and Herzegovina,BIH,0,0,0,5,5
2005,Serbia and Kosovo: S/RES/1244 (1999),SRB,Bosnia and Herzegovina,BIH,0,0,16,20,36
2005,Ukraine,UKR,Bosnia and Herzegovina,BIH,0,0,5,0,5
2005,Congo,COG,Chad,TCD,0,0,5,0,5
2005,Dem. Rep. of the Congo,COD,Chad,TCD,0,19,18,0,37
2005,Eritrea,ERI,Chad,TCD,0,5,0,0,5
2005,Ethiopia,ETH,Chad,TCD,0,5,0,0,5
2005,Rwanda,RWA,Chad,TCD,0,5,5,0,10
2005,Sudan,SDN,Chad,TCD,0,13,0,0,13
2005,Togo,TGO,Chad,TCD,0,5,5,0,10
2005,Azerbaijan,AZE,Estonia,EST,0,0,5,0,5
2005,Iraq,IRQ,Estonia,EST,0,0,5,0,5
2005,Russian Federation,RUS,Estonia,EST,0,0,5,0,5
2005,Uzbekistan,UZB,Estonia,EST,0,0,5,0,5
2005,Burundi,BDI,Ethiopia,ETH,0,0,5,0,5
2005,Cameroon,CMR,Ethiopia,ETH,0,0,0,5,5
2005,Dem. Rep. of the Congo,COD,Ethiopia,ETH,60,0,0,0,60
2005,Eritrea,ERI,Ethiopia,ETH,2966,0,0,0,2966
2005,Afghanistan,AFG,Finland,FIN,0,102,0,5,107
2005,Albania,ALB,Finland,FIN,0,0,0,10,10
2005,Algeria,DZA,Finland,FIN,0,0,0,15,15
2005,Angola,AGO,Finland,FIN,0,22,11,5,38
2005,Egypt,EGY,Finland,FIN,0,0,0,11,11
2005,Armenia,ARM,Finland,FIN,0,0,0,14,14
2005,Azerbaijan,AZE,Finland,FIN,0,0,0,12,12
2005,Bangladesh,BGD,Finland,FIN,0,5,10,12,27
2005,Belarus,BLR,Finland,FIN,0,0,10,14,24
2005,Bosnia and Herzegovina,BIH,Finland,FIN,0,0,5,22,27
2005,Bulgaria,BGR,Finland,FIN,0,0,0,482,482
2005,China,CHN,Finland,FIN,0,0,0,12,12
2005,Cameroon,CMR,Finland,FIN,0,5,13,0,18
2005,Dem. Rep. of the Congo,COD,Finland,FIN,0,18,5,0,23
2005,Czechia,CZE,Finland,FIN,0,0,0,5,5
2005,Ethiopia,ETH,Finland,FIN,0,0,12,0,12
2005,Georgia,GEO,Finland,FIN,0,0,0,19,19
2005,Ghana,GHA,Finland,FIN,0,0,0,5,5
2005,Croatia,HRV,Finland,FIN,0,0,5,0,5
2005,India,IND,Finland,FIN,0,0,0,5,5
2005,Iran (Islamic Rep. of),IRN,Finland,FIN,0,17,35,15,67
2005,Iraq,IRQ,Finland,FIN,0,95,0,17,112
2005,Israel,ISR,Finland,FIN,0,5,0,0,5
2005,Kazakhstan,KAZ,Finland,FIN,0,0,5,0,5
2005,Kyrgyzstan,KGZ,Finland,FIN,0,13,0,0,13
2005,Libya,LBY,Finland,FIN,0,5,0,5,10
2005,Sri Lanka,LKA,Finland,FIN,0,0,5,0,5
2005,Latvia,LVA,Finland,FIN,0,14,0,0,14
2005,North Macedonia,MKD,Finland,FIN,0,0,5,48,53
2005,Rep. of Moldova,MDA,Finland,FIN,0,0,0,23,23
2005,Nigeria,NGA,Finland,FIN,0,5,30,21,56
2005,Pakistan,PAK,Finland,FIN,0,0,5,0,5
2005,Romania,ROU,Finland,FIN,0,0,5,55,60
2005,Russian Federation,RUS,Finland,FIN,5,36,16,106,163
2005,Rwanda,RWA,Finland,FIN,0,5,0,0,5
2005,Serbia and Kosovo: S/RES/1244 (1999),SRB,Finland,FIN,0,48,31,141,220
2005,Somalia,SOM,Finland,FIN,5,154,0,5,164
2005,Viet Nam,VNM,Finland,FIN,0,0,0,5,5
2005,Sudan,SDN,Finland,FIN,0,0,0,5,5
2005,Slovakia,SVK,Finland,FIN,0,0,0,62,62
2005,Syrian Arab Rep.,SYR,Finland,FIN,0,0,0,10,10
2005,Turkey,TUR,Finland,FIN,0,32,20,51,103
2005,Ukraine,UKR,Finland,FIN,0,0,5,5,10
2005,Stateless,XXA,Finland,FIN,0,13,0,5,18
2005,Afghanistan,AFG,Italy,ITA,12,54,25,0,91
2005,Albania,ALB,Italy,ITA,0,10,19,0,29
2005,Azerbaijan,AZE,Italy,ITA,13,0,0,0,13
2005,Bangladesh,BGD,Italy,ITA,5,33,315,0,353
2005,Chad,TCD,Italy,ITA,0,0,5,0,5
2005,Cameroon,CMR,Italy,ITA,36,15,30,0,81
2005,Congo,COG,Italy,ITA,26,26,20,0,72
2005,Dem. Rep. of the Congo,COD,Italy,ITA,33,16,0,0,49
2005,Colombia,COL,Italy,ITA,11,19,23,0,53
2005,Cuba,CUB,Italy,ITA,11,5,0,0,16
2005,Eritrea,ERI,Italy,ITA,245,1675,45,0,1965
2005,Ethiopia,ETH,Italy,ITA,103,488,134,0,725
2005,Palestinian,PSE,Italy,ITA,5,16,130,0,151
2005,Ghana,GHA,Italy,ITA,0,31,433,0,464
2005,Cote d'Ivoire,CIV,Italy,ITA,23,430,277,0,730
2005,India,IND,Italy,ITA,0,5,79,0,84
2005,Iran (Islamic Rep. of),IRN,Italy,ITA,41,23,12,0,76
2005,Iraq,IRQ,Italy,ITA,22,49,71,0,142
2005,Liberia,LBR,Italy,ITA,18,111,649,0,778
2005,Sri Lanka,LKA,Italy,ITA,5,29,15,0,49
2005,North Macedonia,MKD,Italy,ITA,5,10,38,0,53
2005,Rep. of Moldova,MDA,Italy,ITA,5,11,42,0,58
2005,Mali,MLI,Italy,ITA,0,0,50,0,50
2005,Nigeria,NGA,Italy,ITA,31,72,517,0,620
2005,Pakistan,PAK,Italy,ITA,11,47,336,0,394
2005,Romania,ROU,Italy,ITA,0,17,193,0,210
2005,Russian Federation,RUS,Italy,ITA,5,10,27,0,42
2005,Serbia and Kosovo: S/RES/1244 (1999),SRB,Italy,ITA,38,142,803,0,983
2005,Senegal,SEN,Italy,ITA,0,0,11,0,11
2005,Sierra Leone,SLE,Italy,ITA,5,35,116,0,156
2005,Somalia,SOM,Italy,ITA,23,194,21,0,238
2005,Sudan,SDN,Italy,ITA,46,493,259,0,798
2005,Syrian Arab Rep.,SYR,Italy,ITA,14,0,0,0,14
2005,Togo,TGO,Italy,ITA,46,209,216,0,471
2005,Turkey,TUR,Italy,ITA,22,51,159,0,232
2005,Bangladesh,BGD,Rep. of Korea,KOR,0,0,5,0,5
2005,China,CHN,Rep. of Korea,KOR,0,0,49,5,54
2005,Dem. Rep. of the Congo,COD,Rep. of Korea,KOR,0,12,0,0,12
2005,Ethiopia,ETH,Rep. of Korea,KOR,5,0,0,0,5
2005,Cote d'Ivoire,CIV,Rep. of Korea,KOR,0,0,0,5,5
2005,Iran (Islamic Rep. of),IRN,Rep. of Korea,KOR,0,0,0,5,5
2005,Liberia,LBR,Rep. of Korea,KOR,0,0,0,10,10
2005,Sri Lanka,LKA,Rep. of Korea,KOR,0,0,5,0,5
2005,Myanmar,MMR,Rep. of Korea,KOR,5,0,12,0,17
2005,Nigeria,NGA,Rep. of Korea,KOR,0,0,0,5,5
2005,Pakistan,PAK,Rep. of Korea,KOR,0,0,5,0,5
2005,Uganda,UGA,Rep. of Korea,KOR,0,0,0,5,5
2005,Iraq,IRQ,Latvia,LVA,0,0,0,5,5
2005,Afghanistan,AFG,Rep. of Moldova,MDA,0,5,0,0,5
2005,Dem. Rep. of the Congo,COD,Rep. of Moldova,MDA,0,0,0,5,5
2005,Palestinian,PSE,Rep. of Moldova,MDA,10,0,0,10,20
2005,Georgia,GEO,Rep. of Moldova,MDA,0,0,0,5,5
2005,Iraq,IRQ,Rep. of Moldova,MDA,0,5,0,5,10
2005,Jordan,JOR,Rep. of Moldova,MDA,5,0,0,5,10
2005,Kyrgyzstan,KGZ,Rep. of Moldova,MDA,5,0,0,0,5
2005,Russian Federation,RUS,Rep. of Moldova,MDA,5,5,19,24,53
2005,Sudan,SDN,Rep. of Moldova,MDA,0,0,5,0,5
2005,Syrian Arab Rep.,SYR,Rep. of Moldova,MDA,11,0,0,0,11
2005,Turkey,TUR,Rep. of Moldova,MDA,0,0,0,5,5
2005,Colombia,COL,Panama,PAN,47,71,149,0,267
2005,Cuba,CUB,Panama,PAN,5,0,0,5,10
2005,Egypt,EGY,Papua New Guinea,PNG,5,0,0,0,5
2005,Indonesia,IDN,Papua New Guinea,PNG,0,186,0,0,186
2005,Russian Federation,RUS,Papua New Guinea,PNG,5,0,0,0,5
2005,Algeria,DZA,Romania,ROU,0,0,5,0,5
2005,Egypt,EGY,Romania,ROU,0,0,5,5,10
2005,Bangladesh,BGD,Romania,ROU,0,0,51,0,51
2005,China,CHN,Romania,ROU,0,0,39,10,49
2005,Congo,COG,Romania,ROU,0,0,12,0,12
2005,Palestinian,PSE,Romania,ROU,0,0,5,0,5
2005,Georgia,GEO,Romania,ROU,0,0,14,0,14
2005,Guinea,GIN,Romania,ROU,0,0,5,0,5
2005,Cote d'Ivoire,CIV,Romania,ROU,0,0,5,0,5
2005,India,IND,Romania,ROU,0,0,24,5,29
2005,Iran (Islamic Rep. of),IRN,Romania,ROU,0,0,16,5,21
2005,Iraq,IRQ,Romania,ROU,26,10,39,5,80
2005,Jordan,JOR,Romania,ROU,0,0,10,0,10
2005,Liberia,LBR,Romania,ROU,0,0,24,0,24
2005,Lebanon,LBN,Romania,ROU,0,0,5,0,5
2005,Rep. of Moldova,MDA,Romania,ROU,0,0,5,0,5
2005,Nigeria,NGA,Romania,ROU,0,0,20,0,20
2005,Pakistan,PAK,Romania,ROU,0,0,36,5,41
2005,Sierra Leone,SLE,Romania,ROU,0,0,5,0,5
2005,Somalia,SOM,Romania,ROU,10,0,11,0,21
2005,Sudan,SDN,Romania,ROU,5,0,5,0,10
2005,Syrian Arab Rep.,SYR,Romania,ROU,0,5,30,5,40
2005,Tunisia,TUN,Romania,ROU,0,0,5,0,5
2005,Turkey,TUR,Romania,ROU,5,0,28,10,43
2005,Ukraine,UKR,Romania,ROU,0,0,5,0,5
2005,Uzbekistan,UZB,Romania,ROU,5,0,0,0,5
2005,Afghanistan,AFG,Spain,ESP,0,0,5,5,10
2005,Albania,ALB,Spain,ESP,13,0,0,0,13
2005,Algeria,DZA,Spain,ESP,0,0,85,489,574
2005,Angola,AGO,Spain,ESP,0,0,18,5,23
2005,Egypt,EGY,Spain,ESP,0,14,0,0,14
2005,Argentina,ARG,Spain,ESP,0,0,0,5,5
2005,Armenia,ARM,Spain,ESP,5,0,66,26,97
2005,Azerbaijan,AZE,Spain,ESP,0,0,0,5,5
2005,Burundi,BDI,Spain,ESP,0,0,5,0,5
2005,Benin,BEN,Spain,ESP,0,0,0,5,5
2005,Bangladesh,BGD,Spain,ESP,0,0,14,27,41
2005,Burkina Faso,BFA,Spain,ESP,0,0,0,5,5
2005,Belarus,BLR,Spain,ESP,0,0,21,5,26
2005,Bolivia (Plurinational State of),BOL,Spain,ESP,0,0,0,10,10
2005,Brazil,BRA,Spain,ESP,0,0,5,0,5
2005,Bosnia and Herzegovina,BIH,Spain,ESP,0,0,12,0,12
2005,Central African Rep.,CAF,Spain,ESP,0,0,0,5,5
2005,China,CHN,Spain,ESP,0,0,0,10,10
2005,Chile,CHL,Spain,ESP,0,0,0,5,5
2005,Cameroon,CMR,Spain,ESP,0,0,40,41,81
2005,Congo,COG,Spain,ESP,0,0,16,5,21
2005,Dem. Rep. of the Congo,COD,Spain,ESP,5,0,93,68,166
2005,Colombia,COL,Spain,ESP,98,27,596,512,1233
2005,Cuba,CUB,Spain,ESP,17,17,51,29,114
2005,Ecuador,ECU,Spain,ESP,0,0,0,5,5
2005,Equatorial Guinea,GNQ,Spain,ESP,17,0,20,5,42
2005,Eritrea,ERI,Spain,ESP,0,0,5,0,5
2005,Ethiopia,ETH,Spain,ESP,5,0,21,0,26
2005,France,FRA,Spain,ESP,0,0,0,5,5
2005,Gabon,GAB,Spain,ESP,0,0,5,0,5
2005,Gambia,GMB,Spain,ESP,0,0,23,53,76
2005,Georgia,GEO,Spain,ESP,5,0,25,10,40
2005,Ghana,GHA,Spain,ESP,0,0,5,31,36
2005,Guinea-Bissau,GNB,Spain,ESP,0,0,31,91,122
2005,Guatemala,GTM,Spain,ESP,0,0,5,0,5
2005,Guinea,GIN,Spain,ESP,0,0,28,160,188
2005,Haiti,HTI,Spain,ESP,0,0,0,5,5
2005,Cote d'Ivoire,CIV,Spain,ESP,0,12,25,14,51
2005,India,IND,Spain,ESP,0,0,5,18,23
2005,Iran (Islamic Rep. of),IRN,Spain,ESP,5,0,17,5,27
2005,Iraq,IRQ,Spain,ESP,5,10,0,10,25
2005,Kazakhstan,KAZ,Spain,ESP,0,0,10,0,10
2005,Kyrgyzstan,KGZ,Spain,ESP,0,0,5,0,5
2005,Liberia,LBR,Spain,ESP,0,5,13,43,61
2005,Sri Lanka,LKA,Spain,ESP,0,0,5,0,5
2005,Mauritania,MRT,Spain,ESP,5,0,12,13,30
2005,North Macedonia,MKD,Spain,ESP,0,0,0,14,14
2005,Rep. of Moldova,MDA,Spain,ESP,0,0,0,5,5
2005,Mexico,MEX,Spain,ESP,0,0,5,0,5
2005,Mali,MLI,Spain,ESP,0,0,80,192,272
2005,Mongolia,MNG,Spain,ESP,0,0,0,18,18
2005,Morocco,MAR,Spain,ESP,5,0,15,35,55
2005,Mozambique,MOZ,Spain,ESP,0,0,0,5,5
2005,Nepal,NPL,Spain,ESP,0,0,0,5,5
2005,Niger,NER,Spain,ESP,0,0,0,12,12
2005,Nigeria,NGA,Spain,ESP,0,0,136,607,743
2005,Pakistan,PAK,Spain,ESP,0,0,0,12,12
2005,Peru,PER,Spain,ESP,0,0,5,5,10
2005,Romania,ROU,Spain,ESP,0,0,0,11,11
2005,Russian Federation,RUS,Spain,ESP,23,20,58,33,134
2005,Rwanda,RWA,Spain,ESP,0,0,5,0,5
2005,Serbia and Kosovo: S/RES/1244 (1999),SRB,Spain,ESP,5,5,29,19,58
2005,Senegal,SEN,Spain,ESP,0,0,0,12,12
2005,Sierra Leone,SLE,Spain,ESP,0,5,5,53,63
2005,Somalia,SOM,Spain,ESP,0,12,5,0,17
2005,Sudan,SDN,Spain,ESP,0,0,43,15,58
2005,Slovakia,SVK,Spain,ESP,0,0,5,0,5
2005,Syrian Arab Rep.,SYR,Spain,ESP,0,0,0,5,5
2005,Togo,TGO,Spain,ESP,0,0,5,0,5
2005,Tunisia,TUN,Spain,ESP,0,0,5,0,5
2005,Turkey,TUR,Spain,ESP,0,0,10,10,20
2005,Uganda,UGA,Spain,ESP,0,0,0,5,5
2005,Ukraine,UKR,Spain,ESP,0,0,19,11,30
2005,Uzbekistan,UZB,Spain,ESP,0,0,0,5,5
2005,Venezuela (Bolivarian Republic of),VEN,Spain,ESP,0,0,5,14,19
2005,Zimbabwe,ZWE,Spain,ESP,0,0,0,5,5
2005,Stateless,XXA,Spain,ESP,5,5,11,17,38
2005,Eritrea,ERI,Sudan,SDN,5942,0,69,194,6205
2005,Ethiopia,ETH,Sudan,SDN,17,0,10,0,27
2005,Somalia,SOM,Sudan,SDN,0,0,5,5,10
2005,Afghanistan,AFG,Tajikistan,TJK,53,0,211,402,666
2005,Iran (Islamic Rep. of),IRN,Tajikistan,TJK,0,0,15,0,15
2006,China,CHN,Albania,ALB,5,0,0,0,5
2006,India,IND,Albania,ALB,0,0,0,5,5
2006,Serbia and Kosovo: S/RES/1244 (1999),SRB,Albania,ALB,0,5,0,0,5
2006,Chad,TCD,Angola,AGO,0,0,10,0,10
2006,Congo,COG,Angola,AGO,0,0,5,0,5
2006,Dem. Rep. of the Congo,COD,Angola,AGO,5,0,15,0,20
2006,Eritrea,ERI,Angola,AGO,5,0,0,0,5
2006,Ethiopia,ETH,Angola,AGO,0,0,5,0,5
2006,Guinea,GIN,Angola,AGO,5,0,12,0,17
2006,Cote d'Ivoire,CIV,Angola,AGO,61,0,65,0,126
2006,Liberia,LBR,Angola,AGO,35,0,13,0,48
2006,Mauritania,MRT,Angola,AGO,5,0,5,0,10
2006,Sierra Leone,SLE,Angola,AGO,13,5,39,0,57
2006,Somalia,SOM,Angola,AGO,0,0,5,0,5
2006,Sudan,SDN,Angola,AGO,0,0,14,0,14
2006,Afghanistan,AFG,Austria,AUT,475,212,128,145,960
2006,Albania,ALB,Austria,AUT,17,0,21,10,48
2006,Algeria,DZA,Austria,AUT,0,0,75,67,142
2006,Angola,AGO,Austria,AUT,18,0,5,5,28
2006,Egypt,EGY,Austria,AUT,0,0,23,24,47
2006,Armenia,ARM,Austria,AUT,100,35,125,91,351
2006,Azerbaijan,AZE,Austria,AUT,31,10,14,15,70
2006,Burundi,BDI,Austria,AUT,0,0,0,5,5
2006,Benin,BEN,Austria,AUT,5,0,0,0,5
2006,Bangladesh,BGD,Austria,AUT,5,5,46,102,158
2006,Burkina Faso,BFA,Austria,AUT,5,0,0,0,5
2006,Belarus,BLR,Austria,AUT,5,0,96,132,233
2006,Bosnia and Herzegovina,BIH,Austria,AUT,17,21,105,137,280
2006,Bulgaria,BGR,Austria,AUT,0,0,17,27,44
2006,China,CHN,Austria,AUT,26,0,126,189,341
2006,Cameroon,CMR,Austria,AUT,17,0,13,14,44
2006,Congo,COG,Austria,AUT,14,0,0,5,19
2006,Dem. Rep. of the Congo,COD,Austria,AUT,57,0,5,5,67
2006,Colombia,COL,Austria,AUT,11,0,0,0,11
2006,Eritrea,ERI,Austria,AUT,5,0,0,0,5
2006,Estonia,EST,Austria,AUT,0,0,5,0,5
2006,Ethiopia,ETH,Austria,AUT,16,0,0,0,16
2006,Gabon,GAB,Austria,AUT,0,0,0,5,5
2006,Gambia,GMB,Austria,AUT,5,0,43,32,80
2006,Georgia,GEO,Austria,AUT,38,27,504,311,880
2006,Ghana,GHA,Austria,AUT,5,0,28,14,47
2006,Guinea-Bissau,GNB,Austria,AUT,0,0,31,23,54
2006,Guinea,GIN,Austria,AUT,5,0,12,13,30
2006,Croatia,HRV,Austria,AUT,0,0,5,5,10
2006,Hungary,HUN,Austria,AUT,0,0,5,5,10
2006,Cote d'Ivoire,CIV,Austria,AUT,0,0,5,10,15
2006,India,IND,Austria,AUT,0,5,432,342,779
2006,Iran (Islamic Rep. of),IRN,Austria,AUT,211,15,62,80,368
2006,Iraq,IRQ,Austria,AUT,92,46,50,122,310
2006,Israel,ISR,Austria,AUT,0,0,0,11,11
2006,Jordan,JOR,Austria,AUT,0,0,10,0,10
2006,Kazakhstan,KAZ,Austria,AUT,0,0,0,13,13
2006,Kenya,KEN,Austria,AUT,0,0,5,0,5
2006,Kyrgyzstan,KGZ,Austria,AUT,26,5,21,16,68
2006,Dem. People's Rep. of Korea,PRK,Austria,AUT,0,0,0,5,5
2006,Liberia,LBR,Austria,AUT,5,0,30,16,51
2006,Libya,LBY,Austria,AUT,0,0,5,0,5
2006,Lebanon,LBN,Austria,AUT,0,0,12,19,31
2006,Sri Lanka,LKA,Austria,AUT,0,0,5,16,21
2006,Mauritania,MRT,Austria,AUT,0,0,0,5,5
2006,North Macedonia,MKD,Austria,AUT,10,11,157,106,284
2006,Rep. of Moldova,MDA,Austria,AUT,13,10,259,748,1030
2006,Mali,MLI,Austria,AUT,0,0,12,5,17
2006,Mongolia,MNG,Austria,AUT,0,10,159,208,377
2006,Morocco,MAR,Austria,AUT,5,0,15,16,36
2006,Nepal,NPL,Austria,AUT,10,0,13,11,34
2006,Nigeria,NGA,Austria,AUT,11,11,352,320,694
2006,Pakistan,PAK,Austria,AUT,5,5,90,105,205
2006,Philippines,PHL,Austria,AUT,0,0,0,5,5
2006,Poland,POL,Austria,AUT,0,0,5,0,5
2006,Romania,ROU,Austria,AUT,5,0,73,44,122
2006,South Africa,ZAF,Austria,AUT,0,5,5,0,10
2006,Russian Federation,RUS,Austria,AUT,2091,214,398,458,3161
2006,Rwanda,RWA,Austria,AUT,5,0,0,0,5
2006,Serbia and Kosovo: S/RES/1244 (1999),SRB,Austria,AUT,318,168,1530,869,2885
2006,Senegal,SEN,Austria,AUT,0,0,14,5,19
2006,Sierra Leone,SLE,Austria,AUT,0,0,23,17,40
2006,Somalia,SOM,Austria,AUT,103,18,10,30,161
2006,Viet Nam,VNM,Austria,AUT,0,0,14,5,19
2006,Sudan,SDN,Austria,AUT,27,0,21,11,59
2006,Slovakia,SVK,Austria,AUT,0,0,0,5,5
2006,Syrian Arab Rep.,SYR,Austria,AUT,48,0,20,23,91
2006,Tajikistan,TJK,Austria,AUT,5,0,0,0,5
2006,Togo,TGO,Austria,AUT,0,0,5,5,10
2006,Tunisia,TUN,Austria,AUT,0,0,5,13,18
2006,Turkey,TUR,Austria,AUT,113,30,380,307,830
2006,Uganda,UGA,Austria,AUT,0,0,0,14,14
2006,Ukraine,UKR,Austria,AUT,20,10,107,95,232
2006,Uzbekistan,UZB,Austria,AUT,13,5,5,5,28
2006,Stateless,XXA,Austria,AUT,41,18,80,78,217
2006,China,CHN,Bosnia and Herzegovina,BIH,0,0,0,5,5
2006,Palestinian,PSE,Bosnia and Herzegovina,BIH,5,0,0,0,5
2006,Iraq,IRQ,Bosnia and Herzegovina,BIH,0,0,0,5,5
2006,North Macedonia,MKD,Bosnia and Herzegovina,BIH,0,0,0,10,10
2006,Rep. of Moldova,MDA,Bosnia and Herzegovina,BIH,0,0,5,0,5
2006,Russian Federation,RUS,Bosnia and Herzegovina,BIH,0,0,0,5,5
2006,Serbia and Kosovo: S/RES/1244 (1999),SRB,Bosnia and Herzegovina,BIH,0,0,23,68,91
2006,Colombia,COL,Costa Rica,CRI,383,0,0,0,383
2006,Cuba,CUB,Costa Rica,CRI,22,0,0,0,22
2006,Venezuela (Bolivarian Republic of),VEN,Costa Rica,CRI,26,0,0,0,26
2006,Angola,AGO,Gabon,GAB,0,0,0,31,31
2006,Central African Rep.,CAF,Gabon,GAB,0,0,5,0,5
2006,Chad,TCD,Gabon,GAB,0,0,39,291,330
2006,Cameroon,CMR,Gabon,GAB,0,0,5,5,10
2006,Congo,COG,Gabon,GAB,0,0,49,5,54
2006,Dem. Rep. of the Congo,COD,Gabon,GAB,0,0,72,524,596
2006,Equatorial Guinea,GNQ,Gabon,GAB,0,0,5,34,39
2006,Cote d'Ivoire,CIV,Gabon,GAB,0,0,15,0,15
2006,Liberia,LBR,Gabon,GAB,0,0,0,18,18
2006,Mauritania,MRT,Gabon,GAB,0,0,0,18,18
2006,Niger,NER,Gabon,GAB,0,0,0,10,10
2006,Nigeria,NGA,Gabon,GAB,0,0,5,0,5
2006,Rwanda,RWA,Gabon,GAB,0,0,5,5,10
2006,Sierra Leone,SLE,Gabon,GAB,0,0,0,14,14
2006,Somalia,SOM,Gabon,GAB,0,0,0,5,5
2006,Togo,TGO,Gabon,GAB,0,0,5,0,5
2006,Iran (Islamic Rep. of),IRN,Georgia,GEO,0,0,11,0,11
2006,Russian Federation,RUS,Georgia,GEO,10,0,0,0,10
2006,Afghanistan,AFG,Greece,GRC,10,10,1008,120,1148
2006,Albania,ALB,Greece,GRC,0,0,10,13,23
2006,Algeria,DZA,Greece,GRC,0,0,26,10,36
2006,Egypt,EGY,Greece,GRC,0,0,20,12,32
2006,Armenia,ARM,Greece,GRC,0,0,16,18,34
2006,Azerbaijan,AZE,Greece,GRC,0,5,13,0,18
2006,Burundi,BDI,Greece,GRC,0,0,14,10,24
2006,Bangladesh,BGD,Greece,GRC,0,0,2791,376,3167
2006,Burkina Faso,BFA,Greece,GRC,0,0,24,0,24
2006,Belarus,BLR,Greece,GRC,0,0,0,18,18
2006,Bulgaria,BGR,Greece,GRC,0,0,10,29,39
2006,Chad,TCD,Greece,GRC,0,0,5,0,5
2006,China,CHN,Greece,GRC,0,0,26,159,185
2006,Cameroon,CMR,Greece,GRC,0,0,10,0,10
2006,Dem. Rep. of the Congo,COD,Greece,GRC,11,5,24,10,50
2006,Eritrea,ERI,Greece,GRC,0,0,18,26,44
2006,Ethiopia,ETH,Greece,GRC,0,0,143,66,209
2006,Gambia,GMB,Greece,GRC,0,0,5,0,5
2006,Georgia,GEO,Greece,GRC,0,0,221,354,575
2006,Ghana,GHA,Greece,GRC,0,0,79,15,94
2006,Guinea,GIN,Greece,GRC,0,0,30,0,30
2006,Cote d'Ivoire,CIV,Greece,GRC,0,5,70,5,80
2006,India,IND,Greece,GRC,0,0,120,61,181
2006,Indonesia,IDN,Greece,GRC,0,0,5,5,10
2006,Iran (Islamic Rep. of),IRN,Greece,GRC,10,0,480,67,557
2006,Iraq,IRQ,Greece,GRC,0,0,1756,218,1974
2006,Kazakhstan,KAZ,Greece,GRC,0,0,5,0,5
2006,Kenya,KEN,Greece,GRC,0,0,0,5,5
2006,Liberia,LBR,Greece,GRC,0,0,11,0,11
2006,Libya,LBY,Greece,GRC,5,0,5,0,10
2006,Lebanon,LBN,Greece,GRC,0,0,25,5,30
2006,Sri Lanka,LKA,Greece,GRC,0,0,93,33,126
2006,Mauritania,MRT,Greece,GRC,0,0,55,0,55
2006,Rep. of Moldova,MDA,Greece,GRC,0,0,32,42,74
2006,Mali,MLI,Greece,GRC,0,0,5,0,5
2006,Morocco,MAR,Greece,GRC,0,0,5,5,10
2006,Myanmar,MMR,Greece,GRC,0,0,20,28,48
2006,Nepal,NPL,Greece,GRC,0,0,0,5,5
2006,Nigeria,NGA,Greece,GRC,0,13,499,102,614
2006,Pakistan,PAK,Greece,GRC,0,0,1752,374,2126
2006,Philippines,PHL,Greece,GRC,0,0,14,10,24
2006,Romania,ROU,Greece,GRC,0,0,15,71,86
2006,Russian Federation,RUS,Greece,GRC,0,0,23,85,108
2006,Rwanda,RWA,Greece,GRC,0,0,22,5,27
2006,Senegal,SEN,Greece,GRC,0,0,55,5,60
2006,Sierra Leone,SLE,Greece,GRC,0,0,35,11,46
2006,Somalia,SOM,Greece,GRC,10,5,153,69,237
2006,Sudan,SDN,Greece,GRC,0,5,198,39,242
2006,Syrian Arab Rep.,SYR,Greece,GRC,0,0,134,27,161
2006,United Rep. of Tanzania,TZA,Greece,GRC,0,0,15,0,15
2006,Tunisia,TUN,Greece,GRC,0,0,5,0,5
2006,Turkey,TUR,Greece,GRC,0,0,115,15,130
2006,Uganda,UGA,Greece,GRC,0,0,10,5,15
2006,Ukraine,UKR,Greece,GRC,0,0,15,41,56
2006,Uzbekistan,UZB,Greece,GRC,0,0,5,5,10
2006,Afghanistan,AFG,Italy,ITA,51,120,86,0,257
2006,Albania,ALB,Italy,ITA,5,5,18,0,28
2006,Algeria,DZA,Italy,ITA,0,5,17,0,22
2006,Angola,AGO,Italy,ITA,5,10,5,0,20
2006,Egypt,EGY,Italy,ITA,0,0,22,0,22
2006,Armenia,ARM,Italy,ITA,5,12,10,0,27
2006,Azerbaijan,AZE,Italy,ITA,12,14,5,0,31
2006,Burundi,BDI,Italy,ITA,0,10,0,0,10
2006,Benin,BEN,Italy,ITA,0,0,14,0,14
2006,Bangladesh,BGD,Italy,ITA,13,65,397,0,475
2006,Burkina Faso,BFA,Italy,ITA,5,10,19,0,34
2006,Belarus,BLR,Italy,ITA,0,5,10,0,15
2006,Brazil,BRA,Italy,ITA,0,0,5,0,5
2006,Bosnia and Herzegovina,BIH,Italy,ITA,0,0,14,0,14
2006,Bulgaria,BGR,Italy,ITA,0,5,27,0,32
2006,Central African Rep.,CAF,Italy,ITA,0,5,0,0,5
2006,Chad,TCD,Italy,ITA,0,10,21,0,31
2006,China,CHN,Italy,ITA,0,5,0,0,5
2006,Cameroon,CMR,Italy,ITA,38,41,29,0,108
2006,Congo,COG,Italy,ITA,40,67,35,0,142
2006,Dem. Rep. of the Congo,COD,Italy,ITA,24,23,0,0,47
2006,Colombia,COL,Italy,ITA,23,151,122,0,296
2006,Cuba,CUB,Italy,ITA,5,11,5,0,21
2006,Cabo Verde,CPV,Italy,ITA,17,0,0,0,17
2006,Ecuador,ECU,Italy,ITA,0,0,5,0,5
2006,Eritrea,ERI,Italy,ITA,177,2139,404,0,2720
2006,Ethiopia,ETH,Italy,ITA,151,307,121,0,579
2006,Gambia,GMB,Italy,ITA,5,10,43,0,58
2006,Palestinian,PSE,Italy,ITA,0,13,103,0,116
2006,Georgia,GEO,Italy,ITA,0,10,15,0,25
2006,Ghana,GHA,Italy,ITA,0,29,562,0,591
2006,Guinea-Bissau,GNB,Italy,ITA,0,5,5,0,10
2006,Guinea,GIN,Italy,ITA,5,28,41,0,74
2006,Cote d'Ivoire,CIV,Italy,ITA,52,400,168,0,620
2006,India,IND,Italy,ITA,0,14,158,0,172
2006,Iran (Islamic Rep. of),IRN,Italy,ITA,27,32,32,0,91
2006,Iraq,IRQ,Italy,ITA,22,74,293,0,389
2006,Jordan,JOR,Italy,ITA,0,0,5,0,5
2006,Liberia,LBR,Italy,ITA,5,105,483,0,593
2006,Lebanon,LBN,Italy,ITA,5,28,16,0,49
2006,Sri Lanka,LKA,Italy,ITA,5,28,190,0,223
2006,Mauritania,MRT,Italy,ITA,0,13,0,0,13
2006,North Macedonia,MKD,Italy,ITA,0,5,81,0,86
2006,Rep. of Moldova,MDA,Italy,ITA,0,10,63,0,73
2006,Mali,MLI,Italy,ITA,0,5,95,0,100
2006,Morocco,MAR,Italy,ITA,5,10,341,0,356
2006,Myanmar,MMR,Italy,ITA,0,0,5,0,5
2006,Niger,NER,Italy,ITA,5,5,117,0,127
2006,Nigeria,NGA,Italy,ITA,29,248,808,0,1085
2006,Pakistan,PAK,Italy,ITA,10,70,698,0,778
2006,Peru,PER,Italy,ITA,0,5,5,0,10
2006,Philippines,PHL,Italy,ITA,0,0,5,0,5
2006,Poland,POL,Italy,ITA,0,0,5,0,5
2006,Romania,ROU,Italy,ITA,0,5,347,0,352
2006,Russian Federation,RUS,Italy,ITA,5,20,43,0,68
2006,Rwanda,RWA,Italy,ITA,5,0,0,0,5
2006,El Salvador,SLV,Italy,ITA,0,5,5,0,10
2006,Serbia and Kosovo: S/RES/1244 (1999),SRB,Italy,ITA,36,212,740,0,988
2006,Senegal,SEN,Italy,ITA,0,5,24,0,29
2006,Sierra Leone,SLE,Italy,ITA,5,27,117,0,149
2006,Somalia,SOM,Italy,ITA,16,118,247,0,381
2006,Viet Nam,VNM,Italy,ITA,0,0,5,0,5
2006,Sudan,SDN,Italy,ITA,82,243,251,0,576
2006,Syrian Arab Rep.,SYR,Italy,ITA,11,5,12,0,28
2006,Togo,TGO,Italy,ITA,78,398,170,0,646
2006,Tunisia,TUN,Italy,ITA,0,5,49,0,54
2006,Turkey,TUR,Italy,ITA,37,76,165,0,278
2006,Uganda,UGA,Italy,ITA,0,12,0,0,12
2006,Ukraine,UKR,Italy,ITA,0,27,37,0,64
2006,Uzbekistan,UZB,Italy,ITA,5,0,0,0,5
2006,Stateless,XXA,Italy,ITA,5,0,0,0,5
2006,Afghanistan,AFG,Kyrgyzstan,KGZ,14,0,47,14,75
2006,Iran (Islamic Rep. of),IRN,Kyrgyzstan,KGZ,5,0,5,0,10
2006,Russian Federation,RUS,Kyrgyzstan,KGZ,0,0,0,155,155
2006,Syrian Arab Rep.,SYR,Kyrgyzstan,KGZ,0,0,5,0,5
2006,Tajikistan,TJK,Kyrgyzstan,KGZ,5,0,0,0,5
2006,Uzbekistan,UZB,Kyrgyzstan,KGZ,0,0,5,42,47
2006,Bangladesh,BGD,Rep. of Korea,KOR,0,0,5,0,5
2006,China,CHN,Rep. of Korea,KOR,0,5,64,17,86
2006,Dem. Rep. of the Congo,COD,Rep. of Korea,KOR,0,0,5,0,5
2006,Ethiopia,ETH,Rep. of Korea,KOR,0,0,5,0,5
2006,Iran (Islamic Rep. of),IRN,Rep. of Korea,KOR,0,5,0,0,5
2006,Liberia,LBR,Rep. of Korea,KOR,0,0,0,5,5
2006,Myanmar,MMR,Rep. of Korea,KOR,12,0,0,5,17
2006,Nepal,NPL,Rep. of Korea,KOR,0,0,0,5,5
2006,Nigeria,NGA,Rep. of Korea,KOR,0,0,13,0,13
2006,Pakistan,PAK,Rep. of Korea,KOR,0,0,5,0,5
2006,Uganda,UGA,Rep. of Korea,KOR,0,0,12,5,17
2006,Russian Federation,RUS,Latvia,LVA,0,0,0,5,5
2006,Somalia,SOM,Latvia,LVA,0,5,0,0,5
2006,Afghanistan,AFG,Rep. of Moldova,MDA,0,5,0,0,5
2006,Egypt,EGY,Rep. of Moldova,MDA,0,5,0,0,5
2006,Armenia,ARM,Rep. of Moldova,MDA,5,13,0,5,23
2006,Azerbaijan,AZE,Rep. of Moldova,MDA,0,5,0,0,5
2006,Ethiopia,ETH,Rep. of Moldova,MDA,0,5,0,0,5
2006,Palestinian,PSE,Rep. of Moldova,MDA,0,5,0,5,10
2006,Georgia,GEO,Rep. of Moldova,MDA,0,5,0,5,10
2006,Iran (Islamic Rep. of),IRN,Rep. of Moldova,MDA,0,5,0,0,5
2006,Jordan,JOR,Rep. of Moldova,MDA,0,0,5,0,5
2006,Lebanon,LBN,Rep. of Moldova,MDA,0,0,5,5,10
2006,Russian Federation,RUS,Rep. of Moldova,MDA,0,5,0,5,10
2006,Serbia and Kosovo: S/RES/1244 (1999),SRB,Rep. of Moldova,MDA,5,0,0,0,5
2006,Sudan,SDN,Rep. of Moldova,MDA,0,5,0,5,10
2006,Syrian Arab Rep.,SYR,Rep. of Moldova,MDA,0,12,0,5,17
2006,Tajikistan,TJK,Rep. of Moldova,MDA,0,5,0,0,5
2006,Turkey,TUR,Rep. of Moldova,MDA,0,0,5,5,10
2006,Angola,AGO,Mozambique,MOZ,0,0,0,5,5
2006,Burundi,BDI,Mozambique,MOZ,179,0,0,5,184
2006,Congo,COG,Mozambique,MOZ,16,0,0,0,16
2006,Dem. Rep. of the Congo,COD,Mozambique,MOZ,335,0,0,0,335
2006,Rwanda,RWA,Mozambique,MOZ,119,0,0,0,119
2006,Afghanistan,AFG,Romania,ROU,0,0,5,0,5
2006,Albania,ALB,Romania,ROU,0,0,0,5,5
2006,Egypt,EGY,Romania,ROU,0,0,5,0,5
2006,Bangladesh,BGD,Romania,ROU,0,0,0,20,20
2006,Bolivia (Plurinational State of),BOL,Romania,ROU,0,0,0,5,5
2006,China,CHN,Romania,ROU,0,0,42,5,47
2006,Congo,COG,Romania,ROU,5,0,5,0,10
2006,Dem. Rep. of the Congo,COD,Romania,ROU,0,0,0,5,5
2006,Djibouti,DJI,Romania,ROU,0,0,0,5,5
2006,Eritrea,ERI,Romania,ROU,5,0,0,0,5
2006,Palestinian,PSE,Romania,ROU,5,0,0,21,26
2006,Georgia,GEO,Romania,ROU,0,0,19,0,19
2006,Guinea,GIN,Romania,ROU,0,0,5,0,5
2006,Cote d'Ivoire,CIV,Romania,ROU,0,0,5,5,10
2006,India,IND,Romania,ROU,0,0,0,15,15
2006,Iran (Islamic Rep. of),IRN,Romania,ROU,0,0,11,27,38
2006,Iraq,IRQ,Romania,ROU,31,0,33,28,92
2006,Israel,ISR,Romania,ROU,0,0,5,0,5
2006,Jordan,JOR,Romania,ROU,0,0,0,5,5
2006,Liberia,LBR,Romania,ROU,0,0,5,0,5
2006,Libya,LBY,Romania,ROU,0,0,0,5,5
2006,Lebanon,LBN,Romania,ROU,0,0,0,5,5
2006,Sri Lanka,LKA,Romania,ROU,0,0,0,5,5
2006,Rep. of Moldova,MDA,Romania,ROU,0,0,5,11,16
2006,Morocco,MAR,Romania,ROU,5,0,0,0,5
2006,Nigeria,NGA,Romania,ROU,0,0,5,0,5
2006,Pakistan,PAK,Romania,ROU,0,0,14,5,19
2006,Russian Federation,RUS,Romania,ROU,0,0,12,5,17
2006,Sierra Leone,SLE,Romania,ROU,0,0,0,5,5
2006,Somalia,SOM,Romania,ROU,5,0,40,5,50
2006,Sudan,SDN,Romania,ROU,0,0,0,13,13
2006,Syrian Arab Rep.,SYR,Romania,ROU,5,0,13,0,18
2006,Tunisia,TUN,Romania,ROU,0,0,0,5,5
2006,Turkey,TUR,Romania,ROU,0,0,20,5,25
2006,Uzbekistan,UZB,Romania,ROU,0,5,0,0,5
2006,Zimbabwe,ZWE,Romania,ROU,0,0,5,0,5
2006,Eritrea,ERI,Sudan,SDN,8568,0,16,25,8609
2006,Ethiopia,ETH,Sudan,SDN,923,0,30,0,953
2006,Somalia,SOM,Sudan,SDN,211,0,0,0,211
2006,Albania,ALB,Slovenia,SVN,0,0,10,17,27
2006,Armenia,ARM,Slovenia,SVN,0,0,5,0,5
2006,Bangladesh,BGD,Slovenia,SVN,0,0,5,0,5
2006,Bosnia and Herzegovina,BIH,Slovenia,SVN,0,0,94,31,125
2006,Palestinian,PSE,Slovenia,SVN,0,0,5,5,10
2006,Georgia,GEO,Slovenia,SVN,0,0,0,11,11
2006,Croatia,HRV,Slovenia,SVN,0,0,5,0,5
2006,Hungary,HUN,Slovenia,SVN,0,0,5,0,5
2006,India,IND,Slovenia,SVN,0,0,5,0,5
2006,Iran (Islamic Rep. of),IRN,Slovenia,SVN,0,0,0,5,5
2006,Iraq,IRQ,Slovenia,SVN,0,0,0,12,12
2006,Kazakhstan,KAZ,Slovenia,SVN,0,0,5,0,5
2006,Liberia,LBR,Slovenia,SVN,0,0,5,0,5
2006,Sri Lanka,LKA,Slovenia,SVN,0,0,0,5,5
2006,North Macedonia,MKD,Slovenia,SVN,0,0,10,24,34
2006,Rep. of Moldova,MDA,Slovenia,SVN,0,0,0,11,11
2006,Pakistan,PAK,Slovenia,SVN,0,0,5,5,10
2006,Russian Federation,RUS,Slovenia,SVN,0,0,5,0,5
2006,Serbia and Kosovo: S/RES/1244 (1999),SRB,Slovenia,SVN,0,5,345,155,505
2006,Turkey,TUR,Slovenia,SVN,0,0,21,30,51
2006,Uzbekistan,UZB,Slovenia,SVN,0,0,0,5,5
2006,Rwanda,RWA,United Rep. of Tanzania,TZA,194,0,0,0,194
2006,Somalia,SOM,United Rep. of Tanzania,TZA,764,0,0,0,764
2006,Myanmar,MMR,Thailand,THA,0,15762,129,1438,17329
2006,Afghanistan,AFG,Tajikistan,TJK,46,0,187,0,233
2006,Burundi,BDI,Zimbabwe,ZWE,193,0,0,5,198
2006,Dem. Rep. of the Congo,COD,Zimbabwe,ZWE,366,0,17,343,726
2006,Rwanda,RWA,Zimbabwe,ZWE,5,0,0,27,32
2007,North Macedonia,MKD,Albania,ALB,0,0,0,10,10
2007,Nepal,NPL,Albania,ALB,0,0,0,10,10
2007,Serbia and Kosovo: S/RES/1244 (1999),SRB,Albania,ALB,0,0,0,13,13
2007,Chad,TCD,Angola,AGO,0,0,5,0,5
2007,Dem. Rep. of the Congo,COD,Angola,AGO,21,0,10,0,31
2007,Eritrea,ERI,Angola,AGO,0,0,5,0,5
2007,Guinea,GIN,Angola,AGO,5,0,0,0,5
2007,Cote d'Ivoire,CIV,Angola,AGO,15,0,19,0,34
2007,Liberia,LBR,Angola,AGO,5,0,0,0,5
2007,Mauritania,MRT,Angola,AGO,0,0,5,0,5
2007,Sierra Leone,SLE,Angola,AGO,10,0,0,0,10
2007,Somalia,SOM,Angola,AGO,14,0,0,0,14
2007,Sudan,SDN,Angola,AGO,18,0,5,0,23
2007,Afghanistan,AFG,Austria,AUT,497,306,151,157,1111
2007,Albania,ALB,Austria,AUT,10,10,20,10,50
2007,Algeria,DZA,Austria,AUT,12,0,102,61,175
2007,Angola,AGO,Austria,AUT,21,5,10,5,41
2007,Egypt,EGY,Austria,AUT,10,0,41,21,72
2007,Armenia,ARM,Austria,AUT,135,60,196,52,443
2007,Azerbaijan,AZE,Austria,AUT,73,14,37,11,135
2007,Burundi,BDI,Austria,AUT,0,0,0,11,11
2007,Benin,BEN,Austria,AUT,0,0,5,0,5
2007,Bangladesh,BGD,Austria,AUT,5,0,28,50,83
2007,Burkina Faso,BFA,Austria,AUT,0,0,0,5,5
2007,Belarus,BLR,Austria,AUT,15,5,85,47,152
2007,Bosnia and Herzegovina,BIH,Austria,AUT,11,20,67,55,153
2007,Bulgaria,BGR,Austria,AUT,0,0,11,10,21
2007,China,CHN,Austria,AUT,35,10,164,95,304
2007,Cameroon,CMR,Austria,AUT,33,0,13,20,66
2007,Congo,COG,Austria,AUT,13,0,0,5,18
2007,Dem. Rep. of the Congo,COD,Austria,AUT,39,0,10,10,59
2007,Cuba,CUB,Austria,AUT,12,0,0,0,12
2007,Dominican Rep.,DOM,Austria,AUT,0,0,5,0,5
2007,Eritrea,ERI,Austria,AUT,10,0,0,0,10
2007,Estonia,EST,Austria,AUT,0,0,0,5,5
2007,Ethiopia,ETH,Austria,AUT,12,0,5,0,17
2007,Gambia,GMB,Austria,AUT,5,0,93,46,144
2007,Georgia,GEO,Austria,AUT,56,57,480,161,754
2007,Ghana,GHA,Austria,AUT,0,0,25,21,46
2007,Guinea-Bissau,GNB,Austria,AUT,0,0,20,24,44
2007,Guinea,GIN,Austria,AUT,5,0,24,31,60
2007,Croatia,HRV,Austria,AUT,0,0,14,0,14
2007,Cote d'Ivoire,CIV,Austria,AUT,5,0,13,0,18
2007,India,IND,Austria,AUT,0,5,312,167,484
2007,Iran (Islamic Rep. of),IRN,Austria,AUT,318,44,45,40,447
2007,Iraq,IRQ,Austria,AUT,215,143,96,94,548
2007,Israel,ISR,Austria,AUT,0,0,5,10,15
2007,Jordan,JOR,Austria,AUT,0,0,0,12,12
2007,Kazakhstan,KAZ,Austria,AUT,5,0,0,0,5
2007,Kenya,KEN,Austria,AUT,0,0,5,5,10
2007,Kyrgyzstan,KGZ,Austria,AUT,22,0,31,16,69
2007,Liberia,LBR,Austria,AUT,0,0,39,40,79
2007,Lebanon,LBN,Austria,AUT,18,5,15,25,63
2007,Sri Lanka,LKA,Austria,AUT,5,0,23,27,55
2007,Lithuania,LTU,Austria,AUT,0,0,5,0,5
2007,Latvia,LVA,Austria,AUT,5,0,0,0,5
2007,Mauritania,MRT,Austria,AUT,0,0,13,0,13
2007,North Macedonia,MKD,Austria,AUT,18,24,188,64,294
2007,Rep. of Moldova,MDA,Austria,AUT,13,22,160,540,735
2007,Mali,MLI,Austria,AUT,0,0,13,5,18
2007,Mongolia,MNG,Austria,AUT,23,12,154,156,345
2007,Morocco,MAR,Austria,AUT,0,0,55,30,85
2007,Montenegro,MNE,Austria,AUT,0,5,15,0,20
2007,Nepal,NPL,Austria,AUT,5,0,16,5,26
2007,Niger,NER,Austria,AUT,0,0,0,5,5
2007,Nigeria,NGA,Austria,AUT,20,19,514,341,894
2007,Pakistan,PAK,Austria,AUT,5,5,62,69,141
2007,Peru,PER,Austria,AUT,0,0,5,0,5
2007,Philippines,PHL,Austria,AUT,0,5,0,0,5
2007,Poland,POL,Austria,AUT,0,0,5,0,5
2007,Romania,ROU,Austria,AUT,5,0,50,18,73
2007,Russian Federation,RUS,Austria,AUT,2636,427,542,477,4082
2007,Serbia and Kosovo: S/RES/1244 (1999),SRB,Austria,AUT,240,325,1759,580,2904
2007,Senegal,SEN,Austria,AUT,0,0,5,11,16
2007,Sierra Leone,SLE,Austria,AUT,5,0,18,23,46
2007,Somalia,SOM,Austria,AUT,191,22,41,71,325
2007,Viet Nam,VNM,Austria,AUT,11,0,12,0,23
2007,Sudan,SDN,Austria,AUT,30,0,20,18,68
2007,Slovakia,SVK,Austria,AUT,0,0,10,0,10
2007,Syrian Arab Rep.,SYR,Austria,AUT,86,5,18,24,133
2007,Tajikistan,TJK,Austria,AUT,12,0,0,0,12
2007,Togo,TGO,Austria,AUT,0,0,0,12,12
2007,Tunisia,TUN,Austria,AUT,0,0,13,10,23
2007,Turkey,TUR,Austria,AUT,195,32,531,258,1016
2007,Uganda,UGA,Austria,AUT,0,0,5,5,10
2007,Ukraine,UKR,Austria,AUT,20,10,127,58,215
2007,Uzbekistan,UZB,Austria,AUT,16,0,11,0,27
2007,Yemen,YEM,Austria,AUT,5,0,0,0,5
2007,Zimbabwe,ZWE,Austria,AUT,0,0,0,5,5
2007,Stateless,XXA,Austria,AUT,50,22,61,61,194
2007,Croatia,HRV,Bosnia and Herzegovina,BIH,0,0,0,5,5
2007,Serbia and Kosovo: S/RES/1244 (1999),SRB,Bosnia and Herzegovina,BIH,0,0,0,20,20
2007,Afghanistan,AFG,Bulgaria,BGR,5,18,33,36,92
2007,Albania,ALB,Bulgaria,BGR,0,0,10,0,10
2007,Algeria,DZA,Bulgaria,BGR,0,0,5,0,5
2007,Armenia,ARM,Bulgaria,BGR,0,5,29,22,56
2007,Azerbaijan,AZE,Bulgaria,BGR,0,0,5,0,5
2007,Bangladesh,BGD,Bulgaria,BGR,0,0,10,10,20
2007,China,CHN,Bulgaria,BGR,0,0,5,5,10
2007,Congo,COG,Bulgaria,BGR,0,0,5,0,5
2007,Colombia,COL,Bulgaria,BGR,0,0,0,5,5
2007,Cuba,CUB,Bulgaria,BGR,0,0,0,5,5
2007,Georgia,GEO,Bulgaria,BGR,0,0,5,0,5
2007,Guinea,GIN,Bulgaria,BGR,0,0,5,0,5
2007,Cote d'Ivoire,CIV,Bulgaria,BGR,0,0,5,0,5
2007,Iran (Islamic Rep. of),IRN,Bulgaria,BGR,0,10,18,5,33
2007,Iraq,IRQ,Bulgaria,BGR,0,276,10,100,386
2007,Lebanon,LBN,Bulgaria,BGR,0,0,13,5,18
2007,Nigeria,NGA,Bulgaria,BGR,0,0,13,5,18
2007,Pakistan,PAK,Bulgaria,BGR,0,0,5,0,5
2007,Russian Federation,RUS,Bulgaria,BGR,0,0,0,5,5
2007,Serbia and Kosovo: S/RES/1244 (1999),SRB,Bulgaria,BGR,0,0,5,0,5
2007,Viet Nam,VNM,Bulgaria,BGR,0,0,0,5,5
2007,Sudan,SDN,Bulgaria,BGR,0,5,5,0,10
2007,Syrian Arab Rep.,SYR,Bulgaria,BGR,5,5,5,0,15
2007,United Rep. of Tanzania,TZA,Bulgaria,BGR,0,0,0,5,5
2007,Turkey,TUR,Bulgaria,BGR,0,0,12,0,12
2007,United Arab Emirates,ARE,Bulgaria,BGR,0,0,0,5,5
2007,Stateless,XXA,Bulgaria,BGR,0,0,27,28,55
2007,Afghanistan,AFG,Canada,CAN,121,0,29,26,176
2007,Albania,ALB,Canada,CAN,87,0,60,16,163
2007,Algeria,DZA,Canada,CAN,12,0,10,10,32
2007,Angola,AGO,Canada,CAN,12,0,0,0,12
2007,Egypt,EGY,Canada,CAN,17,0,15,5,37
2007,Argentina,ARG,Canada,CAN,0,0,14,0,14
2007,Armenia,ARM,Canada,CAN,5,0,14,0,19
2007,Austria,AUT,Canada,CAN,0,0,0,5,5
2007,Azerbaijan,AZE,Canada,CAN,11,0,0,5,16
2007,Barbados,BRB,Canada,CAN,5,0,14,0,19
2007,Burundi,BDI,Canada,CAN,193,0,37,5,235
2007,Belgium,BEL,Canada,CAN,0,0,5,0,5
2007,Benin,BEN,Canada,CAN,5,0,0,0,5
2007,Bangladesh,BGD,Canada,CAN,46,0,46,13,105
2007,Burkina Faso,BFA,Canada,CAN,5,0,0,0,5
2007,Belarus,BLR,Canada,CAN,12,0,0,0,12
2007,Bolivia (Plurinational State of),BOL,Canada,CAN,5,0,5,0,10
2007,Botswana,BWA,Canada,CAN,5,0,5,0,10
2007,Brazil,BRA,Canada,CAN,5,0,15,17,37
2007,Bosnia and Herzegovina,BIH,Canada,CAN,0,0,5,0,5
2007,Bulgaria,BGR,Canada,CAN,11,0,0,5,16
2007,Cambodia,KHM,Canada,CAN,14,0,0,0,14
2007,Chad,TCD,Canada,CAN,23,0,25,0,48
2007,China,CHN,Canada,CAN,728,0,326,76,1130
2007,Chile,CHL,Canada,CAN,5,0,15,5,25
2007,Cameroon,CMR,Canada,CAN,30,0,18,5,53
2007,Congo,COG,Canada,CAN,14,0,0,0,14
2007,Dem. Rep. of the Congo,COD,Canada,CAN,160,0,76,13,249
2007,Colombia,COL,Canada,CAN,737,0,142,61,940
2007,Costa Rica,CRI,Canada,CAN,5,0,22,11,38
2007,Cuba,CUB,Canada,CAN,67,0,21,31,119
2007,Denmark,DNK,Canada,CAN,0,0,5,0,5
2007,Djibouti,DJI,Canada,CAN,5,0,0,0,5
2007,Dominica,DMA,Canada,CAN,0,0,0,5,5
2007,Dominican Rep.,DOM,Canada,CAN,12,0,12,5,29
2007,Ecuador,ECU,Canada,CAN,14,0,5,0,19
2007,Eritrea,ERI,Canada,CAN,110,0,5,0,115
2007,Estonia,EST,Canada,CAN,5,0,0,5,10
2007,Ethiopia,ETH,Canada,CAN,135,0,25,10,170
2007,Fiji,FJI,Canada,CAN,0,0,15,5,20
2007,France,FRA,Canada,CAN,0,0,5,5,10
2007,Gabon,GAB,Canada,CAN,0,0,5,0,5
2007,Palestinian,PSE,Canada,CAN,12,0,5,0,17
2007,United Kingdom of Great Britain and Northern Ireland,GBR,Canada,CAN,0,0,10,0,10
2007,Georgia,GEO,Canada,CAN,20,0,16,5,41
2007,Germany,DEU,Canada,CAN,5,0,5,13,23
2007,Ghana,GHA,Canada,CAN,5,0,14,5,24
2007,Grenada,GRD,Canada,CAN,5,0,13,0,18
2007,Guatemala,GTM,Canada,CAN,54,0,38,14,106
2007,Guinea,GIN,Canada,CAN,28,0,22,0,50
2007,Guyana,GUY,Canada,CAN,16,0,104,12,132
2007,Haiti,HTI,Canada,CAN,124,0,75,53,252
2007,"China, Hong Kong SAR",HKG,Canada,CAN,0,0,5,0,5
2007,Honduras,HND,Canada,CAN,36,0,50,29,115
2007,Croatia,HRV,Canada,CAN,0,0,0,5,5
2007,Hungary,HUN,Canada,CAN,5,0,13,10,28
2007,Cote d'Ivoire,CIV,Canada,CAN,11,0,12,5,28
2007,India,IND,Canada,CAN,44,0,196,114,354
2007,Indonesia,IDN,Canada,CAN,12,0,19,0,31
2007,Iran (Islamic Rep. of),IRN,Canada,CAN,89,0,17,17,123
2007,Iraq,IRQ,Canada,CAN,45,0,11,15,71
2007,Israel,ISR,Canada,CAN,32,0,101,54,187
2007,Italy,ITA,Canada,CAN,0,0,5,5,10
2007,Jamaica,JAM,Canada,CAN,28,0,43,17,88
2007,Jordan,JOR,Canada,CAN,15,0,10,5,30
2007,Kazakhstan,KAZ,Canada,CAN,0,0,5,0,5
2007,Kenya,KEN,Canada,CAN,30,0,13,0,43
2007,Kyrgyzstan,KGZ,Canada,CAN,10,0,5,0,15
2007,Rep. of Korea,KOR,Canada,CAN,5,0,76,12,93
2007,Dem. People's Rep. of Korea,PRK,Canada,CAN,0,0,0,10,10
2007,Kuwait,KWT,Canada,CAN,5,0,0,0,5
2007,Liberia,LBR,Canada,CAN,0,0,14,0,14
2007,Libya,LBY,Canada,CAN,13,0,0,5,18
2007,Saint Lucia,LCA,Canada,CAN,22,0,45,22,89
2007,Lebanon,LBN,Canada,CAN,33,0,56,31,120
2007,Sri Lanka,LKA,Canada,CAN,702,0,61,34,797
2007,Lithuania,LTU,Canada,CAN,5,0,0,0,5
2007,Mauritania,MRT,Canada,CAN,10,0,5,0,15
2007,North Macedonia,MKD,Canada,CAN,12,0,0,0,12
2007,Rep. of Moldova,MDA,Canada,CAN,5,0,0,0,5
2007,Mexico,MEX,Canada,CAN,378,0,2132,1104,3614
2007,Mali,MLI,Canada,CAN,13,0,0,0,13
2007,Malaysia,MYS,Canada,CAN,10,0,24,5,39
2007,Mongolia,MNG,Canada,CAN,12,0,5,0,17
2007,Morocco,MAR,Canada,CAN,17,0,10,5,32
2007,Montenegro,MNE,Canada,CAN,17,0,30,5,52
2007,Mauritius,MUS,Canada,CAN,0,0,5,0,5
2007,Myanmar,MMR,Canada,CAN,12,0,5,0,17
2007,Namibia,NAM,Canada,CAN,0,0,5,0,5
2007,Nepal,NPL,Canada,CAN,61,0,5,0,66
2007,Netherlands,NLD,Canada,CAN,0,0,5,0,5
2007,Niger,NER,Canada,CAN,0,0,0,5,5
2007,Nicaragua,NIC,Canada,CAN,0,0,10,5,15
2007,Nigeria,NGA,Canada,CAN,132,0,125,44,301
2007,Pakistan,PAK,Canada,CAN,195,0,150,54,399
2007,Panama,PAN,Canada,CAN,0,0,5,0,5
2007,Paraguay,PRY,Canada,CAN,5,0,0,0,5
2007,Peru,PER,Canada,CAN,70,0,55,13,138
2007,Philippines,PHL,Canada,CAN,18,0,42,5,65
2007,Poland,POL,Canada,CAN,5,0,12,11,28
2007,Portugal,PRT,Canada,CAN,5,0,13,0,18
2007,Romania,ROU,Canada,CAN,10,0,11,26,47
2007,South Africa,ZAF,Canada,CAN,0,0,10,0,10
2007,Russian Federation,RUS,Canada,CAN,68,0,22,27,117
2007,Rwanda,RWA,Canada,CAN,103,0,25,5,133
2007,El Salvador,SLV,Canada,CAN,67,0,68,25,160
2007,Serbia and Kosovo: S/RES/1244 (1999),SRB,Canada,CAN,0,0,5,0,5
2007,Senegal,SEN,Canada,CAN,17,0,5,0,22
2007,Sierra Leone,SLE,Canada,CAN,5,0,0,0,5
2007,Solomon Islands,SLB,Canada,CAN,10,0,0,0,10
2007,Somalia,SOM,Canada,CAN,121,0,10,19,150
2007,Spain,ESP,Canada,CAN,0,0,0,5,5
2007,Viet Nam,VNM,Canada,CAN,0,0,0,13,13
2007,Sudan,SDN,Canada,CAN,31,0,0,5,36
2007,Suriname,SUR,Canada,CAN,0,0,5,0,5
2007,Slovakia,SVK,Canada,CAN,5,0,0,0,5
2007,Slovenia,SVN,Canada,CAN,5,0,0,0,5
2007,Sweden,SWE,Canada,CAN,5,0,5,0,10
2007,Syrian Arab Rep.,SYR,Canada,CAN,5,0,5,12,22
2007,United Rep. of Tanzania,TZA,Canada,CAN,0,0,5,0,5
2007,Thailand,THA,Canada,CAN,0,0,0,5,5
2007,Togo,TGO,Canada,CAN,12,0,5,0,17
2007,Trinidad and Tobago,TTO,Canada,CAN,14,0,41,13,68
2007,Tunisia,TUN,Canada,CAN,10,0,0,10,20
2007,Turkey,TUR,Canada,CAN,54,0,77,47,178
2007,Uganda,UGA,Canada,CAN,33,0,5,0,38
2007,Ukraine,UKR,Canada,CAN,65,0,27,27,119
2007,Uruguay,URY,Canada,CAN,5,0,16,0,21
2007,United States of America,USA,Canada,CAN,10,0,113,89,212
2007,Uzbekistan,UZB,Canada,CAN,12,0,0,0,12
2007,Saint Vincent and the Grenadines,VCT,Canada,CAN,45,0,96,25,166
2007,Venezuela (Bolivarian Republic of),VEN,Canada,CAN,37,0,32,5,74
2007,Yemen,YEM,Canada,CAN,5,0,0,0,5
2007,Zimbabwe,ZWE,Canada,CAN,186,0,75,17,278
2007,Colombia,COL,Costa Rica,CRI,131,0,452,0,583
2007,Cuba,CUB,Costa Rica,CRI,24,0,31,0,55
2007,Guatemala,GTM,Costa Rica,CRI,5,0,0,0,5
2007,Nicaragua,NIC,Costa Rica,CRI,0,0,5,0,5
2007,El Salvador,SLV,Costa Rica,CRI,0,0,16,0,16
2007,Venezuela (Bolivarian Republic of),VEN,Costa Rica,CRI,21,0,13,0,34
2007,Afghanistan,AFG,Ecuador,ECU,0,10,0,0,10
2007,Andorra,AND,Ecuador,ECU,0,0,0,5,5
2007,Argentina,ARG,Ecuador,ECU,0,0,11,0,11
2007,Bolivia (Plurinational State of),BOL,Ecuador,ECU,0,0,5,0,5
2007,China,CHN,Ecuador,ECU,0,0,5,0,5
2007,Chile,CHL,Ecuador,ECU,0,0,5,0,5
2007,Colombia,COL,Ecuador,ECU,866,2071,3403,105,6445
2007,Cuba,CUB,Ecuador,ECU,15,15,5,0,35
2007,Cabo Verde,CPV,Ecuador,ECU,0,0,5,0,5
2007,Dominican Rep.,DOM,Ecuador,ECU,0,0,18,0,18
2007,Ecuador,ECU,Ecuador,ECU,0,14,5,0,19
2007,Gambia,GMB,Ecuador,ECU,0,0,5,0,5
2007,Haiti,HTI,Ecuador,ECU,0,0,5,0,5
2007,Iraq,IRQ,Ecuador,ECU,0,5,0,0,5
2007,Rep. of Korea,KOR,Ecuador,ECU,0,0,5,0,5
2007,Liberia,LBR,Ecuador,ECU,0,0,5,0,5
2007,Mali,MLI,Ecuador,ECU,0,0,5,0,5
2007,Nepal,NPL,Ecuador,ECU,0,0,5,0,5
2007,Peru,PER,Ecuador,ECU,5,5,2418,17,2445
2007,South Africa,ZAF,Ecuador,ECU,0,0,5,0,5
2007,Trinidad and Tobago,TTO,Ecuador,ECU,0,0,5,0,5
2007,Venezuela (Bolivarian Republic of),VEN,Ecuador,ECU,0,0,11,0,11
2007,Angola,AGO,Gabon,GAB,0,0,0,5,5
2007,Congo,COG,Gabon,GAB,5,0,100,18,123
2007,Dem. Rep. of the Congo,COD,Gabon,GAB,0,0,10,0,10
2007,Equatorial Guinea,GNQ,Gabon,GAB,20,0,0,0,20
2007,Cote d'Ivoire,CIV,Gabon,GAB,0,0,5,0,5
2007,Liberia,LBR,Gabon,GAB,0,0,0,5,5
2007,Rwanda,RWA,Gabon,GAB,0,0,0,5,5
2007,Russian Federation,RUS,Georgia,GEO,10,0,5,0,15
2007,Afghanistan,AFG,Kyrgyzstan,KGZ,22,0,125,56,203
2007,Iran (Islamic Rep. of),IRN,Kyrgyzstan,KGZ,0,0,5,15,20
2007,Dem. People's Rep. of Korea,PRK,Kyrgyzstan,KGZ,5,0,0,0,5
2007,Russian Federation,RUS,Kyrgyzstan,KGZ,0,0,0,15,15
2007,Syrian Arab Rep.,SYR,Kyrgyzstan,KGZ,5,0,0,0,5
2007,Uzbekistan,UZB,Kyrgyzstan,KGZ,0,0,0,185,185
2007,Bangladesh,BGD,Rep. of Korea,KOR,5,0,0,0,5
2007,China,CHN,Rep. of Korea,KOR,0,0,32,16,48
2007,Dem. Rep. of the Congo,COD,Rep. of Korea,KOR,5,0,5,0,10
2007,Ethiopia,ETH,Rep. of Korea,KOR,0,0,5,5,10
2007,Ghana,GHA,Rep. of Korea,KOR,0,5,0,0,5
2007,Cote d'Ivoire,CIV,Rep. of Korea,KOR,0,5,0,5,10
2007,Iran (Islamic Rep. of),IRN,Rep. of Korea,KOR,0,0,5,0,5
2007,Kyrgyzstan,KGZ,Rep. of Korea,KOR,0,0,5,0,5
2007,Sri Lanka,LKA,Rep. of Korea,KOR,0,0,0,5,5
2007,Myanmar,MMR,Rep. of Korea,KOR,13,0,0,0,13
2007,Nepal,NPL,Rep. of Korea,KOR,0,0,0,14,14
2007,Nigeria,NGA,Rep. of Korea,KOR,0,0,16,5,21
2007,Pakistan,PAK,Rep. of Korea,KOR,0,0,5,0,5
2007,Viet Nam,VNM,Rep. of Korea,KOR,0,0,5,0,5
2007,Uganda,UGA,Rep. of Korea,KOR,0,0,0,11,11
2007,Afghanistan,AFG,Rep. of Moldova,MDA,0,5,0,0,5
2007,Armenia,ARM,Rep. of Moldova,MDA,0,5,12,0,17
2007,Jordan,JOR,Rep. of Moldova,MDA,0,5,5,0,10
2007,Lebanon,LBN,Rep. of Moldova,MDA,0,0,5,0,5
2007,Russian Federation,RUS,Rep. of Moldova,MDA,0,0,5,0,5
2007,Sudan,SDN,Rep. of Moldova,MDA,0,5,0,0,5
2007,Syrian Arab Rep.,SYR,Rep. of Moldova,MDA,0,0,5,0,5
2007,Turkey,TUR,Rep. of Moldova,MDA,0,0,10,0,10
2007,Burundi,BDI,Malawi,MWI,5,0,28,85,118
2007,Dem. Rep. of the Congo,COD,Malawi,MWI,30,0,14,77,121
2007,Eritrea,ERI,Malawi,MWI,0,0,0,505,505
2007,Ethiopia,ETH,Malawi,MWI,0,0,78,1471,1549
2007,Rwanda,RWA,Malawi,MWI,127,0,1680,415,2222
2007,Somalia,SOM,Malawi,MWI,0,0,0,940,940
2007,Sudan,SDN,Malawi,MWI,0,0,0,10,10
2007,Zambia,ZMB,Malawi,MWI,0,0,0,5,5
2007,Egypt,EGY,Romania,ROU,0,0,5,0,5
2007,Bangladesh,BGD,Romania,ROU,0,0,5,0,5
2007,China,CHN,Romania,ROU,0,0,12,5,17
2007,Cameroon,CMR,Romania,ROU,0,0,5,0,5
2007,Dem. Rep. of the Congo,COD,Romania,ROU,0,0,10,0,10
2007,Palestinian,PSE,Romania,ROU,0,0,24,0,24
2007,Georgia,GEO,Romania,ROU,0,0,5,0,5
2007,Guinea,GIN,Romania,ROU,0,0,5,0,5
2007,India,IND,Romania,ROU,0,0,16,0,16
2007,Iran (Islamic Rep. of),IRN,Romania,ROU,0,0,18,5,23
2007,Iraq,IRQ,Romania,ROU,108,5,61,10,184
2007,Israel,ISR,Romania,ROU,0,0,5,0,5
2007,Jordan,JOR,Romania,ROU,5,0,5,0,10
2007,Lebanon,LBN,Romania,ROU,0,0,5,0,5
2007,Rep. of Moldova,MDA,Romania,ROU,0,0,17,0,17
2007,Nigeria,NGA,Romania,ROU,0,0,5,0,5
2007,Pakistan,PAK,Romania,ROU,0,0,14,0,14
2007,Russian Federation,RUS,Romania,ROU,0,0,5,0,5
2007,Serbia and Kosovo: S/RES/1244 (1999),SRB,Romania,ROU,0,0,92,80,172
2007,Somalia,SOM,Romania,ROU,14,5,16,0,35
2007,Sudan,SDN,Romania,ROU,0,0,5,0,5
2007,Syrian Arab Rep.,SYR,Romania,ROU,0,0,15,0,15
2007,Tunisia,TUN,Romania,ROU,0,0,5,0,5
2007,Turkey,TUR,Romania,ROU,0,5,22,10,37
2007,Ukraine,UKR,Romania,ROU,0,0,5,0,5
2007,Zimbabwe,ZWE,Romania,ROU,0,0,5,0,5
2007,Afghanistan,AFG,Spain,ESP,0,0,5,0,5
2007,Albania,ALB,Spain,ESP,0,0,5,0,5
2007,Algeria,DZA,Spain,ESP,5,0,194,0,199
2007,Angola,AGO,Spain,ESP,0,0,5,0,5
2007,Egypt,EGY,Spain,ESP,0,0,5,0,5
2007,Argentina,ARG,Spain,ESP,0,0,5,0,5
2007,Armenia,ARM,Spain,ESP,0,0,83,0,83
2007,Azerbaijan,AZE,Spain,ESP,10,0,0,0,10
2007,Bangladesh,BGD,Spain,ESP,0,0,34,0,34
2007,Bhutan,BTN,Spain,ESP,0,0,5,0,5
2007,Burkina Faso,BFA,Spain,ESP,0,0,5,0,5
2007,Belarus,BLR,Spain,ESP,0,0,12,0,12
2007,Bolivia (Plurinational State of),BOL,Spain,ESP,0,0,10,0,10
2007,Bosnia and Herzegovina,BIH,Spain,ESP,0,0,10,0,10
2007,Central African Rep.,CAF,Spain,ESP,0,0,5,0,5
2007,Chad,TCD,Spain,ESP,0,0,5,0,5
2007,Cameroon,CMR,Spain,ESP,0,0,32,0,32
2007,Congo,COG,Spain,ESP,0,0,5,0,5
2007,Dem. Rep. of the Congo,COD,Spain,ESP,5,0,49,0,54
2007,Colombia,COL,Spain,ESP,23,5,1651,0,1679
2007,Costa Rica,CRI,Spain,ESP,0,0,10,0,10
2007,Cuba,CUB,Spain,ESP,19,0,54,0,73
2007,Dominican Rep.,DOM,Spain,ESP,0,0,24,0,24
2007,Ecuador,ECU,Spain,ESP,0,0,5,0,5
2007,Equatorial Guinea,GNQ,Spain,ESP,14,0,19,0,33
2007,Eritrea,ERI,Spain,ESP,10,0,18,0,28
2007,Ethiopia,ETH,Spain,ESP,5,0,11,0,16
2007,Gambia,GMB,Spain,ESP,0,0,39,0,39
2007,Georgia,GEO,Spain,ESP,0,0,18,0,18
2007,Ghana,GHA,Spain,ESP,0,0,5,0,5
2007,Guinea-Bissau,GNB,Spain,ESP,0,0,13,0,13
2007,Guatemala,GTM,Spain,ESP,0,0,5,0,5
2007,Guinea,GIN,Spain,ESP,0,0,69,0,69
2007,Honduras,HND,Spain,ESP,0,0,5,0,5
2007,Cote d'Ivoire,CIV,Spain,ESP,0,0,100,0,100
2007,India,IND,Spain,ESP,0,0,28,0,28
2007,Iran (Islamic Rep. of),IRN,Spain,ESP,5,0,21,0,26
2007,Iraq,IRQ,Spain,ESP,18,0,1021,0,1039
2007,Kazakhstan,KAZ,Spain,ESP,5,0,5,0,10
2007,Kenya,KEN,Spain,ESP,0,0,5,0,5
2007,Kyrgyzstan,KGZ,Spain,ESP,0,0,5,0,5
2007,Liberia,LBR,Spain,ESP,0,0,20,0,20
2007,Lebanon,LBN,Spain,ESP,0,0,5,0,5
2007,Sri Lanka,LKA,Spain,ESP,0,0,5,0,5
2007,Mauritania,MRT,Spain,ESP,0,0,23,0,23
2007,Rep. of Moldova,MDA,Spain,ESP,0,0,10,0,10
2007,Mali,MLI,Spain,ESP,0,0,5,0,5
2007,Morocco,MAR,Spain,ESP,5,0,319,0,324
2007,Nepal,NPL,Spain,ESP,0,0,31,0,31
2007,Nigeria,NGA,Spain,ESP,0,0,608,0,608
2007,Pakistan,PAK,Spain,ESP,0,0,13,0,13
2007,Paraguay,PRY,Spain,ESP,0,0,5,0,5
2007,Peru,PER,Spain,ESP,0,0,5,0,5
2007,Russian Federation,RUS,Spain,ESP,20,0,96,0,116
2007,Rwanda,RWA,Spain,ESP,12,0,0,0,12
2007,El Salvador,SLV,Spain,ESP,0,0,15,0,15
2007,Serbia and Kosovo: S/RES/1244 (1999),SRB,Spain,ESP,0,0,10,0,10
2007,Senegal,SEN,Spain,ESP,0,0,38,0,38
2007,Sierra Leone,SLE,Spain,ESP,5,0,36,0,41
2007,Somalia,SOM,Spain,ESP,0,0,98,0,98
2007,Viet Nam,VNM,Spain,ESP,0,0,5,0,5
2007,Sudan,SDN,Spain,ESP,0,0,58,0,58
2007,Syrian Arab Rep.,SYR,Spain,ESP,0,0,34,0,34
2007,Togo,TGO,Spain,ESP,0,0,10,0,10
2007,Tunisia,TUN,Spain,ESP,0,0,5,0,5
2007,Turkey,TUR,Spain,ESP,0,0,20,0,20
2007,Uganda,UGA,Spain,ESP,0,0,5,0,5
2007,Ukraine,UKR,Spain,ESP,0,0,15,0,15
2007,Uzbekistan,UZB,Spain,ESP,0,0,10,0,10
2007,Venezuela (Bolivarian Republic of),VEN,Spain,ESP,0,0,19,0,19
2007,Stateless,XXA,Spain,ESP,50,0,10,0,60
2007,Burundi,BDI,United Rep. of Tanzania,TZA,302,0,0,0,302
2007,Dem. Rep. of the Congo,COD,United Rep. of Tanzania,TZA,27,0,0,0,27
2007,Ethiopia,ETH,United Rep. of Tanzania,TZA,5,0,0,0,5
2007,Somalia,SOM,United Rep. of Tanzania,TZA,684,0,0,0,684
2007,Myanmar,MMR,Thailand,THA,0,2657,0,2673,5330
2007,Afghanistan,AFG,Tajikistan,TJK,325,0,516,0,841
2008,Serbia and Kosovo: S/RES/1244 (1999),SRB,Albania,ALB,0,0,0,5,5
2008,Chad,TCD,Angola,AGO,10,0,0,0,10
2008,Dem. Rep. of the Congo,COD,Angola,AGO,11,0,17,0,28
2008,Guinea,GIN,Angola,AGO,0,0,5,0,5
2008,Cote d'Ivoire,CIV,Angola,AGO,26,0,16,0,42
2008,Liberia,LBR,Angola,AGO,0,0,13,0,13
2008,Mauritania,MRT,Angola,AGO,0,0,13,0,13
2008,Rwanda,RWA,Angola,AGO,19,0,5,0,24
2008,Sierra Leone,SLE,Angola,AGO,0,0,11,0,11
2008,Somalia,SOM,Angola,AGO,5,0,5,0,10
2008,Sudan,SDN,Angola,AGO,14,0,0,0,14
2008,Afghanistan,AFG,Austria,AUT,486,391,217,221,1315
2008,Albania,ALB,Austria,AUT,5,5,22,14,46
2008,Algeria,DZA,Austria,AUT,0,0,112,71,183
2008,Angola,AGO,Austria,AUT,14,0,0,0,14
2008,Egypt,EGY,Austria,AUT,5,0,43,22,70
2008,Armenia,ARM,Austria,AUT,105,95,353,61,614
2008,Azerbaijan,AZE,Austria,AUT,59,11,37,18,125
2008,Burundi,BDI,Austria,AUT,5,0,0,0,5
2008,Benin,BEN,Austria,AUT,0,0,0,5,5
2008,Bangladesh,BGD,Austria,AUT,5,10,19,23,57
2008,Belarus,BLR,Austria,AUT,10,5,51,32,98
2008,Bolivia (Plurinational State of),BOL,Austria,AUT,0,0,5,0,5
2008,Bosnia and Herzegovina,BIH,Austria,AUT,11,12,69,37,129
2008,Bulgaria,BGR,Austria,AUT,0,0,11,0,11
2008,China,CHN,Austria,AUT,19,14,162,98,293
2008,Cameroon,CMR,Austria,AUT,29,0,24,10,63
2008,Congo,COG,Austria,AUT,14,5,0,0,19
2008,Dem. Rep. of the Congo,COD,Austria,AUT,27,5,5,11,48
2008,Cuba,CUB,Austria,AUT,5,5,0,0,10
2008,Eritrea,ERI,Austria,AUT,5,0,5,0,10
2008,Estonia,EST,Austria,AUT,5,0,0,0,5
2008,Ethiopia,ETH,Austria,AUT,5,0,14,0,19
2008,Gambia,GMB,Austria,AUT,5,5,91,41,142
2008,Georgia,GEO,Austria,AUT,61,49,380,129,619
2008,Ghana,GHA,Austria,AUT,5,0,38,16,59
2008,Guinea-Bissau,GNB,Austria,AUT,0,0,5,18,23
2008,Guatemala,GTM,Austria,AUT,5,0,0,0,5
2008,Guinea,GIN,Austria,AUT,5,0,17,18,40
2008,Croatia,HRV,Austria,AUT,0,0,5,5,10
2008,Hungary,HUN,Austria,AUT,0,0,0,5,5
2008,Cote d'Ivoire,CIV,Austria,AUT,11,0,0,5,16
2008,India,IND,Austria,AUT,5,5,438,179,627
2008,Iran (Islamic Rep. of),IRN,Austria,AUT,198,16,78,51,343
2008,Iraq,IRQ,Austria,AUT,240,146,95,64,545
2008,Israel,ISR,Austria,AUT,0,0,0,5,5
2008,Italy,ITA,Austria,AUT,0,0,0,5,5
2008,Jordan,JOR,Austria,AUT,0,0,0,5,5
2008,Kazakhstan,KAZ,Austria,AUT,5,0,14,0,19
2008,Kenya,KEN,Austria,AUT,0,0,5,0,5
2008,Kyrgyzstan,KGZ,Austria,AUT,43,5,37,39,124
2008,Liberia,LBR,Austria,AUT,0,0,26,21,47
2008,Libya,LBY,Austria,AUT,0,0,0,5,5
2008,Lebanon,LBN,Austria,AUT,0,0,26,19,45
2008,Sri Lanka,LKA,Austria,AUT,5,0,5,16,26
2008,Mauritania,MRT,Austria,AUT,0,0,5,0,5
2008,North Macedonia,MKD,Austria,AUT,11,11,229,74,325
2008,Rep. of Moldova,MDA,Austria,AUT,10,5,182,167,364
2008,Mali,MLI,Austria,AUT,0,0,5,12,17
2008,Mongolia,MNG,Austria,AUT,20,18,94,89,221
2008,Morocco,MAR,Austria,AUT,0,0,72,21,93
2008,Montenegro,MNE,Austria,AUT,0,10,18,0,28
2008,Myanmar,MMR,Austria,AUT,5,0,0,0,5
2008,Nepal,NPL,Austria,AUT,5,0,12,10,27
2008,Nigeria,NGA,Austria,AUT,12,20,671,323,1026
2008,Pakistan,PAK,Austria,AUT,13,5,53,70,141
2008,Philippines,PHL,Austria,AUT,0,0,5,0,5
2008,Romania,ROU,Austria,AUT,0,0,24,21,45
2008,Russian Federation,RUS,Austria,AUT,1557,433,1682,332,4004
2008,Serbia and Kosovo: S/RES/1244 (1999),SRB,Austria,AUT,148,183,1486,625,2442
2008,Senegal,SEN,Austria,AUT,0,0,5,14,19
2008,Sierra Leone,SLE,Austria,AUT,5,0,17,10,32
2008,Somalia,SOM,Austria,AUT,118,37,48,125,328
2008,Viet Nam,VNM,Austria,AUT,5,0,29,12,46
2008,Sudan,SDN,Austria,AUT,16,0,16,17,49
2008,Slovakia,SVK,Austria,AUT,0,0,0,5,5
2008,Syrian Arab Rep.,SYR,Austria,AUT,69,5,25,12,111
2008,Tajikistan,TJK,Austria,AUT,0,5,5,0,10
2008,Turkmenistan,TKM,Austria,AUT,0,0,0,5,5
2008,Togo,TGO,Austria,AUT,0,0,5,0,5
2008,Tunisia,TUN,Austria,AUT,0,0,14,5,19
2008,Turkey,TUR,Austria,AUT,246,24,508,251,1029
2008,Uganda,UGA,Austria,AUT,0,0,0,11,11
2008,Ukraine,UKR,Austria,AUT,33,25,204,81,343
2008,Uzbekistan,UZB,Austria,AUT,40,0,16,0,56
2008,Zimbabwe,ZWE,Austria,AUT,5,5,0,0,10
2008,Stateless,XXA,Austria,AUT,55,29,67,43,194
2008,Sri Lanka,LKA,Bosnia and Herzegovina,BIH,0,0,0,5,5
2008,North Macedonia,MKD,Bosnia and Herzegovina,BIH,0,0,0,5,5
2008,Serbia and Kosovo: S/RES/1244 (1999),SRB,Bosnia and Herzegovina,BIH,0,0,35,183,218
2008,Bolivia (Plurinational State of),BOL,Costa Rica,CRI,10,0,0,0,10
2008,Colombia,COL,Costa Rica,CRI,268,0,542,0,810
2008,Cuba,CUB,Costa Rica,CRI,51,0,16,0,67
2008,Guatemala,GTM,Costa Rica,CRI,0,0,5,0,5
2008,Haiti,HTI,Costa Rica,CRI,5,0,0,0,5
2008,Israel,ISR,Costa Rica,CRI,5,0,0,0,5
2008,Nicaragua,NIC,Costa Rica,CRI,0,0,12,0,12
2008,Peru,PER,Costa Rica,CRI,0,0,5,0,5
2008,El Salvador,SLV,Costa Rica,CRI,0,0,13,0,13
2008,United States of America,USA,Costa Rica,CRI,0,0,5,0,5
2008,Venezuela (Bolivarian Republic of),VEN,Costa Rica,CRI,44,0,26,0,70
2008,Afghanistan,AFG,Ecuador,ECU,0,10,0,0,10
2008,Argentina,ARG,Ecuador,ECU,0,0,5,0,5
2008,Bolivia (Plurinational State of),BOL,Ecuador,ECU,0,0,10,0,10
2008,China,CHN,Ecuador,ECU,0,0,13,0,13
2008,Chile,CHL,Ecuador,ECU,0,0,11,0,11
2008,Cameroon,CMR,Ecuador,ECU,0,0,10,0,10
2008,Colombia,COL,Ecuador,ECU,35,4296,3824,220,8375
2008,Cuba,CUB,Ecuador,ECU,0,58,25,0,83
2008,Dominican Rep.,DOM,Ecuador,ECU,0,0,27,0,27
2008,Haiti,HTI,Ecuador,ECU,0,0,11,0,11
2008,Honduras,HND,Ecuador,ECU,0,5,0,0,5
2008,Rep. of Korea,KOR,Ecuador,ECU,0,0,5,0,5
2008,Lebanon,LBN,Ecuador,ECU,0,5,0,0,5
2008,Nepal,NPL,Ecuador,ECU,0,5,0,0,5
2008,Peru,PER,Ecuador,ECU,0,17,2360,70,2447
2008,South Africa,ZAF,Ecuador,ECU,0,0,5,0,5
2008,Stateless,XXA,Ecuador,ECU,0,0,5,0,5
2008,Chad,TCD,Gabon,GAB,0,0,12,0,12
2008,Congo,COG,Gabon,GAB,5,0,0,204,209
2008,Dem. Rep. of the Congo,COD,Gabon,GAB,0,0,5,14,19
2008,Cote d'Ivoire,CIV,Gabon,GAB,0,0,0,5,5
2008,Togo,TGO,Gabon,GAB,0,0,5,0,5
2008,Azerbaijan,AZE,Georgia,GEO,0,0,0,5,5
2008,Iraq,IRQ,Georgia,GEO,5,0,0,0,5
2008,Russian Federation,RUS,Georgia,GEO,16,0,0,0,16
2008,Turkey,TUR,Georgia,GEO,0,0,0,5,5
2008,Central African Rep.,CAF,Guinea,GIN,0,0,0,5,5
2008,Chad,TCD,Guinea,GIN,16,0,0,5,21
2008,Cameroon,CMR,Guinea,GIN,0,0,0,5,5
2008,Congo,COG,Guinea,GIN,0,0,0,5,5
2008,Dem. Rep. of the Congo,COD,Guinea,GIN,0,0,0,43,43
2008,Guinea-Bissau,GNB,Guinea,GIN,0,0,0,10,10
2008,Cote d'Ivoire,CIV,Guinea,GIN,5,0,0,729,734
2008,Liberia,LBR,Guinea,GIN,0,0,5,1119,1124
2008,Nigeria,NGA,Guinea,GIN,0,0,0,5,5
2008,Sierra Leone,SLE,Guinea,GIN,0,0,0,1777,1777
2008,Afghanistan,AFG,Cote d'Ivoire,CIV,0,0,0,5,5
2008,Angola,AGO,Cote d'Ivoire,CIV,0,0,0,5,5
2008,Burundi,BDI,Cote d'Ivoire,CIV,0,0,0,5,5
2008,Central African Rep.,CAF,Cote d'Ivoire,CIV,0,0,5,175,180
2008,Chad,TCD,Cote d'Ivoire,CIV,0,0,5,5,10
2008,Cameroon,CMR,Cote d'Ivoire,CIV,0,0,0,13,13
2008,Congo,COG,Cote d'Ivoire,CIV,5,0,58,571,634
2008,Dem. Rep. of the Congo,COD,Cote d'Ivoire,CIV,11,0,40,102,153
2008,Palestinian,PSE,Cote d'Ivoire,CIV,0,0,0,5,5
2008,Ghana,GHA,Cote d'Ivoire,CIV,0,0,0,5,5
2008,Guinea,GIN,Cote d'Ivoire,CIV,5,0,5,28,38
2008,Liberia,LBR,Cote d'Ivoire,CIV,0,0,10,0,10
2008,Sri Lanka,LKA,Cote d'Ivoire,CIV,0,0,0,10,10
2008,Mauritania,MRT,Cote d'Ivoire,CIV,0,0,0,5,5
2008,Nigeria,NGA,Cote d'Ivoire,CIV,0,0,30,0,30
2008,Romania,ROU,Cote d'Ivoire,CIV,0,0,0,5,5
2008,Rwanda,RWA,Cote d'Ivoire,CIV,5,0,0,43,48
2008,Senegal,SEN,Cote d'Ivoire,CIV,0,0,0,5,5
2008,Sierra Leone,SLE,Cote d'Ivoire,CIV,0,0,30,294,324
2008,Togo,TGO,Cote d'Ivoire,CIV,0,0,47,48,95
2008,Egypt,EGY,Rep. of Korea,KOR,0,0,0,5,5
2008,Bangladesh,BGD,Rep. of Korea,KOR,0,0,5,0,5
2008,China,CHN,Rep. of Korea,KOR,0,0,15,10,25
2008,Cameroon,CMR,Rep. of Korea,KOR,0,0,0,5,5
2008,Dem. Rep. of the Congo,COD,Rep. of Korea,KOR,10,0,0,0,10
2008,Ethiopia,ETH,Rep. of Korea,KOR,5,10,0,0,15
2008,Ghana,GHA,Rep. of Korea,KOR,0,0,13,0,13
2008,Cote d'Ivoire,CIV,Rep. of Korea,KOR,0,0,5,0,5
2008,Iraq,IRQ,Rep. of Korea,KOR,0,0,0,5,5
2008,Sri Lanka,LKA,Rep. of Korea,KOR,0,0,0,17,17
2008,Myanmar,MMR,Rep. of Korea,KOR,20,10,0,0,30
2008,Nepal,NPL,Rep. of Korea,KOR,0,0,33,31,64
2008,Nigeria,NGA,Rep. of Korea,KOR,0,0,5,5,10
2008,Pakistan,PAK,Rep. of Korea,KOR,0,0,0,5,5
2008,South Africa,ZAF,Rep. of Korea,KOR,0,0,0,5,5
2008,Uganda,UGA,Rep. of Korea,KOR,0,0,0,13,13
2008,Afghanistan,AFG,North Macedonia,MKD,0,0,0,5,5
2008,Serbia and Kosovo: S/RES/1244 (1999),SRB,North Macedonia,MKD,0,46,17,47,110
2008,Afghanistan,AFG,Rep. of Moldova,MDA,0,0,0,5,5
2008,Armenia,ARM,Rep. of Moldova,MDA,0,5,19,0,24
2008,Azerbaijan,AZE,Rep. of Moldova,MDA,0,5,0,0,5
2008,Jordan,JOR,Rep. of Moldova,MDA,0,0,5,0,5
2008,Russian Federation,RUS,Rep. of Moldova,MDA,0,12,0,0,12
2008,Sudan,SDN,Rep. of Moldova,MDA,0,0,5,0,5
2008,Syrian Arab Rep.,SYR,Rep. of Moldova,MDA,0,0,0,5,5
2008,Turkey,TUR,Rep. of Moldova,MDA,0,0,5,5,10
2008,Uzbekistan,UZB,Rep. of Moldova,MDA,0,0,5,0,5
2008,Burundi,BDI,Malawi,MWI,311,0,0,39,350
2008,Dem. Rep. of the Congo,COD,Malawi,MWI,844,0,0,12,856
2008,Rwanda,RWA,Malawi,MWI,71,0,231,121,423
2008,Somalia,SOM,Malawi,MWI,13,0,0,22,35
2008,Sudan,SDN,Malawi,MWI,5,0,0,0,5
2008,Albania,ALB,Montenegro,MNE,0,0,5,0,5
2008,Dem. Rep. of the Congo,COD,Portugal,PRT,5,5,0,0,10
2008,Colombia,COL,Portugal,PRT,0,16,5,0,21
2008,Eritrea,ERI,Portugal,PRT,0,5,0,0,5
2008,Guinea-Bissau,GNB,Portugal,PRT,5,0,0,0,5
2008,Guinea,GIN,Portugal,PRT,0,5,5,0,10
2008,Sri Lanka,LKA,Portugal,PRT,0,5,0,0,5
2008,Nigeria,NGA,Portugal,PRT,0,5,0,0,5
2008,Russian Federation,RUS,Portugal,PRT,0,5,5,0,10
2008,Senegal,SEN,Portugal,PRT,0,0,5,0,5
2008,Somalia,SOM,Portugal,PRT,0,19,0,0,19
2008,Afghanistan,AFG,Romania,ROU,0,0,5,0,5
2008,Albania,ALB,Romania,ROU,0,0,0,5,5
2008,Egypt,EGY,Romania,ROU,0,0,5,0,5
2008,Bangladesh,BGD,Romania,ROU,0,0,145,0,145
2008,Bulgaria,BGR,Romania,ROU,0,0,5,0,5
2008,China,CHN,Romania,ROU,0,0,43,5,48
2008,Cameroon,CMR,Romania,ROU,0,0,12,0,12
2008,Congo,COG,Romania,ROU,0,0,5,0,5
2008,Cuba,CUB,Romania,ROU,0,0,5,0,5
2008,Ecuador,ECU,Romania,ROU,0,0,5,0,5
2008,Georgia,GEO,Romania,ROU,0,0,48,0,48
2008,Guinea,GIN,Romania,ROU,5,0,5,0,10
2008,Cote d'Ivoire,CIV,Romania,ROU,0,0,5,0,5
2008,India,IND,Romania,ROU,0,0,123,0,123
2008,Iran (Islamic Rep. of),IRN,Romania,ROU,5,0,5,0,10
2008,Iraq,IRQ,Romania,ROU,90,0,83,16,189
2008,Israel,ISR,Romania,ROU,0,0,5,0,5
2008,Kenya,KEN,Romania,ROU,0,0,5,0,5
2008,Lebanon,LBN,Romania,ROU,0,0,0,12,12
2008,Rep. of Moldova,MDA,Romania,ROU,0,0,13,0,13
2008,Morocco,MAR,Romania,ROU,0,0,0,5,5
2008,Pakistan,PAK,Romania,ROU,5,0,226,0,231
2008,Russian Federation,RUS,Romania,ROU,0,0,11,0,11
2008,Serbia and Kosovo: S/RES/1244 (1999),SRB,Romania,ROU,10,0,13,14,37
2008,Senegal,SEN,Romania,ROU,0,0,5,0,5
2008,Somalia,SOM,Romania,ROU,13,0,0,0,13
2008,Sudan,SDN,Romania,ROU,0,0,5,0,5
2008,Syrian Arab Rep.,SYR,Romania,ROU,0,0,12,0,12
2008,Turkey,TUR,Romania,ROU,0,0,49,19,68
2008,Eritrea,ERI,El Salvador,SLV,0,0,0,5,5
2008,Burundi,BDI,United Rep. of Tanzania,TZA,39,0,0,0,39
2008,Dem. Rep. of the Congo,COD,United Rep. of Tanzania,TZA,15,0,0,0,15
2008,Myanmar,MMR,Thailand,THA,755,0,150,40,945
2009,Afghanistan,AFG,Austria,AUT,587,535,585,267,1974
2009,Albania,ALB,Austria,AUT,5,5,45,34,89
2009,Algeria,DZA,Austria,AUT,0,5,221,62,288
2009,Angola,AGO,Austria,AUT,12,5,10,0,27
2009,Egypt,EGY,Austria,AUT,5,5,37,12,59
2009,Armenia,ARM,Austria,AUT,44,39,617,35,735
2009,Azerbaijan,AZE,Austria,AUT,25,5,92,31,153
2009,Burundi,BDI,Austria,AUT,5,0,0,0,5
2009,Benin,BEN,Austria,AUT,0,0,5,0,5
2009,Bangladesh,BGD,Austria,AUT,14,5,43,28,90
2009,Belarus,BLR,Austria,AUT,5,17,108,20,150
2009,Bosnia and Herzegovina,BIH,Austria,AUT,10,10,58,25,103
2009,Bulgaria,BGR,Austria,AUT,0,0,5,0,5
2009,Chad,TCD,Austria,AUT,0,0,5,0,5
2009,China,CHN,Austria,AUT,48,5,450,124,627
2009,Cameroon,CMR,Austria,AUT,31,0,26,5,62
2009,Congo,COG,Austria,AUT,18,0,5,0,23
2009,Dem. Rep. of the Congo,COD,Austria,AUT,30,5,13,16,64
2009,Cuba,CUB,Austria,AUT,5,0,0,0,5
2009,Eritrea,ERI,Austria,AUT,12,5,5,0,22
2009,Ethiopia,ETH,Austria,AUT,12,5,5,0,22
2009,Gabon,GAB,Austria,AUT,0,0,5,0,5
2009,Gambia,GMB,Austria,AUT,14,0,139,22,175
2009,Georgia,GEO,Austria,AUT,62,60,1095,173,1390
2009,Ghana,GHA,Austria,AUT,0,5,72,12,89
2009,Guinea-Bissau,GNB,Austria,AUT,0,0,13,11,24
2009,Guinea,GIN,Austria,AUT,0,0,24,5,29
2009,Croatia,HRV,Austria,AUT,0,0,14,0,14
2009,Cote d'Ivoire,CIV,Austria,AUT,5,0,5,0,10
2009,India,IND,Austria,AUT,5,11,580,139,735
2009,Iran (Islamic Rep. of),IRN,Austria,AUT,153,17,98,63,331
2009,Iraq,IRQ,Austria,AUT,177,114,71,86,448
2009,Israel,ISR,Austria,AUT,0,0,14,0,14
2009,Jordan,JOR,Austria,AUT,0,0,5,5,10
2009,Kazakhstan,KAZ,Austria,AUT,5,0,28,10,43
2009,Kenya,KEN,Austria,AUT,11,0,0,0,11
2009,Kyrgyzstan,KGZ,Austria,AUT,26,12,48,10,96
2009,Liberia,LBR,Austria,AUT,0,5,34,10,49
2009,Libya,LBY,Austria,AUT,0,0,0,5,5
2009,Lebanon,LBN,Austria,AUT,0,5,24,12,41
2009,Sri Lanka,LKA,Austria,AUT,11,0,5,10,26
2009,Mauritania,MRT,Austria,AUT,0,0,5,0,5
2009,North Macedonia,MKD,Austria,AUT,0,32,362,49,443
2009,Rep. of Moldova,MDA,Austria,AUT,5,5,284,94,388
2009,Mali,MLI,Austria,AUT,0,0,5,0,5
2009,Mongolia,MNG,Austria,AUT,5,13,266,76,360
2009,Morocco,MAR,Austria,AUT,0,5,104,33,142
2009,Montenegro,MNE,Austria,AUT,0,0,5,0,5
2009,Nepal,NPL,Austria,AUT,5,5,43,10,63
2009,Niger,NER,Austria,AUT,0,0,13,0,13
2009,Nigeria,NGA,Austria,AUT,16,27,999,225,1267
2009,Pakistan,PAK,Austria,AUT,0,5,162,46,213
2009,Peru,PER,Austria,AUT,0,0,5,0,5
2009,Philippines,PHL,Austria,AUT,0,0,5,0,5
2009,Poland,POL,Austria,AUT,0,0,0,5,5
2009,Romania,ROU,Austria,AUT,0,0,18,5,23
2009,South Africa,ZAF,Austria,AUT,0,0,5,0,5
2009,Russian Federation,RUS,Austria,AUT,1398,312,2731,561,5002
2009,Rwanda,RWA,Austria,AUT,13,0,0,0,13
2009,Serbia and Kosovo: S/RES/1244 (1999),SRB,Austria,AUT,90,118,2253,724,3185
2009,Senegal,SEN,Austria,AUT,0,0,5,5,10
2009,Sierra Leone,SLE,Austria,AUT,5,0,15,5,25
2009,Somalia,SOM,Austria,AUT,149,54,60,90,353
2009,Viet Nam,VNM,Austria,AUT,0,0,71,5,76
2009,Sudan,SDN,Austria,AUT,12,0,21,12,45
2009,Slovakia,SVK,Austria,AUT,0,0,5,0,5
2009,Syrian Arab Rep.,SYR,Austria,AUT,52,0,80,12,144
2009,Tajikistan,TJK,Austria,AUT,12,0,0,5,17
2009,Turkmenistan,TKM,Austria,AUT,5,0,0,0,5
2009,Togo,TGO,Austria,AUT,0,0,13,0,13
2009,Tunisia,TUN,Austria,AUT,0,0,20,10,30
2009,Turkey,TUR,Austria,AUT,93,24,942,149,1208
2009,Uganda,UGA,Austria,AUT,0,0,0,5,5
2009,Ukraine,UKR,Austria,AUT,13,26,259,41,339
2009,United States of America,USA,Austria,AUT,0,0,0,5,5
2009,Uzbekistan,UZB,Austria,AUT,12,10,25,0,47
2009,Zimbabwe,ZWE,Austria,AUT,0,0,14,0,14
2009,Stateless,XXA,Austria,AUT,34,10,90,31,165
2009,India,IND,Bosnia and Herzegovina,BIH,0,0,0,5,5
2009,Serbia and Kosovo: S/RES/1244 (1999),SRB,Bosnia and Herzegovina,BIH,0,5,93,53,151
2009,Colombia,COL,Costa Rica,CRI,337,0,486,0,823
2009,Cuba,CUB,Costa Rica,CRI,43,0,5,0,48
2009,Ethiopia,ETH,Costa Rica,CRI,5,0,0,0,5
2009,Guatemala,GTM,Costa Rica,CRI,11,0,0,0,11
2009,Haiti,HTI,Costa Rica,CRI,5,0,0,0,5
2009,Honduras,HND,Costa Rica,CRI,0,0,13,0,13
2009,Iraq,IRQ,Costa Rica,CRI,5,0,0,0,5
2009,Nicaragua,NIC,Costa Rica,CRI,0,0,26,0,26
2009,El Salvador,SLV,Costa Rica,CRI,10,0,43,0,53
2009,United States of America,USA,Costa Rica,CRI,0,0,5,0,5
2009,Venezuela (Bolivarian Republic of),VEN,Costa Rica,CRI,39,0,10,0,49
2009,Afghanistan,AFG,Ecuador,ECU,26,0,0,0,26
2009,Argentina,ARG,Ecuador,ECU,5,0,5,0,10
2009,China,CHN,Ecuador,ECU,0,0,11,0,11
2009,Chile,CHL,Ecuador,ECU,0,0,5,0,5
2009,Colombia,COL,Ecuador,ECU,26223,0,1686,91,28000
2009,Cuba,CUB,Ecuador,ECU,34,0,569,17,620
2009,Dominican Rep.,DOM,Ecuador,ECU,0,0,16,0,16
2009,Ethiopia,ETH,Ecuador,ECU,5,0,0,0,5
2009,Haiti,HTI,Ecuador,ECU,5,0,44,0,49
2009,Cote d'Ivoire,CIV,Ecuador,ECU,0,0,5,0,5
2009,Sri Lanka,LKA,Ecuador,ECU,5,0,0,0,5
2009,Nepal,NPL,Ecuador,ECU,0,0,5,0,5
2009,Nigeria,NGA,Ecuador,ECU,13,0,0,0,13
2009,Pakistan,PAK,Ecuador,ECU,12,0,5,0,17
2009,Peru,PER,Ecuador,ECU,5,0,1009,35,1049
2009,South Africa,ZAF,Ecuador,ECU,0,0,5,0,5
2009,Russian Federation,RUS,Ecuador,ECU,5,0,0,0,5
2009,United States of America,USA,Ecuador,ECU,0,0,5,0,5
2009,Venezuela (Bolivarian Republic of),VEN,Ecuador,ECU,0,0,5,0,5
2009,Zimbabwe,ZWE,Ecuador,ECU,5,0,0,0,5
2009,Central African Rep.,CAF,Gabon,GAB,0,0,0,5,5
2009,Chad,TCD,Gabon,GAB,0,0,0,5,5
2009,Congo,COG,Gabon,GAB,5,0,5,73,83
2009,Dem. Rep. of the Congo,COD,Gabon,GAB,0,0,0,11,11
2009,Cote d'Ivoire,CIV,Gabon,GAB,0,0,0,5,5
2009,Iran (Islamic Rep. of),IRN,Georgia,GEO,0,0,5,0,5
2009,Iraq,IRQ,Georgia,GEO,5,0,0,0,5
2009,Russian Federation,RUS,Georgia,GEO,5,0,12,0,17
2009,Afghanistan,AFG,Hungary,HUN,5,141,167,737,1050
2009,Albania,ALB,Hungary,HUN,0,0,0,26,26
2009,Algeria,DZA,Hungary,HUN,0,0,5,30,35
2009,Egypt,EGY,Hungary,HUN,0,0,10,44,54
2009,Armenia,ARM,Hungary,HUN,0,0,5,16,21
2009,Bangladesh,BGD,Hungary,HUN,0,0,0,26,26
2009,Belarus,BLR,Hungary,HUN,0,0,0,5,5
2009,Bosnia and Herzegovina,BIH,Hungary,HUN,0,0,5,19,24
2009,China,CHN,Hungary,HUN,0,0,33,217,250
2009,Cameroon,CMR,Hungary,HUN,0,0,5,0,5
2009,Dem. Rep. of the Congo,COD,Hungary,HUN,5,0,0,0,5
2009,Cuba,CUB,Hungary,HUN,0,0,0,5,5
2009,Ethiopia,ETH,Hungary,HUN,0,0,0,5,5
2009,Palestinian,PSE,Hungary,HUN,11,5,5,10,31
2009,Georgia,GEO,Hungary,HUN,0,10,25,127,162
2009,Ghana,GHA,Hungary,HUN,0,0,0,5,5
2009,Guinea,GIN,Hungary,HUN,0,0,5,0,5
2009,Cote d'Ivoire,CIV,Hungary,HUN,0,5,17,0,22
2009,India,IND,Hungary,HUN,0,0,5,0,5
2009,Indonesia,IDN,Hungary,HUN,0,0,0,5,5
2009,Iran (Islamic Rep. of),IRN,Hungary,HUN,10,0,10,37,57
2009,Iraq,IRQ,Hungary,HUN,11,24,19,48,102
2009,Jordan,JOR,Hungary,HUN,0,0,5,0,5
2009,Liberia,LBR,Hungary,HUN,0,0,5,0,5
2009,Libya,LBY,Hungary,HUN,0,0,5,0,5
2009,Lebanon,LBN,Hungary,HUN,0,0,0,20,20
2009,Sri Lanka,LKA,Hungary,HUN,5,0,0,21,26
2009,North Macedonia,MKD,Hungary,HUN,0,0,10,52,62
2009,Rep. of Moldova,MDA,Hungary,HUN,0,0,11,22,33
2009,Mongolia,MNG,Hungary,HUN,0,0,10,38,48
2009,Morocco,MAR,Hungary,HUN,0,0,0,5,5
2009,Montenegro,MNE,Hungary,HUN,0,0,0,11,11
2009,Nigeria,NGA,Hungary,HUN,0,0,37,57,94
2009,Pakistan,PAK,Hungary,HUN,0,0,11,53,64
2009,Romania,ROU,Hungary,HUN,0,0,0,5,5
2009,Russian Federation,RUS,Hungary,HUN,0,0,10,14,24
2009,Serbia and Kosovo: S/RES/1244 (1999),SRB,Hungary,HUN,0,5,828,2441,3274
2009,Sierra Leone,SLE,Hungary,HUN,0,5,0,0,5
2009,Somalia,SOM,Hungary,HUN,100,13,11,63,187
2009,Viet Nam,VNM,Hungary,HUN,0,0,32,506,538
2009,Slovakia,SVK,Hungary,HUN,0,0,0,11,11
2009,Syrian Arab Rep.,SYR,Hungary,HUN,0,0,10,37,47
2009,Tunisia,TUN,Hungary,HUN,5,0,0,0,5
2009,Turkey,TUR,Hungary,HUN,0,0,19,120,139
2009,Ukraine,UKR,Hungary,HUN,0,0,0,5,5
2009,Stateless,XXA,Hungary,HUN,0,5,0,0,5
2009,Burundi,BDI,Cote d'Ivoire,CIV,0,0,0,5,5
2009,Chad,TCD,Cote d'Ivoire,CIV,17,0,0,0,17
2009,Congo,COG,Cote d'Ivoire,CIV,0,0,14,10,24
2009,Dem. Rep. of the Congo,COD,Cote d'Ivoire,CIV,5,0,46,0,51
2009,Equatorial Guinea,GNQ,Cote d'Ivoire,CIV,0,0,0,5,5
2009,Liberia,LBR,Cote d'Ivoire,CIV,0,0,10,18,28
2009,Nigeria,NGA,Cote d'Ivoire,CIV,0,0,26,0,26
2009,Rwanda,RWA,Cote d'Ivoire,CIV,0,0,0,19,19
2009,Senegal,SEN,Cote d'Ivoire,CIV,0,0,0,5,5
2009,Sierra Leone,SLE,Cote d'Ivoire,CIV,0,0,16,13,29
2009,Togo,TGO,Cote d'Ivoire,CIV,5,0,19,41,65
2009,Egypt,EGY,Rep. of Korea,KOR,0,0,5,0,5
2009,Bangladesh,BGD,Rep. of Korea,KOR,21,0,24,10,55
2009,China,CHN,Rep. of Korea,KOR,0,0,87,11,98
2009,Cameroon,CMR,Rep. of Korea,KOR,0,0,5,0,5
2009,Dem. Rep. of the Congo,COD,Rep. of Korea,KOR,0,0,21,5,26
2009,Ethiopia,ETH,Rep. of Korea,KOR,5,0,16,0,21
2009,Ghana,GHA,Rep. of Korea,KOR,0,0,74,10,84
2009,Cote d'Ivoire,CIV,Rep. of Korea,KOR,0,0,34,10,44
2009,Iran (Islamic Rep. of),IRN,Rep. of Korea,KOR,0,0,13,0,13
2009,Kenya,KEN,Rep. of Korea,KOR,0,0,10,0,10
2009,Liberia,LBR,Rep. of Korea,KOR,0,0,26,5,31
2009,Sri Lanka,LKA,Rep. of Korea,KOR,0,0,128,31,159
2009,Myanmar,MMR,Rep. of Korea,KOR,37,5,62,14,118
2009,Nepal,NPL,Rep. of Korea,KOR,0,5,228,62,295
2009,Nigeria,NGA,Rep. of Korea,KOR,0,0,109,15,124
2009,Pakistan,PAK,Rep. of Korea,KOR,0,0,61,11,72
2009,South Africa,ZAF,Rep. of Korea,KOR,0,0,0,5,5
2009,Russian Federation,RUS,Rep. of Korea,KOR,0,0,0,5,5
2009,Togo,TGO,Rep. of Korea,KOR,0,0,5,0,5
2009,Uganda,UGA,Rep. of Korea,KOR,5,5,86,12,108
2009,Uzbekistan,UZB,Rep. of Korea,KOR,5,0,0,0,5
2009,Afghanistan,AFG,North Macedonia,MKD,0,0,0,69,69
2009,Albania,ALB,North Macedonia,MKD,0,0,0,5,5
2009,Serbia and Kosovo: S/RES/1244 (1999),SRB,North Macedonia,MKD,0,0,19,12,31
2009,Afghanistan,AFG,Rep. of Moldova,MDA,0,5,0,0,5
2009,Armenia,ARM,Rep. of Moldova,MDA,0,10,11,0,21
2009,Georgia,GEO,Rep. of Moldova,MDA,0,5,0,0,5
2009,Iran (Islamic Rep. of),IRN,Rep. of Moldova,MDA,0,5,0,0,5
2009,Pakistan,PAK,Rep. of Moldova,MDA,0,5,0,0,5
2009,Russian Federation,RUS,Rep. of Moldova,MDA,0,5,5,0,10
2009,Spain,ESP,Rep. of Moldova,MDA,0,0,5,0,5
2009,Syrian Arab Rep.,SYR,Rep. of Moldova,MDA,0,0,5,0,5
2009,Turkey,TUR,Rep. of Moldova,MDA,0,0,5,0,5
2009,Albania,ALB,Montenegro,MNE,0,0,0,5,5
2009,North Macedonia,MKD,Montenegro,MNE,0,0,5,0,5
2009,Serbia and Kosovo: S/RES/1244 (1999),SRB,Montenegro,MNE,0,0,5,0,5
2009,Central African Rep.,CAF,Nigeria,NGA,0,0,0,5,5
2009,Chad,TCD,Nigeria,NGA,0,0,0,5,5
2009,Cameroon,CMR,Nigeria,NGA,0,0,0,22,22
2009,Guinea,GIN,Nigeria,NGA,0,0,0,5,5
2009,Cote d'Ivoire,CIV,Nigeria,NGA,0,0,0,21,21
2009,Liberia,LBR,Nigeria,NGA,0,0,0,180,180
2009,Lebanon,LBN,Nigeria,NGA,0,0,0,5,5
2009,Sierra Leone,SLE,Nigeria,NGA,0,0,0,98,98
2009,Sudan,SDN,Nigeria,NGA,0,0,0,15,15
2009,Togo,TGO,Nigeria,NGA,0,0,0,12,12
2009,Colombia,COL,Paraguay,PRY,5,0,0,0,5
2009,Cuba,CUB,Paraguay,PRY,5,0,0,5,10
2009,Iraq,IRQ,Paraguay,PRY,5,0,0,0,5
2009,Afghanistan,AFG,Romania,ROU,14,5,37,0,56
2009,Albania,ALB,Romania,ROU,0,0,0,5,5
2009,Egypt,EGY,Romania,ROU,0,0,10,5,15
2009,Bangladesh,BGD,Romania,ROU,0,0,85,5,90
2009,China,CHN,Romania,ROU,0,0,60,25,85
2009,Cameroon,CMR,Romania,ROU,5,0,16,0,21
2009,Congo,COG,Romania,ROU,5,0,0,0,5
2009,Dem. Rep. of the Congo,COD,Romania,ROU,0,0,23,0,23
2009,Palestinian,PSE,Romania,ROU,0,0,5,5,10
2009,Georgia,GEO,Romania,ROU,0,0,24,0,24
2009,Guinea,GIN,Romania,ROU,0,0,5,0,5
2009,Cote d'Ivoire,CIV,Romania,ROU,0,0,5,0,5
2009,India,IND,Romania,ROU,0,0,64,0,64
2009,Iran (Islamic Rep. of),IRN,Romania,ROU,0,0,12,0,12
2009,Iraq,IRQ,Romania,ROU,28,14,53,5,100
2009,Israel,ISR,Romania,ROU,0,0,5,0,5
2009,Jordan,JOR,Romania,ROU,0,0,5,0,5
2009,Lebanon,LBN,Romania,ROU,0,0,0,5,5
2009,Sri Lanka,LKA,Romania,ROU,0,0,5,0,5
2009,Rep. of Moldova,MDA,Romania,ROU,5,0,112,27,144
2009,Nigeria,NGA,Romania,ROU,0,0,10,5,15
2009,Pakistan,PAK,Romania,ROU,0,0,118,5,123
2009,Russian Federation,RUS,Romania,ROU,0,0,5,0,5
2009,Serbia and Kosovo: S/RES/1244 (1999),SRB,Romania,ROU,0,0,5,16,21
2009,Senegal,SEN,Romania,ROU,0,0,5,0,5
2009,Somalia,SOM,Romania,ROU,0,0,12,0,12
2009,Syrian Arab Rep.,SYR,Romania,ROU,0,0,10,10,20
2009,Turkey,TUR,Romania,ROU,5,0,74,27,106
2009,Ukraine,UKR,Romania,ROU,0,0,5,0,5
2009,Colombia,COL,El Salvador,SLV,0,0,0,5,5
2009,Eritrea,ERI,El Salvador,SLV,0,0,0,26,26
2009,Nepal,NPL,El Salvador,SLV,0,0,0,5,5
2009,Somalia,SOM,El Salvador,SLV,0,0,0,5,5
2009,Central African Rep.,CAF,Sudan,SDN,16,0,0,0,16
2009,Chad,TCD,Sudan,SDN,81,0,0,0,81
2009,Dem. Rep. of the Congo,COD,Sudan,SDN,5,0,0,0,5
2009,Eritrea,ERI,Sudan,SDN,10103,0,23,0,10126
2009,Ethiopia,ETH,Sudan,SDN,245,0,0,0,245
2009,Somalia,SOM,Sudan,SDN,42,0,0,0,42
2009,Burundi,BDI,United Rep. of Tanzania,TZA,5,0,0,174,179
2009,Dem. Rep. of the Congo,COD,United Rep. of Tanzania,TZA,31,0,12,49,92
2009,Rwanda,RWA,United Rep. of Tanzania,TZA,10,0,0,0,10
2009,Sudan,SDN,United Rep. of Tanzania,TZA,0,0,10,0,10
2009,Uganda,UGA,United Rep. of Tanzania,TZA,5,0,0,0,5
2009,Myanmar,MMR,Thailand,THA,6809,0,1128,0,7937
2009,Afghanistan,AFG,Tajikistan,TJK,894,0,200,0,1094
2009,Iraq,IRQ,Tajikistan,TJK,0,0,5,0,5
2009,Burundi,BDI,Uganda,UGA,607,0,46,35,688
2009,Dem. Rep. of the Congo,COD,Uganda,UGA,4426,0,14,237,4677
2009,Eritrea,ERI,Uganda,UGA,2278,0,0,174,2452
2009,Ethiopia,ETH,Uganda,UGA,331,0,41,48,420
2009,Kenya,KEN,Uganda,UGA,159,0,5,47,211
2009,Pakistan,PAK,Uganda,UGA,5,0,0,0,5
2009,Rwanda,RWA,Uganda,UGA,571,0,127,3722,4420
2009,Somalia,SOM,Uganda,UGA,1942,0,0,366,2308
2009,Sudan,SDN,Uganda,UGA,2797,0,26,122,2945
2009,Colombia,COL,Venezuela (Bolivarian Republic of),VEN,210,0,226,0,436
2009,Iran (Islamic Rep. of),IRN,Venezuela (Bolivarian Republic of),VEN,5,0,0,0,5
2009,Burundi,BDI,Zambia,ZMB,5,0,13,0,18
2009,Dem. Rep. of the Congo,COD,Zambia,ZMB,92,0,55,20,167
2009,Ethiopia,ETH,Zambia,ZMB,0,0,0,5,5
2009,Iraq,IRQ,Zambia,ZMB,0,0,5,0,5
2009,Kenya,KEN,Zambia,ZMB,0,0,5,0,5
2009,Rwanda,RWA,Zambia,ZMB,5,0,14,0,19
2009,Somalia,SOM,Zambia,ZMB,23,0,0,35,58
2009,Uganda,UGA,Zambia,ZMB,0,0,10,0,10
2009,Zimbabwe,ZWE,Zambia,ZMB,0,0,5,0,5
2010,Chad,TCD,Angola,AGO,16,0,0,0,16
2010,Dem. Rep. of the Congo,COD,Angola,AGO,16,0,0,0,16
2010,Guinea,GIN,Angola,AGO,16,0,0,0,16
2010,Cote d'Ivoire,CIV,Angola,AGO,21,0,0,0,21
2010,Mauritania,MRT,Angola,AGO,19,0,0,0,19
2010,Rwanda,RWA,Angola,AGO,13,0,0,0,13
2010,Sudan,SDN,Angola,AGO,24,0,0,0,24
2010,Afghanistan,AFG,Austria,AUT,584,669,962,165,2380
2010,Albania,ALB,Austria,AUT,12,0,86,13,111
2010,Algeria,DZA,Austria,AUT,5,0,243,85,333
2010,Angola,AGO,Austria,AUT,11,5,5,5,26
2010,Egypt,EGY,Austria,AUT,0,5,43,20,68
2010,Armenia,ARM,Austria,AUT,22,56,741,50,869
2010,Azerbaijan,AZE,Austria,AUT,46,27,130,14,217
2010,Burundi,BDI,Austria,AUT,0,0,11,0,11
2010,Benin,BEN,Austria,AUT,0,0,10,0,10
2010,Bangladesh,BGD,Austria,AUT,14,5,63,22,104
2010,Burkina Faso,BFA,Austria,AUT,0,0,5,0,5
2010,Belarus,BLR,Austria,AUT,5,11,102,15,133
2010,Bolivia (Plurinational State of),BOL,Austria,AUT,14,0,0,0,14
2010,Bosnia and Herzegovina,BIH,Austria,AUT,5,11,111,17,144
2010,Bulgaria,BGR,Austria,AUT,0,0,0,10,10
2010,China,CHN,Austria,AUT,32,10,467,119,628
2010,Chile,CHL,Austria,AUT,0,0,5,0,5
2010,Cameroon,CMR,Austria,AUT,19,0,44,5,68
2010,Congo,COG,Austria,AUT,13,5,5,0,23
2010,Dem. Rep. of the Congo,COD,Austria,AUT,52,5,15,10,82
2010,Cuba,CUB,Austria,AUT,0,0,5,0,5
2010,Eritrea,ERI,Austria,AUT,16,0,5,0,21
2010,Ethiopia,ETH,Austria,AUT,12,5,5,5,27
2010,Gabon,GAB,Austria,AUT,0,0,5,0,5
2010,Gambia,GMB,Austria,AUT,20,5,134,23,182
2010,Georgia,GEO,Austria,AUT,25,54,849,101,1029
2010,Ghana,GHA,Austria,AUT,0,5,87,5,97
2010,Guinea-Bissau,GNB,Austria,AUT,0,0,12,20,32
2010,Guinea,GIN,Austria,AUT,10,0,30,12,52
2010,Croatia,HRV,Austria,AUT,0,0,5,0,5
2010,Cote d'Ivoire,CIV,Austria,AUT,5,0,12,0,17
2010,India,IND,Austria,AUT,0,5,606,85,696
2010,Iran (Islamic Rep. of),IRN,Austria,AUT,222,15,141,47,425
2010,Iraq,IRQ,Austria,AUT,81,154,108,48,391
2010,Israel,ISR,Austria,AUT,5,0,10,0,15
2010,Jordan,JOR,Austria,AUT,0,0,5,5,10
2010,Kazakhstan,KAZ,Austria,AUT,5,0,17,5,27
2010,Kenya,KEN,Austria,AUT,0,0,5,5,10
2010,Kyrgyzstan,KGZ,Austria,AUT,10,15,21,5,51
2010,Liberia,LBR,Austria,AUT,0,5,51,5,61
2010,Libya,LBY,Austria,AUT,0,0,11,0,11
2010,Lebanon,LBN,Austria,AUT,5,0,54,17,76
2010,Sri Lanka,LKA,Austria,AUT,5,0,14,0,19
2010,Mauritania,MRT,Austria,AUT,0,0,5,0,5
2010,North Macedonia,MKD,Austria,AUT,0,5,291,55,351
2010,Rep. of Moldova,MDA,Austria,AUT,5,11,178,90,284
2010,Mali,MLI,Austria,AUT,0,0,10,13,23
2010,Mongolia,MNG,Austria,AUT,5,10,377,76,468
2010,Morocco,MAR,Austria,AUT,0,0,127,19,146
2010,Montenegro,MNE,Austria,AUT,0,0,15,0,15
2010,Myanmar,MMR,Austria,AUT,0,0,5,0,5
2010,Nepal,NPL,Austria,AUT,5,0,78,18,101
2010,Niger,NER,Austria,AUT,0,0,15,0,15
2010,Nigeria,NGA,Austria,AUT,15,41,1182,216,1454
2010,Pakistan,PAK,Austria,AUT,5,0,184,30,219
2010,Philippines,PHL,Austria,AUT,0,0,5,0,5
2010,Romania,ROU,Austria,AUT,0,0,12,15,27
2010,Russian Federation,RUS,Austria,AUT,1082,341,2183,270,3876
2010,Rwanda,RWA,Austria,AUT,0,0,13,0,13
2010,Serbia and Kosovo: S/RES/1244 (1999),SRB,Austria,AUT,76,96,1772,411,2355
2010,Senegal,SEN,Austria,AUT,0,0,18,10,28
2010,Sierra Leone,SLE,Austria,AUT,5,0,22,5,32
2010,Somalia,SOM,Austria,AUT,189,84,42,50,365
2010,Viet Nam,VNM,Austria,AUT,0,0,10,5,15
2010,Sudan,SDN,Austria,AUT,21,5,18,17,61
2010,Syrian Arab Rep.,SYR,Austria,AUT,117,5,85,25,232
2010,Tajikistan,TJK,Austria,AUT,5,5,11,5,26
2010,Togo,TGO,Austria,AUT,0,0,5,5,10
2010,Tunisia,TUN,Austria,AUT,0,0,28,15,43
2010,Turkey,TUR,Austria,AUT,112,27,934,125,1198
2010,Uganda,UGA,Austria,AUT,0,0,0,5,5
2010,Ukraine,UKR,Austria,AUT,14,15,194,27,250
2010,Uzbekistan,UZB,Austria,AUT,5,0,13,0,18
2010,Yemen,YEM,Austria,AUT,0,0,5,0,5
2010,Zimbabwe,ZWE,Austria,AUT,5,0,10,0,15
2010,Stateless,XXA,Austria,AUT,49,25,137,37,248
2010,Dem. Rep. of the Congo,COD,Burundi,BDI,4640,349,0,0,4989
2010,Madagascar,MDG,Burundi,BDI,0,0,0,5,5
2010,Mauritania,MRT,Burundi,BDI,10,0,0,0,10
2010,Rwanda,RWA,Burundi,BDI,23,0,0,10,33
2010,Somalia,SOM,Burundi,BDI,16,0,0,0,16
2010,Ethiopia,ETH,Botswana,BWA,0,0,0,5,5
2010,Somalia,SOM,Botswana,BWA,0,0,0,14,14
2010,Zimbabwe,ZWE,Botswana,BWA,12,0,0,0,12
2010,Serbia and Kosovo: S/RES/1244 (1999),SRB,Bosnia and Herzegovina,BIH,0,0,225,23,248
2010,Cuba,CUB,Belize,BLZ,0,0,0,5,5
2010,Guatemala,GTM,Belize,BLZ,0,0,0,5,5
2010,Somalia,SOM,Belize,BLZ,0,0,0,5,5
2010,Afghanistan,AFG,Ecuador,ECU,11,0,5,10,26
2010,Angola,AGO,Ecuador,ECU,0,0,0,5,5
2010,Argentina,ARG,Ecuador,ECU,0,0,5,5,10
2010,Bangladesh,BGD,Ecuador,ECU,0,0,5,0,5
2010,Bolivia (Plurinational State of),BOL,Ecuador,ECU,0,0,5,5,10
2010,Brazil,BRA,Ecuador,ECU,0,0,5,0,5
2010,China,CHN,Ecuador,ECU,0,0,0,27,27
2010,Chile,CHL,Ecuador,ECU,0,0,0,13,13
2010,Cameroon,CMR,Ecuador,ECU,0,0,11,0,11
2010,Colombia,COL,Ecuador,ECU,1346,6520,1206,18248,27320
2010,Cuba,CUB,Ecuador,ECU,0,0,2189,129,2318
2010,Dominican Rep.,DOM,Ecuador,ECU,0,0,21,13,34
2010,Eritrea,ERI,Ecuador,ECU,5,0,5,0,10
2010,Ethiopia,ETH,Ecuador,ECU,0,0,0,5,5
2010,Gambia,GMB,Ecuador,ECU,0,0,0,5,5
2010,Ghana,GHA,Ecuador,ECU,0,0,0,5,5
2010,Guinea-Bissau,GNB,Ecuador,ECU,5,0,0,0,5
2010,Guinea,GIN,Ecuador,ECU,0,0,5,0,5
2010,Haiti,HTI,Ecuador,ECU,0,0,80,31,111
2010,Cote d'Ivoire,CIV,Ecuador,ECU,0,0,0,5,5
2010,India,IND,Ecuador,ECU,0,0,5,5,10
2010,Iran (Islamic Rep. of),IRN,Ecuador,ECU,0,0,0,10,10
2010,Iraq,IRQ,Ecuador,ECU,0,0,0,12,12
2010,Liberia,LBR,Ecuador,ECU,0,0,0,5,5
2010,Sri Lanka,LKA,Ecuador,ECU,0,5,5,13,23
2010,Mexico,MEX,Ecuador,ECU,0,0,0,5,5
2010,Nepal,NPL,Ecuador,ECU,0,0,0,5,5
2010,Nigeria,NGA,Ecuador,ECU,10,0,49,0,59
2010,Pakistan,PAK,Ecuador,ECU,0,0,19,5,24
2010,Peru,PER,Ecuador,ECU,5,0,463,1244,1712
2010,South Africa,ZAF,Ecuador,ECU,0,0,0,5,5
2010,Russian Federation,RUS,Ecuador,ECU,0,0,0,5,5
2010,Serbia and Kosovo: S/RES/1244 (1999),SRB,Ecuador,ECU,0,0,0,5,5
2010,Spain,ESP,Ecuador,ECU,0,5,0,0,5
2010,Venezuela (Bolivarian Republic of),VEN,Ecuador,ECU,0,0,5,10,15
2010,Stateless,XXA,Ecuador,ECU,5,0,0,0,5
2010,Chad,TCD,Gabon,GAB,0,0,0,28,28
2010,Congo,COG,Gabon,GAB,0,0,0,155,155
2010,Armenia,ARM,Georgia,GEO,0,0,5,0,5
2010,Azerbaijan,AZE,Georgia,GEO,0,0,0,5,5
2010,Iran (Islamic Rep. of),IRN,Georgia,GEO,0,0,5,0,5
2010,Sri Lanka,LKA,Georgia,GEO,0,0,0,5,5
2010,Russian Federation,RUS,Georgia,GEO,5,0,14,5,24
2010,Ukraine,UKR,Georgia,GEO,0,0,5,0,5
2010,Congo,COG,Guinea,GIN,0,0,0,10,10
2010,Dem. Rep. of the Congo,COD,Guinea,GIN,5,0,0,11,16
2010,Cote d'Ivoire,CIV,Guinea,GIN,0,0,31,64,95
2010,Liberia,LBR,Guinea,GIN,0,0,95,372,467
2010,Sierra Leone,SLE,Guinea,GIN,5,0,0,141,146
2010,Togo,TGO,Guinea,GIN,0,0,0,57,57
2010,Burundi,BDI,Cote d'Ivoire,CIV,0,0,0,5,5
2010,Central African Rep.,CAF,Cote d'Ivoire,CIV,0,0,5,0,5
2010,Chad,TCD,Cote d'Ivoire,CIV,13,0,5,0,18
2010,Cameroon,CMR,Cote d'Ivoire,CIV,0,0,5,0,5
2010,Congo,COG,Cote d'Ivoire,CIV,0,0,29,5,34
2010,Dem. Rep. of the Congo,COD,Cote d'Ivoire,CIV,17,0,29,5,51
2010,Equatorial Guinea,GNQ,Cote d'Ivoire,CIV,0,0,0,5,5
2010,Gabon,GAB,Cote d'Ivoire,CIV,0,0,5,0,5
2010,Liberia,LBR,Cote d'Ivoire,CIV,0,0,10,0,10
2010,Nigeria,NGA,Cote d'Ivoire,CIV,5,0,24,0,29
2010,Rwanda,RWA,Cote d'Ivoire,CIV,10,0,0,14,24
2010,Senegal,SEN,Cote d'Ivoire,CIV,0,0,5,0,5
2010,Sierra Leone,SLE,Cote d'Ivoire,CIV,5,0,21,5,31
2010,Togo,TGO,Cote d'Ivoire,CIV,10,0,17,36,63
2010,Afghanistan,AFG,Rep. of Korea,KOR,5,5,0,0,10
2010,Bangladesh,BGD,Rep. of Korea,KOR,5,0,29,10,44
2010,China,CHN,Rep. of Korea,KOR,0,0,13,0,13
2010,Cameroon,CMR,Rep. of Korea,KOR,0,5,5,0,10
2010,Dem. Rep. of the Congo,COD,Rep. of Korea,KOR,5,5,0,0,10
2010,Ethiopia,ETH,Rep. of Korea,KOR,5,0,0,0,5
2010,Ghana,GHA,Rep. of Korea,KOR,0,0,5,0,5
2010,Cote d'Ivoire,CIV,Rep. of Korea,KOR,0,11,0,0,11
2010,India,IND,Rep. of Korea,KOR,0,0,5,0,5
2010,Iran (Islamic Rep. of),IRN,Rep. of Korea,KOR,0,0,14,0,14
2010,Iraq,IRQ,Rep. of Korea,KOR,0,0,5,0,5
2010,Kenya,KEN,Rep. of Korea,KOR,0,0,5,0,5
2010,Kyrgyzstan,KGZ,Rep. of Korea,KOR,0,0,0,24,24
2010,Liberia,LBR,Rep. of Korea,KOR,0,0,0,5,5
2010,Sri Lanka,LKA,Rep. of Korea,KOR,0,0,5,5,10
2010,Myanmar,MMR,Rep. of Korea,KOR,13,10,0,0,23
2010,Nepal,NPL,Rep. of Korea,KOR,0,0,5,0,5
2010,Nigeria,NGA,Rep. of Korea,KOR,0,0,24,0,24
2010,Pakistan,PAK,Rep. of Korea,KOR,0,5,47,14,66
2010,Philippines,PHL,Rep. of Korea,KOR,0,0,5,0,5
2010,South Africa,ZAF,Rep. of Korea,KOR,0,0,5,0,5
2010,Russian Federation,RUS,Rep. of Korea,KOR,5,0,0,0,5
2010,Uganda,UGA,Rep. of Korea,KOR,0,5,0,0,5
2010,Uzbekistan,UZB,Rep. of Korea,KOR,5,0,0,0,5
2010,Eritrea,ERI,Liechtenstein,LIE,0,0,5,0,5
2010,North Macedonia,MKD,Liechtenstein,LIE,0,0,33,5,38
2010,Nigeria,NGA,Liechtenstein,LIE,0,0,0,11,11
2010,Russian Federation,RUS,Liechtenstein,LIE,0,0,14,18,32
2010,Serbia and Kosovo: S/RES/1244 (1999),SRB,Liechtenstein,LIE,0,0,5,0,5
2010,Somalia,SOM,Liechtenstein,LIE,0,0,0,5,5
2010,Afghanistan,AFG,North Macedonia,MKD,0,0,0,44,44
2010,Eritrea,ERI,North Macedonia,MKD,0,0,0,5,5
2010,Palestinian,PSE,North Macedonia,MKD,0,0,0,10,10
2010,Serbia and Kosovo: S/RES/1244 (1999),SRB,North Macedonia,MKD,0,0,10,10,20
2010,Somalia,SOM,North Macedonia,MKD,0,0,0,5,5
2010,Afghanistan,AFG,Rep. of Moldova,MDA,0,11,0,0,11
2010,Armenia,ARM,Rep. of Moldova,MDA,0,13,10,0,23
2010,Georgia,GEO,Rep. of Moldova,MDA,0,10,0,0,10
2010,Iraq,IRQ,Rep. of Moldova,MDA,0,0,0,5,5
2010,Kyrgyzstan,KGZ,Rep. of Moldova,MDA,0,5,0,0,5
2010,Pakistan,PAK,Rep. of Moldova,MDA,0,0,5,0,5
2010,Romania,ROU,Rep. of Moldova,MDA,0,0,5,0,5
2010,Russian Federation,RUS,Rep. of Moldova,MDA,0,11,0,0,11
2010,Turkey,TUR,Rep. of Moldova,MDA,0,0,5,0,5
2010,Ukraine,UKR,Rep. of Moldova,MDA,0,0,5,0,5
2010,Russian Federation,RUS,Montenegro,MNE,0,0,5,0,5
2010,Serbia and Kosovo: S/RES/1244 (1999),SRB,Montenegro,MNE,0,0,0,5,5
2010,Afghanistan,AFG,Romania,ROU,13,22,79,0,114
2010,Albania,ALB,Romania,ROU,0,0,0,5,5
2010,Algeria,DZA,Romania,ROU,0,0,10,0,10
2010,Egypt,EGY,Romania,ROU,0,0,17,0,17
2010,Bangladesh,BGD,Romania,ROU,0,0,18,0,18
2010,China,CHN,Romania,ROU,0,0,56,24,80
2010,Cameroon,CMR,Romania,ROU,0,0,5,0,5
2010,Dem. Rep. of the Congo,COD,Romania,ROU,0,5,10,0,15
2010,Gambia,GMB,Romania,ROU,0,0,5,0,5
2010,Palestinian,PSE,Romania,ROU,0,0,5,5,10
2010,Georgia,GEO,Romania,ROU,0,0,5,0,5
2010,Ghana,GHA,Romania,ROU,0,0,5,0,5
2010,Guinea,GIN,Romania,ROU,0,0,5,0,5
2010,Cote d'Ivoire,CIV,Romania,ROU,0,0,5,0,5
2010,India,IND,Romania,ROU,0,0,13,5,18
2010,Iran (Islamic Rep. of),IRN,Romania,ROU,5,5,19,5,34
2010,Iraq,IRQ,Romania,ROU,19,0,38,35,92
2010,Jordan,JOR,Romania,ROU,0,0,0,5,5
2010,Sri Lanka,LKA,Romania,ROU,0,0,18,0,18
2010,Rep. of Moldova,MDA,Romania,ROU,0,0,90,28,118
2010,Morocco,MAR,Romania,ROU,0,0,0,5,5
2010,Myanmar,MMR,Romania,ROU,44,0,0,0,44
2010,Nigeria,NGA,Romania,ROU,0,0,19,5,24
2010,Pakistan,PAK,Romania,ROU,0,0,67,5,72
2010,Russian Federation,RUS,Romania,ROU,0,0,10,0,10
2010,Serbia and Kosovo: S/RES/1244 (1999),SRB,Romania,ROU,0,0,10,0,10
2010,Somalia,SOM,Romania,ROU,0,0,5,0,5
2010,Viet Nam,VNM,Romania,ROU,0,0,11,5,16
2010,Syrian Arab Rep.,SYR,Romania,ROU,0,0,17,0,17
2010,Tunisia,TUN,Romania,ROU,0,0,10,0,10
2010,Turkey,TUR,Romania,ROU,0,0,49,17,66
2010,Ukraine,UKR,Romania,ROU,0,0,10,0,10
2010,Stateless,XXA,Romania,ROU,0,0,13,0,13
2010,Central African Rep.,CAF,Sudan,SDN,21,0,0,0,21
2010,Chad,TCD,Sudan,SDN,319,0,0,0,319
2010,Dem. Rep. of the Congo,COD,Sudan,SDN,5,0,0,0,5
2010,Eritrea,ERI,Sudan,SDN,10798,0,243,497,11538
2010,Ethiopia,ETH,Sudan,SDN,216,0,5,5,226
2010,Somalia,SOM,Sudan,SDN,47,0,0,0,47
2010,Uganda,UGA,Sudan,SDN,5,0,0,0,5
2010,Myanmar,MMR,Thailand,THA,5,0,0,0,5
2010,Afghanistan,AFG,Tajikistan,TJK,487,0,174,0,661
2010,Sri Lanka,LKA,Timor-Leste,TLS,0,0,0,5,5
2010,Burundi,BDI,Uganda,UGA,481,0,24,0,505
2010,Chad,TCD,Uganda,UGA,5,0,0,0,5
2010,Dem. Rep. of the Congo,COD,Uganda,UGA,2611,0,10,0,2621
2010,Eritrea,ERI,Uganda,UGA,13,0,136,0,149
2010,Ethiopia,ETH,Uganda,UGA,39,0,284,0,323
2010,Kenya,KEN,Uganda,UGA,5,0,0,0,5
2010,Rwanda,RWA,Uganda,UGA,96,0,124,0,220
2010,Somalia,SOM,Uganda,UGA,2361,0,0,0,2361
2010,Sudan,SDN,Uganda,UGA,36,0,5,0,41
2010,Angola,AGO,Zambia,ZMB,39,0,0,0,39
2010,Burundi,BDI,Zambia,ZMB,59,0,5,0,64
2010,Dem. Rep. of the Congo,COD,Zambia,ZMB,246,0,11,0,257
2010,Rwanda,RWA,Zambia,ZMB,170,0,5,0,175
2010,Somalia,SOM,Zambia,ZMB,5,0,0,0,5
2011,Iraq,IRQ,Albania,ALB,0,0,0,5,5
2011,Serbia and Kosovo: S/RES/1244 (1999),SRB,Albania,ALB,0,0,0,5,5
2011,Burundi,BDI,Angola,AGO,5,0,0,0,5
2011,Central African Rep.,CAF,Angola,AGO,5,0,0,0,5
2011,Chad,TCD,Angola,AGO,43,0,18,0,61
2011,Congo,COG,Angola,AGO,20,0,5,0,25
2011,Eritrea,ERI,Angola,AGO,0,0,5,0,5
2011,Guinea-Bissau,GNB,Angola,AGO,5,0,0,0,5
2011,Guinea,GIN,Angola,AGO,48,0,130,0,178
2011,Cote d'Ivoire,CIV,Angola,AGO,196,0,175,0,371
2011,Liberia,LBR,Angola,AGO,85,0,0,0,85
2011,Mauritania,MRT,Angola,AGO,152,0,0,0,152
2011,Rwanda,RWA,Angola,AGO,10,0,0,0,10
2011,Sierra Leone,SLE,Angola,AGO,194,0,17,0,211
2011,Somalia,SOM,Angola,AGO,178,0,0,0,178
2011,Sudan,SDN,Angola,AGO,122,0,62,0,184
2011,Western Sahara,ESH,Angola,AGO,10,0,0,0,10
2011,Afghanistan,AFG,Austria,AUT,822,887,800,154,2663
2011,Albania,ALB,Austria,AUT,5,5,74,10,94
2011,Algeria,DZA,Austria,AUT,10,0,315,170,495
2011,Angola,AGO,Austria,AUT,5,11,10,0,26
2011,Egypt,EGY,Austria,AUT,10,10,60,26,106
2011,Armenia,ARM,Austria,AUT,30,51,636,26,743
2011,Azerbaijan,AZE,Austria,AUT,13,18,112,10,153
2011,Benin,BEN,Austria,AUT,0,0,10,0,10
2011,Bangladesh,BGD,Austria,AUT,10,10,92,16,128
2011,Burkina Faso,BFA,Austria,AUT,5,0,0,0,5
2011,Belarus,BLR,Austria,AUT,5,0,47,11,63
2011,Bolivia (Plurinational State of),BOL,Austria,AUT,0,0,10,0,10
2011,Bosnia and Herzegovina,BIH,Austria,AUT,5,5,145,12,167
2011,Bulgaria,BGR,Austria,AUT,0,0,10,5,15
2011,China,CHN,Austria,AUT,51,5,279,64,399
2011,Cameroon,CMR,Austria,AUT,18,0,30,5,53
2011,Congo,COG,Austria,AUT,21,0,5,0,26
2011,Dem. Rep. of the Congo,COD,Austria,AUT,21,11,19,11,62
2011,Cuba,CUB,Austria,AUT,0,0,5,0,5
2011,Eritrea,ERI,Austria,AUT,12,0,5,5,22
2011,Ethiopia,ETH,Austria,AUT,11,5,5,5,26
2011,Gabon,GAB,Austria,AUT,0,0,0,5,5
2011,Gambia,GMB,Austria,AUT,10,5,89,20,124
2011,Georgia,GEO,Austria,AUT,11,39,511,62,623
2011,Ghana,GHA,Austria,AUT,0,0,38,0,38
2011,Guinea-Bissau,GNB,Austria,AUT,0,0,12,14,26
2011,Guinea,GIN,Austria,AUT,18,5,31,17,71
2011,Croatia,HRV,Austria,AUT,0,0,5,0,5
2011,Cote d'Ivoire,CIV,Austria,AUT,0,24,33,10,67
2011,India,IND,Austria,AUT,0,5,506,65,576
2011,Iran (Islamic Rep. of),IRN,Austria,AUT,275,11,100,37,423
2011,Iraq,IRQ,Austria,AUT,202,187,269,71,729
2011,Israel,ISR,Austria,AUT,0,0,5,5,10
2011,Jordan,JOR,Austria,AUT,0,0,0,5,5
2011,Kazakhstan,KAZ,Austria,AUT,10,0,37,0,47
2011,Kenya,KEN,Austria,AUT,5,0,14,0,19
2011,Kyrgyzstan,KGZ,Austria,AUT,28,14,64,16,122
2011,Liberia,LBR,Austria,AUT,0,0,26,0,26
2011,Libya,LBY,Austria,AUT,0,5,22,17,44
2011,Lebanon,LBN,Austria,AUT,5,5,54,15,79
2011,Sri Lanka,LKA,Austria,AUT,0,0,12,0,12
2011,Mauritania,MRT,Austria,AUT,0,0,5,0,5
2011,North Macedonia,MKD,Austria,AUT,0,5,213,33,251
2011,Rep. of Moldova,MDA,Austria,AUT,0,10,82,26,118
2011,Mali,MLI,Austria,AUT,0,0,13,10,23
2011,Mongolia,MNG,Austria,AUT,5,23,341,40,409
2011,Morocco,MAR,Austria,AUT,0,0,205,59,264
2011,Montenegro,MNE,Austria,AUT,0,0,10,0,10
2011,Myanmar,MMR,Austria,AUT,5,0,5,0,10
2011,Nepal,NPL,Austria,AUT,0,5,54,10,69
2011,Niger,NER,Austria,AUT,0,0,5,0,5
2011,Nigeria,NGA,Austria,AUT,15,47,774,127,963
2011,Pakistan,PAK,Austria,AUT,5,5,303,110,423
2011,Philippines,PHL,Austria,AUT,0,0,10,0,10
2011,Romania,ROU,Austria,AUT,0,0,19,5,24
2011,South Africa,ZAF,Austria,AUT,0,5,0,0,5
2011,Russian Federation,RUS,Austria,AUT,1016,246,1958,271,3491
2011,Rwanda,RWA,Austria,AUT,0,5,5,0,10
2011,Serbia and Kosovo: S/RES/1244 (1999),SRB,Austria,AUT,57,86,1619,194,1956
2011,Senegal,SEN,Austria,AUT,0,0,10,17,27
2011,Sierra Leone,SLE,Austria,AUT,0,5,24,5,34
2011,Somalia,SOM,Austria,AUT,261,126,51,26,464
2011,Viet Nam,VNM,Austria,AUT,5,0,5,0,10
2011,Sudan,SDN,Austria,AUT,41,10,30,11,92
2011,Slovakia,SVK,Austria,AUT,0,0,5,0,5
2011,Syrian Arab Rep.,SYR,Austria,AUT,360,49,83,25,517
2011,Tajikistan,TJK,Austria,AUT,5,0,10,10,25
2011,Togo,TGO,Austria,AUT,0,0,5,0,5
2011,Tunisia,TUN,Austria,AUT,0,0,137,34,171
2011,Turkey,TUR,Austria,AUT,64,26,701,93,884
2011,Uganda,UGA,Austria,AUT,0,0,5,5,10
2011,Ukraine,UKR,Austria,AUT,11,20,152,19,202
2011,Uzbekistan,UZB,Austria,AUT,10,5,26,5,46
2011,Yemen,YEM,Austria,AUT,0,0,5,0,5
2011,Zimbabwe,ZWE,Austria,AUT,5,0,5,0,10
2011,Stateless,XXA,Austria,AUT,83,22,120,48,273
2011,Dem. Rep. of the Congo,COD,Burundi,BDI,5404,0,5,189,5598
2011,Rwanda,RWA,Burundi,BDI,33,0,0,5,38
2011,Somalia,SOM,Burundi,BDI,5,0,0,0,5
2011,Burundi,BDI,Botswana,BWA,15,0,5,0,20
2011,Dem. Rep. of the Congo,COD,Botswana,BWA,44,0,12,0,56
2011,Ethiopia,ETH,Botswana,BWA,0,0,0,5,5
2011,Namibia,NAM,Botswana,BWA,5,0,0,0,5
2011,Rwanda,RWA,Botswana,BWA,0,0,5,0,5
2011,Somalia,SOM,Botswana,BWA,15,0,5,13,33
2011,Sudan,SDN,Botswana,BWA,0,0,5,0,5
2011,Uganda,UGA,Botswana,BWA,22,0,5,0,27
2011,Zimbabwe,ZWE,Botswana,BWA,50,0,14,0,64
2011,Afghanistan,AFG,Bosnia and Herzegovina,BIH,0,0,0,11,11
2011,Algeria,DZA,Bosnia and Herzegovina,BIH,0,0,0,5,5
2011,Cameroon,CMR,Bosnia and Herzegovina,BIH,0,0,0,5,5
2011,Ethiopia,ETH,Bosnia and Herzegovina,BIH,0,0,0,5,5
2011,Palestinian,PSE,Bosnia and Herzegovina,BIH,0,0,0,5,5
2011,Iran (Islamic Rep. of),IRN,Bosnia and Herzegovina,BIH,0,0,0,5,5
2011,Morocco,MAR,Bosnia and Herzegovina,BIH,0,0,0,5,5
2011,Pakistan,PAK,Bosnia and Herzegovina,BIH,0,0,0,5,5
2011,Serbia and Kosovo: S/RES/1244 (1999),SRB,Bosnia and Herzegovina,BIH,0,5,88,10,103
2011,Afghanistan,AFG,Bulgaria,BGR,0,27,10,13,50
2011,Algeria,DZA,Bulgaria,BGR,0,0,5,11,16
2011,Armenia,ARM,Bulgaria,BGR,0,5,19,0,24
2011,Azerbaijan,AZE,Bulgaria,BGR,0,0,5,0,5
2011,Ethiopia,ETH,Bulgaria,BGR,0,0,0,5,5
2011,Georgia,GEO,Bulgaria,BGR,0,0,0,11,11
2011,Iran (Islamic Rep. of),IRN,Bulgaria,BGR,0,5,14,10,29
2011,Iraq,IRQ,Bulgaria,BGR,5,120,180,127,432
2011,Kyrgyzstan,KGZ,Bulgaria,BGR,0,0,0,5,5
2011,Libya,LBY,Bulgaria,BGR,0,0,0,5,5
2011,Lebanon,LBN,Bulgaria,BGR,0,0,0,5,5
2011,Sri Lanka,LKA,Bulgaria,BGR,0,0,0,5,5
2011,Morocco,MAR,Bulgaria,BGR,0,0,5,14,19
2011,Nigeria,NGA,Bulgaria,BGR,0,0,12,0,12
2011,Pakistan,PAK,Bulgaria,BGR,0,0,5,18,23
2011,Russian Federation,RUS,Bulgaria,BGR,0,0,5,0,5
2011,Somalia,SOM,Bulgaria,BGR,0,0,11,0,11
2011,Sudan,SDN,Bulgaria,BGR,0,0,5,0,5
2011,Syrian Arab Rep.,SYR,Bulgaria,BGR,0,5,43,20,68
2011,Tunisia,TUN,Bulgaria,BGR,0,0,5,5,10
2011,Turkey,TUR,Bulgaria,BGR,0,0,0,5,5
2011,Stateless,XXA,Bulgaria,BGR,0,15,27,35,77
2011,Angola,AGO,Congo,COG,0,0,5,20,25
2011,Burundi,BDI,Congo,COG,0,0,0,5,5
2011,Central African Rep.,CAF,Congo,COG,0,0,0,100,100
2011,Chad,TCD,Congo,COG,0,0,5,97,102
2011,Cameroon,CMR,Congo,COG,0,0,0,5,5
2011,Dem. Rep. of the Congo,COD,Congo,COG,50,0,321,2423,2794
2011,Ethiopia,ETH,Congo,COG,0,0,0,5,5
2011,Guinea,GIN,Congo,COG,0,0,0,5,5
2011,Cote d'Ivoire,CIV,Congo,COG,0,0,0,55,55
2011,Liberia,LBR,Congo,COG,0,0,0,5,5
2011,Mauritania,MRT,Congo,COG,0,0,0,18,18
2011,Rwanda,RWA,Congo,COG,0,0,5,0,5
2011,Sierra Leone,SLE,Congo,COG,0,0,0,5,5
2011,Sudan,SDN,Congo,COG,0,0,0,13,13
2011,Togo,TGO,Congo,COG,0,0,0,5,5
2011,Afghanistan,AFG,Ecuador,ECU,0,0,11,0,11
2011,Argentina,ARG,Ecuador,ECU,0,0,14,0,14
2011,Benin,BEN,Ecuador,ECU,0,0,5,0,5
2011,Bangladesh,BGD,Ecuador,ECU,0,0,30,0,30
2011,Bolivia (Plurinational State of),BOL,Ecuador,ECU,0,0,5,0,5
2011,Botswana,BWA,Ecuador,ECU,0,0,5,0,5
2011,Chile,CHL,Ecuador,ECU,0,0,5,0,5
2011,Cameroon,CMR,Ecuador,ECU,0,0,14,0,14
2011,Colombia,COL,Ecuador,ECU,2652,0,7528,48,10228
2011,Cuba,CUB,Ecuador,ECU,0,0,1122,11,1133
2011,Dominican Rep.,DOM,Ecuador,ECU,0,0,32,0,32
2011,Guinea,GIN,Ecuador,ECU,0,0,5,0,5
2011,Haiti,HTI,Ecuador,ECU,0,0,227,5,232
2011,Cote d'Ivoire,CIV,Ecuador,ECU,0,0,5,0,5
2011,India,IND,Ecuador,ECU,0,0,11,0,11
2011,Iran (Islamic Rep. of),IRN,Ecuador,ECU,0,0,5,0,5
2011,Sri Lanka,LKA,Ecuador,ECU,0,0,13,0,13
2011,Mexico,MEX,Ecuador,ECU,0,0,5,0,5
2011,Mali,MLI,Ecuador,ECU,0,0,5,0,5
2011,Nepal,NPL,Ecuador,ECU,0,0,5,0,5
2011,Nigeria,NGA,Ecuador,ECU,0,0,82,0,82
2011,Pakistan,PAK,Ecuador,ECU,5,0,53,0,58
2011,Peru,PER,Ecuador,ECU,0,0,354,0,354
2011,Sierra Leone,SLE,Ecuador,ECU,0,0,10,0,10
2011,Somalia,SOM,Ecuador,ECU,0,0,5,0,5
2011,Spain,ESP,Ecuador,ECU,0,0,5,0,5
2011,Syrian Arab Rep.,SYR,Ecuador,ECU,5,0,0,0,5
2011,Venezuela (Bolivarian Republic of),VEN,Ecuador,ECU,0,0,15,0,15
2011,Chad,TCD,Gabon,GAB,0,0,0,5,5
2011,Congo,COG,Gabon,GAB,0,0,0,1855,1855
2011,Dem. Rep. of the Congo,COD,Gabon,GAB,0,0,0,12,12
2011,Iran (Islamic Rep. of),IRN,Georgia,GEO,0,0,10,5,15
2011,Nepal,NPL,Georgia,GEO,0,0,5,0,5
2011,Nigeria,NGA,Georgia,GEO,0,0,5,0,5
2011,Russian Federation,RUS,Georgia,GEO,15,0,22,5,42
2011,Uzbekistan,UZB,Georgia,GEO,5,0,0,0,5
2011,Dem. Rep. of the Congo,COD,Guinea,GIN,11,0,0,0,11
2011,Cote d'Ivoire,CIV,Guinea,GIN,124,0,52,136,312
2011,Liberia,LBR,Guinea,GIN,65,0,93,0,158
2011,Rwanda,RWA,Guinea,GIN,5,0,0,0,5
2011,Sierra Leone,SLE,Guinea,GIN,0,0,30,0,30
2011,Togo,TGO,Guinea,GIN,0,0,10,0,10
2011,Afghanistan,AFG,Rep. of Korea,KOR,0,0,11,0,11
2011,Bangladesh,BGD,Rep. of Korea,KOR,5,0,31,5,41
2011,China,CHN,Rep. of Korea,KOR,0,0,0,11,11
2011,Dem. Rep. of the Congo,COD,Rep. of Korea,KOR,5,0,0,0,5
2011,Cote d'Ivoire,CIV,Rep. of Korea,KOR,0,5,27,0,32
2011,Iran (Islamic Rep. of),IRN,Rep. of Korea,KOR,0,0,5,0,5
2011,Kenya,KEN,Rep. of Korea,KOR,0,0,5,0,5
2011,Kyrgyzstan,KGZ,Rep. of Korea,KOR,0,0,48,18,66
2011,Liberia,LBR,Rep. of Korea,KOR,0,0,5,5,10
2011,Sri Lanka,LKA,Rep. of Korea,KOR,0,0,5,0,5
2011,Myanmar,MMR,Rep. of Korea,KOR,20,0,11,5,36
2011,Nigeria,NGA,Rep. of Korea,KOR,0,0,12,0,12
2011,Pakistan,PAK,Rep. of Korea,KOR,0,5,95,31,131
2011,South Africa,ZAF,Rep. of Korea,KOR,0,0,0,5,5
2011,Uganda,UGA,Rep. of Korea,KOR,0,0,10,5,15
2011,Algeria,DZA,Lesotho,LSO,5,0,0,0,5
2011,Afghanistan,AFG,North Macedonia,MKD,0,0,0,249,249
2011,Bosnia and Herzegovina,BIH,North Macedonia,MKD,0,0,0,5,5
2011,Palestinian,PSE,North Macedonia,MKD,0,0,0,27,27
2011,India,IND,North Macedonia,MKD,0,0,0,10,10
2011,Iran (Islamic Rep. of),IRN,North Macedonia,MKD,0,0,0,10,10
2011,Iraq,IRQ,North Macedonia,MKD,0,0,0,10,10
2011,Pakistan,PAK,North Macedonia,MKD,0,0,0,145,145
2011,Serbia and Kosovo: S/RES/1244 (1999),SRB,North Macedonia,MKD,0,0,0,18,18
2011,Somalia,SOM,North Macedonia,MKD,0,0,0,25,25
2011,Sudan,SDN,North Macedonia,MKD,0,0,0,5,5
2011,Afghanistan,AFG,Rep. of Moldova,MDA,0,10,0,0,10
2011,Armenia,ARM,Rep. of Moldova,MDA,0,0,18,0,18
2011,Iraq,IRQ,Rep. of Moldova,MDA,0,0,5,0,5
2011,Kazakhstan,KAZ,Rep. of Moldova,MDA,0,5,0,0,5
2011,Russian Federation,RUS,Rep. of Moldova,MDA,0,0,13,0,13
2011,Syrian Arab Rep.,SYR,Rep. of Moldova,MDA,0,0,5,0,5
2011,Tajikistan,TJK,Rep. of Moldova,MDA,0,0,5,0,5
2011,Turkey,TUR,Rep. of Moldova,MDA,0,0,5,0,5
2011,Ukraine,UKR,Rep. of Moldova,MDA,0,0,12,0,12
2011,Uzbekistan,UZB,Rep. of Moldova,MDA,0,0,5,0,5
2011,Cameroon,CMR,Mexico,MEX,5,0,0,0,5
2011,Dem. Rep. of the Congo,COD,Mexico,MEX,5,0,0,0,5
2011,Colombia,COL,Mexico,MEX,17,0,0,5,22
2011,Cuba,CUB,Mexico,MEX,5,0,0,0,5
2011,Ecuador,ECU,Mexico,MEX,0,0,0,5,5
2011,Ghana,GHA,Mexico,MEX,5,0,0,0,5
2011,Guatemala,GTM,Mexico,MEX,28,10,0,0,38
2011,Haiti,HTI,Mexico,MEX,10,0,0,0,10
2011,Honduras,HND,Mexico,MEX,39,0,0,0,39
2011,Cote d'Ivoire,CIV,Mexico,MEX,5,0,0,0,5
2011,Iran (Islamic Rep. of),IRN,Mexico,MEX,5,0,0,0,5
2011,Sri Lanka,LKA,Mexico,MEX,20,0,0,0,20
2011,Myanmar,MMR,Mexico,MEX,5,0,0,0,5
2011,Nepal,NPL,Mexico,MEX,5,0,0,0,5
2011,Nigeria,NGA,Mexico,MEX,17,0,0,0,17
2011,Peru,PER,Mexico,MEX,0,5,0,0,5
2011,El Salvador,SLV,Mexico,MEX,73,5,0,0,78
2011,Afghanistan,AFG,Montenegro,MNE,0,0,5,5,10
2011,Algeria,DZA,Montenegro,MNE,0,0,41,16,57
2011,Palestinian,PSE,Montenegro,MNE,0,0,5,16,21
2011,Iran (Islamic Rep. of),IRN,Montenegro,MNE,0,0,0,5,5
2011,Libya,LBY,Montenegro,MNE,0,0,5,0,5
2011,Morocco,MAR,Montenegro,MNE,0,0,49,17,66
2011,Pakistan,PAK,Montenegro,MNE,0,0,0,5,5
2011,Tunisia,TUN,Montenegro,MNE,0,0,18,10,28
2011,Turkey,TUR,Montenegro,MNE,0,0,5,0,5
2011,Central African Rep.,CAF,Nigeria,NGA,0,0,0,5,5
2011,Chad,TCD,Nigeria,NGA,0,0,0,12,12
2011,Cameroon,CMR,Nigeria,NGA,0,0,0,30,30
2011,Congo,COG,Nigeria,NGA,0,0,0,5,5
2011,Dem. Rep. of the Congo,COD,Nigeria,NGA,36,0,57,293,386
2011,Eritrea,ERI,Nigeria,NGA,0,0,0,5,5
2011,Cote d'Ivoire,CIV,Nigeria,NGA,0,0,0,5,5
2011,Sudan,SDN,Nigeria,NGA,0,0,0,27,27
2011,Togo,TGO,Nigeria,NGA,0,0,0,5,5
2011,Afghanistan,AFG,Romania,ROU,17,18,58,5,98
2011,Algeria,DZA,Romania,ROU,0,0,435,5,440
2011,Angola,AGO,Romania,ROU,0,0,5,0,5
2011,Egypt,EGY,Romania,ROU,5,0,18,0,23
2011,Armenia,ARM,Romania,ROU,0,0,13,10,23
2011,Azerbaijan,AZE,Romania,ROU,0,0,5,0,5
2011,Bangladesh,BGD,Romania,ROU,0,0,17,0,17
2011,China,CHN,Romania,ROU,0,0,44,33,77
2011,Cameroon,CMR,Romania,ROU,10,0,20,5,35
2011,Dem. Rep. of the Congo,COD,Romania,ROU,0,5,0,5,10
2011,Cuba,CUB,Romania,ROU,0,0,5,0,5
2011,Palestinian,PSE,Romania,ROU,0,5,28,0,33
2011,Georgia,GEO,Romania,ROU,0,0,17,5,22
2011,Guinea,GIN,Romania,ROU,0,0,5,0,5
2011,Cote d'Ivoire,CIV,Romania,ROU,0,0,5,0,5
2011,India,IND,Romania,ROU,0,0,18,0,18
2011,Iran (Islamic Rep. of),IRN,Romania,ROU,5,0,21,21,47
2011,Iraq,IRQ,Romania,ROU,25,0,30,10,65
2011,Libya,LBY,Romania,ROU,0,0,21,0,21
2011,Lebanon,LBN,Romania,ROU,0,0,0,5,5
2011,Rep. of Moldova,MDA,Romania,ROU,0,0,46,19,65
2011,Mexico,MEX,Romania,ROU,0,0,0,5,5
2011,Morocco,MAR,Romania,ROU,0,0,200,10,210
2011,Nepal,NPL,Romania,ROU,0,0,5,0,5
2011,Nigeria,NGA,Romania,ROU,0,0,5,11,16
2011,Pakistan,PAK,Romania,ROU,0,0,97,10,107
2011,Philippines,PHL,Romania,ROU,0,0,0,5,5
2011,Russian Federation,RUS,Romania,ROU,0,0,10,0,10
2011,Serbia and Kosovo: S/RES/1244 (1999),SRB,Romania,ROU,0,0,5,0,5
2011,Senegal,SEN,Romania,ROU,0,0,5,0,5
2011,Somalia,SOM,Romania,ROU,0,0,5,0,5
2011,Viet Nam,VNM,Romania,ROU,0,0,0,5,5
2011,Sudan,SDN,Romania,ROU,5,0,5,0,10
2011,Syrian Arab Rep.,SYR,Romania,ROU,0,0,25,5,30
2011,Tunisia,TUN,Romania,ROU,0,0,199,10,209
2011,Turkey,TUR,Romania,ROU,0,5,23,5,33
2011,Ukraine,UKR,Romania,ROU,0,0,5,0,5
2011,Stateless,XXA,Romania,ROU,0,0,10,0,10
2011,Chad,TCD,Sudan,SDN,207,0,5,0,212
2011,Eritrea,ERI,Sudan,SDN,8653,0,142,30,8825
2011,Ethiopia,ETH,Sudan,SDN,157,0,5,5,167
2011,Guinea,GIN,Sudan,SDN,0,0,22,5,27
2011,Cote d'Ivoire,CIV,Sudan,SDN,0,0,41,5,46
2011,Liberia,LBR,Sudan,SDN,0,0,92,64,156
2011,Niger,NER,Sudan,SDN,0,0,5,0,5
2011,Sierra Leone,SLE,Sudan,SDN,0,0,12,0,12
2011,Somalia,SOM,Sudan,SDN,40,0,0,15,55
2011,Myanmar,MMR,Thailand,THA,0,0,0,8461,8461
2011,Afghanistan,AFG,Tajikistan,TJK,218,0,80,0,298
2011,Kyrgyzstan,KGZ,Tajikistan,TJK,47,0,0,0,47
2011,Burundi,BDI,Uganda,UGA,1684,0,14,0,1698
2011,Dem. Rep. of the Congo,COD,Uganda,UGA,2585,0,0,0,2585
2011,Eritrea,ERI,Uganda,UGA,5,0,826,0,831
2011,Ethiopia,ETH,Uganda,UGA,10,0,685,0,695
2011,Kenya,KEN,Uganda,UGA,5,0,0,0,5
2011,Pakistan,PAK,Uganda,UGA,0,0,17,0,17
2011,Rwanda,RWA,Uganda,UGA,43,0,921,0,964
2011,Somalia,SOM,Uganda,UGA,3173,0,0,0,3173
2011,Sudan,SDN,Uganda,UGA,64,0,16,0,80
2011,Afghanistan,AFG,Ukraine,UKR,110,0,73,90,273
2011,Algeria,DZA,Ukraine,UKR,0,0,5,0,5
2011,Egypt,EGY,Ukraine,UKR,0,0,0,5,5
2011,Azerbaijan,AZE,Ukraine,UKR,0,0,0,10,10
2011,Bangladesh,BGD,Ukraine,UKR,0,0,0,5,5
2011,Cameroon,CMR,Ukraine,UKR,0,0,5,5,10
2011,Dem. Rep. of the Congo,COD,Ukraine,UKR,0,0,11,5,16
2011,Palestinian,PSE,Ukraine,UKR,13,0,5,5,23
2011,Georgia,GEO,Ukraine,UKR,0,0,11,0,11
2011,Guinea,GIN,Ukraine,UKR,0,0,18,5,23
2011,Cote d'Ivoire,CIV,Ukraine,UKR,0,0,0,5,5
2011,India,IND,Ukraine,UKR,0,0,0,5,5
2011,Iran (Islamic Rep. of),IRN,Ukraine,UKR,0,0,5,0,5
2011,Iraq,IRQ,Ukraine,UKR,0,0,0,5,5
2011,Kyrgyzstan,KGZ,Ukraine,UKR,0,0,138,75,213
2011,Sri Lanka,LKA,Ukraine,UKR,5,0,0,5,10
2011,Nigeria,NGA,Ukraine,UKR,0,0,0,5,5
2011,Pakistan,PAK,Ukraine,UKR,0,0,0,14,14
2011,Russian Federation,RUS,Ukraine,UKR,0,0,0,16,16
2011,Somalia,SOM,Ukraine,UKR,5,0,50,80,135
2011,Syrian Arab Rep.,SYR,Ukraine,UKR,0,0,13,13,26
2011,Tajikistan,TJK,Ukraine,UKR,0,0,0,5,5
2011,Tunisia,TUN,Ukraine,UKR,0,0,0,5,5
2011,Turkey,TUR,Ukraine,UKR,5,0,0,0,5
2011,Uzbekistan,UZB,Ukraine,UKR,0,0,11,0,11
2011,Stateless,XXA,Ukraine,UKR,0,0,0,5,5
2012,Serbia and Kosovo: S/RES/1244 (1999),SRB,Albania,ALB,5,0,0,0,5
2012,Somalia,SOM,Albania,ALB,0,0,0,5,5
2012,Afghanistan,AFG,Austria,AUT,969,816,1034,321,3140
2012,Albania,ALB,Austria,AUT,5,0,41,5,51
2012,Algeria,DZA,Austria,AUT,0,10,621,54,685
2012,Angola,AGO,Austria,AUT,5,0,11,0,16
2012,Egypt,EGY,Austria,AUT,15,10,83,17,125
2012,Armenia,ARM,Austria,AUT,19,35,245,13,312
2012,Azerbaijan,AZE,Austria,AUT,10,10,71,5,96
2012,Bangladesh,BGD,Austria,AUT,5,5,120,32,162
2012,Belarus,BLR,Austria,AUT,5,5,38,11,59
2012,Bosnia and Herzegovina,BIH,Austria,AUT,0,10,120,20,150
2012,Chad,TCD,Austria,AUT,0,0,5,0,5
2012,China,CHN,Austria,AUT,43,5,223,58,329
2012,Cameroon,CMR,Austria,AUT,23,0,20,5,48
2012,Congo,COG,Austria,AUT,14,0,0,0,14
2012,Dem. Rep. of the Congo,COD,Austria,AUT,33,10,5,5,53
2012,Eritrea,ERI,Austria,AUT,12,0,5,5,22
2012,Ethiopia,ETH,Austria,AUT,11,0,0,0,11
2012,Gabon,GAB,Austria,AUT,0,0,5,0,5
2012,Gambia,GMB,Austria,AUT,11,0,55,14,80
2012,Georgia,GEO,Austria,AUT,27,31,321,37,416
2012,Ghana,GHA,Austria,AUT,0,5,42,0,47
2012,Guinea-Bissau,GNB,Austria,AUT,0,0,15,11,26
2012,Guinea,GIN,Austria,AUT,5,5,26,10,46
2012,Croatia,HRV,Austria,AUT,0,5,0,0,5
2012,Cote d'Ivoire,CIV,Austria,AUT,0,0,14,0,14
2012,India,IND,Austria,AUT,0,0,326,56,382
2012,Iran (Islamic Rep. of),IRN,Austria,AUT,442,25,104,51,622
2012,Iraq,IRQ,Austria,AUT,161,197,362,47,767
2012,Israel,ISR,Austria,AUT,0,0,0,5,5
2012,Jordan,JOR,Austria,AUT,0,0,0,12,12
2012,Kazakhstan,KAZ,Austria,AUT,5,5,10,10,30
2012,Kenya,KEN,Austria,AUT,5,0,5,0,10
2012,Kyrgyzstan,KGZ,Austria,AUT,10,5,42,10,67
2012,Liberia,LBR,Austria,AUT,0,0,15,5,20
2012,Libya,LBY,Austria,AUT,0,0,25,11,36
2012,Lebanon,LBN,Austria,AUT,0,5,53,10,68
2012,Sri Lanka,LKA,Austria,AUT,0,0,10,11,21
2012,Mauritania,MRT,Austria,AUT,0,0,5,5,10
2012,North Macedonia,MKD,Austria,AUT,0,0,144,25,169
2012,Rep. of Moldova,MDA,Austria,AUT,0,0,34,16,50
2012,Mali,MLI,Austria,AUT,5,0,10,10,25
2012,Mongolia,MNG,Austria,AUT,5,15,208,34,262
2012,Morocco,MAR,Austria,AUT,0,0,302,62,364
2012,Montenegro,MNE,Austria,AUT,0,0,17,0,17
2012,Myanmar,MMR,Austria,AUT,5,0,0,0,5
2012,Nepal,NPL,Austria,AUT,0,0,59,5,64
2012,Niger,NER,Austria,AUT,0,0,0,5,5
2012,Nigeria,NGA,Austria,AUT,13,20,428,131,592
2012,Pakistan,PAK,Austria,AUT,14,10,1456,194,1674
2012,Romania,ROU,Austria,AUT,0,0,12,0,12
2012,Russian Federation,RUS,Austria,AUT,839,241,1999,245,3324
2012,Serbia and Kosovo: S/RES/1244 (1999),SRB,Austria,AUT,32,34,971,75,1112
2012,Senegal,SEN,Austria,AUT,0,0,19,15,34
2012,Sierra Leone,SLE,Austria,AUT,0,0,20,5,25
2012,Somalia,SOM,Austria,AUT,241,216,108,36,601
2012,Viet Nam,VNM,Austria,AUT,0,0,13,0,13
2012,Sudan,SDN,Austria,AUT,22,0,20,15,57
2012,Syrian Arab Rep.,SYR,Austria,AUT,542,239,100,22,903
2012,Tajikistan,TJK,Austria,AUT,13,5,0,5,23
2012,Timor-Leste,TLS,Austria,AUT,0,0,5,0,5
2012,Togo,TGO,Austria,AUT,0,0,5,0,5
2012,Tunisia,TUN,Austria,AUT,0,0,155,22,177
2012,Turkey,TUR,Austria,AUT,33,15,337,48,433
2012,Uganda,UGA,Austria,AUT,0,0,11,0,11
2012,Ukraine,UKR,Austria,AUT,10,0,55,10,75
2012,Uzbekistan,UZB,Austria,AUT,5,0,36,5,46
2012,Yemen,YEM,Austria,AUT,5,0,0,0,5
2012,Zimbabwe,ZWE,Austria,AUT,0,0,5,0,5
2012,Stateless,XXA,Austria,AUT,48,48,104,18,218
2012,Dem. Rep. of the Congo,COD,Burundi,BDI,6393,0,65,5464,11922
2012,Rwanda,RWA,Burundi,BDI,27,0,0,260,287
2012,Somalia,SOM,Burundi,BDI,0,0,0,16,16
2012,Algeria,DZA,Bosnia and Herzegovina,BIH,0,0,0,5,5
2012,Eritrea,ERI,Bosnia and Herzegovina,BIH,0,5,0,0,5
2012,Serbia and Kosovo: S/RES/1244 (1999),SRB,Bosnia and Herzegovina,BIH,0,0,28,0,28
2012,Syrian Arab Rep.,SYR,Bosnia and Herzegovina,BIH,0,0,0,11,11
2012,Afghanistan,AFG,Bulgaria,BGR,5,10,31,25,71
2012,Algeria,DZA,Bulgaria,BGR,0,0,5,13,18
2012,Egypt,EGY,Bulgaria,BGR,0,0,0,5,5
2012,Armenia,ARM,Bulgaria,BGR,0,0,23,0,23
2012,Azerbaijan,AZE,Bulgaria,BGR,0,0,5,0,5
2012,Bangladesh,BGD,Bulgaria,BGR,0,5,0,0,5
2012,Bosnia and Herzegovina,BIH,Bulgaria,BGR,0,0,5,0,5
2012,China,CHN,Bulgaria,BGR,0,0,5,0,5
2012,Cameroon,CMR,Bulgaria,BGR,0,0,5,0,5
2012,Georgia,GEO,Bulgaria,BGR,0,0,0,10,10
2012,Ghana,GHA,Bulgaria,BGR,0,0,5,0,5
2012,Iran (Islamic Rep. of),IRN,Bulgaria,BGR,0,0,36,10,46
2012,Iraq,IRQ,Bulgaria,BGR,5,67,173,70,315
2012,Kyrgyzstan,KGZ,Bulgaria,BGR,0,0,5,0,5
2012,Libya,LBY,Bulgaria,BGR,0,0,0,5,5
2012,Lebanon,LBN,Bulgaria,BGR,0,0,5,0,5
2012,Morocco,MAR,Bulgaria,BGR,0,0,5,15,20
2012,Nigeria,NGA,Bulgaria,BGR,0,0,5,5,10
2012,Pakistan,PAK,Bulgaria,BGR,0,0,25,5,30
2012,Russian Federation,RUS,Bulgaria,BGR,0,0,5,0,5
2012,Somalia,SOM,Bulgaria,BGR,0,10,15,0,25
2012,Sudan,SDN,Bulgaria,BGR,0,0,5,0,5
2012,Syrian Arab Rep.,SYR,Bulgaria,BGR,0,57,27,52,136
2012,Tunisia,TUN,Bulgaria,BGR,0,0,5,5,10
2012,Turkey,TUR,Bulgaria,BGR,0,0,5,0,5
2012,Ukraine,UKR,Bulgaria,BGR,0,0,0,5,5
2012,Uzbekistan,UZB,Bulgaria,BGR,0,0,0,5,5
2012,Stateless,XXA,Bulgaria,BGR,5,14,44,22,85
2012,Central African Rep.,CAF,Chad,TCD,1585,0,0,0,1585
2012,Dem. Rep. of the Congo,COD,Chad,TCD,39,0,0,5,44
2012,Eritrea,ERI,Chad,TCD,35,0,0,0,35
2012,Cote d'Ivoire,CIV,Chad,TCD,5,0,0,0,5
2012,Somalia,SOM,Chad,TCD,5,0,0,0,5
2012,Sudan,SDN,Chad,TCD,2289,0,0,0,2289
2012,Angola,AGO,Congo,COG,0,0,0,19,19
2012,Central African Rep.,CAF,Congo,COG,0,0,0,14,14
2012,Dem. Rep. of the Congo,COD,Congo,COG,17,0,44,40,101
2012,Mauritania,MRT,Congo,COG,0,0,5,0,5
2012,Rwanda,RWA,Congo,COG,0,0,0,5,5
2012,Afghanistan,AFG,Ecuador,ECU,0,0,5,0,5
2012,Argentina,ARG,Ecuador,ECU,0,0,5,0,5
2012,Bangladesh,BGD,Ecuador,ECU,0,0,32,0,32
2012,Bhutan,BTN,Ecuador,ECU,0,0,22,0,22
2012,Bolivia (Plurinational State of),BOL,Ecuador,ECU,0,0,10,0,10
2012,Brazil,BRA,Ecuador,ECU,5,0,5,0,10
2012,Chile,CHL,Ecuador,ECU,0,0,5,0,5
2012,Cameroon,CMR,Ecuador,ECU,0,0,5,0,5
2012,Colombia,COL,Ecuador,ECU,1515,0,14661,0,16176
2012,Cuba,CUB,Ecuador,ECU,0,0,198,0,198
2012,Dominican Rep.,DOM,Ecuador,ECU,0,0,13,0,13
2012,Guatemala,GTM,Ecuador,ECU,0,0,5,0,5
2012,Haiti,HTI,Ecuador,ECU,0,0,98,0,98
2012,India,IND,Ecuador,ECU,0,0,20,0,20
2012,Iran (Islamic Rep. of),IRN,Ecuador,ECU,0,0,10,0,10
2012,Sri Lanka,LKA,Ecuador,ECU,0,0,5,0,5
2012,Mexico,MEX,Ecuador,ECU,0,0,5,0,5
2012,Nepal,NPL,Ecuador,ECU,0,0,10,0,10
2012,Nigeria,NGA,Ecuador,ECU,5,0,29,0,34
2012,Pakistan,PAK,Ecuador,ECU,0,0,50,0,50
2012,Peru,PER,Ecuador,ECU,0,0,162,0,162
2012,Russian Federation,RUS,Ecuador,ECU,10,0,5,0,15
2012,Sierra Leone,SLE,Ecuador,ECU,0,0,5,0,5
2012,Spain,ESP,Ecuador,ECU,0,0,5,0,5
2012,Syrian Arab Rep.,SYR,Ecuador,ECU,0,0,5,0,5
2012,United States of America,USA,Ecuador,ECU,0,0,5,0,5
2012,Venezuela (Bolivarian Republic of),VEN,Ecuador,ECU,5,0,5,0,10
2012,Western Sahara,ESH,Ecuador,ECU,0,0,5,0,5
2012,Dem. Rep. of the Congo,COD,Gabon,GAB,0,0,0,19,19
2012,Egypt,EGY,Georgia,GEO,0,0,0,5,5
2012,Armenia,ARM,Georgia,GEO,5,0,0,5,10
2012,Iran (Islamic Rep. of),IRN,Georgia,GEO,0,0,30,16,46
2012,Iraq,IRQ,Georgia,GEO,5,10,36,17,68
2012,Kyrgyzstan,KGZ,Georgia,GEO,5,0,0,0,5
2012,Sri Lanka,LKA,Georgia,GEO,5,0,0,0,5
2012,Nigeria,NGA,Georgia,GEO,0,0,5,0,5
2012,Russian Federation,RUS,Georgia,GEO,10,0,0,10,20
2012,Dem. Rep. of the Congo,COD,Guinea,GIN,5,0,0,0,5
2012,Cote d'Ivoire,CIV,Guinea,GIN,10,0,10,0,20
2012,Liberia,LBR,Guinea,GIN,11,0,118,0,129
2012,Mali,MLI,Guinea,GIN,0,41,0,0,41
2012,Sierra Leone,SLE,Guinea,GIN,0,0,10,0,10
2012,Togo,TGO,Guinea,GIN,10,0,0,0,10
2012,Afghanistan,AFG,Rep. of Korea,KOR,0,0,23,24,47
2012,Bangladesh,BGD,Rep. of Korea,KOR,16,0,5,10,23
2012,China,CHN,Rep. of Korea,KOR,0,0,0,13,13
2012,Cameroon,CMR,Rep. of Korea,KOR,0,0,0,12,12
2012,Congo,COG,Rep. of Korea,KOR,0,5,0,0,5
2012,Dem. Rep. of the Congo,COD,Rep. of Korea,KOR,5,0,13,0,18
2012,Ethiopia,ETH,Rep. of Korea,KOR,5,0,0,5,10
2012,Guinea,GIN,Rep. of Korea,KOR,0,0,0,5,5
2012,Cote d'Ivoire,CIV,Rep. of Korea,KOR,0,5,0,0,5
2012,India,IND,Rep. of Korea,KOR,0,0,5,17,22
2012,Iran (Islamic Rep. of),IRN,Rep. of Korea,KOR,5,0,0,0,5
2012,Kyrgyzstan,KGZ,Rep. of Korea,KOR,0,0,10,5,15
2012,Liberia,LBR,Rep. of Korea,KOR,0,0,0,13,13
2012,Sri Lanka,LKA,Rep. of Korea,KOR,0,0,104,74,178
2012,Mali,MLI,Rep. of Korea,KOR,0,0,5,0,5
2012,Mongolia,MNG,Rep. of Korea,KOR,0,0,0,5,5
2012,Myanmar,MMR,Rep. of Korea,KOR,18,10,22,18,68
2012,Nepal,NPL,Rep. of Korea,KOR,0,0,0,11,11
2012,Nigeria,NGA,Rep. of Korea,KOR,0,0,5,17,22
2012,Pakistan,PAK,Rep. of Korea,KOR,0,0,151,144,295
2012,Russian Federation,RUS,Rep. of Korea,KOR,5,0,0,0,5
2012,Sudan,SDN,Rep. of Korea,KOR,0,0,5,0,5
2012,Uganda,UGA,Rep. of Korea,KOR,0,0,10,30,40
2012,Uzbekistan,UZB,Rep. of Korea,KOR,0,0,5,0,5
2012,Afghanistan,AFG,North Macedonia,MKD,0,0,0,234,234
2012,Algeria,DZA,North Macedonia,MKD,0,0,0,15,15
2012,Egypt,EGY,North Macedonia,MKD,0,0,0,5,5
2012,Bangladesh,BGD,North Macedonia,MKD,0,0,0,5,5
2012,Eritrea,ERI,North Macedonia,MKD,0,0,0,5,5
2012,Palestinian,PSE,North Macedonia,MKD,0,0,0,10,10
2012,Iran (Islamic Rep. of),IRN,North Macedonia,MKD,0,0,0,5,5
2012,Morocco,MAR,North Macedonia,MKD,0,0,0,23,23
2012,Pakistan,PAK,North Macedonia,MKD,0,0,0,113,113
2012,Serbia and Kosovo: S/RES/1244 (1999),SRB,North Macedonia,MKD,0,0,0,13,13
2012,Somalia,SOM,North Macedonia,MKD,0,0,0,70,70
2012,Sudan,SDN,North Macedonia,MKD,0,0,0,5,5
2012,Syrian Arab Rep.,SYR,North Macedonia,MKD,0,0,0,5,5
2012,Tunisia,TUN,North Macedonia,MKD,0,0,0,5,5
2012,Afghanistan,AFG,Montenegro,MNE,0,0,82,37,119
2012,Algeria,DZA,Montenegro,MNE,0,0,578,272,850
2012,Egypt,EGY,Montenegro,MNE,0,0,0,5,5
2012,Bangladesh,BGD,Montenegro,MNE,0,0,5,0,5
2012,Palestinian,PSE,Montenegro,MNE,0,0,0,5,5
2012,India,IND,Montenegro,MNE,0,0,10,0,10
2012,Iran (Islamic Rep. of),IRN,Montenegro,MNE,0,0,5,5,10
2012,Libya,LBY,Montenegro,MNE,0,0,5,0,5
2012,Morocco,MAR,Montenegro,MNE,0,0,95,39,134
2012,Nigeria,NGA,Montenegro,MNE,0,0,5,0,5
2012,Pakistan,PAK,Montenegro,MNE,0,0,73,25,98
2012,Syrian Arab Rep.,SYR,Montenegro,MNE,0,0,21,16,37
2012,Tunisia,TUN,Montenegro,MNE,0,0,99,61,160
2012,Egypt,EGY,Nigeria,NGA,5,0,0,0,5
2012,Chad,TCD,Nigeria,NGA,5,0,22,74,101
2012,Cameroon,CMR,Nigeria,NGA,0,0,0,5,5
2012,Congo,COG,Nigeria,NGA,0,0,0,5,5
2012,Dem. Rep. of the Congo,COD,Nigeria,NGA,77,0,103,237,417
2012,Eritrea,ERI,Nigeria,NGA,5,0,0,0,5
2012,Guinea,GIN,Nigeria,NGA,0,0,0,10,10
2012,Cote d'Ivoire,CIV,Nigeria,NGA,111,0,0,0,111
2012,Liberia,LBR,Nigeria,NGA,0,0,0,21,21
2012,Mali,MLI,Nigeria,NGA,10,0,0,0,10
2012,Sudan,SDN,Nigeria,NGA,0,0,0,5,5
2012,Togo,TGO,Nigeria,NGA,5,0,0,0,5
2012,Afghanistan,AFG,Romania,ROU,23,11,174,10,218
2012,Algeria,DZA,Romania,ROU,0,0,601,27,628
2012,Angola,AGO,Romania,ROU,0,0,5,0,5
2012,Egypt,EGY,Romania,ROU,5,0,33,12,50
2012,Bangladesh,BGD,Romania,ROU,0,0,60,0,60
2012,Burkina Faso,BFA,Romania,ROU,0,0,5,0,5
2012,China,CHN,Romania,ROU,0,0,26,18,44
2012,Cameroon,CMR,Romania,ROU,5,0,16,5,26
2012,Dem. Rep. of the Congo,COD,Romania,ROU,0,5,5,0,10
2012,Cuba,CUB,Romania,ROU,5,0,0,0,5
2012,Eritrea,ERI,Romania,ROU,11,5,0,0,16
2012,Ethiopia,ETH,Romania,ROU,0,0,5,0,5
2012,Palestinian,PSE,Romania,ROU,12,5,55,5,77
2012,Georgia,GEO,Romania,ROU,0,0,5,0,5
2012,Guinea,GIN,Romania,ROU,0,0,0,5,5
2012,India,IND,Romania,ROU,0,0,20,0,20
2012,Iran (Islamic Rep. of),IRN,Romania,ROU,10,5,15,0,30
2012,Iraq,IRQ,Romania,ROU,15,10,23,5,53
2012,Jordan,JOR,Romania,ROU,0,0,0,5,5
2012,Libya,LBY,Romania,ROU,0,0,19,0,19
2012,Lebanon,LBN,Romania,ROU,0,0,0,12,12
2012,Sri Lanka,LKA,Romania,ROU,0,0,5,0,5
2012,Mauritania,MRT,Romania,ROU,0,0,5,0,5
2012,Rep. of Moldova,MDA,Romania,ROU,0,0,30,13,43
2012,Morocco,MAR,Romania,ROU,0,0,355,13,368
2012,Nepal,NPL,Romania,ROU,0,0,5,0,5
2012,Nigeria,NGA,Romania,ROU,0,0,29,5,34
2012,Pakistan,PAK,Romania,ROU,0,5,316,5,326
2012,Philippines,PHL,Romania,ROU,0,0,14,0,14
2012,Serbia and Kosovo: S/RES/1244 (1999),SRB,Romania,ROU,0,0,14,0,14
2012,Senegal,SEN,Romania,ROU,0,0,5,0,5
2012,Somalia,SOM,Romania,ROU,10,5,24,0,39
2012,Viet Nam,VNM,Romania,ROU,0,0,0,5,5
2012,Sudan,SDN,Romania,ROU,0,0,16,0,16
2012,Syrian Arab Rep.,SYR,Romania,ROU,63,68,75,5,211
2012,Tunisia,TUN,Romania,ROU,0,0,95,10,105
2012,Turkey,TUR,Romania,ROU,0,0,17,5,22
2012,Yemen,YEM,Romania,ROU,0,0,10,0,10
2012,Stateless,XXA,Romania,ROU,5,0,0,0,5
2012,Myanmar,MMR,Thailand,THA,0,0,0,67,67
2012,Afghanistan,AFG,Tajikistan,TJK,410,0,118,0,528
2012,Kyrgyzstan,KGZ,Tajikistan,TJK,47,0,0,0,47
2012,Burundi,BDI,Uganda,UGA,1843,0,596,0,2439
2012,Dem. Rep. of the Congo,COD,Uganda,UGA,3779,0,150,0,3929
2012,Eritrea,ERI,Uganda,UGA,22,0,193,0,215
2012,Ethiopia,ETH,Uganda,UGA,52,0,108,0,160
2012,Kenya,KEN,Uganda,UGA,5,0,14,0,19
2012,Pakistan,PAK,Uganda,UGA,11,0,11,0,22
2012,Rwanda,RWA,Uganda,UGA,146,0,157,0,303
2012,Somalia,SOM,Uganda,UGA,1900,0,5,0,1905
2012,Sudan,SDN,Uganda,UGA,796,0,26,0,822
2013,Afghanistan,AFG,Austria,AUT,1259,828,885,317,3289
2013,Albania,ALB,Austria,AUT,0,5,28,5,38
2013,Algeria,DZA,Austria,AUT,0,0,708,119,827
2013,Angola,AGO,Austria,AUT,5,0,5,0,10
2013,Egypt,EGY,Austria,AUT,10,5,107,18,140
2013,Armenia,ARM,Austria,AUT,12,38,296,17,363
2013,Azerbaijan,AZE,Austria,AUT,15,5,92,12,124
2013,Benin,BEN,Austria,AUT,0,0,5,0,5
2013,Bangladesh,BGD,Austria,AUT,19,14,181,28,242
2013,Burkina Faso,BFA,Austria,AUT,0,0,12,0,12
2013,Belarus,BLR,Austria,AUT,5,0,12,10,27
2013,Bosnia and Herzegovina,BIH,Austria,AUT,0,5,63,33,101
2013,Chad,TCD,Austria,AUT,0,0,5,0,5
2013,China,CHN,Austria,AUT,66,5,115,46,232
2013,Cameroon,CMR,Austria,AUT,27,0,14,0,41
2013,Congo,COG,Austria,AUT,10,0,11,0,21
2013,Dem. Rep. of the Congo,COD,Austria,AUT,26,5,14,0,45
2013,Cuba,CUB,Austria,AUT,0,0,11,5,16
2013,Eritrea,ERI,Austria,AUT,15,0,5,5,25
2013,Ethiopia,ETH,Austria,AUT,0,0,14,0,14
2013,Gambia,GMB,Austria,AUT,10,5,35,13,63
2013,Georgia,GEO,Austria,AUT,5,25,208,41,279
2013,Germany,DEU,Austria,AUT,0,0,0,5,5
2013,Ghana,GHA,Austria,AUT,0,5,29,0,34
2013,Guinea-Bissau,GNB,Austria,AUT,0,0,10,10,20
2013,Guinea,GIN,Austria,AUT,12,5,29,5,51
2013,Croatia,HRV,Austria,AUT,0,0,13,0,13
2013,Cote d'Ivoire,CIV,Austria,AUT,0,0,16,0,16
2013,India,IND,Austria,AUT,0,5,386,45,436
2013,Iran (Islamic Rep. of),IRN,Austria,AUT,520,16,136,28,700
2013,Iraq,IRQ,Austria,AUT,121,125,333,59,638
2013,Israel,ISR,Austria,AUT,0,0,10,0,10
2013,Jordan,JOR,Austria,AUT,5,0,5,0,10
2013,Kazakhstan,KAZ,Austria,AUT,5,5,30,0,40
2013,Kenya,KEN,Austria,AUT,5,0,0,5,10
2013,Kyrgyzstan,KGZ,Austria,AUT,5,12,53,10,80
2013,Liberia,LBR,Austria,AUT,0,0,22,0,22
2013,Libya,LBY,Austria,AUT,0,0,20,10,30
2013,Lebanon,LBN,Austria,AUT,5,0,25,5,35
2013,Sri Lanka,LKA,Austria,AUT,0,0,16,19,35
2013,Mauritania,MRT,Austria,AUT,0,0,33,5,38
2013,North Macedonia,MKD,Austria,AUT,0,0,121,16,137
2013,Rep. of Moldova,MDA,Austria,AUT,0,0,23,20,43
2013,Mali,MLI,Austria,AUT,0,5,22,5,32
2013,Mongolia,MNG,Austria,AUT,0,5,118,24,147
2013,Morocco,MAR,Austria,AUT,0,0,392,81,473
2013,Montenegro,MNE,Austria,AUT,0,0,10,0,10
2013,Myanmar,MMR,Austria,AUT,12,0,0,0,12
2013,Nepal,NPL,Austria,AUT,0,0,33,5,38
2013,Niger,NER,Austria,AUT,0,0,5,0,5
2013,Nigeria,NGA,Austria,AUT,10,24,653,90,777
2013,Pakistan,PAK,Austria,AUT,28,10,1387,156,1581
2013,Poland,POL,Austria,AUT,0,0,5,0,5
2013,Romania,ROU,Austria,AUT,0,0,0,5,5
2013,Russian Federation,RUS,Austria,AUT,673,175,1595,389,2832
2013,Rwanda,RWA,Austria,AUT,0,0,5,0,5
2013,El Salvador,SLV,Austria,AUT,0,0,5,0,5
2013,Serbia and Kosovo: S/RES/1244 (1999),SRB,Austria,AUT,29,43,988,190,1250
2013,Senegal,SEN,Austria,AUT,0,0,29,10,39
2013,Sierra Leone,SLE,Austria,AUT,5,0,25,0,30
2013,Somalia,SOM,Austria,AUT,254,133,105,49,541
2013,Viet Nam,VNM,Austria,AUT,0,0,11,14,25
2013,Sudan,SDN,Austria,AUT,30,0,14,10,54
2013,South Sudan,SSD,Austria,AUT,0,0,12,0,12
2013,Slovakia,SVK,Austria,AUT,0,0,5,0,5
2013,Syrian Arab Rep.,SYR,Austria,AUT,838,253,189,70,1350
2013,Tajikistan,TJK,Austria,AUT,10,5,13,5,33
2013,Turkmenistan,TKM,Austria,AUT,5,0,0,0,5
2013,Tunisia,TUN,Austria,AUT,0,0,162,44,206
2013,Turkey,TUR,Austria,AUT,35,5,256,56,352
2013,Uganda,UGA,Austria,AUT,5,0,0,0,5
2013,Ukraine,UKR,Austria,AUT,0,10,68,10,88
2013,Uzbekistan,UZB,Austria,AUT,5,5,23,0,33
2013,Western Sahara,ESH,Austria,AUT,0,0,5,5,10
2013,Yemen,YEM,Austria,AUT,0,0,5,0,5
2013,Zimbabwe,ZWE,Austria,AUT,0,0,0,5,5
2013,Stateless,XXA,Austria,AUT,32,25,77,15,149
2013,Angola,AGO,Burundi,BDI,0,0,0,10,10
2013,Central African Rep.,CAF,Burundi,BDI,0,0,0,5,5
2013,Dem. Rep. of the Congo,COD,Burundi,BDI,7319,0,5,2713,10037
2013,Rwanda,RWA,Burundi,BDI,21,0,5,202,228
2013,Somalia,SOM,Burundi,BDI,0,0,0,10,10
2013,Central African Rep.,CAF,Chad,TCD,62,0,0,0,62
2013,Dem. Rep. of the Congo,COD,Chad,TCD,42,0,0,0,42
2013,Eritrea,ERI,Chad,TCD,5,0,0,0,5
2013,Rwanda,RWA,Chad,TCD,5,0,0,0,5
2013,Sudan,SDN,Chad,TCD,45,0,0,0,45
2013,Syrian Arab Rep.,SYR,Chad,TCD,11,0,0,0,11
2013,Central African Rep.,CAF,Congo,COG,0,0,0,23,23
2013,Chad,TCD,Congo,COG,12,0,0,12,24
2013,Dem. Rep. of the Congo,COD,Congo,COG,63,0,0,805,868
2013,Cote d'Ivoire,CIV,Congo,COG,0,0,0,33,33
2013,Mauritania,MRT,Congo,COG,0,0,0,5,5
2013,Rwanda,RWA,Congo,COG,21,0,0,12,33
2013,Sierra Leone,SLE,Congo,COG,0,0,0,5,5
2013,Sudan,SDN,Congo,COG,0,0,0,5,5
2013,Bangladesh,BGD,Ecuador,ECU,0,0,0,5,5
2013,Bolivia (Plurinational State of),BOL,Ecuador,ECU,0,0,5,0,5
2013,Chile,CHL,Ecuador,ECU,0,0,5,0,5
2013,Congo,COG,Ecuador,ECU,0,0,5,0,5
2013,Colombia,COL,Ecuador,ECU,509,0,7947,2075,10531
2013,Costa Rica,CRI,Ecuador,ECU,0,0,5,0,5
2013,Cuba,CUB,Ecuador,ECU,0,0,45,23,68
2013,Dominican Rep.,DOM,Ecuador,ECU,0,0,14,5,19
2013,Haiti,HTI,Ecuador,ECU,0,0,38,0,38
2013,India,IND,Ecuador,ECU,0,0,5,0,5
2013,Iran (Islamic Rep. of),IRN,Ecuador,ECU,0,0,5,0,5
2013,Sri Lanka,LKA,Ecuador,ECU,0,0,0,5,5
2013,Nigeria,NGA,Ecuador,ECU,0,0,5,5,10
2013,Pakistan,PAK,Ecuador,ECU,0,0,10,5,15
2013,Peru,PER,Ecuador,ECU,0,0,25,10,35
2013,Russian Federation,RUS,Ecuador,ECU,0,0,5,0,5
2013,El Salvador,SLV,Ecuador,ECU,0,0,10,0,10
2013,Syrian Arab Rep.,SYR,Ecuador,ECU,0,0,5,0,5
2013,Venezuela (Bolivarian Republic of),VEN,Ecuador,ECU,0,0,10,0,10
2013,Dem. Rep. of the Congo,COD,Gabon,GAB,5,0,5,5,15
2013,Egypt,EGY,Georgia,GEO,0,5,12,45,62
2013,Azerbaijan,AZE,Georgia,GEO,0,0,0,5,5
2013,Bangladesh,BGD,Georgia,GEO,0,0,0,5,5
2013,Iran (Islamic Rep. of),IRN,Georgia,GEO,0,0,5,28,33
2013,Iraq,IRQ,Georgia,GEO,12,14,185,413,624
2013,Kazakhstan,KAZ,Georgia,GEO,0,0,5,0,5
2013,Morocco,MAR,Georgia,GEO,0,0,0,5,5
2013,Nigeria,NGA,Georgia,GEO,0,0,0,5,5
2013,Russian Federation,RUS,Georgia,GEO,12,0,15,13,40
2013,Syrian Arab Rep.,SYR,Georgia,GEO,0,25,0,25,50
2013,Nigeria,NGA,Israel,ISR,5,0,0,0,5
2013,Afghanistan,AFG,Rep. of Korea,KOR,0,0,37,0,37
2013,Egypt,EGY,Rep. of Korea,KOR,0,0,5,0,5
2013,Bangladesh,BGD,Rep. of Korea,KOR,12,0,5,5,22
2013,China,CHN,Rep. of Korea,KOR,0,5,0,0,5
2013,Cameroon,CMR,Rep. of Korea,KOR,0,0,12,10,22
2013,Ethiopia,ETH,Rep. of Korea,KOR,0,0,18,0,18
2013,Guinea,GIN,Rep. of Korea,KOR,0,0,5,0,5
2013,Cote d'Ivoire,CIV,Rep. of Korea,KOR,5,0,0,0,5
2013,India,IND,Rep. of Korea,KOR,0,0,14,0,14
2013,Kenya,KEN,Rep. of Korea,KOR,0,0,0,5,5
2013,Liberia,LBR,Rep. of Korea,KOR,0,0,5,14,19
2013,Sri Lanka,LKA,Rep. of Korea,KOR,0,0,92,152,244
2013,Mali,MLI,Rep. of Korea,KOR,5,0,0,0,5
2013,Mongolia,MNG,Rep. of Korea,KOR,0,0,5,0,5
2013,Myanmar,MMR,Rep. of Korea,KOR,14,0,17,5,36
2013,Nepal,NPL,Rep. of Korea,KOR,0,0,25,13,38
2013,Nigeria,NGA,Rep. of Korea,KOR,0,0,33,17,50
2013,Pakistan,PAK,Rep. of Korea,KOR,5,0,184,82,271
2013,South Africa,ZAF,Rep. of Korea,KOR,0,0,0,12,12
2013,Sudan,SDN,Rep. of Korea,KOR,5,0,0,0,5
2013,Syrian Arab Rep.,SYR,Rep. of Korea,KOR,0,0,0,10,10
2013,Uganda,UGA,Rep. of Korea,KOR,0,0,45,12,57
2013,Yemen,YEM,Rep. of Korea,KOR,0,0,5,0,5
2013,Afghanistan,AFG,North Macedonia,MKD,0,0,0,117,117
2013,Algeria,DZA,North Macedonia,MKD,0,0,0,64,64
2013,Bangladesh,BGD,North Macedonia,MKD,0,0,0,13,13
2013,Burkina Faso,BFA,North Macedonia,MKD,0,0,0,5,5
2013,Comoros,COM,North Macedonia,MKD,0,0,0,21,21
2013,Eritrea,ERI,North Macedonia,MKD,0,0,0,10,10
2013,Gambia,GMB,North Macedonia,MKD,0,0,0,10,10
2013,Palestinian,PSE,North Macedonia,MKD,0,0,0,17,17
2013,Ghana,GHA,North Macedonia,MKD,0,0,0,5,5
2013,Guinea,GIN,North Macedonia,MKD,0,0,0,5,5
2013,Cote d'Ivoire,CIV,North Macedonia,MKD,0,0,0,12,12
2013,Iran (Islamic Rep. of),IRN,North Macedonia,MKD,0,0,0,5,5
2013,Iraq,IRQ,North Macedonia,MKD,0,0,0,5,5
2013,Mauritania,MRT,North Macedonia,MKD,0,0,0,14,14
2013,Mali,MLI,North Macedonia,MKD,0,0,0,13,13
2013,Morocco,MAR,North Macedonia,MKD,0,0,0,40,40
2013,Nigeria,NGA,North Macedonia,MKD,0,0,0,23,23
2013,Pakistan,PAK,North Macedonia,MKD,0,0,0,100,100
2013,Serbia and Kosovo: S/RES/1244 (1999),SRB,North Macedonia,MKD,0,0,0,28,28
2013,Senegal,SEN,North Macedonia,MKD,0,0,0,5,5
2013,Somalia,SOM,North Macedonia,MKD,0,0,0,74,74
2013,Sudan,SDN,North Macedonia,MKD,0,0,0,5,5
2013,Syrian Arab Rep.,SYR,North Macedonia,MKD,0,0,0,166,166
2013,Tunisia,TUN,North Macedonia,MKD,0,0,0,5,5
2013,Western Sahara,ESH,North Macedonia,MKD,0,0,0,5,5
2013,Afghanistan,AFG,Montenegro,MNE,0,0,10,174,184
2013,Algeria,DZA,Montenegro,MNE,0,0,161,592,753
2013,Egypt,EGY,Montenegro,MNE,0,0,0,38,38
2013,Bangladesh,BGD,Montenegro,MNE,0,0,0,18,18
2013,Dem. Rep. of the Congo,COD,Montenegro,MNE,0,0,0,5,5
2013,Comoros,COM,Montenegro,MNE,0,0,0,5,5
2013,Eritrea,ERI,Montenegro,MNE,0,0,0,286,286
2013,Ethiopia,ETH,Montenegro,MNE,0,0,0,5,5
2013,Palestinian,PSE,Montenegro,MNE,0,0,0,5,5
2013,Ghana,GHA,Montenegro,MNE,0,0,0,5,5
2013,Guinea,GIN,Montenegro,MNE,0,0,0,10,10
2013,India,IND,Montenegro,MNE,0,0,0,13,13
2013,Indonesia,IDN,Montenegro,MNE,0,0,0,5,5
2013,Iran (Islamic Rep. of),IRN,Montenegro,MNE,0,0,0,5,5
2013,Iraq,IRQ,Montenegro,MNE,0,0,0,5,5
2013,Libya,LBY,Montenegro,MNE,0,0,5,0,5
2013,Morocco,MAR,Montenegro,MNE,0,0,84,216,300
2013,Nigeria,NGA,Montenegro,MNE,0,0,0,113,113
2013,Pakistan,PAK,Montenegro,MNE,0,0,93,899,992
2013,Russian Federation,RUS,Montenegro,MNE,0,0,5,0,5
2013,Serbia and Kosovo: S/RES/1244 (1999),SRB,Montenegro,MNE,0,0,5,0,5
2013,Senegal,SEN,Montenegro,MNE,0,0,0,5,5
2013,Somalia,SOM,Montenegro,MNE,0,0,0,193,193
2013,Sudan,SDN,Montenegro,MNE,0,0,0,117,117
2013,Syrian Arab Rep.,SYR,Montenegro,MNE,0,0,0,232,232
2013,Tunisia,TUN,Montenegro,MNE,0,0,28,114,142
2013,Yemen,YEM,Montenegro,MNE,0,0,0,10,10
2013,Myanmar,MMR,Thailand,THA,968,0,0,89,1057
2013,Afghanistan,AFG,Tajikistan,TJK,227,0,90,0,317
2013,Burundi,BDI,Uganda,UGA,158,0,712,574,1444
2013,Bangladesh,BGD,Uganda,UGA,0,0,5,0,5
2013,Dem. Rep. of the Congo,COD,Uganda,UGA,6098,0,195,2714,9007
2013,Eritrea,ERI,Uganda,UGA,90,0,800,120,1010
2013,Ethiopia,ETH,Uganda,UGA,64,0,140,542,746
2013,Guinea,GIN,Uganda,UGA,0,0,0,5,5
2013,Kenya,KEN,Uganda,UGA,12,0,46,15,73
2013,Liberia,LBR,Uganda,UGA,0,0,0,5,5
2013,Pakistan,PAK,Uganda,UGA,14,0,29,0,43
2013,Rwanda,RWA,Uganda,UGA,144,0,208,2107,2459
2013,Sierra Leone,SLE,Uganda,UGA,0,0,0,5,5
2013,Somalia,SOM,Uganda,UGA,3005,0,0,2235,5240
2013,Sudan,SDN,Uganda,UGA,51,0,5,922,978
2013,South Sudan,SSD,Uganda,UGA,1473,0,64,81,1618
2013,United Rep. of Tanzania,TZA,Uganda,UGA,0,0,0,10,10
2014,Central African Rep.,CAF,Chad,TCD,887,0,0,0,887
2014,Dem. Rep. of the Congo,COD,Chad,TCD,5,0,0,0,5
2014,Sudan,SDN,Chad,TCD,5,0,0,0,5
2014,Central African Rep.,CAF,Congo,COG,28,33,0,0,61
2014,Chad,TCD,Congo,COG,0,0,0,5,5
2014,Dem. Rep. of the Congo,COD,Congo,COG,29,12,5,34,80
2014,Rwanda,RWA,Congo,COG,5,0,0,25,30
2014,Angola,AGO,Gabon,GAB,0,0,0,32,32
2014,Central African Rep.,CAF,Gabon,GAB,13,0,10,0,23
2014,Chad,TCD,Gabon,GAB,0,0,5,270,275
2014,Dem. Rep. of the Congo,COD,Gabon,GAB,0,0,10,284,294
2014,Equatorial Guinea,GNQ,Gabon,GAB,0,0,0,10,10
2014,Cote d'Ivoire,CIV,Gabon,GAB,0,0,0,18,18
2014,Liberia,LBR,Gabon,GAB,0,0,0,5,5
2014,Mauritania,MRT,Gabon,GAB,0,0,0,21,21
2014,Rwanda,RWA,Gabon,GAB,0,0,0,11,11
2014,Sierra Leone,SLE,Gabon,GAB,0,0,0,10,10
2014,Sudan,SDN,Gabon,GAB,0,0,0,5,5
2014,Togo,TGO,Gabon,GAB,0,0,0,5,5
2014,Nicaragua,NIC,Honduras,HND,10,0,0,0,10
2014,El Salvador,SLV,Honduras,HND,5,0,0,0,5
2014,Afghanistan,AFG,Rep. of Korea,KOR,0,5,10,10,25
2014,Egypt,EGY,Rep. of Korea,KOR,0,0,98,27,125
2014,Bangladesh,BGD,Rep. of Korea,KOR,0,0,48,12,60
2014,Burkina Faso,BFA,Rep. of Korea,KOR,0,0,5,0,5
2014,China,CHN,Rep. of Korea,KOR,0,0,93,37,130
2014,Cameroon,CMR,Rep. of Korea,KOR,0,0,34,15,49
2014,Dem. Rep. of the Congo,COD,Rep. of Korea,KOR,0,0,5,5,10
2014,Ethiopia,ETH,Rep. of Korea,KOR,45,0,0,5,50
2014,Ghana,GHA,Rep. of Korea,KOR,0,0,13,0,13
2014,Guinea,GIN,Rep. of Korea,KOR,0,0,10,5,15
2014,Cote d'Ivoire,CIV,Rep. of Korea,KOR,0,0,12,0,12
2014,Indonesia,IDN,Rep. of Korea,KOR,0,0,0,5,5
2014,Iran (Islamic Rep. of),IRN,Rep. of Korea,KOR,10,0,0,0,10
2014,Kenya,KEN,Rep. of Korea,KOR,0,0,12,0,12
2014,Liberia,LBR,Rep. of Korea,KOR,0,5,22,17,44
2014,Sri Lanka,LKA,Rep. of Korea,KOR,0,5,15,5,25
2014,Morocco,MAR,Rep. of Korea,KOR,0,0,14,0,14
2014,Myanmar,MMR,Rep. of Korea,KOR,0,5,0,10,15
2014,Nepal,NPL,Rep. of Korea,KOR,0,0,79,15,94
2014,Nigeria,NGA,Rep. of Korea,KOR,0,0,110,26,136
2014,Pakistan,PAK,Rep. of Korea,KOR,11,5,318,58,392
2014,Philippines,PHL,Rep. of Korea,KOR,0,0,5,0,5
2014,South Africa,ZAF,Rep. of Korea,KOR,0,0,37,14,51
2014,Russian Federation,RUS,Rep. of Korea,KOR,5,0,0,0,5
2014,Somalia,SOM,Rep. of Korea,KOR,0,0,0,5,5
2014,Sudan,SDN,Rep. of Korea,KOR,0,0,5,0,5
2014,Syrian Arab Rep.,SYR,Rep. of Korea,KOR,0,502,10,61,573
2014,Tunisia,TUN,Rep. of Korea,KOR,0,0,0,5,5
2014,Uganda,UGA,Rep. of Korea,KOR,5,0,26,17,48
2014,Uzbekistan,UZB,Rep. of Korea,KOR,0,0,5,0,5
2014,Yemen,YEM,Rep. of Korea,KOR,5,0,5,13,23
2014,Afghanistan,AFG,North Macedonia,MKD,0,0,0,192,192
2014,Algeria,DZA,North Macedonia,MKD,0,0,0,26,26
2014,Bangladesh,BGD,North Macedonia,MKD,0,0,0,44,44
2014,Comoros,COM,North Macedonia,MKD,0,0,0,19,19
2014,Eritrea,ERI,North Macedonia,MKD,0,0,0,14,14
2014,Palestinian,PSE,North Macedonia,MKD,0,0,0,15,15
2014,Ghana,GHA,North Macedonia,MKD,0,0,0,5,5
2014,Cote d'Ivoire,CIV,North Macedonia,MKD,0,0,0,5,5
2014,India,IND,North Macedonia,MKD,0,0,0,5,5
2014,Mali,MLI,North Macedonia,MKD,0,0,0,10,10
2014,Morocco,MAR,North Macedonia,MKD,0,0,0,18,18
2014,Nigeria,NGA,North Macedonia,MKD,0,0,0,5,5
2014,Pakistan,PAK,North Macedonia,MKD,0,0,0,55,55
2014,Serbia and Kosovo: S/RES/1244 (1999),SRB,North Macedonia,MKD,0,0,5,0,5
2014,Senegal,SEN,North Macedonia,MKD,0,0,0,13,13
2014,Somalia,SOM,North Macedonia,MKD,0,0,0,59,59
2014,Syrian Arab Rep.,SYR,North Macedonia,MKD,11,0,0,314,325
2014,Togo,TGO,North Macedonia,MKD,0,0,0,5,5
2014,Afghanistan,AFG,Montenegro,MNE,0,0,0,14,14
2014,Algeria,DZA,Montenegro,MNE,0,0,5,30,35
2014,Egypt,EGY,Montenegro,MNE,0,0,0,5,5
2014,Cameroon,CMR,Montenegro,MNE,0,0,0,5,5
2014,Congo,COG,Montenegro,MNE,0,0,0,11,11
2014,Dem. Rep. of the Congo,COD,Montenegro,MNE,0,0,0,42,42
2014,Cuba,CUB,Montenegro,MNE,0,0,0,5,5
2014,Eritrea,ERI,Montenegro,MNE,0,0,0,363,363
2014,Gambia,GMB,Montenegro,MNE,0,0,0,15,15
2014,Guinea,GIN,Montenegro,MNE,0,0,0,12,12
2014,Cote d'Ivoire,CIV,Montenegro,MNE,0,0,0,5,5
2014,India,IND,Montenegro,MNE,0,0,0,10,10
2014,Iran (Islamic Rep. of),IRN,Montenegro,MNE,0,0,0,10,10
2014,Iraq,IRQ,Montenegro,MNE,0,0,0,5,5
2014,Mali,MLI,Montenegro,MNE,0,0,0,5,5
2014,Morocco,MAR,Montenegro,MNE,0,0,5,15,20
2014,Nigeria,NGA,Montenegro,MNE,0,0,0,31,31
2014,Pakistan,PAK,Montenegro,MNE,0,0,5,16,21
2014,Russian Federation,RUS,Montenegro,MNE,0,0,5,0,5
2014,Serbia and Kosovo: S/RES/1244 (1999),SRB,Montenegro,MNE,0,0,5,0,5
2014,Senegal,SEN,Montenegro,MNE,0,0,0,5,5
2014,Somalia,SOM,Montenegro,MNE,0,0,0,29,29
2014,Sudan,SDN,Montenegro,MNE,0,0,5,80,85
2014,Syrian Arab Rep.,SYR,Montenegro,MNE,0,0,0,1673,1673
2014,Tunisia,TUN,Montenegro,MNE,0,0,0,13,13
2014,Yemen,YEM,Montenegro,MNE,0,0,0,5,5
2014,Afghanistan,AFG,Tajikistan,TJK,159,0,204,1939,2302
2014,Burundi,BDI,Uganda,UGA,791,0,191,51,1033
2014,Bangladesh,BGD,Uganda,UGA,0,0,5,0,5
2014,Central African Rep.,CAF,Uganda,UGA,5,0,0,0,5
2014,Dem. Rep. of the Congo,COD,Uganda,UGA,10391,0,723,1203,12317
2014,Eritrea,ERI,Uganda,UGA,251,0,741,74,1066
2014,Ethiopia,ETH,Uganda,UGA,333,0,82,39,454
2014,Kenya,KEN,Uganda,UGA,0,0,10,0,10
2014,Pakistan,PAK,Uganda,UGA,0,0,21,0,21
2014,Rwanda,RWA,Uganda,UGA,285,0,359,97,741
2014,Somalia,SOM,Uganda,UGA,2697,0,5,95,2797
2014,Sudan,SDN,Uganda,UGA,449,0,5,0,454
2014,South Sudan,SSD,Uganda,UGA,2159,0,0,84,2243
2015,Afghanistan,AFG,Austria,AUT,2083,1263,2478,2306,8130
2015,Albania,ALB,Austria,AUT,0,5,89,21,115
2015,Algeria,DZA,Austria,AUT,0,0,460,206,666
2015,Angola,AGO,Austria,AUT,13,0,0,0,13
2015,Egypt,EGY,Austria,AUT,17,0,68,38,123
2015,Armenia,ARM,Austria,AUT,22,14,145,25,206
2015,Azerbaijan,AZE,Austria,AUT,11,5,24,17,57
2015,Burundi,BDI,Austria,AUT,5,0,0,0,5
2015,Benin,BEN,Austria,AUT,0,0,13,0,13
2015,Bangladesh,BGD,Austria,AUT,42,18,439,142,641
2015,Burkina Faso,BFA,Austria,AUT,0,0,5,0,5
2015,Belarus,BLR,Austria,AUT,0,0,14,11,25
2015,Bosnia and Herzegovina,BIH,Austria,AUT,11,10,99,41,161
2015,Bulgaria,BGR,Austria,AUT,0,0,0,5,5
2015,Chad,TCD,Austria,AUT,0,0,5,0,5
2015,China,CHN,Austria,AUT,54,0,82,46,182
2015,Cameroon,CMR,Austria,AUT,24,5,46,10,85
2015,Congo,COG,Austria,AUT,14,0,0,5,19
2015,Dem. Rep. of the Congo,COD,Austria,AUT,32,10,34,13,89
2015,Cuba,CUB,Austria,AUT,0,0,22,10,32
2015,Equatorial Guinea,GNQ,Austria,AUT,5,0,0,0,5
2015,Eritrea,ERI,Austria,AUT,38,10,10,11,69
2015,Ethiopia,ETH,Austria,AUT,10,5,13,5,33
2015,Gabon,GAB,Austria,AUT,0,0,12,0,12
2015,Gambia,GMB,Austria,AUT,21,0,103,23,147
2015,Georgia,GEO,Austria,AUT,0,33,129,43,205
2015,Germany,DEU,Austria,AUT,0,0,0,13,13
2015,Ghana,GHA,Austria,AUT,0,0,30,11,41
2015,Guinea-Bissau,GNB,Austria,AUT,0,0,0,13,13
2015,Guinea,GIN,Austria,AUT,26,11,32,5,74
2015,Croatia,HRV,Austria,AUT,0,0,5,0,5
2015,Hungary,HUN,Austria,AUT,0,0,0,5,5
2015,Cote d'Ivoire,CIV,Austria,AUT,0,0,32,0,32
2015,India,IND,Austria,AUT,0,5,165,52,222
2015,Iran (Islamic Rep. of),IRN,Austria,AUT,437,5,155,175,772
2015,Iraq,IRQ,Austria,AUT,637,266,571,1394,2868
2015,Israel,ISR,Austria,AUT,0,0,0,5,5
2015,Jordan,JOR,Austria,AUT,14,0,5,0,19
2015,Kazakhstan,KAZ,Austria,AUT,10,0,17,5,32
2015,Kenya,KEN,Austria,AUT,5,0,5,0,10
2015,Kyrgyzstan,KGZ,Austria,AUT,13,5,26,5,49
2015,Kuwait,KWT,Austria,AUT,0,0,0,5,5
2015,Liberia,LBR,Austria,AUT,5,0,5,0,10
2015,Libya,LBY,Austria,AUT,13,5,52,29,99
2015,Lebanon,LBN,Austria,AUT,11,0,24,5,40
2015,Sri Lanka,LKA,Austria,AUT,5,12,19,10,46
2015,Mauritania,MRT,Austria,AUT,0,0,5,5,10
2015,North Macedonia,MKD,Austria,AUT,0,0,187,49,236
2015,Rep. of Moldova,MDA,Austria,AUT,0,0,10,10,20
2015,Mali,MLI,Austria,AUT,0,0,24,13,37
2015,Mongolia,MNG,Austria,AUT,5,5,67,22,99
2015,Morocco,MAR,Austria,AUT,5,0,257,92,354
2015,Montenegro,MNE,Austria,AUT,0,0,13,0,13
2015,Myanmar,MMR,Austria,AUT,0,0,14,0,14
2015,Nepal,NPL,Austria,AUT,0,5,19,5,29
2015,Niger,NER,Austria,AUT,0,0,5,0,5
2015,Nigeria,NGA,Austria,AUT,12,27,637,125,801
2015,Pakistan,PAK,Austria,AUT,26,5,1052,580,1663
2015,Romania,ROU,Austria,AUT,0,0,0,11,11
2015,Russian Federation,RUS,Austria,AUT,667,141,947,228,1983
2015,Rwanda,RWA,Austria,AUT,0,0,5,0,5
2015,Saudi Arabia,SAU,Austria,AUT,5,0,0,0,5
2015,Serbia and Kosovo: S/RES/1244 (1999),SRB,Austria,AUT,28,41,2802,585,3456
2015,Senegal,SEN,Austria,AUT,0,0,52,10,62
2015,Sierra Leone,SLE,Austria,AUT,5,0,15,5,25
2015,Somalia,SOM,Austria,AUT,548,279,247,79,1153
2015,Viet Nam,VNM,Austria,AUT,0,0,0,14,14
2015,Sudan,SDN,Austria,AUT,26,5,19,13,63
2015,South Sudan,SSD,Austria,AUT,0,0,5,0,5
2015,Slovakia,SVK,Austria,AUT,0,0,5,0,5
2015,Syrian Arab Rep.,SYR,Austria,AUT,8114,183,752,1213,10262
2015,United Rep. of Tanzania,TZA,Austria,AUT,0,0,0,5,5
2015,Tajikistan,TJK,Austria,AUT,10,10,39,0,59
2015,Turkmenistan,TKM,Austria,AUT,0,0,5,0,5
2015,Togo,TGO,Austria,AUT,0,0,5,0,5
2015,Tunisia,TUN,Austria,AUT,0,0,84,26,110
2015,Turkey,TUR,Austria,AUT,10,10,105,53,178
2015,Uganda,UGA,Austria,AUT,0,0,19,0,19
2015,Ukraine,UKR,Austria,AUT,22,10,115,47,194
2015,Uzbekistan,UZB,Austria,AUT,5,5,14,0,24
2015,Western Sahara,ESH,Austria,AUT,0,0,5,0,5
2015,Yemen,YEM,Austria,AUT,11,5,5,5,26
2015,Zambia,ZMB,Austria,AUT,0,5,0,0,5
2015,Stateless,XXA,Austria,AUT,1333,39,123,85,1580
2015,Central African Rep.,CAF,Chad,TCD,1041,0,15,0,1056
2015,Dem. Rep. of the Congo,COD,Chad,TCD,19,0,0,0,19
2015,Sudan,SDN,Chad,TCD,21,0,0,0,21
2015,Syrian Arab Rep.,SYR,Chad,TCD,5,0,0,0,5
2015,Angola,AGO,Congo,COG,0,0,0,19,19
2015,Burundi,BDI,Congo,COG,0,0,0,12,12
2015,Central African Rep.,CAF,Congo,COG,5,0,0,35,40
2015,Chad,TCD,Congo,COG,5,0,0,111,116
2015,Dem. Rep. of the Congo,COD,Congo,COG,42,0,0,1550,1592
2015,Guinea,GIN,Congo,COG,0,0,0,5,5
2015,Cote d'Ivoire,CIV,Congo,COG,0,0,0,57,57
2015,Liberia,LBR,Congo,COG,0,0,0,5,5
2015,Mauritania,MRT,Congo,COG,0,0,0,46,46
2015,Rwanda,RWA,Congo,COG,12,0,0,82,94
2015,Sierra Leone,SLE,Congo,COG,0,0,0,5,5
2015,Sudan,SDN,Congo,COG,0,0,0,5,5
2015,Syrian Arab Rep.,SYR,Congo,COG,5,0,0,0,5
2015,Central African Rep.,CAF,Gabon,GAB,0,10,0,0,10
2015,Congo,COG,Gabon,GAB,0,0,0,10,10
2015,Dem. Rep. of the Congo,COD,Gabon,GAB,0,5,0,0,5
2015,Nicaragua,NIC,Honduras,HND,5,0,0,13,18
2015,El Salvador,SLV,Honduras,HND,5,0,0,0,5
2015,Afghanistan,AFG,Hungary,HUN,25,65,367,39888,40345
2015,Albania,ALB,Hungary,HUN,0,0,29,214,243
2015,Algeria,DZA,Hungary,HUN,0,0,141,455,596
2015,Angola,AGO,Hungary,HUN,0,0,0,5,5
2015,Egypt,EGY,Hungary,HUN,5,0,11,70,86
2015,Armenia,ARM,Hungary,HUN,0,0,0,5,5
2015,Azerbaijan,AZE,Hungary,HUN,0,0,0,5,5
2015,Burundi,BDI,Hungary,HUN,0,0,0,5,5
2015,Benin,BEN,Hungary,HUN,0,0,0,5,5
2015,Bangladesh,BGD,Hungary,HUN,0,0,86,3075,3161
2015,Burkina Faso,BFA,Hungary,HUN,0,0,0,41,41
2015,Bosnia and Herzegovina,BIH,Hungary,HUN,0,0,0,11,11
2015,Central African Rep.,CAF,Hungary,HUN,0,0,0,5,5
2015,China,CHN,Hungary,HUN,0,0,0,5,5
2015,Cameroon,CMR,Hungary,HUN,5,0,22,540,567
2015,Congo,COG,Hungary,HUN,0,0,5,315,320
2015,Dem. Rep. of the Congo,COD,Hungary,HUN,5,0,5,545,555
2015,Comoros,COM,Hungary,HUN,0,0,5,152,157
2015,Cuba,CUB,Hungary,HUN,10,0,64,189,263
2015,Dominica,DMA,Hungary,HUN,0,0,0,5,5
2015,Dominican Rep.,DOM,Hungary,HUN,0,0,0,10,10
2015,Eritrea,ERI,Hungary,HUN,5,5,0,436,446
2015,Ethiopia,ETH,Hungary,HUN,0,0,5,29,34
2015,Gabon,GAB,Hungary,HUN,0,0,0,10,10
2015,Gambia,GMB,Hungary,HUN,0,0,11,138,149
2015,Palestinian,PSE,Hungary,HUN,10,5,5,985,1005
2015,Georgia,GEO,Hungary,HUN,5,0,5,26,36
2015,Ghana,GHA,Hungary,HUN,0,0,38,288,326
2015,Guinea,GIN,Hungary,HUN,0,0,10,87,97
2015,Haiti,HTI,Hungary,HUN,0,0,0,18,18
2015,Cote d'Ivoire,CIV,Hungary,HUN,5,0,21,256,282
2015,India,IND,Hungary,HUN,0,0,0,259,259
2015,Iran (Islamic Rep. of),IRN,Hungary,HUN,16,5,36,1443,1500
2015,Iraq,IRQ,Hungary,HUN,5,41,72,7247,7365
2015,Jordan,JOR,Hungary,HUN,0,0,0,5,5
2015,Kenya,KEN,Hungary,HUN,0,0,0,5,5
2015,Lao People's Dem. Rep.,LAO,Hungary,HUN,0,0,0,5,5
2015,Liberia,LBR,Hungary,HUN,0,0,5,12,17
2015,Libya,LBY,Hungary,HUN,0,0,0,49,49
2015,Lebanon,LBN,Hungary,HUN,0,0,0,13,13
2015,Sri Lanka,LKA,Hungary,HUN,0,0,0,90,90
2015,Mauritania,MRT,Hungary,HUN,0,0,5,55,60
2015,North Macedonia,MKD,Hungary,HUN,0,0,0,19,19
2015,Rep. of Moldova,MDA,Hungary,HUN,0,0,5,5,10
2015,Mali,MLI,Hungary,HUN,0,0,10,252,262
2015,Mongolia,MNG,Hungary,HUN,0,0,0,98,98
2015,Morocco,MAR,Hungary,HUN,0,0,41,212,253
2015,Montenegro,MNE,Hungary,HUN,0,0,0,5,5
2015,Myanmar,MMR,Hungary,HUN,0,0,0,45,45
2015,Nepal,NPL,Hungary,HUN,0,0,5,19,24
2015,Niger,NER,Hungary,HUN,0,0,0,12,12
2015,Nigeria,NGA,Hungary,HUN,5,0,125,752,882
2015,Pakistan,PAK,Hungary,HUN,0,5,256,11376,11637
2015,South Africa,ZAF,Hungary,HUN,0,0,0,5,5
2015,Russian Federation,RUS,Hungary,HUN,0,0,5,13,18
2015,Rwanda,RWA,Hungary,HUN,0,0,5,13,18
2015,Serbia and Kosovo: S/RES/1244 (1999),SRB,Hungary,HUN,0,0,1256,33583,34839
2015,Senegal,SEN,Hungary,HUN,0,0,10,205,215
2015,Sierra Leone,SLE,Hungary,HUN,0,0,5,97,102
2015,Somalia,SOM,Hungary,HUN,19,50,5,243,317
2015,Viet Nam,VNM,Hungary,HUN,0,0,18,18,36
2015,Sudan,SDN,Hungary,HUN,0,12,18,206,236
2015,South Sudan,SSD,Hungary,HUN,0,0,0,16,16
2015,Syrian Arab Rep.,SYR,Hungary,HUN,19,140,108,46902,47169
2015,Togo,TGO,Hungary,HUN,0,0,0,63,63
2015,Tunisia,TUN,Hungary,HUN,0,0,10,67,77
2015,Turkey,TUR,Hungary,HUN,0,0,17,270,287
2015,United Arab Emirates,ARE,Hungary,HUN,0,0,0,5,5
2015,Uganda,UGA,Hungary,HUN,0,0,5,68,73
2015,Ukraine,UKR,Hungary,HUN,0,5,5,21,31
2015,Uzbekistan,UZB,Hungary,HUN,0,0,0,12,12
2015,Western Sahara,ESH,Hungary,HUN,0,0,5,5,10
2015,Yemen,YEM,Hungary,HUN,0,13,0,41,54
2015,Stateless,XXA,Hungary,HUN,0,0,0,20,20
2015,Eritrea,ERI,Israel,ISR,0,0,332,0,332
2015,Afghanistan,AFG,Rep. of Korea,KOR,0,12,5,5,22
2015,Algeria,DZA,Rep. of Korea,KOR,0,0,5,0,5
2015,Egypt,EGY,Rep. of Korea,KOR,0,0,389,62,451
2015,Burundi,BDI,Rep. of Korea,KOR,0,5,0,0,5
2015,Bangladesh,BGD,Rep. of Korea,KOR,0,0,135,5,140
2015,Burkina Faso,BFA,Rep. of Korea,KOR,0,0,5,0,5
2015,Cambodia,KHM,Rep. of Korea,KOR,0,0,5,0,5
2015,China,CHN,Rep. of Korea,KOR,0,10,179,20,209
2015,Cameroon,CMR,Rep. of Korea,KOR,0,0,112,10,122
2015,Dem. Rep. of the Congo,COD,Rep. of Korea,KOR,0,0,5,0,5
2015,Ethiopia,ETH,Rep. of Korea,KOR,12,0,19,0,31
2015,Gambia,GMB,Rep. of Korea,KOR,0,0,5,0,5
2015,Ghana,GHA,Rep. of Korea,KOR,0,0,110,5,115
2015,Guinea,GIN,Rep. of Korea,KOR,0,0,14,0,14
2015,Cote d'Ivoire,CIV,Rep. of Korea,KOR,0,0,10,0,10
2015,India,IND,Rep. of Korea,KOR,0,0,36,5,41
2015,Indonesia,IDN,Rep. of Korea,KOR,0,0,0,5,5
2015,Iran (Islamic Rep. of),IRN,Rep. of Korea,KOR,5,5,0,0,10
2015,Iraq,IRQ,Rep. of Korea,KOR,0,14,5,0,19
2015,Jordan,JOR,Rep. of Korea,KOR,0,0,5,0,5
2015,Kazakhstan,KAZ,Rep. of Korea,KOR,0,0,5,5,10
2015,Kenya,KEN,Rep. of Korea,KOR,0,0,16,0,16
2015,Kyrgyzstan,KGZ,Rep. of Korea,KOR,0,0,5,5,10
2015,Liberia,LBR,Rep. of Korea,KOR,0,0,65,10,75
2015,Libya,LBY,Rep. of Korea,KOR,0,5,0,0,5
2015,Sri Lanka,LKA,Rep. of Korea,KOR,0,0,24,5,29
2015,Mali,MLI,Rep. of Korea,KOR,0,0,5,0,5
2015,Mongolia,MNG,Rep. of Korea,KOR,0,0,5,0,5
2015,Morocco,MAR,Rep. of Korea,KOR,0,0,40,5,45
2015,Myanmar,MMR,Rep. of Korea,KOR,5,5,15,0,25
2015,Nepal,NPL,Rep. of Korea,KOR,0,0,200,5,205
2015,Nigeria,NGA,Rep. of Korea,KOR,0,0,335,11,346
2015,Pakistan,PAK,Rep. of Korea,KOR,10,5,512,48,575
2015,Philippines,PHL,Rep. of Korea,KOR,0,0,36,0,36
2015,South Africa,ZAF,Rep. of Korea,KOR,0,0,88,23,111
2015,Russian Federation,RUS,Rep. of Korea,KOR,0,0,10,0,10
2015,Rwanda,RWA,Rep. of Korea,KOR,0,0,5,0,5
2015,Senegal,SEN,Rep. of Korea,KOR,0,0,20,0,20
2015,Sierra Leone,SLE,Rep. of Korea,KOR,0,0,5,0,5
2015,Viet Nam,VNM,Rep. of Korea,KOR,0,0,93,29,122
2015,Sudan,SDN,Rep. of Korea,KOR,0,0,5,0,5
2015,Syrian Arab Rep.,SYR,Rep. of Korea,KOR,0,143,0,5,148
2015,Thailand,THA,Rep. of Korea,KOR,0,0,45,0,45
2015,Togo,TGO,Rep. of Korea,KOR,0,0,5,0,5
2015,Tunisia,TUN,Rep. of Korea,KOR,0,0,11,0,11
2015,Uganda,UGA,Rep. of Korea,KOR,0,0,102,5,107
2015,Ukraine,UKR,Rep. of Korea,KOR,0,5,5,0,10
2015,Uzbekistan,UZB,Rep. of Korea,KOR,0,0,20,5,25
2015,Yemen,YEM,Rep. of Korea,KOR,0,0,60,5,65
2015,Afghanistan,AFG,North Macedonia,MKD,0,0,0,915,915
2015,Algeria,DZA,North Macedonia,MKD,0,0,0,17,17
2015,Egypt,EGY,North Macedonia,MKD,0,0,0,5,5
2015,Bangladesh,BGD,North Macedonia,MKD,0,0,0,30,30
2015,Cameroon,CMR,North Macedonia,MKD,0,0,0,5,5
2015,Congo,COG,North Macedonia,MKD,0,0,0,43,43
2015,Comoros,COM,North Macedonia,MKD,0,0,0,14,14
2015,Eritrea,ERI,North Macedonia,MKD,0,0,0,19,19
2015,Gambia,GMB,North Macedonia,MKD,0,0,0,5,5
2015,Palestinian,PSE,North Macedonia,MKD,0,0,0,70,70
2015,Ghana,GHA,North Macedonia,MKD,0,0,0,14,14
2015,Guinea,GIN,North Macedonia,MKD,0,0,0,10,10
2015,Cote d'Ivoire,CIV,North Macedonia,MKD,0,0,0,5,5
2015,India,IND,North Macedonia,MKD,0,0,0,5,5
2015,Iran (Islamic Rep. of),IRN,North Macedonia,MKD,0,0,0,35,35
2015,Iraq,IRQ,North Macedonia,MKD,0,0,0,180,180
2015,Kazakhstan,KAZ,North Macedonia,MKD,0,0,0,5,5
2015,Lebanon,LBN,North Macedonia,MKD,0,0,0,5,5
2015,Mauritania,MRT,North Macedonia,MKD,0,0,0,5,5
2015,Mali,MLI,North Macedonia,MKD,0,0,0,16,16
2015,Morocco,MAR,North Macedonia,MKD,0,0,0,42,42
2015,Myanmar,MMR,North Macedonia,MKD,0,0,0,10,10
2015,Nigeria,NGA,North Macedonia,MKD,0,0,0,30,30
2015,Pakistan,PAK,North Macedonia,MKD,0,0,0,137,137
2015,Russian Federation,RUS,North Macedonia,MKD,0,0,0,5,5
2015,Serbia and Kosovo: S/RES/1244 (1999),SRB,North Macedonia,MKD,0,0,5,5,10
2015,Senegal,SEN,North Macedonia,MKD,0,0,0,11,11
2015,Sierra Leone,SLE,North Macedonia,MKD,0,0,0,5,5
2015,Somalia,SOM,North Macedonia,MKD,0,0,0,116,116
2015,Sudan,SDN,North Macedonia,MKD,0,0,0,10,10
2015,Syrian Arab Rep.,SYR,North Macedonia,MKD,0,0,5,1643,1648
2015,Western Sahara,ESH,North Macedonia,MKD,0,0,0,5,5
2015,Afghanistan,AFG,Montenegro,MNE,0,0,0,5,5
2015,Armenia,ARM,Montenegro,MNE,0,0,0,5,5
2015,Bangladesh,BGD,Montenegro,MNE,0,0,0,10,10
2015,Cameroon,CMR,Montenegro,MNE,0,0,0,5,5
2015,Dem. Rep. of the Congo,COD,Montenegro,MNE,0,0,0,41,41
2015,Eritrea,ERI,Montenegro,MNE,0,0,0,185,185
2015,Gambia,GMB,Montenegro,MNE,0,0,0,34,34
2015,Palestinian,PSE,Montenegro,MNE,0,0,0,5,5
2015,Croatia,HRV,Montenegro,MNE,0,0,0,5,5
2015,India,IND,Montenegro,MNE,0,0,0,5,5
2015,Iran (Islamic Rep. of),IRN,Montenegro,MNE,0,0,0,5,5
2015,Iraq,IRQ,Montenegro,MNE,0,0,0,42,42
2015,Liberia,LBR,Montenegro,MNE,0,0,0,5,5
2015,Mauritania,MRT,Montenegro,MNE,0,0,0,5,5
2015,Mali,MLI,Montenegro,MNE,0,0,0,14,14
2015,Nigeria,NGA,Montenegro,MNE,0,0,0,24,24
2015,Serbia and Kosovo: S/RES/1244 (1999),SRB,Montenegro,MNE,0,0,0,5,5
2015,Somalia,SOM,Montenegro,MNE,0,0,0,156,156
2015,Sudan,SDN,Montenegro,MNE,0,0,0,38,38
2015,Syrian Arab Rep.,SYR,Montenegro,MNE,14,0,0,1018,1032
2015,Tunisia,TUN,Montenegro,MNE,0,0,0,5,5
2015,Ukraine,UKR,Montenegro,MNE,0,0,0,5,5
2015,Afghanistan,AFG,Tajikistan,TJK,248,0,125,0,373
2015,Egypt,EGY,Uganda,UGA,0,0,0,5,5
2015,Burundi,BDI,Uganda,UGA,7937,0,175,0,8112
2015,Chad,TCD,Uganda,UGA,0,0,5,0,5
2015,Dem. Rep. of the Congo,COD,Uganda,UGA,15079,0,1191,0,16270
2015,Eritrea,ERI,Uganda,UGA,492,0,1343,0,1835
2015,Ethiopia,ETH,Uganda,UGA,422,0,203,0,625
2015,Kenya,KEN,Uganda,UGA,0,0,5,132,137
2015,Mali,MLI,Uganda,UGA,0,0,5,0,5
2015,Pakistan,PAK,Uganda,UGA,133,0,11,0,144
2015,Rwanda,RWA,Uganda,UGA,166,0,554,0,720
2015,Somalia,SOM,Uganda,UGA,7351,0,0,0,7351
2015,Sudan,SDN,Uganda,UGA,360,0,5,0,365
2015,South Sudan,SSD,Uganda,UGA,34,0,0,0,34
2015,Syrian Arab Rep.,SYR,Uganda,UGA,5,0,0,0,5
2015,Yemen,YEM,Uganda,UGA,5,0,0,0,5
2016,Afghanistan,AFG,Austria,AUT,1756,1693,182,2489,6120
2016,Albania,ALB,Austria,AUT,0,5,83,16,104
2016,Algeria,DZA,Austria,AUT,5,0,593,329,927
2016,Angola,AGO,Austria,AUT,5,0,0,0,5
2016,Egypt,EGY,Austria,AUT,30,0,40,63,133
2016,Armenia,ARM,Austria,AUT,12,22,77,44,155
2016,Azerbaijan,AZE,Austria,AUT,13,11,15,0,39
2016,Benin,BEN,Austria,AUT,0,0,5,0,5
2016,Bangladesh,BGD,Austria,AUT,38,10,45,111,204
2016,Burkina Faso,BFA,Austria,AUT,0,0,0,5,5
2016,Belarus,BLR,Austria,AUT,0,0,0,12,12
2016,Bosnia and Herzegovina,BIH,Austria,AUT,0,0,38,100,138
2016,China,CHN,Austria,AUT,58,5,54,70,187
2016,Cameroon,CMR,Austria,AUT,17,0,10,10,37
2016,Congo,COG,Austria,AUT,13,0,0,0,13
2016,Dem. Rep. of the Congo,COD,Austria,AUT,38,0,5,5,48
2016,Cuba,CUB,Austria,AUT,0,0,0,5,5
2016,Dominican Rep.,DOM,Austria,AUT,0,0,0,5,5
2016,Eritrea,ERI,Austria,AUT,56,5,0,40,101
2016,Ethiopia,ETH,Austria,AUT,13,5,0,13,31
2016,Gambia,GMB,Austria,AUT,10,0,10,114,134
2016,Georgia,GEO,Austria,AUT,5,10,127,69,211
2016,Ghana,GHA,Austria,AUT,0,0,22,40,62
2016,Guinea-Bissau,GNB,Austria,AUT,0,0,0,10,10
2016,Guatemala,GTM,Austria,AUT,5,0,0,0,5
2016,Guinea,GIN,Austria,AUT,16,5,5,22,48
2016,Cote d'Ivoire,CIV,Austria,AUT,5,0,5,21,31
2016,India,IND,Austria,AUT,0,5,133,87,225
2016,Iran (Islamic Rep. of),IRN,Austria,AUT,440,5,33,735,1213
2016,Iraq,IRQ,Austria,AUT,1328,633,97,2191,4249
2016,Jordan,JOR,Austria,AUT,17,0,5,10,32
2016,Kazakhstan,KAZ,Austria,AUT,24,5,16,10,55
2016,Kenya,KEN,Austria,AUT,0,5,5,0,10
2016,Kyrgyzstan,KGZ,Austria,AUT,5,5,5,5,20
2016,Kuwait,KWT,Austria,AUT,0,0,0,5,5
2016,Liberia,LBR,Austria,AUT,0,0,0,5,5
2016,Libya,LBY,Austria,AUT,5,13,5,78,101
2016,Lebanon,LBN,Austria,AUT,13,0,5,78,96
2016,Sri Lanka,LKA,Austria,AUT,5,0,5,53,63
2016,Mauritania,MRT,Austria,AUT,0,0,5,0,5
2016,North Macedonia,MKD,Austria,AUT,0,0,166,50,216
2016,Rep. of Moldova,MDA,Austria,AUT,0,0,5,13,18
2016,Mali,MLI,Austria,AUT,0,0,5,32,37
2016,Mongolia,MNG,Austria,AUT,0,0,28,25,53
2016,Morocco,MAR,Austria,AUT,5,0,723,439,1167
2016,Montenegro,MNE,Austria,AUT,0,0,5,0,5
2016,Nepal,NPL,Austria,AUT,0,0,5,22,27
2016,Niger,NER,Austria,AUT,0,0,0,5,5
2016,Nigeria,NGA,Austria,AUT,16,15,211,326,568
2016,Pakistan,PAK,Austria,AUT,31,5,353,911,1300
2016,Philippines,PHL,Austria,AUT,5,0,0,0,5
2016,Romania,ROU,Austria,AUT,0,0,0,5,5
2016,Russian Federation,RUS,Austria,AUT,460,92,359,181,1092
2016,Rwanda,RWA,Austria,AUT,0,0,5,0,5
2016,Serbia and Kosovo: S/RES/1244 (1999),SRB,Austria,AUT,16,29,379,227,651
2016,Senegal,SEN,Austria,AUT,0,0,18,26,44
2016,Sierra Leone,SLE,Austria,AUT,0,0,0,11,11
2016,Somalia,SOM,Austria,AUT,494,384,20,149,1047
2016,Viet Nam,VNM,Austria,AUT,0,0,5,18,23
2016,Sudan,SDN,Austria,AUT,25,13,11,28,77
2016,Syrian Arab Rep.,SYR,Austria,AUT,15529,586,0,1130,17245
2016,Thailand,THA,Austria,AUT,0,0,0,5,5
2016,Tajikistan,TJK,Austria,AUT,55,0,14,0,69
2016,Togo,TGO,Austria,AUT,0,0,0,5,5
2016,Tunisia,TUN,Austria,AUT,0,0,68,67,135
2016,Turkey,TUR,Austria,AUT,10,5,40,201,256
2016,Uganda,UGA,Austria,AUT,5,0,0,5,10
2016,Ukraine,UKR,Austria,AUT,22,22,67,125,236
2016,Uzbekistan,UZB,Austria,AUT,5,0,13,0,18
2016,Western Sahara,ESH,Austria,AUT,0,0,0,5,5
2016,Yemen,YEM,Austria,AUT,22,5,0,10,37
2016,Central African Rep.,CAF,Chad,TCD,901,0,10,10,921
2016,Cameroon,CMR,Chad,TCD,0,0,0,5,5
2016,Dem. Rep. of the Congo,COD,Chad,TCD,10,0,0,73,83
2016,Eritrea,ERI,Chad,TCD,0,0,0,5,5
2016,Ethiopia,ETH,Chad,TCD,0,0,0,13,13
2016,Guinea,GIN,Chad,TCD,0,0,0,5,5
2016,Cote d'Ivoire,CIV,Chad,TCD,0,0,0,14,14
2016,Libya,LBY,Chad,TCD,0,0,0,13,13
2016,Nigeria,NGA,Chad,TCD,0,0,0,23,23
2016,Senegal,SEN,Chad,TCD,0,0,0,5,5
2016,Somalia,SOM,Chad,TCD,0,0,0,21,21
2016,Sudan,SDN,Chad,TCD,13,0,0,10,23
2016,Syrian Arab Rep.,SYR,Chad,TCD,5,0,0,15,20
2016,Central African Rep.,CAF,Congo,COG,12,0,0,0,12
2016,Dem. Rep. of the Congo,COD,Congo,COG,17,0,0,0,17
2016,Rwanda,RWA,Congo,COG,5,0,0,0,5
2016,Central African Rep.,CAF,Gabon,GAB,0,0,26,0,26
2016,Chad,TCD,Gabon,GAB,0,0,10,0,10
2016,Congo,COG,Gabon,GAB,0,0,5,0,5
2016,Dem. Rep. of the Congo,COD,Gabon,GAB,0,5,39,11,55
2016,Nicaragua,NIC,Honduras,HND,0,0,0,5,5
2016,Syrian Arab Rep.,SYR,Honduras,HND,0,0,0,5,5
2016,Afghanistan,AFG,Hungary,HUN,28,69,1484,15170,16751
2016,Albania,ALB,Hungary,HUN,0,0,5,27,32
2016,Algeria,DZA,Hungary,HUN,0,0,176,479,655
2016,Egypt,EGY,Hungary,HUN,0,0,41,194,235
2016,Armenia,ARM,Hungary,HUN,0,0,15,0,15
2016,Azerbaijan,AZE,Hungary,HUN,0,0,5,0,5
2016,Bangladesh,BGD,Hungary,HUN,0,0,91,1000,1091
2016,Burkina Faso,BFA,Hungary,HUN,0,0,5,0,5
2016,Bosnia and Herzegovina,BIH,Hungary,HUN,0,0,0,5,5
2016,China,CHN,Hungary,HUN,0,0,5,14,19
2016,Cameroon,CMR,Hungary,HUN,5,0,12,61,78
2016,Congo,COG,Hungary,HUN,0,0,10,80,90
2016,Dem. Rep. of the Congo,COD,Hungary,HUN,10,0,12,70,92
2016,Comoros,COM,Hungary,HUN,0,0,0,5,5
2016,Cuba,CUB,Hungary,HUN,5,0,56,61,122
2016,Dominican Rep.,DOM,Hungary,HUN,0,0,0,5,5
2016,Eritrea,ERI,Hungary,HUN,0,0,5,137,142
2016,Ethiopia,ETH,Hungary,HUN,5,0,10,36,51
2016,Gambia,GMB,Hungary,HUN,0,0,0,30,30
2016,Palestinian,PSE,Hungary,HUN,5,5,31,230,271
2016,Georgia,GEO,Hungary,HUN,0,0,14,0,14
2016,Ghana,GHA,Hungary,HUN,0,0,10,36,46
2016,Guinea,GIN,Hungary,HUN,0,0,11,16,27
2016,Haiti,HTI,Hungary,HUN,0,0,0,5,5
2016,Cote d'Ivoire,CIV,Hungary,HUN,0,0,10,26,36
2016,India,IND,Hungary,HUN,0,0,47,141,188
2016,Indonesia,IDN,Hungary,HUN,0,0,0,5,5
2016,Iran (Islamic Rep. of),IRN,Hungary,HUN,16,0,187,1395,1598
2016,Iraq,IRQ,Hungary,HUN,12,60,484,4513,5069
2016,Jordan,JOR,Hungary,HUN,0,0,0,10,10
2016,Liberia,LBR,Hungary,HUN,0,0,0,5,5
2016,Libya,LBY,Hungary,HUN,0,0,17,106,123
2016,Lebanon,LBN,Hungary,HUN,0,0,5,22,27
2016,Sri Lanka,LKA,Hungary,HUN,0,0,19,222,241
2016,Mauritania,MRT,Hungary,HUN,0,0,0,16,16
2016,Mali,MLI,Hungary,HUN,0,0,5,42,47
2016,Mongolia,MNG,Hungary,HUN,0,0,5,12,17
2016,Morocco,MAR,Hungary,HUN,0,0,219,791,1010
2016,Montenegro,MNE,Hungary,HUN,0,0,0,12,12
2016,Myanmar,MMR,Hungary,HUN,0,0,0,18,18
2016,Nepal,NPL,Hungary,HUN,0,0,11,48,59
2016,Niger,NER,Hungary,HUN,0,0,0,5,5
2016,Nigeria,NGA,Hungary,HUN,5,5,63,156,229
2016,Pakistan,PAK,Hungary,HUN,5,5,535,6030,6575
2016,Russian Federation,RUS,Hungary,HUN,0,0,11,0,11
2016,Serbia and Kosovo: S/RES/1244 (1999),SRB,Hungary,HUN,0,0,36,445,481
2016,Senegal,SEN,Hungary,HUN,0,0,10,87,97
2016,Sierra Leone,SLE,Hungary,HUN,0,0,0,18,18
2016,Somalia,SOM,Hungary,HUN,17,18,20,333,388
2016,Viet Nam,VNM,Hungary,HUN,0,0,5,0,5
2016,Sudan,SDN,Hungary,HUN,5,0,13,48,66
2016,South Sudan,SSD,Hungary,HUN,0,0,0,5,5
2016,Syrian Arab Rep.,SYR,Hungary,HUN,10,84,907,16555,17556
2016,United Rep. of Tanzania,TZA,Hungary,HUN,0,0,0,5,5
2016,Tajikistan,TJK,Hungary,HUN,0,0,13,42,55
2016,Togo,TGO,Hungary,HUN,0,0,0,5,5
2016,Tunisia,TUN,Hungary,HUN,0,0,15,54,69
2016,Turkey,TUR,Hungary,HUN,0,0,27,412,439
2016,United Arab Emirates,ARE,Hungary,HUN,0,0,0,5,5
2016,Uganda,UGA,Hungary,HUN,0,0,0,14,14
2016,Ukraine,UKR,Hungary,HUN,5,0,5,20,30
2016,Western Sahara,ESH,Hungary,HUN,0,0,0,11,11
2016,Yemen,YEM,Hungary,HUN,0,5,0,20,25
2016,Stateless,XXA,Hungary,HUN,0,0,0,5,5
2016,Afghanistan,AFG,Rep. of Korea,KOR,0,0,10,10,20
2016,Algeria,DZA,Rep. of Korea,KOR,0,0,5,0,5
2016,Egypt,EGY,Rep. of Korea,KOR,5,0,1028,92,1125
2016,Burundi,BDI,Rep. of Korea,KOR,0,0,5,0,5
2016,Bangladesh,BGD,Rep. of Korea,KOR,10,0,247,52,309
2016,Cambodia,KHM,Rep. of Korea,KOR,0,0,31,16,47
2016,China,CHN,Rep. of Korea,KOR,0,0,714,77,791
2016,Cameroon,CMR,Rep. of Korea,KOR,0,0,149,5,154
2016,Dem. Rep. of the Congo,COD,Rep. of Korea,KOR,0,0,10,0,10
2016,Ethiopia,ETH,Rep. of Korea,KOR,15,0,0,0,15
2016,Gambia,GMB,Rep. of Korea,KOR,0,0,14,0,14
2016,Ghana,GHA,Rep. of Korea,KOR,0,0,248,10,258
2016,Guinea,GIN,Rep. of Korea,KOR,0,0,19,0,19
2016,Cote d'Ivoire,CIV,Rep. of Korea,KOR,0,0,25,0,25
2016,India,IND,Rep. of Korea,KOR,0,0,151,51,202
2016,Indonesia,IDN,Rep. of Korea,KOR,0,0,10,0,10
2016,Iran (Islamic Rep. of),IRN,Rep. of Korea,KOR,0,0,11,0,11
2016,Iraq,IRQ,Rep. of Korea,KOR,0,10,18,14,42
2016,Jordan,JOR,Rep. of Korea,KOR,0,0,26,0,26
2016,Kazakhstan,KAZ,Rep. of Korea,KOR,5,0,135,39,179
2016,Kenya,KEN,Rep. of Korea,KOR,0,0,14,5,19
2016,Kyrgyzstan,KGZ,Rep. of Korea,KOR,0,0,27,10,37
2016,Liberia,LBR,Rep. of Korea,KOR,0,0,144,10,154
2016,Libya,LBY,Rep. of Korea,KOR,0,0,10,0,10
2016,Lesotho,LSO,Rep. of Korea,KOR,0,0,0,5,5
2016,Sri Lanka,LKA,Rep. of Korea,KOR,0,0,63,10,73
2016,Mali,MLI,Rep. of Korea,KOR,0,0,5,0,5
2016,Mongolia,MNG,Rep. of Korea,KOR,0,0,5,0,5
2016,Morocco,MAR,Rep. of Korea,KOR,0,0,101,10,111
2016,Myanmar,MMR,Rep. of Korea,KOR,0,0,24,0,24
2016,Nepal,NPL,Rep. of Korea,KOR,0,0,170,13,183
2016,Nigeria,NGA,Rep. of Korea,KOR,0,0,410,10,420
2016,Pakistan,PAK,Rep. of Korea,KOR,5,0,829,111,945
2016,Philippines,PHL,Rep. of Korea,KOR,0,0,101,5,106
2016,South Africa,ZAF,Rep. of Korea,KOR,0,0,105,19,124
2016,Russian Federation,RUS,Rep. of Korea,KOR,0,0,64,12,76
2016,Senegal,SEN,Rep. of Korea,KOR,0,0,45,0,45
2016,Sierra Leone,SLE,Rep. of Korea,KOR,0,0,0,5,5
2016,Viet Nam,VNM,Rep. of Korea,KOR,0,0,191,48,239
2016,Sudan,SDN,Rep. of Korea,KOR,0,0,18,0,18
2016,Syrian Arab Rep.,SYR,Rep. of Korea,KOR,0,229,5,12,246
2016,Thailand,THA,Rep. of Korea,KOR,0,0,71,18,89
2016,Tajikistan,TJK,Rep. of Korea,KOR,0,0,5,0,5
2016,Togo,TGO,Rep. of Korea,KOR,0,0,5,0,5
2016,Tunisia,TUN,Rep. of Korea,KOR,0,0,13,5,18
2016,Uganda,UGA,Rep. of Korea,KOR,5,0,97,5,107
2016,Ukraine,UKR,Rep. of Korea,KOR,0,0,14,0,14
2016,Uzbekistan,UZB,Rep. of Korea,KOR,0,0,92,32,124
2016,Yemen,YEM,Rep. of Korea,KOR,5,0,50,10,65
2016,Zimbabwe,ZWE,Rep. of Korea,KOR,0,0,5,0,5
2016,Stateless,XXA,Rep. of Korea,KOR,0,0,5,0,5
2016,Afghanistan,AFG,North Macedonia,MKD,0,5,5,157,167
2016,Algeria,DZA,North Macedonia,MKD,0,0,0,13,13
2016,Egypt,EGY,North Macedonia,MKD,0,0,0,5,5
2016,Bangladesh,BGD,North Macedonia,MKD,0,0,0,5,5
2016,Eritrea,ERI,North Macedonia,MKD,0,0,0,5,5
2016,Ethiopia,ETH,North Macedonia,MKD,0,0,0,5,5
2016,Palestinian,PSE,North Macedonia,MKD,0,0,0,13,13
2016,India,IND,North Macedonia,MKD,0,0,0,5,5
2016,Iran (Islamic Rep. of),IRN,North Macedonia,MKD,0,0,12,80,92
2016,Iraq,IRQ,North Macedonia,MKD,0,0,0,65,65
2016,Libya,LBY,North Macedonia,MKD,0,0,0,14,14
2016,Sri Lanka,LKA,North Macedonia,MKD,0,0,0,5,5
2016,Morocco,MAR,North Macedonia,MKD,0,0,0,40,40
2016,Pakistan,PAK,North Macedonia,MKD,0,0,0,121,121
2016,Somalia,SOM,North Macedonia,MKD,0,0,5,5,10
2016,Syrian Arab Rep.,SYR,North Macedonia,MKD,0,0,19,171,190
2016,Afghanistan,AFG,Montenegro,MNE,0,0,0,31,31
2016,Albania,ALB,Montenegro,MNE,0,0,5,0,5
2016,Algeria,DZA,Montenegro,MNE,0,0,0,12,12
2016,Bangladesh,BGD,Montenegro,MNE,0,0,0,5,5
2016,Cuba,CUB,Montenegro,MNE,12,0,0,0,12
2016,Palestinian,PSE,Montenegro,MNE,0,0,0,5,5
2016,Guinea,GIN,Montenegro,MNE,0,0,0,5,5
2016,India,IND,Montenegro,MNE,0,0,0,5,5
2016,Iran (Islamic Rep. of),IRN,Montenegro,MNE,0,0,0,19,19
2016,Iraq,IRQ,Montenegro,MNE,0,0,0,17,17
2016,Morocco,MAR,Montenegro,MNE,0,0,0,65,65
2016,Pakistan,PAK,Montenegro,MNE,0,0,0,18,18
2016,Russian Federation,RUS,Montenegro,MNE,0,0,5,0,5
2016,Serbia and Kosovo: S/RES/1244 (1999),SRB,Montenegro,MNE,0,0,5,0,5
2016,Somalia,SOM,Montenegro,MNE,0,0,0,5,5
2016,Syrian Arab Rep.,SYR,Montenegro,MNE,0,10,0,24,34
2016,Tunisia,TUN,Montenegro,MNE,0,0,0,5,5
2016,Turkey,TUR,Montenegro,MNE,0,0,5,0,5
2016,Ukraine,UKR,Montenegro,MNE,0,0,5,0,5
2016,Yemen,YEM,Montenegro,MNE,5,0,0,0,5
2016,Afghanistan,AFG,Philippines,PHL,5,0,0,0,5
2016,Burundi,BDI,Philippines,PHL,10,0,0,0,10
2016,Cambodia,KHM,Philippines,PHL,5,0,0,0,5
2016,Eritrea,ERI,Philippines,PHL,12,0,0,0,12
2016,Ethiopia,ETH,Philippines,PHL,0,0,5,0,5
2016,Palestinian,PSE,Philippines,PHL,5,0,0,0,5
2016,Cote d'Ivoire,CIV,Philippines,PHL,5,0,0,0,5
2016,Iran (Islamic Rep. of),IRN,Philippines,PHL,5,0,0,0,5
2016,Pakistan,PAK,Philippines,PHL,18,0,0,5,23
2016,Somalia,SOM,Philippines,PHL,5,0,5,0,10
2016,Syrian Arab Rep.,SYR,Philippines,PHL,16,0,0,0,16
2016,Afghanistan,AFG,Senegal,SEN,10,0,0,0,10
2016,Central African Rep.,CAF,Senegal,SEN,0,153,0,0,153
2016,Dem. Rep. of the Congo,COD,Senegal,SEN,0,10,0,0,10
2016,Gambia,GMB,Senegal,SEN,26,14,0,0,40
2016,Afghanistan,AFG,Tajikistan,TJK,77,0,75,0,152
2016,Central African Rep.,CAF,Togo,TGO,33,0,50,0,83
2016,Dem. Rep. of the Congo,COD,Togo,TGO,5,0,0,0,5
2016,Cote d'Ivoire,CIV,Togo,TGO,0,0,25,0,25
2016,Mali,MLI,Togo,TGO,56,0,11,0,67
2016,Burundi,BDI,Uganda,UGA,671,0,25,573,1269
2016,Central African Rep.,CAF,Uganda,UGA,5,0,0,0,5
2016,Congo,COG,Uganda,UGA,0,0,0,5,5
2016,Dem. Rep. of the Congo,COD,Uganda,UGA,11850,0,1379,433,13662
2016,Eritrea,ERI,Uganda,UGA,522,0,1252,451,2225
2016,Ethiopia,ETH,Uganda,UGA,269,0,110,398,777
2016,India,IND,Uganda,UGA,0,0,0,26,26
2016,Kenya,KEN,Uganda,UGA,0,0,0,10,10
2016,Pakistan,PAK,Uganda,UGA,45,0,166,5,216
2016,Rwanda,RWA,Uganda,UGA,135,0,109,174,418
2016,Somalia,SOM,Uganda,UGA,5030,0,0,249,5279
2016,Sudan,SDN,Uganda,UGA,176,0,5,33,214
2016,South Sudan,SSD,Uganda,UGA,20,0,0,15,35
2016,Yemen,YEM,Uganda,UGA,31,0,0,0,31
2017,Afghanistan,AFG,Austria,AUT,4274,3248,564,1925,10011
2017,Albania,ALB,Austria,AUT,0,11,70,10,91
2017,Algeria,DZA,Austria,AUT,0,0,342,204,546
2017,Angola,AGO,Austria,AUT,5,0,0,0,5
2017,Egypt,EGY,Austria,AUT,27,0,75,42,144
2017,Armenia,ARM,Austria,AUT,22,10,123,45,200
2017,Azerbaijan,AZE,Austria,AUT,19,5,15,5,44
2017,Benin,BEN,Austria,AUT,0,0,5,0,5
2017,Bangladesh,BGD,Austria,AUT,38,5,53,74,170
2017,Belarus,BLR,Austria,AUT,5,0,15,5,25
2017,Bosnia and Herzegovina,BIH,Austria,AUT,5,0,33,16,54
2017,Canada,CAN,Austria,AUT,5,0,0,0,5
2017,China,CHN,Austria,AUT,65,5,111,116,297
2017,Chile,CHL,Austria,AUT,0,0,5,0,5
2017,Cameroon,CMR,Austria,AUT,20,0,20,14,54
2017,Congo,COG,Austria,AUT,15,0,5,0,20
2017,Dem. Rep. of the Congo,COD,Austria,AUT,40,5,20,5,70
2017,Cuba,CUB,Austria,AUT,0,0,0,5,5
2017,Czechia,CZE,Austria,AUT,0,0,0,5,5
2017,Eritrea,ERI,Austria,AUT,62,32,0,19,113
2017,Ethiopia,ETH,Austria,AUT,31,22,5,11,69
2017,Gabon,GAB,Austria,AUT,0,0,5,0,5
2017,Gambia,GMB,Austria,AUT,16,0,38,23,77
2017,Georgia,GEO,Austria,AUT,5,33,183,96,317
2017,Ghana,GHA,Austria,AUT,5,0,34,5,44
2017,Guinea-Bissau,GNB,Austria,AUT,0,0,5,0,5
2017,Guinea,GIN,Austria,AUT,11,0,5,10,26
2017,Hungary,HUN,Austria,AUT,0,0,0,5,5
2017,Cote d'Ivoire,CIV,Austria,AUT,5,0,5,5,15
2017,India,IND,Austria,AUT,0,5,288,120,413
2017,Iran (Islamic Rep. of),IRN,Austria,AUT,1304,25,49,376,1754
2017,Iraq,IRQ,Austria,AUT,1160,1057,305,996,3518
2017,Jordan,JOR,Austria,AUT,17,0,0,5,22
2017,Kazakhstan,KAZ,Austria,AUT,12,0,26,0,38
2017,Kenya,KEN,Austria,AUT,0,0,5,0,5
2017,Kyrgyzstan,KGZ,Austria,AUT,5,5,11,0,21
2017,Liberia,LBR,Austria,AUT,0,5,0,5,10
2017,Libya,LBY,Austria,AUT,17,22,17,80,136
2017,Lebanon,LBN,Austria,AUT,13,0,16,26,55
2017,Sri Lanka,LKA,Austria,AUT,14,0,5,24,43
2017,Mauritania,MRT,Austria,AUT,0,0,0,5,5
2017,North Macedonia,MKD,Austria,AUT,0,0,113,21,134
2017,Rep. of Moldova,MDA,Austria,AUT,0,0,14,0,14
2017,Mali,MLI,Austria,AUT,0,0,0,5,5
2017,Mongolia,MNG,Austria,AUT,5,14,47,35,101
2017,Morocco,MAR,Austria,AUT,0,5,224,103,332
2017,Montenegro,MNE,Austria,AUT,0,0,5,0,5
2017,Myanmar,MMR,Austria,AUT,5,0,0,0,5
2017,Nepal,NPL,Austria,AUT,5,0,11,14,30
2017,Nigeria,NGA,Austria,AUT,15,29,344,236,624
2017,New Zealand,NZL,Austria,AUT,0,0,5,0,5
2017,Pakistan,PAK,Austria,AUT,35,15,713,881,1644
2017,Philippines,PHL,Austria,AUT,5,0,0,0,5
2017,Romania,ROU,Austria,AUT,0,0,0,5,5
2017,Russian Federation,RUS,Austria,AUT,520,71,372,200,1163
2017,Rwanda,RWA,Austria,AUT,0,0,5,0,5
2017,Saudi Arabia,SAU,Austria,AUT,0,0,0,5,5
2017,Serbia and Kosovo: S/RES/1244 (1999),SRB,Austria,AUT,11,12,262,71,356
2017,Senegal,SEN,Austria,AUT,5,0,5,5,15
2017,Sierra Leone,SLE,Austria,AUT,0,0,5,12,17
2017,Somalia,SOM,Austria,AUT,714,1007,37,128,1886
2017,Viet Nam,VNM,Austria,AUT,0,0,5,12,17
2017,Sudan,SDN,Austria,AUT,28,13,17,10,68
2017,Slovakia,SVK,Austria,AUT,0,0,0,5,5
2017,Syrian Arab Rep.,SYR,Austria,AUT,11827,1194,19,528,13568
2017,United Rep. of Tanzania,TZA,Austria,AUT,0,0,5,0,5
2017,Tajikistan,TJK,Austria,AUT,21,5,21,5,52
2017,Togo,TGO,Austria,AUT,5,0,0,0,5
2017,Tunisia,TUN,Austria,AUT,0,0,56,30,86
2017,Turkey,TUR,Austria,AUT,31,0,99,88,218
2017,Uganda,UGA,Austria,AUT,14,0,0,0,14
2017,Ukraine,UKR,Austria,AUT,10,13,247,183,453
2017,United States of America,USA,Austria,AUT,0,0,5,0,5
2017,Uzbekistan,UZB,Austria,AUT,0,0,15,5,20
2017,Venezuela (Bolivarian Republic of),VEN,Austria,AUT,0,5,0,5,10
2017,Western Sahara,ESH,Austria,AUT,0,0,0,5,5
2017,Yemen,YEM,Austria,AUT,25,81,0,10,116
2017,Afghanistan,AFG,Bulgaria,BGR,17,5,1041,5628,6691
2017,Algeria,DZA,Bulgaria,BGR,0,0,19,10,29
2017,Egypt,EGY,Bulgaria,BGR,0,0,5,0,5
2017,Armenia,ARM,Bulgaria,BGR,0,0,5,0,5
2017,Bangladesh,BGD,Bulgaria,BGR,0,0,18,11,29
2017,China,CHN,Bulgaria,BGR,0,0,5,0,5
2017,Congo,COG,Bulgaria,BGR,0,0,5,0,5
2017,Dem. Rep. of the Congo,COD,Bulgaria,BGR,0,0,5,0,5
2017,Ghana,GHA,Bulgaria,BGR,0,0,10,0,10
2017,Guinea,GIN,Bulgaria,BGR,0,0,5,0,5
2017,Cote d'Ivoire,CIV,Bulgaria,BGR,0,0,5,0,5
2017,India,IND,Bulgaria,BGR,0,0,5,0,5
2017,Iran (Islamic Rep. of),IRN,Bulgaria,BGR,0,0,117,272,389
2017,Iraq,IRQ,Bulgaria,BGR,41,73,835,2255,3204
2017,Lebanon,LBN,Bulgaria,BGR,0,0,0,10,10
2017,Sri Lanka,LKA,Bulgaria,BGR,0,0,5,11,16
2017,Mali,MLI,Bulgaria,BGR,0,0,5,0,5
2017,Morocco,MAR,Bulgaria,BGR,0,0,0,5,5
2017,Nepal,NPL,Bulgaria,BGR,0,0,0,5,5
2017,Nigeria,NGA,Bulgaria,BGR,0,0,5,0,5
2017,Pakistan,PAK,Bulgaria,BGR,5,0,157,1026,1188
2017,Russian Federation,RUS,Bulgaria,BGR,0,0,10,0,10
2017,Somalia,SOM,Bulgaria,BGR,0,0,11,0,11
2017,Syrian Arab Rep.,SYR,Bulgaria,BGR,726,802,95,398,2021
2017,Tunisia,TUN,Bulgaria,BGR,0,0,5,0,5
2017,Turkey,TUR,Bulgaria,BGR,0,0,5,5,10
2017,Ukraine,UKR,Bulgaria,BGR,0,0,24,5,29
2017,Stateless,XXA,Bulgaria,BGR,15,12,5,20,52
2017,Burundi,BDI,Central African Rep.,CAF,5,0,0,0,5
2017,Dem. Rep. of the Congo,COD,Central African Rep.,CAF,0,10,0,0,10
2017,Rwanda,RWA,Central African Rep.,CAF,5,0,0,0,5
2017,Turkey,TUR,Central African Rep.,CAF,5,0,0,0,5
2017,Burundi,BDI,Chad,TCD,5,0,0,0,5
2017,Central African Rep.,CAF,Chad,TCD,199,0,0,0,199
2017,Cameroon,CMR,Chad,TCD,0,0,0,513,513
2017,Dem. Rep. of the Congo,COD,Chad,TCD,49,0,0,0,49
2017,Eritrea,ERI,Chad,TCD,5,0,0,0,5
2017,Ethiopia,ETH,Chad,TCD,5,0,0,0,5
2017,Libya,LBY,Chad,TCD,10,0,0,0,10
2017,Nigeria,NGA,Chad,TCD,0,0,0,816,816
2017,Sudan,SDN,Chad,TCD,10,0,0,0,10
2017,South Sudan,SSD,Chad,TCD,5,0,0,0,5
2017,Syrian Arab Rep.,SYR,Chad,TCD,10,0,0,0,10
2017,Turkey,TUR,Chad,TCD,5,0,0,0,5
2017,Afghanistan,AFG,Ecuador,ECU,0,0,0,10,10
2017,Algeria,DZA,Ecuador,ECU,0,0,0,5,5
2017,Angola,AGO,Ecuador,ECU,0,0,0,5,5
2017,Egypt,EGY,Ecuador,ECU,0,0,0,5,5
2017,Argentina,ARG,Ecuador,ECU,0,0,0,18,18
2017,Bangladesh,BGD,Ecuador,ECU,0,0,0,10,10
2017,Bolivia (Plurinational State of),BOL,Ecuador,ECU,0,0,0,13,13
2017,Botswana,BWA,Ecuador,ECU,0,0,0,5,5
2017,Brazil,BRA,Ecuador,ECU,0,0,0,5,5
2017,China,CHN,Ecuador,ECU,0,0,0,19,19
2017,Chile,CHL,Ecuador,ECU,0,0,0,21,21
2017,Cameroon,CMR,Ecuador,ECU,0,0,0,24,24
2017,Congo,COG,Ecuador,ECU,0,0,0,5,5
2017,Colombia,COL,Ecuador,ECU,217,0,456,12276,12949
2017,Cuba,CUB,Ecuador,ECU,0,0,5,1578,1583
2017,Dominican Rep.,DOM,Ecuador,ECU,0,0,0,52,52
2017,Eritrea,ERI,Ecuador,ECU,0,0,0,5,5
2017,Ethiopia,ETH,Ecuador,ECU,0,0,0,5,5
2017,Ghana,GHA,Ecuador,ECU,0,0,0,10,10
2017,Guinea,GIN,Ecuador,ECU,0,0,0,10,10
2017,Haiti,HTI,Ecuador,ECU,0,0,10,182,192
2017,Cote d'Ivoire,CIV,Ecuador,ECU,0,0,0,5,5
2017,India,IND,Ecuador,ECU,0,0,0,10,10
2017,Iraq,IRQ,Ecuador,ECU,0,0,0,12,12
2017,Italy,ITA,Ecuador,ECU,0,0,0,5,5
2017,Lebanon,LBN,Ecuador,ECU,0,0,0,5,5
2017,Sri Lanka,LKA,Ecuador,ECU,0,0,0,10,10
2017,Mexico,MEX,Ecuador,ECU,0,0,0,12,12
2017,Mali,MLI,Ecuador,ECU,0,0,0,5,5
2017,Nepal,NPL,Ecuador,ECU,0,0,0,5,5
2017,Nigeria,NGA,Ecuador,ECU,0,0,0,60,60
2017,Pakistan,PAK,Ecuador,ECU,0,0,0,27,27
2017,Peru,PER,Ecuador,ECU,0,0,5,3405,3410
2017,South Africa,ZAF,Ecuador,ECU,0,0,0,5,5
2017,Russian Federation,RUS,Ecuador,ECU,0,0,0,5,5
2017,El Salvador,SLV,Ecuador,ECU,0,0,0,5,5
2017,Sierra Leone,SLE,Ecuador,ECU,0,0,0,5,5
2017,Spain,ESP,Ecuador,ECU,0,0,0,12,12
2017,Sudan,SDN,Ecuador,ECU,0,0,0,5,5
2017,Syrian Arab Rep.,SYR,Ecuador,ECU,0,0,5,5,10
2017,Togo,TGO,Ecuador,ECU,0,0,0,5,5
2017,Turkey,TUR,Ecuador,ECU,0,0,0,28,28
2017,United States of America,USA,Ecuador,ECU,0,0,0,11,11
2017,Venezuela (Bolivarian Republic of),VEN,Ecuador,ECU,0,0,109,649,758
2017,Yemen,YEM,Ecuador,ECU,0,0,0,17,17
2017,Stateless,XXA,Ecuador,ECU,0,0,0,5,5
2017,Angola,AGO,Gabon,GAB,0,0,10,0,10
2017,Burundi,BDI,Gabon,GAB,0,0,5,0,5
2017,Central African Rep.,CAF,Gabon,GAB,0,11,284,0,295
2017,Chad,TCD,Gabon,GAB,0,23,612,5,640
2017,Dem. Rep. of the Congo,COD,Gabon,GAB,0,23,919,0,942
2017,Equatorial Guinea,GNQ,Gabon,GAB,0,0,5,0,5
2017,Liberia,LBR,Gabon,GAB,0,0,5,0,5
2017,Mauritania,MRT,Gabon,GAB,0,0,5,0,5
2017,Mali,MLI,Gabon,GAB,0,0,5,0,5
2017,Rwanda,RWA,Gabon,GAB,0,0,5,0,5
2017,Sierra Leone,SLE,Gabon,GAB,0,0,10,0,10
2017,South Sudan,SSD,Gabon,GAB,0,0,5,0,5
2017,Togo,TGO,Gabon,GAB,0,0,5,0,5
2017,Belarus,BLR,Israel,ISR,0,0,0,40,40
2017,Central African Rep.,CAF,Israel,ISR,0,0,0,5,5
2017,China,CHN,Israel,ISR,0,0,10,10,20
2017,Cameroon,CMR,Israel,ISR,0,0,5,0,5
2017,Dem. Rep. of the Congo,COD,Israel,ISR,0,0,0,5,5
2017,Colombia,COL,Israel,ISR,0,0,5,0,5
2017,Eritrea,ERI,Israel,ISR,0,0,787,374,1161
2017,Ethiopia,ETH,Israel,ISR,0,0,68,49,117
2017,Georgia,GEO,Israel,ISR,0,0,1117,540,1657
2017,Ghana,GHA,Israel,ISR,0,0,17,5,22
2017,Guinea,GIN,Israel,ISR,0,0,5,0,5
2017,Cote d'Ivoire,CIV,Israel,ISR,0,0,5,0,5
2017,India,IND,Israel,ISR,0,0,16,29,45
2017,Kazakhstan,KAZ,Israel,ISR,0,0,0,5,5
2017,Sri Lanka,LKA,Israel,ISR,0,0,27,18,45
2017,Rep. of Moldova,MDA,Israel,ISR,0,0,22,155,177
2017,Mongolia,MNG,Israel,ISR,0,0,5,15,20
2017,Myanmar,MMR,Israel,ISR,0,0,16,0,16
2017,Nigeria,NGA,Israel,ISR,0,0,35,17,52
2017,Philippines,PHL,Israel,ISR,0,0,0,5,5
2017,Romania,ROU,Israel,ISR,0,0,0,16,16
2017,South Africa,ZAF,Israel,ISR,0,0,0,23,23
2017,Russian Federation,RUS,Israel,ISR,0,0,5,168,173
2017,Sudan,SDN,Israel,ISR,0,0,16,71,87
2017,South Sudan,SSD,Israel,ISR,0,0,0,5,5
2017,Thailand,THA,Israel,ISR,0,0,11,0,11
2017,Turkey,TUR,Israel,ISR,0,0,0,5,5
2017,Uganda,UGA,Israel,ISR,0,0,5,0,5
2017,Ukraine,UKR,Israel,ISR,0,0,949,1876,2825
2017,Uzbekistan,UZB,Israel,ISR,0,0,5,18,23
2017,Afghanistan,AFG,Rep. of Korea,KOR,0,5,0,0,5
2017,Algeria,DZA,Rep. of Korea,KOR,0,0,32,5,37
2017,Angola,AGO,Rep. of Korea,KOR,0,0,5,0,5
2017,Egypt,EGY,Rep. of Korea,KOR,5,0,858,84,947
2017,Burundi,BDI,Rep. of Korea,KOR,0,13,0,0,13
2017,Bangladesh,BGD,Rep. of Korea,KOR,10,0,286,22,318
2017,Burkina Faso,BFA,Rep. of Korea,KOR,0,0,5,0,5
2017,Cambodia,KHM,Rep. of Korea,KOR,0,0,12,10,22
2017,China,CHN,Rep. of Korea,KOR,0,5,684,370,1059
2017,Cameroon,CMR,Rep. of Korea,KOR,0,0,96,10,106
2017,Dem. Rep. of the Congo,COD,Rep. of Korea,KOR,0,0,19,0,19
2017,Ethiopia,ETH,Rep. of Korea,KOR,23,5,25,10,63
2017,Gambia,GMB,Rep. of Korea,KOR,0,0,13,0,13
2017,Ghana,GHA,Rep. of Korea,KOR,0,0,86,5,91
2017,Guinea,GIN,Rep. of Korea,KOR,0,0,24,0,24
2017,Cote d'Ivoire,CIV,Rep. of Korea,KOR,0,0,20,0,20
2017,India,IND,Rep. of Korea,KOR,0,0,261,39,300
2017,Indonesia,IDN,Rep. of Korea,KOR,0,0,5,0,5
2017,Iran (Islamic Rep. of),IRN,Rep. of Korea,KOR,10,0,10,0,20
2017,Iraq,IRQ,Rep. of Korea,KOR,0,0,26,10,36
2017,Jordan,JOR,Rep. of Korea,KOR,5,0,15,0,20
2017,Kazakhstan,KAZ,Rep. of Korea,KOR,0,0,330,140,470
2017,Kenya,KEN,Rep. of Korea,KOR,0,0,17,0,17
2017,Kyrgyzstan,KGZ,Rep. of Korea,KOR,0,0,60,5,65
2017,Liberia,LBR,Rep. of Korea,KOR,0,0,108,5,113
2017,Libya,LBY,Rep. of Korea,KOR,0,0,5,0,5
2017,Lebanon,LBN,Rep. of Korea,KOR,0,0,5,0,5
2017,Sri Lanka,LKA,Rep. of Korea,KOR,0,0,59,13,72
2017,Mexico,MEX,Rep. of Korea,KOR,0,5,0,0,5
2017,Mali,MLI,Rep. of Korea,KOR,0,0,12,0,12
2017,Malaysia,MYS,Rep. of Korea,KOR,0,0,0,5,5
2017,Mongolia,MNG,Rep. of Korea,KOR,0,0,56,14,70
2017,Morocco,MAR,Rep. of Korea,KOR,0,0,96,30,126
2017,Myanmar,MMR,Rep. of Korea,KOR,36,5,5,0,46
2017,Nepal,NPL,Rep. of Korea,KOR,0,0,142,46,188
2017,Nigeria,NGA,Rep. of Korea,KOR,0,0,285,15,300
2017,Pakistan,PAK,Rep. of Korea,KOR,10,0,728,102,840
2017,Philippines,PHL,Rep. of Korea,KOR,0,0,255,12,267
2017,South Africa,ZAF,Rep. of Korea,KOR,0,0,82,12,94
2017,Russian Federation,RUS,Rep. of Korea,KOR,0,0,249,101,350
2017,Senegal,SEN,Rep. of Korea,KOR,0,0,53,0,53
2017,Sierra Leone,SLE,Rep. of Korea,KOR,0,0,5,0,5
2017,Viet Nam,VNM,Rep. of Korea,KOR,0,0,114,16,130
2017,Sudan,SDN,Rep. of Korea,KOR,5,0,62,0,67
2017,Syrian Arab Rep.,SYR,Rep. of Korea,KOR,0,246,16,17,279
2017,United Rep. of Tanzania,TZA,Rep. of Korea,KOR,0,5,5,0,10
2017,Thailand,THA,Rep. of Korea,KOR,5,0,92,29,126
2017,Tajikistan,TJK,Rep. of Korea,KOR,0,0,11,5,16
2017,Tunisia,TUN,Rep. of Korea,KOR,0,0,23,5,28
2017,Turkey,TUR,Rep. of Korea,KOR,0,0,10,0,10
2017,Uganda,UGA,Rep. of Korea,KOR,0,5,134,5,144
2017,Ukraine,UKR,Rep. of Korea,KOR,0,0,0,13,13
2017,Uzbekistan,UZB,Rep. of Korea,KOR,0,0,81,11,92
2017,Yemen,YEM,Rep. of Korea,KOR,11,28,16,19,74
2017,Afghanistan,AFG,North Macedonia,MKD,0,0,0,13,13
2017,Algeria,DZA,North Macedonia,MKD,0,0,0,5,5
2017,Iran (Islamic Rep. of),IRN,North Macedonia,MKD,0,0,0,16,16
2017,Iraq,IRQ,North Macedonia,MKD,0,0,0,11,11
2017,Pakistan,PAK,North Macedonia,MKD,0,0,0,66,66
2017,Serbia and Kosovo: S/RES/1244 (1999),SRB,North Macedonia,MKD,0,0,5,0,5
2017,Syrian Arab Rep.,SYR,North Macedonia,MKD,0,5,0,23,28
2017,Afghanistan,AFG,Montenegro,MNE,0,0,5,41,46
2017,Algeria,DZA,Montenegro,MNE,0,0,11,304,315
2017,Egypt,EGY,Montenegro,MNE,0,0,0,5,5
2017,Armenia,ARM,Montenegro,MNE,0,0,0,5,5
2017,Bangladesh,BGD,Montenegro,MNE,0,0,0,5,5
2017,Cuba,CUB,Montenegro,MNE,0,0,27,5,32
2017,Eritrea,ERI,Montenegro,MNE,0,0,0,5,5
2017,Palestinian,PSE,Montenegro,MNE,0,0,0,5,5
2017,India,IND,Montenegro,MNE,0,0,0,5,5
2017,Iran (Islamic Rep. of),IRN,Montenegro,MNE,0,0,0,40,40
2017,Iraq,IRQ,Montenegro,MNE,0,0,0,60,60
2017,Libya,LBY,Montenegro,MNE,0,0,0,5,5
2017,Morocco,MAR,Montenegro,MNE,0,0,5,60,65
2017,Nigeria,NGA,Montenegro,MNE,0,0,0,5,5
2017,Pakistan,PAK,Montenegro,MNE,0,0,0,69,69
2017,Russian Federation,RUS,Montenegro,MNE,0,0,0,11,11
2017,Somalia,SOM,Montenegro,MNE,0,0,0,5,5
2017,Syrian Arab Rep.,SYR,Montenegro,MNE,0,0,0,25,25
2017,Tunisia,TUN,Montenegro,MNE,0,0,0,12,12
2017,Ukraine,UKR,Montenegro,MNE,0,0,5,5,10
2017,Stateless,XXA,Montenegro,MNE,0,0,0,5,5
2017,Afghanistan,AFG,Philippines,PHL,5,0,0,0,5
2017,China,CHN,Philippines,PHL,0,0,0,5,5
2017,Cameroon,CMR,Philippines,PHL,0,0,5,0,5
2017,Palestinian,PSE,Philippines,PHL,5,0,0,0,5
2017,Cote d'Ivoire,CIV,Philippines,PHL,5,0,0,0,5
2017,Iran (Islamic Rep. of),IRN,Philippines,PHL,0,0,0,13,13
2017,Iraq,IRQ,Philippines,PHL,13,0,0,0,13
2017,Sri Lanka,LKA,Philippines,PHL,5,0,0,0,5
2017,Nigeria,NGA,Philippines,PHL,5,0,0,0,5
2017,Pakistan,PAK,Philippines,PHL,31,0,5,13,49
2017,Somalia,SOM,Philippines,PHL,5,0,5,5,15
2017,Viet Nam,VNM,Philippines,PHL,10,0,0,0,10
2017,Syrian Arab Rep.,SYR,Philippines,PHL,21,5,0,5,31
2017,Turkey,TUR,Philippines,PHL,0,0,0,14,14
2017,Yemen,YEM,Philippines,PHL,5,0,0,0,5
2017,Burundi,BDI,Senegal,SEN,5,0,0,0,5
2017,Central African Rep.,CAF,Senegal,SEN,82,0,0,22,104
2017,Gambia,GMB,Senegal,SEN,0,0,0,24,24
2017,Afghanistan,AFG,Slovakia,SVK,0,14,0,0,14
2017,Armenia,ARM,Slovakia,SVK,0,0,0,5,5
2017,Bangladesh,BGD,Slovakia,SVK,5,0,0,0,5
2017,China,CHN,Slovakia,SVK,0,0,0,5,5
2017,Cameroon,CMR,Slovakia,SVK,5,0,0,0,5
2017,Cuba,CUB,Slovakia,SVK,10,0,0,0,10
2017,Iraq,IRQ,Slovakia,SVK,5,0,0,12,17
2017,Libya,LBY,Slovakia,SVK,0,0,12,0,12
2017,Sri Lanka,LKA,Slovakia,SVK,0,0,0,5,5
2017,Morocco,MAR,Slovakia,SVK,0,0,5,5,10
2017,Nigeria,NGA,Slovakia,SVK,0,0,5,0,5
2017,Pakistan,PAK,Slovakia,SVK,0,0,10,5,15
2017,Poland,POL,Slovakia,SVK,0,0,0,5,5
2017,Viet Nam,VNM,Slovakia,SVK,0,0,0,19,19
2017,Syrian Arab Rep.,SYR,Slovakia,SVK,12,0,0,0,12
2017,Turkey,TUR,Slovakia,SVK,0,0,5,0,5
2017,Ukraine,UKR,Slovakia,SVK,0,12,5,0,17
2017,Afghanistan,AFG,Slovenia,SVN,5,0,188,454,647
2017,Albania,ALB,Slovenia,SVN,0,0,5,0,5
2017,Algeria,DZA,Slovenia,SVN,0,0,46,106,152
2017,Egypt,EGY,Slovenia,SVN,0,0,0,5,5
2017,Bangladesh,BGD,Slovenia,SVN,0,0,0,5,5
2017,China,CHN,Slovenia,SVN,0,0,0,10,10
2017,Cameroon,CMR,Slovenia,SVN,5,0,0,0,5
2017,Cuba,CUB,Slovenia,SVN,0,0,0,12,12
2017,Eritrea,ERI,Slovenia,SVN,31,0,0,0,31
2017,Palestinian,PSE,Slovenia,SVN,10,0,0,0,10
2017,India,IND,Slovenia,SVN,0,0,5,0,5
2017,Iran (Islamic Rep. of),IRN,Slovenia,SVN,5,0,33,42,80
2017,Iraq,IRQ,Slovenia,SVN,5,0,13,12,30
2017,Libya,LBY,Slovenia,SVN,0,0,0,27,27
2017,Sri Lanka,LKA,Slovenia,SVN,0,0,0,5,5
2017,Mongolia,MNG,Slovenia,SVN,0,0,0,5,5
2017,Morocco,MAR,Slovenia,SVN,0,0,10,27,37
2017,Nepal,NPL,Slovenia,SVN,0,0,0,5,5
2017,Nigeria,NGA,Slovenia,SVN,0,0,11,5,16
2017,Pakistan,PAK,Slovenia,SVN,0,0,64,71,135
2017,Russian Federation,RUS,Slovenia,SVN,0,0,5,0,5
2017,Serbia and Kosovo: S/RES/1244 (1999),SRB,Slovenia,SVN,0,0,25,40,65
2017,Somalia,SOM,Slovenia,SVN,0,0,5,0,5
2017,Syrian Arab Rep.,SYR,Slovenia,SVN,88,10,5,24,127
2017,Tunisia,TUN,Slovenia,SVN,0,0,5,10,15
2017,Turkey,TUR,Slovenia,SVN,0,0,32,83,115
2017,Ukraine,UKR,Slovenia,SVN,0,0,5,0,5
2017,Afghanistan,AFG,Tajikistan,TJK,56,0,53,0,109
2017,Central African Rep.,CAF,Togo,TGO,5,0,73,0,78
2017,Cameroon,CMR,Togo,TGO,0,0,5,0,5
2017,Dem. Rep. of the Congo,COD,Togo,TGO,5,0,0,0,5
2017,Gabon,GAB,Togo,TGO,0,0,5,0,5
2017,Cote d'Ivoire,CIV,Togo,TGO,5,0,74,0,79
2017,Liberia,LBR,Togo,TGO,0,0,5,0,5
2017,Mali,MLI,Togo,TGO,0,0,15,0,15
2017,Egypt,EGY,Uganda,UGA,0,0,5,0,5
2017,Burundi,BDI,Uganda,UGA,5045,0,78,878,6001
2017,Bangladesh,BGD,Uganda,UGA,0,0,5,0,5
2017,Central African Rep.,CAF,Uganda,UGA,5,0,0,0,5
2017,Chad,TCD,Uganda,UGA,0,0,5,0,5
2017,Congo,COG,Uganda,UGA,53,0,5,0,58
2017,Dem. Rep. of the Congo,COD,Uganda,UGA,36552,0,3417,0,39969
2017,Eritrea,ERI,Uganda,UGA,1557,0,3013,0,4570
2017,Ethiopia,ETH,Uganda,UGA,718,0,280,0,998
2017,India,IND,Uganda,UGA,0,0,5,0,5
2017,Kenya,KEN,Uganda,UGA,5,0,14,186,205
2017,Mali,MLI,Uganda,UGA,0,0,5,0,5
2017,Pakistan,PAK,Uganda,UGA,195,0,224,0,419
2017,Rwanda,RWA,Uganda,UGA,301,0,377,1358,2036
2017,Somalia,SOM,Uganda,UGA,13426,0,10,25,13461
2017,Sudan,SDN,Uganda,UGA,763,0,21,0,784
2017,South Sudan,SSD,Uganda,UGA,152,0,0,460,612
2017,Syrian Arab Rep.,SYR,Uganda,UGA,0,0,13,0,13
2017,Yemen,YEM,Uganda,UGA,35,0,0,0,35
2018,Afghanistan,AFG,Austria,AUT,4979,2062,1825,914,9780
2018,Albania,ALB,Austria,AUT,5,0,38,5,48
2018,Algeria,DZA,Austria,AUT,0,0,148,43,191
2018,Angola,AGO,Austria,AUT,0,5,5,0,10
2018,Egypt,EGY,Austria,AUT,26,0,98,16,140
2018,Armenia,ARM,Austria,AUT,5,13,168,32,218
2018,Azerbaijan,AZE,Austria,AUT,12,0,15,11,38
2018,Burundi,BDI,Austria,AUT,5,0,0,0,5
2018,Benin,BEN,Austria,AUT,0,0,12,0,12
2018,Bangladesh,BGD,Austria,AUT,30,14,67,34,145
2018,Burkina Faso,BFA,Austria,AUT,0,0,5,0,5
2018,Belarus,BLR,Austria,AUT,0,5,17,5,27
2018,Brazil,BRA,Austria,AUT,0,0,5,0,5
2018,Bosnia and Herzegovina,BIH,Austria,AUT,0,0,20,13,33
2018,Chad,TCD,Austria,AUT,5,0,0,0,5
2018,China,CHN,Austria,AUT,81,5,107,51,244
2018,Cameroon,CMR,Austria,AUT,15,5,14,0,34
2018,Congo,COG,Austria,AUT,5,0,5,0,10
2018,Dem. Rep. of the Congo,COD,Austria,AUT,18,10,24,0,52
2018,Colombia,COL,Austria,AUT,0,0,14,0,14
2018,Cuba,CUB,Austria,AUT,0,0,5,0,5
2018,Czechia,CZE,Austria,AUT,0,0,0,5,5
2018,Eritrea,ERI,Austria,AUT,39,24,0,5,68
2018,Ethiopia,ETH,Austria,AUT,22,15,10,5,52
2018,Gambia,GMB,Austria,AUT,10,0,60,10,80
2018,Georgia,GEO,Austria,AUT,5,30,410,84,529
2018,Germany,DEU,Austria,AUT,0,0,0,5,5
2018,Ghana,GHA,Austria,AUT,0,0,22,5,27
2018,Guinea-Bissau,GNB,Austria,AUT,0,0,5,0,5
2018,Guinea,GIN,Austria,AUT,5,0,20,5,30
2018,Cote d'Ivoire,CIV,Austria,AUT,5,0,5,5,15
2018,India,IND,Austria,AUT,0,0,305,81,386
2018,Iran (Islamic Rep. of),IRN,Austria,AUT,1370,51,140,172,1733
2018,Iraq,IRQ,Austria,AUT,731,536,525,609,2401
2018,Jordan,JOR,Austria,AUT,13,0,13,5,31
2018,Kazakhstan,KAZ,Austria,AUT,5,5,14,17,41
2018,Kenya,KEN,Austria,AUT,0,0,5,5,10
2018,Kyrgyzstan,KGZ,Austria,AUT,14,0,5,0,19
2018,Liberia,LBR,Austria,AUT,0,0,5,0,5
2018,Libya,LBY,Austria,AUT,0,14,5,29,48
2018,Lebanon,LBN,Austria,AUT,18,20,11,14,63
2018,Sri Lanka,LKA,Austria,AUT,5,0,15,15,35
2018,Mauritania,MRT,Austria,AUT,0,0,5,0,5
2018,North Macedonia,MKD,Austria,AUT,0,5,30,21,56
2018,Rep. of Moldova,MDA,Austria,AUT,0,0,12,14,26
2018,Mali,MLI,Austria,AUT,0,0,5,5,10
2018,Mongolia,MNG,Austria,AUT,0,0,47,10,57
2018,Morocco,MAR,Austria,AUT,0,5,95,28,128
2018,Myanmar,MMR,Austria,AUT,5,0,0,0,5
2018,Nepal,NPL,Austria,AUT,0,0,14,0,14
2018,Nigeria,NGA,Austria,AUT,18,29,567,87,701
2018,Pakistan,PAK,Austria,AUT,34,10,411,249,704
2018,Philippines,PHL,Austria,AUT,5,0,0,5,10
2018,Romania,ROU,Austria,AUT,0,0,5,0,5
2018,Russian Federation,RUS,Austria,AUT,526,109,602,161,1398
2018,Rwanda,RWA,Austria,AUT,10,0,0,0,10
2018,Serbia and Kosovo: S/RES/1244 (1999),SRB,Austria,AUT,18,10,179,58,265
2018,Senegal,SEN,Austria,AUT,5,0,20,0,25
2018,Sierra Leone,SLE,Austria,AUT,0,0,14,0,14
2018,Somalia,SOM,Austria,AUT,768,665,64,54,1551
2018,Viet Nam,VNM,Austria,AUT,0,0,5,5,10
2018,Sudan,SDN,Austria,AUT,30,10,5,5,50
2018,Slovakia,SVK,Austria,AUT,0,0,0,5,5
2018,Syrian Arab Rep.,SYR,Austria,AUT,4951,414,93,102,5560
2018,Tajikistan,TJK,Austria,AUT,53,5,17,5,80
2018,Togo,TGO,Austria,AUT,0,0,5,0,5
2018,Tunisia,TUN,Austria,AUT,0,0,51,19,70
2018,Turkey,TUR,Austria,AUT,84,5,100,71,260
2018,Uganda,UGA,Austria,AUT,11,0,0,0,11
2018,Ukraine,UKR,Austria,AUT,23,25,260,74,382
2018,Uzbekistan,UZB,Austria,AUT,5,0,36,5,46
2018,Venezuela (Bolivarian Republic of),VEN,Austria,AUT,0,0,5,0,5
2018,Yemen,YEM,Austria,AUT,69,29,0,5,103
2018,Afghanistan,AFG,Bulgaria,BGR,20,16,709,520,1265
2018,Algeria,DZA,Bulgaria,BGR,0,0,5,5,10
2018,Egypt,EGY,Bulgaria,BGR,5,0,10,0,15
2018,Bangladesh,BGD,Bulgaria,BGR,0,0,5,0,5
2018,China,CHN,Bulgaria,BGR,0,0,5,0,5
2018,Cameroon,CMR,Bulgaria,BGR,0,0,5,0,5
2018,Eritrea,ERI,Bulgaria,BGR,10,0,0,0,10
2018,Iran (Islamic Rep. of),IRN,Bulgaria,BGR,0,5,37,32,74
2018,Iraq,IRQ,Bulgaria,BGR,5,26,404,886,1321
2018,Kazakhstan,KAZ,Bulgaria,BGR,0,0,5,0,5
2018,Lebanon,LBN,Bulgaria,BGR,0,5,0,0,5
2018,Morocco,MAR,Bulgaria,BGR,0,0,5,0,5
2018,Myanmar,MMR,Bulgaria,BGR,0,0,0,5,5
2018,Nigeria,NGA,Bulgaria,BGR,0,0,5,0,5
2018,Pakistan,PAK,Bulgaria,BGR,10,0,115,46,171
2018,Syrian Arab Rep.,SYR,Bulgaria,BGR,261,351,11,74,697
2018,Tunisia,TUN,Bulgaria,BGR,0,0,5,0,5
2018,Turkey,TUR,Bulgaria,BGR,0,0,20,5,25
2018,Ukraine,UKR,Bulgaria,BGR,0,0,5,14,19
2018,Stateless,XXA,Bulgaria,BGR,0,19,5,0,24
2018,Chad,TCD,Central African Rep.,CAF,56,0,0,0,56
2018,Cameroon,CMR,Central African Rep.,CAF,5,0,14,0,19
2018,Dem. Rep. of the Congo,COD,Central African Rep.,CAF,99,0,0,72,171
2018,Liberia,LBR,Central African Rep.,CAF,5,0,0,0,5
2018,Rwanda,RWA,Central African Rep.,CAF,26,0,0,10,36
2018,Sudan,SDN,Central African Rep.,CAF,10,0,0,0,10
2018,South Sudan,SSD,Central African Rep.,CAF,14,0,0,0,14
2018,Turkey,TUR,Central African Rep.,CAF,14,0,0,0,14
2018,Central African Rep.,CAF,Chad,TCD,287,0,5,47,339
2018,Dem. Rep. of the Congo,COD,Chad,TCD,25,0,0,20,45
2018,Eritrea,ERI,Chad,TCD,5,0,0,0,5
2018,Ethiopia,ETH,Chad,TCD,11,0,0,0,11
2018,Libya,LBY,Chad,TCD,10,0,0,0,10
2018,Nigeria,NGA,Chad,TCD,5,0,0,0,5
2018,Sudan,SDN,Chad,TCD,35,0,5,0,40
2018,Syrian Arab Rep.,SYR,Chad,TCD,15,0,0,5,20
2018,Yemen,YEM,Chad,TCD,5,0,0,0,5
2018,Afghanistan,AFG,Ecuador,ECU,54,0,0,0,54
2018,Angola,AGO,Ecuador,ECU,0,0,16,0,16
2018,Egypt,EGY,Ecuador,ECU,5,0,0,0,5
2018,Argentina,ARG,Ecuador,ECU,0,0,5,0,5
2018,Chile,CHL,Ecuador,ECU,0,0,5,0,5
2018,Cameroon,CMR,Ecuador,ECU,5,0,5,0,10
2018,Dem. Rep. of the Congo,COD,Ecuador,ECU,0,0,18,0,18
2018,Colombia,COL,Ecuador,ECU,4468,0,1057,20,5545
2018,Cuba,CUB,Ecuador,ECU,0,0,27,0,27
2018,Iran (Islamic Rep. of),IRN,Ecuador,ECU,20,0,0,0,20
2018,Iraq,IRQ,Ecuador,ECU,26,0,0,0,26
2018,Libya,LBY,Ecuador,ECU,5,0,0,0,5
2018,Sri Lanka,LKA,Ecuador,ECU,5,0,0,0,5
2018,Nigeria,NGA,Ecuador,ECU,5,0,0,0,5
2018,Pakistan,PAK,Ecuador,ECU,5,0,0,0,5
2018,Panama,PAN,Ecuador,ECU,0,0,5,0,5
2018,Peru,PER,Ecuador,ECU,5,0,0,0,5
2018,Russian Federation,RUS,Ecuador,ECU,0,0,5,0,5
2018,El Salvador,SLV,Ecuador,ECU,15,0,0,0,15
2018,Saudi Arabia,SAU,Ecuador,ECU,0,0,5,0,5
2018,Spain,ESP,Ecuador,ECU,0,0,5,0,5
2018,Syrian Arab Rep.,SYR,Ecuador,ECU,64,0,17,0,81
2018,Ukraine,UKR,Ecuador,ECU,14,0,0,0,14
2018,Venezuela (Bolivarian Republic of),VEN,Ecuador,ECU,10,0,5905,5,5920
2018,Yemen,YEM,Ecuador,ECU,50,0,27,0,77
2018,Central African Rep.,CAF,Gabon,GAB,0,0,5,0,5
2018,Chad,TCD,Gabon,GAB,0,0,18,0,18
2018,Dem. Rep. of the Congo,COD,Gabon,GAB,0,0,23,0,23
2018,Central African Rep.,CAF,Cote d'Ivoire,CIV,95,0,0,76,171
2018,Chad,TCD,Cote d'Ivoire,CIV,0,0,0,5,5
2018,Dem. Rep. of the Congo,COD,Cote d'Ivoire,CIV,0,0,5,22,27
2018,Eritrea,ERI,Cote d'Ivoire,CIV,5,0,0,0,5
2018,Ethiopia,ETH,Cote d'Ivoire,CIV,5,0,0,0,5
2018,Palestinian,PSE,Cote d'Ivoire,CIV,0,0,0,5,5
2018,Guinea,GIN,Cote d'Ivoire,CIV,0,0,0,12,12
2018,Iraq,IRQ,Cote d'Ivoire,CIV,5,0,0,0,5
2018,Liberia,LBR,Cote d'Ivoire,CIV,0,0,5,24,29
2018,Mali,MLI,Cote d'Ivoire,CIV,0,0,0,17,17
2018,Nigeria,NGA,Cote d'Ivoire,CIV,0,0,0,17,17
2018,Somalia,SOM,Cote d'Ivoire,CIV,5,0,0,0,5
2018,Syrian Arab Rep.,SYR,Cote d'Ivoire,CIV,81,0,0,0,81
2018,Togo,TGO,Cote d'Ivoire,CIV,0,0,0,5,5
2018,Armenia,ARM,Israel,ISR,0,0,5,5,10
2018,Azerbaijan,AZE,Israel,ISR,0,0,0,12,12
2018,Belarus,BLR,Israel,ISR,0,0,13,80,93
2018,Chad,TCD,Israel,ISR,0,0,5,0,5
2018,China,CHN,Israel,ISR,0,0,15,23,38
2018,Cameroon,CMR,Israel,ISR,0,0,0,5,5
2018,Colombia,COL,Israel,ISR,0,0,32,10,42
2018,Eritrea,ERI,Israel,ISR,5,0,687,430,1122
2018,Ethiopia,ETH,Israel,ISR,0,11,146,38,195
2018,Georgia,GEO,Israel,ISR,0,5,877,501,1383
2018,Ghana,GHA,Israel,ISR,0,0,38,14,52
2018,Greece,GRC,Israel,ISR,0,0,0,5,5
2018,Guinea,GIN,Israel,ISR,0,0,5,0,5
2018,Cote d'Ivoire,CIV,Israel,ISR,0,0,11,0,11
2018,India,IND,Israel,ISR,0,0,93,44,137
2018,Kazakhstan,KAZ,Israel,ISR,0,0,5,18,23
2018,Kenya,KEN,Israel,ISR,0,0,5,0,5
2018,Kyrgyzstan,KGZ,Israel,ISR,0,0,0,10,10
2018,Sri Lanka,LKA,Israel,ISR,0,0,69,33,102
2018,Rep. of Moldova,MDA,Israel,ISR,0,0,68,143,211
2018,Mongolia,MNG,Israel,ISR,0,0,50,41,91
2018,Myanmar,MMR,Israel,ISR,0,0,16,0,16
2018,Nepal,NPL,Israel,ISR,0,0,5,0,5
2018,Nigeria,NGA,Israel,ISR,0,0,54,31,85
2018,Philippines,PHL,Israel,ISR,0,0,5,5,10
2018,Portugal,PRT,Israel,ISR,0,0,5,0,5
2018,Romania,ROU,Israel,ISR,0,0,0,13,13
2018,South Africa,ZAF,Israel,ISR,0,0,10,17,27
2018,Russian Federation,RUS,Israel,ISR,0,0,209,397,606
2018,Sierra Leone,SLE,Israel,ISR,0,0,13,0,13
2018,Sudan,SDN,Israel,ISR,0,485,10,77,572
2018,South Sudan,SSD,Israel,ISR,0,0,0,5,5
2018,Thailand,THA,Israel,ISR,0,0,5,0,5
2018,Turkey,TUR,Israel,ISR,0,0,10,19,29
2018,Uganda,UGA,Israel,ISR,0,0,0,5,5
2018,Ukraine,UKR,Israel,ISR,0,0,2575,2840,5415
2018,United States of America,USA,Israel,ISR,0,0,5,0,5
2018,Uzbekistan,UZB,Israel,ISR,0,0,16,15,31
2018,Afghanistan,AFG,Rep. of Korea,KOR,0,0,5,0,5
2018,Algeria,DZA,Rep. of Korea,KOR,0,0,19,14,33
2018,Angola,AGO,Rep. of Korea,KOR,0,0,10,0,10
2018,Egypt,EGY,Rep. of Korea,KOR,5,0,311,74,390
2018,Burundi,BDI,Rep. of Korea,KOR,14,5,0,0,19
2018,Bangladesh,BGD,Rep. of Korea,KOR,5,5,106,60,176
2018,Burkina Faso,BFA,Rep. of Korea,KOR,0,0,11,0,11
2018,Cambodia,KHM,Rep. of Korea,KOR,0,0,0,10,10
2018,China,CHN,Rep. of Korea,KOR,0,5,339,354,698
2018,Cameroon,CMR,Rep. of Korea,KOR,0,0,65,17,82
2018,Dem. Rep. of the Congo,COD,Rep. of Korea,KOR,12,0,0,0,12
2018,Eritrea,ERI,Rep. of Korea,KOR,5,0,0,0,5
2018,Ethiopia,ETH,Rep. of Korea,KOR,13,5,71,5,94
2018,Gabon,GAB,Rep. of Korea,KOR,0,0,5,0,5
2018,Gambia,GMB,Rep. of Korea,KOR,0,0,16,5,21
2018,Ghana,GHA,Rep. of Korea,KOR,0,0,34,20,54
2018,Guinea,GIN,Rep. of Korea,KOR,0,0,25,0,25
2018,Cote d'Ivoire,CIV,Rep. of Korea,KOR,0,5,16,5,26
2018,India,IND,Rep. of Korea,KOR,0,0,85,98,183
2018,Indonesia,IDN,Rep. of Korea,KOR,0,0,0,5,5
2018,Iran (Islamic Rep. of),IRN,Rep. of Korea,KOR,5,0,10,10,25
2018,Iraq,IRQ,Rep. of Korea,KOR,0,0,16,5,21
2018,Jordan,JOR,Rep. of Korea,KOR,5,0,11,0,16
2018,Kazakhstan,KAZ,Rep. of Korea,KOR,0,0,380,326,706
2018,Kenya,KEN,Rep. of Korea,KOR,0,0,21,5,26
2018,Kyrgyzstan,KGZ,Rep. of Korea,KOR,0,0,33,11,44
2018,Liberia,LBR,Rep. of Korea,KOR,0,0,83,15,98
2018,Libya,LBY,Rep. of Korea,KOR,0,0,5,0,5
2018,Sri Lanka,LKA,Rep. of Korea,KOR,0,0,43,35,78
2018,Mali,MLI,Rep. of Korea,KOR,0,0,17,5,22
2018,Malaysia,MYS,Rep. of Korea,KOR,0,0,54,181,235
2018,Mongolia,MNG,Rep. of Korea,KOR,0,0,60,26,86
2018,Morocco,MAR,Rep. of Korea,KOR,0,0,61,26,87
2018,Myanmar,MMR,Rep. of Korea,KOR,12,0,0,0,12
2018,Nepal,NPL,Rep. of Korea,KOR,0,0,27,57,84
2018,Nigeria,NGA,Rep. of Korea,KOR,0,0,163,21,184
2018,Pakistan,PAK,Rep. of Korea,KOR,13,5,334,66,418
2018,Philippines,PHL,Rep. of Korea,KOR,0,0,72,98,170
2018,South Africa,ZAF,Rep. of Korea,KOR,0,0,49,20,69
2018,Russian Federation,RUS,Rep. of Korea,KOR,0,0,325,199,524
2018,Senegal,SEN,Rep. of Korea,KOR,0,0,96,5,101
2018,Viet Nam,VNM,Rep. of Korea,KOR,0,0,17,13,30
2018,Sudan,SDN,Rep. of Korea,KOR,5,0,24,0,29
2018,Eswatini,SWZ,Rep. of Korea,KOR,0,0,0,5,5
2018,Syrian Arab Rep.,SYR,Rep. of Korea,KOR,0,53,10,10,73
2018,United Rep. of Tanzania,TZA,Rep. of Korea,KOR,0,0,5,5,10
2018,Thailand,THA,Rep. of Korea,KOR,5,0,63,99,167
2018,Tajikistan,TJK,Rep. of Korea,KOR,0,0,5,5,10
2018,Togo,TGO,Rep. of Korea,KOR,0,0,5,0,5
2018,Tunisia,TUN,Rep. of Korea,KOR,0,0,12,5,17
2018,Turkey,TUR,Rep. of Korea,KOR,0,0,17,10,27
2018,Uganda,UGA,Rep. of Korea,KOR,5,0,42,14,61
2018,Ukraine,UKR,Rep. of Korea,KOR,0,0,5,14,19
2018,Uzbekistan,UZB,Rep. of Korea,KOR,0,0,14,22,36
2018,Yemen,YEM,Rep. of Korea,KOR,10,425,22,38,495
2018,Zimbabwe,ZWE,Rep. of Korea,KOR,0,0,5,0,5
2018,Afghanistan,AFG,North Macedonia,MKD,0,0,5,42,47
2018,Algeria,DZA,North Macedonia,MKD,0,0,0,5,5
2018,Bangladesh,BGD,North Macedonia,MKD,0,0,0,12,12
2018,Congo,COG,North Macedonia,MKD,0,5,0,0,5
2018,India,IND,North Macedonia,MKD,0,0,0,5,5
2018,Iran (Islamic Rep. of),IRN,North Macedonia,MKD,0,0,0,18,18
2018,Iraq,IRQ,North Macedonia,MKD,0,0,0,73,73
2018,Libya,LBY,North Macedonia,MKD,0,0,0,5,5
2018,Sri Lanka,LKA,North Macedonia,MKD,0,0,0,5,5
2018,Morocco,MAR,North Macedonia,MKD,0,0,0,5,5
2018,Pakistan,PAK,North Macedonia,MKD,0,0,5,83,88
2018,Syrian Arab Rep.,SYR,North Macedonia,MKD,0,0,0,14,14
2018,Turkey,TUR,North Macedonia,MKD,0,0,0,21,21
2018,Afghanistan,AFG,Montenegro,MNE,0,0,0,47,47
2018,Algeria,DZA,Montenegro,MNE,0,0,0,366,366
2018,Egypt,EGY,Montenegro,MNE,0,0,0,10,10
2018,Bangladesh,BGD,Montenegro,MNE,0,0,0,5,5
2018,Cuba,CUB,Montenegro,MNE,0,0,0,12,12
2018,Eritrea,ERI,Montenegro,MNE,0,0,0,5,5
2018,Palestinian,PSE,Montenegro,MNE,0,0,0,151,151
2018,Ghana,GHA,Montenegro,MNE,0,5,0,0,5
2018,India,IND,Montenegro,MNE,0,0,0,5,5
2018,Iran (Islamic Rep. of),IRN,Montenegro,MNE,5,0,0,51,56
2018,Iraq,IRQ,Montenegro,MNE,0,0,0,239,239
2018,Libya,LBY,Montenegro,MNE,0,0,0,107,107
2018,Morocco,MAR,Montenegro,MNE,0,0,0,180,180
2018,Nepal,NPL,Montenegro,MNE,0,0,0,17,17
2018,Pakistan,PAK,Montenegro,MNE,0,0,0,645,645
2018,Russian Federation,RUS,Montenegro,MNE,0,0,5,5,10
2018,Sweden,SWE,Montenegro,MNE,0,0,5,0,5
2018,Syrian Arab Rep.,SYR,Montenegro,MNE,0,0,0,1199,1199
2018,Tunisia,TUN,Montenegro,MNE,0,0,0,17,17
2018,Yemen,YEM,Montenegro,MNE,0,0,0,32,32
2018,Burundi,BDI,Philippines,PHL,5,0,0,0,5
2018,Cambodia,KHM,Philippines,PHL,5,0,0,5,10
2018,Central African Rep.,CAF,Philippines,PHL,0,0,5,0,5
2018,Cameroon,CMR,Philippines,PHL,12,0,0,5,17
2018,Eritrea,ERI,Philippines,PHL,5,0,0,0,5
2018,Palestinian,PSE,Philippines,PHL,10,0,0,0,10
2018,Cote d'Ivoire,CIV,Philippines,PHL,5,0,12,0,17
2018,Iran (Islamic Rep. of),IRN,Philippines,PHL,5,0,0,0,5
2018,Iraq,IRQ,Philippines,PHL,5,0,0,0,5
2018,Lebanon,LBN,Philippines,PHL,5,0,0,0,5
2018,Nigeria,NGA,Philippines,PHL,0,0,0,5,5
2018,Pakistan,PAK,Philippines,PHL,16,0,0,5,21
2018,Rwanda,RWA,Philippines,PHL,0,0,5,0,5
2018,Saudi Arabia,SAU,Philippines,PHL,5,0,0,0,5
2018,Somalia,SOM,Philippines,PHL,5,0,0,0,5
2018,Syrian Arab Rep.,SYR,Philippines,PHL,39,0,0,0,39
2018,Turkey,TUR,Philippines,PHL,19,0,0,0,19
2018,Yemen,YEM,Philippines,PHL,10,0,0,0,10
2018,Algeria,DZA,Senegal,SEN,0,0,0,10,10
2018,Angola,AGO,Senegal,SEN,0,0,0,12,12
2018,Burundi,BDI,Senegal,SEN,5,0,0,14,19
2018,Benin,BEN,Senegal,SEN,0,0,0,5,5
2018,Central African Rep.,CAF,Senegal,SEN,56,0,0,58,114
2018,Chad,TCD,Senegal,SEN,0,0,0,30,30
2018,Cameroon,CMR,Senegal,SEN,0,0,0,28,28
2018,Congo,COG,Senegal,SEN,0,0,0,223,223
2018,Dem. Rep. of the Congo,COD,Senegal,SEN,0,0,0,190,190
2018,Gambia,GMB,Senegal,SEN,10,0,0,49,59
2018,Ghana,GHA,Senegal,SEN,0,0,0,31,31
2018,Guinea-Bissau,GNB,Senegal,SEN,0,0,0,90,90
2018,Guinea,GIN,Senegal,SEN,0,0,0,16,16
2018,Cote d'Ivoire,CIV,Senegal,SEN,0,0,0,147,147
2018,India,IND,Senegal,SEN,0,0,0,5,5
2018,Liberia,LBR,Senegal,SEN,0,0,0,341,341
2018,Sri Lanka,LKA,Senegal,SEN,0,0,0,81,81
2018,Mauritania,MRT,Senegal,SEN,5,0,0,42,47
2018,Niger,NER,Senegal,SEN,0,0,0,5,5
2018,Nigeria,NGA,Senegal,SEN,0,0,0,323,323
2018,Rwanda,RWA,Senegal,SEN,0,0,0,5,5
2018,Somalia,SOM,Senegal,SEN,0,0,0,5,5
2018,Syrian Arab Rep.,SYR,Senegal,SEN,0,0,0,5,5
2018,United Rep. of Tanzania,TZA,Senegal,SEN,0,0,0,5,5
2018,Togo,TGO,Senegal,SEN,0,0,0,63,63
2018,Turkey,TUR,Senegal,SEN,0,0,0,24,24
2018,Afghanistan,AFG,Slovakia,SVK,0,12,10,10,32
2018,Algeria,DZA,Slovakia,SVK,0,0,5,0,5
2018,Azerbaijan,AZE,Slovakia,SVK,0,0,0,12,12
2018,China,CHN,Slovakia,SVK,0,0,0,5,5
2018,Georgia,GEO,Slovakia,SVK,0,0,0,5,5
2018,India,IND,Slovakia,SVK,0,0,5,0,5
2018,Iran (Islamic Rep. of),IRN,Slovakia,SVK,0,0,13,0,13
2018,Iraq,IRQ,Slovakia,SVK,5,0,5,15,25
2018,Pakistan,PAK,Slovakia,SVK,0,0,0,12,12
2018,Russian Federation,RUS,Slovakia,SVK,0,0,5,5,10
2018,Viet Nam,VNM,Slovakia,SVK,0,0,11,0,11
2018,Syrian Arab Rep.,SYR,Slovakia,SVK,0,5,0,0,5
2018,Turkey,TUR,Slovakia,SVK,0,0,5,0,5
2018,Ukraine,UKR,Slovakia,SVK,0,0,5,0,5
2018,Yemen,YEM,Slovakia,SVK,0,19,0,0,19
2018,Afghanistan,AFG,Tajikistan,TJK,580,0,66,0,646
2019,Afghanistan,AFG,Austria,AUT,4070,1225,1849,1167,8311
2019,Albania,ALB,Austria,AUT,0,0,45,12,57
2019,Algeria,DZA,Austria,AUT,0,0,94,31,125
2019,Angola,AGO,Austria,AUT,0,5,0,0,5
2019,Egypt,EGY,Austria,AUT,19,0,59,33,111
2019,Armenia,ARM,Austria,AUT,10,5,120,11,146
2019,Azerbaijan,AZE,Austria,AUT,5,0,15,5,25
2019,Burundi,BDI,Austria,AUT,0,5,0,0,5
2019,Benin,BEN,Austria,AUT,0,0,5,0,5
2019,Bangladesh,BGD,Austria,AUT,25,10,147,94,276
2019,Belarus,BLR,Austria,AUT,0,0,5,12,17
2019,Brazil,BRA,Austria,AUT,0,0,0,5,5
2019,Bosnia and Herzegovina,BIH,Austria,AUT,5,0,26,156,187
2019,Bulgaria,BGR,Austria,AUT,0,0,0,26,26
2019,China,CHN,Austria,AUT,90,5,90,55,240
2019,Cameroon,CMR,Austria,AUT,10,5,16,5,36
2019,Congo,COG,Austria,AUT,5,0,0,0,5
2019,Dem. Rep. of the Congo,COD,Austria,AUT,5,5,13,0,23
2019,Colombia,COL,Austria,AUT,0,0,0,5,5
2019,Cuba,CUB,Austria,AUT,5,0,12,0,17
2019,Czechia,CZE,Austria,AUT,0,0,0,30,30
2019,Dominican Rep.,DOM,Austria,AUT,0,0,0,10,10
2019,Ecuador,ECU,Austria,AUT,0,0,0,5,5
2019,Eritrea,ERI,Austria,AUT,45,16,0,0,61
2019,Ethiopia,ETH,Austria,AUT,23,5,19,5,52
2019,France,FRA,Austria,AUT,0,0,0,5,5
2019,Gambia,GMB,Austria,AUT,10,0,36,11,57
2019,United Kingdom of Great Britain and Northern Ireland,GBR,Austria,AUT,0,0,0,5,5
2019,Georgia,GEO,Austria,AUT,5,32,363,64,464
2019,Germany,DEU,Austria,AUT,0,0,0,107,107
2019,Ghana,GHA,Austria,AUT,0,0,13,5,18
2019,Guinea-Bissau,GNB,Austria,AUT,0,0,5,0,5
2019,Greece,GRC,Austria,AUT,0,0,0,5,5
2019,Guinea,GIN,Austria,AUT,13,0,12,0,25
2019,Croatia,HRV,Austria,AUT,0,0,0,58,58
2019,Hungary,HUN,Austria,AUT,0,0,0,61,61
2019,Cote d'Ivoire,CIV,Austria,AUT,0,0,13,0,13
2019,India,IND,Austria,AUT,0,0,287,52,339
2019,Ireland,IRL,Austria,AUT,0,0,0,5,5
2019,Iran (Islamic Rep. of),IRN,Austria,AUT,786,5,242,77,1110
2019,Iraq,IRQ,Austria,AUT,300,264,611,332,1507
2019,Israel,ISR,Austria,AUT,0,0,5,0,5
2019,Italy,ITA,Austria,AUT,0,0,0,21,21
2019,Jordan,JOR,Austria,AUT,5,0,20,0,25
2019,Kazakhstan,KAZ,Austria,AUT,10,0,26,5,41
2019,Kenya,KEN,Austria,AUT,5,0,5,0,10
2019,Kyrgyzstan,KGZ,Austria,AUT,0,0,16,0,16
2019,Kuwait,KWT,Austria,AUT,0,0,0,14,14
2019,Liberia,LBR,Austria,AUT,0,0,5,0,5
2019,Libya,LBY,Austria,AUT,12,20,10,12,54
2019,Lebanon,LBN,Austria,AUT,5,0,25,18,48
2019,Sri Lanka,LKA,Austria,AUT,12,0,5,0,17
2019,Lithuania,LTU,Austria,AUT,0,0,0,5,5
2019,North Macedonia,MKD,Austria,AUT,0,0,48,56,104
2019,Rep. of Moldova,MDA,Austria,AUT,0,0,16,12,28
2019,Mali,MLI,Austria,AUT,5,0,0,0,5
2019,Mongolia,MNG,Austria,AUT,0,0,72,10,82
2019,Morocco,MAR,Austria,AUT,5,5,86,10,106
2019,Myanmar,MMR,Austria,AUT,5,0,0,0,5
2019,Nepal,NPL,Austria,AUT,0,0,14,5,19
2019,Netherlands,NLD,Austria,AUT,0,0,0,5,5
2019,Nicaragua,NIC,Austria,AUT,0,0,5,0,5
2019,Nigeria,NGA,Austria,AUT,23,28,376,74,501
2019,Pakistan,PAK,Austria,AUT,21,0,243,82,346
2019,Philippines,PHL,Austria,AUT,0,0,13,0,13
2019,Poland,POL,Austria,AUT,0,0,0,41,41
2019,Portugal,PRT,Austria,AUT,0,0,0,5,5
2019,Romania,ROU,Austria,AUT,0,0,5,265,270
2019,Russian Federation,RUS,Austria,AUT,378,50,1032,178,1638
2019,Rwanda,RWA,Austria,AUT,5,0,0,0,5
2019,Saudi Arabia,SAU,Austria,AUT,5,0,0,0,5
2019,Serbia and Kosovo: S/RES/1244 (1999),SRB,Austria,AUT,15,5,193,349,562
2019,Senegal,SEN,Austria,AUT,0,0,5,0,5
2019,Sierra Leone,SLE,Austria,AUT,0,0,13,0,13
2019,Somalia,SOM,Austria,AUT,751,139,91,55,1036
2019,Spain,ESP,Austria,AUT,0,0,0,5,5
2019,Viet Nam,VNM,Austria,AUT,0,0,12,5,17
2019,Sudan,SDN,Austria,AUT,16,18,10,5,49
2019,Slovakia,SVK,Austria,AUT,0,0,0,47,47
2019,Slovenia,SVN,Austria,AUT,0,0,0,13,13
2019,Syrian Arab Rep.,SYR,Austria,AUT,2534,295,169,87,3085
2019,Tajikistan,TJK,Austria,AUT,31,0,19,0,50
2019,Togo,TGO,Austria,AUT,0,0,5,0,5
2019,Tunisia,TUN,Austria,AUT,0,0,44,16,60
2019,Turkey,TUR,Austria,AUT,86,5,180,280,551
2019,Uganda,UGA,Austria,AUT,0,0,0,5,5
2019,Ukraine,UKR,Austria,AUT,12,10,363,47,432
2019,United States of America,USA,Austria,AUT,0,0,5,0,5
2019,Uzbekistan,UZB,Austria,AUT,0,0,84,5,89
2019,Venezuela (Bolivarian Republic of),VEN,Austria,AUT,5,23,5,0,33
2019,Yemen,YEM,Austria,AUT,42,14,0,0,56
2019,Afghanistan,AFG,Bulgaria,BGR,38,0,631,612,1281
2019,Algeria,DZA,Bulgaria,BGR,0,0,16,5,21
2019,Egypt,EGY,Bulgaria,BGR,0,0,5,0,5
2019,Bangladesh,BGD,Bulgaria,BGR,0,0,12,0,12
2019,India,IND,Bulgaria,BGR,0,0,5,0,5
2019,Iran (Islamic Rep. of),IRN,Bulgaria,BGR,21,0,63,13,97
2019,Iraq,IRQ,Bulgaria,BGR,50,0,233,300,583
2019,Libya,LBY,Bulgaria,BGR,0,0,5,0,5
2019,Lebanon,LBN,Bulgaria,BGR,5,0,0,5,10
2019,Mali,MLI,Bulgaria,BGR,0,0,5,0,5
2019,Morocco,MAR,Bulgaria,BGR,0,0,15,5,20
2019,Myanmar,MMR,Bulgaria,BGR,0,0,5,0,5
2019,Nigeria,NGA,Bulgaria,BGR,0,0,10,0,10
2019,Pakistan,PAK,Bulgaria,BGR,5,0,79,31,115
2019,Russian Federation,RUS,Bulgaria,BGR,0,0,12,0,12
2019,Sudan,SDN,Bulgaria,BGR,0,0,0,5,5
2019,Syrian Arab Rep.,SYR,Bulgaria,BGR,335,0,10,60,405
2019,Turkey,TUR,Bulgaria,BGR,0,0,5,5,10
2019,Ukraine,UKR,Bulgaria,BGR,0,0,5,0,5
2019,Stateless,XXA,Bulgaria,BGR,22,0,5,5,32
2019,Chad,TCD,Central African Rep.,CAF,10,0,51,10,71
2019,Cameroon,CMR,Central African Rep.,CAF,19,0,5,0,24
2019,Congo,COG,Central African Rep.,CAF,0,0,0,5,5
2019,Dem. Rep. of the Congo,COD,Central African Rep.,CAF,13,0,116,51,180
2019,Liberia,LBR,Central African Rep.,CAF,0,0,0,5,5
2019,Sudan,SDN,Central African Rep.,CAF,0,0,0,5,5
2019,South Sudan,SSD,Central African Rep.,CAF,0,0,0,5,5
2019,Togo,TGO,Central African Rep.,CAF,0,0,0,10,10
2019,Turkey,TUR,Central African Rep.,CAF,5,0,0,0,5
2019,Central African Rep.,CAF,Chad,TCD,57,0,0,567,624
2019,Cameroon,CMR,Chad,TCD,0,0,0,5,5
2019,Dem. Rep. of the Congo,COD,Chad,TCD,0,0,0,16,16
2019,Eritrea,ERI,Chad,TCD,0,0,0,10,10
2019,Ethiopia,ETH,Chad,TCD,5,0,0,5,10
2019,Libya,LBY,Chad,TCD,0,0,0,5,5
2019,Nigeria,NGA,Chad,TCD,0,0,0,12,12
2019,Sudan,SDN,Chad,TCD,5,0,0,157,162
2019,South Sudan,SSD,Chad,TCD,0,0,0,5,5
2019,Syrian Arab Rep.,SYR,Chad,TCD,0,0,0,14,14
2019,Yemen,YEM,Chad,TCD,0,0,0,5,5
2019,Afghanistan,AFG,Ecuador,ECU,10,0,0,0,10
2019,Angola,AGO,Ecuador,ECU,0,0,5,12,17
2019,Egypt,EGY,Ecuador,ECU,0,0,0,5,5
2019,Bangladesh,BGD,Ecuador,ECU,0,0,0,5,5
2019,Chile,CHL,Ecuador,ECU,5,0,0,0,5
2019,Cameroon,CMR,Ecuador,ECU,14,0,0,0,14
2019,Dem. Rep. of the Congo,COD,Ecuador,ECU,5,0,5,23,33
2019,Colombia,COL,Ecuador,ECU,2671,0,694,1753,5118
2019,Cuba,CUB,Ecuador,ECU,0,0,32,20,52
2019,Dominican Rep.,DOM,Ecuador,ECU,0,0,0,5,5
2019,Ghana,GHA,Ecuador,ECU,0,0,0,5,5
2019,Haiti,HTI,Ecuador,ECU,0,0,5,0,5
2019,Cote d'Ivoire,CIV,Ecuador,ECU,0,0,5,0,5
2019,India,IND,Ecuador,ECU,0,0,0,5,5
2019,Iran (Islamic Rep. of),IRN,Ecuador,ECU,23,0,0,5,28
2019,Iraq,IRQ,Ecuador,ECU,0,0,0,5,5
2019,Lebanon,LBN,Ecuador,ECU,14,0,0,0,14
2019,Sri Lanka,LKA,Ecuador,ECU,0,0,0,5,5
2019,Nicaragua,NIC,Ecuador,ECU,0,0,0,5,5
2019,Nigeria,NGA,Ecuador,ECU,12,0,0,0,12
2019,Peru,PER,Ecuador,ECU,0,0,14,5,19
2019,Russian Federation,RUS,Ecuador,ECU,5,0,0,0,5
2019,El Salvador,SLV,Ecuador,ECU,18,0,0,0,18
2019,Saudi Arabia,SAU,Ecuador,ECU,5,0,0,5,10
2019,Sudan,SDN,Ecuador,ECU,5,0,0,0,5
2019,Syrian Arab Rep.,SYR,Ecuador,ECU,46,0,0,17,63
2019,Turkmenistan,TKM,Ecuador,ECU,0,0,10,0,10
2019,Turkey,TUR,Ecuador,ECU,0,0,0,5,5
2019,Vanuatu,VUT,Ecuador,ECU,0,0,5,0,5
2019,Venezuela (Bolivarian Republic of),VEN,Ecuador,ECU,369,0,5203,1721,7293
2019,Yemen,YEM,Ecuador,ECU,46,0,0,48,94
2019,Dem. Rep. of the Congo,COD,Gabon,GAB,0,0,0,25,25
2019,Equatorial Guinea,GNQ,Gabon,GAB,0,0,0,5,5
2019,Central African Rep.,CAF,Gambia,GMB,0,0,0,5,5
2019,Senegal,SEN,Gambia,GMB,0,0,0,138,138
2019,Burkina Faso,BFA,Cote d'Ivoire,CIV,0,0,5,0,5
2019,Central African Rep.,CAF,Cote d'Ivoire,CIV,43,0,5,0,48
2019,Cameroon,CMR,Cote d'Ivoire,CIV,0,0,13,0,13
2019,Congo,COG,Cote d'Ivoire,CIV,0,0,0,13,13
2019,Dem. Rep. of the Congo,COD,Cote d'Ivoire,CIV,0,0,0,17,17
2019,Guinea,GIN,Cote d'Ivoire,CIV,0,0,5,0,5
2019,Iraq,IRQ,Cote d'Ivoire,CIV,5,0,0,0,5
2019,Liberia,LBR,Cote d'Ivoire,CIV,0,0,0,35,35
2019,Mauritania,MRT,Cote d'Ivoire,CIV,0,0,0,10,10
2019,Mali,MLI,Cote d'Ivoire,CIV,5,0,0,0,5
2019,Syrian Arab Rep.,SYR,Cote d'Ivoire,CIV,35,0,0,0,35
2019,Togo,TGO,Cote d'Ivoire,CIV,0,0,10,0,10
2019,Turkey,TUR,Cote d'Ivoire,CIV,12,0,0,0,12
2019,Armenia,ARM,Israel,ISR,0,0,0,14,14
2019,Azerbaijan,AZE,Israel,ISR,0,0,0,5,5
2019,Burkina Faso,BFA,Israel,ISR,0,0,5,0,5
2019,Belarus,BLR,Israel,ISR,0,0,15,100,115
2019,Bulgaria,BGR,Israel,ISR,0,0,0,5,5
2019,Chad,TCD,Israel,ISR,0,0,0,5,5
2019,China,CHN,Israel,ISR,0,0,52,16,68
2019,Cameroon,CMR,Israel,ISR,0,0,5,0,5
2019,Dem. Rep. of the Congo,COD,Israel,ISR,0,0,5,11,16
2019,Colombia,COL,Israel,ISR,0,0,19,17,36
2019,Ecuador,ECU,Israel,ISR,0,0,5,0,5
2019,Eritrea,ERI,Israel,ISR,5,0,14,654,673
2019,Ethiopia,ETH,Israel,ISR,0,0,115,38,153
2019,Georgia,GEO,Israel,ISR,0,0,349,431,780
2019,Ghana,GHA,Israel,ISR,0,0,97,28,125
2019,Greece,GRC,Israel,ISR,0,0,0,5,5
2019,Guinea,GIN,Israel,ISR,0,0,22,0,22
2019,Cote d'Ivoire,CIV,Israel,ISR,0,0,5,5,10
2019,India,IND,Israel,ISR,0,0,267,72,339
2019,Kazakhstan,KAZ,Israel,ISR,0,0,5,18,23
2019,Kenya,KEN,Israel,ISR,0,0,5,0,5
2019,Kyrgyzstan,KGZ,Israel,ISR,0,0,0,10,10
2019,Sri Lanka,LKA,Israel,ISR,0,0,279,56,335
2019,Latvia,LVA,Israel,ISR,0,0,0,5,5
2019,Rep. of Moldova,MDA,Israel,ISR,0,0,105,132,237
2019,Myanmar,MMR,Israel,ISR,0,0,5,0,5
2019,Nepal,NPL,Israel,ISR,0,0,63,10,73
2019,Nigeria,NGA,Israel,ISR,0,0,123,23,146
2019,Philippines,PHL,Israel,ISR,0,0,12,10,22
2019,Romania,ROU,Israel,ISR,0,0,10,15,25
2019,South Africa,ZAF,Israel,ISR,0,0,10,33,43
2019,Russian Federation,RUS,Israel,ISR,0,0,776,740,1516
2019,Sierra Leone,SLE,Israel,ISR,0,0,5,0,5
2019,Spain,ESP,Israel,ISR,0,0,0,5,5
2019,Sudan,SDN,Israel,ISR,0,120,0,91,211
2019,South Sudan,SSD,Israel,ISR,0,0,0,10,10
2019,Thailand,THA,Israel,ISR,0,0,5,0,5
2019,Tajikistan,TJK,Israel,ISR,0,0,5,0,5
2019,Turkey,TUR,Israel,ISR,0,0,38,42,80
2019,Uganda,UGA,Israel,ISR,0,0,0,5,5
2019,Ukraine,UKR,Israel,ISR,0,5,1038,2391,3434
2019,Uzbekistan,UZB,Israel,ISR,0,0,66,33,99
2019,Afghanistan,AFG,Rep. of Korea,KOR,5,0,0,0,5
2019,Algeria,DZA,Rep. of Korea,KOR,0,0,45,16,61
2019,Angola,AGO,Rep. of Korea,KOR,0,0,11,5,16
2019,Egypt,EGY,Rep. of Korea,KOR,0,5,351,86,442
2019,Burundi,BDI,Rep. of Korea,KOR,5,0,0,0,5
2019,Bangladesh,BGD,Rep. of Korea,KOR,5,0,129,115,249
2019,Burkina Faso,BFA,Rep. of Korea,KOR,0,0,5,5,10
2019,Cambodia,KHM,Rep. of Korea,KOR,0,0,0,14,14
2019,China,CHN,Rep. of Korea,KOR,0,0,375,639,1014
2019,Cameroon,CMR,Rep. of Korea,KOR,0,0,51,38,89
2019,Dem. Rep. of the Congo,COD,Rep. of Korea,KOR,5,0,5,0,10
2019,Colombia,COL,Rep. of Korea,KOR,0,0,5,0,5
2019,Ethiopia,ETH,Rep. of Korea,KOR,5,0,22,5,32
2019,Gambia,GMB,Rep. of Korea,KOR,0,0,34,5,39
2019,Ghana,GHA,Rep. of Korea,KOR,0,0,107,29,136
2019,Guinea-Bissau,GNB,Rep. of Korea,KOR,0,0,5,0,5
2019,Guinea,GIN,Rep. of Korea,KOR,0,0,54,5,59
2019,Cote d'Ivoire,CIV,Rep. of Korea,KOR,0,0,17,0,17
2019,India,IND,Rep. of Korea,KOR,0,0,413,138,551
2019,Indonesia,IDN,Rep. of Korea,KOR,0,0,36,18,54
2019,Iran (Islamic Rep. of),IRN,Rep. of Korea,KOR,0,0,32,12,44
2019,Iraq,IRQ,Rep. of Korea,KOR,0,0,5,0,5
2019,Jordan,JOR,Rep. of Korea,KOR,0,0,5,0,5
2019,Kazakhstan,KAZ,Rep. of Korea,KOR,0,0,863,898,1761
2019,Kenya,KEN,Rep. of Korea,KOR,0,0,10,5,15
2019,Kyrgyzstan,KGZ,Rep. of Korea,KOR,0,0,44,27,71
2019,Liberia,LBR,Rep. of Korea,KOR,0,0,101,37,138
2019,Libya,LBY,Rep. of Korea,KOR,0,0,0,5,5
2019,Sri Lanka,LKA,Rep. of Korea,KOR,0,0,41,41,82
2019,Mexico,MEX,Rep. of Korea,KOR,0,0,0,5,5
2019,Mali,MLI,Rep. of Korea,KOR,0,0,46,5,51
2019,Malaysia,MYS,Rep. of Korea,KOR,0,0,185,418,603
2019,Mongolia,MNG,Rep. of Korea,KOR,0,0,121,96,217
2019,Morocco,MAR,Rep. of Korea,KOR,0,0,134,79,213
2019,Mozambique,MOZ,Rep. of Korea,KOR,0,0,5,0,5
2019,Myanmar,MMR,Rep. of Korea,KOR,0,0,14,0,14
2019,Nepal,NPL,Rep. of Korea,KOR,0,0,59,27,86
2019,Niger,NER,Rep. of Korea,KOR,0,0,5,0,5
2019,Nigeria,NGA,Rep. of Korea,KOR,0,0,314,51,365
2019,Pakistan,PAK,Rep. of Korea,KOR,5,0,361,162,528
2019,Peru,PER,Rep. of Korea,KOR,0,0,5,0,5
2019,Philippines,PHL,Rep. of Korea,KOR,0,0,113,146,259
2019,South Africa,ZAF,Rep. of Korea,KOR,0,0,68,19,87
2019,Russian Federation,RUS,Rep. of Korea,KOR,0,0,536,675,1211
2019,Rwanda,RWA,Rep. of Korea,KOR,0,0,5,0,5
2019,Senegal,SEN,Rep. of Korea,KOR,0,0,67,10,77
2019,Sierra Leone,SLE,Rep. of Korea,KOR,0,0,5,0,5
2019,Viet Nam,VNM,Rep. of Korea,KOR,0,0,48,55,103
2019,Sudan,SDN,Rep. of Korea,KOR,0,0,20,0,20
2019,Syrian Arab Rep.,SYR,Rep. of Korea,KOR,0,24,0,0,24
2019,United Rep. of Tanzania,TZA,Rep. of Korea,KOR,0,0,13,5,18
2019,Thailand,THA,Rep. of Korea,KOR,0,0,77,224,301
2019,Tajikistan,TJK,Rep. of Korea,KOR,0,0,5,0,5
2019,Togo,TGO,Rep. of Korea,KOR,0,0,5,0,5
2019,Tunisia,TUN,Rep. of Korea,KOR,0,0,22,17,39
2019,Turkey,TUR,Rep. of Korea,KOR,0,0,58,35,93
2019,Uganda,UGA,Rep. of Korea,KOR,0,0,31,16,47
2019,Ukraine,UKR,Rep. of Korea,KOR,0,0,11,13,24
2019,United States of America,USA,Rep. of Korea,KOR,0,0,0,5,5
2019,Uzbekistan,UZB,Rep. of Korea,KOR,0,0,36,30,66
2019,Venezuela (Bolivarian Republic of),VEN,Rep. of Korea,KOR,0,0,5,0,5
2019,Yemen,YEM,Rep. of Korea,KOR,5,195,10,13,223
2019,Zimbabwe,ZWE,Rep. of Korea,KOR,0,0,5,0,5
2019,Afghanistan,AFG,North Macedonia,MKD,0,0,0,114,114
2019,Algeria,DZA,North Macedonia,MKD,0,0,0,10,10
2019,Egypt,EGY,North Macedonia,MKD,0,0,0,5,5
2019,Bangladesh,BGD,North Macedonia,MKD,0,0,0,32,32
2019,Iraq,IRQ,North Macedonia,MKD,0,0,0,31,31
2019,Libya,LBY,North Macedonia,MKD,0,0,0,10,10
2019,Morocco,MAR,North Macedonia,MKD,0,0,0,10,10
2019,Pakistan,PAK,North Macedonia,MKD,0,0,5,111,116
2019,Serbia and Kosovo: S/RES/1244 (1999),SRB,North Macedonia,MKD,0,0,0,5,5
2019,Syrian Arab Rep.,SYR,North Macedonia,MKD,0,0,0,45,45
2019,Afghanistan,AFG,Montenegro,MNE,0,0,0,55,55
2019,Algeria,DZA,Montenegro,MNE,0,0,0,256,256
2019,Egypt,EGY,Montenegro,MNE,0,0,0,5,5
2019,Cuba,CUB,Montenegro,MNE,0,0,0,5,5
2019,Palestinian,PSE,Montenegro,MNE,0,0,0,50,50
2019,Iran (Islamic Rep. of),IRN,Montenegro,MNE,0,0,5,36,41
2019,Iraq,IRQ,Montenegro,MNE,0,0,0,257,257
2019,Jordan,JOR,Montenegro,MNE,0,0,0,5,5
2019,Libya,LBY,Montenegro,MNE,0,0,0,78,78
2019,Morocco,MAR,Montenegro,MNE,0,0,0,417,417
2019,Nepal,NPL,Montenegro,MNE,0,0,0,15,15
2019,Pakistan,PAK,Montenegro,MNE,0,0,0,104,104
2019,Somalia,SOM,Montenegro,MNE,0,0,0,5,5
2019,Sudan,SDN,Montenegro,MNE,0,0,0,5,5
2019,Syrian Arab Rep.,SYR,Montenegro,MNE,5,0,0,278,283
2019,Tunisia,TUN,Montenegro,MNE,0,0,0,10,10
2019,Cambodia,KHM,Philippines,PHL,5,0,0,0,5
2019,Cameroon,CMR,Philippines,PHL,12,0,11,0,23
2019,Dem. Rep. of the Congo,COD,Philippines,PHL,5,0,5,0,10
2019,Cote d'Ivoire,CIV,Philippines,PHL,5,0,5,0,10
2019,Iran (Islamic Rep. of),IRN,Philippines,PHL,5,0,0,0,5
2019,Morocco,MAR,Philippines,PHL,5,0,0,0,5
2019,Rwanda,RWA,Philippines,PHL,0,0,5,0,5
2019,Saudi Arabia,SAU,Philippines,PHL,0,0,5,0,5
2019,Somalia,SOM,Philippines,PHL,5,0,0,0,5
2019,Viet Nam,VNM,Philippines,PHL,5,0,0,0,5
2019,Syrian Arab Rep.,SYR,Philippines,PHL,15,0,0,0,15
2019,Turkey,TUR,Philippines,PHL,26,0,0,0,26
2019,Yemen,YEM,Philippines,PHL,5,0,0,0,5
2019,Afghanistan,AFG,Senegal,SEN,0,0,0,5,5
2019,Central African Rep.,CAF,Senegal,SEN,61,0,0,32,93
2019,Chad,TCD,Senegal,SEN,0,0,0,5,5
2019,Dem. Rep. of the Congo,COD,Senegal,SEN,0,0,0,5,5
2019,Gambia,GMB,Senegal,SEN,10,0,0,16,26
2019,Cote d'Ivoire,CIV,Senegal,SEN,0,0,0,5,5
2019,Liberia,LBR,Senegal,SEN,0,0,0,5,5
2019,Mauritania,MRT,Senegal,SEN,5,0,0,0,5
2019,Turkey,TUR,Senegal,SEN,10,0,0,5,15
2019,Afghanistan,AFG,Tajikistan,TJK,1920,0,210,0,2130
2020,Afghanistan,AFG,Austria,AUT,2875,1198,1447,1173,6693
2020,Albania,ALB,Austria,AUT,0,0,29,17,46
2020,Algeria,DZA,Austria,AUT,0,0,152,51,203
2020,Angola,AGO,Austria,AUT,0,0,13,0,13
2020,Egypt,EGY,Austria,AUT,10,10,106,45,171
2020,Armenia,ARM,Austria,AUT,10,5,111,5,131
2020,Azerbaijan,AZE,Austria,AUT,0,0,25,10,35
2020,Benin,BEN,Austria,AUT,0,0,5,0,5
2020,Bangladesh,BGD,Austria,AUT,23,5,216,99,343
2020,Belarus,BLR,Austria,AUT,0,0,10,10,20
2020,Bosnia and Herzegovina,BIH,Austria,AUT,0,0,15,5,20
2020,China,CHN,Austria,AUT,49,0,72,25,146
2020,Cameroon,CMR,Austria,AUT,10,5,11,0,26
2020,Congo,COG,Austria,AUT,0,0,5,0,5
2020,Dem. Rep. of the Congo,COD,Austria,AUT,23,5,21,5,54
2020,Colombia,COL,Austria,AUT,0,0,5,0,5
2020,Cuba,CUB,Austria,AUT,0,0,5,0,5
2020,Eritrea,ERI,Austria,AUT,42,5,5,0,52
2020,Ethiopia,ETH,Austria,AUT,16,5,11,5,37
2020,Gambia,GMB,Austria,AUT,0,5,31,5,41
2020,Georgia,GEO,Austria,AUT,5,19,208,37,269
2020,Germany,DEU,Austria,AUT,0,0,5,0,5
2020,Ghana,GHA,Austria,AUT,0,0,14,0,14
2020,Guinea-Bissau,GNB,Austria,AUT,0,5,0,0,5
2020,Guinea,GIN,Austria,AUT,0,0,14,0,14
2020,Cote d'Ivoire,CIV,Austria,AUT,0,0,5,0,5
2020,India,IND,Austria,AUT,0,0,212,51,263
2020,Iran (Islamic Rep. of),IRN,Austria,AUT,705,17,286,89,1097
2020,Iraq,IRQ,Austria,AUT,246,573,668,257,1744
2020,Israel,ISR,Austria,AUT,0,0,0,5,5
2020,Jordan,JOR,Austria,AUT,0,0,0,5,5
2020,Kazakhstan,KAZ,Austria,AUT,0,5,5,0,10
2020,Kenya,KEN,Austria,AUT,0,0,0,5,5
2020,Kyrgyzstan,KGZ,Austria,AUT,5,0,12,0,17
2020,Liberia,LBR,Austria,AUT,0,0,5,0,5
2020,Libya,LBY,Austria,AUT,10,5,5,44,64
2020,Lebanon,LBN,Austria,AUT,10,0,52,5,67
2020,Sri Lanka,LKA,Austria,AUT,0,0,13,0,13
2020,North Macedonia,MKD,Austria,AUT,0,0,33,22,55
2020,Rep. of Moldova,MDA,Austria,AUT,0,5,14,5,24
2020,Mali,MLI,Austria,AUT,0,0,0,5,5
2020,Mongolia,MNG,Austria,AUT,13,10,86,0,109
2020,Morocco,MAR,Austria,AUT,0,5,364,70,439
2020,Montenegro,MNE,Austria,AUT,0,0,5,0,5
2020,Nepal,NPL,Austria,AUT,0,0,13,5,18
2020,Nigeria,NGA,Austria,AUT,10,33,191,60,294
2020,Pakistan,PAK,Austria,AUT,35,5,197,70,307
2020,Philippines,PHL,Austria,AUT,5,0,5,0,10
2020,Romania,ROU,Austria,AUT,0,0,11,0,11
2020,Russian Federation,RUS,Austria,AUT,237,35,1247,270,1789
2020,Serbia and Kosovo: S/RES/1244 (1999),SRB,Austria,AUT,5,5,163,102,275
2020,Senegal,SEN,Austria,AUT,0,0,10,0,10
2020,Sierra Leone,SLE,Austria,AUT,0,0,5,0,5
2020,Somalia,SOM,Austria,AUT,566,145,52,43,806
2020,Viet Nam,VNM,Austria,AUT,0,0,0,5,5
2020,Sudan,SDN,Austria,AUT,5,11,5,0,21
2020,Syrian Arab Rep.,SYR,Austria,AUT,2751,318,62,411,3542
2020,Tajikistan,TJK,Austria,AUT,12,0,5,0,17
2020,Tunisia,TUN,Austria,AUT,0,0,33,10,43
2020,Turkey,TUR,Austria,AUT,113,5,113,89,320
2020,Uganda,UGA,Austria,AUT,5,0,5,0,10
2020,Ukraine,UKR,Austria,AUT,10,5,175,19,209
2020,United States of America,USA,Austria,AUT,0,0,5,0,5
2020,Uzbekistan,UZB,Austria,AUT,0,0,23,10,33
2020,Venezuela (Bolivarian Republic of),VEN,Austria,AUT,0,28,5,0,33
2020,Yemen,YEM,Austria,AUT,30,14,0,5,49
2020,Afghanistan,AFG,Bulgaria,BGR,5,5,858,226,1094
2020,Algeria,DZA,Bulgaria,BGR,0,0,41,5,46
2020,Egypt,EGY,Bulgaria,BGR,0,0,10,0,10
2020,Bangladesh,BGD,Bulgaria,BGR,0,0,19,5,24
2020,China,CHN,Bulgaria,BGR,0,0,0,5,5
2020,Cameroon,CMR,Bulgaria,BGR,0,0,5,0,5
2020,Georgia,GEO,Bulgaria,BGR,0,0,5,0,5
2020,Iran (Islamic Rep. of),IRN,Bulgaria,BGR,0,0,45,25,70
2020,Iraq,IRQ,Bulgaria,BGR,0,23,147,124,294
2020,Libya,LBY,Bulgaria,BGR,0,0,13,0,13
2020,Lebanon,LBN,Bulgaria,BGR,0,0,5,0,5
2020,Morocco,MAR,Bulgaria,BGR,0,0,92,5,97
2020,Nigeria,NGA,Bulgaria,BGR,0,0,10,0,10
2020,Pakistan,PAK,Bulgaria,BGR,0,0,56,14,70
2020,Russian Federation,RUS,Bulgaria,BGR,0,0,14,0,14
2020,Syrian Arab Rep.,SYR,Bulgaria,BGR,97,668,5,23,793
2020,Turkmenistan,TKM,Bulgaria,BGR,0,0,5,0,5
2020,Tunisia,TUN,Bulgaria,BGR,0,0,5,0,5
2020,Turkey,TUR,Bulgaria,BGR,0,0,13,0,13
2020,Ukraine,UKR,Bulgaria,BGR,0,0,11,0,11
2020,Venezuela (Bolivarian Republic of),VEN,Bulgaria,BGR,0,0,5,0,5
2020,Yemen,YEM,Bulgaria,BGR,0,0,5,0,5
2020,Stateless,XXA,Bulgaria,BGR,0,10,12,5,27
2020,Dem. Rep. of the Congo,COD,Central African Rep.,CAF,20,0,5,0,25
2020,Central African Rep.,CAF,Chad,TCD,32,0,0,20,52
2020,Libya,LBY,Chad,TCD,0,0,0,5,5
2020,Nigeria,NGA,Chad,TCD,0,0,0,5,5
2020,Sudan,SDN,Chad,TCD,5,0,0,113,118
2020,Syrian Arab Rep.,SYR,Chad,TCD,5,0,0,0,5
2020,Cameroon,CMR,Ecuador,ECU,0,5,0,0,5
2020,Colombia,COL,Ecuador,ECU,763,147,0,32,942
2020,Cuba,CUB,Ecuador,ECU,0,0,0,5,5
2020,Lebanon,LBN,Ecuador,ECU,5,0,0,0,5
2020,Rwanda,RWA,Ecuador,ECU,5,0,0,0,5
2020,Syrian Arab Rep.,SYR,Ecuador,ECU,0,10,0,0,10
2020,Venezuela (Bolivarian Republic of),VEN,Ecuador,ECU,32,10,0,109,151
2020,Yemen,YEM,Ecuador,ECU,5,23,0,0,28
2020,Central African Rep.,CAF,Cote d'Ivoire,CIV,27,0,12,0,39
2020,Congo,COG,Cote d'Ivoire,CIV,5,0,5,0,10
2020,Dem. Rep. of the Congo,COD,Cote d'Ivoire,CIV,0,0,10,0,10
2020,Syrian Arab Rep.,SYR,Cote d'Ivoire,CIV,5,0,5,0,10
2020,Albania,ALB,Israel,ISR,0,0,0,10,10
2020,Armenia,ARM,Israel,ISR,0,0,0,11,11
2020,Azerbaijan,AZE,Israel,ISR,0,0,11,11,22
2020,Belarus,BLR,Israel,ISR,0,5,29,233,267
2020,China,CHN,Israel,ISR,0,0,31,21,52
2020,Cameroon,CMR,Israel,ISR,0,0,5,5,10
2020,Congo,COG,Israel,ISR,0,0,5,0,5
2020,Dem. Rep. of the Congo,COD,Israel,ISR,0,0,0,11,11
2020,Colombia,COL,Israel,ISR,0,0,53,21,74
2020,Eritrea,ERI,Israel,ISR,10,5,294,325,634
2020,Ethiopia,ETH,Israel,ISR,0,5,54,18,77
2020,Georgia,GEO,Israel,ISR,0,0,659,395,1054
2020,Ghana,GHA,Israel,ISR,0,0,67,11,78
2020,Greece,GRC,Israel,ISR,0,0,0,5,5
2020,Guinea,GIN,Israel,ISR,0,0,5,0,5
2020,Hungary,HUN,Israel,ISR,0,0,0,5,5
2020,Cote d'Ivoire,CIV,Israel,ISR,0,0,5,0,5
2020,India,IND,Israel,ISR,0,0,192,96,288
2020,Kazakhstan,KAZ,Israel,ISR,0,0,0,33,33
2020,Kenya,KEN,Israel,ISR,0,0,5,0,5
2020,Kyrgyzstan,KGZ,Israel,ISR,0,0,5,11,16
2020,Sri Lanka,LKA,Israel,ISR,0,0,176,55,231
2020,North Macedonia,MKD,Israel,ISR,0,0,0,49,49
2020,Rep. of Moldova,MDA,Israel,ISR,0,0,69,160,229
2020,Mexico,MEX,Israel,ISR,0,0,5,0,5
2020,Malawi,MWI,Israel,ISR,0,0,0,5,5
2020,Mongolia,MNG,Israel,ISR,0,0,0,5,5
2020,Montenegro,MNE,Israel,ISR,0,0,0,12,12
2020,Nepal,NPL,Israel,ISR,0,0,21,5,26
2020,Nigeria,NGA,Israel,ISR,0,0,32,27,59
2020,Philippines,PHL,Israel,ISR,0,0,5,0,5
2020,Romania,ROU,Israel,ISR,0,0,5,14,19
2020,South Africa,ZAF,Israel,ISR,0,0,5,46,51
2020,Russian Federation,RUS,Israel,ISR,0,5,963,1320,2288
2020,Serbia and Kosovo: S/RES/1244 (1999),SRB,Israel,ISR,0,0,0,62,62
2020,Viet Nam,VNM,Israel,ISR,0,0,5,0,5
2020,Sudan,SDN,Israel,ISR,0,10,0,99,109
2020,South Sudan,SSD,Israel,ISR,0,5,11,5,21
2020,Thailand,THA,Israel,ISR,0,0,10,0,10
2020,Tajikistan,TJK,Israel,ISR,0,0,0,5,5
2020,Turkey,TUR,Israel,ISR,0,0,99,65,164
2020,Uganda,UGA,Israel,ISR,0,0,0,5,5
2020,Ukraine,UKR,Israel,ISR,0,23,1746,1686,3455
2020,Uzbekistan,UZB,Israel,ISR,0,0,58,47,105
2020,Afghanistan,AFG,Rep. of Korea,KOR,0,0,0,12,12
2020,Algeria,DZA,Rep. of Korea,KOR,0,0,78,37,115
2020,Angola,AGO,Rep. of Korea,KOR,0,0,16,5,21
2020,Egypt,EGY,Rep. of Korea,KOR,10,0,334,179,523
2020,Argentina,ARG,Rep. of Korea,KOR,0,0,0,5,5
2020,Burundi,BDI,Rep. of Korea,KOR,11,0,0,0,11
2020,Benin,BEN,Rep. of Korea,KOR,0,0,0,5,5
2020,Bangladesh,BGD,Rep. of Korea,KOR,0,0,316,112,428
2020,Burkina Faso,BFA,Rep. of Korea,KOR,0,0,10,0,10
2020,Brazil,BRA,Rep. of Korea,KOR,0,0,0,5,5
2020,Cambodia,KHM,Rep. of Korea,KOR,0,0,24,27,51
2020,China,CHN,Rep. of Korea,KOR,0,0,564,653,1217
2020,Cameroon,CMR,Rep. of Korea,KOR,0,0,121,23,144
2020,Dem. Rep. of the Congo,COD,Rep. of Korea,KOR,0,0,14,0,14
2020,Colombia,COL,Rep. of Korea,KOR,0,0,0,5,5
2020,Ethiopia,ETH,Rep. of Korea,KOR,5,0,54,5,64
2020,Gambia,GMB,Rep. of Korea,KOR,0,0,43,0,43
2020,Ghana,GHA,Rep. of Korea,KOR,0,0,128,27,155
2020,Guinea-Bissau,GNB,Rep. of Korea,KOR,0,0,5,0,5
2020,Guinea,GIN,Rep. of Korea,KOR,0,0,59,11,70
2020,Haiti,HTI,Rep. of Korea,KOR,0,0,5,0,5
2020,Cote d'Ivoire,CIV,Rep. of Korea,KOR,0,0,18,0,18
2020,India,IND,Rep. of Korea,KOR,0,0,430,257,687
2020,Indonesia,IDN,Rep. of Korea,KOR,0,0,10,16,26
2020,Iran (Islamic Rep. of),IRN,Rep. of Korea,KOR,0,0,14,5,19
2020,Iraq,IRQ,Rep. of Korea,KOR,0,0,12,5,17
2020,Jordan,JOR,Rep. of Korea,KOR,0,0,13,0,13
2020,Kazakhstan,KAZ,Rep. of Korea,KOR,0,0,883,1183,2066
2020,Kenya,KEN,Rep. of Korea,KOR,0,0,21,5,26
2020,Kyrgyzstan,KGZ,Rep. of Korea,KOR,0,0,58,37,95
2020,Liberia,LBR,Rep. of Korea,KOR,0,0,133,22,155
2020,Libya,LBY,Rep. of Korea,KOR,0,5,0,5,10
2020,Sri Lanka,LKA,Rep. of Korea,KOR,0,0,150,55,205
2020,Mali,MLI,Rep. of Korea,KOR,0,0,25,0,25
2020,Malaysia,MYS,Rep. of Korea,KOR,0,0,208,629,837
2020,Mongolia,MNG,Rep. of Korea,KOR,0,0,136,110,246
2020,Morocco,MAR,Rep. of Korea,KOR,0,0,195,119,314
2020,Mozambique,MOZ,Rep. of Korea,KOR,0,0,5,0,5
2020,Myanmar,MMR,Rep. of Korea,KOR,0,0,5,5,10
2020,Nepal,NPL,Rep. of Korea,KOR,0,0,144,72,216
2020,Nigeria,NGA,Rep. of Korea,KOR,0,0,280,43,323
2020,Pakistan,PAK,Rep. of Korea,KOR,10,0,429,213,652
2020,Philippines,PHL,Rep. of Korea,KOR,0,0,67,109,176
2020,South Africa,ZAF,Rep. of Korea,KOR,0,0,44,18,62
2020,Russian Federation,RUS,Rep. of Korea,KOR,0,0,931,1333,2264
2020,Rwanda,RWA,Rep. of Korea,KOR,0,0,5,5,10
2020,Senegal,SEN,Rep. of Korea,KOR,0,0,47,5,52
2020,Sierra Leone,SLE,Rep. of Korea,KOR,0,0,5,0,5
2020,Viet Nam,VNM,Rep. of Korea,KOR,0,0,63,154,217
2020,Sudan,SDN,Rep. of Korea,KOR,11,0,0,10,21
2020,Syrian Arab Rep.,SYR,Rep. of Korea,KOR,0,35,5,5,45
2020,United Rep. of Tanzania,TZA,Rep. of Korea,KOR,0,0,14,5,19
2020,Thailand,THA,Rep. of Korea,KOR,0,0,96,105,201
2020,Tajikistan,TJK,Rep. of Korea,KOR,0,0,0,13,13
2020,Togo,TGO,Rep. of Korea,KOR,0,0,5,0,5
2020,Tunisia,TUN,Rep. of Korea,KOR,0,0,35,17,52
2020,Turkey,TUR,Rep. of Korea,KOR,0,0,119,108,227
2020,Uganda,UGA,Rep. of Korea,KOR,0,0,28,10,38
2020,Ukraine,UKR,Rep. of Korea,KOR,0,0,19,26,45
2020,United States of America,USA,Rep. of Korea,KOR,0,0,5,0,5
2020,Uzbekistan,UZB,Rep. of Korea,KOR,0,0,91,97,188
2020,Venezuela (Bolivarian Republic of),VEN,Rep. of Korea,KOR,0,0,0,12,12
2020,Yemen,YEM,Rep. of Korea,KOR,5,112,5,5,127
2020,Zimbabwe,ZWE,Rep. of Korea,KOR,0,0,5,0,5
2020,Afghanistan,AFG,North Macedonia,MKD,0,5,5,46,56
2020,Iraq,IRQ,North Macedonia,MKD,0,0,0,12,12
2020,Morocco,MAR,North Macedonia,MKD,0,0,5,22,27
2020,Pakistan,PAK,North Macedonia,MKD,0,0,5,35,40
2020,Syrian Arab Rep.,SYR,North Macedonia,MKD,0,0,5,28,33
2020,Turkey,TUR,North Macedonia,MKD,0,0,12,10,22
2020,Afghanistan,AFG,Montenegro,MNE,0,0,0,69,69
2020,Algeria,DZA,Montenegro,MNE,0,0,0,141,141
2020,Egypt,EGY,Montenegro,MNE,0,0,0,5,5
2020,Cuba,CUB,Montenegro,MNE,0,0,0,5,5
2020,Palestinian,PSE,Montenegro,MNE,0,0,0,10,10
2020,Iran (Islamic Rep. of),IRN,Montenegro,MNE,10,0,0,26,36
2020,Iraq,IRQ,Montenegro,MNE,0,0,0,5,5
2020,Libya,LBY,Montenegro,MNE,0,0,0,10,10
2020,Morocco,MAR,Montenegro,MNE,0,0,0,481,481
2020,Pakistan,PAK,Montenegro,MNE,0,0,0,23,23
2020,Russian Federation,RUS,Montenegro,MNE,0,0,0,10,10
2020,Serbia and Kosovo: S/RES/1244 (1999),SRB,Montenegro,MNE,0,0,0,5,5
2020,Syrian Arab Rep.,SYR,Montenegro,MNE,0,0,0,15,15
2020,Turkey,TUR,Montenegro,MNE,0,0,0,5,5
2020,Afghanistan,AFG,Philippines,PHL,0,0,0,5,5
2020,Egypt,EGY,Philippines,PHL,0,0,0,5,5
2020,Cameroon,CMR,Philippines,PHL,5,0,5,0,10
2020,Dem. Rep. of the Congo,COD,Philippines,PHL,0,0,0,5,5
2020,Eritrea,ERI,Philippines,PHL,0,0,0,5,5
2020,Palestinian,PSE,Philippines,PHL,0,0,0,5,5
2020,Guatemala,GTM,Philippines,PHL,0,0,0,5,5
2020,Cote d'Ivoire,CIV,Philippines,PHL,0,0,5,5,10
2020,Iran (Islamic Rep. of),IRN,Philippines,PHL,0,0,0,5,5
2020,Iraq,IRQ,Philippines,PHL,0,0,0,5,5
2020,Malaysia,MYS,Philippines,PHL,5,0,0,0,5
2020,Pakistan,PAK,Philippines,PHL,5,0,0,0,5
2020,Saudi Arabia,SAU,Philippines,PHL,5,0,0,0,5
2020,Somalia,SOM,Philippines,PHL,0,0,0,5,5
2020,Viet Nam,VNM,Philippines,PHL,5,0,0,0,5
2020,Syrian Arab Rep.,SYR,Philippines,PHL,14,0,0,0,14
2020,Turkey,TUR,Philippines,PHL,5,0,0,0,5
2020,Afghanistan,AFG,Senegal,SEN,0,0,0,5,5
2020,Afghanistan,AFG,Tajikistan,TJK,1935,0,145,0,2080
2021,Afghanistan,AFG,Austria,AUT,2568,1730,1086,3880,9264
2021,Albania,ALB,Austria,AUT,0,0,34,5,39
2021,Algeria,DZA,Austria,AUT,0,0,232,78,310
2021,Angola,AGO,Austria,AUT,0,0,10,0,10
2021,Egypt,EGY,Austria,AUT,5,0,551,180,736
2021,Armenia,ARM,Austria,AUT,5,5,131,12,153
2021,Azerbaijan,AZE,Austria,AUT,12,0,68,0,80
2021,Benin,BEN,Austria,AUT,0,0,12,0,12
2021,Bangladesh,BGD,Austria,AUT,36,10,513,410,969
2021,Burkina Faso,BFA,Austria,AUT,0,0,0,5,5
2021,Belarus,BLR,Austria,AUT,0,0,12,11,23
2021,Brazil,BRA,Austria,AUT,0,0,0,5,5
2021,Bosnia and Herzegovina,BIH,Austria,AUT,0,0,11,0,11
2021,Chad,TCD,Austria,AUT,0,0,0,5,5
2021,China,CHN,Austria,AUT,36,5,59,32,132
2021,Cameroon,CMR,Austria,AUT,5,0,14,5,24
2021,Congo,COG,Austria,AUT,5,0,0,0,5
2021,Dem. Rep. of the Congo,COD,Austria,AUT,13,5,19,14,51
2021,Comoros,COM,Austria,AUT,0,0,0,5,5
2021,Colombia,COL,Austria,AUT,0,0,14,5,19
2021,Cuba,CUB,Austria,AUT,5,0,5,5,15
2021,Eritrea,ERI,Austria,AUT,42,0,5,5,52
2021,Ethiopia,ETH,Austria,AUT,11,16,16,0,43
2021,Gambia,GMB,Austria,AUT,5,5,28,16,54
2021,United Kingdom of Great Britain and Northern Ireland,GBR,Austria,AUT,5,0,0,0,5
2021,Georgia,GEO,Austria,AUT,0,23,141,26,190
2021,Germany,DEU,Austria,AUT,0,0,0,5,5
2021,Ghana,GHA,Austria,AUT,0,0,13,5,18
2021,Guinea,GIN,Austria,AUT,5,0,12,5,22
2021,Hungary,HUN,Austria,AUT,0,0,5,0,5
2021,Cote d'Ivoire,CIV,Austria,AUT,0,0,5,0,5
2021,India,IND,Austria,AUT,0,5,393,80,478
2021,Iran (Islamic Rep. of),IRN,Austria,AUT,612,5,231,116,964
2021,Iraq,IRQ,Austria,AUT,262,934,1058,450,2704
2021,Jordan,JOR,Austria,AUT,0,0,12,5,17
2021,Kazakhstan,KAZ,Austria,AUT,0,0,15,0,15
2021,Kenya,KEN,Austria,AUT,0,0,5,0,5
2021,Kyrgyzstan,KGZ,Austria,AUT,0,0,12,0,12
2021,Kuwait,KWT,Austria,AUT,0,0,0,5,5
2021,Liberia,LBR,Austria,AUT,0,0,0,5,5
2021,Libya,LBY,Austria,AUT,0,5,11,66,82
2021,Lebanon,LBN,Austria,AUT,10,10,18,18,56
2021,Sri Lanka,LKA,Austria,AUT,5,0,5,11,21
2021,North Macedonia,MKD,Austria,AUT,0,0,12,16,28
2021,Rep. of Moldova,MDA,Austria,AUT,0,0,13,5,18
2021,Mali,MLI,Austria,AUT,0,0,5,0,5
2021,Mongolia,MNG,Austria,AUT,5,5,63,5,78
2021,Morocco,MAR,Austria,AUT,5,0,1149,173,1327
2021,Myanmar,MMR,Austria,AUT,5,0,0,0,5
2021,Nepal,NPL,Austria,AUT,0,0,21,0,21
2021,Nigeria,NGA,Austria,AUT,17,53,163,58,291
2021,Pakistan,PAK,Austria,AUT,31,5,704,388,1128
2021,Philippines,PHL,Austria,AUT,0,0,5,0,5
2021,Romania,ROU,Austria,AUT,0,0,0,5,5
2021,Russian Federation,RUS,Austria,AUT,236,39,1552,243,2070
2021,Serbia and Kosovo: S/RES/1244 (1999),SRB,Austria,AUT,11,5,171,53,240
2021,Senegal,SEN,Austria,AUT,0,0,5,0,5
2021,Somalia,SOM,Austria,AUT,565,162,64,57,848
2021,Viet Nam,VNM,Austria,AUT,0,0,0,5,5
2021,Sudan,SDN,Austria,AUT,0,13,5,0,18
2021,Syrian Arab Rep.,SYR,Austria,AUT,6861,1053,78,1514,9506
2021,Tajikistan,TJK,Austria,AUT,19,5,5,0,29
2021,Togo,TGO,Austria,AUT,0,0,0,5,5
2021,Tunisia,TUN,Austria,AUT,5,5,207,45,262
2021,Turkey,TUR,Austria,AUT,182,5,140,337,664
2021,Uganda,UGA,Austria,AUT,5,0,0,0,5
2021,Ukraine,UKR,Austria,AUT,11,22,100,20,153
2021,Uzbekistan,UZB,Austria,AUT,5,0,28,10,43
2021,Venezuela (Bolivarian Republic of),VEN,Austria,AUT,5,16,0,5,26
2021,Yemen,YEM,Austria,AUT,29,45,0,14,88
2021,Afghanistan,AFG,Bulgaria,BGR,50,33,32,2851,2966
2021,Algeria,DZA,Bulgaria,BGR,0,0,0,27,27
2021,Egypt,EGY,Bulgaria,BGR,0,0,0,13,13
2021,Bangladesh,BGD,Bulgaria,BGR,0,0,5,11,16
2021,Cameroon,CMR,Bulgaria,BGR,0,0,0,5,5
2021,Georgia,GEO,Bulgaria,BGR,0,0,0,5,5
2021,Iran (Islamic Rep. of),IRN,Bulgaria,BGR,5,5,5,32,47
2021,Iraq,IRQ,Bulgaria,BGR,13,10,34,412,469
2021,Libya,LBY,Bulgaria,BGR,0,0,5,5,10
2021,Lebanon,LBN,Bulgaria,BGR,0,5,5,0,10
2021,Morocco,MAR,Bulgaria,BGR,0,0,10,116,126
2021,Nepal,NPL,Bulgaria,BGR,0,0,0,5,5
2021,Pakistan,PAK,Bulgaria,BGR,5,0,0,149,154
2021,Russian Federation,RUS,Bulgaria,BGR,13,0,0,0,13
2021,Viet Nam,VNM,Bulgaria,BGR,0,0,0,5,5
2021,Syrian Arab Rep.,SYR,Bulgaria,BGR,59,1792,20,300,2171
2021,Tunisia,TUN,Bulgaria,BGR,0,0,5,24,29
2021,Turkey,TUR,Bulgaria,BGR,0,0,0,21,21
2021,Ukraine,UKR,Bulgaria,BGR,0,0,0,5,5
2021,Yemen,YEM,Bulgaria,BGR,0,13,0,0,13
2021,Stateless,XXA,Bulgaria,BGR,5,19,5,19,48
2021,Chad,TCD,Central African Rep.,CAF,39,0,0,0,39
2021,Cameroon,CMR,Central African Rep.,CAF,19,0,0,0,19
2021,Dem. Rep. of the Congo,COD,Central African Rep.,CAF,5,0,0,0,5
2021,Rwanda,RWA,Central African Rep.,CAF,5,0,0,0,5
2021,Sudan,SDN,Central African Rep.,CAF,5,0,0,0,5
2021,South Sudan,SSD,Central African Rep.,CAF,55,0,0,0,55
2021,Turkey,TUR,Central African Rep.,CAF,5,0,0,0,5
2021,Central African Rep.,CAF,Chad,TCD,0,157,0,0,157
2021,Nigeria,NGA,Chad,TCD,0,5,0,0,5
2021,Sudan,SDN,Chad,TCD,0,10,0,0,10
2021,Afghanistan,AFG,Cyprus,CYP,0,0,0,5,5
2021,Algeria,DZA,Cyprus,CYP,0,0,5,0,5
2021,Egypt,EGY,Cyprus,CYP,0,0,603,116,719
2021,Armenia,ARM,Cyprus,CYP,0,0,11,0,11
2021,Bangladesh,BGD,Cyprus,CYP,5,0,1922,51,1978
2021,Burkina Faso,BFA,Cyprus,CYP,0,0,5,0,5
2021,Cameroon,CMR,Cyprus,CYP,48,0,407,87,542
2021,Congo,COG,Cyprus,CYP,0,0,17,0,17
2021,Dem. Rep. of the Congo,COD,Cyprus,CYP,5,5,233,34,277
2021,Gambia,GMB,Cyprus,CYP,0,0,30,5,35
2021,Palestinian,PSE,Cyprus,CYP,74,24,0,0,98
2021,Georgia,GEO,Cyprus,CYP,0,0,811,118,929
2021,Ghana,GHA,Cyprus,CYP,0,0,11,0,11
2021,Guinea,GIN,Cyprus,CYP,5,0,53,0,58
2021,Haiti,HTI,Cyprus,CYP,0,0,10,0,10
2021,Cote d'Ivoire,CIV,Cyprus,CYP,0,0,27,5,32
2021,India,IND,Cyprus,CYP,0,0,2117,267,2384
2021,Iran (Islamic Rep. of),IRN,Cyprus,CYP,40,0,191,13,244
2021,Iraq,IRQ,Cyprus,CYP,21,0,34,12,67
2021,Jordan,JOR,Cyprus,CYP,10,0,49,0,59
2021,Liberia,LBR,Cyprus,CYP,0,0,10,0,10
2021,Lebanon,LBN,Cyprus,CYP,0,0,37,10,47
2021,Sri Lanka,LKA,Cyprus,CYP,0,0,412,66,478
2021,Nepal,NPL,Cyprus,CYP,0,0,471,52,523
2021,Nigeria,NGA,Cyprus,CYP,10,0,497,69,576
2021,Pakistan,PAK,Cyprus,CYP,5,0,1326,54,1385
2021,Philippines,PHL,Cyprus,CYP,0,0,130,25,155
2021,Russian Federation,RUS,Cyprus,CYP,0,0,0,5,5
2021,Serbia and Kosovo: S/RES/1244 (1999),SRB,Cyprus,CYP,0,0,0,5,5
2021,Senegal,SEN,Cyprus,CYP,0,0,10,0,10
2021,Sierra Leone,SLE,Cyprus,CYP,0,0,44,0,44
2021,Somalia,SOM,Cyprus,CYP,18,32,32,31,113
2021,Viet Nam,VNM,Cyprus,CYP,0,0,397,247,644
2021,Syrian Arab Rep.,SYR,Cyprus,CYP,24,1913,0,0,1937
2021,Turkmenistan,TKM,Cyprus,CYP,0,0,5,0,5
2021,Turkey,TUR,Cyprus,CYP,0,0,14,0,14
2021,Ukraine,UKR,Cyprus,CYP,0,0,10,31,41
2021,Uzbekistan,UZB,Cyprus,CYP,0,0,0,10,10
2021,Yemen,YEM,Cyprus,CYP,14,0,0,0,14
2021,Zimbabwe,ZWE,Cyprus,CYP,0,0,10,0,10
2021,Stateless,XXA,Cyprus,CYP,10,0,0,0,10
2021,Central African Rep.,CAF,Gabon,GAB,0,0,0,12,12
2021,Chad,TCD,Gabon,GAB,0,0,5,0,5
2021,Dem. Rep. of the Congo,COD,Gabon,GAB,0,0,10,0,10
2021,Cuba,CUB,Guatemala,GTM,0,0,0,34,34
2021,Honduras,HND,Guatemala,GTM,5,0,17,114,136
2021,Mexico,MEX,Guatemala,GTM,0,0,0,5,5
2021,Nicaragua,NIC,Guatemala,GTM,10,0,13,74,97
2021,El Salvador,SLV,Guatemala,GTM,13,0,14,57,84
2021,Venezuela (Bolivarian Republic of),VEN,Guatemala,GTM,10,0,5,0,15
2021,Burkina Faso,BFA,Cote d'Ivoire,CIV,2129,0,0,0,2129
2021,Central African Rep.,CAF,Cote d'Ivoire,CIV,18,0,0,25,43
2021,Chad,TCD,Cote d'Ivoire,CIV,0,0,5,0,5
2021,Cameroon,CMR,Cote d'Ivoire,CIV,0,0,14,0,14
2021,Congo,COG,Cote d'Ivoire,CIV,0,0,5,0,5
2021,Dem. Rep. of the Congo,COD,Cote d'Ivoire,CIV,0,0,5,0,5
2021,Eritrea,ERI,Cote d'Ivoire,CIV,0,0,5,0,5
2021,Guinea,GIN,Cote d'Ivoire,CIV,0,0,5,0,5
2021,Mauritania,MRT,Cote d'Ivoire,CIV,5,0,5,0,10
2021,Mali,MLI,Cote d'Ivoire,CIV,13,0,13,0,26
2021,Nigeria,NGA,Cote d'Ivoire,CIV,0,0,5,0,5
2021,Syrian Arab Rep.,SYR,Cote d'Ivoire,CIV,5,0,0,0,5
2021,Togo,TGO,Cote d'Ivoire,CIV,0,0,5,0,5
2021,Albania,ALB,Israel,ISR,0,0,0,16,16
2021,Argentina,ARG,Israel,ISR,0,0,5,0,5
2021,Armenia,ARM,Israel,ISR,0,0,12,11,23
2021,Azerbaijan,AZE,Israel,ISR,0,0,5,13,18
2021,Burkina Faso,BFA,Israel,ISR,0,0,5,0,5
2021,Belarus,BLR,Israel,ISR,0,0,28,215,243
2021,Brazil,BRA,Israel,ISR,0,0,0,5,5
2021,China,CHN,Israel,ISR,0,0,98,21,119
2021,Dem. Rep. of the Congo,COD,Israel,ISR,0,0,0,5,5
2021,Colombia,COL,Israel,ISR,0,0,90,31,121
2021,Ecuador,ECU,Israel,ISR,0,0,14,5,19
2021,Eritrea,ERI,Israel,ISR,5,0,489,602,1096
2021,Ethiopia,ETH,Israel,ISR,0,5,20,14,39
2021,Georgia,GEO,Israel,ISR,0,0,369,137,506
2021,Ghana,GHA,Israel,ISR,0,0,169,26,195
2021,Guinea,GIN,Israel,ISR,0,0,5,0,5
2021,Honduras,HND,Israel,ISR,0,0,5,0,5
2021,India,IND,Israel,ISR,0,0,259,114,373
2021,Kazakhstan,KAZ,Israel,ISR,0,0,13,74,87
2021,Kenya,KEN,Israel,ISR,0,0,5,5,10
2021,Kyrgyzstan,KGZ,Israel,ISR,0,0,5,27,32
2021,Sri Lanka,LKA,Israel,ISR,0,0,221,68,289
2021,North Macedonia,MKD,Israel,ISR,0,0,0,5,5
2021,Rep. of Moldova,MDA,Israel,ISR,0,0,180,158,338
2021,Mexico,MEX,Israel,ISR,0,0,0,5,5
2021,Malawi,MWI,Israel,ISR,0,0,0,5,5
2021,Montenegro,MNE,Israel,ISR,0,0,0,5,5
2021,Nepal,NPL,Israel,ISR,0,0,15,5,20
2021,Nigeria,NGA,Israel,ISR,0,0,68,55,123
2021,Peru,PER,Israel,ISR,0,0,11,0,11
2021,Philippines,PHL,Israel,ISR,0,0,18,0,18
2021,Romania,ROU,Israel,ISR,0,0,5,14,19
2021,South Africa,ZAF,Israel,ISR,0,0,43,48,91
2021,Russian Federation,RUS,Israel,ISR,0,0,391,1099,1490
2021,Rwanda,RWA,Israel,ISR,0,0,5,0,5
2021,Serbia and Kosovo: S/RES/1244 (1999),SRB,Israel,ISR,0,0,11,30,41
2021,Sierra Leone,SLE,Israel,ISR,0,0,5,0,5
2021,Viet Nam,VNM,Israel,ISR,0,0,5,0,5
2021,South Sudan,SSD,Israel,ISR,0,0,0,13,13
2021,Thailand,THA,Israel,ISR,0,0,5,0,5
2021,Turkey,TUR,Israel,ISR,0,0,248,33,281
2021,Uganda,UGA,Israel,ISR,0,0,0,14,14
2021,Ukraine,UKR,Israel,ISR,0,0,846,568,1414
2021,Uzbekistan,UZB,Israel,ISR,0,0,89,66,155
2021,Afghanistan,AFG,Japan,JPN,11,0,0,0,11
2021,China,CHN,Japan,JPN,17,5,0,0,22
2021,Ethiopia,ETH,Japan,JPN,0,5,0,0,5
2021,Iran (Islamic Rep. of),IRN,Japan,JPN,5,0,0,0,5
2021,Sri Lanka,LKA,Japan,JPN,0,5,0,0,5
2021,Myanmar,MMR,Japan,JPN,32,498,0,0,530
2021,Syrian Arab Rep.,SYR,Japan,JPN,0,5,0,0,5
2021,Uganda,UGA,Japan,JPN,5,0,0,0,5
2021,Yemen,YEM,Japan,JPN,5,0,0,0,5
2021,Afghanistan,AFG,Rep. of Korea,KOR,5,0,0,0,5
2021,Algeria,DZA,Rep. of Korea,KOR,0,0,154,12,166
2021,Angola,AGO,Rep. of Korea,KOR,5,0,18,5,28
2021,Egypt,EGY,Rep. of Korea,KOR,28,0,292,88,408
2021,Burundi,BDI,Rep. of Korea,KOR,5,0,0,0,5
2021,Bangladesh,BGD,Rep. of Korea,KOR,0,0,244,132,376
2021,Burkina Faso,BFA,Rep. of Korea,KOR,0,0,10,0,10
2021,Brazil,BRA,Rep. of Korea,KOR,0,0,5,5,10
2021,Cambodia,KHM,Rep. of Korea,KOR,0,0,10,10,20
2021,China,CHN,Rep. of Korea,KOR,0,5,565,389,959
2021,Chile,CHL,Rep. of Korea,KOR,0,0,0,5,5
2021,Cameroon,CMR,Rep. of Korea,KOR,0,0,85,15,100
2021,Congo,COG,Rep. of Korea,KOR,0,0,5,0,5
2021,Dem. Rep. of the Congo,COD,Rep. of Korea,KOR,0,0,21,0,21
2021,Colombia,COL,Rep. of Korea,KOR,0,0,11,0,11
2021,Ethiopia,ETH,Rep. of Korea,KOR,11,0,44,5,60
2021,Gabon,GAB,Rep. of Korea,KOR,0,0,5,0,5
2021,Gambia,GMB,Rep. of Korea,KOR,0,0,28,0,28
2021,Ghana,GHA,Rep. of Korea,KOR,0,0,102,10,112
2021,Guinea-Bissau,GNB,Rep. of Korea,KOR,0,0,10,0,10
2021,Guinea,GIN,Rep. of Korea,KOR,0,0,55,5,60
2021,Cote d'Ivoire,CIV,Rep. of Korea,KOR,0,0,18,0,18
2021,India,IND,Rep. of Korea,KOR,0,0,599,119,718
2021,Indonesia,IDN,Rep. of Korea,KOR,0,0,13,10,23
2021,Iran (Islamic Rep. of),IRN,Rep. of Korea,KOR,0,0,10,5,15
2021,Iraq,IRQ,Rep. of Korea,KOR,0,0,10,5,15
2021,Jordan,JOR,Rep. of Korea,KOR,0,0,5,0,5
2021,Kazakhstan,KAZ,Rep. of Korea,KOR,0,0,849,533,1382
2021,Kenya,KEN,Rep. of Korea,KOR,0,0,25,5,30
2021,Kyrgyzstan,KGZ,Rep. of Korea,KOR,0,0,51,17,68
2021,Lao People's Dem. Rep.,LAO,Rep. of Korea,KOR,0,0,5,0,5
2021,Liberia,LBR,Rep. of Korea,KOR,0,0,150,21,171
2021,Libya,LBY,Rep. of Korea,KOR,0,14,0,0,14
2021,Sri Lanka,LKA,Rep. of Korea,KOR,0,0,73,76,149
2021,Mali,MLI,Rep. of Korea,KOR,0,0,29,5,34
2021,Malaysia,MYS,Rep. of Korea,KOR,0,0,375,623,998
2021,Mongolia,MNG,Rep. of Korea,KOR,0,0,183,54,237
2021,Morocco,MAR,Rep. of Korea,KOR,0,0,257,35,292
2021,Myanmar,MMR,Rep. of Korea,KOR,0,5,12,0,17
2021,Nepal,NPL,Rep. of Korea,KOR,0,0,124,84,208
2021,Nigeria,NGA,Rep. of Korea,KOR,0,0,261,20,281
2021,Pakistan,PAK,Rep. of Korea,KOR,5,0,470,226,701
2021,Peru,PER,Rep. of Korea,KOR,0,0,0,5,5
2021,Philippines,PHL,Rep. of Korea,KOR,0,0,104,226,330
2021,South Africa,ZAF,Rep. of Korea,KOR,0,0,56,10,66
2021,Russian Federation,RUS,Rep. of Korea,KOR,0,0,968,574,1542
2021,Rwanda,RWA,Rep. of Korea,KOR,0,0,5,0,5
2021,Saudi Arabia,SAU,Rep. of Korea,KOR,0,0,5,0,5
2021,Senegal,SEN,Rep. of Korea,KOR,0,0,51,5,56
2021,Sierra Leone,SLE,Rep. of Korea,KOR,0,0,11,0,11
2021,Viet Nam,VNM,Rep. of Korea,KOR,0,0,59,123,182
2021,Sudan,SDN,Rep. of Korea,KOR,0,0,23,5,28
2021,South Sudan,SSD,Rep. of Korea,KOR,0,0,5,0,5
2021,Syrian Arab Rep.,SYR,Rep. of Korea,KOR,0,15,5,5,25
2021,United Rep. of Tanzania,TZA,Rep. of Korea,KOR,0,0,13,0,13
2021,Thailand,THA,Rep. of Korea,KOR,0,0,137,54,191
2021,Tajikistan,TJK,Rep. of Korea,KOR,0,0,0,5,5
2021,Togo,TGO,Rep. of Korea,KOR,0,0,5,0,5
2021,Tunisia,TUN,Rep. of Korea,KOR,0,0,43,0,43
2021,Turkey,TUR,Rep. of Korea,KOR,0,0,167,40,207
2021,Uganda,UGA,Rep. of Korea,KOR,0,0,29,5,34
2021,Ukraine,UKR,Rep. of Korea,KOR,0,0,13,0,13
2021,United States of America,USA,Rep. of Korea,KOR,0,0,0,5,5
2021,Uzbekistan,UZB,Rep. of Korea,KOR,0,0,106,76,182
2021,Venezuela (Bolivarian Republic of),VEN,Rep. of Korea,KOR,0,0,0,10,10
2021,Yemen,YEM,Rep. of Korea,KOR,0,16,10,5,31
2021,Zimbabwe,ZWE,Rep. of Korea,KOR,0,0,5,0,5
2021,Stateless,XXA,Rep. of Korea,KOR,0,0,5,0,5
2021,Afghanistan,AFG,North Macedonia,MKD,0,5,0,5,10
2021,Algeria,DZA,North Macedonia,MKD,0,0,0,5,5
2021,Gambia,GMB,North Macedonia,MKD,0,0,0,5,5
2021,Iran (Islamic Rep. of),IRN,North Macedonia,MKD,0,0,0,5,5
2021,Iraq,IRQ,North Macedonia,MKD,0,5,0,0,5
2021,Pakistan,PAK,North Macedonia,MKD,0,0,0,14,14
2021,Serbia and Kosovo: S/RES/1244 (1999),SRB,North Macedonia,MKD,0,0,5,0,5
2021,Somalia,SOM,North Macedonia,MKD,0,0,0,5,5
2021,Syrian Arab Rep.,SYR,North Macedonia,MKD,0,0,5,21,26
2021,Turkey,TUR,North Macedonia,MKD,0,0,11,0,11
2021,Afghanistan,AFG,Montenegro,MNE,0,0,0,98,98
2021,Algeria,DZA,Montenegro,MNE,0,0,0,12,12
2021,Cuba,CUB,Montenegro,MNE,0,0,5,0,5
2021,Palestinian,PSE,Montenegro,MNE,0,0,0,10,10
2021,Iran (Islamic Rep. of),IRN,Montenegro,MNE,5,0,5,47,57
2021,Morocco,MAR,Montenegro,MNE,0,0,0,88,88
2021,Pakistan,PAK,Montenegro,MNE,0,0,0,14,14
2021,Russian Federation,RUS,Montenegro,MNE,5,0,0,0,5
2021,Syrian Arab Rep.,SYR,Montenegro,MNE,0,0,0,10,10
2021,Tunisia,TUN,Montenegro,MNE,0,0,0,5,5
2021,Turkey,TUR,Montenegro,MNE,0,0,0,14,14
2021,Congo,COG,Philippines,PHL,0,0,0,5,5
2021,Dem. Rep. of the Congo,COD,Philippines,PHL,5,0,0,0,5
2021,Pakistan,PAK,Philippines,PHL,0,0,0,5,5
2021,Syrian Arab Rep.,SYR,Philippines,PHL,0,0,0,5,5
2021,Central African Rep.,CAF,Senegal,SEN,54,0,0,0,54
2021,Gambia,GMB,Senegal,SEN,15,0,0,0,15
2021,Cote d'Ivoire,CIV,Senegal,SEN,5,0,0,0,5
2021,Liberia,LBR,Senegal,SEN,5,0,0,0,5
2021,Afghanistan,AFG,Tajikistan,TJK,3675,0,60,0,3735
2001,Bangladesh,BGD,Albania,ALB,5,0,0,0,5
2001,Iraq,IRQ,Albania,ALB,0,0,0,13,13
2001,North Macedonia,MKD,Albania,ALB,0,15,5,5,25
2001,Serbia and Kosovo: S/RES/1244 (1999),SRB,Albania,ALB,0,0,0,14,14
2001,Turkey,TUR,Albania,ALB,0,0,0,32,32
2001,Afghanistan,AFG,Australia,AUS,1667,0,429,5,2101
2001,Albania,ALB,Australia,AUS,0,0,35,5,40
2001,Algeria,DZA,Australia,AUS,0,0,19,5,24
2001,Angola,AGO,Australia,AUS,0,0,5,0,5
2001,Egypt,EGY,Australia,AUS,10,0,42,12,64
2001,Argentina,ARG,Australia,AUS,0,0,21,0,21
2001,Armenia,ARM,Australia,AUS,0,0,10,0,10
2001,Australia,AUS,Australia,AUS,0,0,5,0,5
2001,Azerbaijan,AZE,Australia,AUS,0,0,5,0,5
2001,Burundi,BDI,Australia,AUS,0,0,5,0,5
2001,Bangladesh,BGD,Australia,AUS,0,0,219,19,238
2001,Belarus,BLR,Australia,AUS,5,0,11,0,16
2001,Bolivia (Plurinational State of),BOL,Australia,AUS,0,0,10,0,10
2001,Brazil,BRA,Australia,AUS,0,0,34,0,34
2001,Bosnia and Herzegovina,BIH,Australia,AUS,5,0,5,0,10
2001,Bulgaria,BGR,Australia,AUS,0,0,5,0,5
2001,Cambodia,KHM,Australia,AUS,0,0,14,0,14
2001,China,CHN,Australia,AUS,11,0,1001,56,1068
2001,Chile,CHL,Australia,AUS,0,0,40,5,45
2001,Cameroon,CMR,Australia,AUS,0,0,5,0,5
2001,Congo,COG,Australia,AUS,0,0,17,0,17
2001,Dem. Rep. of the Congo,COD,Australia,AUS,0,0,5,0,5
2001,Colombia,COL,Australia,AUS,24,0,94,5,123
2001,Cyprus,CYP,Australia,AUS,0,0,15,0,15
2001,Czechia,CZE,Australia,AUS,0,0,5,0,5
2001,Ecuador,ECU,Australia,AUS,0,0,30,0,30
2001,Eritrea,ERI,Australia,AUS,0,0,5,0,5
2001,Estonia,EST,Australia,AUS,0,0,5,0,5
2001,Ethiopia,ETH,Australia,AUS,5,0,10,0,15
2001,Fiji,FJI,Australia,AUS,0,0,768,25,793
2001,France,FRA,Australia,AUS,0,0,5,0,5
2001,Palestinian,PSE,Australia,AUS,39,0,119,0,158
2001,United Kingdom of Great Britain and Northern Ireland,GBR,Australia,AUS,0,0,12,0,12
2001,Georgia,GEO,Australia,AUS,0,0,12,0,12
2001,Ghana,GHA,Australia,AUS,0,0,35,5,40
2001,Greece,GRC,Australia,AUS,0,0,0,5,5
2001,Guinea,GIN,Australia,AUS,0,0,5,0,5
2001,"China, Hong Kong SAR",HKG,Australia,AUS,0,0,5,0,5
2001,Croatia,HRV,Australia,AUS,0,0,5,0,5
2001,India,IND,Australia,AUS,0,0,476,40,516
2001,Indonesia,IDN,Australia,AUS,5,0,763,33,801
2001,Iran (Islamic Rep. of),IRN,Australia,AUS,190,0,439,22,651
2001,Iraq,IRQ,Australia,AUS,1081,0,230,16,1327
2001,Israel,ISR,Australia,AUS,0,0,24,5,29
2001,Italy,ITA,Australia,AUS,0,0,14,0,14
2001,Jordan,JOR,Australia,AUS,5,0,33,0,38
2001,Kyrgyzstan,KGZ,Australia,AUS,0,0,16,0,16
2001,Rep. of Korea,KOR,Australia,AUS,0,0,169,16,185
2001,Dem. People's Rep. of Korea,PRK,Australia,AUS,0,0,5,0,5
2001,Lao People's Dem. Rep.,LAO,Australia,AUS,0,0,12,0,12
2001,Lebanon,LBN,Australia,AUS,10,0,125,5,140
2001,Sri Lanka,LKA,Australia,AUS,95,0,228,19,342
2001,Lithuania,LTU,Australia,AUS,0,0,21,0,21
2001,Latvia,LVA,Australia,AUS,0,0,10,0,10
2001,Mauritania,MRT,Australia,AUS,0,0,5,0,5
2001,North Macedonia,MKD,Australia,AUS,0,0,67,10,77
2001,Rep. of Moldova,MDA,Australia,AUS,0,0,23,0,23
2001,Malaysia,MYS,Australia,AUS,0,0,234,11,245
2001,Mongolia,MNG,Australia,AUS,0,0,56,0,56
2001,Myanmar,MMR,Australia,AUS,10,0,65,10,85
2001,Nepal,NPL,Australia,AUS,0,0,67,0,67
2001,Nigeria,NGA,Australia,AUS,5,0,80,5,90
2001,Pakistan,PAK,Australia,AUS,44,0,90,10,144
2001,Peru,PER,Australia,AUS,0,0,82,0,82
2001,Philippines,PHL,Australia,AUS,0,0,203,5,208
2001,Papua New Guinea,PNG,Australia,AUS,0,0,13,0,13
2001,Poland,POL,Australia,AUS,0,0,11,0,11
2001,Romania,ROU,Australia,AUS,0,0,26,0,26
2001,South Africa,ZAF,Australia,AUS,0,0,36,5,41
2001,Russian Federation,RUS,Australia,AUS,10,0,74,5,89
2001,Senegal,SEN,Australia,AUS,0,0,5,0,5
2001,Singapore,SGP,Australia,AUS,5,0,5,0,10
2001,Sierra Leone,SLE,Australia,AUS,0,0,10,0,10
2001,Solomon Islands,SLB,Australia,AUS,5,0,16,0,21
2001,Somalia,SOM,Australia,AUS,0,0,12,0,12
2001,Viet Nam,VNM,Australia,AUS,0,0,187,14,201
2001,Sudan,SDN,Australia,AUS,0,0,14,0,14
2001,Slovakia,SVK,Australia,AUS,0,0,5,0,5
2001,Syrian Arab Rep.,SYR,Australia,AUS,10,0,41,0,51
2001,United Rep. of Tanzania,TZA,Australia,AUS,0,0,5,0,5
2001,Thailand,THA,Australia,AUS,0,0,177,5,182
2001,Tonga,TON,Australia,AUS,0,0,59,12,71
2001,Tunisia,TUN,Australia,AUS,0,0,11,0,11
2001,Turkey,TUR,Australia,AUS,18,0,79,5,102
2001,Uganda,UGA,Australia,AUS,0,0,5,5,10
2001,Ukraine,UKR,Australia,AUS,0,0,108,5,113
2001,Uruguay,URY,Australia,AUS,0,0,19,0,19
2001,United States of America,USA,Australia,AUS,0,0,5,0,5
2001,Uzbekistan,UZB,Australia,AUS,0,0,14,0,14
2001,Venezuela (Bolivarian Republic of),VEN,Australia,AUS,0,0,5,0,5
2001,Samoa,WSM,Australia,AUS,0,0,10,0,10
2001,Yemen,YEM,Australia,AUS,0,0,5,0,5
2001,Zimbabwe,ZWE,Australia,AUS,5,0,29,5,39
2001,Stateless,XXA,Australia,AUS,26,0,25,0,51
2001,Dem. Rep. of the Congo,COD,Burundi,BDI,11,0,0,0,11
2001,Rwanda,RWA,Burundi,BDI,0,0,0,46,46
2001,United Rep. of Tanzania,TZA,Burundi,BDI,0,0,0,10,10
2001,Colombia,COL,Costa Rica,CRI,2126,0,1545,277,3948
2001,Cuba,CUB,Costa Rica,CRI,70,0,12,0,82
2001,Guatemala,GTM,Costa Rica,CRI,10,0,0,0,10
2001,Nicaragua,NIC,Costa Rica,CRI,0,0,5,0,5
2001,Peru,PER,Costa Rica,CRI,14,0,11,0,25
2001,Afghanistan,AFG,Czechia,CZE,10,0,49,535,594
2001,Algeria,DZA,Czechia,CZE,0,0,44,72,116
2001,Angola,AGO,Czechia,CZE,0,0,5,0,5
2001,Armenia,ARM,Czechia,CZE,0,0,193,392,585
2001,Azerbaijan,AZE,Czechia,CZE,0,0,5,33,38
2001,Belarus,BLR,Czechia,CZE,23,0,108,121,252
2001,Bulgaria,BGR,Czechia,CZE,0,0,171,77,248
2001,China,CHN,Czechia,CZE,0,0,0,13,13
2001,Georgia,GEO,Czechia,CZE,5,0,137,480,622
2001,Ghana,GHA,Czechia,CZE,0,0,0,10,10
2001,Guinea,GIN,Czechia,CZE,0,0,0,5,5
2001,Cote d'Ivoire,CIV,Czechia,CZE,0,0,11,0,11
2001,India,IND,Czechia,CZE,0,0,5,1397,1402
2001,Iran (Islamic Rep. of),IRN,Czechia,CZE,10,0,5,10,25
2001,Iraq,IRQ,Czechia,CZE,5,0,0,268,273
2001,Kazakhstan,KAZ,Czechia,CZE,0,0,48,0,48
2001,Kyrgyzstan,KGZ,Czechia,CZE,0,0,5,12,17
2001,Sri Lanka,LKA,Czechia,CZE,0,0,10,168,178
2001,Lithuania,LTU,Czechia,CZE,0,0,0,13,13
2001,North Macedonia,MKD,Czechia,CZE,0,0,50,0,50
2001,Rep. of Moldova,MDA,Czechia,CZE,0,0,758,669,1427
2001,Mongolia,MNG,Czechia,CZE,0,0,106,0,106
2001,Nigeria,NGA,Czechia,CZE,0,0,11,17,28
2001,Pakistan,PAK,Czechia,CZE,0,0,10,89,99
2001,Romania,ROU,Czechia,CZE,0,0,514,1174,1688
2001,Russian Federation,RUS,Czechia,CZE,5,0,204,255,464
2001,Serbia and Kosovo: S/RES/1244 (1999),SRB,Czechia,CZE,10,0,81,15,106
2001,Viet Nam,VNM,Czechia,CZE,0,0,692,210,902
2001,Slovakia,SVK,Czechia,CZE,0,0,290,56,346
2001,Syrian Arab Rep.,SYR,Czechia,CZE,0,0,0,23,23
2001,Turkey,TUR,Czechia,CZE,0,0,0,66,66
2001,Ukraine,UKR,Czechia,CZE,5,0,2440,86,2531
2001,Uzbekistan,UZB,Czechia,CZE,0,0,10,0,10
2001,Stateless,XXA,Czechia,CZE,0,0,14,16,30
2001,Afghanistan,AFG,United Kingdom of Great Britain and Northern Ireland,GBR,2260,7370,1070,1460,12160
2001,Albania,ALB,United Kingdom of Great Britain and Northern Ireland,GBR,30,160,1120,400,1710
2001,Algeria,DZA,United Kingdom of Great Britain and Northern Ireland,GBR,60,75,1925,600,2660
2001,Angola,AGO,United Kingdom of Great Britain and Northern Ireland,GBR,100,495,475,185,1255
2001,Burundi,BDI,United Kingdom of Great Britain and Northern Ireland,GBR,225,250,380,245,1100
2001,Bangladesh,BGD,United Kingdom of Great Britain and Northern Ireland,GBR,10,40,645,260,955
2001,China,CHN,United Kingdom of Great Britain and Northern Ireland,GBR,15,160,2890,1220,4285
2001,Dem. Rep. of the Congo,COD,United Kingdom of Great Britain and Northern Ireland,GBR,310,330,1530,260,2430
2001,Colombia,COL,United Kingdom of Great Britain and Northern Ireland,GBR,40,55,550,105,750
2001,Czechia,CZE,United Kingdom of Great Britain and Northern Ireland,GBR,0,5,800,90,895
2001,Ecuador,ECU,United Kingdom of Great Britain and Northern Ireland,GBR,10,10,390,100,510
2001,Eritrea,ERI,United Kingdom of Great Britain and Northern Ireland,GBR,120,235,840,100,1295
2001,Ethiopia,ETH,United Kingdom of Great Britain and Northern Ireland,GBR,85,235,750,85,1155
2001,Gambia,GMB,United Kingdom of Great Britain and Northern Ireland,GBR,5,20,50,15,90
2001,Ghana,GHA,United Kingdom of Great Britain and Northern Ireland,GBR,45,45,215,105,410
2001,Cote d'Ivoire,CIV,United Kingdom of Great Britain and Northern Ireland,GBR,15,20,365,80,480
2001,India,IND,United Kingdom of Great Britain and Northern Ireland,GBR,15,45,1590,1255,2905
2001,Iran (Islamic Rep. of),IRN,United Kingdom of Great Britain and Northern Ireland,GBR,555,295,4015,955,5820
2001,Iraq,IRQ,United Kingdom of Great Britain and Northern Ireland,GBR,815,1855,4680,1530,8880
2001,Jamaica,JAM,United Kingdom of Great Britain and Northern Ireland,GBR,5,15,315,145,480
2001,Kenya,KEN,United Kingdom of Great Britain and Northern Ireland,GBR,20,70,625,180,895
2001,Sri Lanka,LKA,United Kingdom of Great Britain and Northern Ireland,GBR,1415,525,7245,980,10165
2001,North Macedonia,MKD,United Kingdom of Great Britain and Northern Ireland,GBR,5,140,340,140,625
2001,Nepal,NPL,United Kingdom of Great Britain and Northern Ireland,GBR,25,15,770,190,1000
2001,Nigeria,NGA,United Kingdom of Great Britain and Northern Ireland,GBR,25,130,745,355,1255
2001,Pakistan,PAK,United Kingdom of Great Britain and Northern Ireland,GBR,220,130,2685,1255,4290
2001,Poland,POL,United Kingdom of Great Britain and Northern Ireland,GBR,0,10,650,140,800
2001,Romania,ROU,United Kingdom of Great Britain and Northern Ireland,GBR,0,70,880,1200,2150
2001,Russian Federation,RUS,United Kingdom of Great Britain and Northern Ireland,GBR,75,145,2370,1110,3670
2001,Rwanda,RWA,United Kingdom of Great Britain and Northern Ireland,GBR,200,320,260,180,960
2001,Serbia and Kosovo: S/RES/1244 (1999),SRB,United Kingdom of Great Britain and Northern Ireland,GBR,365,2045,7325,2005,11965
2001,Sierra Leone,SLE,United Kingdom of Great Britain and Northern Ireland,GBR,165,1405,685,430,2685
2001,Somalia,SOM,United Kingdom of Great Britain and Northern Ireland,GBR,2845,1960,2145,1350,8300
2001,Sudan,SDN,United Kingdom of Great Britain and Northern Ireland,GBR,120,50,520,75,765
2001,United Rep. of Tanzania,TZA,United Kingdom of Great Britain and Northern Ireland,GBR,5,20,90,20,135
2001,Turkey,TUR,United Kingdom of Great Britain and Northern Ireland,GBR,195,275,6270,925,7665
2001,Uganda,UGA,United Kingdom of Great Britain and Northern Ireland,GBR,50,90,805,135,1080
2001,Ukraine,UKR,United Kingdom of Great Britain and Northern Ireland,GBR,10,25,825,290,1150
2001,Zimbabwe,ZWE,United Kingdom of Great Britain and Northern Ireland,GBR,115,45,1750,200,2110
2001,Afghanistan,AFG,Malta,MLT,5,5,0,0,10
2001,Algeria,DZA,Malta,MLT,0,0,5,0,5
2001,Egypt,EGY,Malta,MLT,5,0,0,0,5
2001,Palestinian,PSE,Malta,MLT,0,5,5,0,10
2001,India,IND,Malta,MLT,0,0,5,0,5
2001,Iraq,IRQ,Malta,MLT,5,0,5,0,10
2001,Libya,LBY,Malta,MLT,10,0,0,0,10
2001,Sri Lanka,LKA,Malta,MLT,10,0,0,0,10
2001,Morocco,MAR,Malta,MLT,0,5,0,0,5
2001,Sierra Leone,SLE,Malta,MLT,10,0,0,0,10
2001,Sudan,SDN,Malta,MLT,0,10,0,0,10
2001,Turkey,TUR,Malta,MLT,0,10,0,0,10
2002,North Macedonia,MKD,Albania,ALB,0,5,0,23,28
2002,Serbia and Kosovo: S/RES/1244 (1999),SRB,Albania,ALB,0,0,5,22,27
2002,Turkey,TUR,Albania,ALB,5,0,5,57,67
2002,Dem. Rep. of the Congo,COD,Burundi,BDI,12,0,0,0,12
2002,Afghanistan,AFG,Czechia,CZE,14,0,10,80,104
2002,Algeria,DZA,Czechia,CZE,0,0,25,54,79
2002,Armenia,ARM,Czechia,CZE,5,0,134,597,736
2002,Azerbaijan,AZE,Czechia,CZE,5,0,0,62,67
2002,Belarus,BLR,Czechia,CZE,26,0,105,203,334
2002,Bulgaria,BGR,Czechia,CZE,0,0,116,86,202
2002,China,CHN,Czechia,CZE,0,0,170,136,306
2002,Georgia,GEO,Czechia,CZE,0,0,73,991,1064
2002,Ghana,GHA,Czechia,CZE,0,0,5,0,5
2002,Guinea,GIN,Czechia,CZE,0,0,0,10,10
2002,Cote d'Ivoire,CIV,Czechia,CZE,0,0,0,19,19
2002,India,IND,Czechia,CZE,0,0,182,232,414
2002,Iran (Islamic Rep. of),IRN,Czechia,CZE,0,0,0,10,10
2002,Iraq,IRQ,Czechia,CZE,10,0,26,208,244
2002,Kazakhstan,KAZ,Czechia,CZE,0,0,72,49,121
2002,Kyrgyzstan,KGZ,Czechia,CZE,0,0,39,17,56
2002,Sri Lanka,LKA,Czechia,CZE,0,0,5,14,19
2002,Lithuania,LTU,Czechia,CZE,0,0,14,5,19
2002,North Macedonia,MKD,Czechia,CZE,0,0,23,28,51
2002,Rep. of Moldova,MDA,Czechia,CZE,0,0,587,1087,1674
2002,Mongolia,MNG,Czechia,CZE,0,0,64,66,130
2002,Nigeria,NGA,Czechia,CZE,0,0,0,28,28
2002,Pakistan,PAK,Czechia,CZE,0,0,5,13,18
2002,Romania,ROU,Czechia,CZE,0,0,112,375,487
2002,Russian Federation,RUS,Czechia,CZE,28,0,128,466,622
2002,Serbia and Kosovo: S/RES/1244 (1999),SRB,Czechia,CZE,0,0,42,44,86
2002,Senegal,SEN,Czechia,CZE,0,0,5,5,10
2002,Somalia,SOM,Czechia,CZE,0,0,0,5,5
2002,Viet Nam,VNM,Czechia,CZE,0,0,731,543,1274
2002,Slovakia,SVK,Czechia,CZE,0,0,633,93,726
2002,Syrian Arab Rep.,SYR,Czechia,CZE,5,0,0,16,21
2002,Turkey,TUR,Czechia,CZE,0,0,0,38,38
2002,Ukraine,UKR,Czechia,CZE,0,0,1750,1391,3141
2002,Uzbekistan,UZB,Czechia,CZE,0,0,15,22,37
2002,Stateless,XXA,Czechia,CZE,0,0,52,55,107
2002,Afghanistan,AFG,United Kingdom of Great Britain and Northern Ireland,GBR,115,4765,2360,935,8175
2002,Albania,ALB,United Kingdom of Great Britain and Northern Ireland,GBR,20,285,695,255,1255
2002,Algeria,DZA,United Kingdom of Great Britain and Northern Ireland,GBR,20,35,770,305,1130
2002,Angola,AGO,United Kingdom of Great Britain and Northern Ireland,GBR,65,700,420,155,1340
2002,Burundi,BDI,United Kingdom of Great Britain and Northern Ireland,GBR,115,230,270,75,590
2002,Bangladesh,BGD,United Kingdom of Great Britain and Northern Ireland,GBR,5,170,335,110,620
2002,China,CHN,United Kingdom of Great Britain and Northern Ireland,GBR,15,240,1850,1510,3615
2002,Cameroon,CMR,United Kingdom of Great Britain and Northern Ireland,GBR,40,45,395,45,525
2002,Congo,COG,United Kingdom of Great Britain and Northern Ireland,GBR,35,60,420,60,575
2002,Dem. Rep. of the Congo,COD,United Kingdom of Great Britain and Northern Ireland,GBR,155,305,1390,200,2050
2002,Colombia,COL,United Kingdom of Great Britain and Northern Ireland,GBR,45,20,345,70,480
2002,Czechia,CZE,United Kingdom of Great Britain and Northern Ireland,GBR,0,10,1060,160,1230
2002,Ecuador,ECU,United Kingdom of Great Britain and Northern Ireland,GBR,20,10,240,50,320
2002,Eritrea,ERI,United Kingdom of Great Britain and Northern Ireland,GBR,140,210,675,80,1105
2002,Ethiopia,ETH,United Kingdom of Great Britain and Northern Ireland,GBR,50,170,420,65,705
2002,Gambia,GMB,United Kingdom of Great Britain and Northern Ireland,GBR,0,5,55,55,115
2002,Ghana,GHA,United Kingdom of Great Britain and Northern Ireland,GBR,15,10,165,65,255
2002,Cote d'Ivoire,CIV,United Kingdom of Great Britain and Northern Ireland,GBR,10,15,170,30,225
2002,India,IND,United Kingdom of Great Britain and Northern Ireland,GBR,5,35,1125,690,1855
2002,Iran (Islamic Rep. of),IRN,United Kingdom of Great Britain and Northern Ireland,GBR,395,145,2140,280,2960
2002,Iraq,IRQ,United Kingdom of Great Britain and Northern Ireland,GBR,715,8195,1770,1230,11910
2002,Jamaica,JAM,United Kingdom of Great Britain and Northern Ireland,GBR,10,15,600,290,915
2002,Kenya,KEN,United Kingdom of Great Britain and Northern Ireland,GBR,15,45,260,40,360
2002,Sri Lanka,LKA,United Kingdom of Great Britain and Northern Ireland,GBR,340,275,3265,405,4285
2002,North Macedonia,MKD,United Kingdom of Great Britain and Northern Ireland,GBR,5,140,220,75,440
2002,Rep. of Moldova,MDA,United Kingdom of Great Britain and Northern Ireland,GBR,5,110,290,305,710
2002,Nigeria,NGA,United Kingdom of Great Britain and Northern Ireland,GBR,25,75,675,335,1110
2002,Pakistan,PAK,United Kingdom of Great Britain and Northern Ireland,GBR,135,75,1660,645,2515
2002,Poland,POL,United Kingdom of Great Britain and Northern Ireland,GBR,0,0,760,145,905
2002,Romania,ROU,United Kingdom of Great Britain and Northern Ireland,GBR,5,70,540,555,1170
2002,Russian Federation,RUS,United Kingdom of Great Britain and Northern Ireland,GBR,15,20,250,75,360
2002,Rwanda,RWA,United Kingdom of Great Britain and Northern Ireland,GBR,125,245,245,70,685
2002,Serbia and Kosovo: S/RES/1244 (1999),SRB,United Kingdom of Great Britain and Northern Ireland,GBR,225,825,1940,505,3495
2002,Sierra Leone,SLE,United Kingdom of Great Britain and Northern Ireland,GBR,55,185,895,365,1500
2002,Somalia,SOM,United Kingdom of Great Britain and Northern Ireland,GBR,2515,1405,2260,560,6740
2002,Viet Nam,VNM,United Kingdom of Great Britain and Northern Ireland,GBR,25,135,440,120,720
2002,Sudan,SDN,United Kingdom of Great Britain and Northern Ireland,GBR,70,40,405,50,565
2002,United Rep. of Tanzania,TZA,United Kingdom of Great Britain and Northern Ireland,GBR,5,5,30,5,45
2002,Turkey,TUR,United Kingdom of Great Britain and Northern Ireland,GBR,150,200,2805,340,3495
2002,Uganda,UGA,United Kingdom of Great Britain and Northern Ireland,GBR,35,120,445,65,665
2002,Ukraine,UKR,United Kingdom of Great Britain and Northern Ireland,GBR,0,10,255,45,310
2002,Zimbabwe,ZWE,United Kingdom of Great Britain and Northern Ireland,GBR,2240,110,2960,925,6235
2002,Afghanistan,AFG,Malta,MLT,0,0,0,5,5
2002,Algeria,DZA,Malta,MLT,0,0,5,0,5
2002,Bangladesh,BGD,Malta,MLT,0,0,13,0,13
2002,Chad,TCD,Malta,MLT,0,0,5,0,5
2002,Cameroon,CMR,Malta,MLT,0,0,5,0,5
2002,Congo,COG,Malta,MLT,0,0,5,0,5
2002,Dem. Rep. of the Congo,COD,Malta,MLT,5,0,5,0,10
2002,Eritrea,ERI,Malta,MLT,0,5,94,0,99
2002,Ethiopia,ETH,Malta,MLT,5,5,0,0,10
2002,Palestinian,PSE,Malta,MLT,0,0,10,0,10
2002,Ghana,GHA,Malta,MLT,0,0,5,0,5
2002,Iraq,IRQ,Malta,MLT,10,24,0,0,34
2002,Liberia,LBR,Malta,MLT,0,0,12,0,12
2002,Libya,LBY,Malta,MLT,0,0,5,0,5
2002,Mauritania,MRT,Malta,MLT,0,0,5,0,5
2002,Pakistan,PAK,Malta,MLT,0,0,5,0,5
2002,Sierra Leone,SLE,Malta,MLT,0,0,10,0,10
2002,Somalia,SOM,Malta,MLT,0,55,0,0,55
2002,Sudan,SDN,Malta,MLT,0,0,30,0,30
2002,Syrian Arab Rep.,SYR,Malta,MLT,0,5,0,0,5
2002,Turkey,TUR,Malta,MLT,0,0,14,0,14
2003,Ethiopia,ETH,Djibouti,DJI,16,0,200,0,216
2003,Somalia,SOM,Djibouti,DJI,1648,0,0,0,1648
2003,Dem. Rep. of the Congo,COD,Sudan,SDN,16,0,10,0,26
2003,Eritrea,ERI,Sudan,SDN,488,0,742,0,1230
2003,Ethiopia,ETH,Sudan,SDN,398,0,696,0,1094
2003,Somalia,SOM,Sudan,SDN,5,0,14,0,19
2003,Angola,AGO,Zambia,ZMB,0,0,0,73,73
2003,Burundi,BDI,Zambia,ZMB,23,0,16,182,221
2003,Dem. Rep. of the Congo,COD,Zambia,ZMB,55,0,35,264,354
2003,Rwanda,RWA,Zambia,ZMB,5,0,11,344,360
2003,Somalia,SOM,Zambia,ZMB,11,0,5,48,64
2004,Eritrea,ERI,Djibouti,DJI,5,0,54,5,64
2004,Ethiopia,ETH,Djibouti,DJI,72,0,1181,0,1253
2004,Somalia,SOM,Djibouti,DJI,0,0,329,0,329
2004,Sudan,SDN,Djibouti,DJI,0,0,5,0,5
2004,Burundi,BDI,Zambia,ZMB,15,0,10,29,54
2004,Dem. Rep. of the Congo,COD,Zambia,ZMB,39,0,43,172,254
2004,Rwanda,RWA,Zambia,ZMB,5,0,0,42,47
2004,Somalia,SOM,Zambia,ZMB,17,0,31,32,80
2005,Central African Rep.,CAF,Gabon,GAB,0,0,5,5,10
2005,Chad,TCD,Gabon,GAB,0,0,15,13,28
2005,Congo,COG,Gabon,GAB,0,0,19,28,47
2005,Dem. Rep. of the Congo,COD,Gabon,GAB,0,0,50,35,85
2005,Equatorial Guinea,GNQ,Gabon,GAB,0,0,5,0,5
2005,Cote d'Ivoire,CIV,Gabon,GAB,0,0,15,5,20
2005,Liberia,LBR,Gabon,GAB,0,0,0,5,5
2005,Mauritania,MRT,Gabon,GAB,0,0,5,0,5
2005,Sudan,SDN,Gabon,GAB,0,0,5,0,5
2005,Togo,TGO,Gabon,GAB,0,0,12,0,12
2006,Cote d'Ivoire,CIV,Liberia,LBR,0,0,0,10,10
2006,Sierra Leone,SLE,Liberia,LBR,0,0,0,10,10
2006,Togo,TGO,Liberia,LBR,0,0,0,5,5
2008,Colombia,COL,Argentina,ARG,68,0,30,5,103
2008,Cuba,CUB,Argentina,ARG,11,0,18,0,29
2008,Dominican Rep.,DOM,Argentina,ARG,0,0,0,5,5
2008,Ghana,GHA,Argentina,ARG,5,0,5,0,10
2008,Guinea-Bissau,GNB,Argentina,ARG,0,0,5,0,5
2008,Haiti,HTI,Argentina,ARG,11,0,5,0,16
2008,India,IND,Argentina,ARG,0,0,5,0,5
2008,Peru,PER,Argentina,ARG,0,0,14,0,14
2008,Serbia and Kosovo: S/RES/1244 (1999),SRB,Argentina,ARG,0,0,5,0,5
2008,Senegal,SEN,Argentina,ARG,0,0,348,0,348
2008,Tunisia,TUN,Argentina,ARG,5,0,0,0,5
2008,Ukraine,UKR,Argentina,ARG,5,0,0,0,5
2010,Afghanistan,AFG,Bulgaria,BGR,5,5,14,20,44
2010,Algeria,DZA,Bulgaria,BGR,0,0,13,40,53
2010,Egypt,EGY,Bulgaria,BGR,0,0,5,0,5
2010,Armenia,ARM,Bulgaria,BGR,0,5,52,0,57
2010,Bangladesh,BGD,Bulgaria,BGR,0,0,5,0,5
2010,China,CHN,Bulgaria,BGR,0,0,5,0,5
2010,Cameroon,CMR,Bulgaria,BGR,0,0,5,0,5
2010,Dem. Rep. of the Congo,COD,Bulgaria,BGR,0,5,0,0,5
2010,Ethiopia,ETH,Bulgaria,BGR,5,0,0,0,5
2010,Georgia,GEO,Bulgaria,BGR,0,0,5,5,10
2010,Iran (Islamic Rep. of),IRN,Bulgaria,BGR,5,5,31,37,78
2010,Iraq,IRQ,Bulgaria,BGR,0,86,89,58,233
2010,Lebanon,LBN,Bulgaria,BGR,0,0,5,5,10
2010,Sri Lanka,LKA,Bulgaria,BGR,0,0,5,0,5
2010,Rep. of Moldova,MDA,Bulgaria,BGR,0,0,0,5,5
2010,Morocco,MAR,Bulgaria,BGR,0,0,5,14,19
2010,Myanmar,MMR,Bulgaria,BGR,0,0,0,10,10
2010,Nigeria,NGA,Bulgaria,BGR,0,0,12,0,12
2010,Pakistan,PAK,Bulgaria,BGR,0,0,0,10,10
2010,Russian Federation,RUS,Bulgaria,BGR,0,0,11,0,11
2010,Sudan,SDN,Bulgaria,BGR,0,5,12,0,17
2010,Syrian Arab Rep.,SYR,Bulgaria,BGR,0,5,17,10,32
2010,United Rep. of Tanzania,TZA,Bulgaria,BGR,0,0,5,0,5
2010,Tunisia,TUN,Bulgaria,BGR,0,0,0,5,5
2010,Turkey,TUR,Bulgaria,BGR,0,0,5,10,15
2010,Ukraine,UKR,Bulgaria,BGR,0,0,5,0,5
2010,Stateless,XXA,Bulgaria,BGR,5,5,59,52,121
2011,Afghanistan,AFG,Slovakia,SVK,0,47,10,19,76
2011,Algeria,DZA,Slovakia,SVK,0,0,0,5,5
2011,Egypt,EGY,Slovakia,SVK,0,0,5,0,5
2011,Armenia,ARM,Slovakia,SVK,0,0,0,10,10
2011,Bangladesh,BGD,Slovakia,SVK,0,0,0,5,5
2011,China,CHN,Slovakia,SVK,0,0,11,10,21
2011,Cuba,CUB,Slovakia,SVK,5,0,0,0,5
2011,Palestinian,PSE,Slovakia,SVK,0,0,5,0,5
2011,Georgia,GEO,Slovakia,SVK,0,0,5,57,62
2011,India,IND,Slovakia,SVK,0,0,5,21,26
2011,Iran (Islamic Rep. of),IRN,Slovakia,SVK,0,0,0,11,11
2011,Iraq,IRQ,Slovakia,SVK,0,0,5,5,10
2011,Rep. of Moldova,MDA,Slovakia,SVK,0,0,10,31,41
2011,Nigeria,NGA,Slovakia,SVK,0,0,0,5,5
2011,Pakistan,PAK,Slovakia,SVK,0,0,0,12,12
2011,Russian Federation,RUS,Slovakia,SVK,0,0,5,41,46
2011,Serbia and Kosovo: S/RES/1244 (1999),SRB,Slovakia,SVK,0,0,0,5,5
2011,Somalia,SOM,Slovakia,SVK,0,42,0,10,52
2011,Viet Nam,VNM,Slovakia,SVK,0,0,10,14,24
2011,Syrian Arab Rep.,SYR,Slovakia,SVK,5,0,0,5,10
2011,Turkey,TUR,Slovakia,SVK,0,0,5,10,15
2011,Ukraine,UKR,Slovakia,SVK,0,0,0,5,5
2012,Burundi,BDI,Mali,MLI,0,0,0,5,5
2012,Burkina Faso,BFA,Mali,MLI,0,0,0,5,5
2012,Central African Rep.,CAF,Mali,MLI,0,0,0,14,14
2012,Chad,TCD,Mali,MLI,0,0,0,15,15
2012,Cameroon,CMR,Mali,MLI,0,0,0,18,18
2012,Congo,COG,Mali,MLI,0,0,0,28,28
2012,Dem. Rep. of the Congo,COD,Mali,MLI,11,0,0,83,94
2012,Guinea,GIN,Mali,MLI,0,0,0,5,5
2012,Cote d'Ivoire,CIV,Mali,MLI,12,0,0,1868,1880
2012,Liberia,LBR,Mali,MLI,0,0,0,5,5
2012,Mauritania,MRT,Mali,MLI,0,0,0,132,132
2012,Nigeria,NGA,Mali,MLI,0,0,0,27,27
2012,Rwanda,RWA,Mali,MLI,0,0,0,20,20
2012,Togo,TGO,Mali,MLI,0,0,0,49,49
2013,Liberia,LBR,Guinea-Bissau,GNB,0,0,0,15,15
2013,Central African Rep.,CAF,Mali,MLI,15,0,0,0,15
2013,Dem. Rep. of the Congo,COD,Mali,MLI,40,0,0,0,40
2013,Cote d'Ivoire,CIV,Mali,MLI,5,0,0,5,10
2013,Burundi,BDI,Rwanda,RWA,0,5,0,0,5
2013,Dem. Rep. of the Congo,COD,Rwanda,RWA,14264,0,0,0,14264
2013,Burundi,BDI,Zimbabwe,ZWE,5,0,5,0,10
2013,Dem. Rep. of the Congo,COD,Zimbabwe,ZWE,334,0,51,82,467
2013,Ethiopia,ETH,Zimbabwe,ZWE,5,0,0,0,5
2013,Cote d'Ivoire,CIV,Zimbabwe,ZWE,0,0,5,0,5
2013,Mali,MLI,Zimbabwe,ZWE,5,0,0,0,5
2013,Rwanda,RWA,Zimbabwe,ZWE,10,0,10,5,25
2013,Somalia,SOM,Zimbabwe,ZWE,5,0,0,0,5
2014,Central African Rep.,CAF,Mali,MLI,855,0,0,0,855
2014,Dem. Rep. of the Congo,COD,Mali,MLI,20,0,0,0,20
2014,Liberia,LBR,Mali,MLI,0,0,0,5,5
2014,Pakistan,PAK,Mali,MLI,5,0,0,0,5
2014,Rwanda,RWA,Mali,MLI,5,0,0,0,5
2014,Syrian Arab Rep.,SYR,Mali,MLI,16,0,0,0,16
2014,Afghanistan,AFG,New Zealand,NZL,5,0,5,0,10
2014,Egypt,EGY,New Zealand,NZL,0,0,5,0,5
2014,Bangladesh,BGD,New Zealand,NZL,0,0,5,0,5
2014,Brazil,BRA,New Zealand,NZL,0,0,5,0,5
2014,China,CHN,New Zealand,NZL,10,0,19,0,29
2014,Czechia,CZE,New Zealand,NZL,0,0,5,0,5
2014,Fiji,FJI,New Zealand,NZL,0,0,16,0,16
2014,Palestinian,PSE,New Zealand,NZL,5,0,5,0,10
2014,Georgia,GEO,New Zealand,NZL,0,0,5,0,5
2014,India,IND,New Zealand,NZL,0,0,17,0,17
2014,Iran (Islamic Rep. of),IRN,New Zealand,NZL,0,0,11,0,11
2014,Iraq,IRQ,New Zealand,NZL,14,0,0,0,14
2014,Kiribati,KIR,New Zealand,NZL,0,0,5,0,5
2014,Sri Lanka,LKA,New Zealand,NZL,5,0,35,0,40
2014,Mexico,MEX,New Zealand,NZL,0,0,5,0,5
2014,Malaysia,MYS,New Zealand,NZL,0,0,5,0,5
2014,Myanmar,MMR,New Zealand,NZL,0,0,5,0,5
2014,Nepal,NPL,New Zealand,NZL,0,0,5,0,5
2014,Pakistan,PAK,New Zealand,NZL,5,0,18,0,23
2014,Philippines,PHL,New Zealand,NZL,0,0,5,0,5
2014,Saudi Arabia,SAU,New Zealand,NZL,5,0,0,0,5
2014,Viet Nam,VNM,New Zealand,NZL,5,0,0,0,5
2014,Slovakia,SVK,New Zealand,NZL,0,0,5,0,5
2014,Syrian Arab Rep.,SYR,New Zealand,NZL,13,0,0,0,13
2014,Turkey,TUR,New Zealand,NZL,5,0,13,0,18
2014,Uganda,UGA,New Zealand,NZL,0,0,5,0,5
2014,Ukraine,UKR,New Zealand,NZL,0,0,5,0,5
2014,Zimbabwe,ZWE,New Zealand,NZL,0,0,5,0,5
2015,Central African Rep.,CAF,Mali,MLI,383,0,0,60,443
2015,Dem. Rep. of the Congo,COD,Mali,MLI,5,0,0,63,68
2015,Eritrea,ERI,Mali,MLI,5,0,0,0,5
2015,Gambia,GMB,Mali,MLI,0,0,0,5,5
2015,Cote d'Ivoire,CIV,Mali,MLI,0,0,0,85,85
2015,Sri Lanka,LKA,Mali,MLI,5,0,0,0,5
2015,Pakistan,PAK,Mali,MLI,16,0,0,0,16
2015,Rwanda,RWA,Mali,MLI,0,0,0,5,5
2015,Syrian Arab Rep.,SYR,Mali,MLI,58,0,0,0,58
2015,Afghanistan,AFG,New Zealand,NZL,5,0,0,0,5
2015,Bangladesh,BGD,New Zealand,NZL,0,0,10,0,10
2015,Brazil,BRA,New Zealand,NZL,0,0,5,0,5
2015,China,CHN,New Zealand,NZL,17,0,5,0,22
2015,Colombia,COL,New Zealand,NZL,13,0,0,0,13
2015,Fiji,FJI,New Zealand,NZL,10,0,22,0,32
2015,Hungary,HUN,New Zealand,NZL,5,0,0,0,5
2015,India,IND,New Zealand,NZL,0,0,19,0,19
2015,Iran (Islamic Rep. of),IRN,New Zealand,NZL,0,0,13,0,13
2015,Iraq,IRQ,New Zealand,NZL,5,0,5,0,10
2015,Jordan,JOR,New Zealand,NZL,0,0,5,0,5
2015,Dem. People's Rep. of Korea,PRK,New Zealand,NZL,0,0,5,0,5
2015,Kuwait,KWT,New Zealand,NZL,5,0,0,0,5
2015,Libya,LBY,New Zealand,NZL,14,0,0,0,14
2015,Sri Lanka,LKA,New Zealand,NZL,0,0,13,0,13
2015,Malaysia,MYS,New Zealand,NZL,0,0,5,0,5
2015,Pakistan,PAK,New Zealand,NZL,14,0,5,0,19
2015,Papua New Guinea,PNG,New Zealand,NZL,0,0,5,0,5
2015,South Africa,ZAF,New Zealand,NZL,0,0,10,0,10
2015,Russian Federation,RUS,New Zealand,NZL,0,0,5,0,5
2015,Saudi Arabia,SAU,New Zealand,NZL,5,0,0,0,5
2015,Viet Nam,VNM,New Zealand,NZL,5,0,0,0,5
2015,Sudan,SDN,New Zealand,NZL,0,0,5,0,5
2015,Syrian Arab Rep.,SYR,New Zealand,NZL,16,0,0,0,16
2015,Turkey,TUR,New Zealand,NZL,5,0,5,0,10
2015,Ukraine,UKR,New Zealand,NZL,0,0,5,0,5
2015,Samoa,WSM,New Zealand,NZL,0,0,5,0,5
2015,Zimbabwe,ZWE,New Zealand,NZL,5,0,0,0,5
2017,Afghanistan,AFG,Finland,FIN,239,217,932,90,1478
2017,Albania,ALB,Finland,FIN,0,0,72,28,100
2017,Algeria,DZA,Finland,FIN,0,0,18,23,41
2017,Angola,AGO,Finland,FIN,0,5,0,10,15
2017,Egypt,EGY,Finland,FIN,0,0,5,5,10
2017,Azerbaijan,AZE,Finland,FIN,5,0,0,0,5
2017,Bangladesh,BGD,Finland,FIN,5,0,13,18,36
2017,Belarus,BLR,Finland,FIN,0,0,0,35,35
2017,Bulgaria,BGR,Finland,FIN,0,0,0,5,5
2017,China,CHN,Finland,FIN,0,0,0,10,10
2017,Cameroon,CMR,Finland,FIN,0,0,11,22,33
2017,Congo,COG,Finland,FIN,0,0,0,5,5
2017,Dem. Rep. of the Congo,COD,Finland,FIN,0,0,5,12,17
2017,Colombia,COL,Finland,FIN,0,0,5,0,5
2017,Cuba,CUB,Finland,FIN,0,0,5,0,5
2017,Eritrea,ERI,Finland,FIN,225,0,0,5,230
2017,Estonia,EST,Finland,FIN,0,0,5,0,5
2017,Ethiopia,ETH,Finland,FIN,15,0,17,5,37
2017,Gabon,GAB,Finland,FIN,0,0,0,5,5
2017,Gambia,GMB,Finland,FIN,0,0,13,30,43
2017,Georgia,GEO,Finland,FIN,0,0,30,64,94
2017,Germany,DEU,Finland,FIN,0,0,0,5,5
2017,Ghana,GHA,Finland,FIN,0,0,5,14,19
2017,Guinea,GIN,Finland,FIN,0,0,0,5,5
2017,Honduras,HND,Finland,FIN,0,5,0,0,5
2017,Croatia,HRV,Finland,FIN,0,0,5,0,5
2017,Cote d'Ivoire,CIV,Finland,FIN,0,0,0,5,5
2017,India,IND,Finland,FIN,0,0,0,26,26
2017,Iran (Islamic Rep. of),IRN,Finland,FIN,103,5,173,30,311
2017,Iraq,IRQ,Finland,FIN,1034,228,2276,343,3881
2017,Jordan,JOR,Finland,FIN,0,0,5,0,5
2017,Kazakhstan,KAZ,Finland,FIN,0,0,0,5,5
2017,Kenya,KEN,Finland,FIN,0,0,5,0,5
2017,Kyrgyzstan,KGZ,Finland,FIN,0,0,0,5,5
2017,Liberia,LBR,Finland,FIN,0,0,0,5,5
2017,Libya,LBY,Finland,FIN,0,0,0,10,10
2017,Lebanon,LBN,Finland,FIN,0,0,5,0,5
2017,Sri Lanka,LKA,Finland,FIN,0,0,11,0,11
2017,North Macedonia,MKD,Finland,FIN,0,0,13,5,18
2017,Mexico,MEX,Finland,FIN,0,0,0,5,5
2017,Mali,MLI,Finland,FIN,0,0,0,5,5
2017,Morocco,MAR,Finland,FIN,0,0,16,43,59
2017,Myanmar,MMR,Finland,FIN,5,0,0,0,5
2017,Nepal,NPL,Finland,FIN,0,0,5,0,5
2017,Nigeria,NGA,Finland,FIN,0,0,65,59,124
2017,Pakistan,PAK,Finland,FIN,11,0,18,5,34
2017,Philippines,PHL,Finland,FIN,0,0,0,5,5
2017,South Africa,ZAF,Finland,FIN,0,0,5,0,5
2017,Russian Federation,RUS,Finland,FIN,12,0,96,72,180
2017,Rwanda,RWA,Finland,FIN,5,0,0,0,5
2017,Serbia and Kosovo: S/RES/1244 (1999),SRB,Finland,FIN,0,0,30,0,30
2017,Senegal,SEN,Finland,FIN,0,0,0,5,5
2017,Sierra Leone,SLE,Finland,FIN,0,0,5,0,5
2017,Somalia,SOM,Finland,FIN,106,77,268,45,496
2017,Sudan,SDN,Finland,FIN,14,0,5,0,19
2017,Syrian Arab Rep.,SYR,Finland,FIN,601,93,5,34,733
2017,United Rep. of Tanzania,TZA,Finland,FIN,0,0,0,5,5
2017,Tunisia,TUN,Finland,FIN,0,0,0,12,12
2017,Turkey,TUR,Finland,FIN,24,0,27,27,78
2017,United Arab Emirates,ARE,Finland,FIN,0,0,0,5,5
2017,Uganda,UGA,Finland,FIN,0,5,0,5,10
2017,Ukraine,UKR,Finland,FIN,0,0,21,27,48
2017,Venezuela (Bolivarian Republic of),VEN,Finland,FIN,0,0,5,0,5
2017,Yemen,YEM,Finland,FIN,5,42,0,5,52
2017,Stateless,XXA,Finland,FIN,90,17,34,5,146
2017,Colombia,COL,Venezuela (Bolivarian Republic of),VEN,15,0,80,10,105
2018,Afghanistan,AFG,Kazakhstan,KAZ,23,0,79,13,115
2018,China,CHN,Kazakhstan,KAZ,5,0,0,0,5
2018,Syrian Arab Rep.,SYR,Kazakhstan,KAZ,0,0,5,0,5
2018,Turkey,TUR,Kazakhstan,KAZ,0,0,5,0,5
2019,Afghanistan,AFG,Finland,FIN,197,141,290,54,682
2019,Albania,ALB,Finland,FIN,0,5,19,0,24
2019,Algeria,DZA,Finland,FIN,0,0,5,11,16
2019,Angola,AGO,Finland,FIN,5,0,10,18,33
2019,Egypt,EGY,Finland,FIN,5,0,13,0,18
2019,Armenia,ARM,Finland,FIN,0,0,5,0,5
2019,Azerbaijan,AZE,Finland,FIN,14,0,0,10,24
2019,Bangladesh,BGD,Finland,FIN,0,0,13,5,18
2019,Belarus,BLR,Finland,FIN,0,0,0,14,14
2019,Brazil,BRA,Finland,FIN,0,0,5,0,5
2019,China,CHN,Finland,FIN,58,0,0,5,63
2019,Cameroon,CMR,Finland,FIN,14,0,29,18,61
2019,Dem. Rep. of the Congo,COD,Finland,FIN,5,0,10,5,20
2019,Colombia,COL,Finland,FIN,0,0,13,0,13
2019,Cuba,CUB,Finland,FIN,0,0,23,10,33
2019,Eritrea,ERI,Finland,FIN,13,0,0,0,13
2019,Ethiopia,ETH,Finland,FIN,0,0,21,5,26
2019,Gambia,GMB,Finland,FIN,0,0,14,21,35
2019,United Kingdom of Great Britain and Northern Ireland,GBR,Finland,FIN,0,0,0,5,5
2019,Georgia,GEO,Finland,FIN,0,0,36,15,51
2019,Ghana,GHA,Finland,FIN,0,0,10,5,15
2019,Guinea,GIN,Finland,FIN,5,0,0,0,5
2019,Honduras,HND,Finland,FIN,0,0,0,5,5
2019,India,IND,Finland,FIN,0,0,5,0,5
2019,Iran (Islamic Rep. of),IRN,Finland,FIN,93,5,166,26,290
2019,Iraq,IRQ,Finland,FIN,496,116,519,104,1235
2019,Jordan,JOR,Finland,FIN,5,0,0,0,5
2019,Kazakhstan,KAZ,Finland,FIN,0,0,5,0,5
2019,Kenya,KEN,Finland,FIN,0,0,5,5,10
2019,Libya,LBY,Finland,FIN,0,5,0,5,10
2019,Sri Lanka,LKA,Finland,FIN,0,0,12,14,26
2019,Mexico,MEX,Finland,FIN,0,0,10,0,10
2019,Morocco,MAR,Finland,FIN,5,0,10,14,29
2019,Montenegro,MNE,Finland,FIN,0,0,5,0,5
2019,Myanmar,MMR,Finland,FIN,5,0,0,0,5
2019,Namibia,NAM,Finland,FIN,0,0,0,5,5
2019,Nepal,NPL,Finland,FIN,0,0,0,5,5
2019,Nicaragua,NIC,Finland,FIN,33,0,5,0,38
2019,Nigeria,NGA,Finland,FIN,5,0,63,64,132
2019,Pakistan,PAK,Finland,FIN,5,0,19,11,35
2019,Russian Federation,RUS,Finland,FIN,160,0,461,48,669
2019,Rwanda,RWA,Finland,FIN,5,0,12,0,17
2019,Serbia and Kosovo: S/RES/1244 (1999),SRB,Finland,FIN,0,0,20,0,20
2019,Senegal,SEN,Finland,FIN,0,0,5,0,5
2019,Sierra Leone,SLE,Finland,FIN,0,0,5,5,10
2019,Somalia,SOM,Finland,FIN,134,44,73,20,271
2019,Sudan,SDN,Finland,FIN,14,0,0,5,19
2019,Syrian Arab Rep.,SYR,Finland,FIN,62,29,0,32,123
2019,Tajikistan,TJK,Finland,FIN,0,0,5,0,5
2019,Tunisia,TUN,Finland,FIN,0,0,0,5,5
2019,Turkey,TUR,Finland,FIN,402,0,36,21,459
2019,Uganda,UGA,Finland,FIN,0,0,12,0,12
2019,Ukraine,UKR,Finland,FIN,5,0,29,12,46
2019,United States of America,USA,Finland,FIN,0,0,0,5,5
2019,Uzbekistan,UZB,Finland,FIN,0,0,0,11,11
2019,Venezuela (Bolivarian Republic of),VEN,Finland,FIN,0,5,10,0,15
2019,Yemen,YEM,Finland,FIN,28,56,0,0,84
2019,Zimbabwe,ZWE,Finland,FIN,5,0,0,0,5
2019,Stateless,XXA,Finland,FIN,19,0,5,13,37
2001,Albania,ALB,Argentina,ARG,0,0,0,5,5
2001,Armenia,ARM,Argentina,ARG,10,0,12,5,27
2001,Colombia,COL,Argentina,ARG,5,0,0,5,10
2001,Cuba,CUB,Argentina,ARG,0,0,5,5,10
2001,Georgia,GEO,Argentina,ARG,0,0,0,5,5
2001,Haiti,HTI,Argentina,ARG,0,0,5,0,5
2001,Iraq,IRQ,Argentina,ARG,5,0,0,0,5
2001,Nicaragua,NIC,Argentina,ARG,10,0,0,0,10
2001,Peru,PER,Argentina,ARG,17,0,38,41,96
2001,Romania,ROU,Argentina,ARG,0,0,34,0,34
2001,Russian Federation,RUS,Argentina,ARG,5,0,0,5,10
2001,Somalia,SOM,Argentina,ARG,0,0,0,5,5
2001,Afghanistan,AFG,Armenia,ARM,0,0,5,0,5
2001,Afghanistan,AFG,Belgium,BEL,95,0,30,0,125
2001,Albania,ALB,Belgium,BEL,22,0,72,0,94
2001,Algeria,DZA,Belgium,BEL,10,0,53,0,63
2001,Angola,AGO,Belgium,BEL,12,0,41,0,53
2001,Armenia,ARM,Belgium,BEL,0,0,45,0,45
2001,Burundi,BDI,Belgium,BEL,54,0,74,0,128
2001,Bangladesh,BGD,Belgium,BEL,0,0,10,0,10
2001,Bhutan,BTN,Belgium,BEL,0,0,27,0,27
2001,Burkina Faso,BFA,Belgium,BEL,5,0,0,0,5
2001,Belarus,BLR,Belgium,BEL,5,0,34,0,39
2001,Bosnia and Herzegovina,BIH,Belgium,BEL,30,0,32,0,62
2001,Bulgaria,BGR,Belgium,BEL,0,0,20,0,20
2001,China,CHN,Belgium,BEL,0,0,5,0,5
2001,Chile,CHL,Belgium,BEL,0,0,5,0,5
2001,Cameroon,CMR,Belgium,BEL,5,0,71,0,76
2001,Congo,COG,Belgium,BEL,5,0,12,0,17
2001,Dem. Rep. of the Congo,COD,Belgium,BEL,132,0,221,0,353
2001,Colombia,COL,Belgium,BEL,5,0,16,0,21
2001,Cuba,CUB,Belgium,BEL,5,0,0,0,5
2001,Djibouti,DJI,Belgium,BEL,0,0,13,0,13
2001,Ethiopia,ETH,Belgium,BEL,5,0,13,0,18
2001,Palestinian,PSE,Belgium,BEL,0,0,5,0,5
2001,Georgia,GEO,Belgium,BEL,0,0,58,0,58
2001,Guinea,GIN,Belgium,BEL,5,0,57,0,62
2001,Croatia,HRV,Belgium,BEL,0,0,10,0,10
2001,Cote d'Ivoire,CIV,Belgium,BEL,0,0,11,0,11
2001,India,IND,Belgium,BEL,0,0,14,0,14
2001,Iran (Islamic Rep. of),IRN,Belgium,BEL,11,0,74,0,85
2001,Iraq,IRQ,Belgium,BEL,17,0,24,0,41
2001,Israel,ISR,Belgium,BEL,0,0,11,0,11
2001,Jordan,JOR,Belgium,BEL,0,0,5,0,5
2001,Kazakhstan,KAZ,Belgium,BEL,0,0,48,0,48
2001,Liberia,LBR,Belgium,BEL,5,0,0,0,5
2001,Lebanon,LBN,Belgium,BEL,0,0,11,0,11
2001,Sri Lanka,LKA,Belgium,BEL,0,0,5,0,5
2001,Mauritania,MRT,Belgium,BEL,5,0,49,0,54
2001,North Macedonia,MKD,Belgium,BEL,0,0,15,0,15
2001,Rep. of Moldova,MDA,Belgium,BEL,0,0,10,0,10
2001,Myanmar,MMR,Belgium,BEL,0,0,5,0,5
2001,Nepal,NPL,Belgium,BEL,0,0,11,0,11
2001,Niger,NER,Belgium,BEL,0,0,20,0,20
2001,Pakistan,PAK,Belgium,BEL,5,0,38,0,43
2001,Peru,PER,Belgium,BEL,0,0,10,0,10
2001,Romania,ROU,Belgium,BEL,5,0,53,0,58
2001,Russian Federation,RUS,Belgium,BEL,0,0,98,0,98
2001,Rwanda,RWA,Belgium,BEL,162,0,150,0,312
2001,Serbia and Kosovo: S/RES/1244 (1999),SRB,Belgium,BEL,198,0,583,0,781
2001,Sierra Leone,SLE,Belgium,BEL,10,0,71,0,81
2001,Somalia,SOM,Belgium,BEL,42,0,73,0,115
2001,Slovakia,SVK,Belgium,BEL,0,0,28,0,28
2001,Syrian Arab Rep.,SYR,Belgium,BEL,0,0,13,0,13
2001,Togo,TGO,Belgium,BEL,5,0,20,0,25
2001,Turkey,TUR,Belgium,BEL,11,0,57,0,68
2001,Ukraine,UKR,Belgium,BEL,0,0,19,0,19
2001,Uzbekistan,UZB,Belgium,BEL,0,0,20,0,20
2001,Angola,AGO,Benin,BEN,0,0,0,5,5
2001,Burundi,BDI,Benin,BEN,11,0,0,0,11
2001,Burkina Faso,BFA,Benin,BEN,0,0,10,0,10
2001,Bosnia and Herzegovina,BIH,Benin,BEN,5,0,0,0,5
2001,Central African Rep.,CAF,Benin,BEN,26,0,5,0,31
2001,Chad,TCD,Benin,BEN,64,0,138,12,214
2001,Cameroon,CMR,Benin,BEN,0,0,30,0,30
2001,Congo,COG,Benin,BEN,50,0,78,10,138
2001,Dem. Rep. of the Congo,COD,Benin,BEN,104,0,327,18,449
2001,Equatorial Guinea,GNQ,Benin,BEN,0,0,5,0,5
2001,Ethiopia,ETH,Benin,BEN,5,0,0,0,5
2001,Guinea-Bissau,GNB,Benin,BEN,0,0,10,0,10
2001,Guinea,GIN,Benin,BEN,11,0,0,0,11
2001,Cote d'Ivoire,CIV,Benin,BEN,0,0,5,0,5
2001,Iraq,IRQ,Benin,BEN,0,0,5,0,5
2001,Liberia,LBR,Benin,BEN,0,0,10,0,10
2001,Nigeria,NGA,Benin,BEN,83,0,417,232,732
2001,Rwanda,RWA,Benin,BEN,74,0,20,5,99
2001,Sierra Leone,SLE,Benin,BEN,0,0,13,0,13
2001,Sudan,SDN,Benin,BEN,5,0,13,0,18
2001,Togo,TGO,Benin,BEN,197,0,709,109,1015
2001,Burundi,BDI,Burkina Faso,BFA,0,0,5,0,5
2001,Congo,COG,Burkina Faso,BFA,0,0,62,0,62
2001,Dem. Rep. of the Congo,COD,Burkina Faso,BFA,0,0,5,0,5
2001,Ghana,GHA,Burkina Faso,BFA,0,0,5,0,5
2001,Nigeria,NGA,Burkina Faso,BFA,0,0,5,0,5
2001,Rwanda,RWA,Burkina Faso,BFA,0,0,10,0,10
2001,Togo,TGO,Burkina Faso,BFA,0,0,43,0,43
2001,Afghanistan,AFG,Belarus,BLR,85,0,25,51,161
2001,Azerbaijan,AZE,Belarus,BLR,5,0,5,0,10
2001,Bulgaria,BGR,Belarus,BLR,0,0,5,0,5
2001,China,CHN,Belarus,BLR,0,0,5,0,5
2001,Cameroon,CMR,Belarus,BLR,0,0,0,5,5
2001,Ethiopia,ETH,Belarus,BLR,5,0,0,0,5
2001,Palestinian,PSE,Belarus,BLR,5,0,0,0,5
2001,Georgia,GEO,Belarus,BLR,25,0,0,5,30
2001,North Macedonia,MKD,Belarus,BLR,0,0,0,5,5
2001,Pakistan,PAK,Belarus,BLR,0,0,0,5,5
2001,Russian Federation,RUS,Belarus,BLR,0,0,0,5,5
2001,Tajikistan,TJK,Belarus,BLR,10,0,10,10,30
2001,Peru,PER,Bolivia (Plurinational State of),BOL,0,0,13,0,13
2001,Burundi,BDI,Botswana,BWA,5,0,5,0,10
2001,Dem. Rep. of the Congo,COD,Botswana,BWA,5,0,0,0,5
2001,Ethiopia,ETH,Botswana,BWA,0,0,5,0,5
2001,Kenya,KEN,Botswana,BWA,0,0,5,0,5
2001,Rwanda,RWA,Botswana,BWA,5,0,0,0,5
2001,Somalia,SOM,Botswana,BWA,5,0,24,0,29
2001,United Rep. of Tanzania,TZA,Botswana,BWA,0,0,10,0,10
2001,Uganda,UGA,Botswana,BWA,0,0,5,0,5
2001,Zimbabwe,ZWE,Botswana,BWA,5,0,0,0,5
2001,Angola,AGO,Brazil,BRA,61,72,102,0,235
2001,China,CHN,Brazil,BRA,0,0,10,0,10
2001,Dem. Rep. of the Congo,COD,Brazil,BRA,5,0,0,0,5
2001,Colombia,COL,Brazil,BRA,14,0,0,0,14
2001,Cuba,CUB,Brazil,BRA,0,0,14,0,14
2001,Guinea-Bissau,GNB,Brazil,BRA,0,0,0,5,5
2001,Iraq,IRQ,Brazil,BRA,0,0,5,0,5
2001,Nigeria,NGA,Brazil,BRA,0,0,11,0,11
2001,Pakistan,PAK,Brazil,BRA,0,0,0,17,17
2001,Peru,PER,Brazil,BRA,0,0,10,0,10
2001,Romania,ROU,Brazil,BRA,0,0,29,0,29
2001,Serbia and Kosovo: S/RES/1244 (1999),SRB,Brazil,BRA,0,5,0,0,5
2001,Sierra Leone,SLE,Brazil,BRA,17,0,0,5,22
2001,Sudan,SDN,Brazil,BRA,5,0,0,0,5
2001,United Rep. of Tanzania,TZA,Brazil,BRA,5,0,0,0,5
2001,Afghanistan,AFG,Bulgaria,BGR,103,693,90,0,886
2001,Algeria,DZA,Bulgaria,BGR,5,5,14,0,24
2001,Armenia,ARM,Bulgaria,BGR,0,5,398,5,408
2001,Bangladesh,BGD,Bulgaria,BGR,0,0,10,0,10
2001,Congo,COG,Bulgaria,BGR,5,0,0,0,5
2001,Eritrea,ERI,Bulgaria,BGR,0,5,0,0,5
2001,Ethiopia,ETH,Bulgaria,BGR,0,11,0,0,11
2001,Georgia,GEO,Bulgaria,BGR,0,0,13,0,13
2001,Ghana,GHA,Bulgaria,BGR,0,0,5,0,5
2001,Iran (Islamic Rep. of),IRN,Bulgaria,BGR,23,66,30,0,119
2001,Iraq,IRQ,Bulgaria,BGR,140,269,0,15,424
2001,Jordan,JOR,Bulgaria,BGR,5,0,0,0,5
2001,Kazakhstan,KAZ,Bulgaria,BGR,0,0,5,0,5
2001,Liberia,LBR,Bulgaria,BGR,0,5,0,0,5
2001,Lebanon,LBN,Bulgaria,BGR,5,16,5,0,26
2001,"China, Macao SAR",MAC,Bulgaria,BGR,0,5,0,0,5
2001,Nigeria,NGA,Bulgaria,BGR,0,0,0,5,5
2001,Pakistan,PAK,Bulgaria,BGR,0,0,10,0,10
2001,Russian Federation,RUS,Bulgaria,BGR,0,0,17,5,22
2001,Serbia and Kosovo: S/RES/1244 (1999),SRB,Bulgaria,BGR,0,12,5,0,17
2001,Sierra Leone,SLE,Bulgaria,BGR,0,0,5,0,5
2001,Somalia,SOM,Bulgaria,BGR,5,14,0,0,19
2001,Sudan,SDN,Bulgaria,BGR,5,43,0,0,48
2001,Syrian Arab Rep.,SYR,Bulgaria,BGR,35,11,10,0,56
2001,Tunisia,TUN,Bulgaria,BGR,5,0,0,0,5
2001,Turkey,TUR,Bulgaria,BGR,12,13,5,0,30
2001,Stateless,XXA,Bulgaria,BGR,38,5,0,0,43
2001,Ethiopia,ETH,Belize,BLZ,0,0,0,5,5
2001,Nigeria,NGA,Belize,BLZ,0,0,0,25,25
2001,Syrian Arab Rep.,SYR,Belize,BLZ,0,0,0,15,15
2001,Afghanistan,AFG,Canada,CAN,304,0,10,42,356
2001,Albania,ALB,Canada,CAN,239,0,76,50,365
2001,Algeria,DZA,Canada,CAN,112,0,190,43,345
2001,Angola,AGO,Canada,CAN,186,0,218,20,424
2001,Antigua and Barbuda,ATG,Canada,CAN,5,0,0,0,5
2001,Egypt,EGY,Canada,CAN,25,0,39,19,83
2001,Argentina,ARG,Canada,CAN,59,0,1184,256,1499
2001,Armenia,ARM,Canada,CAN,18,0,0,5,23
2001,Azerbaijan,AZE,Canada,CAN,99,0,29,13,141
2001,Barbados,BRB,Canada,CAN,0,0,0,5,5
2001,Burundi,BDI,Canada,CAN,115,0,20,0,135
2001,Belgium,BEL,Canada,CAN,0,0,5,0,5
2001,Benin,BEN,Canada,CAN,5,0,0,0,5
2001,Bangladesh,BGD,Canada,CAN,155,0,120,49,324
2001,Burkina Faso,BFA,Canada,CAN,16,0,0,0,16
2001,Belarus,BLR,Canada,CAN,30,0,10,10,50
2001,Bolivia (Plurinational State of),BOL,Canada,CAN,11,0,22,5,38
2001,Brazil,BRA,Canada,CAN,5,0,12,11,28
2001,Bosnia and Herzegovina,BIH,Canada,CAN,5,0,5,5,15
2001,Bulgaria,BGR,Canada,CAN,113,0,63,31,207
2001,Cambodia,KHM,Canada,CAN,0,0,5,0,5
2001,Central African Rep.,CAF,Canada,CAN,5,0,0,0,5
2001,Chad,TCD,Canada,CAN,34,0,15,10,59
2001,China,CHN,Canada,CAN,942,0,380,413,1735
2001,Chile,CHL,Canada,CAN,16,0,26,12,54
2001,Cameroon,CMR,Canada,CAN,40,0,22,10,72
2001,Congo,COG,Canada,CAN,58,0,25,5,88
2001,Dem. Rep. of the Congo,COD,Canada,CAN,569,0,177,55,801
2001,Comoros,COM,Canada,CAN,0,0,5,0,5
2001,Colombia,COL,Canada,CAN,740,0,130,71,941
2001,Costa Rica,CRI,Canada,CAN,20,0,70,76,166
2001,Cuba,CUB,Canada,CAN,119,0,23,23,165
2001,Czechia,CZE,Canada,CAN,12,0,12,10,34
2001,Denmark,DNK,Canada,CAN,0,0,5,0,5
2001,Djibouti,DJI,Canada,CAN,38,0,13,10,61
2001,Dominica,DMA,Canada,CAN,0,0,0,11,11
2001,Dominican Rep.,DOM,Canada,CAN,0,0,10,24,34
2001,Ecuador,ECU,Canada,CAN,20,0,13,10,43
2001,Eritrea,ERI,Canada,CAN,59,0,5,5,69
2001,Estonia,EST,Canada,CAN,5,0,10,0,15
2001,Ethiopia,ETH,Canada,CAN,100,0,15,27,142
2001,Fiji,FJI,Canada,CAN,218,0,32,19,269
2001,France,FRA,Canada,CAN,0,0,0,14,14
2001,Gabon,GAB,Canada,CAN,0,0,5,5,10
2001,Gambia,GMB,Canada,CAN,0,0,0,5,5
2001,Palestinian,PSE,Canada,CAN,25,0,12,14,51
2001,United Kingdom of Great Britain and Northern Ireland,GBR,Canada,CAN,0,0,5,5,10
2001,Georgia,GEO,Canada,CAN,32,0,20,23,75
2001,Germany,DEU,Canada,CAN,0,0,0,13,13
2001,Ghana,GHA,Canada,CAN,41,0,51,55,147
2001,Guinea-Bissau,GNB,Canada,CAN,5,0,0,0,5
2001,Grenada,GRD,Canada,CAN,13,0,32,24,69
2001,Guatemala,GTM,Canada,CAN,32,0,80,36,148
2001,Guinea,GIN,Canada,CAN,150,0,36,17,203
2001,Guyana,GUY,Canada,CAN,5,0,70,38,113
2001,Haiti,HTI,Canada,CAN,101,0,137,40,278
2001,Honduras,HND,Canada,CAN,12,0,86,69,167
2001,Croatia,HRV,Canada,CAN,15,0,0,0,15
2001,Hungary,HUN,Canada,CAN,217,0,579,993,1789
2001,Cote d'Ivoire,CIV,Canada,CAN,39,0,19,12,70
2001,India,IND,Canada,CAN,379,0,556,377,1312
2001,Indonesia,IDN,Canada,CAN,21,0,5,5,31
2001,Iran (Islamic Rep. of),IRN,Canada,CAN,438,0,186,78,702
2001,Iraq,IRQ,Canada,CAN,151,0,68,23,242
2001,Israel,ISR,Canada,CAN,11,0,87,112,210
2001,Italy,ITA,Canada,CAN,0,0,10,5,15
2001,Jamaica,JAM,Canada,CAN,5,0,59,42,106
2001,Jordan,JOR,Canada,CAN,10,0,5,15,30
2001,Kazakhstan,KAZ,Canada,CAN,21,0,73,10,104
2001,Kenya,KEN,Canada,CAN,69,0,24,14,107
2001,Kyrgyzstan,KGZ,Canada,CAN,42,0,24,5,71
2001,Rep. of Korea,KOR,Canada,CAN,17,0,145,48,210
2001,Dem. People's Rep. of Korea,PRK,Canada,CAN,0,0,5,0,5
2001,Kuwait,KWT,Canada,CAN,42,0,0,5,47
2001,Lao People's Dem. Rep.,LAO,Canada,CAN,5,0,0,0,5
2001,Liberia,LBR,Canada,CAN,12,0,0,0,12
2001,Libya,LBY,Canada,CAN,35,0,19,5,59
2001,Saint Lucia,LCA,Canada,CAN,0,0,14,5,19
2001,Lebanon,LBN,Canada,CAN,101,0,159,71,331
2001,Sri Lanka,LKA,Canada,CAN,1543,0,477,125,2145
2001,Lithuania,LTU,Canada,CAN,5,0,12,15,32
2001,Latvia,LVA,Canada,CAN,0,0,14,0,14
2001,Madagascar,MDG,Canada,CAN,0,0,5,0,5
2001,Mauritania,MRT,Canada,CAN,14,0,5,0,19
2001,North Macedonia,MKD,Canada,CAN,0,0,11,5,16
2001,Rep. of Moldova,MDA,Canada,CAN,15,0,21,11,47
2001,Mexico,MEX,Canada,CAN,237,0,602,324,1163
2001,Mali,MLI,Canada,CAN,23,0,13,0,36
2001,Malaysia,MYS,Canada,CAN,52,0,65,20,137
2001,Mongolia,MNG,Canada,CAN,10,0,5,0,15
2001,Morocco,MAR,Canada,CAN,11,0,14,10,35
2001,Myanmar,MMR,Canada,CAN,13,0,0,0,13
2001,Namibia,NAM,Canada,CAN,5,0,0,0,5
2001,Nepal,NPL,Canada,CAN,16,0,5,0,21
2001,Netherlands,NLD,Canada,CAN,0,0,5,0,5
2001,Niger,NER,Canada,CAN,5,0,0,0,5
2001,Nicaragua,NIC,Canada,CAN,5,0,15,5,25
2001,Nigeria,NGA,Canada,CAN,199,0,298,109,606
2001,Pakistan,PAK,Canada,CAN,1740,0,613,346,2699
2001,Panama,PAN,Canada,CAN,0,0,11,0,11
2001,Peru,PER,Canada,CAN,152,0,156,50,358
2001,Philippines,PHL,Canada,CAN,15,0,65,10,90
2001,Poland,POL,Canada,CAN,133,0,58,39,230
2001,Portugal,PRT,Canada,CAN,0,0,31,23,54
2001,Qatar,QAT,Canada,CAN,0,0,5,5,10
2001,Romania,ROU,Canada,CAN,133,0,148,63,344
2001,South Africa,ZAF,Canada,CAN,0,0,23,5,28
2001,Russian Federation,RUS,Canada,CAN,247,0,171,52,470
2001,Rwanda,RWA,Canada,CAN,148,0,53,10,211
2001,El Salvador,SLV,Canada,CAN,42,0,152,61,255
2001,Saudi Arabia,SAU,Canada,CAN,10,0,0,12,22
2001,Serbia and Kosovo: S/RES/1244 (1999),SRB,Canada,CAN,37,0,50,24,111
2001,Senegal,SEN,Canada,CAN,14,0,5,0,19
2001,Sierra Leone,SLE,Canada,CAN,32,0,14,14,60
2001,Solomon Islands,SLB,Canada,CAN,5,0,0,0,5
2001,Somalia,SOM,Canada,CAN,516,0,42,61,619
2001,Spain,ESP,Canada,CAN,0,0,0,5,5
2001,Viet Nam,VNM,Canada,CAN,21,0,23,23,67
2001,Saint Kitts and Nevis,KNA,Canada,CAN,0,0,5,0,5
2001,Sudan,SDN,Canada,CAN,241,0,52,31,324
2001,Slovakia,SVK,Canada,CAN,5,0,12,5,22
2001,Slovenia,SVN,Canada,CAN,0,0,0,5,5
2001,Syrian Arab Rep.,SYR,Canada,CAN,39,0,36,13,88
2001,United Rep. of Tanzania,TZA,Canada,CAN,147,0,22,10,179
2001,Thailand,THA,Canada,CAN,0,0,0,11,11
2001,Tajikistan,TJK,Canada,CAN,0,0,5,0,5
2001,Togo,TGO,Canada,CAN,22,0,5,5,32
2001,Trinidad and Tobago,TTO,Canada,CAN,5,0,21,32,58
2001,Tunisia,TUN,Canada,CAN,13,0,45,12,70
2001,Turkey,TUR,Canada,CAN,488,0,145,73,706
2001,Uganda,UGA,Canada,CAN,44,0,25,5,74
2001,Ukraine,UKR,Canada,CAN,130,0,112,110,352
2001,Uruguay,URY,Canada,CAN,10,0,69,37,116
2001,United States of America,USA,Canada,CAN,0,0,41,31,72
2001,Uzbekistan,UZB,Canada,CAN,12,0,10,0,22
2001,Saint Vincent and the Grenadines,VCT,Canada,CAN,39,0,29,14,82
2001,Venezuela (Bolivarian Republic of),VEN,Canada,CAN,43,0,38,21,102
2001,Yemen,YEM,Canada,CAN,35,0,20,5,60
2001,Zimbabwe,ZWE,Canada,CAN,121,0,85,51,257
2001,Central African Rep.,CAF,Chad,TCD,5,0,19,0,24
2001,Cameroon,CMR,Chad,TCD,13,0,0,0,13
2001,Dem. Rep. of the Congo,COD,Chad,TCD,113,0,47,0,160
2001,Liberia,LBR,Chad,TCD,0,0,5,0,5
2001,Rwanda,RWA,Chad,TCD,11,0,0,0,11
2001,Sudan,SDN,Chad,TCD,58,0,50,0,108
2001,Afghanistan,AFG,Chile,CHL,5,0,0,0,5
2001,Colombia,COL,Chile,CHL,24,5,0,5,34
2001,Cuba,CUB,Chile,CHL,0,0,0,5,5
2001,Iraq,IRQ,Chile,CHL,5,0,0,0,5
2001,North Macedonia,MKD,Chile,CHL,0,0,5,0,5
2001,Mongolia,MNG,Chile,CHL,0,0,0,5,5
2001,Nigeria,NGA,Chile,CHL,0,0,5,0,5
2001,Peru,PER,Chile,CHL,12,0,0,0,12
2001,Sweden,SWE,Chile,CHL,0,0,5,0,5
2001,Afghanistan,AFG,Denmark,DNK,1493,184,45,0,1722
2001,Albania,ALB,Denmark,DNK,0,0,33,0,33
2001,Algeria,DZA,Denmark,DNK,0,0,17,0,17
2001,Armenia,ARM,Denmark,DNK,0,5,142,0,147
2001,Azerbaijan,AZE,Denmark,DNK,11,0,44,0,55
2001,Burundi,BDI,Denmark,DNK,0,13,0,0,13
2001,Bangladesh,BGD,Denmark,DNK,0,0,15,0,15
2001,Bhutan,BTN,Denmark,DNK,0,0,5,0,5
2001,Belarus,BLR,Denmark,DNK,0,0,41,0,41
2001,Bosnia and Herzegovina,BIH,Denmark,DNK,0,10,942,0,952
2001,Bulgaria,BGR,Denmark,DNK,0,0,17,0,17
2001,China,CHN,Denmark,DNK,0,0,42,0,42
2001,Cameroon,CMR,Denmark,DNK,0,0,15,0,15
2001,Dem. Rep. of the Congo,COD,Denmark,DNK,5,0,11,0,16
2001,Czechia,CZE,Denmark,DNK,0,0,31,0,31
2001,Ecuador,ECU,Denmark,DNK,0,0,10,0,10
2001,Estonia,EST,Denmark,DNK,0,0,10,0,10
2001,Ethiopia,ETH,Denmark,DNK,11,0,0,0,11
2001,Gambia,GMB,Denmark,DNK,0,0,22,0,22
2001,Palestinian,PSE,Denmark,DNK,47,5,137,0,189
2001,Georgia,GEO,Denmark,DNK,0,0,79,0,79
2001,Ghana,GHA,Denmark,DNK,0,0,5,0,5
2001,Guatemala,GTM,Denmark,DNK,0,0,5,0,5
2001,Croatia,HRV,Denmark,DNK,0,0,14,0,14
2001,India,IND,Denmark,DNK,0,5,53,0,58
2001,Iran (Islamic Rep. of),IRN,Denmark,DNK,15,11,244,0,270
2001,Iraq,IRQ,Denmark,DNK,38,1850,254,0,2142
2001,Israel,ISR,Denmark,DNK,0,0,5,0,5
2001,Jordan,JOR,Denmark,DNK,0,0,11,0,11
2001,Kazakhstan,KAZ,Denmark,DNK,0,5,26,0,31
2001,Kyrgyzstan,KGZ,Denmark,DNK,0,0,5,0,5
2001,Libya,LBY,Denmark,DNK,0,0,5,0,5
2001,Lebanon,LBN,Denmark,DNK,5,5,40,0,50
2001,Sri Lanka,LKA,Denmark,DNK,5,16,36,0,57
2001,Lithuania,LTU,Denmark,DNK,0,0,17,0,17
2001,Latvia,LVA,Denmark,DNK,0,0,5,0,5
2001,North Macedonia,MKD,Denmark,DNK,0,0,18,0,18
2001,Rep. of Moldova,MDA,Denmark,DNK,0,0,25,0,25
2001,Mongolia,MNG,Denmark,DNK,0,0,34,0,34
2001,Nigeria,NGA,Denmark,DNK,0,0,11,0,11
2001,Pakistan,PAK,Denmark,DNK,5,5,57,0,67
2001,Poland,POL,Denmark,DNK,0,0,10,0,10
2001,Romania,ROU,Denmark,DNK,0,0,18,0,18
2001,South Africa,ZAF,Denmark,DNK,0,0,5,0,5
2001,Russian Federation,RUS,Denmark,DNK,10,10,105,0,125
2001,Rwanda,RWA,Denmark,DNK,0,12,0,0,12
2001,Serbia and Kosovo: S/RES/1244 (1999),SRB,Denmark,DNK,20,148,1005,0,1173
2001,Sierra Leone,SLE,Denmark,DNK,0,0,12,0,12
2001,Somalia,SOM,Denmark,DNK,155,403,11,0,569
2001,Viet Nam,VNM,Denmark,DNK,15,0,24,0,39
2001,Slovakia,SVK,Denmark,DNK,0,0,255,0,255
2001,Sweden,SWE,Denmark,DNK,0,0,5,0,5
2001,Syrian Arab Rep.,SYR,Denmark,DNK,5,0,20,0,25
2001,Tunisia,TUN,Denmark,DNK,0,0,5,0,5
2001,Turkey,TUR,Denmark,DNK,5,5,41,0,51
2001,Ukraine,UKR,Denmark,DNK,0,0,54,0,54
2001,Uzbekistan,UZB,Denmark,DNK,0,5,0,0,5
2001,Stateless,XXA,Denmark,DNK,5,0,5,0,10
2001,Ethiopia,ETH,Djibouti,DJI,5,0,48,0,53
2001,Somalia,SOM,Djibouti,DJI,0,0,10,0,10
2001,Colombia,COL,Ecuador,ECU,380,0,605,0,985
2001,India,IND,Ecuador,ECU,0,0,5,0,5
2001,Iran (Islamic Rep. of),IRN,Ecuador,ECU,5,0,0,0,5
2001,Iraq,IRQ,Ecuador,ECU,10,0,26,0,36
2001,Sri Lanka,LKA,Ecuador,ECU,0,0,10,0,10
2001,Pakistan,PAK,Ecuador,ECU,11,0,0,0,11
2001,Peru,PER,Ecuador,ECU,5,0,0,0,5
2001,Spain,ESP,Ecuador,ECU,0,0,5,0,5
2001,Turkey,TUR,Ecuador,ECU,0,0,10,15,25
2001,Dem. Rep. of the Congo,COD,Ethiopia,ETH,0,0,0,18,18
2001,Rwanda,RWA,Ethiopia,ETH,5,0,0,0,5
2001,Yemen,YEM,Ethiopia,ETH,0,0,0,17,17
2001,Afghanistan,AFG,Finland,FIN,0,36,0,20,56
2001,Albania,ALB,Finland,FIN,0,10,5,0,15
2001,Algeria,DZA,Finland,FIN,0,5,13,10,28
2001,Angola,AGO,Finland,FIN,0,5,10,0,15
2001,Egypt,EGY,Finland,FIN,0,0,0,5,5
2001,Armenia,ARM,Finland,FIN,0,5,0,13,18
2001,Azerbaijan,AZE,Finland,FIN,0,12,0,0,12
2001,Bangladesh,BGD,Finland,FIN,0,14,45,5,64
2001,Belarus,BLR,Finland,FIN,0,5,21,22,48
2001,Bolivia (Plurinational State of),BOL,Finland,FIN,0,0,0,5,5
2001,Bosnia and Herzegovina,BIH,Finland,FIN,0,15,10,5,30
2001,Bulgaria,BGR,Finland,FIN,0,5,0,0,5
2001,Cambodia,KHM,Finland,FIN,0,5,0,5,10
2001,China,CHN,Finland,FIN,0,0,11,0,11
2001,Congo,COG,Finland,FIN,0,5,5,0,10
2001,Dem. Rep. of the Congo,COD,Finland,FIN,0,10,14,0,24
2001,Czechia,CZE,Finland,FIN,0,0,10,5,15
2001,Estonia,EST,Finland,FIN,0,0,5,5,10
2001,Ethiopia,ETH,Finland,FIN,0,0,16,0,16
2001,Georgia,GEO,Finland,FIN,0,0,5,0,5
2001,Ghana,GHA,Finland,FIN,0,0,5,0,5
2001,Hungary,HUN,Finland,FIN,0,5,0,0,5
2001,India,IND,Finland,FIN,0,0,0,12,12
2001,Iran (Islamic Rep. of),IRN,Finland,FIN,0,19,35,11,65
2001,Iraq,IRQ,Finland,FIN,0,76,12,23,111
2001,Israel,ISR,Finland,FIN,0,0,0,10,10
2001,Jordan,JOR,Finland,FIN,0,0,0,5,5
2001,Kazakhstan,KAZ,Finland,FIN,0,11,0,5,16
2001,Libya,LBY,Finland,FIN,0,10,0,0,10
2001,Lebanon,LBN,Finland,FIN,0,0,5,0,5
2001,Sri Lanka,LKA,Finland,FIN,0,13,14,24,51
2001,Lithuania,LTU,Finland,FIN,0,0,45,10,55
2001,Latvia,LVA,Finland,FIN,0,5,0,0,5
2001,Rep. of Moldova,MDA,Finland,FIN,0,0,0,14,14
2001,Morocco,MAR,Finland,FIN,0,0,0,11,11
2001,Nigeria,NGA,Finland,FIN,0,0,0,10,10
2001,Pakistan,PAK,Finland,FIN,0,14,5,0,19
2001,Poland,POL,Finland,FIN,0,0,0,10,10
2001,Romania,ROU,Finland,FIN,0,0,0,36,36
2001,Russian Federation,RUS,Finland,FIN,0,10,35,253,298
2001,Rwanda,RWA,Finland,FIN,0,5,0,0,5
2001,Serbia and Kosovo: S/RES/1244 (1999),SRB,Finland,FIN,0,306,92,20,418
2001,Sierra Leone,SLE,Finland,FIN,0,5,0,0,5
2001,Somalia,SOM,Finland,FIN,0,90,0,12,102
2001,Slovakia,SVK,Finland,FIN,0,5,44,40,89
2001,Syrian Arab Rep.,SYR,Finland,FIN,0,12,0,0,12
2001,Tajikistan,TJK,Finland,FIN,0,5,0,0,5
2001,Turkey,TUR,Finland,FIN,0,87,59,12,158
2001,Ukraine,UKR,Finland,FIN,0,5,77,83,165
2001,Uzbekistan,UZB,Finland,FIN,0,12,5,0,17
2001,Stateless,XXA,Finland,FIN,0,5,11,0,16
2001,Afghanistan,AFG,France,FRA,184,0,95,0,279
2001,Albania,ALB,France,FRA,26,0,334,0,360
2001,Algeria,DZA,France,FRA,49,0,2232,0,2281
2001,Angola,AGO,France,FRA,133,0,331,0,464
2001,Armenia,ARM,France,FRA,16,0,383,0,399
2001,Azerbaijan,AZE,France,FRA,12,0,146,0,158
2001,Burundi,BDI,France,FRA,31,0,23,0,54
2001,Bangladesh,BGD,France,FRA,22,0,1134,0,1156
2001,Belarus,BLR,France,FRA,5,0,104,0,109
2001,Bosnia and Herzegovina,BIH,France,FRA,166,0,181,0,347
2001,Bulgaria,BGR,France,FRA,0,0,56,0,56
2001,Cambodia,KHM,France,FRA,128,0,108,0,236
2001,Central African Rep.,CAF,France,FRA,28,0,177,0,205
2001,Chad,TCD,France,FRA,49,0,68,0,117
2001,China,CHN,France,FRA,21,0,3281,0,3302
2001,Cameroon,CMR,France,FRA,15,0,99,0,114
2001,Congo,COG,France,FRA,189,0,640,0,829
2001,Dem. Rep. of the Congo,COD,France,FRA,602,0,2664,0,3266
2001,Colombia,COL,France,FRA,33,0,88,0,121
2001,Cuba,CUB,France,FRA,10,0,13,0,23
2001,Djibouti,DJI,France,FRA,5,0,13,0,18
2001,Ecuador,ECU,France,FRA,10,0,57,0,67
2001,Eritrea,ERI,France,FRA,14,0,0,0,14
2001,Ethiopia,ETH,France,FRA,45,0,15,0,60
2001,Georgia,GEO,France,FRA,36,0,525,0,561
2001,Ghana,GHA,France,FRA,36,0,145,0,181
2001,Guinea-Bissau,GNB,France,FRA,35,0,62,0,97
2001,Guinea,GIN,France,FRA,15,0,587,0,602
2001,Haiti,HTI,France,FRA,97,0,2849,0,2946
2001,Croatia,HRV,France,FRA,0,0,24,0,24
2001,Hungary,HUN,France,FRA,13,0,41,0,54
2001,Cote d'Ivoire,CIV,France,FRA,12,0,352,0,364
2001,India,IND,France,FRA,12,0,635,0,647
2001,Iran (Islamic Rep. of),IRN,France,FRA,61,0,174,0,235
2001,Iraq,IRQ,France,FRA,133,0,184,0,317
2001,Kazakhstan,KAZ,France,FRA,5,0,93,0,98
2001,Lao People's Dem. Rep.,LAO,France,FRA,43,0,5,0,48
2001,Liberia,LBR,France,FRA,5,0,31,0,36
2001,Lebanon,LBN,France,FRA,10,0,35,0,45
2001,Sri Lanka,LKA,France,FRA,956,0,1901,0,2857
2001,Mauritania,MRT,France,FRA,109,0,885,0,994
2001,Rep. of Moldova,MDA,France,FRA,5,0,797,0,802
2001,Mali,MLI,France,FRA,0,0,2923,0,2923
2001,Myanmar,MMR,France,FRA,5,0,28,0,33
2001,Nigeria,NGA,France,FRA,10,0,267,0,277
2001,Pakistan,PAK,France,FRA,19,0,619,0,638
2001,Peru,PER,France,FRA,14,0,67,0,81
2001,Romania,ROU,France,FRA,5,0,222,0,227
2001,Russian Federation,RUS,France,FRA,134,0,703,0,837
2001,Rwanda,RWA,France,FRA,287,0,89,0,376
2001,Serbia and Kosovo: S/RES/1244 (1999),SRB,France,FRA,320,0,2127,0,2447
2001,Senegal,SEN,France,FRA,5,0,688,0,693
2001,Sierra Leone,SLE,France,FRA,26,0,212,0,238
2001,Somalia,SOM,France,FRA,48,0,60,0,108
2001,Viet Nam,VNM,France,FRA,182,0,19,0,201
2001,Sudan,SDN,France,FRA,57,0,83,0,140
2001,Slovakia,SVK,France,FRA,5,0,74,0,79
2001,Syrian Arab Rep.,SYR,France,FRA,53,0,28,0,81
2001,Togo,TGO,France,FRA,10,0,39,0,49
2001,Tunisia,TUN,France,FRA,10,0,26,0,36
2001,Turkey,TUR,France,FRA,371,0,4134,0,4505
2001,Ukraine,UKR,France,FRA,12,0,787,0,799
2001,Uzbekistan,UZB,France,FRA,0,0,23,0,23
2001,Stateless,XXA,France,FRA,62,0,28,0,90
2001,Cuba,CUB,Ghana,GHA,0,0,5,0,5
2001,Sierra Leone,SLE,Ghana,GHA,102,0,0,0,102
2001,Senegal,SEN,Guinea-Bissau,GNB,7332,0,0,457,7789
2001,Sierra Leone,SLE,Guinea-Bissau,GNB,0,0,0,17,17
2001,Afghanistan,AFG,Greece,GRC,18,5,183,19,225
2001,Albania,ALB,Greece,GRC,0,0,5,5,10
2001,Algeria,DZA,Greece,GRC,0,0,10,5,15
2001,Azerbaijan,AZE,Greece,GRC,0,0,5,0,5
2001,Bangladesh,BGD,Greece,GRC,5,0,17,14,36
2001,Belarus,BLR,Greece,GRC,0,0,5,0,5
2001,Dem. Rep. of the Congo,COD,Greece,GRC,0,0,5,5,10
2001,Ethiopia,ETH,Greece,GRC,0,0,5,0,5
2001,Gambia,GMB,Greece,GRC,0,0,5,0,5
2001,Palestinian,PSE,Greece,GRC,0,0,14,0,14
2001,Ghana,GHA,Greece,GRC,0,0,10,0,10
2001,Guinea-Bissau,GNB,Greece,GRC,0,0,14,0,14
2001,India,IND,Greece,GRC,0,5,5,0,10
2001,Iran (Islamic Rep. of),IRN,Greece,GRC,14,23,59,5,101
2001,Iraq,IRQ,Greece,GRC,46,55,349,113,563
2001,Sri Lanka,LKA,Greece,GRC,5,5,17,0,27
2001,Morocco,MAR,Greece,GRC,0,0,133,5,138
2001,Myanmar,MMR,Greece,GRC,0,0,5,0,5
2001,Nigeria,NGA,Greece,GRC,0,0,12,0,12
2001,Pakistan,PAK,Greece,GRC,0,0,18,5,23
2001,Romania,ROU,Greece,GRC,0,0,5,0,5
2001,Russian Federation,RUS,Greece,GRC,0,0,13,0,13
2001,Rwanda,RWA,Greece,GRC,0,0,5,0,5
2001,Serbia and Kosovo: S/RES/1244 (1999),SRB,Greece,GRC,0,0,5,5,10
2001,Sierra Leone,SLE,Greece,GRC,0,5,16,5,26
2001,Somalia,SOM,Greece,GRC,0,0,5,0,5
2001,Sudan,SDN,Greece,GRC,5,0,17,16,38
2001,Syrian Arab Rep.,SYR,Greece,GRC,0,14,0,0,14
2001,Turkey,TUR,Greece,GRC,48,20,108,106,282
2001,Ukraine,UKR,Greece,GRC,0,0,10,0,10
2001,Western Sahara,ESH,Greece,GRC,0,0,5,0,5
2001,Chad,TCD,Guinea,GIN,5,0,0,0,5
2001,Dem. Rep. of the Congo,COD,Guinea,GIN,5,0,0,0,5
2001,Ghana,GHA,Guinea,GIN,5,0,0,0,5
2001,Liberia,LBR,Guinea,GIN,559,0,5,0,564
2001,Sierra Leone,SLE,Guinea,GIN,611,0,5,0,616
2001,Cuba,CUB,Honduras,HND,0,0,11,0,11
2001,Guatemala,GTM,Honduras,HND,0,0,5,0,5
2001,Iran (Islamic Rep. of),IRN,Honduras,HND,5,0,0,0,5
2001,Sri Lanka,LKA,Honduras,HND,0,0,5,0,5
2001,Somalia,SOM,Honduras,HND,0,0,5,0,5
2001,Afghanistan,AFG,Croatia,HRV,0,0,5,0,5
2001,Congo,COG,Croatia,HRV,0,0,5,0,5
2001,Iran (Islamic Rep. of),IRN,Croatia,HRV,0,0,31,0,31
2001,Iraq,IRQ,Croatia,HRV,0,0,5,0,5
2001,North Macedonia,MKD,Croatia,HRV,0,0,0,5,5
2001,Pakistan,PAK,Croatia,HRV,0,0,10,0,10
2001,Russian Federation,RUS,Croatia,HRV,0,0,5,0,5
2001,Serbia and Kosovo: S/RES/1244 (1999),SRB,Croatia,HRV,0,0,10,0,10
2001,Sierra Leone,SLE,Croatia,HRV,0,0,5,0,5
2001,Somalia,SOM,Croatia,HRV,0,0,5,0,5
2001,Afghanistan,AFG,Hungary,HUN,52,106,843,2635,3636
2001,Algeria,DZA,Hungary,HUN,10,0,41,32,83
2001,Angola,AGO,Hungary,HUN,0,0,5,11,16
2001,Egypt,EGY,Hungary,HUN,0,0,0,25,25
2001,Armenia,ARM,Hungary,HUN,12,0,21,24,57
2001,Azerbaijan,AZE,Hungary,HUN,0,0,5,0,5
2001,Bangladesh,BGD,Hungary,HUN,0,0,695,690,1385
2001,Bosnia and Herzegovina,BIH,Hungary,HUN,0,0,5,11,16
2001,Bulgaria,BGR,Hungary,HUN,0,0,5,0,5
2001,China,CHN,Hungary,HUN,0,0,45,89,134
2001,Cameroon,CMR,Hungary,HUN,5,5,5,15,30
2001,Dem. Rep. of the Congo,COD,Hungary,HUN,0,5,10,5,20
2001,Eritrea,ERI,Hungary,HUN,0,0,5,11,16
2001,Ethiopia,ETH,Hungary,HUN,5,10,12,25,52
2001,Palestinian,PSE,Hungary,HUN,10,5,27,34,76
2001,Georgia,GEO,Hungary,HUN,5,0,10,19,34
2001,Ghana,GHA,Hungary,HUN,0,0,15,11,26
2001,Cote d'Ivoire,CIV,Hungary,HUN,0,0,5,0,5
2001,India,IND,Hungary,HUN,0,0,75,120,195
2001,Iran (Islamic Rep. of),IRN,Hungary,HUN,0,5,47,71,123
2001,Iraq,IRQ,Hungary,HUN,48,49,335,559,991
2001,Libya,LBY,Hungary,HUN,5,0,0,0,5
2001,Lebanon,LBN,Hungary,HUN,0,0,5,10,15
2001,Sri Lanka,LKA,Hungary,HUN,0,0,34,27,61
2001,North Macedonia,MKD,Hungary,HUN,0,0,37,63,100
2001,Rep. of Moldova,MDA,Hungary,HUN,0,0,10,10,20
2001,Mongolia,MNG,Hungary,HUN,0,0,12,0,12
2001,Morocco,MAR,Hungary,HUN,0,0,11,0,11
2001,Nepal,NPL,Hungary,HUN,0,0,5,0,5
2001,Nigeria,NGA,Hungary,HUN,0,5,32,40,77
2001,Pakistan,PAK,Hungary,HUN,0,0,66,71,137
2001,Romania,ROU,Hungary,HUN,10,0,71,5,86
2001,Russian Federation,RUS,Hungary,HUN,5,5,26,12,48
2001,Rwanda,RWA,Hungary,HUN,0,0,5,0,5
2001,Serbia and Kosovo: S/RES/1244 (1999),SRB,Hungary,HUN,0,66,103,72,241
2001,Senegal,SEN,Hungary,HUN,0,0,0,5,5
2001,Sierra Leone,SLE,Hungary,HUN,0,10,115,127,252
2001,Somalia,SOM,Hungary,HUN,5,13,53,194,265
2001,Viet Nam,VNM,Hungary,HUN,0,0,44,15,59
2001,Sudan,SDN,Hungary,HUN,0,5,60,29,94
2001,Syrian Arab Rep.,SYR,Hungary,HUN,0,0,11,13,24
2001,Togo,TGO,Hungary,HUN,0,0,0,5,5
2001,Tunisia,TUN,Hungary,HUN,0,0,5,5,10
2001,Turkey,TUR,Hungary,HUN,0,0,30,42,72
2001,Ukraine,UKR,Hungary,HUN,0,0,21,0,21
2001,Uzbekistan,UZB,Hungary,HUN,0,0,5,0,5
2001,Stateless,XXA,Hungary,HUN,0,0,10,0,10
2001,Afghanistan,AFG,Iceland,ISL,0,0,5,0,5
2001,Algeria,DZA,Iceland,ISL,0,0,0,5,5
2001,Iran (Islamic Rep. of),IRN,Iceland,ISL,0,0,0,5,5
2001,North Macedonia,MKD,Iceland,ISL,0,0,0,5,5
2001,Romania,ROU,Iceland,ISL,0,0,0,5,5
2001,Serbia and Kosovo: S/RES/1244 (1999),SRB,Iceland,ISL,0,0,5,0,5
2001,Afghanistan,AFG,Cote d'Ivoire,CIV,5,0,0,0,5
2001,Burundi,BDI,Cote d'Ivoire,CIV,5,0,0,0,5
2001,Congo,COG,Cote d'Ivoire,CIV,94,0,12,0,106
2001,Dem. Rep. of the Congo,COD,Cote d'Ivoire,CIV,54,0,38,0,92
2001,Guinea,GIN,Cote d'Ivoire,CIV,5,0,0,0,5
2001,Liberia,LBR,Cote d'Ivoire,CIV,162,7523,0,0,7685
2001,Nigeria,NGA,Cote d'Ivoire,CIV,0,0,5,0,5
2001,Rwanda,RWA,Cote d'Ivoire,CIV,34,0,10,0,44
2001,Sierra Leone,SLE,Cote d'Ivoire,CIV,316,21,0,0,337
2001,Togo,TGO,Cote d'Ivoire,CIV,0,0,5,0,5
2001,Afghanistan,AFG,Ireland,IRL,0,0,5,12,17
2001,Albania,ALB,Ireland,IRL,5,0,28,62,95
2001,Algeria,DZA,Ireland,IRL,0,5,234,136,375
2001,Angola,AGO,Ireland,IRL,44,5,107,46,202
2001,Egypt,EGY,Ireland,IRL,5,0,0,13,18
2001,Armenia,ARM,Ireland,IRL,0,0,20,11,31
2001,Azerbaijan,AZE,Ireland,IRL,0,0,14,5,19
2001,Burundi,BDI,Ireland,IRL,5,0,10,5,20
2001,Belgium,BEL,Ireland,IRL,0,0,0,5,5
2001,Benin,BEN,Ireland,IRL,0,0,0,5,5
2001,Bangladesh,BGD,Ireland,IRL,0,0,5,0,5
2001,Burkina Faso,BFA,Ireland,IRL,0,0,0,5,5
2001,Belarus,BLR,Ireland,IRL,0,0,23,75,98
2001,Brazil,BRA,Ireland,IRL,0,0,0,5,5
2001,Bosnia and Herzegovina,BIH,Ireland,IRL,5,0,5,0,10
2001,Bulgaria,BGR,Ireland,IRL,0,5,77,70,152
2001,China,CHN,Ireland,IRL,0,0,5,5,10
2001,Cameroon,CMR,Ireland,IRL,10,0,23,55,88
2001,Congo,COG,Ireland,IRL,15,0,5,13,33
2001,Dem. Rep. of the Congo,COD,Ireland,IRL,50,5,112,164,331
2001,Czechia,CZE,Ireland,IRL,11,0,112,130,253
2001,Eritrea,ERI,Ireland,IRL,5,0,0,0,5
2001,Estonia,EST,Ireland,IRL,0,0,10,23,33
2001,Ethiopia,ETH,Ireland,IRL,0,0,11,0,11
2001,Gabon,GAB,Ireland,IRL,0,0,5,0,5
2001,Gambia,GMB,Ireland,IRL,0,0,0,15,15
2001,Palestinian,PSE,Ireland,IRL,0,0,5,10,15
2001,Georgia,GEO,Ireland,IRL,5,0,26,29,60
2001,Ghana,GHA,Ireland,IRL,5,0,30,85,120
2001,Guinea,GIN,Ireland,IRL,0,0,0,5,5
2001,Croatia,HRV,Ireland,IRL,14,0,45,25,84
2001,Hungary,HUN,Ireland,IRL,0,0,0,16,16
2001,Cote d'Ivoire,CIV,Ireland,IRL,0,0,27,32,59
2001,India,IND,Ireland,IRL,0,0,0,19,19
2001,Iran (Islamic Rep. of),IRN,Ireland,IRL,14,0,0,5,19
2001,Iraq,IRQ,Ireland,IRL,35,0,29,23,87
2001,Jamaica,JAM,Ireland,IRL,0,0,0,5,5
2001,Jordan,JOR,Ireland,IRL,5,0,0,0,5
2001,Kazakhstan,KAZ,Ireland,IRL,12,0,19,21,52
2001,Kenya,KEN,Ireland,IRL,5,0,17,40,62
2001,Kyrgyzstan,KGZ,Ireland,IRL,0,0,0,10,10
2001,Dem. People's Rep. of Korea,PRK,Ireland,IRL,0,0,5,0,5
2001,Liberia,LBR,Ireland,IRL,0,0,5,11,16
2001,Libya,LBY,Ireland,IRL,5,0,12,21,38
2001,Lebanon,LBN,Ireland,IRL,0,0,0,11,11
2001,Sri Lanka,LKA,Ireland,IRL,0,0,5,27,32
2001,Lithuania,LTU,Ireland,IRL,0,0,24,168,192
2001,Latvia,LVA,Ireland,IRL,0,5,35,41,81
2001,North Macedonia,MKD,Ireland,IRL,0,0,0,17,17
2001,Rep. of Moldova,MDA,Ireland,IRL,0,0,207,287,494
2001,Mongolia,MNG,Ireland,IRL,0,0,0,5,5
2001,Morocco,MAR,Ireland,IRL,0,0,0,17,17
2001,Nigeria,NGA,Ireland,IRL,28,5,1268,2570,3871
2001,Pakistan,PAK,Ireland,IRL,5,0,24,43,72
2001,Philippines,PHL,Ireland,IRL,0,0,5,0,5
2001,Poland,POL,Ireland,IRL,0,0,110,221,331
2001,Romania,ROU,Ireland,IRL,5,18,1127,1602,2752
2001,South Africa,ZAF,Ireland,IRL,0,0,67,83,150
2001,Russian Federation,RUS,Ireland,IRL,13,0,167,193,373
2001,Rwanda,RWA,Ireland,IRL,5,0,5,14,24
2001,Serbia and Kosovo: S/RES/1244 (1999),SRB,Ireland,IRL,49,5,155,164,373
2001,Sierra Leone,SLE,Ireland,IRL,20,0,76,94,190
2001,Somalia,SOM,Ireland,IRL,34,0,40,89,163
2001,Sudan,SDN,Ireland,IRL,5,0,21,12,38
2001,Slovakia,SVK,Ireland,IRL,0,0,10,13,23
2001,Syrian Arab Rep.,SYR,Ireland,IRL,5,0,0,5,10
2001,United Rep. of Tanzania,TZA,Ireland,IRL,5,0,0,5,10
2001,Tajikistan,TJK,Ireland,IRL,5,0,0,5,10
2001,Togo,TGO,Ireland,IRL,12,0,5,18,35
2001,Turkey,TUR,Ireland,IRL,0,0,11,14,25
2001,Uganda,UGA,Ireland,IRL,0,0,13,0,13
2001,Ukraine,UKR,Ireland,IRL,0,0,93,248,341
2001,Uzbekistan,UZB,Ireland,IRL,0,0,5,13,18
2001,Yemen,YEM,Ireland,IRL,5,0,0,0,5
2001,Zimbabwe,ZWE,Ireland,IRL,0,0,11,12,23
2001,Stateless,XXA,Ireland,IRL,0,0,0,17,17
2001,Afghanistan,AFG,Japan,JPN,0,12,31,5,48
2001,Bangladesh,BGD,Japan,JPN,0,0,5,0,5
2001,Ethiopia,ETH,Japan,JPN,0,5,0,0,5
2001,Iran (Islamic Rep. of),IRN,Japan,JPN,14,0,0,0,14
2001,Myanmar,MMR,Japan,JPN,12,40,17,0,69
2001,Pakistan,PAK,Japan,JPN,0,5,28,10,43
2001,Sudan,SDN,Japan,JPN,0,5,5,0,10
2001,Turkey,TUR,Japan,JPN,0,0,164,12,176
2001,Stateless,XXA,Japan,JPN,0,0,5,0,5
2001,Afghanistan,AFG,Kazakhstan,KAZ,45,0,10,162,217
2001,Afghanistan,AFG,Kyrgyzstan,KGZ,159,0,67,47,273
2001,Russian Federation,RUS,Kyrgyzstan,KGZ,0,0,0,124,124
2001,Tajikistan,TJK,Kyrgyzstan,KGZ,0,191,27,0,218
2001,Dem. Rep. of the Congo,COD,Rep. of Korea,KOR,0,0,0,5,5
2001,Myanmar,MMR,Rep. of Korea,KOR,0,0,0,5,5
2001,Bosnia and Herzegovina,BIH,Liechtenstein,LIE,0,0,5,0,5
2001,North Macedonia,MKD,Liechtenstein,LIE,0,0,0,5,5
2001,Serbia and Kosovo: S/RES/1244 (1999),SRB,Liechtenstein,LIE,0,5,28,10,43
2001,Afghanistan,AFG,Lithuania,LTU,0,0,5,16,21
2001,Belarus,BLR,Lithuania,LTU,0,0,5,0,5
2001,Sri Lanka,LKA,Lithuania,LTU,0,0,0,5,5
2001,Pakistan,PAK,Lithuania,LTU,0,0,0,5,5
2001,Russian Federation,RUS,Lithuania,LTU,0,0,125,68,193
2001,Russian Federation,RUS,Latvia,LVA,0,0,11,0,11
2001,Bosnia and Herzegovina,BIH,North Macedonia,MKD,5,0,0,0,5
2001,Serbia and Kosovo: S/RES/1244 (1999),SRB,North Macedonia,MKD,25,0,64,41,130
2001,Uzbekistan,UZB,North Macedonia,MKD,0,0,5,0,5
2001,Congo,COG,Mali,MLI,5,0,0,0,5
2001,Liberia,LBR,Mali,MLI,0,0,5,0,5
2001,Sierra Leone,SLE,Mali,MLI,22,0,0,0,22
2001,Ethiopia,ETH,Mozambique,MOZ,0,0,0,5,5
2001,Rwanda,RWA,Mozambique,MOZ,0,0,0,5,5
2001,Sudan,SDN,Mozambique,MOZ,0,0,0,5,5
2001,Dem. Rep. of the Congo,COD,Namibia,NAM,5,0,0,0,5
2001,Bhutan,BTN,Nepal,NPL,0,10,10,0,20
2001,China,CHN,Nepal,NPL,5,0,5,0,10
2001,Iraq,IRQ,Nepal,NPL,0,0,5,5,10
2001,Afghanistan,AFG,Netherlands,NLD,79,2018,1003,1693,4793
2001,Albania,ALB,Netherlands,NLD,0,0,73,86,159
2001,Algeria,DZA,Netherlands,NLD,0,5,187,188,380
2001,Angola,AGO,Netherlands,NLD,0,215,952,611,1778
2001,Egypt,EGY,Netherlands,NLD,0,0,15,14,29
2001,Armenia,ARM,Netherlands,NLD,0,45,394,341,780
2001,Azerbaijan,AZE,Netherlands,NLD,5,63,549,453,1070
2001,Burundi,BDI,Netherlands,NLD,0,270,43,83,396
2001,Belgium,BEL,Netherlands,NLD,0,0,0,5,5
2001,Benin,BEN,Netherlands,NLD,0,5,36,10,51
2001,Bangladesh,BGD,Netherlands,NLD,0,0,40,30,70
2001,Burkina Faso,BFA,Netherlands,NLD,0,0,19,10,29
2001,Belarus,BLR,Netherlands,NLD,0,5,43,30,78
2001,Bosnia and Herzegovina,BIH,Netherlands,NLD,0,74,651,714,1439
2001,Bulgaria,BGR,Netherlands,NLD,0,0,15,10,25
2001,Cambodia,KHM,Netherlands,NLD,0,0,12,0,12
2001,Chad,TCD,Netherlands,NLD,0,5,29,34,68
2001,China,CHN,Netherlands,NLD,0,60,524,388,972
2001,Cameroon,CMR,Netherlands,NLD,0,10,180,88,278
2001,Congo,COG,Netherlands,NLD,0,52,259,184,495
2001,Dem. Rep. of the Congo,COD,Netherlands,NLD,0,61,273,181,515
2001,Colombia,COL,Netherlands,NLD,0,10,14,16,40
2001,Cuba,CUB,Netherlands,NLD,0,0,5,5,10
2001,Czechia,CZE,Netherlands,NLD,0,0,58,72,130
2001,Denmark,DNK,Netherlands,NLD,0,0,0,5,5
2001,Djibouti,DJI,Netherlands,NLD,0,0,11,0,11
2001,Ecuador,ECU,Netherlands,NLD,0,0,5,5,10
2001,Eritrea,ERI,Netherlands,NLD,0,17,111,88,216
2001,Ethiopia,ETH,Netherlands,NLD,0,14,148,72,234
2001,France,FRA,Netherlands,NLD,0,0,0,5,5
2001,Gabon,GAB,Netherlands,NLD,0,0,5,0,5
2001,Gambia,GMB,Netherlands,NLD,0,0,13,5,18
2001,Palestinian,PSE,Netherlands,NLD,0,0,0,10,10
2001,Georgia,GEO,Netherlands,NLD,0,16,170,116,302
2001,Ghana,GHA,Netherlands,NLD,0,0,5,18,23
2001,Guinea-Bissau,GNB,Netherlands,NLD,0,5,11,10,26
2001,Guinea,GIN,Netherlands,NLD,0,101,815,431,1347
2001,Croatia,HRV,Netherlands,NLD,0,5,39,66,110
2001,Hungary,HUN,Netherlands,NLD,0,0,37,45,82
2001,Cote d'Ivoire,CIV,Netherlands,NLD,0,5,65,29,99
2001,India,IND,Netherlands,NLD,0,0,37,45,82
2001,Indonesia,IDN,Netherlands,NLD,0,0,12,0,12
2001,Iran (Islamic Rep. of),IRN,Netherlands,NLD,10,77,1025,890,2002
2001,Iraq,IRQ,Netherlands,NLD,5,126,1322,906,2359
2001,Israel,ISR,Netherlands,NLD,0,0,13,5,18
2001,Italy,ITA,Netherlands,NLD,0,0,0,10,10
2001,Jordan,JOR,Netherlands,NLD,0,0,5,5,10
2001,Kazakhstan,KAZ,Netherlands,NLD,0,5,87,73,165
2001,Kenya,KEN,Netherlands,NLD,0,0,10,10,20
2001,Kyrgyzstan,KGZ,Netherlands,NLD,0,5,41,50,96
2001,Dem. People's Rep. of Korea,PRK,Netherlands,NLD,0,5,0,0,5
2001,Liberia,LBR,Netherlands,NLD,0,16,89,70,175
2001,Libya,LBY,Netherlands,NLD,0,0,29,35,64
2001,Lebanon,LBN,Netherlands,NLD,0,0,60,44,104
2001,Sri Lanka,LKA,Netherlands,NLD,0,25,329,435,789
2001,Lithuania,LTU,Netherlands,NLD,0,0,14,0,14
2001,Latvia,LVA,Netherlands,NLD,0,0,0,14,14
2001,Mauritania,MRT,Netherlands,NLD,0,10,66,34,110
2001,North Macedonia,MKD,Netherlands,NLD,0,0,75,67,142
2001,Rep. of Moldova,MDA,Netherlands,NLD,0,0,12,10,22
2001,Mali,MLI,Netherlands,NLD,0,0,0,11,11
2001,Mongolia,MNG,Netherlands,NLD,0,15,99,111,225
2001,Morocco,MAR,Netherlands,NLD,0,0,14,30,44
2001,Myanmar,MMR,Netherlands,NLD,0,5,15,5,25
2001,Nepal,NPL,Netherlands,NLD,0,0,11,18,29
2001,Netherlands,NLD,Netherlands,NLD,0,0,0,12,12
2001,Niger,NER,Netherlands,NLD,0,5,112,33,150
2001,Nigeria,NGA,Netherlands,NLD,0,5,213,115,333
2001,Pakistan,PAK,Netherlands,NLD,0,5,55,78,138
2001,Philippines,PHL,Netherlands,NLD,0,0,5,0,5
2001,Poland,POL,Netherlands,NLD,0,0,10,28,38
2001,Portugal,PRT,Netherlands,NLD,0,0,0,5,5
2001,Romania,ROU,Netherlands,NLD,0,0,16,24,40
2001,South Africa,ZAF,Netherlands,NLD,0,0,5,0,5
2001,Russian Federation,RUS,Netherlands,NLD,0,69,492,366,927
2001,Rwanda,RWA,Netherlands,NLD,5,73,129,92,299
2001,Serbia and Kosovo: S/RES/1244 (1999),SRB,Netherlands,NLD,108,102,989,1220,2419
2001,Senegal,SEN,Netherlands,NLD,0,0,5,5,10
2001,Sierra Leone,SLE,Netherlands,NLD,0,1006,470,615,2091
2001,Somalia,SOM,Netherlands,NLD,0,177,595,654,1426
2001,Viet Nam,VNM,Netherlands,NLD,0,5,20,23,48
2001,Sudan,SDN,Netherlands,NLD,5,176,515,431,1127
2001,Suriname,SUR,Netherlands,NLD,0,5,0,13,18
2001,Slovakia,SVK,Netherlands,NLD,0,0,162,182,344
2001,Slovenia,SVN,Netherlands,NLD,0,0,0,5,5
2001,Syrian Arab Rep.,SYR,Netherlands,NLD,10,57,353,338,758
2001,United Rep. of Tanzania,TZA,Netherlands,NLD,0,0,14,0,14
2001,Tajikistan,TJK,Netherlands,NLD,0,0,49,26,75
2001,Togo,TGO,Netherlands,NLD,0,19,294,127,440
2001,Tunisia,TUN,Netherlands,NLD,0,5,5,17,27
2001,Turkey,TUR,Netherlands,NLD,5,41,1017,762,1825
2001,Uganda,UGA,Netherlands,NLD,0,5,28,28,61
2001,Ukraine,UKR,Netherlands,NLD,0,10,98,115,223
2001,Uzbekistan,UZB,Netherlands,NLD,0,18,142,83,243
2001,Yemen,YEM,Netherlands,NLD,0,0,46,35,81
2001,Stateless,XXA,Netherlands,NLD,5,15,415,287,722
2001,Congo,COG,Nigeria,NGA,5,0,5,0,10
2001,Equatorial Guinea,GNQ,Nigeria,NGA,5,0,0,0,5
2001,Ethiopia,ETH,Nigeria,NGA,0,0,5,0,5
2001,Liberia,LBR,Nigeria,NGA,16,0,298,0,314
2001,Rwanda,RWA,Nigeria,NGA,0,0,5,0,5
2001,Sierra Leone,SLE,Nigeria,NGA,66,0,32,0,98
2001,Sudan,SDN,Nigeria,NGA,0,0,5,0,5
2001,Afghanistan,AFG,Norway,NOR,31,341,339,11,722
2001,Albania,ALB,Norway,NOR,0,13,27,12,52
2001,Algeria,DZA,Norway,NOR,0,22,70,34,126
2001,Angola,AGO,Norway,NOR,0,10,0,0,10
2001,Egypt,EGY,Norway,NOR,0,0,5,0,5
2001,Armenia,ARM,Norway,NOR,0,34,95,11,140
2001,Azerbaijan,AZE,Norway,NOR,0,20,31,10,61
2001,Burundi,BDI,Norway,NOR,0,10,40,0,50
2001,Bangladesh,BGD,Norway,NOR,0,10,11,5,26
2001,Belarus,BLR,Norway,NOR,0,28,129,45,202
2001,Bosnia and Herzegovina,BIH,Norway,NOR,5,41,397,46,489
2001,Bulgaria,BGR,Norway,NOR,0,0,537,252,789
2001,China,CHN,Norway,NOR,5,5,13,0,23
2001,Chile,CHL,Norway,NOR,0,0,10,0,10
2001,Cameroon,CMR,Norway,NOR,0,12,5,0,17
2001,Congo,COG,Norway,NOR,0,5,59,0,64
2001,Dem. Rep. of the Congo,COD,Norway,NOR,0,10,31,0,41
2001,Colombia,COL,Norway,NOR,0,0,5,0,5
2001,Czechia,CZE,Norway,NOR,0,0,262,18,280
2001,Eritrea,ERI,Norway,NOR,0,53,38,0,91
2001,Estonia,EST,Norway,NOR,0,0,30,0,30
2001,Ethiopia,ETH,Norway,NOR,5,91,72,0,168
2001,Georgia,GEO,Norway,NOR,0,41,67,21,129
2001,Croatia,HRV,Norway,NOR,0,22,804,43,869
2001,India,IND,Norway,NOR,0,5,14,0,19
2001,Indonesia,IDN,Norway,NOR,0,0,5,0,5
2001,Iran (Islamic Rep. of),IRN,Norway,NOR,20,101,122,20,263
2001,Iraq,IRQ,Norway,NOR,10,252,138,93,493
2001,Israel,ISR,Norway,NOR,0,0,10,0,10
2001,Jordan,JOR,Norway,NOR,0,0,5,0,5
2001,Kazakhstan,KAZ,Norway,NOR,0,52,42,5,99
2001,Kenya,KEN,Norway,NOR,0,0,10,0,10
2001,Kyrgyzstan,KGZ,Norway,NOR,0,0,10,0,10
2001,Liberia,LBR,Norway,NOR,0,0,47,0,47
2001,Libya,LBY,Norway,NOR,0,0,13,0,13
2001,Lebanon,LBN,Norway,NOR,5,0,15,0,20
2001,Sri Lanka,LKA,Norway,NOR,0,112,206,5,323
2001,Lithuania,LTU,Norway,NOR,0,0,67,45,112
2001,Latvia,LVA,Norway,NOR,0,0,18,12,30
2001,North Macedonia,MKD,Norway,NOR,0,5,64,13,82
2001,Rep. of Moldova,MDA,Norway,NOR,0,21,41,5,67
2001,Mongolia,MNG,Norway,NOR,0,0,26,12,38
2001,Morocco,MAR,Norway,NOR,0,0,14,5,19
2001,Mozambique,MOZ,Norway,NOR,0,5,0,0,5
2001,Namibia,NAM,Norway,NOR,0,0,5,0,5
2001,Nepal,NPL,Norway,NOR,0,10,16,0,26
2001,Niger,NER,Norway,NOR,0,5,5,0,10
2001,Pakistan,PAK,Norway,NOR,10,155,115,25,305
2001,Peru,PER,Norway,NOR,0,0,5,0,5
2001,Poland,POL,Norway,NOR,0,0,22,0,22
2001,Romania,ROU,Norway,NOR,0,5,340,214,559
2001,Russian Federation,RUS,Norway,NOR,25,144,511,86,766
2001,Rwanda,RWA,Norway,NOR,0,5,32,0,37
2001,Serbia and Kosovo: S/RES/1244 (1999),SRB,Norway,NOR,167,1509,3144,139,4959
2001,Sierra Leone,SLE,Norway,NOR,0,27,15,5,47
2001,Somalia,SOM,Norway,NOR,5,644,81,49,779
2001,Viet Nam,VNM,Norway,NOR,0,5,0,0,5
2001,Sudan,SDN,Norway,NOR,0,29,27,0,56
2001,Slovakia,SVK,Norway,NOR,0,0,225,29,254
2001,Slovenia,SVN,Norway,NOR,0,0,5,0,5
2001,Syrian Arab Rep.,SYR,Norway,NOR,5,17,46,5,73
2001,United Rep. of Tanzania,TZA,Norway,NOR,0,5,0,0,5
2001,Tajikistan,TJK,Norway,NOR,0,11,13,5,29
2001,Turkmenistan,TKM,Norway,NOR,0,5,0,0,5
2001,Tunisia,TUN,Norway,NOR,0,0,0,5,5
2001,Turkey,TUR,Norway,NOR,0,19,153,24,196
2001,Uganda,UGA,Norway,NOR,0,5,5,0,10
2001,Ukraine,UKR,Norway,NOR,0,59,152,22,233
2001,Uzbekistan,UZB,Norway,NOR,0,0,11,0,11
2001,Stateless,XXA,Norway,NOR,0,54,115,13,182
2001,Afghanistan,AFG,New Zealand,NZL,137,0,10,0,147
2001,Albania,ALB,New Zealand,NZL,0,0,5,0,5
2001,Algeria,DZA,New Zealand,NZL,5,0,19,0,24
2001,Egypt,EGY,New Zealand,NZL,0,0,5,0,5
2001,Austria,AUT,New Zealand,NZL,0,0,5,0,5
2001,Bangladesh,BGD,New Zealand,NZL,0,0,28,0,28
2001,Bolivia (Plurinational State of),BOL,New Zealand,NZL,0,0,11,0,11
2001,Bulgaria,BGR,New Zealand,NZL,0,0,10,0,10
2001,Cambodia,KHM,New Zealand,NZL,11,0,0,0,11
2001,China,CHN,New Zealand,NZL,14,0,144,0,158
2001,Chile,CHL,New Zealand,NZL,0,0,12,0,12
2001,Congo,COG,New Zealand,NZL,5,0,5,0,10
2001,Colombia,COL,New Zealand,NZL,0,0,12,0,12
2001,Czechia,CZE,New Zealand,NZL,0,0,42,0,42
2001,Ecuador,ECU,New Zealand,NZL,0,0,5,0,5
2001,Ethiopia,ETH,New Zealand,NZL,5,0,0,0,5
2001,Fiji,FJI,New Zealand,NZL,0,0,36,0,36
2001,Ghana,GHA,New Zealand,NZL,0,0,5,0,5
2001,India,IND,New Zealand,NZL,5,0,194,0,199
2001,Indonesia,IDN,New Zealand,NZL,0,0,40,0,40
2001,Iran (Islamic Rep. of),IRN,New Zealand,NZL,77,0,39,0,116
2001,Iraq,IRQ,New Zealand,NZL,25,0,10,0,35
2001,Israel,ISR,New Zealand,NZL,0,0,5,0,5
2001,Kuwait,KWT,New Zealand,NZL,27,0,0,0,27
2001,Liberia,LBR,New Zealand,NZL,0,0,5,0,5
2001,Lebanon,LBN,New Zealand,NZL,0,0,5,0,5
2001,Sri Lanka,LKA,New Zealand,NZL,96,0,45,0,141
2001,Lithuania,LTU,New Zealand,NZL,0,0,5,0,5
2001,Latvia,LVA,New Zealand,NZL,0,0,5,0,5
2001,North Macedonia,MKD,New Zealand,NZL,0,0,5,0,5
2001,Malaysia,MYS,New Zealand,NZL,5,0,19,0,24
2001,Mongolia,MNG,New Zealand,NZL,5,0,0,0,5
2001,Morocco,MAR,New Zealand,NZL,0,0,5,0,5
2001,Myanmar,MMR,New Zealand,NZL,5,0,0,0,5
2001,Nepal,NPL,New Zealand,NZL,5,0,0,0,5
2001,Nigeria,NGA,New Zealand,NZL,0,0,12,0,12
2001,Pakistan,PAK,New Zealand,NZL,0,0,24,0,24
2001,Philippines,PHL,New Zealand,NZL,0,0,18,0,18
2001,Romania,ROU,New Zealand,NZL,0,0,10,0,10
2001,South Africa,ZAF,New Zealand,NZL,0,0,10,0,10
2001,Russian Federation,RUS,New Zealand,NZL,0,0,5,0,5
2001,Serbia and Kosovo: S/RES/1244 (1999),SRB,New Zealand,NZL,0,0,5,0,5
2001,Sierra Leone,SLE,New Zealand,NZL,0,0,10,0,10
2001,Somalia,SOM,New Zealand,NZL,11,0,0,0,11
2001,Viet Nam,VNM,New Zealand,NZL,5,0,33,0,38
2001,Sudan,SDN,New Zealand,NZL,0,0,5,0,5
2001,Slovakia,SVK,New Zealand,NZL,0,0,5,0,5
2001,United Rep. of Tanzania,TZA,New Zealand,NZL,0,0,5,0,5
2001,Thailand,THA,New Zealand,NZL,0,0,442,0,442
2001,Tonga,TON,New Zealand,NZL,0,0,16,0,16
2001,Tunisia,TUN,New Zealand,NZL,5,0,0,0,5
2001,Turkey,TUR,New Zealand,NZL,5,0,5,0,10
2001,Ukraine,UKR,New Zealand,NZL,0,0,10,0,10
2001,Zimbabwe,ZWE,New Zealand,NZL,0,0,58,0,58
2001,Albania,ALB,Panama,PAN,5,0,0,0,5
2001,Colombia,COL,Panama,PAN,52,0,39,10,101
2001,Cuba,CUB,Panama,PAN,5,0,0,0,5
2001,Russian Federation,RUS,Peru,PER,5,0,0,0,5
2001,Somalia,SOM,Philippines,PHL,0,0,0,5,5
2001,Afghanistan,AFG,Poland,POL,13,0,117,300,430
2001,Algeria,DZA,Poland,POL,0,0,0,14,14
2001,Egypt,EGY,Poland,POL,0,0,5,0,5
2001,Armenia,ARM,Poland,POL,0,0,878,74,952
2001,Azerbaijan,AZE,Poland,POL,0,0,76,62,138
2001,Bangladesh,BGD,Poland,POL,0,0,5,13,18
2001,Belarus,BLR,Poland,POL,22,0,69,16,107
2001,Bulgaria,BGR,Poland,POL,0,0,187,11,198
2001,China,CHN,Poland,POL,0,0,15,5,20
2001,Cameroon,CMR,Poland,POL,0,0,0,5,5
2001,Congo,COG,Poland,POL,5,0,0,0,5
2001,Dem. Rep. of the Congo,COD,Poland,POL,0,0,5,0,5
2001,Georgia,GEO,Poland,POL,0,0,54,42,96
2001,Ghana,GHA,Poland,POL,0,0,0,5,5
2001,India,IND,Poland,POL,0,0,23,10,33
2001,Iraq,IRQ,Poland,POL,0,0,10,105,115
2001,Kazakhstan,KAZ,Poland,POL,0,0,19,12,31
2001,Kyrgyzstan,KGZ,Poland,POL,0,0,5,5,10
2001,Liberia,LBR,Poland,POL,0,0,0,5,5
2001,Libya,LBY,Poland,POL,0,0,5,0,5
2001,Lebanon,LBN,Poland,POL,0,0,0,5,5
2001,Sri Lanka,LKA,Poland,POL,0,0,5,32,37
2001,Lithuania,LTU,Poland,POL,0,0,0,12,12
2001,Rep. of Moldova,MDA,Poland,POL,0,0,190,58,248
2001,Mongolia,MNG,Poland,POL,0,0,302,28,330
2001,Morocco,MAR,Poland,POL,0,0,5,5,10
2001,Nigeria,NGA,Poland,POL,0,0,5,5,10
2001,Pakistan,PAK,Poland,POL,0,0,17,39,56
2001,Romania,ROU,Poland,POL,0,0,256,25,281
2001,Russian Federation,RUS,Poland,POL,206,0,211,801,1218
2001,Serbia and Kosovo: S/RES/1244 (1999),SRB,Poland,POL,5,0,5,31,41
2001,Senegal,SEN,Poland,POL,0,0,0,5,5
2001,Somalia,SOM,Poland,POL,10,0,0,14,24
2001,Viet Nam,VNM,Poland,POL,0,0,187,27,214
2001,Sudan,SDN,Poland,POL,0,0,11,0,11
2001,Syrian Arab Rep.,SYR,Poland,POL,0,0,13,0,13
2001,Turkey,TUR,Poland,POL,0,0,0,12,12
2001,Ukraine,UKR,Poland,POL,0,0,122,26,148
2001,Uzbekistan,UZB,Poland,POL,0,0,10,5,15
2001,Yemen,YEM,Poland,POL,0,0,5,0,5
2001,Stateless,XXA,Poland,POL,0,0,13,0,13
2001,Afghanistan,AFG,Portugal,PRT,0,5,0,5,10
2001,Albania,ALB,Portugal,PRT,0,0,0,5,5
2001,Angola,AGO,Portugal,PRT,0,5,0,22,27
2001,Cameroon,CMR,Portugal,PRT,0,0,0,5,5
2001,Dem. Rep. of the Congo,COD,Portugal,PRT,0,0,0,12,12
2001,Cuba,CUB,Portugal,PRT,5,0,0,5,10
2001,Gambia,GMB,Portugal,PRT,0,0,0,13,13
2001,Guinea,GIN,Portugal,PRT,0,0,0,5,5
2001,Iran (Islamic Rep. of),IRN,Portugal,PRT,0,0,0,5,5
2001,Sri Lanka,LKA,Portugal,PRT,0,0,0,5,5
2001,North Macedonia,MKD,Portugal,PRT,0,0,0,5,5
2001,Nigeria,NGA,Portugal,PRT,0,0,0,5,5
2001,Pakistan,PAK,Portugal,PRT,0,0,0,5,5
2001,Russian Federation,RUS,Portugal,PRT,0,0,0,5,5
2001,Sierra Leone,SLE,Portugal,PRT,0,14,0,26,40
2001,Zimbabwe,ZWE,Portugal,PRT,0,5,0,0,5
2001,Afghanistan,AFG,Romania,ROU,10,5,769,5,789
2001,Algeria,DZA,Romania,ROU,0,0,16,0,16
2001,Egypt,EGY,Romania,ROU,0,0,13,0,13
2001,Bangladesh,BGD,Romania,ROU,0,0,33,0,33
2001,China,CHN,Romania,ROU,0,0,34,5,39
2001,Cameroon,CMR,Romania,ROU,0,0,5,0,5
2001,Congo,COG,Romania,ROU,12,0,17,0,29
2001,Dem. Rep. of the Congo,COD,Romania,ROU,0,0,5,0,5
2001,Djibouti,DJI,Romania,ROU,0,0,0,5,5
2001,Eritrea,ERI,Romania,ROU,0,0,5,0,5
2001,Palestinian,PSE,Romania,ROU,10,0,32,0,42
2001,India,IND,Romania,ROU,0,0,130,5,135
2001,Iran (Islamic Rep. of),IRN,Romania,ROU,15,0,84,5,104
2001,Iraq,IRQ,Romania,ROU,15,19,600,10,644
2001,Jordan,JOR,Romania,ROU,0,0,10,0,10
2001,Liberia,LBR,Romania,ROU,0,0,5,0,5
2001,Lebanon,LBN,Romania,ROU,0,0,10,0,10
2001,Sri Lanka,LKA,Romania,ROU,0,0,10,0,10
2001,North Macedonia,MKD,Romania,ROU,0,5,0,0,5
2001,Nigeria,NGA,Romania,ROU,0,0,5,0,5
2001,Pakistan,PAK,Romania,ROU,0,0,108,5,113
2001,Russian Federation,RUS,Romania,ROU,0,0,5,0,5
2001,Rwanda,RWA,Romania,ROU,0,0,5,0,5
2001,Serbia and Kosovo: S/RES/1244 (1999),SRB,Romania,ROU,5,0,19,10,34
2001,Sierra Leone,SLE,Romania,ROU,0,0,32,5,37
2001,Somalia,SOM,Romania,ROU,5,0,167,0,172
2001,Sudan,SDN,Romania,ROU,5,0,50,0,55
2001,Syrian Arab Rep.,SYR,Romania,ROU,0,5,14,0,19
2001,Turkey,TUR,Romania,ROU,5,0,35,5,45
2001,Afghanistan,AFG,South Africa,ZAF,5,0,0,0,5
2001,Algeria,DZA,South Africa,ZAF,0,0,82,12,94
2001,Angola,AGO,South Africa,ZAF,860,0,36,68,964
2001,Egypt,EGY,South Africa,ZAF,0,0,39,5,44
2001,Burundi,BDI,South Africa,ZAF,809,0,235,5,1049
2001,Benin,BEN,South Africa,ZAF,0,0,75,5,80
2001,Bangladesh,BGD,South Africa,ZAF,0,0,268,30,298
2001,Bosnia and Herzegovina,BIH,South Africa,ZAF,12,0,0,0,12
2001,Bulgaria,BGR,South Africa,ZAF,0,0,96,12,108
2001,China,CHN,South Africa,ZAF,0,0,229,64,293
2001,Cameroon,CMR,South Africa,ZAF,0,0,252,10,262
2001,Congo,COG,South Africa,ZAF,219,0,614,21,854
2001,Dem. Rep. of the Congo,COD,South Africa,ZAF,561,0,367,175,1103
2001,Comoros,COM,South Africa,ZAF,0,0,61,5,66
2001,Eritrea,ERI,South Africa,ZAF,0,0,212,30,242
2001,Ethiopia,ETH,South Africa,ZAF,5,0,1336,78,1419
2001,Ghana,GHA,South Africa,ZAF,5,0,322,17,344
2001,Cote d'Ivoire,CIV,South Africa,ZAF,0,0,190,21,211
2001,India,IND,South Africa,ZAF,0,0,1132,59,1191
2001,Iran (Islamic Rep. of),IRN,South Africa,ZAF,0,0,5,0,5
2001,Iraq,IRQ,South Africa,ZAF,0,0,12,5,17
2001,Kenya,KEN,South Africa,ZAF,0,0,286,5,291
2001,Liberia,LBR,South Africa,ZAF,46,0,54,5,105
2001,Sri Lanka,LKA,South Africa,ZAF,0,0,15,0,15
2001,Mali,MLI,South Africa,ZAF,0,0,22,5,27
2001,Mozambique,MOZ,South Africa,ZAF,0,0,0,5,5
2001,Nigeria,NGA,South Africa,ZAF,5,0,804,109,918
2001,Pakistan,PAK,South Africa,ZAF,5,0,1181,133,1319
2001,Rwanda,RWA,South Africa,ZAF,427,0,65,11,503
2001,Serbia and Kosovo: S/RES/1244 (1999),SRB,South Africa,ZAF,0,0,35,0,35
2001,Senegal,SEN,South Africa,ZAF,0,0,322,26,348
2001,Sierra Leone,SLE,South Africa,ZAF,41,0,147,10,198
2001,Somalia,SOM,South Africa,ZAF,530,0,64,54,648
2001,Sudan,SDN,South Africa,ZAF,50,0,61,5,116
2001,United Rep. of Tanzania,TZA,South Africa,ZAF,0,0,403,0,403
2001,Uganda,UGA,South Africa,ZAF,0,0,373,10,383
2001,Zambia,ZMB,South Africa,ZAF,5,0,37,0,42
2001,Zimbabwe,ZWE,South Africa,ZAF,0,0,11,0,11
2001,Afghanistan,AFG,Russian Federation,RUS,119,0,1132,0,1251
2001,Angola,AGO,Russian Federation,RUS,0,0,11,0,11
2001,Armenia,ARM,Russian Federation,RUS,0,0,11,0,11
2001,Azerbaijan,AZE,Russian Federation,RUS,0,0,19,0,19
2001,Cambodia,KHM,Russian Federation,RUS,0,0,5,0,5
2001,Dem. Rep. of the Congo,COD,Russian Federation,RUS,0,0,11,0,11
2001,Ethiopia,ETH,Russian Federation,RUS,0,0,10,0,10
2001,Georgia,GEO,Russian Federation,RUS,5,0,33,0,38
2001,Iraq,IRQ,Russian Federation,RUS,5,0,58,0,63
2001,Kazakhstan,KAZ,Russian Federation,RUS,0,0,46,0,46
2001,Kyrgyzstan,KGZ,Russian Federation,RUS,5,0,5,0,10
2001,Rep. of Moldova,MDA,Russian Federation,RUS,0,0,11,0,11
2001,Rwanda,RWA,Russian Federation,RUS,0,0,19,0,19
2001,Somalia,SOM,Russian Federation,RUS,0,0,5,0,5
2001,Sudan,SDN,Russian Federation,RUS,0,0,5,0,5
2001,Tajikistan,TJK,Russian Federation,RUS,0,0,24,0,24
2001,Turkmenistan,TKM,Russian Federation,RUS,0,0,10,0,10
2001,Ukraine,UKR,Russian Federation,RUS,0,0,5,0,5
2001,Uzbekistan,UZB,Russian Federation,RUS,0,0,27,0,27
2001,Afghanistan,AFG,Serbia and Kosovo: S/RES/1244 (1999),SRB,12,0,5,5,22
2001,Bangladesh,BGD,Serbia and Kosovo: S/RES/1244 (1999),SRB,0,0,0,5,5
2001,Palestinian,PSE,Serbia and Kosovo: S/RES/1244 (1999),SRB,0,0,5,5,10
2001,Georgia,GEO,Serbia and Kosovo: S/RES/1244 (1999),SRB,0,0,5,5,10
2001,Iran (Islamic Rep. of),IRN,Serbia and Kosovo: S/RES/1244 (1999),SRB,0,0,0,5,5
2001,Iraq,IRQ,Serbia and Kosovo: S/RES/1244 (1999),SRB,5,0,18,5,28
2001,Pakistan,PAK,Serbia and Kosovo: S/RES/1244 (1999),SRB,0,0,0,5,5
2001,Romania,ROU,Serbia and Kosovo: S/RES/1244 (1999),SRB,0,0,5,0,5
2001,Russian Federation,RUS,Serbia and Kosovo: S/RES/1244 (1999),SRB,0,0,0,14,14
2001,Chad,TCD,Senegal,SEN,0,0,5,0,5
2001,Congo,COG,Senegal,SEN,0,0,5,0,5
2001,Dem. Rep. of the Congo,COD,Senegal,SEN,0,0,11,0,11
2001,Ethiopia,ETH,Senegal,SEN,0,0,5,0,5
2001,Guinea-Bissau,GNB,Senegal,SEN,0,0,5,0,5
2001,Liberia,LBR,Senegal,SEN,0,0,20,0,20
2001,Sri Lanka,LKA,Senegal,SEN,0,0,5,0,5
2001,Mauritania,MRT,Senegal,SEN,0,0,13,0,13
2001,Nigeria,NGA,Senegal,SEN,0,0,15,0,15
2001,Pakistan,PAK,Senegal,SEN,0,0,10,0,10
2001,Rwanda,RWA,Senegal,SEN,12,0,0,0,12
2001,Sierra Leone,SLE,Senegal,SEN,0,0,155,0,155
2001,Afghanistan,AFG,Spain,ESP,15,0,28,5,48
2001,Albania,ALB,Spain,ESP,0,0,0,14,14
2001,Algeria,DZA,Spain,ESP,5,0,119,233,357
2001,Angola,AGO,Spain,ESP,0,12,45,13,70
2001,Egypt,EGY,Spain,ESP,0,0,0,5,5
2001,Argentina,ARG,Spain,ESP,0,0,0,10,10
2001,Armenia,ARM,Spain,ESP,28,10,271,194,503
2001,Azerbaijan,AZE,Spain,ESP,0,5,35,13,53
2001,Benin,BEN,Spain,ESP,0,0,0,5,5
2001,Bangladesh,BGD,Spain,ESP,0,0,5,23,28
2001,Burkina Faso,BFA,Spain,ESP,5,0,0,0,5
2001,Belarus,BLR,Spain,ESP,0,0,0,12,12
2001,Bolivia (Plurinational State of),BOL,Spain,ESP,0,0,0,5,5
2001,Bosnia and Herzegovina,BIH,Spain,ESP,0,0,0,5,5
2001,Bulgaria,BGR,Spain,ESP,0,0,0,10,10
2001,China,CHN,Spain,ESP,0,0,0,13,13
2001,Cameroon,CMR,Spain,ESP,0,0,0,11,11
2001,Congo,COG,Spain,ESP,0,0,36,10,46
2001,Dem. Rep. of the Congo,COD,Spain,ESP,26,0,57,39,122
2001,Colombia,COL,Spain,ESP,76,91,475,817,1459
2001,Cuba,CUB,Spain,ESP,15,0,90,2193,2298
2001,Czechia,CZE,Spain,ESP,0,0,10,0,10
2001,Ecuador,ECU,Spain,ESP,0,0,5,15,20
2001,Equatorial Guinea,GNQ,Spain,ESP,22,5,25,15,67
2001,Eritrea,ERI,Spain,ESP,0,0,0,5,5
2001,Ethiopia,ETH,Spain,ESP,16,0,14,10,40
2001,Gambia,GMB,Spain,ESP,0,0,5,0,5
2001,Georgia,GEO,Spain,ESP,5,0,102,97,204
2001,Ghana,GHA,Spain,ESP,0,0,0,24,24
2001,Guinea-Bissau,GNB,Spain,ESP,0,0,14,5,19
2001,Guatemala,GTM,Spain,ESP,0,0,0,5,5
2001,Guinea,GIN,Spain,ESP,5,0,5,24,34
2001,Honduras,HND,Spain,ESP,5,0,0,0,5
2001,Croatia,HRV,Spain,ESP,0,0,0,5,5
2001,Cote d'Ivoire,CIV,Spain,ESP,0,0,10,11,21
2001,India,IND,Spain,ESP,0,0,10,23,33
2001,Iran (Islamic Rep. of),IRN,Spain,ESP,5,0,49,20,74
2001,Iraq,IRQ,Spain,ESP,0,22,47,47,116
2001,Kazakhstan,KAZ,Spain,ESP,0,0,0,5,5
2001,Kyrgyzstan,KGZ,Spain,ESP,0,0,0,5,5
2001,Liberia,LBR,Spain,ESP,0,5,14,35,54
2001,Lebanon,LBN,Spain,ESP,0,0,5,0,5
2001,Sri Lanka,LKA,Spain,ESP,0,0,0,21,21
2001,Lithuania,LTU,Spain,ESP,0,0,0,10,10
2001,Mauritania,MRT,Spain,ESP,0,0,0,5,5
2001,North Macedonia,MKD,Spain,ESP,0,0,0,15,15
2001,Rep. of Moldova,MDA,Spain,ESP,0,0,0,46,46
2001,Mali,MLI,Spain,ESP,0,0,0,5,5
2001,Mongolia,MNG,Spain,ESP,0,0,0,10,10
2001,Morocco,MAR,Spain,ESP,0,0,16,18,34
2001,Nepal,NPL,Spain,ESP,0,0,0,5,5
2001,Nigeria,NGA,Spain,ESP,0,0,16,1240,1256
2001,Pakistan,PAK,Spain,ESP,5,0,31,22,58
2001,Peru,PER,Spain,ESP,5,0,17,11,33
2001,Poland,POL,Spain,ESP,0,0,0,5,5
2001,Romania,ROU,Spain,ESP,0,0,5,320,325
2001,Russian Federation,RUS,Spain,ESP,50,35,102,221,408
2001,Rwanda,RWA,Spain,ESP,0,0,5,5,10
2001,Serbia and Kosovo: S/RES/1244 (1999),SRB,Spain,ESP,0,18,60,29,107
2001,Senegal,SEN,Spain,ESP,0,0,0,13,13
2001,Sierra Leone,SLE,Spain,ESP,0,31,110,596,737
2001,Somalia,SOM,Spain,ESP,0,10,50,5,65
2001,Sudan,SDN,Spain,ESP,0,5,5,11,21
2001,Slovakia,SVK,Spain,ESP,0,0,0,5,5
2001,Syrian Arab Rep.,SYR,Spain,ESP,5,0,33,5,43
2001,United Rep. of Tanzania,TZA,Spain,ESP,0,0,0,5,5
2001,Tajikistan,TJK,Spain,ESP,0,0,0,5,5
2001,Togo,TGO,Spain,ESP,0,0,0,5,5
2001,Tunisia,TUN,Spain,ESP,10,0,0,0,10
2001,Turkey,TUR,Spain,ESP,0,0,30,23,53
2001,Ukraine,UKR,Spain,ESP,5,5,13,189,212
2001,Afghanistan,AFG,Slovakia,SVK,5,0,13,2821,2839
2001,Algeria,DZA,Slovakia,SVK,0,0,5,5,10
2001,Angola,AGO,Slovakia,SVK,0,0,0,5,5
2001,Armenia,ARM,Slovakia,SVK,0,0,10,21,31
2001,Bangladesh,BGD,Slovakia,SVK,0,0,5,224,229
2001,Bhutan,BTN,Slovakia,SVK,0,0,0,5,5
2001,Belarus,BLR,Slovakia,SVK,0,0,0,5,5
2001,Bulgaria,BGR,Slovakia,SVK,0,0,10,0,10
2001,China,CHN,Slovakia,SVK,0,0,0,27,27
2001,Cameroon,CMR,Slovakia,SVK,0,0,0,5,5
2001,Czechia,CZE,Slovakia,SVK,0,0,5,0,5
2001,Ethiopia,ETH,Slovakia,SVK,0,0,0,14,14
2001,Georgia,GEO,Slovakia,SVK,0,0,0,11,11
2001,Ghana,GHA,Slovakia,SVK,0,0,0,5,5
2001,India,IND,Slovakia,SVK,0,0,30,759,789
2001,Iran (Islamic Rep. of),IRN,Slovakia,SVK,0,0,0,89,91
2001,Iraq,IRQ,Slovakia,SVK,0,0,11,623,634
2001,Sri Lanka,LKA,Slovakia,SVK,0,0,0,107,107
2001,North Macedonia,MKD,Slovakia,SVK,0,0,0,12,12
2001,Nepal,NPL,Slovakia,SVK,0,0,0,16,16
2001,Nigeria,NGA,Slovakia,SVK,0,0,0,11,11
2001,Pakistan,PAK,Slovakia,SVK,0,0,11,133,144
2001,Romania,ROU,Slovakia,SVK,0,0,0,5,5
2001,Russian Federation,RUS,Slovakia,SVK,5,0,0,15,20
2001,Serbia and Kosovo: S/RES/1244 (1999),SRB,Slovakia,SVK,0,0,11,10,21
2001,Senegal,SEN,Slovakia,SVK,0,0,0,5,5
2001,Sierra Leone,SLE,Slovakia,SVK,0,0,0,77,77
2001,Somalia,SOM,Slovakia,SVK,0,0,0,75,75
2001,Viet Nam,VNM,Slovakia,SVK,0,0,0,37,37
2001,Sudan,SDN,Slovakia,SVK,0,0,0,28,28
2001,Syrian Arab Rep.,SYR,Slovakia,SVK,0,0,0,5,5
2001,Tunisia,TUN,Slovakia,SVK,0,0,0,5,5
2001,Turkey,TUR,Slovakia,SVK,0,0,0,42,42
2001,Stateless,XXA,Slovakia,SVK,0,0,0,5,5
2001,Afghanistan,AFG,Slovenia,SVN,0,0,0,296,296
2001,Algeria,DZA,Slovenia,SVN,0,0,0,198,198
2001,Armenia,ARM,Slovenia,SVN,0,0,0,34,34
2001,Azerbaijan,AZE,Slovenia,SVN,0,0,0,5,5
2001,Bangladesh,BGD,Slovenia,SVN,0,0,0,252,252
2001,Belarus,BLR,Slovenia,SVN,0,5,0,0,5
2001,Bosnia and Herzegovina,BIH,Slovenia,SVN,0,5,5,42,52
2001,China,CHN,Slovenia,SVN,0,0,0,41,41
2001,Cameroon,CMR,Slovenia,SVN,0,0,0,5,5
2001,Dem. Rep. of the Congo,COD,Slovenia,SVN,0,0,0,5,5
2001,Ethiopia,ETH,Slovenia,SVN,0,0,0,5,5
2001,Palestinian,PSE,Slovenia,SVN,0,0,0,10,10
2001,Ghana,GHA,Slovenia,SVN,0,0,0,14,14
2001,Croatia,HRV,Slovenia,SVN,0,0,0,5,5
2001,India,IND,Slovenia,SVN,0,0,0,88,88
2001,Iran (Islamic Rep. of),IRN,Slovenia,SVN,0,0,12,5854,5866
2001,Iraq,IRQ,Slovenia,SVN,0,0,0,639,639
2001,Liberia,LBR,Slovenia,SVN,0,0,0,5,5
2001,Lebanon,LBN,Slovenia,SVN,0,0,0,5,5
2001,Sri Lanka,LKA,Slovenia,SVN,0,0,0,15,15
2001,North Macedonia,MKD,Slovenia,SVN,0,0,5,74,79
2001,Rep. of Moldova,MDA,Slovenia,SVN,0,0,0,40,40
2001,Morocco,MAR,Slovenia,SVN,0,0,0,5,5
2001,Pakistan,PAK,Slovenia,SVN,0,0,0,72,72
2001,Romania,ROU,Slovenia,SVN,0,0,0,48,48
2001,Russian Federation,RUS,Slovenia,SVN,0,0,0,34,34
2001,Serbia and Kosovo: S/RES/1244 (1999),SRB,Slovenia,SVN,0,10,41,521,572
2001,Sierra Leone,SLE,Slovenia,SVN,0,5,10,170,185
2001,Somalia,SOM,Slovenia,SVN,0,0,0,11,11
2001,Sudan,SDN,Slovenia,SVN,0,0,0,25,25
2001,Slovakia,SVK,Slovenia,SVN,0,0,12,0,12
2001,Togo,TGO,Slovenia,SVN,0,0,0,5,5
2001,Turkey,TUR,Slovenia,SVN,0,0,0,1394,1394
2001,Burundi,BDI,Eswatini,SWZ,5,0,0,0,5
2001,Bulgaria,BGR,Eswatini,SWZ,5,0,0,0,5
2001,Congo,COG,Eswatini,SWZ,5,0,0,0,5
2001,Ethiopia,ETH,Eswatini,SWZ,0,0,10,0,10
2001,Liberia,LBR,Eswatini,SWZ,0,0,28,0,28
2001,Sri Lanka,LKA,Eswatini,SWZ,0,0,22,0,22
2001,Rwanda,RWA,Eswatini,SWZ,10,0,0,0,10
2001,Sierra Leone,SLE,Eswatini,SWZ,0,0,30,0,30
2001,Somalia,SOM,Eswatini,SWZ,0,0,5,0,5
2001,Afghanistan,AFG,Sweden,SWE,12,262,37,38,349
2001,Albania,ALB,Sweden,SWE,0,10,66,5,81
2001,Algeria,DZA,Sweden,SWE,0,0,70,21,91
2001,Angola,AGO,Sweden,SWE,0,5,5,0,10
2001,Egypt,EGY,Sweden,SWE,0,5,17,22,44
2001,Argentina,ARG,Sweden,SWE,0,0,5,0,5
2001,Armenia,ARM,Sweden,SWE,0,21,102,18,141
2001,Azerbaijan,AZE,Sweden,SWE,5,0,37,5,47
2001,Bahrain,BHR,Sweden,SWE,0,0,5,0,5
2001,Burundi,BDI,Sweden,SWE,0,18,0,0,18
2001,Bangladesh,BGD,Sweden,SWE,0,5,81,10,96
2001,Belarus,BLR,Sweden,SWE,15,0,186,39,240
2001,Bolivia (Plurinational State of),BOL,Sweden,SWE,0,0,26,10,36
2001,Bosnia and Herzegovina,BIH,Sweden,SWE,5,247,3842,286,4380
2001,Bulgaria,BGR,Sweden,SWE,0,0,265,101,366
2001,Canada,CAN,Sweden,SWE,0,0,5,0,5
2001,Chad,TCD,Sweden,SWE,0,5,0,0,5
2001,China,CHN,Sweden,SWE,0,0,39,12,51
2001,Chile,CHL,Sweden,SWE,0,5,33,0,38
2001,Congo,COG,Sweden,SWE,0,0,5,0,5
2001,Dem. Rep. of the Congo,COD,Sweden,SWE,0,22,45,0,67
2001,Colombia,COL,Sweden,SWE,0,15,47,15,77
2001,Cuba,CUB,Sweden,SWE,0,5,21,0,26
2001,Czechia,CZE,Sweden,SWE,0,0,42,5,47
2001,Ecuador,ECU,Sweden,SWE,0,0,94,14,108
2001,Eritrea,ERI,Sweden,SWE,0,13,117,5,135
2001,Estonia,EST,Sweden,SWE,0,0,16,0,16
2001,Ethiopia,ETH,Sweden,SWE,0,14,56,5,75
2001,Gambia,GMB,Sweden,SWE,0,0,11,0,11
2001,Georgia,GEO,Sweden,SWE,0,0,50,12,62
2001,Ghana,GHA,Sweden,SWE,0,0,14,0,14
2001,Guinea-Bissau,GNB,Sweden,SWE,0,0,5,0,5
2001,Guinea,GIN,Sweden,SWE,0,0,10,0,10
2001,Croatia,HRV,Sweden,SWE,0,12,154,21,187
2001,India,IND,Sweden,SWE,0,0,48,5,53
2001,Iran (Islamic Rep. of),IRN,Sweden,SWE,26,64,592,84,766
2001,Iraq,IRQ,Sweden,SWE,60,2652,376,111,3199
2001,Israel,ISR,Sweden,SWE,0,0,11,0,11
2001,Jordan,JOR,Sweden,SWE,0,10,18,0,28
2001,Kazakhstan,KAZ,Sweden,SWE,0,17,76,11,104
2001,Kenya,KEN,Sweden,SWE,0,0,11,0,11
2001,Kyrgyzstan,KGZ,Sweden,SWE,0,0,15,0,15
2001,Rep. of Korea,KOR,Sweden,SWE,0,0,5,0,5
2001,Libya,LBY,Sweden,SWE,0,0,19,14,33
2001,Lebanon,LBN,Sweden,SWE,0,14,112,31,157
2001,Sri Lanka,LKA,Sweden,SWE,0,5,59,32,96
2001,Lithuania,LTU,Sweden,SWE,0,0,64,23,87
2001,Latvia,LVA,Sweden,SWE,0,5,14,11,30
2001,North Macedonia,MKD,Sweden,SWE,0,10,77,5,92
2001,Rep. of Moldova,MDA,Sweden,SWE,0,0,21,5,26
2001,Mongolia,MNG,Sweden,SWE,0,0,69,11,80
2001,Morocco,MAR,Sweden,SWE,0,0,11,5,16
2001,Nigeria,NGA,Sweden,SWE,0,0,31,5,36
2001,Pakistan,PAK,Sweden,SWE,0,0,98,32,130
2001,Peru,PER,Sweden,SWE,0,14,70,11,95
2001,Poland,POL,Sweden,SWE,0,5,41,0,46
2001,Romania,ROU,Sweden,SWE,0,0,49,28,77
2001,Russian Federation,RUS,Sweden,SWE,0,14,477,66,557
2001,Rwanda,RWA,Sweden,SWE,0,11,0,0,11
2001,El Salvador,SLV,Sweden,SWE,0,0,129,10,139
2001,Serbia and Kosovo: S/RES/1244 (1999),SRB,Sweden,SWE,0,500,1445,231,2176
2001,Sierra Leone,SLE,Sweden,SWE,0,5,17,5,27
2001,Somalia,SOM,Sweden,SWE,5,184,33,35,257
2001,Viet Nam,VNM,Sweden,SWE,0,15,0,0,15
2001,Sudan,SDN,Sweden,SWE,0,14,0,0,14
2001,Slovakia,SVK,Sweden,SWE,0,0,240,41,281
2001,Sweden,SWE,Sweden,SWE,0,0,0,5,5
2001,Syrian Arab Rep.,SYR,Sweden,SWE,5,20,249,14,288
2001,United Rep. of Tanzania,TZA,Sweden,SWE,0,0,12,0,12
2001,Thailand,THA,Sweden,SWE,0,5,0,0,5
2001,Tajikistan,TJK,Sweden,SWE,0,5,5,0,10
2001,Tunisia,TUN,Sweden,SWE,0,0,11,0,11
2001,Turkey,TUR,Sweden,SWE,10,19,160,14,203
2001,Uganda,UGA,Sweden,SWE,0,0,10,0,10
2001,Ukraine,UKR,Sweden,SWE,10,10,123,24,167
2001,United States of America,USA,Sweden,SWE,0,0,5,5,10
2001,Uzbekistan,UZB,Sweden,SWE,0,0,33,0,33
2001,Venezuela (Bolivarian Republic of),VEN,Sweden,SWE,0,0,5,0,5
2001,Yemen,YEM,Sweden,SWE,0,5,0,0,5
2001,Stateless,XXA,Sweden,SWE,5,73,226,26,330
2001,Afghanistan,AFG,Switzerland,CHE,226,130,136,71,563
2001,Albania,ALB,Switzerland,CHE,10,16,34,184,244
2001,Algeria,DZA,Switzerland,CHE,30,16,287,255,588
2001,Angola,AGO,Switzerland,CHE,5,270,317,86,678
2001,Egypt,EGY,Switzerland,CHE,12,0,0,0,12
2001,Argentina,ARG,Switzerland,CHE,0,0,0,5,5
2001,Armenia,ARM,Switzerland,CHE,0,19,174,135,328
2001,Azerbaijan,AZE,Switzerland,CHE,0,0,30,37,67
2001,Burundi,BDI,Switzerland,CHE,0,0,21,0,21
2001,Benin,BEN,Switzerland,CHE,0,0,0,5,5
2001,Bangladesh,BGD,Switzerland,CHE,0,5,99,63,167
2001,Burkina Faso,BFA,Switzerland,CHE,0,0,32,21,53
2001,Belarus,BLR,Switzerland,CHE,0,0,16,84,100
2001,Bosnia and Herzegovina,BIH,Switzerland,CHE,168,788,977,273,2206
2001,Bulgaria,BGR,Switzerland,CHE,0,0,76,95,171
2001,Cambodia,KHM,Switzerland,CHE,15,0,0,0,15
2001,Chad,TCD,Switzerland,CHE,5,0,5,0,10
2001,China,CHN,Switzerland,CHE,20,0,21,17,58
2001,Chile,CHL,Switzerland,CHE,0,0,0,5,5
2001,Cameroon,CMR,Switzerland,CHE,0,0,74,47,121
2001,Congo,COG,Switzerland,CHE,5,0,18,10,33
2001,Dem. Rep. of the Congo,COD,Switzerland,CHE,53,250,428,162,893
2001,Colombia,COL,Switzerland,CHE,19,13,46,11,89
2001,Cuba,CUB,Switzerland,CHE,0,0,11,5,16
2001,Czechia,CZE,Switzerland,CHE,0,0,24,18,42
2001,Ecuador,ECU,Switzerland,CHE,0,0,5,0,5
2001,Eritrea,ERI,Switzerland,CHE,5,27,166,16,214
2001,Ethiopia,ETH,Switzerland,CHE,5,38,294,20,357
2001,France,FRA,Switzerland,CHE,0,0,0,5,5
2001,Gambia,GMB,Switzerland,CHE,0,0,0,23,23
2001,Georgia,GEO,Switzerland,CHE,0,17,85,99,201
2001,Germany,DEU,Switzerland,CHE,0,0,0,5,5
2001,Ghana,GHA,Switzerland,CHE,0,0,0,12,12
2001,Guinea-Bissau,GNB,Switzerland,CHE,0,0,16,62,78
2001,Guinea,GIN,Switzerland,CHE,0,5,264,340,609
2001,Croatia,HRV,Switzerland,CHE,0,0,10,5,15
2001,Cote d'Ivoire,CIV,Switzerland,CHE,0,0,46,64,110
2001,India,IND,Switzerland,CHE,5,12,43,155,215
2001,Indonesia,IDN,Switzerland,CHE,0,0,0,5,5
2001,Iran (Islamic Rep. of),IRN,Switzerland,CHE,69,23,280,100,472
2001,Iraq,IRQ,Switzerland,CHE,351,258,773,363,1745
2001,Israel,ISR,Switzerland,CHE,0,0,5,16,21
2001,Jordan,JOR,Switzerland,CHE,5,0,5,14,24
2001,Kazakhstan,KAZ,Switzerland,CHE,0,0,5,13,18
2001,Kenya,KEN,Switzerland,CHE,0,0,5,5,10
2001,Kyrgyzstan,KGZ,Switzerland,CHE,0,0,5,0,5
2001,Liberia,LBR,Switzerland,CHE,0,0,10,28,38
2001,Libya,LBY,Switzerland,CHE,119,0,21,22,162
2001,Lebanon,LBN,Switzerland,CHE,0,0,20,85,105
2001,Sri Lanka,LKA,Switzerland,CHE,90,1456,1394,183,3123
2001,Lithuania,LTU,Switzerland,CHE,0,0,0,58,58
2001,Latvia,LVA,Switzerland,CHE,0,0,5,11,16
2001,Mauritania,MRT,Switzerland,CHE,0,0,17,49,66
2001,North Macedonia,MKD,Switzerland,CHE,0,0,34,174,208
2001,Rep. of Moldova,MDA,Switzerland,CHE,0,0,5,46,51
2001,Mali,MLI,Switzerland,CHE,0,0,28,69,97
2001,Mongolia,MNG,Switzerland,CHE,0,0,50,204,254
2001,Morocco,MAR,Switzerland,CHE,11,0,0,16,27
2001,Myanmar,MMR,Switzerland,CHE,0,0,0,5,5
2001,Nepal,NPL,Switzerland,CHE,0,0,5,36,41
2001,Nigeria,NGA,Switzerland,CHE,5,0,88,162,255
2001,Pakistan,PAK,Switzerland,CHE,5,24,123,125,277
2001,Poland,POL,Switzerland,CHE,0,0,33,11,44
2001,Romania,ROU,Switzerland,CHE,0,0,0,27,27
2001,South Africa,ZAF,Switzerland,CHE,0,0,5,0,5
2001,Russian Federation,RUS,Switzerland,CHE,0,17,79,209,305
2001,Rwanda,RWA,Switzerland,CHE,5,0,25,5,35
2001,El Salvador,SLV,Switzerland,CHE,0,0,0,5,5
2001,Saudi Arabia,SAU,Switzerland,CHE,0,0,0,5,5
2001,Serbia and Kosovo: S/RES/1244 (1999),SRB,Switzerland,CHE,266,4793,3845,1463,10367
2001,Senegal,SEN,Switzerland,CHE,0,0,0,13,13
2001,Sierra Leone,SLE,Switzerland,CHE,0,5,96,240,341
2001,Somalia,SOM,Switzerland,CHE,22,341,342,80,785
2001,Viet Nam,VNM,Switzerland,CHE,61,0,12,5,78
2001,Sudan,SDN,Switzerland,CHE,12,0,54,5,71
2001,Slovakia,SVK,Switzerland,CHE,0,0,12,10,22
2001,Slovenia,SVN,Switzerland,CHE,0,0,0,5,5
2001,Syrian Arab Rep.,SYR,Switzerland,CHE,13,23,65,46,147
2001,United Rep. of Tanzania,TZA,Switzerland,CHE,0,0,5,0,5
2001,Tajikistan,TJK,Switzerland,CHE,0,0,0,5,5
2001,Togo,TGO,Switzerland,CHE,5,0,53,32,90
2001,Tunisia,TUN,Switzerland,CHE,109,0,15,59,183
2001,Turkey,TUR,Switzerland,CHE,496,166,820,358,1840
2001,Uganda,UGA,Switzerland,CHE,0,0,13,0,13
2001,Ukraine,UKR,Switzerland,CHE,0,0,46,84,130
2001,United States of America,USA,Switzerland,CHE,0,0,0,5,5
2001,Uzbekistan,UZB,Switzerland,CHE,5,0,5,0,10
2001,Yemen,YEM,Switzerland,CHE,5,0,37,10,52
2001,Kenya,KEN,United Rep. of Tanzania,TZA,25,0,108,0,133
2001,Afghanistan,AFG,Tajikistan,TJK,0,0,0,577,577
2001,Burundi,BDI,Uganda,UGA,5,0,0,24,29
2001,Chad,TCD,Uganda,UGA,0,0,5,0,5
2001,Dem. Rep. of the Congo,COD,Uganda,UGA,2136,0,5,141,2282
2001,Eritrea,ERI,Uganda,UGA,0,0,0,10,10
2001,Ethiopia,ETH,Uganda,UGA,5,0,0,54,59
2001,Kenya,KEN,Uganda,UGA,0,0,0,10,10
2001,Liberia,LBR,Uganda,UGA,0,0,5,0,5
2001,Rwanda,RWA,Uganda,UGA,312,0,0,5,317
2001,Somalia,SOM,Uganda,UGA,48,0,0,20,68
2001,Sudan,SDN,Uganda,UGA,734,0,0,46,780
2001,Afghanistan,AFG,Ukraine,UKR,223,0,101,0,324
2001,Armenia,ARM,Ukraine,UKR,37,0,5,0,42
2001,Azerbaijan,AZE,Ukraine,UKR,72,0,10,5,87
2001,Bangladesh,BGD,Ukraine,UKR,0,0,5,0,5
2001,Congo,COG,Ukraine,UKR,10,0,0,0,10
2001,Palestinian,PSE,Ukraine,UKR,0,0,5,0,5
2001,Georgia,GEO,Ukraine,UKR,0,0,0,13,13
2001,Iran (Islamic Rep. of),IRN,Ukraine,UKR,11,0,0,0,11
2001,Iraq,IRQ,Ukraine,UKR,23,0,15,0,38
2001,Jordan,JOR,Ukraine,UKR,5,0,0,0,5
2001,Dem. People's Rep. of Korea,PRK,Ukraine,UKR,0,0,5,0,5
2001,Lebanon,LBN,Ukraine,UKR,0,0,5,0,5
2001,Sri Lanka,LKA,Ukraine,UKR,0,0,10,0,10
2001,Pakistan,PAK,Ukraine,UKR,0,0,5,0,5
2001,Russian Federation,RUS,Ukraine,UKR,41,0,134,16,191
2001,Rwanda,RWA,Ukraine,UKR,5,0,0,0,5
2001,Sudan,SDN,Ukraine,UKR,0,0,5,0,5
2001,Syrian Arab Rep.,SYR,Ukraine,UKR,16,0,5,0,21
2001,Tajikistan,TJK,Ukraine,UKR,5,0,0,0,5
2001,Uzbekistan,UZB,Ukraine,UKR,0,0,10,0,10
2001,Angola,AGO,Zambia,ZMB,10,0,0,0,10
2001,Burundi,BDI,Zambia,ZMB,90,0,5,0,95
2001,Dem. Rep. of the Congo,COD,Zambia,ZMB,190,0,14,22,226
2001,Rwanda,RWA,Zambia,ZMB,205,0,0,20,225
2001,Somalia,SOM,Zambia,ZMB,10,0,0,0,10
2001,Angola,AGO,Zimbabwe,ZWE,151,0,5,0,156
2001,Burundi,BDI,Zimbabwe,ZWE,444,0,5,0,449
2001,Bangladesh,BGD,Zimbabwe,ZWE,5,0,0,0,5
2001,Bosnia and Herzegovina,BIH,Zimbabwe,ZWE,5,0,0,0,5
2001,Cameroon,CMR,Zimbabwe,ZWE,10,0,0,0,10
2001,Congo,COG,Zimbabwe,ZWE,5,0,0,0,5
2001,Dem. Rep. of the Congo,COD,Zimbabwe,ZWE,2276,0,0,0,2276
2001,Eritrea,ERI,Zimbabwe,ZWE,24,0,0,0,24
2001,Ethiopia,ETH,Zimbabwe,ZWE,95,0,0,0,95
2001,Ghana,GHA,Zimbabwe,ZWE,5,0,0,0,5
2001,Kenya,KEN,Zimbabwe,ZWE,5,0,0,0,5
2001,Liberia,LBR,Zimbabwe,ZWE,41,0,0,0,41
2001,Pakistan,PAK,Zimbabwe,ZWE,5,0,0,0,5
2001,Rwanda,RWA,Zimbabwe,ZWE,1364,0,0,0,1364
2001,Serbia and Kosovo: S/RES/1244 (1999),SRB,Zimbabwe,ZWE,5,0,0,0,5
2001,Sierra Leone,SLE,Zimbabwe,ZWE,21,0,0,0,21
2001,Somalia,SOM,Zimbabwe,ZWE,28,0,0,0,28
2001,Sudan,SDN,Zimbabwe,ZWE,61,0,5,0,66
2001,United Rep. of Tanzania,TZA,Zimbabwe,ZWE,10,0,0,0,10
2001,Togo,TGO,Zimbabwe,ZWE,5,0,0,0,5
2001,Uganda,UGA,Zimbabwe,ZWE,18,0,0,0,18
2001,Zambia,ZMB,Zimbabwe,ZWE,0,0,5,0,5
2002,Congo,COG,Angola,AGO,5,0,0,0,5
2002,Dem. Rep. of the Congo,COD,Angola,AGO,5,0,35,0,40
2002,Rwanda,RWA,Angola,AGO,5,0,0,0,5
2002,Sierra Leone,SLE,Angola,AGO,0,0,5,0,5
2002,United Rep. of Tanzania,TZA,Angola,AGO,5,0,0,0,5
2002,Armenia,ARM,Argentina,ARG,0,0,22,0,22
2002,Cuba,CUB,Argentina,ARG,16,0,10,0,26
2002,Haiti,HTI,Argentina,ARG,0,0,0,5,5
2002,Iraq,IRQ,Argentina,ARG,0,0,5,0,5
2002,Nigeria,NGA,Argentina,ARG,0,0,5,0,5
2002,Pakistan,PAK,Argentina,ARG,5,0,0,0,5
2002,Peru,PER,Argentina,ARG,26,0,129,0,155
2002,Romania,ROU,Argentina,ARG,0,0,25,0,25
2002,Senegal,SEN,Argentina,ARG,0,0,5,0,5
2002,Sierra Leone,SLE,Argentina,ARG,10,0,0,0,10
2002,Turkey,TUR,Argentina,ARG,0,0,0,5,5
2002,Ukraine,UKR,Argentina,ARG,0,0,5,0,5
2002,Iran (Islamic Rep. of),IRN,Armenia,ARM,5,0,0,0,5
2002,Iraq,IRQ,Armenia,ARM,5,0,0,0,5
2002,Afghanistan,AFG,Australia,AUS,189,0,111,0,300
2002,Albania,ALB,Australia,AUS,0,0,34,5,39
2002,Egypt,EGY,Australia,AUS,14,0,49,0,63
2002,Argentina,ARG,Australia,AUS,0,0,31,0,31
2002,Armenia,ARM,Australia,AUS,5,0,5,0,10
2002,Austria,AUT,Australia,AUS,0,0,5,0,5
2002,Bangladesh,BGD,Australia,AUS,0,0,218,10,228
2002,Belarus,BLR,Australia,AUS,0,0,11,0,11
2002,Botswana,BWA,Australia,AUS,0,0,5,0,5
2002,Brazil,BRA,Australia,AUS,0,0,39,5,44
2002,Bosnia and Herzegovina,BIH,Australia,AUS,0,0,5,0,5
2002,Bulgaria,BGR,Australia,AUS,0,0,13,0,13
2002,Cambodia,KHM,Australia,AUS,0,0,27,0,27
2002,Canada,CAN,Australia,AUS,0,0,5,0,5
2002,China,CHN,Australia,AUS,14,0,1211,31,1256
2002,Chile,CHL,Australia,AUS,0,0,20,0,20
2002,Congo,COG,Australia,AUS,5,0,5,0,10
2002,Colombia,COL,Australia,AUS,18,0,34,5,57
2002,Cyprus,CYP,Australia,AUS,0,0,5,5,10
2002,Ecuador,ECU,Australia,AUS,0,0,10,0,10
2002,Ethiopia,ETH,Australia,AUS,0,0,14,0,14
2002,Fiji,FJI,Australia,AUS,5,0,414,11,430
2002,France,FRA,Australia,AUS,0,0,5,5,10
2002,Palestinian,PSE,Australia,AUS,26,0,11,0,37
2002,United Kingdom of Great Britain and Northern Ireland,GBR,Australia,AUS,0,0,21,0,21
2002,Georgia,GEO,Australia,AUS,0,0,5,0,5
2002,Germany,DEU,Australia,AUS,0,0,0,5,5
2002,Ghana,GHA,Australia,AUS,0,0,26,0,26
2002,Greece,GRC,Australia,AUS,0,0,5,0,5
2002,"China, Hong Kong SAR",HKG,Australia,AUS,0,0,10,0,10
2002,Hungary,HUN,Australia,AUS,0,0,17,5,22
2002,India,IND,Australia,AUS,5,0,694,10,709
2002,Indonesia,IDN,Australia,AUS,0,0,1405,118,1523
2002,Iran (Islamic Rep. of),IRN,Australia,AUS,69,0,51,5,125
2002,Iraq,IRQ,Australia,AUS,721,0,59,5,785
2002,Israel,ISR,Australia,AUS,0,0,36,5,41
2002,Italy,ITA,Australia,AUS,0,0,10,0,10
2002,Jordan,JOR,Australia,AUS,0,0,18,0,18
2002,Kazakhstan,KAZ,Australia,AUS,0,0,5,0,5
2002,Kenya,KEN,Australia,AUS,0,0,21,0,21
2002,Kyrgyzstan,KGZ,Australia,AUS,0,0,5,0,5
2002,Rep. of Korea,KOR,Australia,AUS,0,0,394,5,399
2002,Lao People's Dem. Rep.,LAO,Australia,AUS,0,0,10,0,10
2002,Libya,LBY,Australia,AUS,0,0,5,0,5
2002,Lebanon,LBN,Australia,AUS,0,0,171,10,181
2002,Sri Lanka,LKA,Australia,AUS,60,0,310,10,380
2002,Lithuania,LTU,Australia,AUS,0,0,22,0,22
2002,Latvia,LVA,Australia,AUS,0,0,5,0,5
2002,North Macedonia,MKD,Australia,AUS,0,0,40,0,40
2002,Rep. of Moldova,MDA,Australia,AUS,0,0,11,0,11
2002,Malaysia,MYS,Australia,AUS,0,0,239,16,255
2002,Mongolia,MNG,Australia,AUS,0,0,83,0,83
2002,Myanmar,MMR,Australia,AUS,18,0,50,0,68
2002,Nepal,NPL,Australia,AUS,0,0,110,5,115
2002,Nigeria,NGA,Australia,AUS,5,0,15,5,25
2002,New Zealand,NZL,Australia,AUS,0,0,5,0,5
2002,Pakistan,PAK,Australia,AUS,0,0,118,5,123
2002,Peru,PER,Australia,AUS,0,0,48,0,48
2002,Philippines,PHL,Australia,AUS,0,0,88,0,88
2002,Papua New Guinea,PNG,Australia,AUS,0,0,13,0,13
2002,Poland,POL,Australia,AUS,0,0,28,0,28
2002,Portugal,PRT,Australia,AUS,0,0,17,0,17
2002,Romania,ROU,Australia,AUS,0,0,24,0,24
2002,South Africa,ZAF,Australia,AUS,0,0,22,0,22
2002,Russian Federation,RUS,Australia,AUS,10,0,74,5,89
2002,Rwanda,RWA,Australia,AUS,0,0,5,0,5
2002,Saudi Arabia,SAU,Australia,AUS,5,0,0,0,5
2002,Serbia and Kosovo: S/RES/1244 (1999),SRB,Australia,AUS,0,0,26,5,31
2002,Sierra Leone,SLE,Australia,AUS,0,0,5,0,5
2002,Solomon Islands,SLB,Australia,AUS,5,0,12,0,17
2002,Somalia,SOM,Australia,AUS,5,0,0,0,5
2002,Viet Nam,VNM,Australia,AUS,0,0,143,5,148
2002,Sudan,SDN,Australia,AUS,5,0,0,0,5
2002,Switzerland,CHE,Australia,AUS,0,0,0,5,5
2002,Syrian Arab Rep.,SYR,Australia,AUS,5,0,11,0,16
2002,Thailand,THA,Australia,AUS,0,0,314,10,324
2002,Timor-Leste,TLS,Australia,AUS,0,0,229,14,243
2002,Tonga,TON,Australia,AUS,0,0,84,11,95
2002,Turkey,TUR,Australia,AUS,21,0,99,5,125
2002,Tuvalu,TUV,Australia,AUS,0,0,5,0,5
2002,Uganda,UGA,Australia,AUS,0,0,5,0,5
2002,Ukraine,UKR,Australia,AUS,0,0,76,0,76
2002,Uruguay,URY,Australia,AUS,0,0,49,5,54
2002,United States of America,USA,Australia,AUS,0,0,13,0,13
2002,Venezuela (Bolivarian Republic of),VEN,Australia,AUS,0,0,0,5,5
2002,Zimbabwe,ZWE,Australia,AUS,5,0,18,5,28
2002,Stateless,XXA,Australia,AUS,5,0,19,5,29
2002,Afghanistan,AFG,Belgium,BEL,5,0,0,85,92
2002,Albania,ALB,Belgium,BEL,49,0,74,22,145
2002,Algeria,DZA,Belgium,BEL,33,0,530,88,651
2002,Angola,AGO,Belgium,BEL,5,0,27,12,44
2002,Armenia,ARM,Belgium,BEL,0,0,52,5,57
2002,Azerbaijan,AZE,Belgium,BEL,0,0,13,0,13
2002,Burundi,BDI,Belgium,BEL,46,0,61,14,133
2002,Bangladesh,BGD,Belgium,BEL,0,0,0,5,5
2002,Bhutan,BTN,Belgium,BEL,0,0,0,5,5
2002,Belarus,BLR,Belgium,BEL,11,0,52,10,73
2002,Bosnia and Herzegovina,BIH,Belgium,BEL,14,0,17,5,36
2002,Bulgaria,BGR,Belgium,BEL,0,0,22,5,27
2002,Chad,TCD,Belgium,BEL,0,0,5,0,5
2002,China,CHN,Belgium,BEL,0,0,11,0,11
2002,Cameroon,CMR,Belgium,BEL,5,0,57,5,67
2002,Congo,COG,Belgium,BEL,0,0,11,0,11
2002,Dem. Rep. of the Congo,COD,Belgium,BEL,105,0,323,122,553
2002,Colombia,COL,Belgium,BEL,0,0,13,5,18
2002,Czechia,CZE,Belgium,BEL,0,0,11,0,11
2002,Djibouti,DJI,Belgium,BEL,5,0,10,12,27
2002,Ethiopia,ETH,Belgium,BEL,11,0,0,5,16
2002,Palestinian,PSE,Belgium,BEL,0,0,12,12,24
2002,Georgia,GEO,Belgium,BEL,5,0,112,19,136
2002,Guinea,GIN,Belgium,BEL,0,0,307,33,340
2002,Cote d'Ivoire,CIV,Belgium,BEL,0,0,12,0,12
2002,India,IND,Belgium,BEL,0,0,5,12,17
2002,Iran (Islamic Rep. of),IRN,Belgium,BEL,16,0,212,46,275
2002,Iraq,IRQ,Belgium,BEL,77,0,68,26,171
2002,Israel,ISR,Belgium,BEL,0,0,0,5,5
2002,Kazakhstan,KAZ,Belgium,BEL,10,0,62,0,72
2002,Kyrgyzstan,KGZ,Belgium,BEL,5,0,13,0,18
2002,Liberia,LBR,Belgium,BEL,5,0,5,0,10
2002,Libya,LBY,Belgium,BEL,0,0,5,0,5
2002,Lebanon,LBN,Belgium,BEL,10,0,21,0,31
2002,Sri Lanka,LKA,Belgium,BEL,0,0,0,14,14
2002,Mauritania,MRT,Belgium,BEL,5,0,17,5,27
2002,North Macedonia,MKD,Belgium,BEL,13,0,32,13,58
2002,Rep. of Moldova,MDA,Belgium,BEL,0,0,11,0,11
2002,Nepal,NPL,Belgium,BEL,0,0,197,14,211
2002,Niger,NER,Belgium,BEL,0,0,34,0,34
2002,Nigeria,NGA,Belgium,BEL,0,0,5,0,5
2002,Pakistan,PAK,Belgium,BEL,5,0,19,11,35
2002,Peru,PER,Belgium,BEL,0,0,0,5,5
2002,Romania,ROU,Belgium,BEL,0,0,25,10,37
2002,Russian Federation,RUS,Belgium,BEL,12,0,124,62,199
2002,Rwanda,RWA,Belgium,BEL,269,0,147,47,463
2002,Serbia and Kosovo: S/RES/1244 (1999),SRB,Belgium,BEL,341,0,261,120,722
2002,Sierra Leone,SLE,Belgium,BEL,5,0,32,12,48
2002,Somalia,SOM,Belgium,BEL,34,0,10,5,49
2002,Sudan,SDN,Belgium,BEL,0,0,5,0,5
2002,Slovakia,SVK,Belgium,BEL,0,0,12,0,12
2002,Syrian Arab Rep.,SYR,Belgium,BEL,5,0,27,0,32
2002,Tajikistan,TJK,Belgium,BEL,5,0,0,0,5
2002,Togo,TGO,Belgium,BEL,0,0,22,10,32
2002,Turkey,TUR,Belgium,BEL,36,0,269,87,392
2002,Ukraine,UKR,Belgium,BEL,0,0,23,10,33
2002,Uzbekistan,UZB,Belgium,BEL,12,0,23,0,35
2002,Burundi,BDI,Benin,BEN,5,0,0,0,5
2002,Central African Rep.,CAF,Benin,BEN,19,0,16,5,40
2002,Chad,TCD,Benin,BEN,21,0,22,10,53
2002,Cameroon,CMR,Benin,BEN,5,0,0,0,5
2002,Congo,COG,Benin,BEN,24,0,17,5,46
2002,Dem. Rep. of the Congo,COD,Benin,BEN,68,0,60,18,146
2002,Ethiopia,ETH,Benin,BEN,5,0,0,0,5
2002,Cote d'Ivoire,CIV,Benin,BEN,18,0,0,0,18
2002,Iraq,IRQ,Benin,BEN,5,0,0,0,5
2002,Liberia,LBR,Benin,BEN,5,0,0,0,5
2002,Nigeria,NGA,Benin,BEN,15,0,50,62,127
2002,Rwanda,RWA,Benin,BEN,26,0,10,10,46
2002,Sudan,SDN,Benin,BEN,15,0,5,0,20
2002,Togo,TGO,Benin,BEN,30,0,62,15,107
2002,Afghanistan,AFG,Belarus,BLR,40,0,41,29,110
2002,Armenia,ARM,Belarus,BLR,0,0,0,5,5
2002,Azerbaijan,AZE,Belarus,BLR,0,0,0,13,13
2002,Georgia,GEO,Belarus,BLR,14,0,0,0,14
2002,Iraq,IRQ,Belarus,BLR,0,0,5,5,10
2002,Sri Lanka,LKA,Belarus,BLR,0,0,0,5,5
2002,Nigeria,NGA,Belarus,BLR,0,0,0,5,5
2002,Tajikistan,TJK,Belarus,BLR,0,0,0,5,5
2002,Uzbekistan,UZB,Belarus,BLR,0,0,0,5,5
2002,Colombia,COL,Bolivia (Plurinational State of),BOL,0,0,0,5,5
2002,Iraq,IRQ,Bolivia (Plurinational State of),BOL,5,0,0,0,5
2002,Peru,PER,Bolivia (Plurinational State of),BOL,0,0,0,5,5
2002,Burundi,BDI,Botswana,BWA,15,0,5,0,20
2002,Dem. Rep. of the Congo,COD,Botswana,BWA,28,0,5,0,33
2002,Ethiopia,ETH,Botswana,BWA,0,0,5,0,5
2002,Kenya,KEN,Botswana,BWA,5,0,0,0,5
2002,Rwanda,RWA,Botswana,BWA,12,0,0,0,12
2002,Somalia,SOM,Botswana,BWA,68,0,28,0,96
2002,Sudan,SDN,Botswana,BWA,13,0,0,0,13
2002,United Rep. of Tanzania,TZA,Botswana,BWA,0,0,0,14,14
2002,Uganda,UGA,Botswana,BWA,0,0,10,0,10
2002,Zimbabwe,ZWE,Botswana,BWA,18,0,5,0,23
2002,Afghanistan,AFG,Brazil,BRA,21,0,5,0,26
2002,Angola,AGO,Brazil,BRA,116,0,90,0,206
2002,Congo,COG,Brazil,BRA,0,0,0,5,5
2002,Dem. Rep. of the Congo,COD,Brazil,BRA,10,0,11,0,21
2002,Colombia,COL,Brazil,BRA,37,0,15,0,52
2002,Cuba,CUB,Brazil,BRA,5,0,12,0,17
2002,Georgia,GEO,Brazil,BRA,10,0,0,0,10
2002,Guinea-Bissau,GNB,Brazil,BRA,0,0,13,0,13
2002,Guinea,GIN,Brazil,BRA,0,0,5,0,5
2002,Iran (Islamic Rep. of),IRN,Brazil,BRA,10,0,0,0,10
2002,Iraq,IRQ,Brazil,BRA,5,0,5,0,10
2002,Liberia,LBR,Brazil,BRA,5,0,0,0,5
2002,Mexico,MEX,Brazil,BRA,0,0,5,0,5
2002,Nigeria,NGA,Brazil,BRA,0,0,14,5,19
2002,Pakistan,PAK,Brazil,BRA,0,0,0,13,13
2002,Peru,PER,Brazil,BRA,0,0,5,5,10
2002,Romania,ROU,Brazil,BRA,0,0,462,0,462
2002,Sierra Leone,SLE,Brazil,BRA,5,0,40,17,62
2002,United Rep. of Tanzania,TZA,Brazil,BRA,0,0,0,5,5
2002,Afghanistan,AFG,Bulgaria,BGR,18,195,46,871,1130
2002,Albania,ALB,Bulgaria,BGR,5,0,0,0,5
2002,Algeria,DZA,Bulgaria,BGR,0,0,5,5,10
2002,Armenia,ARM,Bulgaria,BGR,0,0,425,10,435
2002,Bangladesh,BGD,Bulgaria,BGR,0,5,5,13,23
2002,Dem. Rep. of the Congo,COD,Bulgaria,BGR,0,5,0,15,20
2002,Ethiopia,ETH,Bulgaria,BGR,0,0,13,10,23
2002,Georgia,GEO,Bulgaria,BGR,0,0,10,5,15
2002,Ghana,GHA,Bulgaria,BGR,0,0,5,5,10
2002,Iran (Islamic Rep. of),IRN,Bulgaria,BGR,0,24,76,75,175
2002,Iraq,IRQ,Bulgaria,BGR,39,293,30,583,945
2002,Lebanon,LBN,Bulgaria,BGR,0,0,5,0,5
2002,Rep. of Moldova,MDA,Bulgaria,BGR,0,0,5,0,5
2002,Nigeria,NGA,Bulgaria,BGR,0,0,58,102,160
2002,Pakistan,PAK,Bulgaria,BGR,0,0,0,11,11
2002,Russian Federation,RUS,Bulgaria,BGR,0,0,13,0,13
2002,Sierra Leone,SLE,Bulgaria,BGR,0,0,10,5,15
2002,Somalia,SOM,Bulgaria,BGR,0,16,0,14,30
2002,Sudan,SDN,Bulgaria,BGR,10,83,5,55,153
2002,Syrian Arab Rep.,SYR,Bulgaria,BGR,5,0,0,0,5
2002,United Rep. of Tanzania,TZA,Bulgaria,BGR,0,0,5,0,5
2002,Turkey,TUR,Bulgaria,BGR,0,20,16,26,62
2002,Ukraine,UKR,Bulgaria,BGR,0,0,5,0,5
2002,Uzbekistan,UZB,Bulgaria,BGR,0,0,5,0,5
2002,Stateless,XXA,Bulgaria,BGR,0,0,12,10,22
2002,Afghanistan,AFG,Canada,CAN,217,0,45,36,298
2002,Albania,ALB,Canada,CAN,174,0,186,71,431
2002,Algeria,DZA,Canada,CAN,108,0,231,48,387
2002,Angola,AGO,Canada,CAN,166,0,137,21,324
2002,Antigua and Barbuda,ATG,Canada,CAN,5,0,0,0,5
2002,Egypt,EGY,Canada,CAN,53,0,42,14,109
2002,Argentina,ARG,Canada,CAN,31,0,794,186,1011
2002,Armenia,ARM,Canada,CAN,16,0,25,10,51
2002,Austria,AUT,Canada,CAN,0,0,5,0,5
2002,Azerbaijan,AZE,Canada,CAN,93,0,52,5,150
2002,Barbados,BRB,Canada,CAN,5,0,0,5,10
2002,Burundi,BDI,Canada,CAN,252,0,35,11,298
2002,Benin,BEN,Canada,CAN,5,0,0,0,5
2002,Bangladesh,BGD,Canada,CAN,145,0,123,29,297
2002,Burkina Faso,BFA,Canada,CAN,12,0,0,0,12
2002,Belarus,BLR,Canada,CAN,44,0,16,14,74
2002,Bolivia (Plurinational State of),BOL,Canada,CAN,15,0,13,5,33
2002,Brazil,BRA,Canada,CAN,5,0,39,41,85
2002,Bosnia and Herzegovina,BIH,Canada,CAN,5,0,12,5,22
2002,Bulgaria,BGR,Canada,CAN,112,0,32,25,169
2002,Cambodia,KHM,Canada,CAN,5,0,11,0,16
2002,Central African Rep.,CAF,Canada,CAN,5,0,0,0,5
2002,Chad,TCD,Canada,CAN,51,0,26,10,87
2002,China,CHN,Canada,CAN,1196,0,487,465,2148
2002,Chile,CHL,Canada,CAN,12,0,30,10,52
2002,Cameroon,CMR,Canada,CAN,75,0,41,5,121
2002,Congo,COG,Canada,CAN,56,0,38,5,99
2002,Dem. Rep. of the Congo,COD,Canada,CAN,489,0,237,60,786
2002,Colombia,COL,Canada,CAN,1084,0,199,124,1407
2002,Costa Rica,CRI,Canada,CAN,26,0,225,349,600
2002,Cuba,CUB,Canada,CAN,129,0,22,31,182
2002,Czechia,CZE,Canada,CAN,10,0,13,5,28
2002,Djibouti,DJI,Canada,CAN,32,0,36,5,73
2002,Dominica,DMA,Canada,CAN,12,0,0,5,17
2002,Dominican Rep.,DOM,Canada,CAN,5,0,18,75,98
2002,Ecuador,ECU,Canada,CAN,10,0,10,12,32
2002,Eritrea,ERI,Canada,CAN,71,0,5,10,86
2002,Estonia,EST,Canada,CAN,5,0,10,0,15
2002,Ethiopia,ETH,Canada,CAN,84,0,34,10,128
2002,Fiji,FJI,Canada,CAN,121,0,51,5,177
2002,France,FRA,Canada,CAN,0,0,5,5,10
2002,Gabon,GAB,Canada,CAN,5,0,11,0,16
2002,Gambia,GMB,Canada,CAN,0,0,5,0,5
2002,Palestinian,PSE,Canada,CAN,30,0,11,26,67
2002,United Kingdom of Great Britain and Northern Ireland,GBR,Canada,CAN,0,0,0,5,5
2002,Georgia,GEO,Canada,CAN,33,0,31,14,78
2002,Germany,DEU,Canada,CAN,0,0,0,10,10
2002,Ghana,GHA,Canada,CAN,25,0,75,43,143
2002,Greece,GRC,Canada,CAN,0,0,13,5,18
2002,Grenada,GRD,Canada,CAN,18,0,32,39,89
2002,Guatemala,GTM,Canada,CAN,24,0,84,39,147
2002,Guinea,GIN,Canada,CAN,171,0,108,27,306
2002,Guyana,GUY,Canada,CAN,24,0,57,52,133
2002,Haiti,HTI,Canada,CAN,69,0,136,14,219
2002,"China, Hong Kong SAR",HKG,Canada,CAN,0,0,5,0,5
2002,Honduras,HND,Canada,CAN,12,0,93,70,175
2002,Croatia,HRV,Canada,CAN,5,0,5,0,10
2002,Hungary,HUN,Canada,CAN,248,0,820,1163,2231
2002,Cote d'Ivoire,CIV,Canada,CAN,26,0,23,5,54
2002,India,IND,Canada,CAN,304,0,506,381,1191
2002,Indonesia,IDN,Canada,CAN,17,0,17,5,39
2002,Iran (Islamic Rep. of),IRN,Canada,CAN,374,0,195,75,644
2002,Iraq,IRQ,Canada,CAN,137,0,79,49,265
2002,Israel,ISR,Canada,CAN,55,0,211,103,369
2002,Italy,ITA,Canada,CAN,0,0,0,12,12
2002,Jamaica,JAM,Canada,CAN,10,0,41,43,94
2002,Jordan,JOR,Canada,CAN,14,0,30,13,57
2002,Kazakhstan,KAZ,Canada,CAN,23,0,42,18,83
2002,Kenya,KEN,Canada,CAN,96,0,42,12,150
2002,Kyrgyzstan,KGZ,Canada,CAN,24,0,16,0,40
2002,Rep. of Korea,KOR,Canada,CAN,19,0,111,73,203
2002,Kuwait,KWT,Canada,CAN,36,0,5,0,41
2002,Liberia,LBR,Canada,CAN,5,0,12,0,17
2002,Libya,LBY,Canada,CAN,36,0,40,5,81
2002,Saint Lucia,LCA,Canada,CAN,10,0,18,16,44
2002,Lebanon,LBN,Canada,CAN,95,0,182,69,346
2002,Lesotho,LSO,Canada,CAN,0,0,0,5,5
2002,Sri Lanka,LKA,Canada,CAN,1905,0,457,104,2466
2002,Lithuania,LTU,Canada,CAN,17,0,18,19,54
2002,Latvia,LVA,Canada,CAN,17,0,17,5,39
2002,Mauritania,MRT,Canada,CAN,26,0,12,5,43
2002,North Macedonia,MKD,Canada,CAN,10,0,10,5,25
2002,Rep. of Moldova,MDA,Canada,CAN,20,0,13,5,38
2002,Mexico,MEX,Canada,CAN,290,0,491,426,1207
2002,Mali,MLI,Canada,CAN,20,0,26,5,51
2002,Malaysia,MYS,Canada,CAN,36,0,72,28,136
2002,Malawi,MWI,Canada,CAN,5,0,0,5,10
2002,Mongolia,MNG,Canada,CAN,5,0,12,0,17
2002,Morocco,MAR,Canada,CAN,10,0,17,12,39
2002,Malta,MLT,Canada,CAN,0,0,0,5,5
2002,Mauritius,MUS,Canada,CAN,0,0,5,0,5
2002,Myanmar,MMR,Canada,CAN,12,0,0,5,17
2002,Namibia,NAM,Canada,CAN,0,0,5,0,5
2002,Nepal,NPL,Canada,CAN,49,0,18,5,72
2002,Netherlands,NLD,Canada,CAN,0,0,0,5,5
2002,Niger,NER,Canada,CAN,0,0,5,0,5
2002,Nicaragua,NIC,Canada,CAN,0,0,12,5,17
2002,Nigeria,NGA,Canada,CAN,172,0,228,96,496
2002,Pakistan,PAK,Canada,CAN,1238,0,788,252,2278
2002,Panama,PAN,Canada,CAN,5,0,10,0,15
2002,Paraguay,PRY,Canada,CAN,5,0,0,0,5
2002,Peru,PER,Canada,CAN,148,0,249,72,469
2002,Philippines,PHL,Canada,CAN,12,0,116,24,152
2002,Poland,POL,Canada,CAN,75,0,88,61,224
2002,Portugal,PRT,Canada,CAN,0,0,28,32,60
2002,Romania,ROU,Canada,CAN,93,0,131,59,283
2002,South Africa,ZAF,Canada,CAN,5,0,17,10,32
2002,Russian Federation,RUS,Canada,CAN,219,0,118,67,404
2002,Rwanda,RWA,Canada,CAN,101,0,38,5,144
2002,El Salvador,SLV,Canada,CAN,82,0,166,57,305
2002,Saudi Arabia,SAU,Canada,CAN,13,0,12,10,35
2002,Serbia and Kosovo: S/RES/1244 (1999),SRB,Canada,CAN,33,0,50,14,97
2002,Senegal,SEN,Canada,CAN,11,0,11,0,22
2002,Singapore,SGP,Canada,CAN,0,0,5,0,5
2002,Sierra Leone,SLE,Canada,CAN,35,0,22,14,71
2002,Somalia,SOM,Canada,CAN,549,0,29,79,657
2002,Spain,ESP,Canada,CAN,0,0,5,0,5
2002,Viet Nam,VNM,Canada,CAN,18,0,28,29,75
2002,Sudan,SDN,Canada,CAN,244,0,57,29,330
2002,Slovakia,SVK,Canada,CAN,5,0,15,5,25
2002,Slovenia,SVN,Canada,CAN,0,0,5,0,5
2002,Eswatini,SWZ,Canada,CAN,5,0,0,0,5
2002,Sweden,SWE,Canada,CAN,0,0,0,5,5
2002,Syrian Arab Rep.,SYR,Canada,CAN,51,0,35,19,105
2002,United Rep. of Tanzania,TZA,Canada,CAN,102,0,33,12,147
2002,Thailand,THA,Canada,CAN,0,0,0,5,5
2002,Tajikistan,TJK,Canada,CAN,0,0,5,0,5
2002,Togo,TGO,Canada,CAN,24,0,10,5,39
2002,Trinidad and Tobago,TTO,Canada,CAN,10,0,21,23,54
2002,Tunisia,TUN,Canada,CAN,18,0,74,18,110
2002,Turkey,TUR,Canada,CAN,572,0,334,132,1038
2002,United Arab Emirates,ARE,Canada,CAN,0,0,0,12,12
2002,Uganda,UGA,Canada,CAN,35,0,5,5,45
2002,Ukraine,UKR,Canada,CAN,168,0,129,64,361
2002,Uruguay,URY,Canada,CAN,25,0,85,47,157
2002,United States of America,USA,Canada,CAN,0,0,29,55,84
2002,Uzbekistan,UZB,Canada,CAN,16,0,12,10,38
2002,Saint Vincent and the Grenadines,VCT,Canada,CAN,41,0,49,34,124
2002,Venezuela (Bolivarian Republic of),VEN,Canada,CAN,44,0,68,20,132
2002,Yemen,YEM,Canada,CAN,16,0,24,11,51
2002,Zambia,ZMB,Canada,CAN,0,0,5,0,5
2002,Zimbabwe,ZWE,Canada,CAN,1705,0,359,83,2147
2002,Dem. Rep. of the Congo,COD,Central African Rep.,CAF,49,0,0,5,54
2002,Central African Rep.,CAF,Chad,TCD,5,0,5,0,10
2002,Cameroon,CMR,Chad,TCD,5,0,0,0,5
2002,Dem. Rep. of the Congo,COD,Chad,TCD,22,0,25,0,47
2002,Rwanda,RWA,Chad,TCD,5,0,0,0,5
2002,Sudan,SDN,Chad,TCD,5,0,18,0,23
2002,Bangladesh,BGD,Chile,CHL,0,0,0,5,5
2002,Dem. Rep. of the Congo,COD,Chile,CHL,5,0,0,0,5
2002,Colombia,COL,Chile,CHL,30,0,0,10,40
2002,Iran (Islamic Rep. of),IRN,Chile,CHL,5,0,0,0,5
2002,Romania,ROU,Chile,CHL,0,0,10,17,27
2002,Rwanda,RWA,Chile,CHL,5,0,0,0,5
2002,Colombia,COL,Costa Rica,CRI,2299,2179,1876,436,6790
2002,Cuba,CUB,Costa Rica,CRI,39,46,36,0,121
2002,Peru,PER,Costa Rica,CRI,5,0,19,5,29
2002,Afghanistan,AFG,Cyprus,CYP,0,0,5,0,5
2002,Bosnia and Herzegovina,BIH,Cyprus,CYP,0,0,5,0,5
2002,Palestinian,PSE,Cyprus,CYP,0,0,12,0,12
2002,Georgia,GEO,Cyprus,CYP,0,0,16,0,16
2002,India,IND,Cyprus,CYP,0,0,5,0,5
2002,Iran (Islamic Rep. of),IRN,Cyprus,CYP,0,0,33,0,33
2002,Iraq,IRQ,Cyprus,CYP,0,0,5,0,5
2002,Lebanon,LBN,Cyprus,CYP,0,0,5,0,5
2002,Rep. of Moldova,MDA,Cyprus,CYP,0,0,5,0,5
2002,Pakistan,PAK,Cyprus,CYP,0,0,27,0,27
2002,Russian Federation,RUS,Cyprus,CYP,0,0,10,0,10
2002,Serbia and Kosovo: S/RES/1244 (1999),SRB,Cyprus,CYP,0,0,5,0,5
2002,Turkey,TUR,Cyprus,CYP,0,0,5,0,5
2002,Ukraine,UKR,Cyprus,CYP,0,0,5,0,5
2002,Afghanistan,AFG,Denmark,DNK,632,136,948,0,1716
2002,Albania,ALB,Denmark,DNK,0,0,49,0,49
2002,Algeria,DZA,Denmark,DNK,0,0,20,0,20
2002,Angola,AGO,Denmark,DNK,0,5,0,0,5
2002,Egypt,EGY,Denmark,DNK,0,0,5,0,5
2002,Armenia,ARM,Denmark,DNK,0,0,28,0,28
2002,Azerbaijan,AZE,Denmark,DNK,0,0,49,0,49
2002,Burundi,BDI,Denmark,DNK,10,46,0,0,56
2002,Bangladesh,BGD,Denmark,DNK,0,0,12,0,12
2002,Belarus,BLR,Denmark,DNK,0,0,10,0,10
2002,Bosnia and Herzegovina,BIH,Denmark,DNK,5,5,683,0,693
2002,Bulgaria,BGR,Denmark,DNK,0,0,5,0,5
2002,Cambodia,KHM,Denmark,DNK,5,0,0,0,5
2002,Chad,TCD,Denmark,DNK,0,0,5,0,5
2002,China,CHN,Denmark,DNK,10,0,48,0,58
2002,Cameroon,CMR,Denmark,DNK,0,0,17,0,17
2002,Congo,COG,Denmark,DNK,5,0,0,0,5
2002,Dem. Rep. of the Congo,COD,Denmark,DNK,18,10,35,0,63
2002,Colombia,COL,Denmark,DNK,0,0,5,0,5
2002,Czechia,CZE,Denmark,DNK,0,0,26,0,26
2002,Eritrea,ERI,Denmark,DNK,0,0,11,0,11
2002,Ethiopia,ETH,Denmark,DNK,5,5,40,0,50
2002,Gambia,GMB,Denmark,DNK,0,0,21,0,21
2002,Palestinian,PSE,Denmark,DNK,31,5,191,0,227
2002,Georgia,GEO,Denmark,DNK,0,5,20,0,25
2002,Guinea,GIN,Denmark,DNK,0,5,0,0,5
2002,Croatia,HRV,Denmark,DNK,0,0,43,0,43
2002,India,IND,Denmark,DNK,5,5,59,0,69
2002,Iran (Islamic Rep. of),IRN,Denmark,DNK,15,17,324,0,356
2002,Iraq,IRQ,Denmark,DNK,45,547,1707,0,2299
2002,Israel,ISR,Denmark,DNK,0,0,5,0,5
2002,Jordan,JOR,Denmark,DNK,0,0,13,0,13
2002,Kazakhstan,KAZ,Denmark,DNK,0,0,12,0,12
2002,Kenya,KEN,Denmark,DNK,0,0,10,0,10
2002,Dem. People's Rep. of Korea,PRK,Denmark,DNK,5,0,0,0,5
2002,Liberia,LBR,Denmark,DNK,0,0,5,0,5
2002,Libya,LBY,Denmark,DNK,0,0,21,0,21
2002,Lebanon,LBN,Denmark,DNK,5,0,55,0,60
2002,Sri Lanka,LKA,Denmark,DNK,5,24,31,0,60
2002,Lithuania,LTU,Denmark,DNK,0,0,5,0,5
2002,North Macedonia,MKD,Denmark,DNK,0,0,172,0,172
2002,Rep. of Moldova,MDA,Denmark,DNK,0,0,10,0,10
2002,Mongolia,MNG,Denmark,DNK,0,0,54,0,54
2002,Morocco,MAR,Denmark,DNK,0,0,5,0,5
2002,Myanmar,MMR,Denmark,DNK,11,0,0,0,11
2002,Niger,NER,Denmark,DNK,0,0,5,0,5
2002,Nigeria,NGA,Denmark,DNK,0,0,25,0,25
2002,Pakistan,PAK,Denmark,DNK,0,0,74,0,74
2002,Poland,POL,Denmark,DNK,0,0,15,0,15
2002,Romania,ROU,Denmark,DNK,0,0,10,0,10
2002,Russian Federation,RUS,Denmark,DNK,10,67,60,0,137
2002,Rwanda,RWA,Denmark,DNK,20,14,31,0,65
2002,Serbia and Kosovo: S/RES/1244 (1999),SRB,Denmark,DNK,19,45,1094,0,1158
2002,Senegal,SEN,Denmark,DNK,0,0,5,0,5
2002,Seychelles,SYC,Denmark,DNK,0,0,5,0,5
2002,Sierra Leone,SLE,Denmark,DNK,0,0,17,0,17
2002,Somalia,SOM,Denmark,DNK,210,408,56,0,674
2002,Viet Nam,VNM,Denmark,DNK,12,0,30,0,42
2002,Sudan,SDN,Denmark,DNK,21,16,5,0,42
2002,Slovakia,SVK,Denmark,DNK,0,0,20,0,20
2002,Syrian Arab Rep.,SYR,Denmark,DNK,12,14,59,0,85
2002,Tunisia,TUN,Denmark,DNK,5,0,5,0,10
2002,Turkey,TUR,Denmark,DNK,0,5,88,0,93
2002,Uganda,UGA,Denmark,DNK,0,0,5,0,5
2002,Ukraine,UKR,Denmark,DNK,0,0,29,0,29
2002,Uzbekistan,UZB,Denmark,DNK,5,0,10,0,15
2002,Yemen,YEM,Denmark,DNK,0,5,5,0,10
2002,Stateless,XXA,Denmark,DNK,18,0,18,0,36
2002,Colombia,COL,Ecuador,ECU,1568,0,1196,1568,4332
2002,Iraq,IRQ,Ecuador,ECU,5,0,0,0,5
2002,Pakistan,PAK,Ecuador,ECU,0,0,0,5,5
2002,Peru,PER,Ecuador,ECU,5,0,0,0,5
2002,Turkey,TUR,Ecuador,ECU,0,0,0,10,10
2002,Armenia,ARM,Estonia,EST,0,0,5,0,5
2002,Pakistan,PAK,Estonia,EST,0,0,5,0,5
2002,Syrian Arab Rep.,SYR,Estonia,EST,0,0,5,0,5
2002,Uzbekistan,UZB,Estonia,EST,0,0,5,0,5
2002,Eritrea,ERI,Ethiopia,ETH,1066,0,0,0,1066
2002,Sudan,SDN,Ethiopia,ETH,6134,0,0,0,6134
2002,Afghanistan,AFG,Finland,FIN,0,21,5,11,37
2002,Albania,ALB,Finland,FIN,0,0,0,5,5
2002,Algeria,DZA,Finland,FIN,0,0,23,5,28
2002,Angola,AGO,Finland,FIN,0,24,5,0,29
2002,Egypt,EGY,Finland,FIN,0,0,0,5,5
2002,Armenia,ARM,Finland,FIN,0,0,0,5,5
2002,Azerbaijan,AZE,Finland,FIN,0,0,5,0,5
2002,Bangladesh,BGD,Finland,FIN,0,10,34,18,62
2002,Belarus,BLR,Finland,FIN,0,14,14,17,45
2002,Bolivia (Plurinational State of),BOL,Finland,FIN,0,12,5,0,17
2002,Bosnia and Herzegovina,BIH,Finland,FIN,0,16,102,22,140
2002,Bulgaria,BGR,Finland,FIN,0,0,65,99,164
2002,China,CHN,Finland,FIN,0,0,13,0,13
2002,Cameroon,CMR,Finland,FIN,0,5,10,14,29
2002,Congo,COG,Finland,FIN,0,0,10,0,10
2002,Dem. Rep. of the Congo,COD,Finland,FIN,0,12,26,5,43
2002,Colombia,COL,Finland,FIN,0,10,0,0,10
2002,Cuba,CUB,Finland,FIN,0,0,14,0,14
2002,Czechia,CZE,Finland,FIN,0,0,33,10,43
2002,Ethiopia,ETH,Finland,FIN,0,10,0,0,10
2002,Georgia,GEO,Finland,FIN,0,0,0,11,11
2002,Ghana,GHA,Finland,FIN,0,12,0,0,12
2002,India,IND,Finland,FIN,0,0,5,13,18
2002,Iran (Islamic Rep. of),IRN,Finland,FIN,5,20,39,10,74
2002,Iraq,IRQ,Finland,FIN,0,88,15,16,119
2002,Israel,ISR,Finland,FIN,0,0,5,5,10
2002,Jordan,JOR,Finland,FIN,0,0,5,5,10
2002,Kazakhstan,KAZ,Finland,FIN,0,10,0,14,24
2002,Lebanon,LBN,Finland,FIN,0,0,5,0,5
2002,Sri Lanka,LKA,Finland,FIN,0,11,16,0,27
2002,Lithuania,LTU,Finland,FIN,0,0,5,14,19
2002,Latvia,LVA,Finland,FIN,0,0,5,5,10
2002,North Macedonia,MKD,Finland,FIN,0,0,5,13,18
2002,Rep. of Moldova,MDA,Finland,FIN,0,0,11,0,11
2002,Mongolia,MNG,Finland,FIN,0,0,5,5,10
2002,Morocco,MAR,Finland,FIN,0,0,14,0,14
2002,Nepal,NPL,Finland,FIN,0,0,5,0,5
2002,Nigeria,NGA,Finland,FIN,0,0,0,5,5
2002,New Zealand,NZL,Finland,FIN,0,0,0,5,5
2002,Pakistan,PAK,Finland,FIN,0,5,5,5,15
2002,Peru,PER,Finland,FIN,0,0,5,0,5
2002,Poland,POL,Finland,FIN,0,0,5,25,30
2002,Romania,ROU,Finland,FIN,0,0,10,582,592
2002,Russian Federation,RUS,Finland,FIN,0,98,24,439,561
2002,Rwanda,RWA,Finland,FIN,0,12,0,0,12
2002,Serbia and Kosovo: S/RES/1244 (1999),SRB,Finland,FIN,0,43,63,56,162
2002,Sierra Leone,SLE,Finland,FIN,0,0,13,0,13
2002,Somalia,SOM,Finland,FIN,0,60,5,5,70
2002,Viet Nam,VNM,Finland,FIN,0,0,5,0,5
2002,Slovakia,SVK,Finland,FIN,0,0,279,65,344
2002,Syrian Arab Rep.,SYR,Finland,FIN,0,5,12,0,17
2002,Turkmenistan,TKM,Finland,FIN,0,5,0,0,5
2002,Togo,TGO,Finland,FIN,0,0,0,5,5
2002,Tunisia,TUN,Finland,FIN,0,0,5,0,5
2002,Turkey,TUR,Finland,FIN,0,57,108,40,205
2002,Ukraine,UKR,Finland,FIN,0,5,47,36,88
2002,Uzbekistan,UZB,Finland,FIN,0,0,5,32,37
2002,Stateless,XXA,Finland,FIN,0,5,0,15,20
2002,Afghanistan,AFG,France,FRA,89,0,175,0,264
2002,Albania,ALB,France,FRA,40,0,506,0,546
2002,Algeria,DZA,France,FRA,68,0,2568,0,2636
2002,Angola,AGO,France,FRA,184,0,819,0,1003
2002,Egypt,EGY,France,FRA,5,0,12,0,17
2002,Armenia,ARM,France,FRA,36,0,530,0,566
2002,Azerbaijan,AZE,France,FRA,32,0,225,0,257
2002,Burundi,BDI,France,FRA,27,0,44,0,71
2002,Bangladesh,BGD,France,FRA,32,0,613,0,645
2002,Burkina Faso,BFA,France,FRA,0,0,52,0,52
2002,Belarus,BLR,France,FRA,13,0,190,0,203
2002,Bosnia and Herzegovina,BIH,France,FRA,342,0,251,0,593
2002,Cambodia,KHM,France,FRA,69,0,114,0,183
2002,Central African Rep.,CAF,France,FRA,85,0,253,0,338
2002,Chad,TCD,France,FRA,75,0,102,0,177
2002,China,CHN,France,FRA,17,0,2558,0,2575
2002,Cameroon,CMR,France,FRA,46,0,497,0,543
2002,Congo,COG,France,FRA,433,0,2208,0,2641
2002,Dem. Rep. of the Congo,COD,France,FRA,1058,0,4603,0,5661
2002,Comoros,COM,France,FRA,5,0,73,0,78
2002,Colombia,COL,France,FRA,29,0,160,0,189
2002,Cuba,CUB,France,FRA,10,0,16,0,26
2002,Czechia,CZE,France,FRA,0,0,5,0,5
2002,Ecuador,ECU,France,FRA,5,0,65,0,70
2002,Estonia,EST,France,FRA,0,0,5,0,5
2002,Ethiopia,ETH,France,FRA,21,0,5,0,26
2002,Gabon,GAB,France,FRA,0,0,24,0,24
2002,Georgia,GEO,France,FRA,59,0,1053,0,1112
2002,Ghana,GHA,France,FRA,17,0,76,0,93
2002,Guinea-Bissau,GNB,France,FRA,40,0,152,0,192
2002,Guinea,GIN,France,FRA,58,0,879,0,937
2002,Guyana,GUY,France,FRA,0,0,23,0,23
2002,Haiti,HTI,France,FRA,180,0,2089,0,2269
2002,Croatia,HRV,France,FRA,12,0,15,0,27
2002,Cote d'Ivoire,CIV,France,FRA,70,0,534,0,604
2002,India,IND,France,FRA,10,0,362,0,372
2002,Iran (Islamic Rep. of),IRN,France,FRA,32,0,214,0,246
2002,Iraq,IRQ,France,FRA,67,0,142,0,209
2002,Israel,ISR,France,FRA,0,0,10,0,10
2002,Kazakhstan,KAZ,France,FRA,21,0,94,0,115
2002,Kyrgyzstan,KGZ,France,FRA,0,0,28,0,28
2002,Lao People's Dem. Rep.,LAO,France,FRA,22,0,5,0,27
2002,Lebanon,LBN,France,FRA,5,0,31,0,36
2002,Sri Lanka,LKA,France,FRA,630,0,2232,0,2862
2002,Mauritania,MRT,France,FRA,354,0,2556,0,2910
2002,Rep. of Moldova,MDA,France,FRA,10,0,772,0,782
2002,Mali,MLI,France,FRA,5,0,2606,0,2611
2002,Morocco,MAR,France,FRA,5,0,48,0,53
2002,Mauritius,MUS,France,FRA,0,0,16,0,16
2002,Myanmar,MMR,France,FRA,0,0,21,0,21
2002,Nepal,NPL,France,FRA,0,0,5,0,5
2002,Niger,NER,France,FRA,0,0,11,0,11
2002,Nigeria,NGA,France,FRA,23,0,850,0,873
2002,Pakistan,PAK,France,FRA,11,0,346,0,357
2002,Peru,PER,France,FRA,21,0,97,0,118
2002,Poland,POL,France,FRA,0,0,13,0,13
2002,South Africa,ZAF,France,FRA,0,0,5,0,5
2002,Russian Federation,RUS,France,FRA,484,0,1099,0,1583
2002,Rwanda,RWA,France,FRA,217,0,51,0,268
2002,Serbia and Kosovo: S/RES/1244 (1999),SRB,France,FRA,435,0,1663,0,2098
2002,Senegal,SEN,France,FRA,0,0,555,0,555
2002,Sierra Leone,SLE,France,FRA,73,0,911,0,984
2002,Somalia,SOM,France,FRA,38,0,55,0,93
2002,Viet Nam,VNM,France,FRA,79,0,19,0,98
2002,Sudan,SDN,France,FRA,13,0,55,0,68
2002,Slovakia,SVK,France,FRA,0,0,39,0,39
2002,Syrian Arab Rep.,SYR,France,FRA,20,0,23,0,43
2002,Thailand,THA,France,FRA,0,0,33,0,33
2002,Tajikistan,TJK,France,FRA,0,0,20,0,20
2002,Togo,TGO,France,FRA,56,0,175,0,231
2002,Tunisia,TUN,France,FRA,14,0,27,0,41
2002,Turkey,TUR,France,FRA,417,0,5579,0,5996
2002,Ukraine,UKR,France,FRA,12,0,608,0,620
2002,Uzbekistan,UZB,France,FRA,12,0,51,0,63
2002,Stateless,XXA,France,FRA,55,0,32,0,87
2002,Angola,AGO,Gabon,GAB,5,85,0,0,90
2002,Burundi,BDI,Gabon,GAB,5,20,0,0,25
2002,Benin,BEN,Gabon,GAB,0,0,0,5,5
2002,Central African Rep.,CAF,Gabon,GAB,0,0,16,0,16
2002,Chad,TCD,Gabon,GAB,12,895,94,5,1006
2002,Cameroon,CMR,Gabon,GAB,0,0,0,10,10
2002,Congo,COG,Gabon,GAB,5,0,17,5,27
2002,Dem. Rep. of the Congo,COD,Gabon,GAB,18,0,131,5,154
2002,Equatorial Guinea,GNQ,Gabon,GAB,5,0,11,0,16
2002,Liberia,LBR,Gabon,GAB,0,0,29,0,29
2002,Mauritania,MRT,Gabon,GAB,0,10,31,0,41
2002,Mali,MLI,Gabon,GAB,0,0,0,12,12
2002,Niger,NER,Gabon,GAB,0,0,0,5,5
2002,Nigeria,NGA,Gabon,GAB,0,0,25,0,25
2002,Rwanda,RWA,Gabon,GAB,16,0,5,0,21
2002,Sierra Leone,SLE,Gabon,GAB,0,0,5,5,10
2002,Sao Tome and Principe,STP,Gabon,GAB,0,15,0,0,15
2002,Togo,TGO,Gabon,GAB,0,10,0,0,10
2002,Sierra Leone,SLE,Ghana,GHA,71,0,0,0,71
2002,Sudan,SDN,Ghana,GHA,10,0,0,0,10
2002,Liberia,LBR,Guinea-Bissau,GNB,10,0,0,10,20
2002,Senegal,SEN,Guinea-Bissau,GNB,0,0,0,5,5
2002,Sierra Leone,SLE,Guinea-Bissau,GNB,5,0,16,318,339
2002,Afghanistan,AFG,Greece,GRC,0,5,2286,169,2460
2002,Albania,ALB,Greece,GRC,0,0,10,0,10
2002,Algeria,DZA,Greece,GRC,0,5,14,5,24
2002,Egypt,EGY,Greece,GRC,0,0,5,0,5
2002,Armenia,ARM,Greece,GRC,0,0,5,0,5
2002,Azerbaijan,AZE,Greece,GRC,0,5,0,0,5
2002,Burundi,BDI,Greece,GRC,0,0,11,0,11
2002,Bangladesh,BGD,Greece,GRC,0,0,36,0,36
2002,Belarus,BLR,Greece,GRC,0,0,10,0,10
2002,Central African Rep.,CAF,Greece,GRC,0,0,10,0,10
2002,China,CHN,Greece,GRC,0,5,57,5,67
2002,Cameroon,CMR,Greece,GRC,0,0,5,0,5
2002,Dem. Rep. of the Congo,COD,Greece,GRC,0,0,63,11,74
2002,Eritrea,ERI,Greece,GRC,0,0,43,0,43
2002,Ethiopia,ETH,Greece,GRC,0,0,61,5,66
2002,Palestinian,PSE,Greece,GRC,5,0,90,0,95
2002,Georgia,GEO,Greece,GRC,0,0,0,5,5
2002,Ghana,GHA,Greece,GRC,0,0,5,0,5
2002,India,IND,Greece,GRC,0,0,124,5,129
2002,Iran (Islamic Rep. of),IRN,Greece,GRC,0,5,480,61,546
2002,Iraq,IRQ,Greece,GRC,10,18,4112,270,4410
2002,Jordan,JOR,Greece,GRC,0,0,11,0,11
2002,Kyrgyzstan,KGZ,Greece,GRC,0,0,0,5,5
2002,Liberia,LBR,Greece,GRC,0,0,5,0,5
2002,Libya,LBY,Greece,GRC,0,0,10,0,10
2002,Sri Lanka,LKA,Greece,GRC,0,0,20,0,20
2002,Morocco,MAR,Greece,GRC,0,0,19,0,19
2002,Myanmar,MMR,Greece,GRC,0,0,10,0,10
2002,Nigeria,NGA,Greece,GRC,0,5,113,5,123
2002,Pakistan,PAK,Greece,GRC,0,5,362,5,372
2002,Romania,ROU,Greece,GRC,0,0,0,5,5
2002,Russian Federation,RUS,Greece,GRC,5,5,43,5,58
2002,Rwanda,RWA,Greece,GRC,0,0,17,0,17
2002,Serbia and Kosovo: S/RES/1244 (1999),SRB,Greece,GRC,5,0,12,0,17
2002,Senegal,SEN,Greece,GRC,0,0,5,0,5
2002,Sierra Leone,SLE,Greece,GRC,0,0,189,5,194
2002,Somalia,SOM,Greece,GRC,0,0,64,0,64
2002,Sudan,SDN,Greece,GRC,0,0,63,5,68
2002,Syrian Arab Rep.,SYR,Greece,GRC,0,0,13,0,13
2002,Turkey,TUR,Greece,GRC,5,5,879,184,1073
2002,Ukraine,UKR,Greece,GRC,0,0,5,0,5
2002,Uzbekistan,UZB,Greece,GRC,0,0,13,0,13
2002,Dem. Rep. of the Congo,COD,Guinea,GIN,12,0,0,0,12
2002,Liberia,LBR,Guinea,GIN,751,0,94,30,875
2002,Nigeria,NGA,Guinea,GIN,5,0,0,0,5
2002,Sierra Leone,SLE,Guinea,GIN,1264,0,112,89,1465
2002,Colombia,COL,Honduras,HND,0,0,12,0,12
2002,Cuba,CUB,Honduras,HND,5,0,42,10,57
2002,Peru,PER,Honduras,HND,5,0,0,0,5
2002,Afghanistan,AFG,Croatia,HRV,0,0,0,5,5
2002,Algeria,DZA,Croatia,HRV,0,0,0,10,10
2002,China,CHN,Croatia,HRV,0,0,5,0,5
2002,Palestinian,PSE,Croatia,HRV,0,0,5,0,5
2002,Iran (Islamic Rep. of),IRN,Croatia,HRV,0,0,5,20,25
2002,Iraq,IRQ,Croatia,HRV,0,0,0,16,16
2002,Sri Lanka,LKA,Croatia,HRV,0,0,0,5,5
2002,Nigeria,NGA,Croatia,HRV,0,0,0,5,5
2002,Pakistan,PAK,Croatia,HRV,0,0,0,13,13
2002,Russian Federation,RUS,Croatia,HRV,0,0,5,5,10
2002,Serbia and Kosovo: S/RES/1244 (1999),SRB,Croatia,HRV,0,0,0,10,10
2002,Sierra Leone,SLE,Croatia,HRV,0,0,0,5,5
2002,Ukraine,UKR,Croatia,HRV,0,0,0,5,5
2002,Afghanistan,AFG,Hungary,HUN,10,731,266,2194,3201
2002,Albania,ALB,Hungary,HUN,0,0,0,5,5
2002,Algeria,DZA,Hungary,HUN,0,0,17,17,34
2002,Angola,AGO,Hungary,HUN,0,5,5,0,10
2002,Egypt,EGY,Hungary,HUN,0,0,5,0,5
2002,Armenia,ARM,Hungary,HUN,5,0,14,5,24
2002,Azerbaijan,AZE,Hungary,HUN,0,0,5,0,5
2002,Bangladesh,BGD,Hungary,HUN,0,0,195,442,637
2002,Bosnia and Herzegovina,BIH,Hungary,HUN,0,0,5,0,5
2002,China,CHN,Hungary,HUN,0,0,61,10,71
2002,Cameroon,CMR,Hungary,HUN,14,0,0,0,14
2002,Dem. Rep. of the Congo,COD,Hungary,HUN,0,5,0,0,5
2002,Ethiopia,ETH,Hungary,HUN,0,0,0,12,12
2002,Palestinian,PSE,Hungary,HUN,5,5,28,20,58
2002,Georgia,GEO,Hungary,HUN,0,0,30,34,64
2002,Ghana,GHA,Hungary,HUN,0,0,10,15,25
2002,India,IND,Hungary,HUN,0,0,15,95,110
2002,Iran (Islamic Rep. of),IRN,Hungary,HUN,5,21,27,106,159
2002,Iraq,IRQ,Hungary,HUN,46,399,102,1385,1932
2002,Liberia,LBR,Hungary,HUN,0,0,0,5,5
2002,Sri Lanka,LKA,Hungary,HUN,0,0,5,5,10
2002,North Macedonia,MKD,Hungary,HUN,0,0,21,5,26
2002,Rep. of Moldova,MDA,Hungary,HUN,0,0,11,5,16
2002,Mongolia,MNG,Hungary,HUN,0,0,5,5,10
2002,Nigeria,NGA,Hungary,HUN,5,23,54,75,157
2002,Pakistan,PAK,Hungary,HUN,0,5,15,50,70
2002,Romania,ROU,Hungary,HUN,0,0,13,5,18
2002,Russian Federation,RUS,Hungary,HUN,5,10,13,5,33
2002,Serbia and Kosovo: S/RES/1244 (1999),SRB,Hungary,HUN,10,0,44,55,109
2002,Sierra Leone,SLE,Hungary,HUN,0,5,29,77,111
2002,Somalia,SOM,Hungary,HUN,0,34,5,221,260
2002,Viet Nam,VNM,Hungary,HUN,0,0,156,24,180
2002,Sudan,SDN,Hungary,HUN,0,49,5,45,99
2002,Slovakia,SVK,Hungary,HUN,0,0,10,0,10
2002,Syrian Arab Rep.,SYR,Hungary,HUN,0,0,11,0,11
2002,Tunisia,TUN,Hungary,HUN,0,0,0,5,5
2002,Turkey,TUR,Hungary,HUN,5,5,63,122,195
2002,Ukraine,UKR,Hungary,HUN,0,0,11,11,22
2002,Uzbekistan,UZB,Hungary,HUN,0,0,5,0,5
2002,Stateless,XXA,Hungary,HUN,0,0,5,0,5
2002,Albania,ALB,Iceland,ISL,0,0,5,10,15
2002,Algeria,DZA,Iceland,ISL,0,0,5,0,5
2002,Belarus,BLR,Iceland,ISL,0,0,0,5,5
2002,Bulgaria,BGR,Iceland,ISL,0,0,0,5,5
2002,Georgia,GEO,Iceland,ISL,0,0,5,0,5
2002,Iran (Islamic Rep. of),IRN,Iceland,ISL,0,0,5,0,5
2002,Mongolia,MNG,Iceland,ISL,0,0,0,5,5
2002,Romania,ROU,Iceland,ISL,0,0,10,21,31
2002,Russian Federation,RUS,Iceland,ISL,0,0,15,0,15
2002,Slovakia,SVK,Iceland,ISL,0,0,5,0,5
2002,Ukraine,UKR,Iceland,ISL,0,0,5,0,5
2002,Uzbekistan,UZB,Iceland,ISL,0,0,0,5,5
2002,Afghanistan,AFG,Ireland,IRL,0,0,5,19,24
2002,Albania,ALB,Ireland,IRL,14,0,98,82,194
2002,Algeria,DZA,Ireland,IRL,5,13,130,69,217
2002,Angola,AGO,Ireland,IRL,51,0,140,16,207
2002,Egypt,EGY,Ireland,IRL,5,0,19,28,52
2002,Armenia,ARM,Ireland,IRL,5,0,0,14,19
2002,Azerbaijan,AZE,Ireland,IRL,0,0,5,10,15
2002,Burundi,BDI,Ireland,IRL,0,0,14,5,19
2002,Benin,BEN,Ireland,IRL,0,0,0,13,13
2002,Bangladesh,BGD,Ireland,IRL,0,0,5,5,10
2002,Bhutan,BTN,Ireland,IRL,5,0,0,0,5
2002,Belarus,BLR,Ireland,IRL,5,0,39,61,105
2002,Bosnia and Herzegovina,BIH,Ireland,IRL,0,0,10,0,10
2002,Bulgaria,BGR,Ireland,IRL,0,0,44,66,110
2002,China,CHN,Ireland,IRL,5,0,16,38,59
2002,Cameroon,CMR,Ireland,IRL,31,0,103,94,228
2002,Congo,COG,Ireland,IRL,12,0,11,5,28
2002,Dem. Rep. of the Congo,COD,Ireland,IRL,125,0,213,76,414
2002,Cuba,CUB,Ireland,IRL,0,0,5,0,5
2002,Czechia,CZE,Ireland,IRL,10,0,140,136,286
2002,Eritrea,ERI,Ireland,IRL,5,0,0,0,5
2002,Estonia,EST,Ireland,IRL,0,0,52,56,108
2002,Ethiopia,ETH,Ireland,IRL,12,0,0,0,12
2002,Gambia,GMB,Ireland,IRL,0,0,18,26,44
2002,Palestinian,PSE,Ireland,IRL,19,0,15,11,45
2002,Georgia,GEO,Ireland,IRL,10,0,94,56,160
2002,Ghana,GHA,Ireland,IRL,5,0,90,201,296
2002,Guinea,GIN,Ireland,IRL,13,0,0,0,13
2002,Croatia,HRV,Ireland,IRL,29,0,243,59,331
2002,Hungary,HUN,Ireland,IRL,0,0,5,10,15
2002,Cote d'Ivoire,CIV,Ireland,IRL,10,0,41,36,87
2002,India,IND,Ireland,IRL,0,0,0,47,47
2002,Iran (Islamic Rep. of),IRN,Ireland,IRL,10,0,11,10,31
2002,Iraq,IRQ,Ireland,IRL,43,0,34,14,91
2002,Israel,ISR,Ireland,IRL,0,0,49,20,69
2002,Jamaica,JAM,Ireland,IRL,0,0,5,13,18
2002,Kazakhstan,KAZ,Ireland,IRL,5,0,72,22,99
2002,Kenya,KEN,Ireland,IRL,11,0,32,47,90
2002,Kyrgyzstan,KGZ,Ireland,IRL,0,0,5,13,18
2002,Liberia,LBR,Ireland,IRL,10,0,14,10,34
2002,Libya,LBY,Ireland,IRL,10,0,34,12,56
2002,Lebanon,LBN,Ireland,IRL,0,0,16,17,33
2002,Lesotho,LSO,Ireland,IRL,0,0,5,0,5
2002,Sri Lanka,LKA,Ireland,IRL,5,0,5,10,20
2002,Lithuania,LTU,Ireland,IRL,0,0,97,275,372
2002,Latvia,LVA,Ireland,IRL,0,0,31,42,73
2002,North Macedonia,MKD,Ireland,IRL,0,0,17,20,37
2002,Rep. of Moldova,MDA,Ireland,IRL,5,0,318,436,759
2002,Malawi,MWI,Ireland,IRL,0,0,5,5,10
2002,Mongolia,MNG,Ireland,IRL,0,0,0,5,5
2002,Morocco,MAR,Ireland,IRL,0,0,5,10,15
2002,Niger,NER,Ireland,IRL,0,0,5,0,5
2002,Nigeria,NGA,Ireland,IRL,34,5,1585,3619,5243
2002,Pakistan,PAK,Ireland,IRL,36,0,60,84,180
2002,Poland,POL,Ireland,IRL,0,0,224,211,435
2002,Romania,ROU,Ireland,IRL,5,37,591,1313,1946
2002,South Africa,ZAF,Ireland,IRL,5,0,155,114,274
2002,Russian Federation,RUS,Ireland,IRL,29,5,183,163,380
2002,Rwanda,RWA,Ireland,IRL,15,0,13,5,33
2002,Serbia and Kosovo: S/RES/1244 (1999),SRB,Ireland,IRL,37,5,134,68,244
2002,Sierra Leone,SLE,Ireland,IRL,12,0,158,55,225
2002,Somalia,SOM,Ireland,IRL,35,0,45,15,95
2002,Sudan,SDN,Ireland,IRL,11,0,23,12,46
2002,Slovakia,SVK,Ireland,IRL,10,0,14,57,81
2002,Switzerland,CHE,Ireland,IRL,5,0,0,0,5
2002,Syrian Arab Rep.,SYR,Ireland,IRL,5,0,5,0,10
2002,United Rep. of Tanzania,TZA,Ireland,IRL,0,0,0,5,5
2002,Togo,TGO,Ireland,IRL,17,0,12,10,39
2002,Tunisia,TUN,Ireland,IRL,0,0,5,0,5
2002,Turkey,TUR,Ireland,IRL,0,0,12,5,17
2002,Uganda,UGA,Ireland,IRL,5,0,12,5,22
2002,Ukraine,UKR,Ireland,IRL,5,0,166,294,465
2002,Uzbekistan,UZB,Ireland,IRL,5,0,38,17,60
2002,Zambia,ZMB,Ireland,IRL,0,0,5,0,5
2002,Zimbabwe,ZWE,Ireland,IRL,159,0,149,36,344
2002,Stateless,XXA,Ireland,IRL,5,0,23,41,69
2002,Armenia,ARM,Israel,ISR,5,0,0,0,5
2002,Dem. Rep. of the Congo,COD,Israel,ISR,5,0,0,10,15
2002,Colombia,COL,Israel,ISR,0,0,0,5,5
2002,Eritrea,ERI,Israel,ISR,5,0,0,13,18
2002,Ethiopia,ETH,Israel,ISR,52,0,62,26,140
2002,Ghana,GHA,Israel,ISR,0,0,5,0,5
2002,India,IND,Israel,ISR,0,0,0,5,5
2002,Iran (Islamic Rep. of),IRN,Israel,ISR,0,0,0,5,5
2002,Liberia,LBR,Israel,ISR,0,0,5,0,5
2002,Lebanon,LBN,Israel,ISR,0,0,0,5,5
2002,Nigeria,NGA,Israel,ISR,0,0,5,5,10
2002,Rwanda,RWA,Israel,ISR,0,0,5,0,5
2002,Sierra Leone,SLE,Israel,ISR,0,27,0,23,50
2002,Turkey,TUR,Israel,ISR,0,0,5,0,5
2002,Afghanistan,AFG,Japan,JPN,5,0,42,5,52
2002,Bangladesh,BGD,Japan,JPN,0,0,12,0,12
2002,China,CHN,Japan,JPN,0,12,0,0,12
2002,Cameroon,CMR,Japan,JPN,0,0,5,0,5
2002,India,IND,Japan,JPN,0,0,5,0,5
2002,Iran (Islamic Rep. of),IRN,Japan,JPN,0,5,11,5,21
2002,Iraq,IRQ,Japan,JPN,0,0,5,0,5
2002,Sri Lanka,LKA,Japan,JPN,0,0,0,5,5
2002,Myanmar,MMR,Japan,JPN,0,16,5,0,21
2002,Nigeria,NGA,Japan,JPN,0,0,5,0,5
2002,Pakistan,PAK,Japan,JPN,0,5,36,5,46
2002,Turkey,TUR,Japan,JPN,0,5,27,5,37
2002,Afghanistan,AFG,Kazakhstan,KAZ,39,0,10,5,54
2002,Iraq,IRQ,Kazakhstan,KAZ,0,0,5,0,5
2002,Afghanistan,AFG,Kyrgyzstan,KGZ,81,0,0,0,81
2002,China,CHN,Kyrgyzstan,KGZ,10,0,0,0,10
2002,Tajikistan,TJK,Kyrgyzstan,KGZ,127,0,0,0,127
2002,China,CHN,Rep. of Korea,KOR,0,0,0,5,5
2002,Dem. Rep. of the Congo,COD,Rep. of Korea,KOR,0,0,0,5,5
2002,Ethiopia,ETH,Rep. of Korea,KOR,0,5,0,0,5
2002,Iran (Islamic Rep. of),IRN,Rep. of Korea,KOR,0,0,5,0,5
2002,Iraq,IRQ,Rep. of Korea,KOR,0,5,0,0,5
2002,Pakistan,PAK,Rep. of Korea,KOR,0,0,0,5,5
2002,Somalia,SOM,Rep. of Korea,KOR,0,0,5,0,5
2002,Nigeria,NGA,Liberia,LBR,0,5,5,0,10
2002,Armenia,ARM,Liechtenstein,LIE,0,10,0,0,10
2002,Bosnia and Herzegovina,BIH,Liechtenstein,LIE,0,0,0,5,5
2002,North Macedonia,MKD,Liechtenstein,LIE,0,0,5,41,46
2002,Russian Federation,RUS,Liechtenstein,LIE,0,0,0,5,5
2002,Serbia and Kosovo: S/RES/1244 (1999),SRB,Liechtenstein,LIE,0,15,5,67,87
2002,Ukraine,UKR,Liechtenstein,LIE,0,0,0,5,5
2002,Afghanistan,AFG,Lithuania,LTU,0,5,10,15,30
2002,India,IND,Lithuania,LTU,0,0,0,5,5
2002,Russian Federation,RUS,Lithuania,LTU,0,76,5,37,118
2002,Belarus,BLR,Latvia,LVA,0,5,0,0,5
2002,Russian Federation,RUS,Latvia,LVA,0,0,5,0,5
2002,Slovakia,SVK,Latvia,LVA,0,0,10,0,10
2002,Ukraine,UKR,Latvia,LVA,0,0,5,0,5
2002,Albania,ALB,Mexico,MEX,0,0,13,0,13
2002,Bangladesh,BGD,Mexico,MEX,0,0,0,12,12
2002,China,CHN,Mexico,MEX,0,0,5,0,5
2002,Dem. Rep. of the Congo,COD,Mexico,MEX,5,0,0,0,5
2002,Colombia,COL,Mexico,MEX,18,0,18,10,46
2002,Cuba,CUB,Mexico,MEX,0,0,27,11,38
2002,Ethiopia,ETH,Mexico,MEX,5,0,0,0,5
2002,Ghana,GHA,Mexico,MEX,0,0,5,0,5
2002,Guatemala,GTM,Mexico,MEX,10,0,0,0,10
2002,Honduras,HND,Mexico,MEX,5,0,0,0,5
2002,India,IND,Mexico,MEX,0,0,0,5,5
2002,Iraq,IRQ,Mexico,MEX,0,0,0,10,10
2002,Sri Lanka,LKA,Mexico,MEX,0,0,5,0,5
2002,Nigeria,NGA,Mexico,MEX,5,0,5,0,10
2002,Peru,PER,Mexico,MEX,0,0,5,0,5
2002,Serbia and Kosovo: S/RES/1244 (1999),SRB,Mexico,MEX,5,0,0,0,5
2002,Ukraine,UKR,Mexico,MEX,0,0,5,0,5
2002,Chad,TCD,Mali,MLI,5,0,0,0,5
2002,Cameroon,CMR,Mali,MLI,0,0,5,0,5
2002,Congo,COG,Mali,MLI,5,0,0,0,5
2002,Dem. Rep. of the Congo,COD,Mali,MLI,10,0,0,0,10
2002,Cote d'Ivoire,CIV,Mali,MLI,0,0,5,0,5
2002,Liberia,LBR,Mali,MLI,12,0,10,0,22
2002,Mauritania,MRT,Mali,MLI,5,0,10,0,15
2002,Nigeria,NGA,Mali,MLI,0,0,5,0,5
2002,Rwanda,RWA,Mali,MLI,0,0,13,0,13
2002,Sierra Leone,SLE,Mali,MLI,38,0,0,0,38
2002,Togo,TGO,Mali,MLI,5,0,5,0,10
2002,Burundi,BDI,Malawi,MWI,126,0,0,0,126
2002,Dem. Rep. of the Congo,COD,Malawi,MWI,186,0,0,0,186
2002,Rwanda,RWA,Malawi,MWI,335,0,0,0,335
2002,Sierra Leone,SLE,Malawi,MWI,0,0,0,5,5
2002,Somalia,SOM,Malawi,MWI,21,0,0,0,21
2002,Burundi,BDI,Namibia,NAM,11,0,0,171,182
2002,Cameroon,CMR,Namibia,NAM,0,0,0,5,5
2002,Congo,COG,Namibia,NAM,10,0,0,85,95
2002,Dem. Rep. of the Congo,COD,Namibia,NAM,29,0,0,649,678
2002,Liberia,LBR,Namibia,NAM,0,0,5,36,41
2002,Rwanda,RWA,Namibia,NAM,0,0,0,34,34
2002,Sierra Leone,SLE,Namibia,NAM,0,0,0,5,5
2002,Somalia,SOM,Namibia,NAM,0,0,0,5,5
2002,Sudan,SDN,Namibia,NAM,0,0,0,5,5
2002,United Rep. of Tanzania,TZA,Namibia,NAM,0,0,0,5,5
2002,China,CHN,Nepal,NPL,13,0,0,0,13
2002,Iran (Islamic Rep. of),IRN,Nepal,NPL,0,0,5,0,5
2002,Afghanistan,AFG,Netherlands,NLD,11,139,884,560,1594
2002,Albania,ALB,Netherlands,NLD,0,0,92,45,137
2002,Algeria,DZA,Netherlands,NLD,0,5,214,65,284
2002,Angola,AGO,Netherlands,NLD,5,689,4636,284,5614
2002,Egypt,EGY,Netherlands,NLD,0,0,24,5,29
2002,Armenia,ARM,Netherlands,NLD,0,37,516,31,584
2002,Azerbaijan,AZE,Netherlands,NLD,5,52,619,50,726
2002,Burundi,BDI,Netherlands,NLD,5,275,150,60,490
2002,Benin,BEN,Netherlands,NLD,0,0,117,5,122
2002,Bangladesh,BGD,Netherlands,NLD,0,0,44,5,49
2002,Burkina Faso,BFA,Netherlands,NLD,0,0,32,0,32
2002,Belarus,BLR,Netherlands,NLD,5,5,123,27,160
2002,Bosnia and Herzegovina,BIH,Netherlands,NLD,0,22,332,71,425
2002,Bulgaria,BGR,Netherlands,NLD,0,0,25,13,38
2002,Chad,TCD,Netherlands,NLD,0,0,20,0,20
2002,China,CHN,Netherlands,NLD,0,10,1238,180,1428
2002,Cameroon,CMR,Netherlands,NLD,10,16,352,28,406
2002,Congo,COG,Netherlands,NLD,5,53,489,56,603
2002,Dem. Rep. of the Congo,COD,Netherlands,NLD,0,58,660,57,775
2002,Colombia,COL,Netherlands,NLD,0,5,18,10,33
2002,Cuba,CUB,Netherlands,NLD,0,0,10,5,15
2002,Czechia,CZE,Netherlands,NLD,0,0,25,37,62
2002,Ecuador,ECU,Netherlands,NLD,0,0,0,5,5
2002,Eritrea,ERI,Netherlands,NLD,0,22,259,21,302
2002,Estonia,EST,Netherlands,NLD,0,0,0,5,5
2002,Ethiopia,ETH,Netherlands,NLD,5,10,242,21,278
2002,France,FRA,Netherlands,NLD,0,0,0,5,5
2002,Gabon,GAB,Netherlands,NLD,0,0,5,0,5
2002,Gambia,GMB,Netherlands,NLD,0,0,18,0,18
2002,United Kingdom of Great Britain and Northern Ireland,GBR,Netherlands,NLD,0,0,5,0,5
2002,Georgia,GEO,Netherlands,NLD,0,11,315,31,357
2002,Germany,DEU,Netherlands,NLD,0,0,5,0,5
2002,Ghana,GHA,Netherlands,NLD,0,0,22,10,32
2002,Guinea-Bissau,GNB,Netherlands,NLD,0,0,39,10,49
2002,Greece,GRC,Netherlands,NLD,0,0,0,5,5
2002,Guinea,GIN,Netherlands,NLD,5,184,1489,83,1761
2002,Haiti,HTI,Netherlands,NLD,0,0,5,0,5
2002,Croatia,HRV,Netherlands,NLD,0,0,40,20,60
2002,Hungary,HUN,Netherlands,NLD,0,0,50,25,75
2002,Cote d'Ivoire,CIV,Netherlands,NLD,0,5,157,10,172
2002,India,IND,Netherlands,NLD,0,0,134,83,217
2002,Indonesia,IDN,Netherlands,NLD,0,0,11,0,11
2002,Iran (Islamic Rep. of),IRN,Netherlands,NLD,30,66,1091,146,1333
2002,Iraq,IRQ,Netherlands,NLD,13,131,1199,248,1591
2002,Israel,ISR,Netherlands,NLD,0,0,23,11,34
2002,Jamaica,JAM,Netherlands,NLD,0,0,5,0,5
2002,Jordan,JOR,Netherlands,NLD,0,0,29,12,41
2002,Kazakhstan,KAZ,Netherlands,NLD,0,5,76,10,91
2002,Kenya,KEN,Netherlands,NLD,0,0,32,0,32
2002,Kyrgyzstan,KGZ,Netherlands,NLD,0,5,70,10,85
2002,Rep. of Korea,KOR,Netherlands,NLD,0,0,0,5,5
2002,Liberia,LBR,Netherlands,NLD,5,16,261,34,316
2002,Libya,LBY,Netherlands,NLD,0,0,42,18,60
2002,Lebanon,LBN,Netherlands,NLD,0,5,77,15,97
2002,Sri Lanka,LKA,Netherlands,NLD,5,51,397,90,543
2002,Lithuania,LTU,Netherlands,NLD,0,0,13,0,13
2002,Latvia,LVA,Netherlands,NLD,0,0,5,5,10
2002,Mauritania,MRT,Netherlands,NLD,0,0,71,10,81
2002,North Macedonia,MKD,Netherlands,NLD,0,0,107,22,129
2002,Rep. of Moldova,MDA,Netherlands,NLD,0,0,22,10,32
2002,Mali,MLI,Netherlands,NLD,0,0,21,0,21
2002,Mongolia,MNG,Netherlands,NLD,0,5,275,52,332
2002,Morocco,MAR,Netherlands,NLD,0,0,19,10,29
2002,Myanmar,MMR,Netherlands,NLD,5,5,30,5,45
2002,Nepal,NPL,Netherlands,NLD,0,0,41,0,41
2002,Netherlands,NLD,Netherlands,NLD,0,0,5,5,10
2002,Niger,NER,Netherlands,NLD,0,10,244,13,267
2002,Nicaragua,NIC,Netherlands,NLD,0,0,5,0,5
2002,Nigeria,NGA,Netherlands,NLD,0,0,583,74,657
2002,Pakistan,PAK,Netherlands,NLD,5,0,103,15,123
2002,Peru,PER,Netherlands,NLD,0,0,11,0,11
2002,Poland,POL,Netherlands,NLD,0,0,5,13,18
2002,Romania,ROU,Netherlands,NLD,0,0,37,26,63
2002,South Africa,ZAF,Netherlands,NLD,0,0,5,5,10
2002,Russian Federation,RUS,Netherlands,NLD,0,60,572,101,733
2002,Rwanda,RWA,Netherlands,NLD,5,27,207,30,269
2002,Serbia and Kosovo: S/RES/1244 (1999),SRB,Netherlands,NLD,0,39,631,176,846
2002,Senegal,SEN,Netherlands,NLD,0,0,13,5,18
2002,Sierra Leone,SLE,Netherlands,NLD,0,949,1574,246,2769
2002,Somalia,SOM,Netherlands,NLD,5,128,1155,188,1476
2002,Viet Nam,VNM,Netherlands,NLD,0,0,81,5,86
2002,Sudan,SDN,Netherlands,NLD,10,88,831,99,1028
2002,Suriname,SUR,Netherlands,NLD,0,0,0,5,5
2002,Slovakia,SVK,Netherlands,NLD,0,0,126,104,230
2002,Slovenia,SVN,Netherlands,NLD,0,0,0,5,5
2002,Syrian Arab Rep.,SYR,Netherlands,NLD,19,47,455,56,577
2002,United Rep. of Tanzania,TZA,Netherlands,NLD,0,5,14,0,19
2002,Tajikistan,TJK,Netherlands,NLD,0,0,11,5,16
2002,Togo,TGO,Netherlands,NLD,5,16,568,44,633
2002,Tunisia,TUN,Netherlands,NLD,0,0,14,0,14
2002,Turkey,TUR,Netherlands,NLD,10,44,766,178,998
2002,Uganda,UGA,Netherlands,NLD,0,5,57,5,67
2002,Ukraine,UKR,Netherlands,NLD,0,5,164,37,206
2002,United States of America,USA,Netherlands,NLD,0,0,5,0,5
2002,Uzbekistan,UZB,Netherlands,NLD,10,0,93,14,117
2002,Yemen,YEM,Netherlands,NLD,0,0,42,5,47
2002,Zimbabwe,ZWE,Netherlands,NLD,0,0,12,0,12
2002,Stateless,XXA,Netherlands,NLD,11,20,501,81,613
2002,Ghana,GHA,Nicaragua,NIC,0,0,0,5,5
2002,Sierra Leone,SLE,Nicaragua,NIC,5,0,0,0,5
2002,Somalia,SOM,Nicaragua,NIC,5,0,0,0,5
2002,Angola,AGO,Nigeria,NGA,0,0,5,0,5
2002,Central African Rep.,CAF,Nigeria,NGA,0,0,5,0,5
2002,Chad,TCD,Nigeria,NGA,0,0,13,0,13
2002,Cameroon,CMR,Nigeria,NGA,5,0,0,0,5
2002,Dem. Rep. of the Congo,COD,Nigeria,NGA,11,0,5,0,16
2002,Ethiopia,ETH,Nigeria,NGA,0,0,5,0,5
2002,Liberia,LBR,Nigeria,NGA,304,0,326,0,630
2002,Rwanda,RWA,Nigeria,NGA,0,0,5,0,5
2002,Sierra Leone,SLE,Nigeria,NGA,48,0,64,0,112
2002,Somalia,SOM,Nigeria,NGA,10,0,0,0,10
2002,Sudan,SDN,Nigeria,NGA,12,0,0,0,12
2002,Afghanistan,AFG,Norway,NOR,16,285,320,217,838
2002,Albania,ALB,Norway,NOR,0,5,243,89,337
2002,Algeria,DZA,Norway,NOR,0,5,168,264,437
2002,Angola,AGO,Norway,NOR,0,5,0,5,10
2002,Egypt,EGY,Norway,NOR,0,0,11,5,16
2002,Argentina,ARG,Norway,NOR,0,0,16,0,16
2002,Armenia,ARM,Norway,NOR,0,5,114,46,165
2002,Azerbaijan,AZE,Norway,NOR,0,5,112,59,176
2002,Burundi,BDI,Norway,NOR,5,15,5,5,30
2002,Benin,BEN,Norway,NOR,0,0,0,5,5
2002,Bangladesh,BGD,Norway,NOR,0,5,13,0,18
2002,Bhutan,BTN,Norway,NOR,0,0,13,0,13
2002,Belarus,BLR,Norway,NOR,0,0,247,161,408
2002,Bolivia (Plurinational State of),BOL,Norway,NOR,0,0,0,5,5
2002,Brazil,BRA,Norway,NOR,0,0,5,0,5
2002,Bosnia and Herzegovina,BIH,Norway,NOR,0,62,579,470,1111
2002,Bulgaria,BGR,Norway,NOR,0,5,360,148,513
2002,Cambodia,KHM,Norway,NOR,0,5,25,13,43
2002,China,CHN,Norway,NOR,5,5,13,10,33
2002,Chile,CHL,Norway,NOR,0,0,5,5,10
2002,Congo,COG,Norway,NOR,0,5,11,0,16
2002,Dem. Rep. of the Congo,COD,Norway,NOR,0,5,14,0,19
2002,Colombia,COL,Norway,NOR,0,5,12,5,22
2002,Czechia,CZE,Norway,NOR,0,0,230,11,241
2002,Djibouti,DJI,Norway,NOR,0,0,0,5,5
2002,Eritrea,ERI,Norway,NOR,5,25,84,10,124
2002,Estonia,EST,Norway,NOR,0,0,26,5,31
2002,Ethiopia,ETH,Norway,NOR,14,53,123,21,211
2002,Gambia,GMB,Norway,NOR,0,0,0,5,5
2002,Georgia,GEO,Norway,NOR,0,5,155,102,262
2002,Guinea,GIN,Norway,NOR,0,0,5,0,5
2002,Croatia,HRV,Norway,NOR,0,21,346,43,410
2002,Hungary,HUN,Norway,NOR,0,0,25,10,35
2002,India,IND,Norway,NOR,0,0,14,0,14
2002,Iran (Islamic Rep. of),IRN,Norway,NOR,40,47,216,131,434
2002,Iraq,IRQ,Norway,NOR,35,585,198,321,1139
2002,Israel,ISR,Norway,NOR,0,0,36,5,41
2002,Jordan,JOR,Norway,NOR,0,0,0,5,5
2002,Kazakhstan,KAZ,Norway,NOR,0,5,106,32,143
2002,Kenya,KEN,Norway,NOR,0,0,11,0,11
2002,Kyrgyzstan,KGZ,Norway,NOR,0,0,92,50,142
2002,Liberia,LBR,Norway,NOR,0,0,12,0,12
2002,Libya,LBY,Norway,NOR,5,28,5,29,67
2002,Lebanon,LBN,Norway,NOR,0,5,13,15,33
2002,Sri Lanka,LKA,Norway,NOR,0,37,128,35,200
2002,Lithuania,LTU,Norway,NOR,0,0,49,24,73
2002,Latvia,LVA,Norway,NOR,0,0,48,25,73
2002,"China, Macao SAR",MAC,Norway,NOR,0,10,253,85,348
2002,Rep. of Moldova,MDA,Norway,NOR,0,0,70,25,95
2002,Mongolia,MNG,Norway,NOR,0,0,479,143,622
2002,Morocco,MAR,Norway,NOR,0,0,5,17,22
2002,Myanmar,MMR,Norway,NOR,0,5,0,5,10
2002,Nepal,NPL,Norway,NOR,0,0,78,20,98
2002,Niger,NER,Norway,NOR,0,5,33,14,52
2002,Nigeria,NGA,Norway,NOR,0,0,12,0,12
2002,Pakistan,PAK,Norway,NOR,11,15,151,24,201
2002,Peru,PER,Norway,NOR,0,0,5,0,5
2002,Poland,POL,Norway,NOR,0,0,50,11,61
2002,Romania,ROU,Norway,NOR,0,5,248,40,293
2002,Russian Federation,RUS,Norway,NOR,69,161,663,630,1523
2002,Rwanda,RWA,Norway,NOR,0,5,13,5,23
2002,El Salvador,SLV,Norway,NOR,0,0,0,5,5
2002,Saudi Arabia,SAU,Norway,NOR,5,0,0,0,5
2002,Serbia and Kosovo: S/RES/1244 (1999),SRB,Norway,NOR,88,413,1010,844,2355
2002,Sierra Leone,SLE,Norway,NOR,0,5,46,11,62
2002,Somalia,SOM,Norway,NOR,18,968,136,176,1298
2002,Viet Nam,VNM,Norway,NOR,0,0,0,21,21
2002,Sudan,SDN,Norway,NOR,0,10,34,10,54
2002,Slovakia,SVK,Norway,NOR,0,0,297,47,344
2002,Slovenia,SVN,Norway,NOR,0,0,5,0,5
2002,Syrian Arab Rep.,SYR,Norway,NOR,0,10,24,21,55
2002,United Rep. of Tanzania,TZA,Norway,NOR,0,0,5,0,5
2002,Tajikistan,TJK,Norway,NOR,0,0,20,5,25
2002,Tunisia,TUN,Norway,NOR,0,0,0,10,10
2002,Turkey,TUR,Norway,NOR,0,5,137,68,210
2002,Ukraine,UKR,Norway,NOR,0,5,952,711,1668
2002,Uzbekistan,UZB,Norway,NOR,0,5,93,69,167
2002,Stateless,XXA,Norway,NOR,5,82,55,72,214
2002,Afghanistan,AFG,New Zealand,NZL,22,0,26,0,48
2002,Albania,ALB,New Zealand,NZL,0,0,10,0,10
2002,Algeria,DZA,New Zealand,NZL,0,0,11,0,11
2002,Egypt,EGY,New Zealand,NZL,0,0,5,0,5
2002,Argentina,ARG,New Zealand,NZL,0,0,10,0,10
2002,Bangladesh,BGD,New Zealand,NZL,0,0,43,0,43
2002,Bolivia (Plurinational State of),BOL,New Zealand,NZL,0,0,5,0,5
2002,Bulgaria,BGR,New Zealand,NZL,0,0,11,0,11
2002,Cambodia,KHM,New Zealand,NZL,0,0,5,0,5
2002,China,CHN,New Zealand,NZL,15,0,55,0,70
2002,Chile,CHL,New Zealand,NZL,0,0,29,0,29
2002,Dem. Rep. of the Congo,COD,New Zealand,NZL,0,0,32,0,32
2002,Colombia,COL,New Zealand,NZL,16,0,15,0,31
2002,Czechia,CZE,New Zealand,NZL,5,0,117,0,122
2002,Ethiopia,ETH,New Zealand,NZL,5,0,5,0,10
2002,Fiji,FJI,New Zealand,NZL,0,0,32,0,32
2002,Palestinian,PSE,New Zealand,NZL,0,0,5,0,5
2002,Ghana,GHA,New Zealand,NZL,0,0,5,0,5
2002,Croatia,HRV,New Zealand,NZL,0,0,5,0,5
2002,Hungary,HUN,New Zealand,NZL,0,0,29,0,29
2002,India,IND,New Zealand,NZL,0,0,120,0,120
2002,Indonesia,IDN,New Zealand,NZL,0,0,22,0,22
2002,Iran (Islamic Rep. of),IRN,New Zealand,NZL,146,0,80,0,226
2002,Iraq,IRQ,New Zealand,NZL,66,0,24,0,90
2002,Israel,ISR,New Zealand,NZL,0,0,5,0,5
2002,Jordan,JOR,New Zealand,NZL,0,0,18,0,18
2002,Rep. of Korea,KOR,New Zealand,NZL,0,0,15,0,15
2002,Kuwait,KWT,New Zealand,NZL,24,0,5,0,29
2002,Lao People's Dem. Rep.,LAO,New Zealand,NZL,5,0,0,0,5
2002,Liberia,LBR,New Zealand,NZL,5,0,5,0,10
2002,Lebanon,LBN,New Zealand,NZL,5,0,5,0,10
2002,Sri Lanka,LKA,New Zealand,NZL,52,0,101,0,153
2002,Lithuania,LTU,New Zealand,NZL,0,0,5,0,5
2002,Latvia,LVA,New Zealand,NZL,0,0,5,0,5
2002,Madagascar,MDG,New Zealand,NZL,5,0,0,0,5
2002,North Macedonia,MKD,New Zealand,NZL,0,0,5,0,5
2002,Mali,MLI,New Zealand,NZL,0,0,5,0,5
2002,Malaysia,MYS,New Zealand,NZL,0,0,22,0,22
2002,Myanmar,MMR,New Zealand,NZL,5,0,0,0,5
2002,Nepal,NPL,New Zealand,NZL,0,0,32,0,32
2002,Nigeria,NGA,New Zealand,NZL,0,0,23,0,23
2002,Oman,OMN,New Zealand,NZL,0,0,5,0,5
2002,Pakistan,PAK,New Zealand,NZL,0,0,54,0,54
2002,Peru,PER,New Zealand,NZL,0,0,5,0,5
2002,Philippines,PHL,New Zealand,NZL,0,0,5,0,5
2002,Romania,ROU,New Zealand,NZL,0,0,5,0,5
2002,South Africa,ZAF,New Zealand,NZL,0,0,18,0,18
2002,Russian Federation,RUS,New Zealand,NZL,0,0,5,0,5
2002,Rwanda,RWA,New Zealand,NZL,5,0,0,0,5
2002,Saudi Arabia,SAU,New Zealand,NZL,0,0,5,0,5
2002,Serbia and Kosovo: S/RES/1244 (1999),SRB,New Zealand,NZL,0,0,12,0,12
2002,Sierra Leone,SLE,New Zealand,NZL,0,0,10,0,10
2002,Somalia,SOM,New Zealand,NZL,17,0,5,0,22
2002,Viet Nam,VNM,New Zealand,NZL,0,0,13,0,13
2002,Sudan,SDN,New Zealand,NZL,5,0,5,0,10
2002,Slovakia,SVK,New Zealand,NZL,0,0,5,0,5
2002,Syrian Arab Rep.,SYR,New Zealand,NZL,5,0,5,0,10
2002,Thailand,THA,New Zealand,NZL,0,0,392,0,392
2002,Tonga,TON,New Zealand,NZL,0,0,29,0,29
2002,Turkey,TUR,New Zealand,NZL,0,0,14,0,14
2002,Uganda,UGA,New Zealand,NZL,0,0,5,0,5
2002,Ukraine,UKR,New Zealand,NZL,0,0,5,0,5
2002,Uzbekistan,UZB,New Zealand,NZL,0,0,5,0,5
2002,Zimbabwe,ZWE,New Zealand,NZL,20,0,74,0,94
2002,Colombia,COL,Panama,PAN,55,0,29,5,89
2002,Cuba,CUB,Panama,PAN,5,0,0,0,5
2002,Colombia,COL,Peru,PER,5,0,5,0,10
2002,Cuba,CUB,Peru,PER,5,0,0,0,5
2002,Palestinian,PSE,Philippines,PHL,5,0,0,0,5
2002,Iran (Islamic Rep. of),IRN,Philippines,PHL,5,0,0,0,5
2002,Dem. People's Rep. of Korea,PRK,Philippines,PHL,0,0,0,73,73
2002,Liberia,LBR,Philippines,PHL,0,0,0,5,5
2002,Afghanistan,AFG,Poland,POL,0,0,716,5,721
2002,Algeria,DZA,Poland,POL,0,0,20,0,20
2002,Angola,AGO,Poland,POL,0,0,5,0,5
2002,Armenia,ARM,Poland,POL,0,0,530,10,540
2002,Azerbaijan,AZE,Poland,POL,0,0,83,10,93
2002,Bangladesh,BGD,Poland,POL,0,0,12,0,12
2002,Belarus,BLR,Poland,POL,10,0,66,5,81
2002,Bulgaria,BGR,Poland,POL,0,0,27,0,27
2002,China,CHN,Poland,POL,0,0,40,0,40
2002,Congo,COG,Poland,POL,5,0,5,0,10
2002,Dem. Rep. of the Congo,COD,Poland,POL,0,0,5,0,5
2002,Cuba,CUB,Poland,POL,0,0,0,5,5
2002,Eritrea,ERI,Poland,POL,0,0,5,0,5
2002,Ethiopia,ETH,Poland,POL,5,0,0,0,5
2002,Palestinian,PSE,Poland,POL,5,0,5,0,10
2002,Georgia,GEO,Poland,POL,0,0,87,11,98
2002,Guinea-Bissau,GNB,Poland,POL,0,0,5,0,5
2002,Guinea,GIN,Poland,POL,0,0,5,0,5
2002,Cote d'Ivoire,CIV,Poland,POL,0,0,0,5,5
2002,India,IND,Poland,POL,0,0,186,0,186
2002,Iraq,IRQ,Poland,POL,0,0,56,0,56
2002,Kazakhstan,KAZ,Poland,POL,0,0,15,0,15
2002,Liberia,LBR,Poland,POL,5,0,0,0,5
2002,Libya,LBY,Poland,POL,0,0,5,0,5
2002,Lebanon,LBN,Poland,POL,0,0,5,0,5
2002,Sri Lanka,LKA,Poland,POL,5,0,44,0,49
2002,North Macedonia,MKD,Poland,POL,0,0,10,0,10
2002,Rep. of Moldova,MDA,Poland,POL,0,0,198,24,222
2002,Mongolia,MNG,Poland,POL,0,0,177,0,177
2002,Nigeria,NGA,Poland,POL,0,0,36,0,36
2002,Pakistan,PAK,Poland,POL,0,0,55,0,55
2002,Romania,ROU,Poland,POL,0,0,49,0,49
2002,Russian Federation,RUS,Poland,POL,206,0,1888,384,2478
2002,Rwanda,RWA,Poland,POL,5,0,0,0,5
2002,Senegal,SEN,Poland,POL,0,0,5,0,5
2002,Sierra Leone,SLE,Poland,POL,5,0,0,0,5
2002,Somalia,SOM,Poland,POL,5,0,0,0,5
2002,Viet Nam,VNM,Poland,POL,0,0,103,5,108
2002,Sudan,SDN,Poland,POL,0,0,13,0,13
2002,Slovakia,SVK,Poland,POL,0,0,0,5,5
2002,Syrian Arab Rep.,SYR,Poland,POL,0,0,13,0,13
2002,Ukraine,UKR,Poland,POL,0,0,130,5,135
2002,Uzbekistan,UZB,Poland,POL,0,0,15,0,15
2002,Stateless,XXA,Poland,POL,0,0,16,0,16
2002,Afghanistan,AFG,Portugal,PRT,0,0,5,12,17
2002,Angola,AGO,Portugal,PRT,0,0,27,0,27
2002,Belarus,BLR,Portugal,PRT,0,5,0,0,5
2002,Dem. Rep. of the Congo,COD,Portugal,PRT,0,0,11,0,11
2002,Colombia,COL,Portugal,PRT,5,0,0,0,5
2002,Cuba,CUB,Portugal,PRT,5,0,5,0,10
2002,Guinea-Bissau,GNB,Portugal,PRT,0,0,5,0,5
2002,Guinea,GIN,Portugal,PRT,0,0,5,0,5
2002,Iran (Islamic Rep. of),IRN,Portugal,PRT,0,0,5,0,5
2002,Iraq,IRQ,Portugal,PRT,0,0,5,0,5
2002,Kazakhstan,KAZ,Portugal,PRT,5,0,5,0,10
2002,Liberia,LBR,Portugal,PRT,0,0,5,0,5
2002,Sri Lanka,LKA,Portugal,PRT,0,0,5,0,5
2002,Mongolia,MNG,Portugal,PRT,0,5,0,0,5
2002,Poland,POL,Portugal,PRT,0,0,10,0,10
2002,Romania,ROU,Portugal,PRT,0,0,5,0,5
2002,Russian Federation,RUS,Portugal,PRT,0,0,5,0,5
2002,Serbia and Kosovo: S/RES/1244 (1999),SRB,Portugal,PRT,0,0,0,5,5
2002,Sierra Leone,SLE,Portugal,PRT,0,5,32,0,37
2002,Zimbabwe,ZWE,Portugal,PRT,0,0,5,0,5
2002,Afghanistan,AFG,Romania,ROU,0,0,41,0,41
2002,Egypt,EGY,Romania,ROU,0,0,5,0,5
2002,Bangladesh,BGD,Romania,ROU,0,0,73,0,73
2002,Bosnia and Herzegovina,BIH,Romania,ROU,0,0,5,0,5
2002,China,CHN,Romania,ROU,0,0,91,5,96
2002,Cameroon,CMR,Romania,ROU,0,0,5,0,5
2002,Congo,COG,Romania,ROU,0,0,11,0,11
2002,Eritrea,ERI,Romania,ROU,0,0,5,0,5
2002,Palestinian,PSE,Romania,ROU,0,0,22,5,27
2002,Georgia,GEO,Romania,ROU,0,0,11,0,11
2002,India,IND,Romania,ROU,0,0,149,10,159
2002,Iran (Islamic Rep. of),IRN,Romania,ROU,5,0,33,5,43
2002,Iraq,IRQ,Romania,ROU,19,10,300,5,334
2002,Israel,ISR,Romania,ROU,0,0,0,5,5
2002,Jordan,JOR,Romania,ROU,0,0,11,0,11
2002,Lebanon,LBN,Romania,ROU,0,0,5,5,10
2002,Sri Lanka,LKA,Romania,ROU,0,0,0,5,5
2002,Rep. of Moldova,MDA,Romania,ROU,0,0,5,0,5
2002,Nigeria,NGA,Romania,ROU,0,0,10,0,10
2002,Pakistan,PAK,Romania,ROU,0,0,26,5,31
2002,Russian Federation,RUS,Romania,ROU,0,0,5,0,5
2002,Serbia and Kosovo: S/RES/1244 (1999),SRB,Romania,ROU,5,0,0,0,5
2002,Sierra Leone,SLE,Romania,ROU,0,0,5,0,5
2002,Somalia,SOM,Romania,ROU,5,0,30,0,35
2002,Sudan,SDN,Romania,ROU,5,0,44,0,49
2002,Syrian Arab Rep.,SYR,Romania,ROU,0,0,26,5,31
2002,Turkey,TUR,Romania,ROU,0,0,29,10,39
2002,Afghanistan,AFG,South Africa,ZAF,5,0,0,0,5
2002,Angola,AGO,South Africa,ZAF,542,0,14,0,556
2002,Egypt,EGY,South Africa,ZAF,0,0,13,0,13
2002,Burundi,BDI,South Africa,ZAF,280,0,14,39,333
2002,Bangladesh,BGD,South Africa,ZAF,0,0,5,19,24
2002,Bulgaria,BGR,South Africa,ZAF,0,0,0,5,5
2002,China,CHN,South Africa,ZAF,0,0,0,14,14
2002,Cameroon,CMR,South Africa,ZAF,27,0,11,15,53
2002,Congo,COG,South Africa,ZAF,116,0,12,17,145
2002,Dem. Rep. of the Congo,COD,South Africa,ZAF,2261,0,69,40,2370
2002,Eritrea,ERI,South Africa,ZAF,0,0,5,5,10
2002,Ethiopia,ETH,South Africa,ZAF,15,0,35,67,117
2002,Ghana,GHA,South Africa,ZAF,0,0,12,44,56
2002,Cote d'Ivoire,CIV,South Africa,ZAF,5,0,5,0,10
2002,India,IND,South Africa,ZAF,0,0,5,25,30
2002,Iraq,IRQ,South Africa,ZAF,5,0,0,0,5
2002,Kenya,KEN,South Africa,ZAF,10,0,42,38,90
2002,Kyrgyzstan,KGZ,South Africa,ZAF,11,0,0,0,11
2002,Liberia,LBR,South Africa,ZAF,30,0,0,5,35
2002,Sri Lanka,LKA,South Africa,ZAF,5,0,0,0,5
2002,Mali,MLI,South Africa,ZAF,0,0,0,11,11
2002,Malawi,MWI,South Africa,ZAF,0,0,32,11,43
2002,Nigeria,NGA,South Africa,ZAF,13,0,39,69,121
2002,Pakistan,PAK,South Africa,ZAF,17,0,59,93,169
2002,Rwanda,RWA,South Africa,ZAF,174,0,10,0,184
2002,Serbia and Kosovo: S/RES/1244 (1999),SRB,South Africa,ZAF,0,0,0,5,5
2002,Senegal,SEN,South Africa,ZAF,0,0,0,13,13
2002,Sierra Leone,SLE,South Africa,ZAF,12,0,11,0,23
2002,Somalia,SOM,South Africa,ZAF,1186,0,75,28,1289
2002,Sudan,SDN,South Africa,ZAF,34,0,0,0,34
2002,United Rep. of Tanzania,TZA,South Africa,ZAF,5,0,18,67,90
2002,Uganda,UGA,South Africa,ZAF,26,0,41,38,105
2002,Zambia,ZMB,South Africa,ZAF,5,0,5,5,15
2002,Zimbabwe,ZWE,South Africa,ZAF,0,0,5,0,5
2002,Afghanistan,AFG,Russian Federation,RUS,44,0,702,0,746
2002,Angola,AGO,Russian Federation,RUS,0,0,5,0,5
2002,Azerbaijan,AZE,Russian Federation,RUS,0,0,5,0,5
2002,Dem. Rep. of the Congo,COD,Russian Federation,RUS,0,0,5,0,5
2002,Ethiopia,ETH,Russian Federation,RUS,0,0,5,0,5
2002,United Kingdom of Great Britain and Northern Ireland,GBR,Russian Federation,RUS,0,0,10,0,10
2002,Georgia,GEO,Russian Federation,RUS,5,0,20,0,25
2002,Iraq,IRQ,Russian Federation,RUS,0,0,48,0,48
2002,Kazakhstan,KAZ,Russian Federation,RUS,0,0,15,0,15
2002,Kyrgyzstan,KGZ,Russian Federation,RUS,0,0,5,0,5
2002,Rep. of Moldova,MDA,Russian Federation,RUS,0,0,19,0,19
2002,Somalia,SOM,Russian Federation,RUS,0,0,5,0,5
2002,Sudan,SDN,Russian Federation,RUS,0,0,5,0,5
2002,Tajikistan,TJK,Russian Federation,RUS,0,0,12,0,12
2002,Turkmenistan,TKM,Russian Federation,RUS,0,0,5,0,5
2002,Uzbekistan,UZB,Russian Federation,RUS,0,0,35,0,35
2002,Colombia,COL,El Salvador,SLV,5,0,0,0,5
2002,Benin,BEN,Senegal,SEN,0,0,0,5,5
2002,Burkina Faso,BFA,Senegal,SEN,0,0,0,5,5
2002,Central African Rep.,CAF,Senegal,SEN,5,0,12,5,22
2002,Chad,TCD,Senegal,SEN,0,0,5,0,5
2002,Congo,COG,Senegal,SEN,0,0,11,0,11
2002,Dem. Rep. of the Congo,COD,Senegal,SEN,0,0,19,0,19
2002,Gambia,GMB,Senegal,SEN,0,0,10,0,10
2002,Guinea-Bissau,GNB,Senegal,SEN,0,0,5,528,533
2002,Guinea,GIN,Senegal,SEN,0,0,5,0,5
2002,India,IND,Senegal,SEN,0,0,0,10,10
2002,Iraq,IRQ,Senegal,SEN,0,0,0,5,5
2002,Liberia,LBR,Senegal,SEN,13,0,24,0,37
2002,Mauritania,MRT,Senegal,SEN,0,0,0,297,297
2002,Mali,MLI,Senegal,SEN,0,0,0,5,5
2002,Nigeria,NGA,Senegal,SEN,0,0,23,78,101
2002,Pakistan,PAK,Senegal,SEN,0,0,0,5,5
2002,Rwanda,RWA,Senegal,SEN,0,0,30,0,30
2002,Sierra Leone,SLE,Senegal,SEN,5,0,82,0,87
2002,Somalia,SOM,Senegal,SEN,0,0,5,0,5
2002,Sudan,SDN,Senegal,SEN,0,0,0,5,5
2002,Togo,TGO,Senegal,SEN,0,0,5,0,5
2002,Afghanistan,AFG,Spain,ESP,0,0,26,10,36
2002,Albania,ALB,Spain,ESP,0,0,10,19,29
2002,Algeria,DZA,Spain,ESP,0,11,25,260,296
2002,Angola,AGO,Spain,ESP,0,0,45,64,109
2002,Argentina,ARG,Spain,ESP,0,0,0,10,10
2002,Armenia,ARM,Spain,ESP,5,11,35,40,91
2002,Azerbaijan,AZE,Spain,ESP,0,0,14,5,19
2002,Burundi,BDI,Spain,ESP,0,0,5,0,5
2002,Benin,BEN,Spain,ESP,0,0,0,5,5
2002,Bangladesh,BGD,Spain,ESP,0,0,0,13,13
2002,Belarus,BLR,Spain,ESP,5,0,0,10,15
2002,Bolivia (Plurinational State of),BOL,Spain,ESP,0,0,0,5,5
2002,Bosnia and Herzegovina,BIH,Spain,ESP,0,0,17,16,33
2002,China,CHN,Spain,ESP,0,0,5,5,10
2002,Cameroon,CMR,Spain,ESP,0,0,5,19,24
2002,Congo,COG,Spain,ESP,0,0,15,13,28
2002,Dem. Rep. of the Congo,COD,Spain,ESP,10,0,70,125,205
2002,Colombia,COL,Spain,ESP,42,5,306,742,1095
2002,Cuba,CUB,Spain,ESP,12,0,57,1132,1201
2002,Czechia,CZE,Spain,ESP,0,0,5,5,10
2002,Ecuador,ECU,Spain,ESP,0,0,5,40,45
2002,Equatorial Guinea,GNQ,Spain,ESP,16,10,25,10,61
2002,Eritrea,ERI,Spain,ESP,5,0,0,0,5
2002,Ethiopia,ETH,Spain,ESP,10,0,39,10,59
2002,Gambia,GMB,Spain,ESP,0,0,0,10,10
2002,Georgia,GEO,Spain,ESP,0,0,19,48,67
2002,Ghana,GHA,Spain,ESP,0,0,0,32,32
2002,Guinea-Bissau,GNB,Spain,ESP,0,0,0,5,5
2002,Guatemala,GTM,Spain,ESP,0,0,5,0,5
2002,Guinea,GIN,Spain,ESP,0,0,10,25,35
2002,Haiti,HTI,Spain,ESP,5,0,0,0,5
2002,Croatia,HRV,Spain,ESP,0,0,0,5,5
2002,Cote d'Ivoire,CIV,Spain,ESP,0,0,0,19,19
2002,India,IND,Spain,ESP,0,0,5,0,5
2002,Iran (Islamic Rep. of),IRN,Spain,ESP,5,0,15,5,25
2002,Iraq,IRQ,Spain,ESP,0,5,33,38,76
2002,Kazakhstan,KAZ,Spain,ESP,0,0,40,0,40
2002,Liberia,LBR,Spain,ESP,0,0,5,21,26
2002,Lebanon,LBN,Spain,ESP,0,0,0,11,11
2002,Sri Lanka,LKA,Spain,ESP,0,0,0,10,10
2002,Lithuania,LTU,Spain,ESP,0,0,5,0,5
2002,Latvia,LVA,Spain,ESP,11,0,0,0,11
2002,Mauritania,MRT,Spain,ESP,0,0,0,14,14
2002,North Macedonia,MKD,Spain,ESP,0,0,0,15,15
2002,Rep. of Moldova,MDA,Spain,ESP,5,0,29,13,47
2002,Mali,MLI,Spain,ESP,0,0,0,21,21
2002,Morocco,MAR,Spain,ESP,0,0,5,29,34
2002,Myanmar,MMR,Spain,ESP,0,0,5,0,5
2002,Niger,NER,Spain,ESP,0,0,0,5,5
2002,Nigeria,NGA,Spain,ESP,0,5,73,1224,1302
2002,Pakistan,PAK,Spain,ESP,0,0,5,16,21
2002,Peru,PER,Spain,ESP,0,0,0,13,13
2002,Romania,ROU,Spain,ESP,0,0,5,169,174
2002,Russian Federation,RUS,Spain,ESP,23,19,111,101,254
2002,Rwanda,RWA,Spain,ESP,0,0,14,0,14
2002,Serbia and Kosovo: S/RES/1244 (1999),SRB,Spain,ESP,5,5,19,21,50
2002,Senegal,SEN,Spain,ESP,0,0,0,5,5
2002,Sierra Leone,SLE,Spain,ESP,0,0,77,290,367
2002,Somalia,SOM,Spain,ESP,0,0,20,5,25
2002,Sudan,SDN,Spain,ESP,0,0,5,50,55
2002,Slovakia,SVK,Spain,ESP,0,0,5,0,5
2002,Syrian Arab Rep.,SYR,Spain,ESP,0,0,0,5,5
2002,United Rep. of Tanzania,TZA,Spain,ESP,0,0,0,5,5
2002,Togo,TGO,Spain,ESP,0,0,5,5,10
2002,Tunisia,TUN,Spain,ESP,5,0,0,5,10
2002,Turkey,TUR,Spain,ESP,0,0,10,13,23
2002,Ukraine,UKR,Spain,ESP,5,0,151,73,229
2002,Uzbekistan,UZB,Spain,ESP,0,0,0,5,5
2002,Stateless,XXA,Spain,ESP,0,0,0,31,31
2002,Afghanistan,AFG,Slovakia,SVK,5,0,30,2680,2715
2002,Algeria,DZA,Slovakia,SVK,0,0,0,32,32
2002,Angola,AGO,Slovakia,SVK,0,0,5,0,5
2002,Egypt,EGY,Slovakia,SVK,0,0,0,5,5
2002,Armenia,ARM,Slovakia,SVK,0,0,5,13,18
2002,Azerbaijan,AZE,Slovakia,SVK,0,0,5,5,10
2002,Bangladesh,BGD,Slovakia,SVK,0,0,46,483,529
2002,Belarus,BLR,Slovakia,SVK,0,0,0,5,5
2002,China,CHN,Slovakia,SVK,0,0,5,862,867
2002,Cameroon,CMR,Slovakia,SVK,0,0,0,5,5
2002,Congo,COG,Slovakia,SVK,0,0,0,5,5
2002,Eritrea,ERI,Slovakia,SVK,0,0,0,5,5
2002,Ethiopia,ETH,Slovakia,SVK,0,0,0,11,11
2002,Georgia,GEO,Slovakia,SVK,0,0,5,36,41
2002,Ghana,GHA,Slovakia,SVK,0,0,0,18,18
2002,India,IND,Slovakia,SVK,0,0,42,1105,1147
2002,Iran (Islamic Rep. of),IRN,Slovakia,SVK,0,0,0,85,85
2002,Iraq,IRQ,Slovakia,SVK,0,0,12,1228,1240
2002,Sri Lanka,LKA,Slovakia,SVK,0,0,5,57,62
2002,North Macedonia,MKD,Slovakia,SVK,0,0,5,11,16
2002,Rep. of Moldova,MDA,Slovakia,SVK,0,0,17,197,214
2002,Morocco,MAR,Slovakia,SVK,0,0,0,5,5
2002,Nepal,NPL,Slovakia,SVK,0,0,0,65,65
2002,Nigeria,NGA,Slovakia,SVK,0,0,0,59,59
2002,Pakistan,PAK,Slovakia,SVK,0,0,11,146,157
2002,Russian Federation,RUS,Slovakia,SVK,0,0,57,271,328
2002,Rwanda,RWA,Slovakia,SVK,0,0,0,0,5
2002,Serbia and Kosovo: S/RES/1244 (1999),SRB,Slovakia,SVK,5,0,11,17,33
2002,Senegal,SEN,Slovakia,SVK,0,0,11,0,11
2002,Sierra Leone,SLE,Slovakia,SVK,0,0,5,87,92
2002,Somalia,SOM,Slovakia,SVK,0,0,0,223,223
2002,Viet Nam,VNM,Slovakia,SVK,0,0,0,146,146
2002,Sudan,SDN,Slovakia,SVK,0,0,0,51,51
2002,Syrian Arab Rep.,SYR,Slovakia,SVK,0,0,0,17,17
2002,Turkey,TUR,Slovakia,SVK,0,0,0,34,34
2002,Ukraine,UKR,Slovakia,SVK,0,0,10,10,20
2002,Uzbekistan,UZB,Slovakia,SVK,0,0,0,5,5
2002,Stateless,XXA,Slovakia,SVK,0,0,0,5,5
2002,Afghanistan,AFG,Slovenia,SVN,0,0,5,10,15
2002,Algeria,DZA,Slovenia,SVN,0,0,10,59,69
2002,Armenia,ARM,Slovenia,SVN,0,0,5,0,5
2002,Bangladesh,BGD,Slovenia,SVN,0,0,0,10,10
2002,Bosnia and Herzegovina,BIH,Slovenia,SVN,0,0,5,16,21
2002,Bulgaria,BGR,Slovenia,SVN,0,0,0,5,5
2002,China,CHN,Slovenia,SVN,0,0,11,0,11
2002,Georgia,GEO,Slovenia,SVN,0,0,0,10,10
2002,India,IND,Slovenia,SVN,0,0,0,5,5
2002,Iran (Islamic Rep. of),IRN,Slovenia,SVN,0,0,48,95,143
2002,Iraq,IRQ,Slovenia,SVN,0,0,28,94,122
2002,Liberia,LBR,Slovenia,SVN,0,0,0,5,5
2002,North Macedonia,MKD,Slovenia,SVN,0,0,25,15,40
2002,Rep. of Moldova,MDA,Slovenia,SVN,0,0,5,10,15
2002,Morocco,MAR,Slovenia,SVN,0,0,0,5,5
2002,Nigeria,NGA,Slovenia,SVN,0,0,0,10,10
2002,Pakistan,PAK,Slovenia,SVN,0,0,5,22,27
2002,Russian Federation,RUS,Slovenia,SVN,0,0,0,19,19
2002,Serbia and Kosovo: S/RES/1244 (1999),SRB,Slovenia,SVN,0,0,43,73,116
2002,Sierra Leone,SLE,Slovenia,SVN,0,0,5,14,19
2002,Somalia,SOM,Slovenia,SVN,0,0,0,10,10
2002,Sudan,SDN,Slovenia,SVN,0,0,5,0,5
2002,Tunisia,TUN,Slovenia,SVN,0,0,0,5,5
2002,Turkey,TUR,Slovenia,SVN,0,0,0,104,104
2002,Ukraine,UKR,Slovenia,SVN,0,0,0,5,5
2002,Afghanistan,AFG,Sweden,SWE,5,338,109,24,476
2002,Albania,ALB,Sweden,SWE,0,11,161,23,195
2002,Algeria,DZA,Sweden,SWE,0,5,142,48,195
2002,Angola,AGO,Sweden,SWE,0,24,5,0,29
2002,Egypt,EGY,Sweden,SWE,0,10,86,5,101
2002,Argentina,ARG,Sweden,SWE,0,0,10,0,10
2002,Armenia,ARM,Sweden,SWE,0,24,202,30,256
2002,Austria,AUT,Sweden,SWE,0,0,5,0,5
2002,Azerbaijan,AZE,Sweden,SWE,5,12,152,25,194
2002,Burundi,BDI,Sweden,SWE,5,78,0,0,83
2002,Bangladesh,BGD,Sweden,SWE,0,14,171,10,195
2002,Belarus,BLR,Sweden,SWE,0,0,239,103,342
2002,Bolivia (Plurinational State of),BOL,Sweden,SWE,0,0,101,12,113
2002,Brazil,BRA,Sweden,SWE,0,0,5,0,5
2002,Bosnia and Herzegovina,BIH,Sweden,SWE,0,108,3077,408,3593
2002,Bulgaria,BGR,Sweden,SWE,0,0,623,68,691
2002,Cambodia,KHM,Sweden,SWE,0,0,14,0,14
2002,China,CHN,Sweden,SWE,5,0,37,5,47
2002,Chile,CHL,Sweden,SWE,0,0,11,10,21
2002,Cameroon,CMR,Sweden,SWE,5,0,0,0,5
2002,Congo,COG,Sweden,SWE,0,12,0,0,12
2002,Dem. Rep. of the Congo,COD,Sweden,SWE,5,16,53,0,74
2002,Colombia,COL,Sweden,SWE,5,10,41,12,68
2002,Cuba,CUB,Sweden,SWE,0,5,23,0,28
2002,Czechia,CZE,Sweden,SWE,0,0,146,29,175
2002,Ecuador,ECU,Sweden,SWE,0,5,148,11,164
2002,Eritrea,ERI,Sweden,SWE,5,20,108,5,138
2002,Estonia,EST,Sweden,SWE,0,0,14,0,14
2002,Ethiopia,ETH,Sweden,SWE,0,0,84,5,89
2002,Gambia,GMB,Sweden,SWE,0,0,19,5,24
2002,Georgia,GEO,Sweden,SWE,0,0,177,57,234
2002,Germany,DEU,Sweden,SWE,0,0,5,0,5
2002,Guatemala,GTM,Sweden,SWE,0,0,0,5,5
2002,Guinea,GIN,Sweden,SWE,0,0,57,5,62
2002,Honduras,HND,Sweden,SWE,0,0,5,0,5
2002,Croatia,HRV,Sweden,SWE,0,12,444,73,529
2002,Hungary,HUN,Sweden,SWE,0,0,14,0,14
2002,Cote d'Ivoire,CIV,Sweden,SWE,5,0,10,0,15
2002,India,IND,Sweden,SWE,0,0,42,5,47
2002,Iran (Islamic Rep. of),IRN,Sweden,SWE,44,68,631,88,831
2002,Iraq,IRQ,Sweden,SWE,93,2959,1698,296,5046
2002,Israel,ISR,Sweden,SWE,0,0,55,5,60
2002,Jordan,JOR,Sweden,SWE,0,0,61,5,66
2002,Kenya,KEN,Sweden,SWE,0,0,5,0,5
2002,Kyrgyzstan,KGZ,Sweden,SWE,0,22,156,17,195
2002,Liberia,LBR,Sweden,SWE,0,0,14,0,14
2002,Libya,LBY,Sweden,SWE,0,5,108,41,154
2002,Lebanon,LBN,Sweden,SWE,0,5,161,36,202
2002,Sri Lanka,LKA,Sweden,SWE,0,0,29,10,39
2002,Lithuania,LTU,Sweden,SWE,0,5,77,15,97
2002,Latvia,LVA,Sweden,SWE,0,0,20,0,20
2002,Mauritania,MRT,Sweden,SWE,0,0,5,0,5
2002,North Macedonia,MKD,Sweden,SWE,0,10,456,41,507
2002,Rep. of Moldova,MDA,Sweden,SWE,0,0,245,50,295
2002,Mongolia,MNG,Sweden,SWE,0,0,351,58,409
2002,Morocco,MAR,Sweden,SWE,0,5,23,5,33
2002,Myanmar,MMR,Sweden,SWE,0,0,5,0,5
2002,Nepal,NPL,Sweden,SWE,0,0,5,0,5
2002,Niger,NER,Sweden,SWE,0,0,5,0,5
2002,Nigeria,NGA,Sweden,SWE,0,0,43,11,54
2002,Pakistan,PAK,Sweden,SWE,0,5,61,11,77
2002,Peru,PER,Sweden,SWE,0,5,89,10,104
2002,Philippines,PHL,Sweden,SWE,0,0,14,0,14
2002,Poland,POL,Sweden,SWE,0,5,32,0,37
2002,Romania,ROU,Sweden,SWE,0,0,287,154,441
2002,Russian Federation,RUS,Sweden,SWE,5,65,718,146,934
2002,Rwanda,RWA,Sweden,SWE,0,10,0,0,10
2002,El Salvador,SLV,Sweden,SWE,0,0,445,55,500
2002,Serbia and Kosovo: S/RES/1244 (1999),SRB,Sweden,SWE,49,447,3388,593,4477
2002,Senegal,SEN,Sweden,SWE,0,0,0,5,5
2002,Sierra Leone,SLE,Sweden,SWE,0,5,24,0,29
2002,Somalia,SOM,Sweden,SWE,5,276,56,30,367
2002,Viet Nam,VNM,Sweden,SWE,0,10,11,12,33
2002,Sudan,SDN,Sweden,SWE,0,0,14,0,14
2002,Slovakia,SVK,Sweden,SWE,0,0,592,167,759
2002,Sweden,SWE,Sweden,SWE,0,0,0,5,5
2002,Syrian Arab Rep.,SYR,Sweden,SWE,5,53,429,37,524
2002,United Rep. of Tanzania,TZA,Sweden,SWE,0,0,5,0,5
2002,Thailand,THA,Sweden,SWE,0,0,5,0,5
2002,Tajikistan,TJK,Sweden,SWE,0,0,13,0,13
2002,Turkmenistan,TKM,Sweden,SWE,0,0,11,5,16
2002,Togo,TGO,Sweden,SWE,0,0,5,0,5
2002,Tunisia,TUN,Sweden,SWE,5,5,27,10,47
2002,Turkey,TUR,Sweden,SWE,0,33,401,46,480
2002,Uganda,UGA,Sweden,SWE,0,0,14,0,14
2002,Ukraine,UKR,Sweden,SWE,0,5,439,67,511
2002,Uzbekistan,UZB,Sweden,SWE,5,12,350,48,415
2002,Venezuela (Bolivarian Republic of),VEN,Sweden,SWE,0,0,10,0,10
2002,Yemen,YEM,Sweden,SWE,0,5,12,0,17
2002,Zimbabwe,ZWE,Sweden,SWE,0,5,5,0,10
2002,Stateless,XXA,Sweden,SWE,5,122,290,67,484
2002,Afghanistan,AFG,Switzerland,CHE,41,13,155,79,288
2002,Albania,ALB,Switzerland,CHE,0,17,35,133,185
2002,Algeria,DZA,Switzerland,CHE,15,19,651,350,1035
2002,Angola,AGO,Switzerland,CHE,0,330,564,96,990
2002,Egypt,EGY,Switzerland,CHE,0,0,5,5,10
2002,Armenia,ARM,Switzerland,CHE,5,23,221,271,520
2002,Azerbaijan,AZE,Switzerland,CHE,0,0,39,53,92
2002,Burundi,BDI,Switzerland,CHE,5,20,20,10,55
2002,Belgium,BEL,Switzerland,CHE,0,0,0,5,5
2002,Benin,BEN,Switzerland,CHE,0,0,59,32,91
2002,Bangladesh,BGD,Switzerland,CHE,0,11,131,119,261
2002,Burkina Faso,BFA,Switzerland,CHE,0,5,43,23,71
2002,Belarus,BLR,Switzerland,CHE,0,0,51,159,210
2002,Brazil,BRA,Switzerland,CHE,0,0,5,0,5
2002,Bosnia and Herzegovina,BIH,Switzerland,CHE,155,647,778,261,1841
2002,Bulgaria,BGR,Switzerland,CHE,0,0,137,667,804
2002,Cambodia,KHM,Switzerland,CHE,12,0,5,0,17
2002,Chad,TCD,Switzerland,CHE,0,0,13,10,23
2002,China,CHN,Switzerland,CHE,15,0,19,30,64
2002,Cameroon,CMR,Switzerland,CHE,5,5,209,130,349
2002,Congo,COG,Switzerland,CHE,5,0,39,16,60
2002,Dem. Rep. of the Congo,COD,Switzerland,CHE,33,204,577,124,938
2002,Colombia,COL,Switzerland,CHE,12,10,35,16,73
2002,Cuba,CUB,Switzerland,CHE,0,0,5,5,10
2002,Czechia,CZE,Switzerland,CHE,0,0,64,30,94
2002,Ecuador,ECU,Switzerland,CHE,0,0,0,5,5
2002,Eritrea,ERI,Switzerland,CHE,0,21,80,17,118
2002,Estonia,EST,Switzerland,CHE,0,0,0,5,5
2002,Ethiopia,ETH,Switzerland,CHE,5,37,285,37,364
2002,France,FRA,Switzerland,CHE,0,0,10,5,15
2002,Gabon,GAB,Switzerland,CHE,0,0,13,0,13
2002,Gambia,GMB,Switzerland,CHE,0,0,5,25,30
2002,United Kingdom of Great Britain and Northern Ireland,GBR,Switzerland,CHE,0,0,5,0,5
2002,Georgia,GEO,Switzerland,CHE,0,19,297,244,560
2002,Germany,DEU,Switzerland,CHE,0,0,0,5,5
2002,Ghana,GHA,Switzerland,CHE,0,0,5,33,38
2002,Guinea-Bissau,GNB,Switzerland,CHE,0,0,19,53,72
2002,Guinea,GIN,Switzerland,CHE,0,0,436,351,787
2002,Haiti,HTI,Switzerland,CHE,0,0,0,5,5
2002,Croatia,HRV,Switzerland,CHE,5,0,24,22,51
2002,Hungary,HUN,Switzerland,CHE,0,0,5,0,5
2002,Cote d'Ivoire,CIV,Switzerland,CHE,0,0,57,62,119
2002,India,IND,Switzerland,CHE,0,0,64,99,163
2002,Iran (Islamic Rep. of),IRN,Switzerland,CHE,29,17,271,60,377
2002,Iraq,IRQ,Switzerland,CHE,352,377,697,359,1785
2002,Israel,ISR,Switzerland,CHE,0,0,5,12,17
2002,Jordan,JOR,Switzerland,CHE,0,0,0,5,5
2002,Kazakhstan,KAZ,Switzerland,CHE,5,0,28,22,55
2002,Kenya,KEN,Switzerland,CHE,0,0,13,10,23
2002,Kyrgyzstan,KGZ,Switzerland,CHE,0,0,5,13,18
2002,Lao People's Dem. Rep.,LAO,Switzerland,CHE,5,0,0,0,5
2002,Liberia,LBR,Switzerland,CHE,0,0,45,51,96
2002,Libya,LBY,Switzerland,CHE,30,0,31,27,88
2002,Lebanon,LBN,Switzerland,CHE,0,5,31,109,145
2002,Sri Lanka,LKA,Switzerland,CHE,90,235,418,132,875
2002,Lithuania,LTU,Switzerland,CHE,0,0,5,94,99
2002,Latvia,LVA,Switzerland,CHE,0,0,5,10,15
2002,Mauritania,MRT,Switzerland,CHE,0,0,23,70,93
2002,North Macedonia,MKD,Switzerland,CHE,5,15,866,413,1299
2002,Rep. of Moldova,MDA,Switzerland,CHE,0,0,20,122,142
2002,Mali,MLI,Switzerland,CHE,0,0,103,58,161
2002,Mongolia,MNG,Switzerland,CHE,0,5,19,203,227
2002,Morocco,MAR,Switzerland,CHE,0,0,5,34,39
2002,Nepal,NPL,Switzerland,CHE,0,0,0,42,42
2002,Niger,NER,Switzerland,CHE,0,0,40,264,304
2002,Nigeria,NGA,Switzerland,CHE,0,5,651,10,666
2002,Pakistan,PAK,Switzerland,CHE,0,15,113,117,245
2002,Peru,PER,Switzerland,CHE,0,0,5,0,5
2002,Poland,POL,Switzerland,CHE,0,0,5,21,26
2002,Portugal,PRT,Switzerland,CHE,0,0,0,5,5
2002,Romania,ROU,Switzerland,CHE,0,0,17,934,951
2002,South Africa,ZAF,Switzerland,CHE,0,0,10,0,10
2002,Russian Federation,RUS,Switzerland,CHE,0,24,170,233,427
2002,Rwanda,RWA,Switzerland,CHE,31,10,12,5,58
2002,Serbia and Kosovo: S/RES/1244 (1999),SRB,Switzerland,CHE,169,1610,2238,1539,5556
2002,Senegal,SEN,Switzerland,CHE,0,0,5,20,25
2002,Sierra Leone,SLE,Switzerland,CHE,0,5,298,174,477
2002,Somalia,SOM,Switzerland,CHE,24,257,258,56,595
2002,Viet Nam,VNM,Switzerland,CHE,50,5,19,10,84
2002,Sudan,SDN,Switzerland,CHE,5,0,32,13,50
2002,Slovakia,SVK,Switzerland,CHE,0,0,49,20,69
2002,Slovenia,SVN,Switzerland,CHE,0,0,0,19,19
2002,Syrian Arab Rep.,SYR,Switzerland,CHE,27,26,67,63,183
2002,United Rep. of Tanzania,TZA,Switzerland,CHE,0,0,12,0,12
2002,Tajikistan,TJK,Switzerland,CHE,0,0,0,10,10
2002,Togo,TGO,Switzerland,CHE,14,0,101,41,156
2002,Tunisia,TUN,Switzerland,CHE,89,0,42,56,187
2002,Turkey,TUR,Switzerland,CHE,460,146,915,381,1902
2002,United Arab Emirates,ARE,Switzerland,CHE,0,0,0,5,5
2002,Uganda,UGA,Switzerland,CHE,0,0,14,5,19
2002,Ukraine,UKR,Switzerland,CHE,5,0,55,131,191
2002,Uzbekistan,UZB,Switzerland,CHE,0,0,12,5,17
2002,Western Sahara,ESH,Switzerland,CHE,0,0,0,5,5
2002,Yemen,YEM,Switzerland,CHE,11,5,53,0,69
2002,Zimbabwe,ZWE,Switzerland,CHE,0,0,5,5,10
2002,Stateless,XXA,Switzerland,CHE,0,0,5,0,5
2002,Rwanda,RWA,United Rep. of Tanzania,TZA,21207,0,0,0,21207
2002,Afghanistan,AFG,Tajikistan,TJK,0,0,0,174,174
2002,Burundi,BDI,Uganda,UGA,100,0,0,33,133
2002,Dem. Rep. of the Congo,COD,Uganda,UGA,1288,0,39,178,1505
2002,Eritrea,ERI,Uganda,UGA,0,0,0,11,11
2002,Ethiopia,ETH,Uganda,UGA,51,0,10,26,87
2002,Kenya,KEN,Uganda,UGA,11,0,0,0,11
2002,Liberia,LBR,Uganda,UGA,0,0,5,0,5
2002,Pakistan,PAK,Uganda,UGA,0,0,0,5,5
2002,Rwanda,RWA,Uganda,UGA,114,0,33,104,251
2002,Somalia,SOM,Uganda,UGA,79,0,5,38,122
2002,Sudan,SDN,Uganda,UGA,145,0,0,25,170
2002,Angola,AGO,Zambia,ZMB,5,0,0,0,5
2002,Burundi,BDI,Zambia,ZMB,18,0,10,182,26
2002,Dem. Rep. of the Congo,COD,Zambia,ZMB,52,0,33,0,85
2002,Rwanda,RWA,Zambia,ZMB,59,0,10,0,69
2002,Somalia,SOM,Zambia,ZMB,5,0,0,0,5
2002,Angola,AGO,Zimbabwe,ZWE,5,0,0,0,5
2002,Burundi,BDI,Zimbabwe,ZWE,58,0,0,0,58
2002,Dem. Rep. of the Congo,COD,Zimbabwe,ZWE,513,0,33,0,546
2002,Eritrea,ERI,Zimbabwe,ZWE,5,0,0,0,5
2002,Ethiopia,ETH,Zimbabwe,ZWE,10,0,0,0,10
2002,Rwanda,RWA,Zimbabwe,ZWE,122,0,5,0,127
2002,Sudan,SDN,Zimbabwe,ZWE,10,0,0,0,10
2003,India,IND,Albania,ALB,0,0,0,5,5
2003,Iraq,IRQ,Albania,ALB,0,5,0,0,5
2003,Serbia and Kosovo: S/RES/1244 (1999),SRB,Albania,ALB,5,0,10,11,26
2003,Turkey,TUR,Albania,ALB,0,0,5,5,10
2003,Congo,COG,Angola,AGO,5,0,0,0,5
2003,Dem. Rep. of the Congo,COD,Angola,AGO,5,0,32,0,37
2003,Cote d'Ivoire,CIV,Angola,AGO,0,0,10,0,10
2003,Liberia,LBR,Angola,AGO,5,0,0,0,5
2003,Sierra Leone,SLE,Angola,AGO,0,0,10,0,10
2003,Albania,ALB,Argentina,ARG,0,0,5,0,5
2003,Angola,AGO,Argentina,ARG,5,0,0,0,5
2003,Armenia,ARM,Argentina,ARG,12,0,44,10,66
2003,Bangladesh,BGD,Argentina,ARG,0,0,0,5,5
2003,Colombia,COL,Argentina,ARG,0,0,0,12,12
2003,Cuba,CUB,Argentina,ARG,10,0,5,34,49
2003,Ghana,GHA,Argentina,ARG,0,0,0,5,5
2003,Haiti,HTI,Argentina,ARG,0,0,0,10,10
2003,India,IND,Argentina,ARG,5,0,0,5,10
2003,Liberia,LBR,Argentina,ARG,5,0,0,0,5
2003,Sri Lanka,LKA,Argentina,ARG,0,0,0,5,5
2003,Nigeria,NGA,Argentina,ARG,5,0,0,5,10
2003,Pakistan,PAK,Argentina,ARG,5,0,0,0,5
2003,Peru,PER,Argentina,ARG,18,0,145,105,268
2003,Romania,ROU,Argentina,ARG,0,0,0,28,28
2003,Russian Federation,RUS,Argentina,ARG,0,0,13,5,18
2003,Senegal,SEN,Argentina,ARG,5,0,5,10,20
2003,Sierra Leone,SLE,Argentina,ARG,18,0,0,5,23
2003,Ukraine,UKR,Argentina,ARG,0,0,0,12,12
2003,Iran (Islamic Rep. of),IRN,Armenia,ARM,0,0,5,0,5
2003,Iraq,IRQ,Armenia,ARM,0,28,10,0,38
2003,Afghanistan,AFG,Australia,AUS,20,0,10,0,30
2003,Albania,ALB,Australia,AUS,0,0,32,5,37
2003,Egypt,EGY,Australia,AUS,5,0,55,0,60
2003,Argentina,ARG,Australia,AUS,0,0,15,0,15
2003,Bahrain,BHR,Australia,AUS,0,0,5,0,5
2003,Burundi,BDI,Australia,AUS,0,0,5,0,5
2003,Bangladesh,BGD,Australia,AUS,5,0,114,5,124
2003,Belarus,BLR,Australia,AUS,0,0,5,0,5
2003,Brazil,BRA,Australia,AUS,0,0,27,0,27
2003,Cambodia,KHM,Australia,AUS,0,0,13,0,13
2003,China,CHN,Australia,AUS,17,0,833,28,878
2003,Chile,CHL,Australia,AUS,0,0,5,0,5
2003,Congo,COG,Australia,AUS,0,0,5,0,5
2003,Colombia,COL,Australia,AUS,5,0,16,0,21
2003,Cyprus,CYP,Australia,AUS,0,0,5,0,5
2003,Ecuador,ECU,Australia,AUS,0,0,5,0,5
2003,Ethiopia,ETH,Australia,AUS,5,0,5,0,10
2003,Fiji,FJI,Australia,AUS,0,0,160,10,170
2003,France,FRA,Australia,AUS,0,0,0,5,5
2003,United Kingdom of Great Britain and Northern Ireland,GBR,Australia,AUS,0,0,0,5,5
2003,Germany,DEU,Australia,AUS,0,0,5,0,5
2003,Ghana,GHA,Australia,AUS,0,0,10,0,10
2003,Greece,GRC,Australia,AUS,0,0,5,0,5
2003,Guyana,GUY,Australia,AUS,0,0,5,0,5
2003,"China, Hong Kong SAR",HKG,Australia,AUS,0,0,15,0,15
2003,India,IND,Australia,AUS,0,0,639,5,644
2003,Indonesia,IDN,Australia,AUS,5,0,847,83,935
2003,Iran (Islamic Rep. of),IRN,Australia,AUS,29,0,42,12,83
2003,Iraq,IRQ,Australia,AUS,103,0,5,10,118
2003,Israel,ISR,Australia,AUS,0,0,19,5,24
2003,Italy,ITA,Australia,AUS,0,0,5,0,5
2003,Jordan,JOR,Australia,AUS,0,0,13,5,18
2003,Japan,JPN,Australia,AUS,0,0,5,0,5
2003,Kenya,KEN,Australia,AUS,0,0,20,0,20
2003,Rep. of Korea,KOR,Australia,AUS,0,0,222,15,237
2003,Lao People's Dem. Rep.,LAO,Australia,AUS,0,0,5,0,5
2003,Libya,LBY,Australia,AUS,0,0,5,0,5
2003,Lebanon,LBN,Australia,AUS,0,0,92,5,97
2003,Sri Lanka,LKA,Australia,AUS,18,0,135,10,163
2003,Lithuania,LTU,Australia,AUS,0,0,18,0,18
2003,North Macedonia,MKD,Australia,AUS,0,0,12,0,12
2003,Malaysia,MYS,Australia,AUS,0,0,182,10,192
2003,Mongolia,MNG,Australia,AUS,0,0,13,0,13
2003,Morocco,MAR,Australia,AUS,0,0,5,0,5
2003,Myanmar,MMR,Australia,AUS,5,0,13,10,28
2003,Nepal,NPL,Australia,AUS,0,0,48,0,48
2003,Nigeria,NGA,Australia,AUS,0,0,37,0,37
2003,Norway,NOR,Australia,AUS,0,0,0,5,5
2003,Oman,OMN,Australia,AUS,0,0,5,0,5
2003,Pakistan,PAK,Australia,AUS,5,0,53,0,58
2003,Peru,PER,Australia,AUS,0,0,10,0,10
2003,Philippines,PHL,Australia,AUS,0,0,45,5,50
2003,Papua New Guinea,PNG,Australia,AUS,0,0,5,5,10
2003,Poland,POL,Australia,AUS,0,0,16,0,16
2003,Portugal,PRT,Australia,AUS,0,0,10,5,15
2003,Romania,ROU,Australia,AUS,0,0,11,0,11
2003,South Africa,ZAF,Australia,AUS,5,0,12,0,17
2003,Russian Federation,RUS,Australia,AUS,5,0,33,0,38
2003,Serbia and Kosovo: S/RES/1244 (1999),SRB,Australia,AUS,5,0,22,0,27
2003,Singapore,SGP,Australia,AUS,0,0,5,0,5
2003,Solomon Islands,SLB,Australia,AUS,0,0,12,0,12
2003,Viet Nam,VNM,Australia,AUS,0,0,102,0,102
2003,Sudan,SDN,Australia,AUS,0,0,10,0,10
2003,Syrian Arab Rep.,SYR,Australia,AUS,0,0,15,0,15
2003,Thailand,THA,Australia,AUS,0,0,181,5,186
2003,Timor-Leste,TLS,Australia,AUS,0,0,177,20,197
2003,Tonga,TON,Australia,AUS,0,0,58,10,68
2003,Turkey,TUR,Australia,AUS,0,0,45,5,50
2003,Uganda,UGA,Australia,AUS,0,0,5,0,5
2003,Ukraine,UKR,Australia,AUS,0,0,23,0,23
2003,Uruguay,URY,Australia,AUS,0,0,14,0,14
2003,Uzbekistan,UZB,Australia,AUS,0,0,5,0,5
2003,Venezuela (Bolivarian Republic of),VEN,Australia,AUS,0,0,5,0,5
2003,Zambia,ZMB,Australia,AUS,0,0,5,0,5
2003,Zimbabwe,ZWE,Australia,AUS,10,0,38,10,58
2003,Stateless,XXA,Australia,AUS,5,0,15,5,25
2003,Dem. Rep. of the Congo,COD,Burundi,BDI,17,0,0,0,17
2003,Afghanistan,AFG,Belgium,BEL,234,0,590,92,916
2003,Albania,ALB,Belgium,BEL,26,0,94,42,162
2003,Algeria,DZA,Belgium,BEL,19,0,201,35,255
2003,Angola,AGO,Belgium,BEL,5,0,46,15,66
2003,Armenia,ARM,Belgium,BEL,5,0,38,5,48
2003,Azerbaijan,AZE,Belgium,BEL,0,0,13,5,18
2003,Burundi,BDI,Belgium,BEL,39,0,27,0,66
2003,Bangladesh,BGD,Belgium,BEL,0,0,20,10,30
2003,Bhutan,BTN,Belgium,BEL,0,0,14,5,19
2003,Bosnia and Herzegovina,BIH,Belgium,BEL,25,0,46,13,84
2003,Bulgaria,BGR,Belgium,BEL,0,0,40,10,50
2003,Central African Rep.,CAF,Belgium,BEL,5,0,0,0,5
2003,Chad,TCD,Belgium,BEL,5,0,0,0,5
2003,China,CHN,Belgium,BEL,11,0,5,0,16
2003,Chile,CHL,Belgium,BEL,0,0,0,5,5
2003,Cameroon,CMR,Belgium,BEL,5,0,58,5,68
2003,Congo,COG,Belgium,BEL,0,0,0,12,12
2003,Dem. Rep. of the Congo,COD,Belgium,BEL,124,0,614,112,850
2003,Colombia,COL,Belgium,BEL,0,0,36,10,46
2003,Cuba,CUB,Belgium,BEL,0,0,5,0,5
2003,Djibouti,DJI,Belgium,BEL,5,0,0,12,17
2003,Ethiopia,ETH,Belgium,BEL,5,0,0,0,5
2003,Palestinian,PSE,Belgium,BEL,5,0,21,5,31
2003,Georgia,GEO,Belgium,BEL,16,0,162,30,208
2003,Ghana,GHA,Belgium,BEL,0,0,0,5,5
2003,Guinea-Bissau,GNB,Belgium,BEL,0,0,0,5,5
2003,Guinea,GIN,Belgium,BEL,5,0,63,5,73
2003,Croatia,HRV,Belgium,BEL,0,0,0,13,13
2003,Cote d'Ivoire,CIV,Belgium,BEL,5,0,5,0,10
2003,India,IND,Belgium,BEL,0,0,5,5,10
2003,Iran (Islamic Rep. of),IRN,Belgium,BEL,14,0,206,30,250
2003,Iraq,IRQ,Belgium,BEL,16,0,26,28,70
2003,Israel,ISR,Belgium,BEL,0,0,0,5,5
2003,Jordan,JOR,Belgium,BEL,0,0,0,5,5
2003,Kazakhstan,KAZ,Belgium,BEL,5,0,52,10,67
2003,Kenya,KEN,Belgium,BEL,0,0,0,5,5
2003,Kyrgyzstan,KGZ,Belgium,BEL,5,0,20,0,25
2003,Liberia,LBR,Belgium,BEL,0,0,0,11,11
2003,Libya,LBY,Belgium,BEL,0,0,0,5,5
2003,Lebanon,LBN,Belgium,BEL,0,0,29,21,50
2003,Sri Lanka,LKA,Belgium,BEL,0,0,10,37,47
2003,Mauritania,MRT,Belgium,BEL,5,0,13,11,29
2003,North Macedonia,MKD,Belgium,BEL,5,0,20,5,30
2003,Rep. of Moldova,MDA,Belgium,BEL,0,0,55,17,72
2003,Mongolia,MNG,Belgium,BEL,0,0,11,0,11
2003,Morocco,MAR,Belgium,BEL,0,0,5,5,10
2003,Myanmar,MMR,Belgium,BEL,0,0,5,0,5
2003,Nepal,NPL,Belgium,BEL,0,0,32,5,37
2003,Niger,NER,Belgium,BEL,0,0,15,5,20
2003,Nigeria,NGA,Belgium,BEL,0,0,5,5,10
2003,Pakistan,PAK,Belgium,BEL,0,0,5,11,16
2003,Peru,PER,Belgium,BEL,0,0,0,5,5
2003,Romania,ROU,Belgium,BEL,0,0,16,19,35
2003,Russian Federation,RUS,Belgium,BEL,86,0,363,67,516
2003,Rwanda,RWA,Belgium,BEL,231,0,86,19,336
2003,Serbia and Kosovo: S/RES/1244 (1999),SRB,Belgium,BEL,228,0,231,102,561
2003,Sierra Leone,SLE,Belgium,BEL,0,0,5,11,16
2003,Somalia,SOM,Belgium,BEL,10,0,0,17,27
2003,Viet Nam,VNM,Belgium,BEL,0,0,0,5,5
2003,Sudan,SDN,Belgium,BEL,0,0,47,0,47
2003,Slovakia,SVK,Belgium,BEL,5,0,0,0,5
2003,Syrian Arab Rep.,SYR,Belgium,BEL,5,0,185,16,206
2003,Tajikistan,TJK,Belgium,BEL,0,0,5,0,5
2003,Togo,TGO,Belgium,BEL,5,0,134,14,153
2003,Turkey,TUR,Belgium,BEL,24,0,216,20,260
2003,Ukraine,UKR,Belgium,BEL,0,0,47,19,66
2003,Uzbekistan,UZB,Belgium,BEL,5,0,25,0,30
2003,Burundi,BDI,Benin,BEN,5,0,0,0,5
2003,Burkina Faso,BFA,Benin,BEN,0,0,5,0,5
2003,Central African Rep.,CAF,Benin,BEN,10,0,11,0,21
2003,Chad,TCD,Benin,BEN,11,0,14,0,25
2003,Congo,COG,Benin,BEN,10,0,20,0,30
2003,Dem. Rep. of the Congo,COD,Benin,BEN,28,0,73,0,101
2003,Cote d'Ivoire,CIV,Benin,BEN,61,0,55,0,116
2003,Liberia,LBR,Benin,BEN,5,0,5,0,10
2003,Niger,NER,Benin,BEN,0,0,5,0,5
2003,Nigeria,NGA,Benin,BEN,10,0,18,0,28
2003,Rwanda,RWA,Benin,BEN,25,0,16,0,41
2003,Sierra Leone,SLE,Benin,BEN,0,0,5,0,5
2003,Sudan,SDN,Benin,BEN,0,0,50,0,50
2003,Togo,TGO,Benin,BEN,22,0,261,0,283
2003,Burundi,BDI,Burkina Faso,BFA,10,0,0,0,10
2003,Chad,TCD,Burkina Faso,BFA,0,0,5,0,5
2003,Cameroon,CMR,Burkina Faso,BFA,0,0,5,0,5
2003,Congo,COG,Burkina Faso,BFA,17,0,0,0,17
2003,Togo,TGO,Burkina Faso,BFA,0,0,10,0,10
2003,Afghanistan,AFG,Belarus,BLR,21,0,21,20,62
2003,Armenia,ARM,Belarus,BLR,0,0,0,5,5
2003,Azerbaijan,AZE,Belarus,BLR,5,0,0,0,5
2003,Palestinian,PSE,Belarus,BLR,5,0,5,0,10
2003,Georgia,GEO,Belarus,BLR,28,0,10,5,43
2003,Iraq,IRQ,Belarus,BLR,0,0,0,5,5
2003,Rep. of Moldova,MDA,Belarus,BLR,0,0,5,0,5
2003,Argentina,ARG,Bolivia (Plurinational State of),BOL,0,0,0,5,5
2003,Colombia,COL,Bolivia (Plurinational State of),BOL,0,0,12,0,12
2003,Sri Lanka,LKA,Bolivia (Plurinational State of),BOL,0,0,5,0,5
2003,Peru,PER,Bolivia (Plurinational State of),BOL,5,0,0,0,5
2003,Kenya,KEN,Botswana,BWA,0,0,0,5,5
2003,Angola,AGO,Brazil,BRA,5,0,111,5,121
2003,Argentina,ARG,Brazil,BRA,0,0,0,5,5
2003,Burundi,BDI,Brazil,BRA,12,0,0,0,12
2003,Bangladesh,BGD,Brazil,BRA,0,0,5,0,5
2003,China,CHN,Brazil,BRA,0,0,0,5,5
2003,Dem. Rep. of the Congo,COD,Brazil,BRA,12,0,5,0,17
2003,Colombia,COL,Brazil,BRA,28,0,28,5,61
2003,Cuba,CUB,Brazil,BRA,5,0,28,0,33
2003,Palestinian,PSE,Brazil,BRA,5,0,0,0,5
2003,Ghana,GHA,Brazil,BRA,0,0,5,0,5
2003,Guinea-Bissau,GNB,Brazil,BRA,0,0,19,10,29
2003,Iran (Islamic Rep. of),IRN,Brazil,BRA,0,0,5,0,5
2003,Iraq,IRQ,Brazil,BRA,0,0,0,5,5
2003,Liberia,LBR,Brazil,BRA,15,0,5,0,20
2003,Sri Lanka,LKA,Brazil,BRA,0,0,5,0,5
2003,Morocco,MAR,Brazil,BRA,0,0,5,0,5
2003,Nigeria,NGA,Brazil,BRA,0,0,10,0,10
2003,Paraguay,PRY,Brazil,BRA,5,0,0,0,5
2003,Peru,PER,Brazil,BRA,0,0,5,5,10
2003,Romania,ROU,Brazil,BRA,0,0,5,0,5
2003,South Africa,ZAF,Brazil,BRA,0,0,5,0,5
2003,Senegal,SEN,Brazil,BRA,0,0,5,0,5
2003,Sierra Leone,SLE,Brazil,BRA,0,0,19,0,19
2003,Sudan,SDN,Brazil,BRA,5,0,0,0,5
2003,United Rep. of Tanzania,TZA,Brazil,BRA,0,0,5,0,5
2003,Afghanistan,AFG,Bulgaria,BGR,5,99,291,155,550
2003,Algeria,DZA,Bulgaria,BGR,0,0,153,0,153
2003,Egypt,EGY,Bulgaria,BGR,0,0,5,0,5
2003,Armenia,ARM,Bulgaria,BGR,0,0,203,0,203
2003,Bangladesh,BGD,Bulgaria,BGR,0,5,0,0,5
2003,China,CHN,Bulgaria,BGR,0,0,5,0,5
2003,Dem. Rep. of the Congo,COD,Bulgaria,BGR,0,0,5,0,5
2003,India,IND,Bulgaria,BGR,0,0,5,14,19
2003,Iran (Islamic Rep. of),IRN,Bulgaria,BGR,0,22,84,11,117
2003,Iraq,IRQ,Bulgaria,BGR,5,227,30,252,514
2003,Liberia,LBR,Bulgaria,BGR,0,0,5,0,5
2003,Lebanon,LBN,Bulgaria,BGR,0,0,5,0,5
2003,Sri Lanka,LKA,Bulgaria,BGR,0,0,5,0,5
2003,Rep. of Moldova,MDA,Bulgaria,BGR,0,0,5,0,5
2003,Nigeria,NGA,Bulgaria,BGR,0,0,76,22,98
2003,Pakistan,PAK,Bulgaria,BGR,0,0,13,5,18
2003,Russian Federation,RUS,Bulgaria,BGR,0,5,5,0,10
2003,Sierra Leone,SLE,Bulgaria,BGR,0,0,5,0,5
2003,Somalia,SOM,Bulgaria,BGR,0,23,0,30,53
2003,Syrian Arab Rep.,SYR,Bulgaria,BGR,0,5,5,0,10
2003,United Rep. of Tanzania,TZA,Bulgaria,BGR,0,0,5,0,5
2003,Tunisia,TUN,Bulgaria,BGR,0,0,5,5,10
2003,Turkey,TUR,Bulgaria,BGR,5,0,42,11,58
2003,Stateless,XXA,Bulgaria,BGR,0,5,41,5,51
2003,Haiti,HTI,Belize,BLZ,0,0,0,5,5
2003,Nigeria,NGA,Belize,BLZ,0,0,0,5,5
2003,Afghanistan,AFG,Canada,CAN,202,0,22,29,253
2003,Albania,ALB,Canada,CAN,243,0,417,89,749
2003,Algeria,DZA,Canada,CAN,88,0,155,12,255
2003,Angola,AGO,Canada,CAN,233,0,149,22,404
2003,Antigua and Barbuda,ATG,Canada,CAN,0,0,24,5,29
2003,Egypt,EGY,Canada,CAN,90,0,58,13,161
2003,Argentina,ARG,Canada,CAN,114,0,658,113,885
2003,Armenia,ARM,Canada,CAN,16,0,11,0,27
2003,Azerbaijan,AZE,Canada,CAN,104,0,46,0,150
2003,Barbados,BRB,Canada,CAN,5,0,30,18,53
2003,Burundi,BDI,Canada,CAN,258,0,45,10,313
2003,Benin,BEN,Canada,CAN,12,0,0,0,12
2003,Bangladesh,BGD,Canada,CAN,301,0,166,37,504
2003,Burkina Faso,BFA,Canada,CAN,38,0,11,0,49
2003,Belarus,BLR,Canada,CAN,34,0,13,5,52
2003,Bolivia (Plurinational State of),BOL,Canada,CAN,20,0,24,5,49
2003,Botswana,BWA,Canada,CAN,5,0,0,0,5
2003,Brazil,BRA,Canada,CAN,14,0,77,93,184
2003,Bosnia and Herzegovina,BIH,Canada,CAN,5,0,5,5,15
2003,Bulgaria,BGR,Canada,CAN,110,0,48,30,188
2003,Belize,BLZ,Canada,CAN,0,0,5,0,5
2003,Cambodia,KHM,Canada,CAN,21,0,20,5,46
2003,Central African Rep.,CAF,Canada,CAN,17,0,10,5,32
2003,Chad,TCD,Canada,CAN,80,0,38,5,123
2003,China,CHN,Canada,CAN,1339,0,507,366,2212
2003,Chile,CHL,Canada,CAN,5,0,76,23,104
2003,Cameroon,CMR,Canada,CAN,60,0,37,10,107
2003,Congo,COG,Canada,CAN,45,0,34,5,84
2003,Dem. Rep. of the Congo,COD,Canada,CAN,577,0,384,65,1026
2003,Colombia,COL,Canada,CAN,1960,0,302,150,2412
2003,Costa Rica,CRI,Canada,CAN,38,0,1385,679,2102
2003,Cuba,CUB,Canada,CAN,149,0,39,34,222
2003,Czechia,CZE,Canada,CAN,5,0,18,10,33
2003,Denmark,DNK,Canada,CAN,0,0,5,5,10
2003,Djibouti,DJI,Canada,CAN,16,0,45,5,66
2003,Dominica,DMA,Canada,CAN,10,0,20,10,40
2003,Dominican Rep.,DOM,Canada,CAN,12,0,33,69,114
2003,Ecuador,ECU,Canada,CAN,28,0,17,32,77
2003,Eritrea,ERI,Canada,CAN,114,0,16,12,142
2003,Estonia,EST,Canada,CAN,5,0,10,5,20
2003,Ethiopia,ETH,Canada,CAN,205,0,37,20,262
2003,Fiji,FJI,Canada,CAN,17,0,33,11,61
2003,France,FRA,Canada,CAN,0,0,14,11,25
2003,Gabon,GAB,Canada,CAN,19,0,10,0,29
2003,Gambia,GMB,Canada,CAN,5,0,5,0,10
2003,Palestinian,PSE,Canada,CAN,129,0,23,21,173
2003,United Kingdom of Great Britain and Northern Ireland,GBR,Canada,CAN,0,0,17,5,22
2003,Georgia,GEO,Canada,CAN,39,0,24,5,68
2003,Germany,DEU,Canada,CAN,0,0,13,13,26
2003,Ghana,GHA,Canada,CAN,35,0,135,42,212
2003,Guinea-Bissau,GNB,Canada,CAN,5,0,0,0,5
2003,Greece,GRC,Canada,CAN,0,0,11,5,16
2003,Grenada,GRD,Canada,CAN,82,0,198,68,348
2003,Guatemala,GTM,Canada,CAN,63,0,87,41,191
2003,Guinea,GIN,Canada,CAN,161,0,83,5,249
2003,Guyana,GUY,Canada,CAN,113,0,452,109,674
2003,Haiti,HTI,Canada,CAN,148,0,135,13,296
2003,"China, Hong Kong SAR",HKG,Canada,CAN,0,0,0,5,5
2003,Honduras,HND,Canada,CAN,25,0,159,81,265
2003,Croatia,HRV,Canada,CAN,5,0,5,5,15
2003,Hungary,HUN,Canada,CAN,173,0,1392,490,2055
2003,Cote d'Ivoire,CIV,Canada,CAN,49,0,33,17,99
2003,India,IND,Canada,CAN,392,0,694,282,1368
2003,Indonesia,IDN,Canada,CAN,12,0,41,12,65
2003,Iran (Islamic Rep. of),IRN,Canada,CAN,312,0,153,52,517
2003,Iraq,IRQ,Canada,CAN,185,0,97,35,317
2003,Israel,ISR,Canada,CAN,163,0,343,129,635
2003,Italy,ITA,Canada,CAN,0,0,11,5,16
2003,Jamaica,JAM,Canada,CAN,60,0,214,72,346
2003,Jordan,JOR,Canada,CAN,29,0,34,14,77
2003,Japan,JPN,Canada,CAN,0,0,5,0,5
2003,Kazakhstan,KAZ,Canada,CAN,25,0,24,10,59
2003,Kenya,KEN,Canada,CAN,106,0,51,12,169
2003,Kyrgyzstan,KGZ,Canada,CAN,10,0,5,0,15
2003,Rep. of Korea,KOR,Canada,CAN,79,0,127,103,309
2003,Dem. People's Rep. of Korea,PRK,Canada,CAN,0,0,0,5,5
2003,Kuwait,KWT,Canada,CAN,19,0,5,5,29
2003,Lao People's Dem. Rep.,LAO,Canada,CAN,0,0,5,0,5
2003,Liberia,LBR,Canada,CAN,14,0,0,0,14
2003,Libya,LBY,Canada,CAN,31,0,21,5,57
2003,Saint Lucia,LCA,Canada,CAN,59,0,160,73,292
2003,Lebanon,LBN,Canada,CAN,189,0,248,58,495
2003,Sri Lanka,LKA,Canada,CAN,1749,0,543,104,2396
2003,Lithuania,LTU,Canada,CAN,24,0,26,13,63
2003,Latvia,LVA,Canada,CAN,12,0,5,12,29
2003,Mauritania,MRT,Canada,CAN,51,0,16,0,67
2003,North Macedonia,MKD,Canada,CAN,10,0,41,10,61
2003,Rep. of Moldova,MDA,Canada,CAN,16,0,30,5,51
2003,Mexico,MEX,Canada,CAN,597,0,960,665,2222
2003,Mali,MLI,Canada,CAN,16,0,49,5,70
2003,Malaysia,MYS,Canada,CAN,46,0,163,50,259
2003,Malawi,MWI,Canada,CAN,5,0,0,0,5
2003,Mongolia,MNG,Canada,CAN,14,0,10,0,24
2003,Morocco,MAR,Canada,CAN,10,0,34,14,58
2003,Malta,MLT,Canada,CAN,0,0,5,0,5
2003,Myanmar,MMR,Canada,CAN,24,0,10,0,34
2003,Namibia,NAM,Canada,CAN,0,0,13,0,13
2003,Nepal,NPL,Canada,CAN,31,0,21,5,57
2003,Netherlands,NLD,Canada,CAN,0,0,12,0,12
2003,Niger,NER,Canada,CAN,11,0,11,0,22
2003,Nicaragua,NIC,Canada,CAN,5,0,39,17,61
2003,Nigeria,NGA,Canada,CAN,394,0,321,121,836
2003,Pakistan,PAK,Canada,CAN,1608,0,1751,605,3964
2003,Panama,PAN,Canada,CAN,5,0,17,10,32
2003,Paraguay,PRY,Canada,CAN,5,0,0,13,18
2003,Peru,PER,Canada,CAN,371,0,455,96,922
2003,Philippines,PHL,Canada,CAN,27,0,297,41,365
2003,Poland,POL,Canada,CAN,58,0,131,74,263
2003,Portugal,PRT,Canada,CAN,0,0,481,79,560
2003,Romania,ROU,Canada,CAN,80,0,140,65,285
2003,South Africa,ZAF,Canada,CAN,5,0,12,0,17
2003,Russian Federation,RUS,Canada,CAN,178,0,123,73,374
2003,Rwanda,RWA,Canada,CAN,119,0,41,5,165
2003,El Salvador,SLV,Canada,CAN,93,0,155,40,288
2003,Saudi Arabia,SAU,Canada,CAN,39,0,5,5,49
2003,Serbia and Kosovo: S/RES/1244 (1999),SRB,Canada,CAN,41,0,91,38,170
2003,Senegal,SEN,Canada,CAN,18,0,10,0,28
2003,Seychelles,SYC,Canada,CAN,0,0,10,0,10
2003,Singapore,SGP,Canada,CAN,0,0,14,0,14
2003,Sierra Leone,SLE,Canada,CAN,29,0,31,5,65
2003,Somalia,SOM,Canada,CAN,445,0,59,84,588
2003,Viet Nam,VNM,Canada,CAN,29,0,31,17,77
2003,Saint Kitts and Nevis,KNA,Canada,CAN,0,0,0,5,5
2003,Sudan,SDN,Canada,CAN,203,0,31,37,271
2003,Slovakia,SVK,Canada,CAN,0,0,14,5,19
2003,Slovenia,SVN,Canada,CAN,0,0,5,5,10
2003,Eswatini,SWZ,Canada,CAN,5,0,0,0,5
2003,Switzerland,CHE,Canada,CAN,0,0,5,0,5
2003,Syrian Arab Rep.,SYR,Canada,CAN,47,0,61,10,118
2003,United Rep. of Tanzania,TZA,Canada,CAN,65,0,83,11,159
2003,Thailand,THA,Canada,CAN,5,0,5,0,10
2003,Tajikistan,TJK,Canada,CAN,5,0,0,0,5
2003,Turkmenistan,TKM,Canada,CAN,5,0,0,0,5
2003,Togo,TGO,Canada,CAN,40,0,22,0,62
2003,Trinidad and Tobago,TTO,Canada,CAN,13,0,175,56,244
2003,Tunisia,TUN,Canada,CAN,23,0,50,10,83
2003,Turkey,TUR,Canada,CAN,738,0,379,115,1232
2003,United Arab Emirates,ARE,Canada,CAN,13,0,0,0,13
2003,Uganda,UGA,Canada,CAN,89,0,18,10,117
2003,Ukraine,UKR,Canada,CAN,145,0,155,64,364
2003,Uruguay,URY,Canada,CAN,25,0,89,69,183
2003,United States of America,USA,Canada,CAN,0,0,86,87,173
2003,Uzbekistan,UZB,Canada,CAN,24,0,14,5,43
2003,Saint Vincent and the Grenadines,VCT,Canada,CAN,128,0,263,103,494
2003,Venezuela (Bolivarian Republic of),VEN,Canada,CAN,82,0,132,52,266
2003,Yemen,YEM,Canada,CAN,45,0,44,0,89
2003,Zambia,ZMB,Canada,CAN,11,0,5,0,16
2003,Zimbabwe,ZWE,Canada,CAN,507,0,123,19,649
2003,Chad,TCD,Central African Rep.,CAF,0,0,0,182,182
2003,Congo,COG,Central African Rep.,CAF,0,0,0,36,36
2003,Dem. Rep. of the Congo,COD,Central African Rep.,CAF,192,402,5,1028,1627
2003,Sudan,SDN,Central African Rep.,CAF,0,0,0,521,521
2003,Cambodia,KHM,Chad,TCD,5,0,5,0,10
2003,Central African Rep.,CAF,Chad,TCD,0,18,11,0,29
2003,Congo,COG,Chad,TCD,0,5,0,0,5
2003,Dem. Rep. of the Congo,COD,Chad,TCD,0,36,16,0,52
2003,Cote d'Ivoire,CIV,Chad,TCD,0,0,10,0,10
2003,Liberia,LBR,Chad,TCD,0,15,21,0,36
2003,Rwanda,RWA,Chad,TCD,0,0,5,0,5
2003,Sierra Leone,SLE,Chad,TCD,0,0,5,0,5
2003,Sudan,SDN,Chad,TCD,0,13,0,0,13
2003,Afghanistan,AFG,Chile,CHL,14,0,0,0,14
2003,Colombia,COL,Chile,CHL,22,0,0,0,22
2003,Cuba,CUB,Chile,CHL,0,0,0,5,5
2003,Iran (Islamic Rep. of),IRN,Chile,CHL,5,0,0,0,5
2003,Rwanda,RWA,Chile,CHL,5,0,0,0,5
2003,Iran (Islamic Rep. of),IRN,Colombia,COL,0,0,5,0,5
2003,Venezuela (Bolivarian Republic of),VEN,Colombia,COL,5,0,0,0,5
2003,Colombia,COL,Costa Rica,CRI,773,887,327,24,2011
2003,Cuba,CUB,Costa Rica,CRI,43,42,21,0,106
2003,Peru,PER,Costa Rica,CRI,0,0,0,12,12
2003,Palestinian,PSE,Cyprus,CYP,0,0,28,26,54
2003,Georgia,GEO,Cyprus,CYP,0,0,18,0,18
2003,Iran (Islamic Rep. of),IRN,Cyprus,CYP,0,0,82,32,114
2003,Israel,ISR,Cyprus,CYP,0,0,5,0,5
2003,Kazakhstan,KAZ,Cyprus,CYP,0,0,5,0,5
2003,Kyrgyzstan,KGZ,Cyprus,CYP,0,0,0,5,5
2003,Lebanon,LBN,Cyprus,CYP,0,0,5,0,5
2003,Pakistan,PAK,Cyprus,CYP,0,0,31,24,55
2003,Russian Federation,RUS,Cyprus,CYP,0,0,30,5,35
2003,Serbia and Kosovo: S/RES/1244 (1999),SRB,Cyprus,CYP,0,0,0,5,5
2003,Syrian Arab Rep.,SYR,Cyprus,CYP,0,0,5,0,5
2003,Turkey,TUR,Cyprus,CYP,0,0,48,32,80
2003,Ukraine,UKR,Cyprus,CYP,0,0,5,0,5
2003,Afghanistan,AFG,Czechia,CZE,14,0,25,14,53
2003,Algeria,DZA,Czechia,CZE,0,0,42,54,96
2003,Angola,AGO,Czechia,CZE,0,0,13,0,13
2003,Armenia,ARM,Czechia,CZE,26,0,242,37,305
2003,Azerbaijan,AZE,Czechia,CZE,0,0,0,24,24
2003,Belarus,BLR,Czechia,CZE,20,0,213,131,364
2003,Bosnia and Herzegovina,BIH,Czechia,CZE,0,0,0,5,5
2003,Bulgaria,BGR,Czechia,CZE,0,0,85,19,104
2003,China,CHN,Czechia,CZE,0,0,606,390,996
2003,Georgia,GEO,Czechia,CZE,10,0,202,318,530
2003,Ghana,GHA,Czechia,CZE,0,0,5,11,16
2003,Guinea,GIN,Czechia,CZE,0,0,0,10,10
2003,Cote d'Ivoire,CIV,Czechia,CZE,0,0,21,16,37
2003,India,IND,Czechia,CZE,0,0,139,120,259
2003,Iran (Islamic Rep. of),IRN,Czechia,CZE,5,0,0,5,10
2003,Iraq,IRQ,Czechia,CZE,5,0,26,84,115
2003,Kazakhstan,KAZ,Czechia,CZE,10,0,109,11,130
2003,Kyrgyzstan,KGZ,Czechia,CZE,5,0,51,41,97
2003,Sri Lanka,LKA,Czechia,CZE,0,0,5,34,39
2003,Lithuania,LTU,Czechia,CZE,0,0,21,5,26
2003,North Macedonia,MKD,Czechia,CZE,0,0,20,10,30
2003,Rep. of Moldova,MDA,Czechia,CZE,0,0,352,364,716
2003,Mongolia,MNG,Czechia,CZE,0,0,98,36,134
2003,Nigeria,NGA,Czechia,CZE,0,0,10,31,41
2003,Pakistan,PAK,Czechia,CZE,5,0,5,13,23
2003,Romania,ROU,Czechia,CZE,0,0,82,55,137
2003,Russian Federation,RUS,Czechia,CZE,62,0,1096,2796,3954
2003,Serbia and Kosovo: S/RES/1244 (1999),SRB,Czechia,CZE,5,0,10,13,28
2003,Senegal,SEN,Czechia,CZE,0,0,14,0,14
2003,Somalia,SOM,Czechia,CZE,0,0,10,14,24
2003,Viet Nam,VNM,Czechia,CZE,5,0,754,229,988
2003,Slovakia,SVK,Czechia,CZE,0,0,1008,215,1223
2003,Syrian Arab Rep.,SYR,Czechia,CZE,5,0,0,5,10
2003,Turkey,TUR,Czechia,CZE,0,0,5,13,18
2003,Ukraine,UKR,Czechia,CZE,5,0,2357,418,2780
2003,Uzbekistan,UZB,Czechia,CZE,0,0,74,53,127
2003,Stateless,XXA,Czechia,CZE,0,0,39,67,106
2003,Afghanistan,AFG,Denmark,DNK,326,41,757,0,1124
2003,Albania,ALB,Denmark,DNK,0,0,27,0,27
2003,Algeria,DZA,Denmark,DNK,0,0,13,0,13
2003,Angola,AGO,Denmark,DNK,0,5,0,0,5
2003,Armenia,ARM,Denmark,DNK,0,0,10,0,10
2003,Azerbaijan,AZE,Denmark,DNK,0,0,10,0,10
2003,Burundi,BDI,Denmark,DNK,0,13,21,0,34
2003,Belarus,BLR,Denmark,DNK,0,0,13,0,13
2003,Bosnia and Herzegovina,BIH,Denmark,DNK,5,0,101,0,106
2003,Bulgaria,BGR,Denmark,DNK,0,0,101,0,101
2003,China,CHN,Denmark,DNK,5,0,28,0,33
2003,Dem. Rep. of the Congo,COD,Denmark,DNK,5,0,10,0,15
2003,Czechia,CZE,Denmark,DNK,0,0,11,0,11
2003,Ecuador,ECU,Denmark,DNK,0,0,11,0,11
2003,Estonia,EST,Denmark,DNK,0,0,5,0,5
2003,Palestinian,PSE,Denmark,DNK,15,5,112,0,132
2003,Georgia,GEO,Denmark,DNK,0,0,14,0,14
2003,Ghana,GHA,Denmark,DNK,0,0,10,0,10
2003,Guinea,GIN,Denmark,DNK,0,0,10,0,10
2003,Croatia,HRV,Denmark,DNK,0,0,5,0,5
2003,Cote d'Ivoire,CIV,Denmark,DNK,0,0,5,0,5
2003,India,IND,Denmark,DNK,0,0,55,0,55
2003,Iran (Islamic Rep. of),IRN,Denmark,DNK,18,22,118,0,158
2003,Iraq,IRQ,Denmark,DNK,14,40,185,0,239
2003,Jordan,JOR,Denmark,DNK,0,0,11,0,11
2003,Kenya,KEN,Denmark,DNK,5,0,0,0,5
2003,Liberia,LBR,Denmark,DNK,0,0,5,0,5
2003,Libya,LBY,Denmark,DNK,0,0,21,0,21
2003,Lebanon,LBN,Denmark,DNK,5,0,33,0,38
2003,Sri Lanka,LKA,Denmark,DNK,0,5,16,0,21
2003,Lithuania,LTU,Denmark,DNK,0,0,10,0,10
2003,Latvia,LVA,Denmark,DNK,0,0,5,0,5
2003,North Macedonia,MKD,Denmark,DNK,0,0,49,0,49
2003,Morocco,MAR,Denmark,DNK,0,0,13,0,13
2003,Nepal,NPL,Denmark,DNK,0,0,5,0,5
2003,Nigeria,NGA,Denmark,DNK,0,0,30,0,30
2003,Pakistan,PAK,Denmark,DNK,0,0,24,0,24
2003,Poland,POL,Denmark,DNK,0,0,10,0,10
2003,Romania,ROU,Denmark,DNK,0,0,14,0,14
2003,Russian Federation,RUS,Denmark,DNK,10,43,61,0,114
2003,Rwanda,RWA,Denmark,DNK,13,0,5,0,18
2003,Serbia and Kosovo: S/RES/1244 (1999),SRB,Denmark,DNK,10,5,387,0,402
2003,Somalia,SOM,Denmark,DNK,26,77,156,0,259
2003,Viet Nam,VNM,Denmark,DNK,10,0,16,0,26
2003,Sudan,SDN,Denmark,DNK,10,0,15,0,25
2003,Slovakia,SVK,Denmark,DNK,0,0,11,0,11
2003,Syrian Arab Rep.,SYR,Denmark,DNK,5,0,29,0,34
2003,Turkey,TUR,Denmark,DNK,5,0,35,0,40
2003,Uganda,UGA,Denmark,DNK,0,0,5,0,5
2003,Ukraine,UKR,Denmark,DNK,0,0,11,0,11
2003,Uzbekistan,UZB,Denmark,DNK,0,0,5,0,5
2003,Stateless,XXA,Denmark,DNK,14,5,15,0,34
2003,Colombia,COL,Ecuador,ECU,3282,0,4356,3842,11480
2003,Cuba,CUB,Ecuador,ECU,5,0,0,0,5
2003,Haiti,HTI,Ecuador,ECU,0,0,12,0,12
2003,Iraq,IRQ,Ecuador,ECU,12,0,0,0,12
2003,Peru,PER,Ecuador,ECU,0,0,14,0,14
2003,Serbia and Kosovo: S/RES/1244 (1999),SRB,Ecuador,ECU,0,0,0,5,5
2003,Venezuela (Bolivarian Republic of),VEN,Ecuador,ECU,0,0,5,0,5
2003,Azerbaijan,AZE,Estonia,EST,0,0,5,0,5
2003,Georgia,GEO,Estonia,EST,0,0,5,0,5
2003,Russian Federation,RUS,Estonia,EST,0,0,0,5,5
2003,Turkey,TUR,Estonia,EST,0,0,5,0,5
2003,Burundi,BDI,Ethiopia,ETH,5,0,0,0,5
2003,Dem. Rep. of the Congo,COD,Ethiopia,ETH,16,0,13,0,29
2003,Eritrea,ERI,Ethiopia,ETH,1580,0,0,0,1580
2003,Afghanistan,AFG,Finland,FIN,0,18,15,5,38
2003,Albania,ALB,Finland,FIN,0,5,19,21,45
2003,Algeria,DZA,Finland,FIN,0,10,33,18,61
2003,Angola,AGO,Finland,FIN,0,24,22,0,46
2003,Armenia,ARM,Finland,FIN,0,0,13,0,13
2003,Azerbaijan,AZE,Finland,FIN,0,10,27,5,42
2003,Burundi,BDI,Finland,FIN,0,5,0,0,5
2003,Bangladesh,BGD,Finland,FIN,0,10,60,5,75
2003,Belarus,BLR,Finland,FIN,0,10,31,21,62
2003,Bosnia and Herzegovina,BIH,Finland,FIN,0,28,105,124,257
2003,Bulgaria,BGR,Finland,FIN,0,0,10,392,402
2003,China,CHN,Finland,FIN,0,0,0,5,5
2003,Cameroon,CMR,Finland,FIN,0,11,0,0,11
2003,Congo,COG,Finland,FIN,0,5,5,0,10
2003,Dem. Rep. of the Congo,COD,Finland,FIN,0,20,27,5,52
2003,Cuba,CUB,Finland,FIN,0,0,10,0,10
2003,Czechia,CZE,Finland,FIN,0,0,23,15,38
2003,Ethiopia,ETH,Finland,FIN,0,5,5,0,10
2003,Gambia,GMB,Finland,FIN,0,0,0,5,5
2003,Georgia,GEO,Finland,FIN,0,0,5,5,10
2003,Ghana,GHA,Finland,FIN,0,0,0,11,11
2003,Guinea,GIN,Finland,FIN,0,0,5,0,5
2003,Croatia,HRV,Finland,FIN,0,0,17,105,122
2003,Hungary,HUN,Finland,FIN,0,0,5,0,5
2003,Cote d'Ivoire,CIV,Finland,FIN,0,0,5,0,5
2003,India,IND,Finland,FIN,0,5,5,0,10
2003,Iran (Islamic Rep. of),IRN,Finland,FIN,5,36,33,5,79
2003,Iraq,IRQ,Finland,FIN,0,21,32,15,68
2003,Israel,ISR,Finland,FIN,0,0,0,5,5
2003,Jordan,JOR,Finland,FIN,0,0,5,0,5
2003,Kazakhstan,KAZ,Finland,FIN,0,0,10,0,10
2003,Libya,LBY,Finland,FIN,0,5,0,5,10
2003,Sri Lanka,LKA,Finland,FIN,0,5,5,5,15
2003,Lithuania,LTU,Finland,FIN,0,0,13,0,13
2003,Latvia,LVA,Finland,FIN,0,0,0,12,12
2003,North Macedonia,MKD,Finland,FIN,0,5,11,5,21
2003,Mongolia,MNG,Finland,FIN,0,0,5,0,5
2003,Morocco,MAR,Finland,FIN,0,5,0,5,10
2003,Myanmar,MMR,Finland,FIN,0,5,5,20,30
2003,Nepal,NPL,Finland,FIN,0,5,0,0,5
2003,Nigeria,NGA,Finland,FIN,0,5,22,10,37
2003,Pakistan,PAK,Finland,FIN,0,0,12,0,12
2003,Peru,PER,Finland,FIN,0,5,0,0,5
2003,Poland,POL,Finland,FIN,0,0,13,0,13
2003,Romania,ROU,Finland,FIN,0,0,10,105,115
2003,Russian Federation,RUS,Finland,FIN,0,14,10,237,261
2003,Rwanda,RWA,Finland,FIN,0,5,0,0,5
2003,Serbia and Kosovo: S/RES/1244 (1999),SRB,Finland,FIN,0,64,195,268,527
2003,Senegal,SEN,Finland,FIN,0,0,0,5,5
2003,Sierra Leone,SLE,Finland,FIN,0,0,14,0,14
2003,Somalia,SOM,Finland,FIN,0,75,5,13,93
2003,Slovakia,SVK,Finland,FIN,0,0,77,36,113
2003,Syrian Arab Rep.,SYR,Finland,FIN,0,11,11,5,27
2003,United Rep. of Tanzania,TZA,Finland,FIN,0,0,0,5,5
2003,Turkmenistan,TKM,Finland,FIN,0,0,0,5,5
2003,Togo,TGO,Finland,FIN,0,5,5,0,10
2003,Turkey,TUR,Finland,FIN,0,56,121,84,261
2003,Ukraine,UKR,Finland,FIN,0,5,48,43,96
2003,Uzbekistan,UZB,Finland,FIN,0,0,14,0,14
2003,Stateless,XXA,Finland,FIN,0,11,10,10,31
2003,Afghanistan,AFG,France,FRA,66,0,284,0,350
2003,Albania,ALB,France,FRA,21,0,553,0,574
2003,Algeria,DZA,France,FRA,115,0,2715,0,2830
2003,Angola,AGO,France,FRA,169,0,2191,0,2360
2003,Egypt,EGY,France,FRA,10,0,19,0,29
2003,Argentina,ARG,France,FRA,0,0,11,0,11
2003,Armenia,ARM,France,FRA,63,0,1081,0,1144
2003,Azerbaijan,AZE,France,FRA,117,0,421,0,538
2003,Burundi,BDI,France,FRA,22,0,45,0,67
2003,Benin,BEN,France,FRA,0,0,25,0,25
2003,Bangladesh,BGD,France,FRA,36,0,702,0,738
2003,Burkina Faso,BFA,France,FRA,0,0,34,0,34
2003,Belarus,BLR,France,FRA,42,0,313,0,355
2003,Brazil,BRA,France,FRA,0,0,13,0,13
2003,Bosnia and Herzegovina,BIH,France,FRA,354,0,413,0,767
2003,Cambodia,KHM,France,FRA,10,0,88,0,98
2003,Central African Rep.,CAF,France,FRA,90,0,653,0,743
2003,Chad,TCD,France,FRA,163,0,476,0,639
2003,China,CHN,France,FRA,32,0,3421,0,3453
2003,Cameroon,CMR,France,FRA,61,0,902,0,963
2003,Congo,COG,France,FRA,382,0,2991,0,3373
2003,Dem. Rep. of the Congo,COD,France,FRA,845,0,7315,0,8160
2003,Comoros,COM,France,FRA,10,0,86,0,96
2003,Colombia,COL,France,FRA,33,0,84,0,117
2003,Cuba,CUB,France,FRA,10,0,16,0,26
2003,Djibouti,DJI,France,FRA,10,0,28,0,38
2003,Eritrea,ERI,France,FRA,5,0,19,0,24
2003,Ethiopia,ETH,France,FRA,37,0,32,0,69
2003,Gabon,GAB,France,FRA,0,0,21,0,21
2003,Gambia,GMB,France,FRA,0,0,20,0,20
2003,Georgia,GEO,France,FRA,90,0,1928,0,2018
2003,Guinea-Bissau,GNB,France,FRA,36,0,170,0,206
2003,Guinea,GIN,France,FRA,42,0,995,0,1037
2003,Guyana,GUY,France,FRA,0,0,73,0,73
2003,Haiti,HTI,France,FRA,174,0,1297,0,1471
2003,Cote d'Ivoire,CIV,France,FRA,218,0,1179,0,1397
2003,India,IND,France,FRA,5,0,453,0,458
2003,Iran (Islamic Rep. of),IRN,France,FRA,24,0,121,0,145
2003,Iraq,IRQ,France,FRA,28,0,531,0,559
2003,Israel,ISR,France,FRA,0,0,5,0,5
2003,Kazakhstan,KAZ,France,FRA,11,0,221,0,232
2003,Kyrgyzstan,KGZ,France,FRA,5,0,92,0,97
2003,Liberia,LBR,France,FRA,12,0,130,0,142
2003,Libya,LBY,France,FRA,0,0,11,0,11
2003,Lebanon,LBN,France,FRA,5,0,21,0,26
2003,Sri Lanka,LKA,France,FRA,303,0,1860,0,2163
2003,Lithuania,LTU,France,FRA,0,0,20,0,20
2003,Madagascar,MDG,France,FRA,29,0,346,0,375
2003,Mauritania,MRT,France,FRA,506,0,4073,0,4579
2003,North Macedonia,MKD,France,FRA,5,0,329,0,334
2003,Rep. of Moldova,MDA,France,FRA,5,0,1694,0,1699
2003,Mali,MLI,France,FRA,5,0,1221,0,1226
2003,Mongolia,MNG,France,FRA,0,0,241,0,241
2003,Mauritius,MUS,France,FRA,0,0,16,0,16
2003,Myanmar,MMR,France,FRA,11,0,11,0,22
2003,Nepal,NPL,France,FRA,0,0,12,0,12
2003,Niger,NER,France,FRA,0,0,33,0,33
2003,Nigeria,NGA,France,FRA,11,0,1374,0,1385
2003,Pakistan,PAK,France,FRA,12,0,440,0,452
2003,Peru,PER,France,FRA,5,0,58,0,63
2003,Poland,POL,France,FRA,0,0,5,0,5
2003,Russian Federation,RUS,France,FRA,828,0,1448,0,2276
2003,Rwanda,RWA,France,FRA,216,0,123,0,339
2003,Serbia and Kosovo: S/RES/1244 (1999),SRB,France,FRA,396,0,1579,0,1975
2003,Senegal,SEN,France,FRA,11,0,358,0,369
2003,Sierra Leone,SLE,France,FRA,51,0,914,0,965
2003,Somalia,SOM,France,FRA,30,0,124,0,154
2003,Viet Nam,VNM,France,FRA,16,0,46,0,62
2003,Sudan,SDN,France,FRA,44,0,192,0,236
2003,Slovakia,SVK,France,FRA,0,0,72,0,72
2003,Syrian Arab Rep.,SYR,France,FRA,5,0,36,0,41
2003,Thailand,THA,France,FRA,0,0,39,0,39
2003,Togo,TGO,France,FRA,57,0,314,0,371
2003,Tunisia,TUN,France,FRA,14,0,21,0,35
2003,Turkey,TUR,France,FRA,489,0,9079,0,9568
2003,Ukraine,UKR,France,FRA,24,0,795,0,819
2003,Uzbekistan,UZB,France,FRA,5,0,133,0,138
2003,Stateless,XXA,France,FRA,53,0,58,0,111
2003,Angola,AGO,Gabon,GAB,5,0,12,0,17
2003,Burundi,BDI,Gabon,GAB,5,5,0,0,10
2003,Cambodia,KHM,Gabon,GAB,0,0,0,10,10
2003,Central African Rep.,CAF,Gabon,GAB,0,10,0,0,10
2003,Chad,TCD,Gabon,GAB,5,396,92,0,493
2003,Cameroon,CMR,Gabon,GAB,0,0,5,0,5
2003,Congo,COG,Gabon,GAB,30,1095,121,0,1246
2003,Dem. Rep. of the Congo,COD,Gabon,GAB,16,21,259,0,296
2003,Equatorial Guinea,GNQ,Gabon,GAB,5,14,0,0,19
2003,Cote d'Ivoire,CIV,Gabon,GAB,0,0,5,0,5
2003,Liberia,LBR,Gabon,GAB,0,5,5,0,10
2003,Mauritania,MRT,Gabon,GAB,0,0,10,16,26
2003,Nigeria,NGA,Gabon,GAB,0,0,0,19,19
2003,Rwanda,RWA,Gabon,GAB,0,15,5,0,20
2003,Sierra Leone,SLE,Gabon,GAB,0,0,14,0,14
2003,Sudan,SDN,Gabon,GAB,0,0,5,0,5
2003,Togo,TGO,Gabon,GAB,5,0,0,0,5
2003,Liberia,LBR,Gambia,GMB,71,0,0,0,71
2003,Afghanistan,AFG,United Kingdom of Great Britain and Northern Ireland,GBR,84,601,3266,661,4612
2003,Albania,ALB,United Kingdom of Great Britain and Northern Ireland,GBR,5,198,613,189,1005
2003,Algeria,DZA,United Kingdom of Great Britain and Northern Ireland,GBR,5,37,725,186,953
2003,Angola,AGO,United Kingdom of Great Britain and Northern Ireland,GBR,36,474,849,136,1495
2003,Egypt,EGY,United Kingdom of Great Britain and Northern Ireland,GBR,5,10,72,5,92
2003,Argentina,ARG,United Kingdom of Great Britain and Northern Ireland,GBR,0,0,0,5,5
2003,Armenia,ARM,United Kingdom of Great Britain and Northern Ireland,GBR,5,5,65,0,75
2003,Azerbaijan,AZE,United Kingdom of Great Britain and Northern Ireland,GBR,10,0,232,13,255
2003,Bahrain,BHR,United Kingdom of Great Britain and Northern Ireland,GBR,0,0,5,0,5
2003,Burundi,BDI,United Kingdom of Great Britain and Northern Ireland,GBR,130,276,436,79,921
2003,Benin,BEN,United Kingdom of Great Britain and Northern Ireland,GBR,0,0,10,0,10
2003,Bangladesh,BGD,United Kingdom of Great Britain and Northern Ireland,GBR,5,334,483,117,939
2003,Bhutan,BTN,United Kingdom of Great Britain and Northern Ireland,GBR,10,0,45,13,68
2003,Burkina Faso,BFA,United Kingdom of Great Britain and Northern Ireland,GBR,0,0,11,0,11
2003,Belarus,BLR,United Kingdom of Great Britain and Northern Ireland,GBR,5,5,129,73,212
2003,Bolivia (Plurinational State of),BOL,United Kingdom of Great Britain and Northern Ireland,GBR,5,5,134,21,165
2003,Botswana,BWA,United Kingdom of Great Britain and Northern Ireland,GBR,0,0,19,0,19
2003,Brazil,BRA,United Kingdom of Great Britain and Northern Ireland,GBR,0,0,15,11,26
2003,Bosnia and Herzegovina,BIH,United Kingdom of Great Britain and Northern Ireland,GBR,5,0,82,34,121
2003,Bulgaria,BGR,United Kingdom of Great Britain and Northern Ireland,GBR,0,0,39,13,52
2003,Central African Rep.,CAF,United Kingdom of Great Britain and Northern Ireland,GBR,0,0,13,0,13
2003,Chad,TCD,United Kingdom of Great Britain and Northern Ireland,GBR,5,5,28,5,43
2003,China,CHN,United Kingdom of Great Britain and Northern Ireland,GBR,26,153,1864,1883,3926
2003,Chile,CHL,United Kingdom of Great Britain and Northern Ireland,GBR,0,0,16,0,16
2003,Cameroon,CMR,United Kingdom of Great Britain and Northern Ireland,GBR,21,43,523,43,630
2003,Congo,COG,United Kingdom of Great Britain and Northern Ireland,GBR,46,41,367,56,510
2003,Dem. Rep. of the Congo,COD,United Kingdom of Great Britain and Northern Ireland,GBR,126,226,1979,172,2503
2003,Comoros,COM,United Kingdom of Great Britain and Northern Ireland,GBR,0,0,5,0,5
2003,Colombia,COL,United Kingdom of Great Britain and Northern Ireland,GBR,18,5,377,54,454
2003,Cuba,CUB,United Kingdom of Great Britain and Northern Ireland,GBR,0,0,18,5,23
2003,Cyprus,CYP,United Kingdom of Great Britain and Northern Ireland,GBR,0,0,92,10,102
2003,Czechia,CZE,United Kingdom of Great Britain and Northern Ireland,GBR,0,0,179,51,230
2003,Ecuador,ECU,United Kingdom of Great Britain and Northern Ireland,GBR,5,13,313,48,379
2003,Equatorial Guinea,GNQ,United Kingdom of Great Britain and Northern Ireland,GBR,11,0,0,0,11
2003,Eritrea,ERI,United Kingdom of Great Britain and Northern Ireland,GBR,76,178,954,66,1274
2003,Estonia,EST,United Kingdom of Great Britain and Northern Ireland,GBR,0,0,30,13,43
2003,Ethiopia,ETH,United Kingdom of Great Britain and Northern Ireland,GBR,15,136,606,49,806
2003,Fiji,FJI,United Kingdom of Great Britain and Northern Ireland,GBR,0,0,5,0,5
2003,Gambia,GMB,United Kingdom of Great Britain and Northern Ireland,GBR,0,11,81,30,122
2003,Palestinian,PSE,United Kingdom of Great Britain and Northern Ireland,GBR,13,39,1388,198,1638
2003,Georgia,GEO,United Kingdom of Great Britain and Northern Ireland,GBR,12,5,198,57,272
2003,Ghana,GHA,United Kingdom of Great Britain and Northern Ireland,GBR,13,15,272,82,382
2003,Guinea-Bissau,GNB,United Kingdom of Great Britain and Northern Ireland,GBR,0,0,20,0,20
2003,Guatemala,GTM,United Kingdom of Great Britain and Northern Ireland,GBR,0,0,10,0,10
2003,Guinea,GIN,United Kingdom of Great Britain and Northern Ireland,GBR,11,38,154,26,229
2003,Guyana,GUY,United Kingdom of Great Britain and Northern Ireland,GBR,0,0,15,5,20
2003,Honduras,HND,United Kingdom of Great Britain and Northern Ireland,GBR,0,0,5,0,5
2003,Croatia,HRV,United Kingdom of Great Britain and Northern Ireland,GBR,0,0,122,22,144
2003,Hungary,HUN,United Kingdom of Great Britain and Northern Ireland,GBR,0,0,16,5,21
2003,Cote d'Ivoire,CIV,United Kingdom of Great Britain and Northern Ireland,GBR,26,28,450,77,581
2003,India,IND,United Kingdom of Great Britain and Northern Ireland,GBR,11,33,1434,996,2474
2003,Indonesia,IDN,United Kingdom of Great Britain and Northern Ireland,GBR,0,0,15,19,34
2003,Iran (Islamic Rep. of),IRN,United Kingdom of Great Britain and Northern Ireland,GBR,146,128,3190,464,3928
2003,Iraq,IRQ,United Kingdom of Great Britain and Northern Ireland,GBR,86,2326,3861,1017,7290
2003,Israel,ISR,United Kingdom of Great Britain and Northern Ireland,GBR,0,0,82,10,92
2003,Jamaica,JAM,United Kingdom of Great Britain and Northern Ireland,GBR,0,16,1067,225,1308
2003,Jordan,JOR,United Kingdom of Great Britain and Northern Ireland,GBR,0,0,40,0,40
2003,Kazakhstan,KAZ,United Kingdom of Great Britain and Northern Ireland,GBR,0,0,20,5,25
2003,Kenya,KEN,United Kingdom of Great Britain and Northern Ireland,GBR,19,46,271,49,385
2003,Kyrgyzstan,KGZ,United Kingdom of Great Britain and Northern Ireland,GBR,5,0,23,10,38
2003,Kuwait,KWT,United Kingdom of Great Britain and Northern Ireland,GBR,13,0,54,5,72
2003,Liberia,LBR,United Kingdom of Great Britain and Northern Ireland,GBR,15,99,542,145,801
2003,Libya,LBY,United Kingdom of Great Britain and Northern Ireland,GBR,32,17,243,33,325
2003,Lebanon,LBN,United Kingdom of Great Britain and Northern Ireland,GBR,10,16,346,28,400
2003,Sri Lanka,LKA,United Kingdom of Great Britain and Northern Ireland,GBR,27,100,1394,193,1714
2003,Lithuania,LTU,United Kingdom of Great Britain and Northern Ireland,GBR,0,5,147,46,198
2003,Latvia,LVA,United Kingdom of Great Britain and Northern Ireland,GBR,0,0,83,23,106
2003,North Macedonia,MKD,United Kingdom of Great Britain and Northern Ireland,GBR,0,33,68,30,131
2003,Rep. of Moldova,MDA,United Kingdom of Great Britain and Northern Ireland,GBR,0,63,260,209,532
2003,Mexico,MEX,United Kingdom of Great Britain and Northern Ireland,GBR,0,0,5,0,5
2003,Mali,MLI,United Kingdom of Great Britain and Northern Ireland,GBR,0,0,5,5,10
2003,Malaysia,MYS,United Kingdom of Great Britain and Northern Ireland,GBR,0,0,22,12,34
2003,Malawi,MWI,United Kingdom of Great Britain and Northern Ireland,GBR,0,5,142,27,174
2003,Mongolia,MNG,United Kingdom of Great Britain and Northern Ireland,GBR,5,5,171,90,271
2003,Morocco,MAR,United Kingdom of Great Britain and Northern Ireland,GBR,0,5,22,10,37
2003,Mozambique,MOZ,United Kingdom of Great Britain and Northern Ireland,GBR,0,0,5,0,5
2003,Mauritius,MUS,United Kingdom of Great Britain and Northern Ireland,GBR,0,0,13,0,13
2003,Myanmar,MMR,United Kingdom of Great Britain and Northern Ireland,GBR,34,10,105,14,163
2003,Nepal,NPL,United Kingdom of Great Britain and Northern Ireland,GBR,0,5,261,38,304
2003,Niger,NER,United Kingdom of Great Britain and Northern Ireland,GBR,0,0,11,0,11
2003,Nigeria,NGA,United Kingdom of Great Britain and Northern Ireland,GBR,16,61,847,302,1226
2003,Oman,OMN,United Kingdom of Great Britain and Northern Ireland,GBR,0,0,5,0,5
2003,Pakistan,PAK,United Kingdom of Great Britain and Northern Ireland,GBR,167,73,2775,571,3586
2003,Panama,PAN,United Kingdom of Great Britain and Northern Ireland,GBR,0,5,0,0,5
2003,Paraguay,PRY,United Kingdom of Great Britain and Northern Ireland,GBR,0,0,0,5,5
2003,Peru,PER,United Kingdom of Great Britain and Northern Ireland,GBR,5,0,5,0,10
2003,Philippines,PHL,United Kingdom of Great Britain and Northern Ireland,GBR,0,0,13,5,18
2003,Poland,POL,United Kingdom of Great Britain and Northern Ireland,GBR,5,13,206,57,281
2003,Romania,ROU,United Kingdom of Great Britain and Northern Ireland,GBR,0,50,692,451,1193
2003,South Africa,ZAF,United Kingdom of Great Britain and Northern Ireland,GBR,0,5,266,43,314
2003,Russian Federation,RUS,United Kingdom of Great Britain and Northern Ireland,GBR,26,14,368,116,524
2003,Rwanda,RWA,United Kingdom of Great Britain and Northern Ireland,GBR,34,70,419,44,567
2003,Serbia and Kosovo: S/RES/1244 (1999),SRB,United Kingdom of Great Britain and Northern Ireland,GBR,42,349,2146,408,2945
2003,Senegal,SEN,United Kingdom of Great Britain and Northern Ireland,GBR,0,0,31,5,36
2003,Seychelles,SYC,United Kingdom of Great Britain and Northern Ireland,GBR,0,0,10,0,10
2003,Singapore,SGP,United Kingdom of Great Britain and Northern Ireland,GBR,0,0,0,5,5
2003,Sierra Leone,SLE,United Kingdom of Great Britain and Northern Ireland,GBR,17,72,545,130,764
2003,Somalia,SOM,United Kingdom of Great Britain and Northern Ireland,GBR,2469,633,4843,749,8694
2003,Viet Nam,VNM,United Kingdom of Great Britain and Northern Ireland,GBR,12,198,670,355,1235
2003,Sudan,SDN,United Kingdom of Great Britain and Northern Ireland,GBR,139,24,604,138,905
2003,Slovakia,SVK,United Kingdom of Great Britain and Northern Ireland,GBR,0,0,28,21,49
2003,Slovenia,SVN,United Kingdom of Great Britain and Northern Ireland,GBR,0,0,5,0,5
2003,Eswatini,SWZ,United Kingdom of Great Britain and Northern Ireland,GBR,0,0,5,0,5
2003,Syrian Arab Rep.,SYR,United Kingdom of Great Britain and Northern Ireland,GBR,15,0,142,18,175
2003,United Rep. of Tanzania,TZA,United Kingdom of Great Britain and Northern Ireland,GBR,5,10,50,10,75
2003,Thailand,THA,United Kingdom of Great Britain and Northern Ireland,GBR,0,0,5,0,5
2003,Tajikistan,TJK,United Kingdom of Great Britain and Northern Ireland,GBR,0,0,5,0,5
2003,Turkmenistan,TKM,United Kingdom of Great Britain and Northern Ireland,GBR,5,0,18,0,23
2003,Togo,TGO,United Kingdom of Great Britain and Northern Ireland,GBR,13,10,77,15,115
2003,Trinidad and Tobago,TTO,United Kingdom of Great Britain and Northern Ireland,GBR,0,0,11,5,16
2003,Tunisia,TUN,United Kingdom of Great Britain and Northern Ireland,GBR,12,0,5,0,17
2003,Turkey,TUR,United Kingdom of Great Britain and Northern Ireland,GBR,129,146,3547,327,4149
2003,United Arab Emirates,ARE,United Kingdom of Great Britain and Northern Ireland,GBR,0,0,10,0,10
2003,Uganda,UGA,United Kingdom of Great Britain and Northern Ireland,GBR,31,169,596,97,893
2003,Ukraine,UKR,United Kingdom of Great Britain and Northern Ireland,GBR,0,10,319,89,418
2003,Uzbekistan,UZB,United Kingdom of Great Britain and Northern Ireland,GBR,0,0,18,10,28
2003,Venezuela (Bolivarian Republic of),VEN,United Kingdom of Great Britain and Northern Ireland,GBR,0,0,18,5,23
2003,Yemen,YEM,United Kingdom of Great Britain and Northern Ireland,GBR,12,18,138,30,198
2003,Zambia,ZMB,United Kingdom of Great Britain and Northern Ireland,GBR,10,0,13,5,28
2003,Zimbabwe,ZWE,United Kingdom of Great Britain and Northern Ireland,GBR,1070,36,3431,500,5037
2003,Stateless,XXA,United Kingdom of Great Britain and Northern Ireland,GBR,24,34,233,66,357
2003,Chad,TCD,Ghana,GHA,0,0,0,5,5
2003,Dem. Rep. of the Congo,COD,Ghana,GHA,0,0,0,28,28
2003,Cote d'Ivoire,CIV,Ghana,GHA,0,0,0,3733,3733
2003,Liberia,LBR,Ghana,GHA,11525,0,0,0,11525
2003,Nigeria,NGA,Ghana,GHA,0,0,0,5,5
2003,Sierra Leone,SLE,Ghana,GHA,0,0,0,716,716
2003,Somalia,SOM,Ghana,GHA,0,0,0,5,5
2003,Sudan,SDN,Ghana,GHA,5,0,0,0,5
2003,Liberia,LBR,Guinea-Bissau,GNB,12,0,0,0,12
2003,Sierra Leone,SLE,Guinea-Bissau,GNB,5,0,19,0,24
2003,Afghanistan,AFG,Greece,GRC,0,0,523,5,528
2003,Albania,ALB,Greece,GRC,0,0,12,0,12
2003,Algeria,DZA,Greece,GRC,0,0,5,0,5
2003,Egypt,EGY,Greece,GRC,0,0,5,0,5
2003,Armenia,ARM,Greece,GRC,0,0,5,0,5
2003,Burundi,BDI,Greece,GRC,0,0,10,0,10
2003,Bangladesh,BGD,Greece,GRC,0,0,62,0,62
2003,Belarus,BLR,Greece,GRC,0,0,0,13,13
2003,Bosnia and Herzegovina,BIH,Greece,GRC,0,0,0,5,5
2003,China,CHN,Greece,GRC,0,0,27,0,27
2003,Dem. Rep. of the Congo,COD,Greece,GRC,0,0,16,5,21
2003,Eritrea,ERI,Greece,GRC,0,0,5,0,5
2003,Ethiopia,ETH,Greece,GRC,0,0,60,0,60
2003,Palestinian,PSE,Greece,GRC,0,0,91,0,91
2003,Georgia,GEO,Greece,GRC,0,0,23,0,23
2003,Ghana,GHA,Greece,GRC,0,0,5,0,5
2003,Cote d'Ivoire,CIV,Greece,GRC,0,0,5,0,5
2003,India,IND,Greece,GRC,0,0,73,0,73
2003,Iran (Islamic Rep. of),IRN,Greece,GRC,0,5,434,5,444
2003,Iraq,IRQ,Greece,GRC,0,16,1909,14,1939
2003,Liberia,LBR,Greece,GRC,0,0,11,0,11
2003,Libya,LBY,Greece,GRC,0,0,5,0,5
2003,Lebanon,LBN,Greece,GRC,0,0,5,0,5
2003,Sri Lanka,LKA,Greece,GRC,0,0,36,0,36
2003,Rep. of Moldova,MDA,Greece,GRC,0,0,5,5,10
2003,Myanmar,MMR,Greece,GRC,0,0,136,0,136
2003,Nigeria,NGA,Greece,GRC,0,0,209,10,219
2003,Pakistan,PAK,Greece,GRC,0,0,283,5,288
2003,Russian Federation,RUS,Greece,GRC,0,0,30,15,45
2003,Rwanda,RWA,Greece,GRC,0,0,29,0,29
2003,Sierra Leone,SLE,Greece,GRC,0,0,53,5,58
2003,Somalia,SOM,Greece,GRC,0,0,92,0,92
2003,Sudan,SDN,Greece,GRC,0,0,129,0,129
2003,Syrian Arab Rep.,SYR,Greece,GRC,0,0,13,0,13
2003,Turkey,TUR,Greece,GRC,0,0,166,46,212
2003,Ukraine,UKR,Greece,GRC,0,0,5,0,5
2003,Uzbekistan,UZB,Greece,GRC,0,0,36,5,41
2003,Colombia,COL,Guatemala,GTM,0,0,0,5,5
2003,Cuba,CUB,Guatemala,GTM,0,0,0,5,5
2003,Nicaragua,NIC,Guatemala,GTM,0,0,5,0,5
2003,Dem. Rep. of the Congo,COD,Guinea,GIN,5,0,0,0,5
2003,Cuba,CUB,Guinea,GIN,10,0,0,0,10
2003,Cote d'Ivoire,CIV,Guinea,GIN,224,0,35,0,259
2003,Liberia,LBR,Guinea,GIN,417,0,72,0,489
2003,Nigeria,NGA,Guinea,GIN,5,0,0,0,5
2003,Sierra Leone,SLE,Guinea,GIN,1863,0,132,0,1995
2003,Colombia,COL,Honduras,HND,0,0,5,5,10
2003,Cuba,CUB,Honduras,HND,0,0,41,24,65
2003,Ethiopia,ETH,Honduras,HND,5,0,0,0,5
2003,Bosnia and Herzegovina,BIH,Croatia,HRV,0,0,0,5,5
2003,Palestinian,PSE,Croatia,HRV,0,0,0,10,10
2003,Iraq,IRQ,Croatia,HRV,0,0,0,5,5
2003,Liberia,LBR,Croatia,HRV,0,0,0,14,14
2003,Nigeria,NGA,Croatia,HRV,0,0,0,5,5
2003,Serbia and Kosovo: S/RES/1244 (1999),SRB,Croatia,HRV,0,0,0,10,10
2003,Afghanistan,AFG,Hungary,HUN,28,359,26,266,679
2003,Algeria,DZA,Hungary,HUN,0,14,35,24,73
2003,Angola,AGO,Hungary,HUN,5,0,0,0,5
2003,Egypt,EGY,Hungary,HUN,0,0,5,17,22
2003,Armenia,ARM,Hungary,HUN,10,5,20,16,51
2003,Azerbaijan,AZE,Hungary,HUN,0,0,10,0,10
2003,Bangladesh,BGD,Hungary,HUN,0,0,32,23,55
2003,Belarus,BLR,Hungary,HUN,0,0,5,0,5
2003,Bosnia and Herzegovina,BIH,Hungary,HUN,0,0,0,5,5
2003,China,CHN,Hungary,HUN,0,0,71,13,84
2003,Cameroon,CMR,Hungary,HUN,5,0,0,5,10
2003,Congo,COG,Hungary,HUN,0,0,0,5,5
2003,Dem. Rep. of the Congo,COD,Hungary,HUN,0,0,0,5,5
2003,Ethiopia,ETH,Hungary,HUN,5,0,0,0,5
2003,Palestinian,PSE,Hungary,HUN,0,5,5,20,30
2003,Georgia,GEO,Hungary,HUN,14,17,68,131,230
2003,Ghana,GHA,Hungary,HUN,0,0,0,5,5
2003,Cote d'Ivoire,CIV,Hungary,HUN,0,0,0,5,5
2003,India,IND,Hungary,HUN,0,0,37,34,71
2003,Iran (Islamic Rep. of),IRN,Hungary,HUN,10,47,42,84,183
2003,Iraq,IRQ,Hungary,HUN,33,208,77,364,682
2003,Liberia,LBR,Hungary,HUN,0,0,10,11,21
2003,Libya,LBY,Hungary,HUN,0,0,5,0,5
2003,Sri Lanka,LKA,Hungary,HUN,0,0,0,11,11
2003,North Macedonia,MKD,Hungary,HUN,0,0,12,5,17
2003,Rep. of Moldova,MDA,Hungary,HUN,0,0,12,5,17
2003,Mongolia,MNG,Hungary,HUN,0,0,5,0,5
2003,Nigeria,NGA,Hungary,HUN,0,5,45,17,67
2003,Pakistan,PAK,Hungary,HUN,0,0,22,29,51
2003,Poland,POL,Hungary,HUN,0,0,5,0,5
2003,Romania,ROU,Hungary,HUN,0,0,14,0,14
2003,Russian Federation,RUS,Hungary,HUN,10,43,17,30,100
2003,Serbia and Kosovo: S/RES/1244 (1999),SRB,Hungary,HUN,20,0,71,33,124
2003,Senegal,SEN,Hungary,HUN,0,0,5,12,17
2003,Sierra Leone,SLE,Hungary,HUN,0,0,0,11,11
2003,Somalia,SOM,Hungary,HUN,0,24,5,110,139
2003,Viet Nam,VNM,Hungary,HUN,0,0,43,10,53
2003,Sudan,SDN,Hungary,HUN,10,11,10,30,61
2003,Slovakia,SVK,Hungary,HUN,0,0,5,5,10
2003,Syrian Arab Rep.,SYR,Hungary,HUN,0,11,0,5,16
2003,Tunisia,TUN,Hungary,HUN,0,0,0,5,5
2003,Turkey,TUR,Hungary,HUN,10,5,20,86,121
2003,Ukraine,UKR,Hungary,HUN,0,0,11,5,16
2003,Uzbekistan,UZB,Hungary,HUN,5,0,0,0,5
2003,Stateless,XXA,Hungary,HUN,11,0,0,10,21
2003,Albania,ALB,Iceland,ISL,0,0,11,0,11
2003,Belarus,BLR,Iceland,ISL,0,0,5,0,5
2003,China,CHN,Iceland,ISL,0,0,0,5,5
2003,Mongolia,MNG,Iceland,ISL,0,0,5,0,5
2003,Poland,POL,Iceland,ISL,0,0,0,5,5
2003,Romania,ROU,Iceland,ISL,0,0,20,5,25
2003,Russian Federation,RUS,Iceland,ISL,0,0,5,0,5
2003,Slovakia,SVK,Iceland,ISL,0,5,0,0,5
2003,Afghanistan,AFG,Ireland,IRL,0,0,0,12,12
2003,Albania,ALB,Ireland,IRL,11,0,86,24,121
2003,Algeria,DZA,Ireland,IRL,0,0,60,19,79
2003,Angola,AGO,Ireland,IRL,27,0,90,0,117
2003,Egypt,EGY,Ireland,IRL,0,0,5,0,5
2003,Azerbaijan,AZE,Ireland,IRL,5,0,0,0,5
2003,Burundi,BDI,Ireland,IRL,5,0,5,0,10
2003,Benin,BEN,Ireland,IRL,0,0,5,0,5
2003,Bangladesh,BGD,Ireland,IRL,0,0,5,5,10
2003,Burkina Faso,BFA,Ireland,IRL,0,0,5,0,5
2003,Belarus,BLR,Ireland,IRL,0,0,22,40,62
2003,Bosnia and Herzegovina,BIH,Ireland,IRL,0,0,12,0,12
2003,Bulgaria,BGR,Ireland,IRL,0,0,27,12,39
2003,China,CHN,Ireland,IRL,14,0,25,81,120
2003,Cameroon,CMR,Ireland,IRL,10,0,98,0,108
2003,Congo,COG,Ireland,IRL,0,0,5,0,5
2003,Dem. Rep. of the Congo,COD,Ireland,IRL,12,0,157,17,186
2003,Czechia,CZE,Ireland,IRL,0,0,202,41,243
2003,Eritrea,ERI,Ireland,IRL,5,0,0,0,5
2003,Estonia,EST,Ireland,IRL,0,0,36,5,41
2003,Ethiopia,ETH,Ireland,IRL,5,0,0,0,5
2003,Gambia,GMB,Ireland,IRL,0,0,0,12,12
2003,Palestinian,PSE,Ireland,IRL,10,0,10,10,30
2003,United Kingdom of Great Britain and Northern Ireland,GBR,Ireland,IRL,10,0,0,0,10
2003,Georgia,GEO,Ireland,IRL,5,0,58,5,68
2003,Ghana,GHA,Ireland,IRL,0,0,187,36,223
2003,Guinea,GIN,Ireland,IRL,0,0,11,0,11
2003,Croatia,HRV,Ireland,IRL,10,0,145,13,168
2003,Hungary,HUN,Ireland,IRL,0,0,14,0,14
2003,Cote d'Ivoire,CIV,Ireland,IRL,5,0,43,5,53
2003,India,IND,Ireland,IRL,0,0,5,19,24
2003,Iran (Islamic Rep. of),IRN,Ireland,IRL,11,0,5,11,27
2003,Iraq,IRQ,Ireland,IRL,11,0,10,13,34
2003,Israel,ISR,Ireland,IRL,0,0,55,5,60
2003,Jamaica,JAM,Ireland,IRL,0,0,13,0,13
2003,Jordan,JOR,Ireland,IRL,0,0,5,0,5
2003,Kazakhstan,KAZ,Ireland,IRL,0,0,38,0,38
2003,Kenya,KEN,Ireland,IRL,0,0,60,5,65
2003,Liberia,LBR,Ireland,IRL,5,0,36,10,51
2003,Libya,LBY,Ireland,IRL,0,0,0,13,13
2003,Lebanon,LBN,Ireland,IRL,0,0,5,10,15
2003,Sri Lanka,LKA,Ireland,IRL,0,0,0,5,5
2003,Lithuania,LTU,Ireland,IRL,0,0,127,42,169
2003,Latvia,LVA,Ireland,IRL,0,0,20,19,39
2003,Rep. of Moldova,MDA,Ireland,IRL,12,0,227,370,609
2003,Malaysia,MYS,Ireland,IRL,0,0,0,5,5
2003,Malawi,MWI,Ireland,IRL,0,0,5,5,10
2003,Mongolia,MNG,Ireland,IRL,0,0,0,5,5
2003,Morocco,MAR,Ireland,IRL,0,0,11,0,11
2003,Niger,NER,Ireland,IRL,0,0,5,0,5
2003,Nigeria,NGA,Ireland,IRL,21,0,1789,395,2205
2003,Pakistan,PAK,Ireland,IRL,17,0,49,32,98
2003,Poland,POL,Ireland,IRL,0,0,128,35,163
2003,Romania,ROU,Ireland,IRL,5,0,800,792,1597
2003,South Africa,ZAF,Ireland,IRL,5,0,111,20,136
2003,Russian Federation,RUS,Ireland,IRL,5,0,90,36,131
2003,Rwanda,RWA,Ireland,IRL,0,0,5,5,10
2003,Serbia and Kosovo: S/RES/1244 (1999),SRB,Ireland,IRL,5,0,64,34,103
2003,Sierra Leone,SLE,Ireland,IRL,0,0,43,26,69
2003,Somalia,SOM,Ireland,IRL,24,0,31,12,67
2003,Sudan,SDN,Ireland,IRL,16,0,30,5,51
2003,Slovakia,SVK,Ireland,IRL,0,0,20,5,25
2003,Eswatini,SWZ,Ireland,IRL,0,0,5,0,5
2003,Syrian Arab Rep.,SYR,Ireland,IRL,0,0,0,11,11
2003,Tajikistan,TJK,Ireland,IRL,0,0,5,0,5
2003,Togo,TGO,Ireland,IRL,5,0,51,0,56
2003,Turkey,TUR,Ireland,IRL,0,0,13,5,18
2003,Uganda,UGA,Ireland,IRL,0,0,13,0,13
2003,Ukraine,UKR,Ireland,IRL,10,0,117,68,195
2003,Uzbekistan,UZB,Ireland,IRL,0,0,10,0,10
2003,Zambia,ZMB,Ireland,IRL,0,0,5,0,5
2003,Zimbabwe,ZWE,Ireland,IRL,46,0,93,10,149
2003,Stateless,XXA,Ireland,IRL,0,0,22,14,36
2003,Afghanistan,AFG,Japan,JPN,0,0,5,0,5
2003,Bangladesh,BGD,Japan,JPN,0,0,12,0,12
2003,China,CHN,Japan,JPN,0,0,33,0,33
2003,Cameroon,CMR,Japan,JPN,0,0,16,5,21
2003,Guinea,GIN,Japan,JPN,0,0,5,0,5
2003,Cote d'Ivoire,CIV,Japan,JPN,0,0,5,0,5
2003,Iran (Islamic Rep. of),IRN,Japan,JPN,0,0,20,5,25
2003,Sri Lanka,LKA,Japan,JPN,0,0,5,0,5
2003,Myanmar,MMR,Japan,JPN,5,0,73,0,78
2003,Nigeria,NGA,Japan,JPN,0,0,10,0,10
2003,Pakistan,PAK,Japan,JPN,0,0,23,0,23
2003,Turkey,TUR,Japan,JPN,0,0,65,5,70
2003,Afghanistan,AFG,Kazakhstan,KAZ,17,0,21,0,38
2003,Afghanistan,AFG,Kyrgyzstan,KGZ,20,0,49,0,69
2003,China,CHN,Kyrgyzstan,KGZ,5,5,0,0,10
2003,Ethiopia,ETH,Kyrgyzstan,KGZ,0,0,13,0,13
2003,Russian Federation,RUS,Kyrgyzstan,KGZ,0,0,0,138,138
2003,Cameroon,CMR,Rep. of Korea,KOR,5,0,0,0,5
2003,Myanmar,MMR,Rep. of Korea,KOR,5,0,0,0,5
2003,Belarus,BLR,Liechtenstein,LIE,0,0,0,5,5
2003,Bosnia and Herzegovina,BIH,Liechtenstein,LIE,0,0,5,0,5
2003,Bulgaria,BGR,Liechtenstein,LIE,0,0,0,5,5
2003,North Macedonia,MKD,Liechtenstein,LIE,0,0,40,16,56
2003,Russian Federation,RUS,Liechtenstein,LIE,0,0,5,0,5
2003,Serbia and Kosovo: S/RES/1244 (1999),SRB,Liechtenstein,LIE,0,12,28,11,51
2003,Ukraine,UKR,Liechtenstein,LIE,0,0,5,5,10
2003,Afghanistan,AFG,Lithuania,LTU,0,5,0,23,28
2003,Azerbaijan,AZE,Lithuania,LTU,0,0,5,0,5
2003,Georgia,GEO,Lithuania,LTU,0,0,5,0,5
2003,India,IND,Lithuania,LTU,0,0,5,0,5
2003,Iraq,IRQ,Lithuania,LTU,0,0,0,5,5
2003,Pakistan,PAK,Lithuania,LTU,0,0,5,0,5
2003,Russian Federation,RUS,Lithuania,LTU,0,23,10,193,226
2003,Turkey,TUR,Lithuania,LTU,0,0,11,0,11
2003,Ukraine,UKR,Lithuania,LTU,5,0,0,0,5
2003,Stateless,XXA,Lithuania,LTU,0,0,0,5,5
2003,Georgia,GEO,Latvia,LVA,0,0,5,0,5
2003,Russian Federation,RUS,Latvia,LVA,0,5,0,0,5
2003,Serbia and Kosovo: S/RES/1244 (1999),SRB,North Macedonia,MKD,0,0,50,10,60
2003,Afghanistan,AFG,Rep. of Moldova,MDA,0,0,0,5,5
2003,Georgia,GEO,Rep. of Moldova,MDA,0,0,0,5,5
2003,Iraq,IRQ,Rep. of Moldova,MDA,0,0,0,5,5
2003,Russian Federation,RUS,Rep. of Moldova,MDA,0,0,0,11,11
2003,Sudan,SDN,Rep. of Moldova,MDA,0,0,0,5,5
2003,Tajikistan,TJK,Rep. of Moldova,MDA,0,0,0,10,10
2003,Albania,ALB,Mexico,MEX,0,0,5,5,10
2003,Argentina,ARG,Mexico,MEX,0,0,5,0,5
2003,Armenia,ARM,Mexico,MEX,0,0,0,5,5
2003,Bangladesh,BGD,Mexico,MEX,0,0,0,11,11
2003,China,CHN,Mexico,MEX,0,0,5,0,5
2003,Dem. Rep. of the Congo,COD,Mexico,MEX,5,0,0,0,5
2003,Colombia,COL,Mexico,MEX,13,0,20,16,49
2003,Cuba,CUB,Mexico,MEX,0,0,5,10,15
2003,Eritrea,ERI,Mexico,MEX,0,0,5,0,5
2003,Ethiopia,ETH,Mexico,MEX,0,0,11,0,11
2003,Guatemala,GTM,Mexico,MEX,0,0,47,5,52
2003,Honduras,HND,Mexico,MEX,10,0,10,12,32
2003,Cote d'Ivoire,CIV,Mexico,MEX,5,0,0,0,5
2003,Iraq,IRQ,Mexico,MEX,0,0,0,5,5
2003,Nigeria,NGA,Mexico,MEX,0,0,10,0,10
2003,El Salvador,SLV,Mexico,MEX,0,0,5,0,5
2003,United States of America,USA,Mexico,MEX,0,0,5,0,5
2003,Burundi,BDI,Mali,MLI,5,0,0,0,5
2003,Central African Rep.,CAF,Mali,MLI,5,0,0,0,5
2003,Dem. Rep. of the Congo,COD,Mali,MLI,5,0,5,0,10
2003,Cote d'Ivoire,CIV,Mali,MLI,405,0,0,0,405
2003,Liberia,LBR,Mali,MLI,15,0,0,0,15
2003,Mauritania,MRT,Mali,MLI,28,0,0,0,28
2003,Rwanda,RWA,Mali,MLI,5,0,0,0,5
2003,Sierra Leone,SLE,Mali,MLI,13,0,5,0,18
2003,Togo,TGO,Mali,MLI,5,0,0,0,5
2003,Burundi,BDI,Malawi,MWI,264,0,0,615,879
2003,Dem. Rep. of the Congo,COD,Malawi,MWI,389,0,5,377,771
2003,Rwanda,RWA,Malawi,MWI,706,0,5,1053,1764
2003,Somalia,SOM,Malawi,MWI,41,0,0,14,55
2003,Sudan,SDN,Malawi,MWI,0,0,0,5,5
2003,Burundi,BDI,Mozambique,MOZ,31,0,0,10,41
2003,Dem. Rep. of the Congo,COD,Mozambique,MOZ,75,0,0,25,100
2003,Rwanda,RWA,Mozambique,MOZ,5,0,0,5,10
2003,Somalia,SOM,Mozambique,MOZ,5,0,0,0,5
2003,Algeria,DZA,Malta,MLT,0,0,5,0,5
2003,Chad,TCD,Malta,MLT,0,0,5,0,5
2003,Dem. Rep. of the Congo,COD,Malta,MLT,19,45,5,0,69
2003,Eritrea,ERI,Malta,MLT,14,10,13,0,37
2003,Ethiopia,ETH,Malta,MLT,5,10,31,0,46
2003,Palestinian,PSE,Malta,MLT,0,0,14,0,14
2003,Guinea,GIN,Malta,MLT,0,0,5,0,5
2003,Cote d'Ivoire,CIV,Malta,MLT,0,18,25,0,43
2003,Iraq,IRQ,Malta,MLT,0,5,0,10,15
2003,Liberia,LBR,Malta,MLT,0,0,67,0,67
2003,Libya,LBY,Malta,MLT,0,0,5,5,10
2003,North Macedonia,MKD,Malta,MLT,0,0,10,0,10
2003,Mali,MLI,Malta,MLT,0,0,5,0,5
2003,Serbia and Kosovo: S/RES/1244 (1999),SRB,Malta,MLT,0,0,5,0,5
2003,Somalia,SOM,Malta,MLT,5,161,5,0,171
2003,Sudan,SDN,Malta,MLT,0,19,5,0,24
2003,Syrian Arab Rep.,SYR,Malta,MLT,0,0,5,0,5
2003,Turkey,TUR,Malta,MLT,0,0,11,0,11
2003,Burundi,BDI,Namibia,NAM,14,0,0,5,19
2003,Congo,COG,Namibia,NAM,5,0,0,0,5
2003,Dem. Rep. of the Congo,COD,Namibia,NAM,19,0,0,33,52
2003,Oman,OMN,Namibia,NAM,0,0,0,5,5
2003,Rwanda,RWA,Namibia,NAM,0,0,0,5,5
2003,Sierra Leone,SLE,Namibia,NAM,0,0,0,5,5
2003,Sudan,SDN,Namibia,NAM,0,0,0,5,5
2003,United Rep. of Tanzania,TZA,Namibia,NAM,0,0,0,5,5
2003,Afghanistan,AFG,Netherlands,NLD,93,504,2458,280,3335
2003,Albania,ALB,Netherlands,NLD,0,0,30,15,45
2003,Algeria,DZA,Netherlands,NLD,0,0,86,36,122
2003,Angola,AGO,Netherlands,NLD,10,186,935,131,1262
2003,Egypt,EGY,Netherlands,NLD,0,0,27,10,37
2003,Armenia,ARM,Netherlands,NLD,10,55,318,40,423
2003,Azerbaijan,AZE,Netherlands,NLD,21,88,383,62,554
2003,Burundi,BDI,Netherlands,NLD,0,240,126,40,406
2003,Belgium,BEL,Netherlands,NLD,0,0,0,5,5
2003,Benin,BEN,Netherlands,NLD,0,5,59,0,64
2003,Bangladesh,BGD,Netherlands,NLD,0,0,20,5,25
2003,Bhutan,BTN,Netherlands,NLD,0,0,5,0,5
2003,Burkina Faso,BFA,Netherlands,NLD,0,0,5,0,5
2003,Belarus,BLR,Netherlands,NLD,5,5,65,12,87
2003,Brazil,BRA,Netherlands,NLD,0,0,5,0,5
2003,Bosnia and Herzegovina,BIH,Netherlands,NLD,0,29,171,23,223
2003,Bulgaria,BGR,Netherlands,NLD,0,0,12,5,17
2003,Central African Rep.,CAF,Netherlands,NLD,0,0,5,0,5
2003,Chad,TCD,Netherlands,NLD,0,0,12,0,12
2003,China,CHN,Netherlands,NLD,5,14,373,66,458
2003,Cameroon,CMR,Netherlands,NLD,5,12,136,10,163
2003,Congo,COG,Netherlands,NLD,10,50,179,21,260
2003,Dem. Rep. of the Congo,COD,Netherlands,NLD,5,44,294,37,380
2003,Colombia,COL,Netherlands,NLD,5,5,15,14,39
2003,Cuba,CUB,Netherlands,NLD,0,0,13,0,13
2003,Czechia,CZE,Netherlands,NLD,0,0,21,5,26
2003,Djibouti,DJI,Netherlands,NLD,0,5,0,0,5
2003,Ecuador,ECU,Netherlands,NLD,0,0,5,0,5
2003,Eritrea,ERI,Netherlands,NLD,5,22,95,15,137
2003,Ethiopia,ETH,Netherlands,NLD,0,20,136,10,166
2003,France,FRA,Netherlands,NLD,0,0,5,5,10
2003,Gambia,GMB,Netherlands,NLD,0,0,5,0,5
2003,Palestinian,PSE,Netherlands,NLD,0,0,5,5,10
2003,United Kingdom of Great Britain and Northern Ireland,GBR,Netherlands,NLD,0,0,5,0,5
2003,Georgia,GEO,Netherlands,NLD,0,17,143,14,174
2003,Ghana,GHA,Netherlands,NLD,0,0,33,5,38
2003,Guinea-Bissau,GNB,Netherlands,NLD,0,0,14,0,14
2003,Guinea,GIN,Netherlands,NLD,5,50,372,26,453
2003,Croatia,HRV,Netherlands,NLD,0,0,11,10,21
2003,Hungary,HUN,Netherlands,NLD,0,0,11,0,11
2003,Cote d'Ivoire,CIV,Netherlands,NLD,10,30,224,21,285
2003,India,IND,Netherlands,NLD,0,0,128,32,160
2003,Indonesia,IDN,Netherlands,NLD,0,5,5,0,10
2003,Iran (Islamic Rep. of),IRN,Netherlands,NLD,45,125,523,99,792
2003,Iraq,IRQ,Netherlands,NLD,10,1579,523,463,2575
2003,Israel,ISR,Netherlands,NLD,0,0,5,0,5
2003,Jordan,JOR,Netherlands,NLD,0,0,10,0,10
2003,Japan,JPN,Netherlands,NLD,0,0,5,0,5
2003,Kazakhstan,KAZ,Netherlands,NLD,0,5,41,10,56
2003,Kenya,KEN,Netherlands,NLD,0,0,13,0,13
2003,Kyrgyzstan,KGZ,Netherlands,NLD,0,0,28,5,33
2003,Dem. People's Rep. of Korea,PRK,Netherlands,NLD,0,5,0,0,5
2003,Liberia,LBR,Netherlands,NLD,10,19,273,38,340
2003,Libya,LBY,Netherlands,NLD,5,5,51,10,71
2003,Lebanon,LBN,Netherlands,NLD,0,5,39,10,54
2003,Sri Lanka,LKA,Netherlands,NLD,0,19,126,23,168
2003,Lithuania,LTU,Netherlands,NLD,0,0,10,0,10
2003,Latvia,LVA,Netherlands,NLD,0,0,5,0,5
2003,Mauritania,MRT,Netherlands,NLD,0,5,29,5,39
2003,North Macedonia,MKD,Netherlands,NLD,5,0,33,10,48
2003,Rep. of Moldova,MDA,Netherlands,NLD,0,0,20,10,30
2003,Mali,MLI,Netherlands,NLD,0,0,5,0,5
2003,Mongolia,MNG,Netherlands,NLD,0,5,225,30,260
2003,Morocco,MAR,Netherlands,NLD,0,0,29,12,41
2003,Myanmar,MMR,Netherlands,NLD,0,0,23,5,28
2003,Nepal,NPL,Netherlands,NLD,0,0,60,5,65
2003,Netherlands,NLD,Netherlands,NLD,0,0,0,5,5
2003,Niger,NER,Netherlands,NLD,0,10,136,5,151
2003,Nicaragua,NIC,Netherlands,NLD,0,0,5,0,5
2003,Nigeria,NGA,Netherlands,NLD,0,11,406,51,468
2003,Pakistan,PAK,Netherlands,NLD,0,10,62,10,82
2003,Peru,PER,Netherlands,NLD,0,0,5,0,5
2003,Philippines,PHL,Netherlands,NLD,0,0,5,0,5
2003,Poland,POL,Netherlands,NLD,0,0,11,0,11
2003,Portugal,PRT,Netherlands,NLD,0,0,5,0,5
2003,Romania,ROU,Netherlands,NLD,0,5,24,10,39
2003,Russian Federation,RUS,Netherlands,NLD,17,91,303,71,482
2003,Rwanda,RWA,Netherlands,NLD,5,24,106,23,158
2003,Saudi Arabia,SAU,Netherlands,NLD,0,0,5,0,5
2003,Serbia and Kosovo: S/RES/1244 (1999),SRB,Netherlands,NLD,0,87,385,78,550
2003,Sierra Leone,SLE,Netherlands,NLD,0,177,1138,99,1414
2003,Somalia,SOM,Netherlands,NLD,13,142,461,99,715
2003,Viet Nam,VNM,Netherlands,NLD,0,0,59,0,59
2003,Sudan,SDN,Netherlands,NLD,5,97,398,50,550
2003,Suriname,SUR,Netherlands,NLD,0,0,5,0,5
2003,Slovakia,SVK,Netherlands,NLD,0,5,111,32,148
2003,Syrian Arab Rep.,SYR,Netherlands,NLD,22,63,277,39,401
2003,United Rep. of Tanzania,TZA,Netherlands,NLD,0,0,5,5,10
2003,Tajikistan,TJK,Netherlands,NLD,0,0,25,5,30
2003,Togo,TGO,Netherlands,NLD,0,15,189,10,214
2003,Tunisia,TUN,Netherlands,NLD,0,0,10,0,10
2003,Turkey,TUR,Netherlands,NLD,19,46,379,92,536
2003,Uganda,UGA,Netherlands,NLD,0,0,22,5,27
2003,Ukraine,UKR,Netherlands,NLD,0,5,79,27,111
2003,United States of America,USA,Netherlands,NLD,0,0,5,0,5
2003,Uzbekistan,UZB,Netherlands,NLD,5,13,52,10,80
2003,Venezuela (Bolivarian Republic of),VEN,Netherlands,NLD,0,0,0,5,5
2003,Yemen,YEM,Netherlands,NLD,0,5,22,0,27
2003,Zimbabwe,ZWE,Netherlands,NLD,0,0,14,0,14
2003,Stateless,XXA,Netherlands,NLD,5,28,291,50,374
2003,Colombia,COL,Nicaragua,NIC,0,0,0,5,5
2003,Cuba,CUB,Nicaragua,NIC,0,0,0,5,5
2003,Congo,COG,Nigeria,NGA,5,0,0,0,5
2003,Dem. Rep. of the Congo,COD,Nigeria,NGA,56,0,5,0,61
2003,Ethiopia,ETH,Nigeria,NGA,5,0,0,0,5
2003,Liberia,LBR,Nigeria,NGA,1887,0,0,0,1887
2003,Sierra Leone,SLE,Nigeria,NGA,0,0,5,0,5
2003,Sudan,SDN,Nigeria,NGA,29,0,5,0,34
2003,Afghanistan,AFG,Norway,NOR,81,873,412,256,1622
2003,Albania,ALB,Norway,NOR,0,0,247,71,318
2003,Algeria,DZA,Norway,NOR,0,11,243,128,382
2003,Angola,AGO,Norway,NOR,0,21,10,11,42
2003,Egypt,EGY,Norway,NOR,0,0,0,13,13
2003,Armenia,ARM,Norway,NOR,0,0,80,34,114
2003,Azerbaijan,AZE,Norway,NOR,0,0,104,49,153
2003,Burundi,BDI,Norway,NOR,17,56,5,0,78
2003,Benin,BEN,Norway,NOR,0,0,5,5,10
2003,Bangladesh,BGD,Norway,NOR,0,0,54,13,67
2003,Belarus,BLR,Norway,NOR,0,5,268,132,405
2003,Bosnia and Herzegovina,BIH,Norway,NOR,0,10,371,556,937
2003,Bulgaria,BGR,Norway,NOR,0,0,84,29,113
2003,China,CHN,Norway,NOR,34,19,44,21,118
2003,Cameroon,CMR,Norway,NOR,0,5,67,10,82
2003,Congo,COG,Norway,NOR,5,5,13,5,28
2003,Dem. Rep. of the Congo,COD,Norway,NOR,0,0,17,5,22
2003,Colombia,COL,Norway,NOR,0,5,5,0,10
2003,Cuba,CUB,Norway,NOR,0,0,5,0,5
2003,Czechia,CZE,Norway,NOR,0,0,117,11,128
2003,Eritrea,ERI,Norway,NOR,0,34,253,21,308
2003,Estonia,EST,Norway,NOR,0,0,5,0,5
2003,Ethiopia,ETH,Norway,NOR,46,35,340,28,449
2003,United Kingdom of Great Britain and Northern Ireland,GBR,Norway,NOR,0,0,5,0,5
2003,Georgia,GEO,Norway,NOR,0,0,207,86,293
2003,Ghana,GHA,Norway,NOR,0,0,5,0,5
2003,Guatemala,GTM,Norway,NOR,0,0,5,0,5
2003,Guinea,GIN,Norway,NOR,0,0,19,10,29
2003,Croatia,HRV,Norway,NOR,0,5,52,5,62
2003,Hungary,HUN,Norway,NOR,0,0,5,5,10
2003,Cote d'Ivoire,CIV,Norway,NOR,0,0,0,5,5
2003,India,IND,Norway,NOR,0,0,40,0,40
2003,Indonesia,IDN,Norway,NOR,0,0,0,5,5
2003,Iran (Islamic Rep. of),IRN,Norway,NOR,92,22,341,90,545
2003,Iraq,IRQ,Norway,NOR,10,137,67,234,448
2003,Israel,ISR,Norway,NOR,0,0,68,10,78
2003,Jordan,JOR,Norway,NOR,0,0,22,10,32
2003,Kazakhstan,KAZ,Norway,NOR,0,0,54,42,96
2003,Kenya,KEN,Norway,NOR,0,0,5,5,10
2003,Kyrgyzstan,KGZ,Norway,NOR,0,0,63,30,93
2003,Liberia,LBR,Norway,NOR,0,10,38,0,48
2003,Libya,LBY,Norway,NOR,5,13,144,48,210
2003,Lebanon,LBN,Norway,NOR,0,0,14,22,36
2003,Sri Lanka,LKA,Norway,NOR,0,33,57,14,104
2003,Lithuania,LTU,Norway,NOR,0,0,21,10,31
2003,Latvia,LVA,Norway,NOR,0,0,10,0,10
2003,Mauritania,MRT,Norway,NOR,0,0,0,5,5
2003,North Macedonia,MKD,Norway,NOR,0,0,192,131,323
2003,Rep. of Moldova,MDA,Norway,NOR,0,0,88,23,111
2003,Mali,MLI,Norway,NOR,0,0,5,0,5
2003,Malawi,MWI,Norway,NOR,10,0,0,0,10
2003,Mongolia,MNG,Norway,NOR,0,5,126,37,168
2003,Morocco,MAR,Norway,NOR,0,0,12,5,17
2003,Myanmar,MMR,Norway,NOR,0,12,0,0,12
2003,Nepal,NPL,Norway,NOR,0,0,79,10,89
2003,Niger,NER,Norway,NOR,0,5,78,10,93
2003,Nigeria,NGA,Norway,NOR,5,0,127,47,179
2003,Pakistan,PAK,Norway,NOR,0,5,168,20,193
2003,Peru,PER,Norway,NOR,0,5,0,0,5
2003,Philippines,PHL,Norway,NOR,0,0,0,5,5
2003,Poland,POL,Norway,NOR,0,0,33,5,38
2003,Romania,ROU,Norway,NOR,0,0,182,42,224
2003,Russian Federation,RUS,Norway,NOR,139,580,550,379,1648
2003,Rwanda,RWA,Norway,NOR,5,12,64,0,81
2003,El Salvador,SLV,Norway,NOR,0,5,0,5,10
2003,Serbia and Kosovo: S/RES/1244 (1999),SRB,Norway,NOR,54,62,1868,947,2931
2003,Senegal,SEN,Norway,NOR,0,0,5,0,5
2003,Sierra Leone,SLE,Norway,NOR,0,0,16,5,21
2003,Somalia,SOM,Norway,NOR,5,892,89,231,1217
2003,Spain,ESP,Norway,NOR,0,0,0,5,5
2003,Viet Nam,VNM,Norway,NOR,0,0,54,12,66
2003,Sudan,SDN,Norway,NOR,0,5,54,12,71
2003,Slovakia,SVK,Norway,NOR,0,0,74,15,89
2003,Slovenia,SVN,Norway,NOR,0,0,5,0,5
2003,Tajikistan,TJK,Norway,NOR,0,0,27,5,32
2003,Turkmenistan,TKM,Norway,NOR,0,0,5,5,10
2003,Togo,TGO,Norway,NOR,0,0,12,5,17
2003,Tunisia,TUN,Norway,NOR,0,0,5,5,10
2003,Turkey,TUR,Norway,NOR,0,16,218,75,309
2003,Uganda,UGA,Norway,NOR,0,0,12,0,12
2003,Ukraine,UKR,Norway,NOR,0,0,91,44,135
2003,United States of America,USA,Norway,NOR,0,0,0,5,5
2003,Uzbekistan,UZB,Norway,NOR,0,0,117,67,184
2003,Western Sahara,ESH,Norway,NOR,0,0,0,5,5
2003,Yemen,YEM,Norway,NOR,0,5,10,5,20
2003,Stateless,XXA,Norway,NOR,49,58,244,87,438
2003,Algeria,DZA,New Zealand,NZL,0,0,14,0,14
2003,Bangladesh,BGD,New Zealand,NZL,0,0,29,0,29
2003,China,CHN,New Zealand,NZL,5,0,49,0,54
2003,Chile,CHL,New Zealand,NZL,5,0,14,0,19
2003,Dem. Rep. of the Congo,COD,New Zealand,NZL,0,0,10,0,10
2003,Colombia,COL,New Zealand,NZL,0,0,10,0,10
2003,Czechia,CZE,New Zealand,NZL,0,0,11,0,11
2003,Eritrea,ERI,New Zealand,NZL,0,0,5,0,5
2003,Ethiopia,ETH,New Zealand,NZL,5,0,0,0,5
2003,Fiji,FJI,New Zealand,NZL,0,0,12,0,12
2003,Hungary,HUN,New Zealand,NZL,0,0,67,0,67
2003,India,IND,New Zealand,NZL,0,0,101,0,101
2003,Iran (Islamic Rep. of),IRN,New Zealand,NZL,52,0,55,0,107
2003,Iraq,IRQ,New Zealand,NZL,10,0,38,0,48
2003,Israel,ISR,New Zealand,NZL,0,0,10,0,10
2003,Sri Lanka,LKA,New Zealand,NZL,10,0,24,0,34
2003,Malaysia,MYS,New Zealand,NZL,0,0,39,0,39
2003,Morocco,MAR,New Zealand,NZL,0,0,5,0,5
2003,Myanmar,MMR,New Zealand,NZL,0,0,5,0,5
2003,Nigeria,NGA,New Zealand,NZL,0,0,14,0,14
2003,Pakistan,PAK,New Zealand,NZL,0,0,20,0,20
2003,Peru,PER,New Zealand,NZL,0,0,5,0,5
2003,Russian Federation,RUS,New Zealand,NZL,0,0,5,0,5
2003,Saudi Arabia,SAU,New Zealand,NZL,0,0,5,0,5
2003,Solomon Islands,SLB,New Zealand,NZL,0,0,5,0,5
2003,Somalia,SOM,New Zealand,NZL,14,0,5,0,19
2003,Sudan,SDN,New Zealand,NZL,0,0,5,0,5
2003,Syrian Arab Rep.,SYR,New Zealand,NZL,5,0,0,0,5
2003,Thailand,THA,New Zealand,NZL,0,0,130,0,130
2003,United States of America,USA,New Zealand,NZL,0,0,5,0,5
2003,Zimbabwe,ZWE,New Zealand,NZL,48,0,55,0,103
2003,Colombia,COL,Panama,PAN,0,0,0,5,5
2003,Argentina,ARG,Peru,PER,0,0,0,5,5
2003,Colombia,COL,Peru,PER,19,0,0,53,72
2003,Cuba,CUB,Peru,PER,0,0,0,5,5
2003,Palestinian,PSE,Peru,PER,5,0,0,0,5
2003,Iraq,IRQ,Peru,PER,5,0,0,0,5
2003,Congo,COG,Philippines,PHL,5,0,0,0,5
2003,Sri Lanka,LKA,Philippines,PHL,5,0,0,5,10
2003,Turkey,TUR,Philippines,PHL,0,0,5,0,5
2003,Lebanon,LBN,Papua New Guinea,PNG,0,0,5,0,5
2003,Afghanistan,AFG,Poland,POL,5,0,408,5,418
2003,Algeria,DZA,Poland,POL,0,0,10,0,10
2003,Egypt,EGY,Poland,POL,0,0,5,0,5
2003,Armenia,ARM,Poland,POL,0,0,113,5,118
2003,Azerbaijan,AZE,Poland,POL,0,0,14,0,14
2003,Belarus,BLR,Poland,POL,14,0,27,12,53
2003,Bosnia and Herzegovina,BIH,Poland,POL,0,0,0,15,15
2003,Bulgaria,BGR,Poland,POL,0,0,10,5,15
2003,China,CHN,Poland,POL,0,0,16,0,16
2003,Czechia,CZE,Poland,POL,0,0,5,0,5
2003,Ethiopia,ETH,Poland,POL,0,0,5,0,5
2003,Palestinian,PSE,Poland,POL,0,0,5,0,5
2003,Georgia,GEO,Poland,POL,5,0,29,0,34
2003,India,IND,Poland,POL,0,0,215,0,215
2003,Iran (Islamic Rep. of),IRN,Poland,POL,0,0,11,0,11
2003,Iraq,IRQ,Poland,POL,0,0,145,0,145
2003,Jordan,JOR,Poland,POL,0,0,5,0,5
2003,Kyrgyzstan,KGZ,Poland,POL,0,0,5,5,10
2003,Lebanon,LBN,Poland,POL,0,5,5,0,10
2003,Sri Lanka,LKA,Poland,POL,0,0,35,0,35
2003,Latvia,LVA,Poland,POL,0,0,0,5,5
2003,Rep. of Moldova,MDA,Poland,POL,0,0,25,0,25
2003,Mongolia,MNG,Poland,POL,0,0,23,0,23
2003,Morocco,MAR,Poland,POL,5,0,0,0,5
2003,Nigeria,NGA,Poland,POL,0,0,18,0,18
2003,Pakistan,PAK,Poland,POL,0,0,124,5,129
2003,Romania,ROU,Poland,POL,0,0,5,5,10
2003,Russian Federation,RUS,Poland,POL,185,20,1706,4520,6431
2003,Sierra Leone,SLE,Poland,POL,0,0,5,0,5
2003,Somalia,SOM,Poland,POL,0,0,5,0,5
2003,Viet Nam,VNM,Poland,POL,0,0,22,0,22
2003,Sudan,SDN,Poland,POL,0,0,5,0,5
2003,Slovenia,SVN,Poland,POL,0,0,5,0,5
2003,Turkey,TUR,Poland,POL,0,0,20,0,20
2003,Ukraine,UKR,Poland,POL,0,0,50,18,68
2003,Uzbekistan,UZB,Poland,POL,0,0,0,5,5
2003,Stateless,XXA,Poland,POL,0,0,10,0,10
2003,Albania,ALB,Portugal,PRT,0,0,0,5,5
2003,Angola,AGO,Portugal,PRT,0,0,0,18,18
2003,Bulgaria,BGR,Portugal,PRT,0,0,0,5,5
2003,Dem. Rep. of the Congo,COD,Portugal,PRT,0,0,0,5,5
2003,Colombia,COL,Portugal,PRT,0,5,0,0,5
2003,Georgia,GEO,Portugal,PRT,0,0,0,5,5
2003,Iraq,IRQ,Portugal,PRT,0,5,0,0,5
2003,Liberia,LBR,Portugal,PRT,0,0,0,5,5
2003,Sri Lanka,LKA,Portugal,PRT,0,0,5,0,5
2003,Romania,ROU,Portugal,PRT,0,0,0,5,5
2003,Sierra Leone,SLE,Portugal,PRT,0,0,0,5,5
2003,Ukraine,UKR,Portugal,PRT,0,0,0,5,5
2003,Afghanistan,AFG,Romania,ROU,0,0,16,0,16
2003,Algeria,DZA,Romania,ROU,0,0,5,0,5
2003,Egypt,EGY,Romania,ROU,0,0,5,0,5
2003,China,CHN,Romania,ROU,0,0,122,16,138
2003,Cameroon,CMR,Romania,ROU,0,0,5,0,5
2003,Congo,COG,Romania,ROU,12,0,0,0,12
2003,Palestinian,PSE,Romania,ROU,0,0,10,0,10
2003,India,IND,Romania,ROU,0,0,140,0,140
2003,Iran (Islamic Rep. of),IRN,Romania,ROU,0,5,29,5,39
2003,Iraq,IRQ,Romania,ROU,22,20,163,16,221
2003,Jordan,JOR,Romania,ROU,0,0,5,5,10
2003,Liberia,LBR,Romania,ROU,0,0,5,0,5
2003,Lebanon,LBN,Romania,ROU,0,0,0,5,5
2003,Rep. of Moldova,MDA,Romania,ROU,0,0,0,5,5
2003,Pakistan,PAK,Romania,ROU,0,0,20,0,20
2003,South Africa,ZAF,Romania,ROU,0,0,0,5,5
2003,Russian Federation,RUS,Romania,ROU,0,0,5,0,5
2003,Serbia and Kosovo: S/RES/1244 (1999),SRB,Romania,ROU,0,0,5,0,5
2003,Somalia,SOM,Romania,ROU,5,0,47,0,52
2003,Sudan,SDN,Romania,ROU,0,0,13,0,13
2003,Syrian Arab Rep.,SYR,Romania,ROU,0,0,13,0,13
2003,Turkey,TUR,Romania,ROU,0,0,28,5,33
2003,Stateless,XXA,Romania,ROU,0,0,10,0,10
2003,Angola,AGO,South Africa,ZAF,491,0,26,0,517
2003,Egypt,EGY,South Africa,ZAF,0,0,5,0,5
2003,Burundi,BDI,South Africa,ZAF,275,0,12,0,287
2003,Cameroon,CMR,South Africa,ZAF,5,0,11,0,16
2003,Congo,COG,South Africa,ZAF,124,0,10,0,134
2003,Dem. Rep. of the Congo,COD,South Africa,ZAF,1668,0,83,0,1751
2003,Ethiopia,ETH,South Africa,ZAF,11,0,25,0,36
2003,Ghana,GHA,South Africa,ZAF,0,0,15,0,15
2003,India,IND,South Africa,ZAF,0,0,5,0,5
2003,Kenya,KEN,South Africa,ZAF,0,0,37,0,37
2003,Kyrgyzstan,KGZ,South Africa,ZAF,5,0,0,0,5
2003,Liberia,LBR,South Africa,ZAF,21,0,0,0,21
2003,Malawi,MWI,South Africa,ZAF,0,0,23,0,23
2003,Nigeria,NGA,South Africa,ZAF,0,0,32,0,32
2003,Pakistan,PAK,South Africa,ZAF,0,0,47,0,47
2003,Rwanda,RWA,South Africa,ZAF,221,0,11,0,232
2003,Senegal,SEN,South Africa,ZAF,0,0,5,0,5
2003,Sierra Leone,SLE,South Africa,ZAF,0,0,5,0,5
2003,Somalia,SOM,South Africa,ZAF,389,0,59,0,448
2003,Sudan,SDN,South Africa,ZAF,26,0,0,0,26
2003,United Rep. of Tanzania,TZA,South Africa,ZAF,0,0,12,0,12
2003,Uganda,UGA,South Africa,ZAF,5,0,18,0,23
2003,Zambia,ZMB,South Africa,ZAF,5,0,0,0,5
2003,Zimbabwe,ZWE,South Africa,ZAF,10,0,15,0,25
2003,Afghanistan,AFG,Russian Federation,RUS,28,0,779,0,807
2003,Angola,AGO,Russian Federation,RUS,0,0,10,0,10
2003,Armenia,ARM,Russian Federation,RUS,0,0,5,0,5
2003,Azerbaijan,AZE,Russian Federation,RUS,0,0,38,0,38
2003,Ethiopia,ETH,Russian Federation,RUS,0,0,5,0,5
2003,Georgia,GEO,Russian Federation,RUS,5,0,40,0,45
2003,Iraq,IRQ,Russian Federation,RUS,0,0,14,0,14
2003,Kazakhstan,KAZ,Russian Federation,RUS,0,0,26,0,26
2003,Rep. of Moldova,MDA,Russian Federation,RUS,0,0,10,0,10
2003,Sierra Leone,SLE,Russian Federation,RUS,0,0,5,0,5
2003,Somalia,SOM,Russian Federation,RUS,0,0,5,0,5
2003,Tajikistan,TJK,Russian Federation,RUS,5,0,13,0,18
2003,Turkmenistan,TKM,Russian Federation,RUS,0,0,22,0,22
2003,Ukraine,UKR,Russian Federation,RUS,0,0,5,0,5
2003,Uzbekistan,UZB,Russian Federation,RUS,5,0,35,0,40
2003,Bangladesh,BGD,El Salvador,SLV,0,0,5,0,5
2003,Colombia,COL,El Salvador,SLV,5,0,0,0,5
2003,Guatemala,GTM,El Salvador,SLV,0,0,5,0,5
2003,Central African Rep.,CAF,Senegal,SEN,0,0,10,0,10
2003,Chad,TCD,Senegal,SEN,0,0,5,0,5
2003,Cameroon,CMR,Senegal,SEN,0,0,5,0,5
2003,Congo,COG,Senegal,SEN,0,0,15,0,15
2003,Dem. Rep. of the Congo,COD,Senegal,SEN,0,0,33,0,33
2003,Guinea,GIN,Senegal,SEN,0,0,5,0,5
2003,Cote d'Ivoire,CIV,Senegal,SEN,5,0,13,0,18
2003,Liberia,LBR,Senegal,SEN,14,0,10,0,24
2003,Sri Lanka,LKA,Senegal,SEN,0,0,13,0,13
2003,Mauritania,MRT,Senegal,SEN,0,0,104,0,104
2003,Nigeria,NGA,Senegal,SEN,0,0,5,0,5
2003,Rwanda,RWA,Senegal,SEN,5,0,15,0,20
2003,Sierra Leone,SLE,Senegal,SEN,0,0,24,0,24
2003,Togo,TGO,Senegal,SEN,0,0,5,0,5
2003,Afghanistan,AFG,Spain,ESP,0,0,5,14,19
2003,Albania,ALB,Spain,ESP,0,0,0,10,10
2003,Algeria,DZA,Spain,ESP,0,5,26,695,731
2003,Angola,AGO,Spain,ESP,0,5,26,19,50
2003,Egypt,EGY,Spain,ESP,0,0,0,5,5
2003,Argentina,ARG,Spain,ESP,0,0,0,16,16
2003,Armenia,ARM,Spain,ESP,15,0,43,43,109
2003,Azerbaijan,AZE,Spain,ESP,0,0,5,0,5
2003,Burundi,BDI,Spain,ESP,0,0,0,5,5
2003,Benin,BEN,Spain,ESP,0,0,0,5,5
2003,Bangladesh,BGD,Spain,ESP,0,0,10,17,27
2003,Burkina Faso,BFA,Spain,ESP,0,0,0,5,5
2003,Belarus,BLR,Spain,ESP,11,0,17,11,39
2003,Bosnia and Herzegovina,BIH,Spain,ESP,0,0,5,0,5
2003,Bulgaria,BGR,Spain,ESP,0,0,0,11,11
2003,China,CHN,Spain,ESP,0,0,0,12,12
2003,Cameroon,CMR,Spain,ESP,0,0,11,116,127
2003,Congo,COG,Spain,ESP,0,0,27,19,49
2003,Dem. Rep. of the Congo,COD,Spain,ESP,10,0,47,134,191
2003,Colombia,COL,Spain,ESP,76,64,1293,310,1747
2003,Cuba,CUB,Spain,ESP,19,5,191,61,279
2003,Ecuador,ECU,Spain,ESP,0,0,5,22,27
2003,Equatorial Guinea,GNQ,Spain,ESP,13,5,41,0,61
2003,Eritrea,ERI,Spain,ESP,0,0,10,0,10
2003,Estonia,EST,Spain,ESP,0,0,0,5,5
2003,Ethiopia,ETH,Spain,ESP,5,0,34,11,50
2003,Gambia,GMB,Spain,ESP,0,0,5,33,38
2003,Georgia,GEO,Spain,ESP,10,0,16,41,67
2003,Ghana,GHA,Spain,ESP,0,0,0,56,56
2003,Guinea-Bissau,GNB,Spain,ESP,0,0,0,35,35
2003,Guatemala,GTM,Spain,ESP,0,0,5,0,5
2003,Guinea,GIN,Spain,ESP,0,0,22,110,132
2003,Haiti,HTI,Spain,ESP,0,0,5,0,5
2003,Cote d'Ivoire,CIV,Spain,ESP,0,0,28,78,106
2003,India,IND,Spain,ESP,0,0,0,46,46
2003,Iran (Islamic Rep. of),IRN,Spain,ESP,0,0,11,10,23
2003,Iraq,IRQ,Spain,ESP,5,0,17,50,73
2003,Jordan,JOR,Spain,ESP,0,5,0,0,5
2003,Liberia,LBR,Spain,ESP,0,0,10,124,138
2003,Sri Lanka,LKA,Spain,ESP,0,0,16,5,21
2003,Lithuania,LTU,Spain,ESP,0,0,0,5,5
2003,Mauritania,MRT,Spain,ESP,0,0,5,18,23
2003,Rep. of Moldova,MDA,Spain,ESP,0,0,10,15,25
2003,Mali,MLI,Spain,ESP,0,0,5,32,37
2003,Mongolia,MNG,Spain,ESP,0,0,0,10,10
2003,Morocco,MAR,Spain,ESP,0,0,15,24,39
2003,Mozambique,MOZ,Spain,ESP,0,0,0,5,5
2003,Nepal,NPL,Spain,ESP,0,0,5,13,18
2003,Niger,NER,Spain,ESP,0,0,0,10,10
2003,Nigeria,NGA,Spain,ESP,5,0,62,1726,1793
2003,Pakistan,PAK,Spain,ESP,0,5,5,11,21
2003,Peru,PER,Spain,ESP,0,0,0,5,5
2003,Romania,ROU,Spain,ESP,0,0,5,51,56
2003,South Africa,ZAF,Spain,ESP,0,0,0,5,5
2003,Russian Federation,RUS,Spain,ESP,41,27,61,60,192
2003,Rwanda,RWA,Spain,ESP,0,0,0,5,5
2003,El Salvador,SLV,Spain,ESP,0,0,5,0,5
2003,Serbia and Kosovo: S/RES/1244 (1999),SRB,Spain,ESP,5,0,0,5,10
2003,Senegal,SEN,Spain,ESP,0,0,0,13,13
2003,Sierra Leone,SLE,Spain,ESP,0,0,39,133,175
2003,Somalia,SOM,Spain,ESP,0,0,59,58,117
2003,Sudan,SDN,Spain,ESP,0,0,10,10,17
2003,Syrian Arab Rep.,SYR,Spain,ESP,5,0,5,0,10
2003,Togo,TGO,Spain,ESP,0,0,0,13,13
2003,Tunisia,TUN,Spain,ESP,0,0,17,11,28
2003,Turkey,TUR,Spain,ESP,0,0,33,10,43
2003,Ukraine,UKR,Spain,ESP,5,0,24,27,56
2003,Venezuela (Bolivarian Republic of),VEN,Spain,ESP,0,0,0,13,13
2003,Zimbabwe,ZWE,Spain,ESP,0,0,0,5,5
2003,Stateless,XXA,Spain,ESP,0,10,12,27,49
2003,Afghanistan,AFG,Slovakia,SVK,0,0,19,691,710
2003,Algeria,DZA,Slovakia,SVK,0,0,0,11,11
2003,Angola,AGO,Slovakia,SVK,0,0,5,0,5
2003,Armenia,ARM,Slovakia,SVK,0,0,5,400,405
2003,Azerbaijan,AZE,Slovakia,SVK,0,0,0,36,36
2003,Bangladesh,BGD,Slovakia,SVK,0,0,68,974,1042
2003,Belarus,BLR,Slovakia,SVK,0,0,0,17,17
2003,Bosnia and Herzegovina,BIH,Slovakia,SVK,0,0,0,5,5
2003,Bulgaria,BGR,Slovakia,SVK,0,0,5,5,10
2003,China,CHN,Slovakia,SVK,0,0,35,1556,1591
2003,Congo,COG,Slovakia,SVK,0,0,5,0,5
2003,Cuba,CUB,Slovakia,SVK,0,0,0,5,5
2003,Czechia,CZE,Slovakia,SVK,0,0,5,0,5
2003,Georgia,GEO,Slovakia,SVK,0,0,10,337,347
2003,Ghana,GHA,Slovakia,SVK,0,0,0,5,5
2003,Cote d'Ivoire,CIV,Slovakia,SVK,0,0,0,5,5
2003,India,IND,Slovakia,SVK,0,0,88,1671,1759
2003,Iran (Islamic Rep. of),IRN,Slovakia,SVK,0,0,10,149,159
2003,Iraq,IRQ,Slovakia,SVK,5,0,0,655,660
2003,Israel,ISR,Slovakia,SVK,0,0,0,34,34
2003,Kazakhstan,KAZ,Slovakia,SVK,0,0,0,5,5
2003,Liberia,LBR,Slovakia,SVK,0,0,0,10,10
2003,Lebanon,LBN,Slovakia,SVK,0,0,0,30,30
2003,Sri Lanka,LKA,Slovakia,SVK,0,0,10,80,90
2003,North Macedonia,MKD,Slovakia,SVK,0,0,14,0,14
2003,Rep. of Moldova,MDA,Slovakia,SVK,0,0,12,473,485
2003,Mongolia,MNG,Slovakia,SVK,0,0,5,0,5
2003,Nepal,NPL,Slovakia,SVK,0,0,0,13,13
2003,Nigeria,NGA,Slovakia,SVK,0,0,5,14,19
2003,Pakistan,PAK,Slovakia,SVK,0,0,22,236,258
2003,Romania,ROU,Slovakia,SVK,0,0,0,5,5
2003,Russian Federation,RUS,Slovakia,SVK,0,0,43,1869,1912
2003,Serbia and Kosovo: S/RES/1244 (1999),SRB,Slovakia,SVK,0,0,21,31,52
2003,Senegal,SEN,Slovakia,SVK,0,0,0,11,11
2003,Somalia,SOM,Slovakia,SVK,0,0,0,130,130
2003,Viet Nam,VNM,Slovakia,SVK,0,0,14,97,111
2003,Sudan,SDN,Slovakia,SVK,0,0,0,13,13
2003,Slovakia,SVK,Slovakia,SVK,0,0,5,0,5
2003,Syrian Arab Rep.,SYR,Slovakia,SVK,0,0,0,34,34
2003,Turkmenistan,TKM,Slovakia,SVK,0,0,0,5,5
2003,Togo,TGO,Slovakia,SVK,0,0,5,0,5
2003,Tunisia,TUN,Slovakia,SVK,0,0,0,5,5
2003,Turkey,TUR,Slovakia,SVK,0,0,0,40,40
2003,Ukraine,UKR,Slovakia,SVK,0,0,10,28,38
2003,Uzbekistan,UZB,Slovakia,SVK,0,0,0,5,5
2003,Stateless,XXA,Slovakia,SVK,0,0,0,96,96
2003,Albania,ALB,Slovenia,SVN,0,0,0,14,14
2003,Algeria,DZA,Slovenia,SVN,0,0,5,63,68
2003,Egypt,EGY,Slovenia,SVN,0,0,0,33,33
2003,Bangladesh,BGD,Slovenia,SVN,0,0,0,11,11
2003,Bosnia and Herzegovina,BIH,Slovenia,SVN,5,0,28,26,59
2003,China,CHN,Slovenia,SVN,0,0,5,0,5
2003,Cuba,CUB,Slovenia,SVN,0,0,0,16,16
2003,Palestinian,PSE,Slovenia,SVN,0,0,0,17,17
2003,Georgia,GEO,Slovenia,SVN,0,0,19,43,62
2003,Croatia,HRV,Slovenia,SVN,0,0,0,5,5
2003,India,IND,Slovenia,SVN,0,0,0,10,10
2003,Iran (Islamic Rep. of),IRN,Slovenia,SVN,5,0,0,90,95
2003,Iraq,IRQ,Slovenia,SVN,5,0,0,198,203
2003,North Macedonia,MKD,Slovenia,SVN,0,0,19,51,70
2003,Rep. of Moldova,MDA,Slovenia,SVN,0,0,5,27,32
2003,Pakistan,PAK,Slovenia,SVN,0,0,0,31,31
2003,Romania,ROU,Slovenia,SVN,0,0,5,0,5
2003,Russian Federation,RUS,Slovenia,SVN,0,0,0,13,13
2003,Serbia and Kosovo: S/RES/1244 (1999),SRB,Slovenia,SVN,0,17,61,112,190
2003,Sierra Leone,SLE,Slovenia,SVN,0,0,0,5,5
2003,Turkey,TUR,Slovenia,SVN,0,0,0,187,187
2003,Ukraine,UKR,Slovenia,SVN,0,0,5,11,16
2003,Afghanistan,AFG,Sweden,SWE,21,250,258,36,565
2003,Albania,ALB,Sweden,SWE,0,5,247,49,301
2003,Algeria,DZA,Sweden,SWE,5,0,286,62,353
2003,Angola,AGO,Sweden,SWE,0,11,29,0,40
2003,Egypt,EGY,Sweden,SWE,0,0,120,11,131
2003,Argentina,ARG,Sweden,SWE,0,0,10,0,10
2003,Armenia,ARM,Sweden,SWE,0,20,192,29,241
2003,Azerbaijan,AZE,Sweden,SWE,12,16,645,47,720
2003,Bahrain,BHR,Sweden,SWE,0,0,0,5,5
2003,Burundi,BDI,Sweden,SWE,0,153,5,5,163
2003,Benin,BEN,Sweden,SWE,0,0,0,5,5
2003,Bangladesh,BGD,Sweden,SWE,0,5,119,11,135
2003,Belarus,BLR,Sweden,SWE,5,0,640,143,788
2003,Bolivia (Plurinational State of),BOL,Sweden,SWE,0,0,293,30,323
2003,Brazil,BRA,Sweden,SWE,0,0,17,0,17
2003,Bosnia and Herzegovina,BIH,Sweden,SWE,5,64,1738,157,1964
2003,Bulgaria,BGR,Sweden,SWE,0,0,640,197,837
2003,Chad,TCD,Sweden,SWE,0,5,0,5,10
2003,China,CHN,Sweden,SWE,0,5,55,13,73
2003,Chile,CHL,Sweden,SWE,0,0,232,17,249
2003,Cameroon,CMR,Sweden,SWE,0,0,17,0,17
2003,Congo,COG,Sweden,SWE,0,0,14,0,14
2003,Dem. Rep. of the Congo,COD,Sweden,SWE,0,10,59,5,74
2003,Colombia,COL,Sweden,SWE,0,5,52,11,68
2003,Cuba,CUB,Sweden,SWE,0,0,14,5,19
2003,Czechia,CZE,Sweden,SWE,0,0,73,36,109
2003,Ecuador,ECU,Sweden,SWE,0,5,200,21,226
2003,Eritrea,ERI,Sweden,SWE,0,24,231,20,275
2003,Estonia,EST,Sweden,SWE,0,0,13,5,18
2003,Ethiopia,ETH,Sweden,SWE,5,0,54,5,64
2003,France,FRA,Sweden,SWE,0,0,5,0,5
2003,United Kingdom of Great Britain and Northern Ireland,GBR,Sweden,SWE,0,0,0,5,5
2003,Georgia,GEO,Sweden,SWE,0,10,426,114,550
2003,Germany,DEU,Sweden,SWE,0,0,5,0,5
2003,Guinea-Bissau,GNB,Sweden,SWE,0,0,5,0,5
2003,Guatemala,GTM,Sweden,SWE,5,0,5,0,10
2003,Guinea,GIN,Sweden,SWE,0,0,22,0,22
2003,Honduras,HND,Sweden,SWE,0,0,10,0,10
2003,Croatia,HRV,Sweden,SWE,0,5,199,29,233
2003,Hungary,HUN,Sweden,SWE,0,0,14,5,19
2003,Cote d'Ivoire,CIV,Sweden,SWE,0,0,22,5,27
2003,India,IND,Sweden,SWE,0,0,59,14,73
2003,Iran (Islamic Rep. of),IRN,Sweden,SWE,30,41,669,95,835
2003,Iraq,IRQ,Sweden,SWE,19,1097,792,438,2346
2003,Israel,ISR,Sweden,SWE,0,0,47,5,52
2003,Jordan,JOR,Sweden,SWE,0,13,59,16,88
2003,Kazakhstan,KAZ,Sweden,SWE,5,5,134,23,167
2003,Kenya,KEN,Sweden,SWE,0,0,5,0,5
2003,Kyrgyzstan,KGZ,Sweden,SWE,5,0,0,0,5
2003,Kiribati,KIR,Sweden,SWE,0,10,198,25,233
2003,Lao People's Dem. Rep.,LAO,Sweden,SWE,0,5,0,0,5
2003,Liberia,LBR,Sweden,SWE,5,5,35,5,50
2003,Libya,LBY,Sweden,SWE,0,5,420,90,515
2003,Lebanon,LBN,Sweden,SWE,0,10,342,44,396
2003,Sri Lanka,LKA,Sweden,SWE,0,0,15,5,20
2003,Lithuania,LTU,Sweden,SWE,0,0,35,13,48
2003,Latvia,LVA,Sweden,SWE,0,0,38,5,43
2003,Mauritania,MRT,Sweden,SWE,0,0,5,0,5
2003,North Macedonia,MKD,Sweden,SWE,0,5,534,107,646
2003,Rep. of Moldova,MDA,Sweden,SWE,0,5,177,21,203
2003,Mali,MLI,Sweden,SWE,0,0,5,0,5
2003,Mongolia,MNG,Sweden,SWE,0,0,306,69,375
2003,Morocco,MAR,Sweden,SWE,0,5,34,14,53
2003,Myanmar,MMR,Sweden,SWE,0,5,5,0,10
2003,Nepal,NPL,Sweden,SWE,0,0,12,0,12
2003,Netherlands,NLD,Sweden,SWE,0,0,0,5,5
2003,Niger,NER,Sweden,SWE,0,0,5,0,5
2003,Nicaragua,NIC,Sweden,SWE,0,0,5,0,5
2003,Nigeria,NGA,Sweden,SWE,0,0,206,54,260
2003,Pakistan,PAK,Sweden,SWE,0,0,54,10,64
2003,Paraguay,PRY,Sweden,SWE,0,0,10,0,10
2003,Peru,PER,Sweden,SWE,0,5,88,12,105
2003,Philippines,PHL,Sweden,SWE,0,0,5,0,5
2003,Poland,POL,Sweden,SWE,0,0,20,0,20
2003,Romania,ROU,Sweden,SWE,0,0,429,105,534
2003,Russian Federation,RUS,Sweden,SWE,19,64,1104,281,1468
2003,Rwanda,RWA,Sweden,SWE,0,0,12,5,17
2003,El Salvador,SLV,Sweden,SWE,0,0,46,0,46
2003,Saudi Arabia,SAU,Sweden,SWE,0,0,5,0,5
2003,Serbia and Kosovo: S/RES/1244 (1999),SRB,Sweden,SWE,201,276,5473,679,6629
2003,Sierra Leone,SLE,Sweden,SWE,0,0,70,10,80
2003,Somalia,SOM,Sweden,SWE,24,449,505,81,1059
2003,Viet Nam,VNM,Sweden,SWE,0,5,58,10,73
2003,Sudan,SDN,Sweden,SWE,0,0,23,5,28
2003,Slovakia,SVK,Sweden,SWE,0,0,332,58,390
2003,Slovenia,SVN,Sweden,SWE,0,0,10,0,10
2003,Sweden,SWE,Sweden,SWE,0,0,0,5,5
2003,Syrian Arab Rep.,SYR,Sweden,SWE,25,22,699,36,782
2003,United Rep. of Tanzania,TZA,Sweden,SWE,0,0,5,5,10
2003,Thailand,THA,Sweden,SWE,0,5,0,0,5
2003,Tajikistan,TJK,Sweden,SWE,0,5,56,5,66
2003,Turkmenistan,TKM,Sweden,SWE,0,10,16,5,31
2003,Tunisia,TUN,Sweden,SWE,0,0,92,10,102
2003,Turkey,TUR,Sweden,SWE,19,28,809,53,909
2003,Uganda,UGA,Sweden,SWE,0,5,24,0,29
2003,Ukraine,UKR,Sweden,SWE,5,0,484,111,600
2003,Uruguay,URY,Sweden,SWE,0,0,5,0,5
2003,United States of America,USA,Sweden,SWE,0,0,20,0,20
2003,Uzbekistan,UZB,Sweden,SWE,5,13,434,49,501
2003,Venezuela (Bolivarian Republic of),VEN,Sweden,SWE,0,0,10,0,10
2003,Yemen,YEM,Sweden,SWE,0,0,36,0,36
2003,Zimbabwe,ZWE,Sweden,SWE,0,0,10,0,10
2003,Stateless,XXA,Sweden,SWE,5,402,462,84,953
2003,Afghanistan,AFG,Switzerland,CHE,78,256,608,58,1000
2003,Albania,ALB,Switzerland,CHE,0,10,36,105,151
2003,Algeria,DZA,Switzerland,CHE,29,12,490,595,1126
2003,Angola,AGO,Switzerland,CHE,5,332,642,80,1059
2003,Egypt,EGY,Switzerland,CHE,5,0,5,12,22
2003,Armenia,ARM,Switzerland,CHE,0,20,247,275,542
2003,Azerbaijan,AZE,Switzerland,CHE,5,0,45,53,103
2003,Burundi,BDI,Switzerland,CHE,5,0,32,17,54
2003,Benin,BEN,Switzerland,CHE,0,0,37,32,69
2003,Bangladesh,BGD,Switzerland,CHE,0,5,490,86,581
2003,Burkina Faso,BFA,Switzerland,CHE,5,0,20,24,49
2003,Belarus,BLR,Switzerland,CHE,0,0,140,206,346
2003,Bolivia (Plurinational State of),BOL,Switzerland,CHE,0,0,26,5,31
2003,Brazil,BRA,Switzerland,CHE,0,0,5,0,5
2003,Bosnia and Herzegovina,BIH,Switzerland,CHE,112,339,1082,395,1928
2003,Bulgaria,BGR,Switzerland,CHE,0,0,47,276,323
2003,Cambodia,KHM,Switzerland,CHE,5,0,5,0,10
2003,Canada,CAN,Switzerland,CHE,0,0,0,5,5
2003,Central African Rep.,CAF,Switzerland,CHE,0,0,5,0,5
2003,Chad,TCD,Switzerland,CHE,0,0,20,5,25
2003,China,CHN,Switzerland,CHE,25,0,55,62,142
2003,Cameroon,CMR,Switzerland,CHE,0,0,232,115,347
2003,Congo,COG,Switzerland,CHE,12,0,30,5,47
2003,Dem. Rep. of the Congo,COD,Switzerland,CHE,35,213,524,141,913
2003,Colombia,COL,Switzerland,CHE,36,5,24,10,75
2003,Cuba,CUB,Switzerland,CHE,0,0,14,0,14
2003,Ecuador,ECU,Switzerland,CHE,0,0,5,0,5
2003,Equatorial Guinea,GNQ,Switzerland,CHE,0,0,5,0,5
2003,Eritrea,ERI,Switzerland,CHE,0,28,170,83,281
2003,Estonia,EST,Switzerland,CHE,0,0,0,11,11
2003,Ethiopia,ETH,Switzerland,CHE,16,40,266,93,415
2003,France,FRA,Switzerland,CHE,0,0,0,11,11
2003,Gabon,GAB,Switzerland,CHE,0,0,10,0,10
2003,Gambia,GMB,Switzerland,CHE,11,0,0,12,23
2003,United Kingdom of Great Britain and Northern Ireland,GBR,Switzerland,CHE,0,0,0,5,5
2003,Georgia,GEO,Switzerland,CHE,5,5,433,525,968
2003,Germany,DEU,Switzerland,CHE,0,0,0,5,5
2003,Ghana,GHA,Switzerland,CHE,0,0,5,15,20
2003,Guinea-Bissau,GNB,Switzerland,CHE,5,0,14,65,84
2003,Guinea,GIN,Switzerland,CHE,11,12,315,419,757
2003,Croatia,HRV,Switzerland,CHE,0,0,22,12,34
2003,Hungary,HUN,Switzerland,CHE,0,0,0,10,10
2003,Cote d'Ivoire,CIV,Switzerland,CHE,5,0,147,75,227
2003,India,IND,Switzerland,CHE,5,5,38,207,255
2003,Iran (Islamic Rep. of),IRN,Switzerland,CHE,21,10,313,85,429
2003,Iraq,IRQ,Switzerland,CHE,176,103,220,428,927
2003,Israel,ISR,Switzerland,CHE,0,0,0,12,12
2003,Italy,ITA,Switzerland,CHE,0,0,0,5,5
2003,Jordan,JOR,Switzerland,CHE,0,0,5,14,19
2003,Kazakhstan,KAZ,Switzerland,CHE,0,0,13,15,28
2003,Kenya,KEN,Switzerland,CHE,0,0,16,0,16
2003,Kyrgyzstan,KGZ,Switzerland,CHE,0,0,14,0,14
2003,Lao People's Dem. Rep.,LAO,Switzerland,CHE,5,0,0,0,5
2003,Liberia,LBR,Switzerland,CHE,0,0,24,74,98
2003,Libya,LBY,Switzerland,CHE,32,0,67,41,140
2003,Lebanon,LBN,Switzerland,CHE,0,5,53,94,152
2003,Sri Lanka,LKA,Switzerland,CHE,50,160,393,133,736
2003,Lithuania,LTU,Switzerland,CHE,0,0,5,107,112
2003,Latvia,LVA,Switzerland,CHE,0,0,5,14,19
2003,Mauritania,MRT,Switzerland,CHE,0,0,5,39,44
2003,North Macedonia,MKD,Switzerland,CHE,0,0,572,266,838
2003,Rep. of Moldova,MDA,Switzerland,CHE,0,0,54,154,208
2003,Mali,MLI,Switzerland,CHE,0,0,33,70,103
2003,Mongolia,MNG,Switzerland,CHE,0,0,12,337,349
2003,Morocco,MAR,Switzerland,CHE,0,0,12,31,43
2003,Mozambique,MOZ,Switzerland,CHE,0,0,5,0,5
2003,Myanmar,MMR,Switzerland,CHE,0,0,0,5,5
2003,Nepal,NPL,Switzerland,CHE,0,0,5,42,47
2003,Niger,NER,Switzerland,CHE,0,0,20,14,34
2003,Nigeria,NGA,Switzerland,CHE,0,0,425,306,731
2003,Pakistan,PAK,Switzerland,CHE,5,39,192,132,368
2003,Peru,PER,Switzerland,CHE,0,0,5,0,5
2003,Philippines,PHL,Switzerland,CHE,0,0,0,5,5
2003,Poland,POL,Switzerland,CHE,0,0,30,22,52
2003,Romania,ROU,Switzerland,CHE,0,0,33,222,255
2003,South Africa,ZAF,Switzerland,CHE,0,0,5,0,5
2003,Russian Federation,RUS,Switzerland,CHE,12,17,254,281,564
2003,Rwanda,RWA,Switzerland,CHE,13,0,10,10,33
2003,Serbia and Kosovo: S/RES/1244 (1999),SRB,Switzerland,CHE,112,995,2203,1407,4717
2003,Senegal,SEN,Switzerland,CHE,0,0,5,17,22
2003,Sierra Leone,SLE,Switzerland,CHE,0,12,115,100,227
2003,Somalia,SOM,Switzerland,CHE,19,383,419,77,898
2003,Viet Nam,VNM,Switzerland,CHE,35,0,21,10,66
2003,Sudan,SDN,Switzerland,CHE,0,0,70,31,101
2003,Suriname,SUR,Switzerland,CHE,0,0,0,5,5
2003,Slovakia,SVK,Switzerland,CHE,0,0,21,183,204
2003,Slovenia,SVN,Switzerland,CHE,0,0,0,5,5
2003,Switzerland,CHE,Switzerland,CHE,0,0,5,0,5
2003,Syrian Arab Rep.,SYR,Switzerland,CHE,10,22,182,98,312
2003,Tajikistan,TJK,Switzerland,CHE,0,0,0,5,5
2003,Turkmenistan,TKM,Switzerland,CHE,0,0,0,5,5
2003,Togo,TGO,Switzerland,CHE,21,0,198,30,249
2003,Tunisia,TUN,Switzerland,CHE,85,0,51,60,196
2003,Turkey,TUR,Switzerland,CHE,571,86,1472,418,2547
2003,Uganda,UGA,Switzerland,CHE,0,0,0,14,14
2003,Ukraine,UKR,Switzerland,CHE,5,0,164,123,292
2003,United States of America,USA,Switzerland,CHE,0,0,12,0,12
2003,Uzbekistan,UZB,Switzerland,CHE,0,0,21,11,32
2003,Western Sahara,ESH,Switzerland,CHE,0,0,5,0,5
2003,Yemen,YEM,Switzerland,CHE,23,0,91,18,132
2003,Zimbabwe,ZWE,Switzerland,CHE,0,0,11,10,21
2003,Stateless,XXA,Switzerland,CHE,0,0,39,114,153
2003,Rwanda,RWA,United Rep. of Tanzania,TZA,149,0,27,0,176
2003,Afghanistan,AFG,Tajikistan,TJK,109,0,56,0,165
2003,Burundi,BDI,Uganda,UGA,74,0,11,106,191
2003,Dem. Rep. of the Congo,COD,Uganda,UGA,1563,0,41,156,1760
2003,Eritrea,ERI,Uganda,UGA,12,0,0,0,12
2003,Ethiopia,ETH,Uganda,UGA,22,0,12,18,52
2003,Kenya,KEN,Uganda,UGA,5,0,0,0,5
2003,Liberia,LBR,Uganda,UGA,12,0,0,0,12
2003,Sri Lanka,LKA,Uganda,UGA,0,0,0,5,5
2003,Pakistan,PAK,Uganda,UGA,0,0,5,0,5
2003,Rwanda,RWA,Uganda,UGA,156,0,28,48,232
2003,Somalia,SOM,Uganda,UGA,33,0,11,16,60
2003,Sudan,SDN,Uganda,UGA,156,0,0,28,184
2003,Afghanistan,AFG,Ukraine,UKR,36,0,259,48,343
2003,Angola,AGO,Ukraine,UKR,0,0,10,5,15
2003,Armenia,ARM,Ukraine,UKR,0,0,42,0,42
2003,Azerbaijan,AZE,Ukraine,UKR,0,0,5,0,5
2003,Bangladesh,BGD,Ukraine,UKR,0,0,106,0,106
2003,China,CHN,Ukraine,UKR,0,0,54,0,54
2003,Cameroon,CMR,Ukraine,UKR,0,0,5,0,5
2003,Congo,COG,Ukraine,UKR,0,0,5,0,5
2003,Ethiopia,ETH,Ukraine,UKR,0,0,16,0,16
2003,Palestinian,PSE,Ukraine,UKR,0,0,20,0,20
2003,Georgia,GEO,Ukraine,UKR,0,0,20,0,20
2003,India,IND,Ukraine,UKR,0,0,97,0,97
2003,Iran (Islamic Rep. of),IRN,Ukraine,UKR,0,0,56,0,56
2003,Iraq,IRQ,Ukraine,UKR,0,0,152,0,152
2003,Liberia,LBR,Ukraine,UKR,0,0,10,0,10
2003,Lebanon,LBN,Ukraine,UKR,0,0,18,0,18
2003,Sri Lanka,LKA,Ukraine,UKR,0,0,56,0,56
2003,Nigeria,NGA,Ukraine,UKR,0,0,37,0,37
2003,Pakistan,PAK,Ukraine,UKR,0,0,35,0,35
2003,Russian Federation,RUS,Ukraine,UKR,5,0,88,5,98
2003,Somalia,SOM,Ukraine,UKR,10,0,59,0,69
2003,Viet Nam,VNM,Ukraine,UKR,0,0,13,0,13
2003,Sudan,SDN,Ukraine,UKR,0,0,10,0,10
2003,Syrian Arab Rep.,SYR,Ukraine,UKR,0,0,41,0,41
2003,Tajikistan,TJK,Ukraine,UKR,0,0,0,5,5
2003,Turkey,TUR,Ukraine,UKR,0,0,5,0,5
2003,Uganda,UGA,Ukraine,UKR,0,0,5,0,5
2003,Colombia,COL,Venezuela (Bolivarian Republic of),VEN,0,0,0,83,83
2003,Angola,AGO,Zimbabwe,ZWE,415,0,0,0,415
2003,Burundi,BDI,Zimbabwe,ZWE,680,0,0,0,680
2003,Dem. Rep. of the Congo,COD,Zimbabwe,ZWE,1159,0,5,0,1164
2003,Eritrea,ERI,Zimbabwe,ZWE,0,0,5,0,5
2003,Ethiopia,ETH,Zimbabwe,ZWE,29,0,0,0,29
2003,Cote d'Ivoire,CIV,Zimbabwe,ZWE,5,0,0,0,5
2003,Kenya,KEN,Zimbabwe,ZWE,5,0,0,0,5
2003,Liberia,LBR,Zimbabwe,ZWE,76,0,0,0,76
2003,Mauritius,MUS,Zimbabwe,ZWE,0,0,23,0,23
2003,Pakistan,PAK,Zimbabwe,ZWE,5,0,0,0,5
2003,Rwanda,RWA,Zimbabwe,ZWE,781,0,5,0,786
2003,Sierra Leone,SLE,Zimbabwe,ZWE,5,0,0,0,5
2003,Somalia,SOM,Zimbabwe,ZWE,87,0,0,0,87
2003,Sudan,SDN,Zimbabwe,ZWE,21,0,0,0,21
2003,United Rep. of Tanzania,TZA,Zimbabwe,ZWE,5,0,0,0,5
2003,Uganda,UGA,Zimbabwe,ZWE,14,0,0,0,14
2004,North Macedonia,MKD,Albania,ALB,0,0,0,5,5
2004,Malaysia,MYS,Albania,ALB,0,0,0,5,5
2004,Serbia and Kosovo: S/RES/1244 (1999),SRB,Albania,ALB,23,10,11,10,54
2004,Albania,ALB,Argentina,ARG,5,0,0,0,5
2004,Armenia,ARM,Argentina,ARG,32,0,5,0,37
2004,Bangladesh,BGD,Argentina,ARG,5,0,0,0,5
2004,Colombia,COL,Argentina,ARG,12,0,5,0,17
2004,Cuba,CUB,Argentina,ARG,33,0,17,5,55
2004,Ghana,GHA,Argentina,ARG,0,0,5,0,5
2004,Guinea,GIN,Argentina,ARG,5,0,0,0,5
2004,Haiti,HTI,Argentina,ARG,10,0,0,0,10
2004,India,IND,Argentina,ARG,5,0,0,0,5
2004,Kazakhstan,KAZ,Argentina,ARG,5,0,0,0,5
2004,Liberia,LBR,Argentina,ARG,5,0,0,0,5
2004,Sri Lanka,LKA,Argentina,ARG,5,0,0,0,5
2004,Nigeria,NGA,Argentina,ARG,11,0,0,0,11
2004,Peru,PER,Argentina,ARG,43,5,167,27,242
2004,Russian Federation,RUS,Argentina,ARG,15,0,5,0,20
2004,Senegal,SEN,Argentina,ARG,23,0,15,0,38
2004,Sierra Leone,SLE,Argentina,ARG,24,0,0,0,24
2004,Ukraine,UKR,Argentina,ARG,0,0,0,11,11
2004,United States of America,USA,Argentina,ARG,0,0,5,0,5
2004,Georgia,GEO,Armenia,ARM,0,0,0,5,5
2004,Iran (Islamic Rep. of),IRN,Armenia,ARM,0,0,0,12,12
2004,Iraq,IRQ,Armenia,ARM,0,93,0,36,129
2004,Russian Federation,RUS,Armenia,ARM,0,5,0,0,5
2004,Syrian Arab Rep.,SYR,Armenia,ARM,0,0,0,5,5
2004,Afghanistan,AFG,Australia,AUS,99,0,5,5,109
2004,China,CHN,Australia,AUS,17,0,683,10,710
2004,Iran (Islamic Rep. of),IRN,Australia,AUS,47,0,29,5,81
2004,Iraq,IRQ,Australia,AUS,50,0,24,5,79
2004,Pakistan,PAK,Australia,AUS,11,0,48,0,59
2004,Serbia and Kosovo: S/RES/1244 (1999),SRB,Australia,AUS,55,0,70,0,125
2004,Afghanistan,AFG,Azerbaijan,AZE,0,0,41,0,41
2004,Iran (Islamic Rep. of),IRN,Azerbaijan,AZE,14,0,20,0,34
2004,Pakistan,PAK,Azerbaijan,AZE,0,0,11,0,11
2004,Turkmenistan,TKM,Azerbaijan,AZE,5,0,0,0,5
2004,Dem. Rep. of the Congo,COD,Burundi,BDI,1521,0,490,0,2011
2004,Afghanistan,AFG,Belgium,BEL,24,0,38,5,67
2004,Albania,ALB,Belgium,BEL,37,0,95,37,169
2004,Algeria,DZA,Belgium,BEL,10,0,57,11,78
2004,Angola,AGO,Belgium,BEL,5,0,46,21,72
2004,Egypt,EGY,Belgium,BEL,0,0,5,0,5
2004,Armenia,ARM,Belgium,BEL,12,0,56,19,87
2004,Azerbaijan,AZE,Belgium,BEL,23,0,29,5,57
2004,Burundi,BDI,Belgium,BEL,33,0,46,13,92
2004,Bangladesh,BGD,Belgium,BEL,0,0,20,11,31
2004,Bhutan,BTN,Belgium,BEL,0,0,14,22,36
2004,Burkina Faso,BFA,Belgium,BEL,0,0,5,0,5
2004,Belarus,BLR,Belgium,BEL,37,0,49,15,101
2004,Bosnia and Herzegovina,BIH,Belgium,BEL,37,0,23,20,80
2004,Bulgaria,BGR,Belgium,BEL,0,0,12,0,12
2004,Cambodia,KHM,Belgium,BEL,0,0,0,5,5
2004,Central African Rep.,CAF,Belgium,BEL,0,0,5,0,5
2004,Chad,TCD,Belgium,BEL,5,0,0,0,5
2004,China,CHN,Belgium,BEL,30,0,211,16,257
2004,Chile,CHL,Belgium,BEL,0,0,5,0,5
2004,Cameroon,CMR,Belgium,BEL,12,0,199,24,235
2004,Congo,COG,Belgium,BEL,13,0,5,5,23
2004,Dem. Rep. of the Congo,COD,Belgium,BEL,99,0,555,127,781
2004,Colombia,COL,Belgium,BEL,20,0,48,15,83
2004,Cuba,CUB,Belgium,BEL,0,0,5,5,10
2004,Djibouti,DJI,Belgium,BEL,26,0,13,0,39
2004,Ecuador,ECU,Belgium,BEL,0,0,13,0,13
2004,Ethiopia,ETH,Belgium,BEL,0,0,0,14,14
2004,Palestinian,PSE,Belgium,BEL,0,0,34,5,39
2004,Georgia,GEO,Belgium,BEL,5,0,111,18,134
2004,Ghana,GHA,Belgium,BEL,0,0,0,5,5
2004,Guinea-Bissau,GNB,Belgium,BEL,10,0,0,0,10
2004,Guatemala,GTM,Belgium,BEL,5,0,0,0,5
2004,Guinea,GIN,Belgium,BEL,10,0,35,5,50
2004,Haiti,HTI,Belgium,BEL,0,0,0,5,5
2004,Croatia,HRV,Belgium,BEL,5,0,0,5,10
2004,Cote d'Ivoire,CIV,Belgium,BEL,10,0,10,22,42
2004,India,IND,Belgium,BEL,0,0,10,11,21
2004,Iran (Islamic Rep. of),IRN,Belgium,BEL,57,0,565,53,675
2004,Iraq,IRQ,Belgium,BEL,67,0,34,36,137
2004,Israel,ISR,Belgium,BEL,0,0,10,10,20
2004,Jordan,JOR,Belgium,BEL,5,0,0,0,5
2004,Kazakhstan,KAZ,Belgium,BEL,5,0,72,17,94
2004,Kyrgyzstan,KGZ,Belgium,BEL,12,0,59,5,76
2004,Liberia,LBR,Belgium,BEL,0,0,0,10,10
2004,Libya,LBY,Belgium,BEL,0,0,5,0,5
2004,Lebanon,LBN,Belgium,BEL,0,0,49,18,67
2004,Sri Lanka,LKA,Belgium,BEL,0,0,65,101,166
2004,Latvia,LVA,Belgium,BEL,0,0,5,0,5
2004,Mauritania,MRT,Belgium,BEL,14,0,47,13,74
2004,North Macedonia,MKD,Belgium,BEL,5,0,12,5,22
2004,Rep. of Moldova,MDA,Belgium,BEL,5,0,13,5,23
2004,Mali,MLI,Belgium,BEL,0,0,0,5,5
2004,Mongolia,MNG,Belgium,BEL,0,0,5,0,5
2004,Morocco,MAR,Belgium,BEL,0,0,13,0,13
2004,Myanmar,MMR,Belgium,BEL,5,0,10,0,15
2004,Nepal,NPL,Belgium,BEL,0,0,133,24,157
2004,Niger,NER,Belgium,BEL,5,0,18,5,28
2004,Nigeria,NGA,Belgium,BEL,0,0,0,5,5
2004,Pakistan,PAK,Belgium,BEL,14,0,185,35,234
2004,Peru,PER,Belgium,BEL,0,0,5,5,10
2004,Romania,ROU,Belgium,BEL,0,0,12,14,26
2004,Russian Federation,RUS,Belgium,BEL,774,0,1067,125,1966
2004,Rwanda,RWA,Belgium,BEL,510,0,182,58,750
2004,El Salvador,SLV,Belgium,BEL,0,0,5,5,10
2004,Serbia and Kosovo: S/RES/1244 (1999),SRB,Belgium,BEL,187,0,216,147,550
2004,Senegal,SEN,Belgium,BEL,0,0,0,5,5
2004,Sierra Leone,SLE,Belgium,BEL,0,0,18,36,54
2004,Somalia,SOM,Belgium,BEL,15,0,13,20,48
2004,Viet Nam,VNM,Belgium,BEL,0,0,0,5,5
2004,Sudan,SDN,Belgium,BEL,5,0,33,5,43
2004,Syrian Arab Rep.,SYR,Belgium,BEL,55,0,147,21,223
2004,Tajikistan,TJK,Belgium,BEL,0,0,5,0,5
2004,Turkmenistan,TKM,Belgium,BEL,0,0,5,0,5
2004,Togo,TGO,Belgium,BEL,0,0,123,17,140
2004,Turkey,TUR,Belgium,BEL,22,0,218,38,278
2004,Ukraine,UKR,Belgium,BEL,11,0,41,10,62
2004,Uzbekistan,UZB,Belgium,BEL,14,0,72,0,86
2004,Yemen,YEM,Belgium,BEL,5,0,5,0,10
2004,Stateless,XXA,Belgium,BEL,0,0,5,5,10
2004,Algeria,DZA,Benin,BEN,0,0,0,5,5
2004,Central African Rep.,CAF,Benin,BEN,0,0,5,0,5
2004,Chad,TCD,Benin,BEN,5,0,12,0,17
2004,Congo,COG,Benin,BEN,0,0,26,10,36
2004,Dem. Rep. of the Congo,COD,Benin,BEN,17,0,23,10,50
2004,Guinea,GIN,Benin,BEN,0,0,5,0,5
2004,Cote d'Ivoire,CIV,Benin,BEN,19,0,17,5,41
2004,Liberia,LBR,Benin,BEN,0,0,5,31,36
2004,Nigeria,NGA,Benin,BEN,5,0,55,24,84
2004,Rwanda,RWA,Benin,BEN,5,0,5,0,10
2004,Sierra Leone,SLE,Benin,BEN,0,0,10,0,10
2004,Sudan,SDN,Benin,BEN,5,0,0,0,5
2004,Togo,TGO,Benin,BEN,24,0,28,5,57
2004,Chad,TCD,Burkina Faso,BFA,5,0,5,0,10
2004,Cameroon,CMR,Burkina Faso,BFA,0,0,5,0,5
2004,Congo,COG,Burkina Faso,BFA,14,0,0,0,14
2004,Dem. Rep. of the Congo,COD,Burkina Faso,BFA,12,0,5,0,17
2004,Nigeria,NGA,Burkina Faso,BFA,0,0,5,0,5
2004,Rwanda,RWA,Burkina Faso,BFA,0,0,5,0,5
2004,Togo,TGO,Burkina Faso,BFA,0,0,12,0,12
2004,Afghanistan,AFG,Belarus,BLR,17,49,16,118,200
2004,Armenia,ARM,Belarus,BLR,0,0,0,11,11
2004,Azerbaijan,AZE,Belarus,BLR,0,0,0,24,24
2004,Cameroon,CMR,Belarus,BLR,0,0,0,10,10
2004,Congo,COG,Belarus,BLR,0,0,0,5,5
2004,Palestinian,PSE,Belarus,BLR,0,0,0,5,5
2004,Georgia,GEO,Belarus,BLR,5,5,5,39,54
2004,Guinea,GIN,Belarus,BLR,0,0,0,5,5
2004,Iran (Islamic Rep. of),IRN,Belarus,BLR,0,0,5,0,5
2004,Iraq,IRQ,Belarus,BLR,0,0,0,13,13
2004,Rep. of Moldova,MDA,Belarus,BLR,0,0,0,5,5
2004,Nigeria,NGA,Belarus,BLR,0,0,0,5,5
2004,Pakistan,PAK,Belarus,BLR,0,0,5,16,21
2004,Serbia and Kosovo: S/RES/1244 (1999),SRB,Belarus,BLR,0,0,0,19,19
2004,Syrian Arab Rep.,SYR,Belarus,BLR,0,0,0,5,5
2004,Tajikistan,TJK,Belarus,BLR,0,0,0,21,21
2004,Turkmenistan,TKM,Belarus,BLR,0,0,0,5,5
2004,Ukraine,UKR,Belarus,BLR,0,0,0,5,5
2004,Colombia,COL,Bolivia (Plurinational State of),BOL,0,0,0,5,5
2004,Angola,AGO,Botswana,BWA,5,0,0,0,5
2004,Burundi,BDI,Botswana,BWA,21,0,0,0,21
2004,Dem. Rep. of the Congo,COD,Botswana,BWA,13,0,0,0,13
2004,Namibia,NAM,Botswana,BWA,5,0,0,0,5
2004,Rwanda,RWA,Botswana,BWA,10,0,0,0,10
2004,Somalia,SOM,Botswana,BWA,14,0,0,0,14
2004,Algeria,DZA,Brazil,BRA,0,0,0,5,5
2004,Angola,AGO,Brazil,BRA,11,0,36,0,47
2004,Burundi,BDI,Brazil,BRA,11,0,0,0,11
2004,China,CHN,Brazil,BRA,0,0,0,5,5
2004,Cameroon,CMR,Brazil,BRA,0,0,5,0,5
2004,Dem. Rep. of the Congo,COD,Brazil,BRA,5,0,11,5,21
2004,Colombia,COL,Brazil,BRA,44,0,15,5,64
2004,Cuba,CUB,Brazil,BRA,0,0,19,17,36
2004,Ghana,GHA,Brazil,BRA,0,0,5,0,5
2004,Guinea-Bissau,GNB,Brazil,BRA,0,0,0,11,11
2004,Guinea,GIN,Brazil,BRA,0,0,14,0,14
2004,Cote d'Ivoire,CIV,Brazil,BRA,5,0,0,0,5
2004,Iran (Islamic Rep. of),IRN,Brazil,BRA,0,0,0,5,5
2004,Iraq,IRQ,Brazil,BRA,12,0,0,0,12
2004,Liberia,LBR,Brazil,BRA,15,0,5,12,32
2004,Nigeria,NGA,Brazil,BRA,0,0,11,5,16
2004,Paraguay,PRY,Brazil,BRA,5,0,0,0,5
2004,Romania,ROU,Brazil,BRA,0,0,5,132,137
2004,Senegal,SEN,Brazil,BRA,0,0,5,0,5
2004,Sierra Leone,SLE,Brazil,BRA,0,0,11,0,11
2004,United Rep. of Tanzania,TZA,Brazil,BRA,0,0,16,5,21
2004,Togo,TGO,Brazil,BRA,0,0,5,0,5
2004,Afghanistan,AFG,Bulgaria,BGR,0,79,79,175,333
2004,Albania,ALB,Bulgaria,BGR,5,0,0,0,5
2004,Algeria,DZA,Bulgaria,BGR,0,0,33,15,48
2004,Armenia,ARM,Bulgaria,BGR,0,5,43,5,53
2004,Bangladesh,BGD,Bulgaria,BGR,0,0,35,5,40
2004,Bosnia and Herzegovina,BIH,Bulgaria,BGR,0,0,5,0,5
2004,Cuba,CUB,Bulgaria,BGR,0,5,0,0,5
2004,Ethiopia,ETH,Bulgaria,BGR,0,0,0,5,5
2004,Georgia,GEO,Bulgaria,BGR,0,5,0,0,5
2004,Ghana,GHA,Bulgaria,BGR,0,0,5,0,5
2004,India,IND,Bulgaria,BGR,0,0,13,5,18
2004,Iran (Islamic Rep. of),IRN,Bulgaria,BGR,0,11,18,26,55
2004,Iraq,IRQ,Bulgaria,BGR,0,85,0,27,112
2004,Liberia,LBR,Bulgaria,BGR,0,0,0,5,5
2004,Lebanon,LBN,Bulgaria,BGR,0,0,5,0,5
2004,Mauritania,MRT,Bulgaria,BGR,0,0,5,0,5
2004,Morocco,MAR,Bulgaria,BGR,0,0,5,0,5
2004,Nigeria,NGA,Bulgaria,BGR,0,10,29,40,79
2004,Pakistan,PAK,Bulgaria,BGR,0,0,0,5,5
2004,Russian Federation,RUS,Bulgaria,BGR,0,5,5,0,10
2004,Somalia,SOM,Bulgaria,BGR,0,38,12,5,55
2004,Sudan,SDN,Bulgaria,BGR,0,5,0,0,5
2004,Syrian Arab Rep.,SYR,Bulgaria,BGR,5,0,14,0,19
2004,Tunisia,TUN,Bulgaria,BGR,0,5,0,0,5
2004,Turkey,TUR,Bulgaria,BGR,0,0,0,14,14
2004,Stateless,XXA,Bulgaria,BGR,0,10,22,32,64
2004,Liberia,LBR,Belize,BLZ,0,0,0,5,5
2004,Zimbabwe,ZWE,Belize,BLZ,0,0,0,5,5
2004,Afghanistan,AFG,Canada,CAN,100,0,34,26,160
2004,Albania,ALB,Canada,CAN,291,0,352,80,723
2004,Algeria,DZA,Canada,CAN,29,0,70,10,109
2004,Angola,AGO,Canada,CAN,152,0,94,20,266
2004,Antigua and Barbuda,ATG,Canada,CAN,5,0,17,0,22
2004,Egypt,EGY,Canada,CAN,114,0,126,34,274
2004,Argentina,ARG,Canada,CAN,24,0,322,19,365
2004,Armenia,ARM,Canada,CAN,13,0,5,11,29
2004,Australia,AUS,Canada,CAN,0,0,0,5,5
2004,Austria,AUT,Canada,CAN,0,0,5,0,5
2004,Azerbaijan,AZE,Canada,CAN,107,0,10,10,127
2004,Barbados,BRB,Canada,CAN,10,0,32,0,42
2004,Burundi,BDI,Canada,CAN,126,0,22,5,153
2004,Benin,BEN,Canada,CAN,13,0,5,0,18
2004,Bangladesh,BGD,Canada,CAN,297,0,234,37,568
2004,Burkina Faso,BFA,Canada,CAN,14,0,15,0,29
2004,Belarus,BLR,Canada,CAN,25,0,12,5,42
2004,Bolivia (Plurinational State of),BOL,Canada,CAN,25,0,17,11,53
2004,Botswana,BWA,Canada,CAN,0,0,13,0,13
2004,Brazil,BRA,Canada,CAN,58,0,532,129,719
2004,Bosnia and Herzegovina,BIH,Canada,CAN,18,0,12,5,35
2004,Bulgaria,BGR,Canada,CAN,164,0,35,22,221
2004,Belize,BLZ,Canada,CAN,0,0,5,0,5
2004,Cambodia,KHM,Canada,CAN,26,0,22,0,48
2004,Central African Rep.,CAF,Canada,CAN,11,0,5,0,16
2004,Chad,TCD,Canada,CAN,53,0,49,0,102
2004,China,CHN,Canada,CAN,1258,0,669,476,2403
2004,Chile,CHL,Canada,CAN,21,0,93,39,153
2004,Cameroon,CMR,Canada,CAN,78,0,38,5,121
2004,Congo,COG,Canada,CAN,22,0,22,5,49
2004,Dem. Rep. of the Congo,COD,Canada,CAN,322,0,199,43,564
2004,Comoros,COM,Canada,CAN,5,0,0,0,5
2004,Colombia,COL,Canada,CAN,2628,0,414,217,3259
2004,Costa Rica,CRI,Canada,CAN,63,0,1380,366,1809
2004,Cuba,CUB,Canada,CAN,122,0,39,25,186
2004,Cyprus,CYP,Canada,CAN,0,0,5,0,5
2004,Czechia,CZE,Canada,CAN,5,0,24,10,39
2004,Djibouti,DJI,Canada,CAN,20,0,14,19,53
2004,Dominica,DMA,Canada,CAN,5,0,21,5,31
2004,Dominican Rep.,DOM,Canada,CAN,10,0,20,69,99
2004,Ecuador,ECU,Canada,CAN,25,0,40,31,96
2004,Equatorial Guinea,GNQ,Canada,CAN,5,0,0,0,5
2004,Eritrea,ERI,Canada,CAN,148,0,5,10,163
2004,Estonia,EST,Canada,CAN,5,0,11,0,16
2004,Ethiopia,ETH,Canada,CAN,287,0,71,16,374
2004,Fiji,FJI,Canada,CAN,11,0,23,0,34
2004,France,FRA,Canada,CAN,0,0,20,0,20
2004,Gabon,GAB,Canada,CAN,5,0,5,0,10
2004,Gambia,GMB,Canada,CAN,11,0,5,0,16
2004,Palestinian,PSE,Canada,CAN,100,0,36,5,141
2004,Georgia,GEO,Canada,CAN,28,0,25,5,58
2004,Germany,DEU,Canada,CAN,0,0,17,5,22
2004,Ghana,GHA,Canada,CAN,59,0,143,26,228
2004,Guinea-Bissau,GNB,Canada,CAN,5,0,0,0,5
2004,Greece,GRC,Canada,CAN,0,0,5,5,10
2004,Grenada,GRD,Canada,CAN,21,0,249,32,302
2004,Guatemala,GTM,Canada,CAN,51,0,144,30,225
2004,Guinea,GIN,Canada,CAN,97,0,49,17,163
2004,Guyana,GUY,Canada,CAN,198,0,568,66,832
2004,Haiti,HTI,Canada,CAN,118,0,75,12,205
2004,"China, Hong Kong SAR",HKG,Canada,CAN,0,0,0,10,10
2004,Honduras,HND,Canada,CAN,45,0,130,71,246
2004,Croatia,HRV,Canada,CAN,12,0,0,5,17
2004,Hungary,HUN,Canada,CAN,65,0,399,127,591
2004,Cote d'Ivoire,CIV,Canada,CAN,54,0,35,5,94
2004,India,IND,Canada,CAN,330,0,626,285,1241
2004,Indonesia,IDN,Canada,CAN,83,0,114,16,213
2004,Ireland,IRL,Canada,CAN,0,0,5,0,5
2004,Iran (Islamic Rep. of),IRN,Canada,CAN,254,0,120,41,415
2004,Iraq,IRQ,Canada,CAN,184,0,55,12,251
2004,Israel,ISR,Canada,CAN,134,0,366,92,592
2004,Italy,ITA,Canada,CAN,0,0,12,5,17
2004,Jamaica,JAM,Canada,CAN,47,0,282,47,376
2004,Jordan,JOR,Canada,CAN,76,0,95,17,188
2004,Japan,JPN,Canada,CAN,5,0,0,0,5
2004,Kazakhstan,KAZ,Canada,CAN,19,0,10,0,29
2004,Kenya,KEN,Canada,CAN,136,0,98,10,244
2004,Kyrgyzstan,KGZ,Canada,CAN,5,0,10,0,15
2004,Rep. of Korea,KOR,Canada,CAN,46,0,273,72,391
2004,Kuwait,KWT,Canada,CAN,14,0,0,5,19
2004,Liberia,LBR,Canada,CAN,20,0,15,0,35
2004,Libya,LBY,Canada,CAN,24,0,19,10,53
2004,Saint Lucia,LCA,Canada,CAN,51,0,217,27,295
2004,Lebanon,LBN,Canada,CAN,200,0,278,42,520
2004,Sri Lanka,LKA,Canada,CAN,931,0,471,42,1444
2004,Lithuania,LTU,Canada,CAN,24,0,28,11,63
2004,Latvia,LVA,Canada,CAN,10,0,10,0,20
2004,Madagascar,MDG,Canada,CAN,5,0,0,5,10
2004,Mauritania,MRT,Canada,CAN,41,0,16,0,57
2004,North Macedonia,MKD,Canada,CAN,10,0,38,14,62
2004,Rep. of Moldova,MDA,Canada,CAN,22,0,19,0,41
2004,Mexico,MEX,Canada,CAN,665,0,1331,688,2684
2004,Mali,MLI,Canada,CAN,12,0,11,0,23
2004,Malaysia,MYS,Canada,CAN,31,0,109,26,166
2004,Malawi,MWI,Canada,CAN,10,0,0,0,10
2004,Mongolia,MNG,Canada,CAN,14,0,0,0,14
2004,Morocco,MAR,Canada,CAN,34,0,22,5,61
2004,Mozambique,MOZ,Canada,CAN,5,0,0,0,5
2004,Mauritius,MUS,Canada,CAN,5,0,0,5,10
2004,Myanmar,MMR,Canada,CAN,21,0,0,5,26
2004,Namibia,NAM,Canada,CAN,5,0,0,5,10
2004,Nepal,NPL,Canada,CAN,55,0,10,5,70
2004,Netherlands,NLD,Canada,CAN,0,0,10,0,10
2004,Niger,NER,Canada,CAN,12,0,0,0,12
2004,Nicaragua,NIC,Canada,CAN,10,0,67,10,87
2004,Nigeria,NGA,Canada,CAN,509,0,440,71,1020
2004,New Zealand,NZL,Canada,CAN,0,0,5,0,5
2004,Pakistan,PAK,Canada,CAN,1354,0,2136,361,3851
2004,Panama,PAN,Canada,CAN,5,0,20,10,35
2004,Paraguay,PRY,Canada,CAN,5,0,0,5,10
2004,Peru,PER,Canada,CAN,382,0,455,89,926
2004,Philippines,PHL,Canada,CAN,31,0,669,65,765
2004,Poland,POL,Canada,CAN,64,0,218,64,346
2004,Portugal,PRT,Canada,CAN,0,0,373,68,441
2004,Qatar,QAT,Canada,CAN,0,0,10,0,10
2004,Romania,ROU,Canada,CAN,109,0,165,47,321
2004,South Africa,ZAF,Canada,CAN,5,0,12,0,17
2004,Russian Federation,RUS,Canada,CAN,145,0,86,42,273
2004,Rwanda,RWA,Canada,CAN,97,0,25,5,127
2004,El Salvador,SLV,Canada,CAN,63,0,197,46,306
2004,Saudi Arabia,SAU,Canada,CAN,14,0,0,5,19
2004,Serbia and Kosovo: S/RES/1244 (1999),SRB,Canada,CAN,0,0,5,0,5
2004,Senegal,SEN,Canada,CAN,25,0,12,0,37
2004,Singapore,SGP,Canada,CAN,0,0,11,0,11
2004,Sierra Leone,SLE,Canada,CAN,23,0,10,5,38
2004,Somalia,SOM,Canada,CAN,282,0,18,56,356
2004,Spain,ESP,Canada,CAN,0,0,10,10,20
2004,Viet Nam,VNM,Canada,CAN,14,0,28,10,52
2004,Saint Kitts and Nevis,KNA,Canada,CAN,0,0,5,0,5
2004,Sudan,SDN,Canada,CAN,81,0,30,5,116
2004,Slovakia,SVK,Canada,CAN,5,0,47,19,71
2004,Slovenia,SVN,Canada,CAN,5,0,0,0,5
2004,Eswatini,SWZ,Canada,CAN,5,0,0,0,5
2004,Sweden,SWE,Canada,CAN,0,0,20,0,20
2004,Syrian Arab Rep.,SYR,Canada,CAN,89,0,62,5,156
2004,United Rep. of Tanzania,TZA,Canada,CAN,32,0,71,18,121
2004,Thailand,THA,Canada,CAN,0,0,12,0,12
2004,Tajikistan,TJK,Canada,CAN,5,0,0,0,5
2004,Togo,TGO,Canada,CAN,25,0,5,0,30
2004,Trinidad and Tobago,TTO,Canada,CAN,29,0,220,32,281
2004,Tunisia,TUN,Canada,CAN,35,0,29,5,69
2004,Turkey,TUR,Canada,CAN,637,0,311,68,1016
2004,United Arab Emirates,ARE,Canada,CAN,13,0,0,0,13
2004,Uganda,UGA,Canada,CAN,116,0,26,10,152
2004,Ukraine,UKR,Canada,CAN,144,0,93,36,273
2004,Uruguay,URY,Canada,CAN,24,0,344,61,429
2004,United States of America,USA,Canada,CAN,5,0,161,132,298
2004,Uzbekistan,UZB,Canada,CAN,26,0,14,5,45
2004,Saint Vincent and the Grenadines,VCT,Canada,CAN,113,0,353,66,532
2004,Venezuela (Bolivarian Republic of),VEN,Canada,CAN,192,0,517,50,759
2004,Yemen,YEM,Canada,CAN,36,0,29,0,65
2004,Zambia,ZMB,Canada,CAN,16,0,5,0,21
2004,Zimbabwe,ZWE,Canada,CAN,71,0,30,5,106
2004,Angola,AGO,Central African Rep.,CAF,5,0,0,0,5
2004,Chad,TCD,Central African Rep.,CAF,24,0,10,0,34
2004,Congo,COG,Central African Rep.,CAF,35,0,0,0,35
2004,Dem. Rep. of the Congo,COD,Central African Rep.,CAF,512,22,25,20,579
2004,Liberia,LBR,Central African Rep.,CAF,12,0,5,5,22
2004,Rwanda,RWA,Central African Rep.,CAF,16,0,0,0,16
2004,Sudan,SDN,Central African Rep.,CAF,288,0,0,0,288
2004,Colombia,COL,Chile,CHL,65,0,62,0,127
2004,Peru,PER,Chile,CHL,5,0,0,0,5
2004,Russian Federation,RUS,Chile,CHL,5,0,0,0,5
2004,Cuba,CUB,Colombia,COL,10,0,0,0,10
2004,Peru,PER,Colombia,COL,0,0,5,0,5
2004,Uzbekistan,UZB,Colombia,COL,5,0,0,0,5
2004,Afghanistan,AFG,Cyprus,CYP,0,0,5,0,5
2004,Algeria,DZA,Cyprus,CYP,0,0,0,5,5
2004,Egypt,EGY,Cyprus,CYP,0,0,11,5,16
2004,Armenia,ARM,Cyprus,CYP,0,0,5,0,5
2004,Bangladesh,BGD,Cyprus,CYP,0,0,1048,1372,2420
2004,Belarus,BLR,Cyprus,CYP,0,0,5,0,5
2004,China,CHN,Cyprus,CYP,0,0,0,11,11
2004,Dem. Rep. of the Congo,COD,Cyprus,CYP,0,0,5,0,5
2004,Palestinian,PSE,Cyprus,CYP,0,14,100,171,285
2004,Georgia,GEO,Cyprus,CYP,0,0,64,91,155
2004,Cote d'Ivoire,CIV,Cyprus,CYP,0,0,0,5,5
2004,India,IND,Cyprus,CYP,0,0,37,15,52
2004,Iran (Islamic Rep. of),IRN,Cyprus,CYP,5,20,428,217,670
2004,Iraq,IRQ,Cyprus,CYP,0,0,0,10,10
2004,Jordan,JOR,Cyprus,CYP,0,0,0,5,5
2004,Lebanon,LBN,Cyprus,CYP,5,0,26,26,57
2004,Sri Lanka,LKA,Cyprus,CYP,0,0,5,0,5
2004,Rep. of Moldova,MDA,Cyprus,CYP,0,0,14,0,14
2004,Morocco,MAR,Cyprus,CYP,0,0,0,5,5
2004,Nigeria,NGA,Cyprus,CYP,0,0,10,0,10
2004,Pakistan,PAK,Cyprus,CYP,0,0,410,353,763
2004,Russian Federation,RUS,Cyprus,CYP,0,5,203,96,304
2004,Somalia,SOM,Cyprus,CYP,0,0,5,0,5
2004,Syrian Arab Rep.,SYR,Cyprus,CYP,11,0,27,36,74
2004,Turkey,TUR,Cyprus,CYP,5,0,223,53,281
2004,Ukraine,UKR,Cyprus,CYP,0,5,107,59,171
2004,Uzbekistan,UZB,Cyprus,CYP,0,0,5,0,5
2004,Afghanistan,AFG,Czechia,CZE,5,0,16,5,26
2004,Algeria,DZA,Czechia,CZE,0,0,61,20,81
2004,Angola,AGO,Czechia,CZE,0,0,5,0,5
2004,Armenia,ARM,Czechia,CZE,10,0,68,25,103
2004,Azerbaijan,AZE,Czechia,CZE,0,0,15,5,20
2004,Belarus,BLR,Czechia,CZE,29,0,244,76,349
2004,Bosnia and Herzegovina,BIH,Czechia,CZE,0,0,5,0,5
2004,Bulgaria,BGR,Czechia,CZE,0,0,63,0,63
2004,China,CHN,Czechia,CZE,0,0,310,78,388
2004,Georgia,GEO,Czechia,CZE,5,0,250,87,342
2004,Ghana,GHA,Czechia,CZE,0,0,5,0,5
2004,Guinea,GIN,Czechia,CZE,0,0,5,0,5
2004,Cote d'Ivoire,CIV,Czechia,CZE,0,0,20,5,25
2004,India,IND,Czechia,CZE,0,0,47,17,64
2004,Iran (Islamic Rep. of),IRN,Czechia,CZE,5,0,0,0,5
2004,Iraq,IRQ,Czechia,CZE,5,0,10,42,57
2004,Kazakhstan,KAZ,Czechia,CZE,11,0,50,5,66
2004,Kyrgyzstan,KGZ,Czechia,CZE,5,0,109,35,149
2004,Sri Lanka,LKA,Czechia,CZE,0,0,0,5,5
2004,Lithuania,LTU,Czechia,CZE,0,0,12,5,17
2004,North Macedonia,MKD,Czechia,CZE,0,0,16,0,16
2004,Rep. of Moldova,MDA,Czechia,CZE,0,0,143,29,172
2004,Mongolia,MNG,Czechia,CZE,0,0,110,0,110
2004,Nigeria,NGA,Czechia,CZE,0,0,48,10,58
2004,Pakistan,PAK,Czechia,CZE,0,0,15,0,15
2004,Romania,ROU,Czechia,CZE,0,0,24,5,29
2004,Russian Federation,RUS,Czechia,CZE,45,0,357,2444,2846
2004,Serbia and Kosovo: S/RES/1244 (1999),SRB,Czechia,CZE,0,0,0,11,11
2004,Senegal,SEN,Czechia,CZE,0,0,10,0,10
2004,Somalia,SOM,Czechia,CZE,0,0,0,5,5
2004,Viet Nam,VNM,Czechia,CZE,5,0,414,77,496
2004,Slovakia,SVK,Czechia,CZE,0,0,115,60,175
2004,Syrian Arab Rep.,SYR,Czechia,CZE,0,0,0,5,5
2004,Turkey,TUR,Czechia,CZE,0,0,20,10,30
2004,Ukraine,UKR,Czechia,CZE,5,0,1879,78,1962
2004,Uzbekistan,UZB,Czechia,CZE,0,0,41,5,46
2004,Stateless,XXA,Czechia,CZE,0,0,46,20,66
2004,Afghanistan,AFG,Denmark,DNK,33,5,189,0,227
2004,Albania,ALB,Denmark,DNK,0,0,25,0,25
2004,Algeria,DZA,Denmark,DNK,0,0,10,0,10
2004,Armenia,ARM,Denmark,DNK,0,0,5,0,5
2004,Azerbaijan,AZE,Denmark,DNK,0,5,11,0,16
2004,Burundi,BDI,Denmark,DNK,5,10,16,0,31
2004,Bangladesh,BGD,Denmark,DNK,0,0,23,0,23
2004,Belarus,BLR,Denmark,DNK,0,0,12,0,12
2004,Bosnia and Herzegovina,BIH,Denmark,DNK,0,0,55,0,55
2004,Bulgaria,BGR,Denmark,DNK,0,0,33,0,33
2004,China,CHN,Denmark,DNK,5,0,16,0,21
2004,Cameroon,CMR,Denmark,DNK,0,0,5,0,5
2004,Dem. Rep. of the Congo,COD,Denmark,DNK,0,0,11,0,11
2004,Ecuador,ECU,Denmark,DNK,0,0,10,0,10
2004,Eritrea,ERI,Denmark,DNK,5,0,5,0,10
2004,Ethiopia,ETH,Denmark,DNK,5,0,0,0,5
2004,Palestinian,PSE,Denmark,DNK,10,0,70,0,80
2004,Georgia,GEO,Denmark,DNK,0,0,12,0,12
2004,Ghana,GHA,Denmark,DNK,0,0,5,0,5
2004,Croatia,HRV,Denmark,DNK,0,0,17,0,17
2004,Hungary,HUN,Denmark,DNK,0,0,10,0,10
2004,India,IND,Denmark,DNK,0,0,13,0,13
2004,Iran (Islamic Rep. of),IRN,Denmark,DNK,5,12,80,0,97
2004,Iraq,IRQ,Denmark,DNK,0,5,525,0,530
2004,Libya,LBY,Denmark,DNK,0,5,0,0,5
2004,Lebanon,LBN,Denmark,DNK,0,0,5,0,5
2004,Lithuania,LTU,Denmark,DNK,0,0,14,0,14
2004,Latvia,LVA,Denmark,DNK,0,0,5,0,5
2004,North Macedonia,MKD,Denmark,DNK,0,0,44,0,44
2004,Rep. of Moldova,MDA,Denmark,DNK,0,0,5,0,5
2004,Morocco,MAR,Denmark,DNK,0,0,10,0,10
2004,Myanmar,MMR,Denmark,DNK,0,0,5,0,5
2004,Nepal,NPL,Denmark,DNK,0,0,5,0,5
2004,Nigeria,NGA,Denmark,DNK,0,0,44,0,44
2004,Pakistan,PAK,Denmark,DNK,0,0,21,0,21
2004,Poland,POL,Denmark,DNK,0,0,5,0,5
2004,Romania,ROU,Denmark,DNK,0,0,15,0,15
2004,Russian Federation,RUS,Denmark,DNK,14,50,71,0,135
2004,Rwanda,RWA,Denmark,DNK,5,0,5,0,10
2004,Serbia and Kosovo: S/RES/1244 (1999),SRB,Denmark,DNK,0,0,302,0,302
2004,Sierra Leone,SLE,Denmark,DNK,0,0,5,0,5
2004,Somalia,SOM,Denmark,DNK,0,12,86,0,98
2004,Viet Nam,VNM,Denmark,DNK,0,0,5,0,5
2004,Sudan,SDN,Denmark,DNK,5,0,5,0,10
2004,Slovakia,SVK,Denmark,DNK,0,0,17,0,17
2004,Syrian Arab Rep.,SYR,Denmark,DNK,5,0,26,0,31
2004,Tunisia,TUN,Denmark,DNK,0,0,5,0,5
2004,Turkey,TUR,Denmark,DNK,0,0,34,0,34
2004,Stateless,XXA,Denmark,DNK,0,0,12,0,12
2004,Colombia,COL,Ecuador,ECU,2465,0,4207,1927,8599
2004,Cuba,CUB,Ecuador,ECU,10,0,0,0,10
2004,Haiti,HTI,Ecuador,ECU,13,0,0,0,13
2004,Morocco,MAR,Ecuador,ECU,5,0,0,0,5
2004,Peru,PER,Ecuador,ECU,16,0,100,0,116
2004,Turkey,TUR,Estonia,EST,0,0,5,0,5
2004,Afghanistan,AFG,France,FRA,43,0,181,0,224
2004,Albania,ALB,France,FRA,28,0,542,0,570
2004,Algeria,DZA,France,FRA,155,0,3982,0,4137
2004,Angola,AGO,France,FRA,128,0,1382,0,1510
2004,Egypt,EGY,France,FRA,5,0,21,0,26
2004,Armenia,ARM,France,FRA,26,0,1313,0,1339
2004,Azerbaijan,AZE,France,FRA,64,0,565,0,629
2004,Burundi,BDI,France,FRA,20,0,44,0,64
2004,Bangladesh,BGD,France,FRA,40,0,1534,0,1574
2004,Burkina Faso,BFA,France,FRA,5,0,30,0,35
2004,Belarus,BLR,France,FRA,27,0,235,0,262
2004,Brazil,BRA,France,FRA,0,0,16,0,16
2004,Bosnia and Herzegovina,BIH,France,FRA,981,0,548,0,1529
2004,Cambodia,KHM,France,FRA,5,0,100,0,105
2004,Central African Rep.,CAF,France,FRA,52,0,291,0,343
2004,Chad,TCD,France,FRA,30,0,238,0,268
2004,China,CHN,France,FRA,26,0,6108,0,6134
2004,Cameroon,CMR,France,FRA,35,0,888,0,923
2004,Congo,COG,France,FRA,200,0,1744,0,1944
2004,Dem. Rep. of the Congo,COD,France,FRA,388,0,4928,0,5316
2004,Colombia,COL,France,FRA,25,0,107,0,132
2004,Cuba,CUB,France,FRA,11,0,22,0,33
2004,Cabo Verde,CPV,France,FRA,0,0,12,0,12
2004,Djibouti,DJI,France,FRA,5,0,23,0,28
2004,Dominican Rep.,DOM,France,FRA,0,0,26,0,26
2004,Eritrea,ERI,France,FRA,5,0,23,0,28
2004,Ethiopia,ETH,France,FRA,21,0,41,0,62
2004,Gambia,GMB,France,FRA,0,0,66,0,66
2004,Palestinian,PSE,France,FRA,5,0,64,0,69
2004,Georgia,GEO,France,FRA,46,0,1857,0,1903
2004,Ghana,GHA,France,FRA,0,0,95,0,95
2004,Guinea-Bissau,GNB,France,FRA,38,0,122,0,160
2004,Guinea,GIN,France,FRA,79,0,1090,0,1169
2004,Haiti,HTI,France,FRA,215,0,2815,0,3030
2004,Cote d'Ivoire,CIV,France,FRA,219,0,968,0,1187
2004,India,IND,France,FRA,5,0,1191,0,1196
2004,Iran (Islamic Rep. of),IRN,France,FRA,41,0,118,0,159
2004,Iraq,IRQ,France,FRA,31,0,178,0,209
2004,Israel,ISR,France,FRA,0,0,10,0,10
2004,Kazakhstan,KAZ,France,FRA,5,0,142,0,147
2004,Kyrgyzstan,KGZ,France,FRA,5,0,82,0,87
2004,Liberia,LBR,France,FRA,12,0,404,0,416
2004,Lebanon,LBN,France,FRA,5,0,37,0,42
2004,Sri Lanka,LKA,France,FRA,320,0,2903,0,3223
2004,Madagascar,MDG,France,FRA,31,0,327,0,358
2004,Mauritania,MRT,France,FRA,184,0,2516,0,2700
2004,North Macedonia,MKD,France,FRA,0,0,232,0,232
2004,Rep. of Moldova,MDA,France,FRA,20,0,2188,0,2208
2004,Mali,MLI,France,FRA,5,0,916,0,921
2004,Mongolia,MNG,France,FRA,0,0,614,0,614
2004,Mauritius,MUS,France,FRA,0,0,17,0,17
2004,Myanmar,MMR,France,FRA,5,0,31,0,36
2004,Niger,NER,France,FRA,5,0,25,0,30
2004,Nigeria,NGA,France,FRA,34,0,1654,0,1688
2004,Pakistan,PAK,France,FRA,12,0,1354,0,1366
2004,Peru,PER,France,FRA,5,0,50,0,55
2004,Romania,ROU,France,FRA,0,0,702,0,702
2004,Russian Federation,RUS,France,FRA,1136,0,1718,0,2854
2004,Rwanda,RWA,France,FRA,174,0,170,0,344
2004,Serbia and Kosovo: S/RES/1244 (1999),SRB,France,FRA,563,0,2074,0,2637
2004,Senegal,SEN,France,FRA,5,0,230,0,235
2004,Sierra Leone,SLE,France,FRA,27,0,319,0,346
2004,Somalia,SOM,France,FRA,26,0,125,0,151
2004,Sudan,SDN,France,FRA,116,0,311,0,427
2004,Slovakia,SVK,France,FRA,0,0,40,0,40
2004,Syrian Arab Rep.,SYR,France,FRA,12,0,40,0,52
2004,Thailand,THA,France,FRA,0,0,35,0,35
2004,Tajikistan,TJK,France,FRA,5,0,14,0,19
2004,Togo,TGO,France,FRA,56,0,365,0,421
2004,Tunisia,TUN,France,FRA,12,0,38,0,50
2004,Turkey,TUR,France,FRA,424,0,7002,0,7426
2004,Uganda,UGA,France,FRA,0,0,5,0,5
2004,Ukraine,UKR,France,FRA,19,0,839,0,858
2004,United States of America,USA,France,FRA,0,0,5,0,5
2004,Uzbekistan,UZB,France,FRA,5,0,74,0,79
2004,Stateless,XXA,France,FRA,71,0,126,0,197
2004,Angola,AGO,Gabon,GAB,0,0,5,0,5
2004,Central African Rep.,CAF,Gabon,GAB,0,0,13,0,13
2004,Chad,TCD,Gabon,GAB,0,0,40,0,40
2004,Congo,COG,Gabon,GAB,10,0,140,0,150
2004,Dem. Rep. of the Congo,COD,Gabon,GAB,10,0,134,0,144
2004,Equatorial Guinea,GNQ,Gabon,GAB,0,0,5,0,5
2004,Cote d'Ivoire,CIV,Gabon,GAB,0,0,5,0,5
2004,Mauritania,MRT,Gabon,GAB,0,0,10,0,10
2004,Mali,MLI,Gabon,GAB,0,0,10,0,10
2004,Sudan,SDN,Gabon,GAB,0,0,5,0,5
2004,Afghanistan,AFG,United Kingdom of Great Britain and Northern Ireland,GBR,46,455,2116,387,3004
2004,Albania,ALB,United Kingdom of Great Britain and Northern Ireland,GBR,0,111,400,83,594
2004,Algeria,DZA,United Kingdom of Great Britain and Northern Ireland,GBR,12,33,589,156,790
2004,Angola,AGO,United Kingdom of Great Britain and Northern Ireland,GBR,10,108,647,63,828
2004,Egypt,EGY,United Kingdom of Great Britain and Northern Ireland,GBR,0,5,101,19,125
2004,Armenia,ARM,United Kingdom of Great Britain and Northern Ireland,GBR,0,0,69,5,74
2004,Azerbaijan,AZE,United Kingdom of Great Britain and Northern Ireland,GBR,10,0,101,15,126
2004,Burundi,BDI,United Kingdom of Great Britain and Northern Ireland,GBR,26,120,280,27,453
2004,Benin,BEN,United Kingdom of Great Britain and Northern Ireland,GBR,0,0,5,5,10
2004,Bangladesh,BGD,United Kingdom of Great Britain and Northern Ireland,GBR,0,277,306,45,628
2004,Bhutan,BTN,United Kingdom of Great Britain and Northern Ireland,GBR,10,0,43,25,78
2004,Burkina Faso,BFA,United Kingdom of Great Britain and Northern Ireland,GBR,0,0,14,0,14
2004,Belarus,BLR,United Kingdom of Great Britain and Northern Ireland,GBR,0,0,113,86,199
2004,Bolivia (Plurinational State of),BOL,United Kingdom of Great Britain and Northern Ireland,GBR,5,0,16,0,21
2004,Botswana,BWA,United Kingdom of Great Britain and Northern Ireland,GBR,0,0,10,0,10
2004,Brazil,BRA,United Kingdom of Great Britain and Northern Ireland,GBR,0,0,38,0,38
2004,Bosnia and Herzegovina,BIH,United Kingdom of Great Britain and Northern Ireland,GBR,0,0,37,11,48
2004,Bulgaria,BGR,United Kingdom of Great Britain and Northern Ireland,GBR,0,0,17,5,22
2004,Central African Rep.,CAF,United Kingdom of Great Britain and Northern Ireland,GBR,0,0,5,0,5
2004,Chad,TCD,United Kingdom of Great Britain and Northern Ireland,GBR,0,5,24,5,34
2004,China,CHN,United Kingdom of Great Britain and Northern Ireland,GBR,13,83,1867,703,2666
2004,Chile,CHL,United Kingdom of Great Britain and Northern Ireland,GBR,0,0,10,0,10
2004,Cameroon,CMR,United Kingdom of Great Britain and Northern Ireland,GBR,22,51,336,25,434
2004,Congo,COG,United Kingdom of Great Britain and Northern Ireland,GBR,16,24,246,15,301
2004,Dem. Rep. of the Congo,COD,United Kingdom of Great Britain and Northern Ireland,GBR,65,190,1796,206,2257
2004,Colombia,COL,United Kingdom of Great Britain and Northern Ireland,GBR,13,0,158,25,196
2004,Cuba,CUB,United Kingdom of Great Britain and Northern Ireland,GBR,0,0,16,5,21
2004,Cabo Verde,CPV,United Kingdom of Great Britain and Northern Ireland,GBR,0,0,0,5,5
2004,Cyprus,CYP,United Kingdom of Great Britain and Northern Ireland,GBR,0,0,34,0,34
2004,Czechia,CZE,United Kingdom of Great Britain and Northern Ireland,GBR,0,0,95,15,110
2004,Djibouti,DJI,United Kingdom of Great Britain and Northern Ireland,GBR,0,0,10,0,10
2004,Dominican Rep.,DOM,United Kingdom of Great Britain and Northern Ireland,GBR,0,0,5,0,5
2004,Ecuador,ECU,United Kingdom of Great Britain and Northern Ireland,GBR,0,5,71,5,81
2004,Equatorial Guinea,GNQ,United Kingdom of Great Britain and Northern Ireland,GBR,0,0,5,0,5
2004,Eritrea,ERI,United Kingdom of Great Britain and Northern Ireland,GBR,85,189,707,145,1126
2004,Estonia,EST,United Kingdom of Great Britain and Northern Ireland,GBR,0,0,14,0,14
2004,Ethiopia,ETH,United Kingdom of Great Britain and Northern Ireland,GBR,14,132,516,50,712
2004,Gabon,GAB,United Kingdom of Great Britain and Northern Ireland,GBR,0,0,5,0,5
2004,Gambia,GMB,United Kingdom of Great Britain and Northern Ireland,GBR,0,0,116,17,133
2004,Palestinian,PSE,United Kingdom of Great Britain and Northern Ireland,GBR,26,25,525,120,696
2004,Georgia,GEO,United Kingdom of Great Britain and Northern Ireland,GBR,10,10,169,31,220
2004,Ghana,GHA,United Kingdom of Great Britain and Northern Ireland,GBR,10,5,304,48,367
2004,Guinea-Bissau,GNB,United Kingdom of Great Britain and Northern Ireland,GBR,0,0,25,0,25
2004,Guinea,GIN,United Kingdom of Great Britain and Northern Ireland,GBR,5,50,267,22,344
2004,Guyana,GUY,United Kingdom of Great Britain and Northern Ireland,GBR,0,0,13,0,13
2004,Croatia,HRV,United Kingdom of Great Britain and Northern Ireland,GBR,5,0,41,0,46
2004,Hungary,HUN,United Kingdom of Great Britain and Northern Ireland,GBR,0,0,5,0,5
2004,Cote d'Ivoire,CIV,United Kingdom of Great Britain and Northern Ireland,GBR,5,16,269,22,312
2004,India,IND,United Kingdom of Great Britain and Northern Ireland,GBR,5,16,1145,454,1620
2004,Indonesia,IDN,United Kingdom of Great Britain and Northern Ireland,GBR,5,0,19,10,34
2004,Iran (Islamic Rep. of),IRN,United Kingdom of Great Britain and Northern Ireland,GBR,97,240,3605,611,4553
2004,Iraq,IRQ,United Kingdom of Great Britain and Northern Ireland,GBR,11,191,4122,773,5097
2004,Israel,ISR,United Kingdom of Great Britain and Northern Ireland,GBR,0,0,67,10,77
2004,Jamaica,JAM,United Kingdom of Great Britain and Northern Ireland,GBR,0,16,543,30,589
2004,Jordan,JOR,United Kingdom of Great Britain and Northern Ireland,GBR,0,0,18,0,18
2004,Japan,JPN,United Kingdom of Great Britain and Northern Ireland,GBR,0,0,0,5,5
2004,Kazakhstan,KAZ,United Kingdom of Great Britain and Northern Ireland,GBR,0,0,11,0,11
2004,Kenya,KEN,United Kingdom of Great Britain and Northern Ireland,GBR,10,32,197,24,263
2004,Kyrgyzstan,KGZ,United Kingdom of Great Britain and Northern Ireland,GBR,5,0,17,5,27
2004,Dem. People's Rep. of Korea,PRK,United Kingdom of Great Britain and Northern Ireland,GBR,5,12,36,13,66
2004,Kuwait,KWT,United Kingdom of Great Britain and Northern Ireland,GBR,0,5,40,5,50
2004,Liberia,LBR,United Kingdom of Great Britain and Northern Ireland,GBR,5,64,378,95,542
2004,Libya,LBY,United Kingdom of Great Britain and Northern Ireland,GBR,26,5,174,33,238
2004,Lebanon,LBN,United Kingdom of Great Britain and Northern Ireland,GBR,0,5,181,21,207
2004,Sri Lanka,LKA,United Kingdom of Great Britain and Northern Ireland,GBR,10,88,663,74,835
2004,Lithuania,LTU,United Kingdom of Great Britain and Northern Ireland,GBR,0,0,53,14,67
2004,Latvia,LVA,United Kingdom of Great Britain and Northern Ireland,GBR,0,0,26,0,26
2004,Mauritania,MRT,United Kingdom of Great Britain and Northern Ireland,GBR,5,0,12,0,17
2004,North Macedonia,MKD,United Kingdom of Great Britain and Northern Ireland,GBR,0,13,27,5,45
2004,Rep. of Moldova,MDA,United Kingdom of Great Britain and Northern Ireland,GBR,0,36,106,77,219
2004,Mali,MLI,United Kingdom of Great Britain and Northern Ireland,GBR,0,0,11,0,11
2004,Malaysia,MYS,United Kingdom of Great Britain and Northern Ireland,GBR,0,0,11,0,11
2004,Malawi,MWI,United Kingdom of Great Britain and Northern Ireland,GBR,0,5,168,19,192
2004,Mongolia,MNG,United Kingdom of Great Britain and Northern Ireland,GBR,10,5,157,32,204
2004,Morocco,MAR,United Kingdom of Great Britain and Northern Ireland,GBR,0,5,25,10,40
2004,Mozambique,MOZ,United Kingdom of Great Britain and Northern Ireland,GBR,0,0,5,0,5
2004,Mauritius,MUS,United Kingdom of Great Britain and Northern Ireland,GBR,5,0,23,5,33
2004,Myanmar,MMR,United Kingdom of Great Britain and Northern Ireland,GBR,20,0,83,5,108
2004,Nepal,NPL,United Kingdom of Great Britain and Northern Ireland,GBR,5,5,179,35,224
2004,Niger,NER,United Kingdom of Great Britain and Northern Ireland,GBR,0,0,5,0,5
2004,Nicaragua,NIC,United Kingdom of Great Britain and Northern Ireland,GBR,0,0,5,0,5
2004,Nigeria,NGA,United Kingdom of Great Britain and Northern Ireland,GBR,5,47,971,164,1187
2004,Pakistan,PAK,United Kingdom of Great Britain and Northern Ireland,GBR,125,108,2949,227,3409
2004,Peru,PER,United Kingdom of Great Britain and Northern Ireland,GBR,0,0,13,0,13
2004,Philippines,PHL,United Kingdom of Great Britain and Northern Ireland,GBR,0,0,24,5,29
2004,Poland,POL,United Kingdom of Great Britain and Northern Ireland,GBR,0,0,87,10,97
2004,Qatar,QAT,United Kingdom of Great Britain and Northern Ireland,GBR,0,0,5,0,5
2004,Romania,ROU,United Kingdom of Great Britain and Northern Ireland,GBR,0,86,298,112,496
2004,South Africa,ZAF,United Kingdom of Great Britain and Northern Ireland,GBR,0,0,306,15,321
2004,Russian Federation,RUS,United Kingdom of Great Britain and Northern Ireland,GBR,41,5,275,58,379
2004,Rwanda,RWA,United Kingdom of Great Britain and Northern Ireland,GBR,20,26,190,21,257
2004,El Salvador,SLV,United Kingdom of Great Britain and Northern Ireland,GBR,5,0,5,0,10
2004,Serbia and Kosovo: S/RES/1244 (1999),SRB,United Kingdom of Great Britain and Northern Ireland,GBR,23,165,1022,181,1391
2004,Senegal,SEN,United Kingdom of Great Britain and Northern Ireland,GBR,0,0,18,10,28
2004,Seychelles,SYC,United Kingdom of Great Britain and Northern Ireland,GBR,0,0,11,0,11
2004,Sierra Leone,SLE,United Kingdom of Great Britain and Northern Ireland,GBR,10,50,302,54,416
2004,Somalia,SOM,United Kingdom of Great Britain and Northern Ireland,GBR,652,482,2710,483,4327
2004,Viet Nam,VNM,United Kingdom of Great Britain and Northern Ireland,GBR,5,220,439,266,930
2004,Sudan,SDN,United Kingdom of Great Britain and Northern Ireland,GBR,130,49,1094,336,1609
2004,Slovakia,SVK,United Kingdom of Great Britain and Northern Ireland,GBR,0,0,25,0,25
2004,Eswatini,SWZ,United Kingdom of Great Britain and Northern Ireland,GBR,0,0,5,0,5
2004,Syrian Arab Rep.,SYR,United Kingdom of Great Britain and Northern Ireland,GBR,19,16,273,50,358
2004,United Rep. of Tanzania,TZA,United Kingdom of Great Britain and Northern Ireland,GBR,5,5,18,0,28
2004,Thailand,THA,United Kingdom of Great Britain and Northern Ireland,GBR,0,0,14,0,14
2004,Tajikistan,TJK,United Kingdom of Great Britain and Northern Ireland,GBR,0,0,5,0,5
2004,Turkmenistan,TKM,United Kingdom of Great Britain and Northern Ireland,GBR,10,0,10,0,20
2004,Togo,TGO,United Kingdom of Great Britain and Northern Ireland,GBR,5,5,97,13,120
2004,Trinidad and Tobago,TTO,United Kingdom of Great Britain and Northern Ireland,GBR,0,0,11,0,11
2004,Tunisia,TUN,United Kingdom of Great Britain and Northern Ireland,GBR,0,0,23,5,28
2004,Turkey,TUR,United Kingdom of Great Britain and Northern Ireland,GBR,121,99,2295,265,2780
2004,Uganda,UGA,United Kingdom of Great Britain and Northern Ireland,GBR,31,112,391,29,563
2004,Ukraine,UKR,United Kingdom of Great Britain and Northern Ireland,GBR,5,10,154,17,186
2004,Uzbekistan,UZB,United Kingdom of Great Britain and Northern Ireland,GBR,0,0,25,5,30
2004,Venezuela (Bolivarian Republic of),VEN,United Kingdom of Great Britain and Northern Ireland,GBR,0,0,11,0,11
2004,Yemen,YEM,United Kingdom of Great Britain and Northern Ireland,GBR,5,22,143,12,182
2004,Zambia,ZMB,United Kingdom of Great Britain and Northern Ireland,GBR,5,0,19,10,34
2004,Zimbabwe,ZWE,United Kingdom of Great Britain and Northern Ireland,GBR,303,31,2686,188,3208
2004,Stateless,XXA,United Kingdom of Great Britain and Northern Ireland,GBR,0,0,99,20,119
2004,Iran (Islamic Rep. of),IRN,Georgia,GEO,0,0,5,0,5
2004,Cote d'Ivoire,CIV,Guinea-Bissau,GNB,15,0,0,0,15
2004,Afghanistan,AFG,Greece,GRC,0,5,216,56,277
2004,Albania,ALB,Greece,GRC,0,0,16,0,16
2004,Algeria,DZA,Greece,GRC,0,0,14,5,19
2004,Egypt,EGY,Greece,GRC,0,0,88,0,88
2004,Armenia,ARM,Greece,GRC,0,0,23,0,23
2004,Azerbaijan,AZE,Greece,GRC,0,0,5,0,5
2004,Burundi,BDI,Greece,GRC,0,0,10,0,10
2004,Bangladesh,BGD,Greece,GRC,0,0,192,5,197
2004,Belarus,BLR,Greece,GRC,0,0,23,0,23
2004,Bulgaria,BGR,Greece,GRC,0,0,34,0,34
2004,Central African Rep.,CAF,Greece,GRC,0,10,0,0,10
2004,China,CHN,Greece,GRC,0,0,79,22,101
2004,Cameroon,CMR,Greece,GRC,0,0,5,0,5
2004,Dem. Rep. of the Congo,COD,Greece,GRC,0,0,12,5,17
2004,Eritrea,ERI,Greece,GRC,0,0,12,5,17
2004,Ethiopia,ETH,Greece,GRC,0,0,25,5,30
2004,Gambia,GMB,Greece,GRC,0,0,5,0,5
2004,Palestinian,PSE,Greece,GRC,0,0,153,45,198
2004,Georgia,GEO,Greece,GRC,0,0,222,24,246
2004,Ghana,GHA,Greece,GRC,0,0,5,0,5
2004,Cote d'Ivoire,CIV,Greece,GRC,0,0,41,5,46
2004,India,IND,Greece,GRC,0,0,23,0,23
2004,Indonesia,IDN,Greece,GRC,0,0,5,5,10
2004,Iran (Islamic Rep. of),IRN,Greece,GRC,5,0,236,54,295
2004,Iraq,IRQ,Greece,GRC,0,0,785,165,950
2004,Kazakhstan,KAZ,Greece,GRC,0,0,5,0,5
2004,Liberia,LBR,Greece,GRC,0,0,5,0,5
2004,Libya,LBY,Greece,GRC,0,0,10,0,10
2004,Lebanon,LBN,Greece,GRC,0,0,5,0,5
2004,Sri Lanka,LKA,Greece,GRC,0,0,14,0,14
2004,Mauritania,MRT,Greece,GRC,0,0,14,0,14
2004,North Macedonia,MKD,Greece,GRC,0,0,5,0,5
2004,Rep. of Moldova,MDA,Greece,GRC,0,0,52,5,57
2004,Morocco,MAR,Greece,GRC,0,0,10,0,10
2004,Myanmar,MMR,Greece,GRC,0,0,218,5,223
2004,Nigeria,NGA,Greece,GRC,0,0,188,41,229
2004,Pakistan,PAK,Greece,GRC,0,0,325,14,339
2004,Philippines,PHL,Greece,GRC,0,0,5,0,5
2004,Romania,ROU,Greece,GRC,0,0,39,0,39
2004,Russian Federation,RUS,Greece,GRC,0,0,108,21,129
2004,Rwanda,RWA,Greece,GRC,0,0,17,0,17
2004,Serbia and Kosovo: S/RES/1244 (1999),SRB,Greece,GRC,0,0,5,5,10
2004,Sierra Leone,SLE,Greece,GRC,0,0,28,0,28
2004,Somalia,SOM,Greece,GRC,0,0,118,57,175
2004,Sudan,SDN,Greece,GRC,0,0,65,32,97
2004,Syrian Arab Rep.,SYR,Greece,GRC,0,0,28,0,28
2004,Turkey,TUR,Greece,GRC,0,5,119,12,136
2004,Ukraine,UKR,Greece,GRC,5,0,79,0,84
2004,Uzbekistan,UZB,Greece,GRC,0,0,14,0,14
2004,Colombia,COL,Guatemala,GTM,0,0,0,5,5
2004,Cuba,CUB,Guatemala,GTM,0,0,0,5,5
2004,Dem. Rep. of the Congo,COD,Guinea,GIN,12,0,0,0,12
2004,Cote d'Ivoire,CIV,Guinea,GIN,94,0,26,0,120
2004,Liberia,LBR,Guinea,GIN,143,0,27,0,170
2004,Sierra Leone,SLE,Guinea,GIN,133,0,24,0,157
2004,Togo,TGO,Guinea,GIN,13,0,0,0,13
2004,Colombia,COL,Honduras,HND,0,0,0,5,5
2004,Cuba,CUB,Honduras,HND,0,0,15,34,49
2004,Eritrea,ERI,Honduras,HND,0,0,0,5,5
2004,Ethiopia,ETH,Honduras,HND,0,0,0,10,10
2004,Haiti,HTI,Honduras,HND,0,0,0,5,5
2004,Algeria,DZA,Croatia,HRV,0,0,12,0,12
2004,Egypt,EGY,Croatia,HRV,0,0,5,0,5
2004,Bangladesh,BGD,Croatia,HRV,0,0,0,5,5
2004,Bosnia and Herzegovina,BIH,Croatia,HRV,0,0,5,0,5
2004,Cuba,CUB,Croatia,HRV,0,0,5,0,5
2004,Cote d'Ivoire,CIV,Croatia,HRV,0,0,5,0,5
2004,India,IND,Croatia,HRV,0,0,12,0,12
2004,Iraq,IRQ,Croatia,HRV,0,0,5,0,5
2004,Sri Lanka,LKA,Croatia,HRV,0,0,5,0,5
2004,North Macedonia,MKD,Croatia,HRV,0,0,0,10,10
2004,Pakistan,PAK,Croatia,HRV,0,0,11,0,11
2004,Russian Federation,RUS,Croatia,HRV,0,0,5,0,5
2004,Serbia and Kosovo: S/RES/1244 (1999),SRB,Croatia,HRV,0,0,18,0,18
2004,Turkey,TUR,Croatia,HRV,0,0,22,11,33
2004,Afghanistan,AFG,Hungary,HUN,19,38,5,12,74
2004,Algeria,DZA,Hungary,HUN,0,0,52,22,74
2004,Angola,AGO,Hungary,HUN,0,5,0,0,5
2004,Egypt,EGY,Hungary,HUN,0,0,0,5,5
2004,Armenia,ARM,Hungary,HUN,5,0,12,10,27
2004,Bangladesh,BGD,Hungary,HUN,0,0,16,5,21
2004,Belarus,BLR,Hungary,HUN,0,0,0,5,5
2004,China,CHN,Hungary,HUN,0,0,45,10,55
2004,Cameroon,CMR,Hungary,HUN,0,5,5,0,10
2004,Congo,COG,Hungary,HUN,0,0,5,0,5
2004,Dem. Rep. of the Congo,COD,Hungary,HUN,5,0,5,0,10
2004,Cuba,CUB,Hungary,HUN,0,5,0,0,5
2004,Ecuador,ECU,Hungary,HUN,0,0,0,5,5
2004,Ethiopia,ETH,Hungary,HUN,5,5,0,0,10
2004,Gambia,GMB,Hungary,HUN,0,0,5,5,10
2004,Palestinian,PSE,Hungary,HUN,10,5,15,26,56
2004,Georgia,GEO,Hungary,HUN,0,10,77,147,234
2004,Cote d'Ivoire,CIV,Hungary,HUN,0,5,0,0,5
2004,India,IND,Hungary,HUN,0,0,22,10,32
2004,Iran (Islamic Rep. of),IRN,Hungary,HUN,20,5,26,12,63
2004,Iraq,IRQ,Hungary,HUN,19,32,10,11,72
2004,Liberia,LBR,Hungary,HUN,0,0,5,5,10
2004,North Macedonia,MKD,Hungary,HUN,0,0,0,5,5
2004,Rep. of Moldova,MDA,Hungary,HUN,0,0,24,26,50
2004,Mongolia,MNG,Hungary,HUN,0,0,11,0,11
2004,Nepal,NPL,Hungary,HUN,5,0,14,5,24
2004,Nigeria,NGA,Hungary,HUN,5,5,55,17,82
2004,Pakistan,PAK,Hungary,HUN,5,0,22,26,53
2004,Romania,ROU,Hungary,HUN,0,0,13,10,23
2004,Russian Federation,RUS,Hungary,HUN,0,5,21,21,47
2004,Serbia and Kosovo: S/RES/1244 (1999),SRB,Hungary,HUN,23,13,66,48,150
2004,Sierra Leone,SLE,Hungary,HUN,0,0,0,5,5
2004,Somalia,SOM,Hungary,HUN,5,10,0,5,20
2004,Viet Nam,VNM,Hungary,HUN,0,0,97,5,102
2004,Sudan,SDN,Hungary,HUN,0,0,5,5,10
2004,Slovakia,SVK,Hungary,HUN,0,0,12,0,12
2004,Syrian Arab Rep.,SYR,Hungary,HUN,0,11,0,0,11
2004,United Rep. of Tanzania,TZA,Hungary,HUN,0,5,0,0,5
2004,Tunisia,TUN,Hungary,HUN,0,0,5,0,5
2004,Turkey,TUR,Hungary,HUN,10,10,58,46,124
2004,Uganda,UGA,Hungary,HUN,5,0,0,0,5
2004,Ukraine,UKR,Hungary,HUN,0,10,17,12,39
2004,Stateless,XXA,Hungary,HUN,5,0,0,13,18
2004,Albania,ALB,Iceland,ISL,0,0,5,0,5
2004,Bulgaria,BGR,Iceland,ISL,0,0,5,0,5
2004,Palestinian,PSE,Iceland,ISL,0,0,0,5,5
2004,Iraq,IRQ,Iceland,ISL,0,0,0,5,5
2004,Sri Lanka,LKA,Iceland,ISL,0,0,5,5,10
2004,Rep. of Moldova,MDA,Iceland,ISL,0,0,5,0,5
2004,Nigeria,NGA,Iceland,ISL,0,0,0,5,5
2004,Russian Federation,RUS,Iceland,ISL,0,0,0,5,5
2004,Serbia and Kosovo: S/RES/1244 (1999),SRB,Iceland,ISL,0,0,5,0,5
2004,Afghanistan,AFG,Ireland,IRL,16,0,15,5,36
2004,Albania,ALB,Ireland,IRL,5,0,124,35,164
2004,Algeria,DZA,Ireland,IRL,0,0,49,19,68
2004,Angola,AGO,Ireland,IRL,11,0,40,5,56
2004,Egypt,EGY,Ireland,IRL,0,0,13,5,18
2004,Armenia,ARM,Ireland,IRL,0,0,12,0,12
2004,Azerbaijan,AZE,Ireland,IRL,5,0,5,0,10
2004,Burundi,BDI,Ireland,IRL,5,0,28,5,38
2004,Bangladesh,BGD,Ireland,IRL,0,0,0,5,5
2004,Belarus,BLR,Ireland,IRL,5,0,22,5,32
2004,Brazil,BRA,Ireland,IRL,0,0,13,0,13
2004,Bulgaria,BGR,Ireland,IRL,0,0,5,5,10
2004,China,CHN,Ireland,IRL,23,0,69,142,234
2004,Cameroon,CMR,Ireland,IRL,11,0,81,10,102
2004,Congo,COG,Ireland,IRL,0,0,11,0,11
2004,Dem. Rep. of the Congo,COD,Ireland,IRL,0,0,200,15,215
2004,Cuba,CUB,Ireland,IRL,0,0,5,0,5
2004,Czechia,CZE,Ireland,IRL,5,0,51,5,61
2004,Eritrea,ERI,Ireland,IRL,5,0,16,0,21
2004,Estonia,EST,Ireland,IRL,0,0,5,0,5
2004,Ethiopia,ETH,Ireland,IRL,0,0,13,0,13
2004,Gambia,GMB,Ireland,IRL,0,0,10,0,10
2004,Palestinian,PSE,Ireland,IRL,14,0,10,5,29
2004,United Kingdom of Great Britain and Northern Ireland,GBR,Ireland,IRL,0,0,5,0,5
2004,Georgia,GEO,Ireland,IRL,5,0,100,27,132
2004,Ghana,GHA,Ireland,IRL,0,0,92,14,106
2004,Guinea,GIN,Ireland,IRL,5,0,10,5,20
2004,Croatia,HRV,Ireland,IRL,5,0,128,21,154
2004,Cote d'Ivoire,CIV,Ireland,IRL,0,0,39,5,44
2004,India,IND,Ireland,IRL,0,0,0,13,13
2004,Iran (Islamic Rep. of),IRN,Ireland,IRL,20,0,19,5,44
2004,Iraq,IRQ,Ireland,IRL,34,0,64,93,191
2004,Israel,ISR,Ireland,IRL,0,0,23,0,23
2004,Jamaica,JAM,Ireland,IRL,0,0,10,0,10
2004,Kazakhstan,KAZ,Ireland,IRL,0,0,14,5,19
2004,Kenya,KEN,Ireland,IRL,10,0,34,10,54
2004,Kyrgyzstan,KGZ,Ireland,IRL,5,0,5,0,10
2004,Kuwait,KWT,Ireland,IRL,0,0,5,0,5
2004,Liberia,LBR,Ireland,IRL,10,0,72,15,97
2004,Lebanon,LBN,Ireland,IRL,0,0,5,5,10
2004,Lesotho,LSO,Ireland,IRL,0,0,5,0,5
2004,Sri Lanka,LKA,Ireland,IRL,5,0,0,0,5
2004,Lithuania,LTU,Ireland,IRL,0,0,10,13,23
2004,Latvia,LVA,Ireland,IRL,0,0,5,5,10
2004,Mauritania,MRT,Ireland,IRL,5,0,0,0,5
2004,North Macedonia,MKD,Ireland,IRL,0,0,5,0,5
2004,Rep. of Moldova,MDA,Ireland,IRL,5,0,85,34,124
2004,Mongolia,MNG,Ireland,IRL,0,0,0,5,5
2004,Mozambique,MOZ,Ireland,IRL,0,0,5,0,5
2004,Nepal,NPL,Ireland,IRL,0,0,5,5,10
2004,Nigeria,NGA,Ireland,IRL,18,0,2605,642,3265
2004,Pakistan,PAK,Ireland,IRL,5,0,61,5,71
2004,Poland,POL,Ireland,IRL,0,0,24,27,51
2004,Romania,ROU,Ireland,IRL,5,0,215,137,357
2004,South Africa,ZAF,Ireland,IRL,0,0,67,21,88
2004,Russian Federation,RUS,Ireland,IRL,14,0,52,26,92
2004,Rwanda,RWA,Ireland,IRL,0,0,15,5,20
2004,Serbia and Kosovo: S/RES/1244 (1999),SRB,Ireland,IRL,5,0,66,26,97
2004,Senegal,SEN,Ireland,IRL,0,0,5,0,5
2004,Sierra Leone,SLE,Ireland,IRL,0,0,15,10,25
2004,Somalia,SOM,Ireland,IRL,82,0,78,20,180
2004,Sudan,SDN,Ireland,IRL,34,0,11,11,56
2004,Slovakia,SVK,Ireland,IRL,0,0,5,5,10
2004,Syrian Arab Rep.,SYR,Ireland,IRL,5,0,5,5,15
2004,Turkmenistan,TKM,Ireland,IRL,0,0,0,5,5
2004,Togo,TGO,Ireland,IRL,0,0,35,5,40
2004,Tunisia,TUN,Ireland,IRL,0,0,5,0,5
2004,Turkey,TUR,Ireland,IRL,0,0,11,10,21
2004,Uganda,UGA,Ireland,IRL,0,0,19,5,24
2004,Ukraine,UKR,Ireland,IRL,14,0,62,15,91
2004,Uzbekistan,UZB,Ireland,IRL,0,0,0,5,5
2004,Zimbabwe,ZWE,Ireland,IRL,17,0,39,10,66
2004,Stateless,XXA,Ireland,IRL,5,0,20,5,30
2004,Burundi,BDI,Israel,ISR,0,0,0,5,5
2004,Cameroon,CMR,Israel,ISR,0,0,0,10,10
2004,Dem. Rep. of the Congo,COD,Israel,ISR,0,5,0,14,19
2004,Colombia,COL,Israel,ISR,0,0,0,14,14
2004,Eritrea,ERI,Israel,ISR,0,0,0,5,5
2004,Ethiopia,ETH,Israel,ISR,0,0,0,257,257
2004,Ghana,GHA,Israel,ISR,0,0,0,31,31
2004,Guinea,GIN,Israel,ISR,0,0,0,5,5
2004,Cote d'Ivoire,CIV,Israel,ISR,0,35,0,39,74
2004,Kenya,KEN,Israel,ISR,0,0,0,10,10
2004,Liberia,LBR,Israel,ISR,0,11,0,50,61
2004,Sri Lanka,LKA,Israel,ISR,0,0,0,13,13
2004,Mali,MLI,Israel,ISR,0,0,0,5,5
2004,Myanmar,MMR,Israel,ISR,0,0,0,5,5
2004,Nepal,NPL,Israel,ISR,0,0,0,5,5
2004,Nigeria,NGA,Israel,ISR,0,0,0,81,81
2004,Philippines,PHL,Israel,ISR,0,0,0,5,5
2004,Sierra Leone,SLE,Israel,ISR,0,0,0,20,20
2004,Sudan,SDN,Israel,ISR,0,0,0,12,12
2004,Eswatini,SWZ,Israel,ISR,0,0,0,5,5
2004,United Rep. of Tanzania,TZA,Israel,ISR,0,0,0,5,5
2004,Togo,TGO,Israel,ISR,0,0,0,19,19
2004,Turkey,TUR,Israel,ISR,0,0,0,19,19
2004,Zimbabwe,ZWE,Israel,ISR,0,0,0,10,10
2004,Bangladesh,BGD,Japan,JPN,0,0,5,5,10
2004,China,CHN,Japan,JPN,0,0,11,0,11
2004,Cameroon,CMR,Japan,JPN,0,0,5,0,5
2004,Dem. Rep. of the Congo,COD,Japan,JPN,0,0,5,0,5
2004,Colombia,COL,Japan,JPN,0,0,5,0,5
2004,Estonia,EST,Japan,JPN,0,0,5,0,5
2004,Guinea,GIN,Japan,JPN,0,0,5,0,5
2004,India,IND,Japan,JPN,0,0,13,0,13
2004,Iran (Islamic Rep. of),IRN,Japan,JPN,0,0,14,5,19
2004,Sri Lanka,LKA,Japan,JPN,0,0,5,0,5
2004,Myanmar,MMR,Japan,JPN,10,0,47,0,57
2004,Nigeria,NGA,Japan,JPN,0,0,5,0,5
2004,Pakistan,PAK,Japan,JPN,0,0,11,0,11
2004,Philippines,PHL,Japan,JPN,0,0,5,5,10
2004,Russian Federation,RUS,Japan,JPN,0,0,5,0,5
2004,Viet Nam,VNM,Japan,JPN,0,0,5,0,5
2004,Turkey,TUR,Japan,JPN,0,0,135,13,148
2004,Afghanistan,AFG,Kazakhstan,KAZ,69,0,27,0,96
2004,Afghanistan,AFG,Kyrgyzstan,KGZ,36,0,19,21,76
2004,India,IND,Kyrgyzstan,KGZ,5,0,0,0,5
2004,Iran (Islamic Rep. of),IRN,Kyrgyzstan,KGZ,5,0,0,0,5
2004,Iraq,IRQ,Kyrgyzstan,KGZ,5,0,0,0,5
2004,Sri Lanka,LKA,Kyrgyzstan,KGZ,0,0,0,5,5
2004,Russian Federation,RUS,Kyrgyzstan,KGZ,0,0,0,166,166
2004,Syrian Arab Rep.,SYR,Kyrgyzstan,KGZ,5,0,13,0,18
2004,Tajikistan,TJK,Kyrgyzstan,KGZ,23,0,0,0,23
2004,Belarus,BLR,Liechtenstein,LIE,0,0,0,11,11
2004,Bosnia and Herzegovina,BIH,Liechtenstein,LIE,0,0,0,5,5
2004,Germany,DEU,Liechtenstein,LIE,0,0,0,5,5
2004,Kazakhstan,KAZ,Liechtenstein,LIE,0,0,0,5,5
2004,North Macedonia,MKD,Liechtenstein,LIE,0,0,0,15,15
2004,Russian Federation,RUS,Liechtenstein,LIE,0,0,10,10,20
2004,Serbia and Kosovo: S/RES/1244 (1999),SRB,Liechtenstein,LIE,0,0,0,16,16
2004,Ukraine,UKR,Liechtenstein,LIE,0,0,5,5,10
2004,Afghanistan,AFG,Lithuania,LTU,0,5,0,13,18
2004,Egypt,EGY,Lithuania,LTU,0,0,0,12,12
2004,Azerbaijan,AZE,Lithuania,LTU,0,5,0,0,5
2004,Belarus,BLR,Lithuania,LTU,0,0,5,0,5
2004,Palestinian,PSE,Lithuania,LTU,0,5,5,0,10
2004,India,IND,Lithuania,LTU,0,0,0,21,21
2004,Pakistan,PAK,Lithuania,LTU,0,0,5,25,30
2004,Russian Federation,RUS,Lithuania,LTU,12,52,11,18,93
2004,Ukraine,UKR,Lithuania,LTU,0,0,0,5,5
2004,Stateless,XXA,Lithuania,LTU,0,0,5,0,5
2004,Serbia and Kosovo: S/RES/1244 (1999),SRB,North Macedonia,MKD,10,956,5,184,1155
2004,Armenia,ARM,Rep. of Moldova,MDA,5,0,0,0,5
2004,Palestinian,PSE,Rep. of Moldova,MDA,0,0,5,0,5
2004,Iraq,IRQ,Rep. of Moldova,MDA,0,0,5,0,5
2004,Russian Federation,RUS,Rep. of Moldova,MDA,0,0,5,22,27
2004,Sudan,SDN,Rep. of Moldova,MDA,0,0,0,5,5
2004,Turkey,TUR,Rep. of Moldova,MDA,0,0,0,5,5
2004,Bangladesh,BGD,Mexico,MEX,0,0,5,0,5
2004,China,CHN,Mexico,MEX,5,0,0,0,5
2004,Colombia,COL,Mexico,MEX,5,5,21,10,41
2004,Cuba,CUB,Mexico,MEX,0,0,5,18,23
2004,Eritrea,ERI,Mexico,MEX,14,0,0,0,14
2004,Ethiopia,ETH,Mexico,MEX,22,0,5,5,32
2004,Guatemala,GTM,Mexico,MEX,0,0,13,5,18
2004,Guinea,GIN,Mexico,MEX,0,0,5,0,5
2004,Haiti,HTI,Mexico,MEX,0,0,0,5,5
2004,Honduras,HND,Mexico,MEX,5,0,35,20,60
2004,India,IND,Mexico,MEX,0,0,5,0,5
2004,Liberia,LBR,Mexico,MEX,0,0,10,0,10
2004,Sri Lanka,LKA,Mexico,MEX,0,0,12,0,12
2004,Nicaragua,NIC,Mexico,MEX,0,0,5,5,10
2004,Peru,PER,Mexico,MEX,0,0,5,0,5
2004,El Salvador,SLV,Mexico,MEX,5,0,20,10,35
2004,Somalia,SOM,Mexico,MEX,12,0,0,0,12
2004,Ukraine,UKR,Mexico,MEX,0,0,5,0,5
2004,Venezuela (Bolivarian Republic of),VEN,Mexico,MEX,0,0,0,5,5
2004,Burundi,BDI,Mali,MLI,5,0,0,0,5
2004,Chad,TCD,Mali,MLI,5,0,0,0,5
2004,Congo,COG,Mali,MLI,5,0,0,0,5
2004,Dem. Rep. of the Congo,COD,Mali,MLI,18,0,0,0,18
2004,Cote d'Ivoire,CIV,Mali,MLI,743,0,0,0,743
2004,Liberia,LBR,Mali,MLI,51,0,0,0,51
2004,Mauritania,MRT,Mali,MLI,37,0,0,0,37
2004,Rwanda,RWA,Mali,MLI,5,0,0,0,5
2004,Burundi,BDI,Malawi,MWI,310,0,0,2045,2355
2004,Dem. Rep. of the Congo,COD,Malawi,MWI,316,0,5,1122,1443
2004,Rwanda,RWA,Malawi,MWI,847,0,0,5390,6237
2004,Somalia,SOM,Malawi,MWI,5,0,0,100,105
2004,Sudan,SDN,Malawi,MWI,0,0,0,5,5
2004,Algeria,DZA,Malta,MLT,0,0,12,0,12
2004,Egypt,EGY,Malta,MLT,5,0,0,5,10
2004,Bangladesh,BGD,Malta,MLT,0,0,5,0,5
2004,Dem. Rep. of the Congo,COD,Malta,MLT,0,5,40,0,45
2004,Eritrea,ERI,Malta,MLT,5,51,5,0,61
2004,Ethiopia,ETH,Malta,MLT,5,0,14,0,19
2004,Palestinian,PSE,Malta,MLT,0,0,33,0,33
2004,Cote d'Ivoire,CIV,Malta,MLT,0,0,21,0,21
2004,India,IND,Malta,MLT,0,0,10,0,10
2004,Iran (Islamic Rep. of),IRN,Malta,MLT,5,0,0,0,5
2004,Iraq,IRQ,Malta,MLT,5,5,13,0,23
2004,Kyrgyzstan,KGZ,Malta,MLT,0,0,5,0,5
2004,Liberia,LBR,Malta,MLT,0,0,10,0,10
2004,Libya,LBY,Malta,MLT,0,0,5,0,5
2004,Sri Lanka,LKA,Malta,MLT,15,0,0,0,15
2004,Morocco,MAR,Malta,MLT,11,0,0,0,11
2004,Nigeria,NGA,Malta,MLT,0,0,13,0,13
2004,Pakistan,PAK,Malta,MLT,0,0,16,0,16
2004,Russian Federation,RUS,Malta,MLT,0,0,5,0,5
2004,Serbia and Kosovo: S/RES/1244 (1999),SRB,Malta,MLT,0,0,5,0,5
2004,Sierra Leone,SLE,Malta,MLT,5,0,0,0,5
2004,Somalia,SOM,Malta,MLT,0,466,5,0,471
2004,Sudan,SDN,Malta,MLT,0,16,18,0,34
2004,Tunisia,TUN,Malta,MLT,0,0,5,0,5
2004,Turkey,TUR,Malta,MLT,0,0,25,5,30
2004,Afghanistan,AFG,Netherlands,NLD,64,393,565,184,1206
2004,Albania,ALB,Netherlands,NLD,0,5,55,14,74
2004,Algeria,DZA,Netherlands,NLD,0,0,69,25,94
2004,Angola,AGO,Netherlands,NLD,5,108,325,123,561
2004,Egypt,EGY,Netherlands,NLD,0,0,17,5,22
2004,Armenia,ARM,Netherlands,NLD,5,38,253,75,371
2004,Azerbaijan,AZE,Netherlands,NLD,22,77,323,103,525
2004,Burundi,BDI,Netherlands,NLD,14,271,116,35,436
2004,Benin,BEN,Netherlands,NLD,0,0,18,0,18
2004,Bangladesh,BGD,Netherlands,NLD,0,5,23,0,28
2004,Bhutan,BTN,Netherlands,NLD,0,0,0,5,5
2004,Burkina Faso,BFA,Netherlands,NLD,0,0,5,0,5
2004,Belarus,BLR,Netherlands,NLD,0,5,33,10,48
2004,Bosnia and Herzegovina,BIH,Netherlands,NLD,0,31,95,12,138
2004,Bulgaria,BGR,Netherlands,NLD,0,0,5,0,5
2004,Central African Rep.,CAF,Netherlands,NLD,0,0,0,5,5
2004,Chad,TCD,Netherlands,NLD,0,0,0,5,5
2004,China,CHN,Netherlands,NLD,13,20,229,114,376
2004,Cameroon,CMR,Netherlands,NLD,10,13,76,25,124
2004,Congo,COG,Netherlands,NLD,5,33,76,23,137
2004,Dem. Rep. of the Congo,COD,Netherlands,NLD,0,65,128,55,248
2004,Colombia,COL,Netherlands,NLD,5,5,122,23,155
2004,Cuba,CUB,Netherlands,NLD,0,0,10,0,10
2004,Czechia,CZE,Netherlands,NLD,0,0,17,0,17
2004,Dominican Rep.,DOM,Netherlands,NLD,0,0,5,0,5
2004,Eritrea,ERI,Netherlands,NLD,10,59,73,13,155
2004,Ethiopia,ETH,Netherlands,NLD,5,43,55,22,125
2004,France,FRA,Netherlands,NLD,0,0,5,0,5
2004,Gabon,GAB,Netherlands,NLD,0,0,5,0,5
2004,Gambia,GMB,Netherlands,NLD,0,0,16,0,16
2004,United Kingdom of Great Britain and Northern Ireland,GBR,Netherlands,NLD,0,0,0,5,5
2004,Georgia,GEO,Netherlands,NLD,5,16,65,22,108
2004,Ghana,GHA,Netherlands,NLD,0,0,14,10,24
2004,Guinea-Bissau,GNB,Netherlands,NLD,0,5,5,0,10
2004,Guinea,GIN,Netherlands,NLD,5,46,154,49,254
2004,Croatia,HRV,Netherlands,NLD,0,0,15,5,20
2004,Hungary,HUN,Netherlands,NLD,0,0,0,10,10
2004,Cote d'Ivoire,CIV,Netherlands,NLD,10,10,84,16,120
2004,India,IND,Netherlands,NLD,0,0,124,56,180
2004,Indonesia,IDN,Netherlands,NLD,0,0,5,0,5
2004,Iran (Islamic Rep. of),IRN,Netherlands,NLD,72,137,415,94,718
2004,Iraq,IRQ,Netherlands,NLD,13,1244,703,512,2472
2004,Kazakhstan,KAZ,Netherlands,NLD,0,5,22,0,27
2004,Kenya,KEN,Netherlands,NLD,0,5,5,0,10
2004,Kyrgyzstan,KGZ,Netherlands,NLD,0,0,10,0,10
2004,Dem. People's Rep. of Korea,PRK,Netherlands,NLD,0,0,5,0,5
2004,Liberia,LBR,Netherlands,NLD,0,21,143,64,228
2004,Libya,LBY,Netherlands,NLD,0,5,46,13,64
2004,Lebanon,LBN,Netherlands,NLD,0,5,25,5,35
2004,Sri Lanka,LKA,Netherlands,NLD,0,29,76,18,123
2004,Lithuania,LTU,Netherlands,NLD,0,0,5,5,10
2004,Latvia,LVA,Netherlands,NLD,0,5,0,0,5
2004,Mauritania,MRT,Netherlands,NLD,0,0,12,10,22
2004,North Macedonia,MKD,Netherlands,NLD,0,0,26,10,36
2004,Rep. of Moldova,MDA,Netherlands,NLD,0,0,35,5,40
2004,Mali,MLI,Netherlands,NLD,0,0,5,0,5
2004,Mongolia,MNG,Netherlands,NLD,0,0,80,20,100
2004,Morocco,MAR,Netherlands,NLD,0,0,25,5,30
2004,Myanmar,MMR,Netherlands,NLD,0,5,14,0,19
2004,Nepal,NPL,Netherlands,NLD,5,0,54,17,76
2004,Netherlands,NLD,Netherlands,NLD,0,0,0,12,12
2004,Niger,NER,Netherlands,NLD,0,5,20,14,39
2004,Nigeria,NGA,Netherlands,NLD,0,11,239,66,316
2004,Pakistan,PAK,Netherlands,NLD,5,5,48,11,69
2004,Poland,POL,Netherlands,NLD,0,0,0,5,5
2004,Romania,ROU,Netherlands,NLD,0,0,20,5,25
2004,South Africa,ZAF,Netherlands,NLD,0,0,5,0,5
2004,Russian Federation,RUS,Netherlands,NLD,21,81,197,55,354
2004,Rwanda,RWA,Netherlands,NLD,10,35,43,19,107
2004,Saudi Arabia,SAU,Netherlands,NLD,0,5,0,0,5
2004,Serbia and Kosovo: S/RES/1244 (1999),SRB,Netherlands,NLD,5,77,427,100,609
2004,Senegal,SEN,Netherlands,NLD,0,0,5,0,5
2004,Sierra Leone,SLE,Netherlands,NLD,0,77,288,92,457
2004,Somalia,SOM,Netherlands,NLD,36,377,323,125,861
2004,Viet Nam,VNM,Netherlands,NLD,0,5,23,5,33
2004,Sudan,SDN,Netherlands,NLD,14,108,196,60,378
2004,Suriname,SUR,Netherlands,NLD,0,0,5,0,5
2004,Slovakia,SVK,Netherlands,NLD,0,0,18,23,41
2004,Syrian Arab Rep.,SYR,Netherlands,NLD,30,101,171,48,350
2004,United Rep. of Tanzania,TZA,Netherlands,NLD,0,0,11,0,11
2004,Tajikistan,TJK,Netherlands,NLD,0,14,10,5,29
2004,Togo,TGO,Netherlands,NLD,5,25,59,22,111
2004,Tunisia,TUN,Netherlands,NLD,0,14,5,5,24
2004,Turkey,TUR,Netherlands,NLD,12,49,278,98,437
2004,Uganda,UGA,Netherlands,NLD,0,5,25,10,40
2004,Ukraine,UKR,Netherlands,NLD,0,11,28,5,44
2004,Uzbekistan,UZB,Netherlands,NLD,0,5,35,5,45
2004,Yemen,YEM,Netherlands,NLD,0,0,13,0,13
2004,Zimbabwe,ZWE,Netherlands,NLD,0,0,10,0,10
2004,Stateless,XXA,Netherlands,NLD,14,42,219,55,330
2004,Central African Rep.,CAF,Nigeria,NGA,5,0,0,0,5
2004,Cameroon,CMR,Nigeria,NGA,47,0,0,0,47
2004,Congo,COG,Nigeria,NGA,5,0,0,0,5
2004,Dem. Rep. of the Congo,COD,Nigeria,NGA,33,0,0,0,33
2004,Cote d'Ivoire,CIV,Nigeria,NGA,5,0,5,0,10
2004,Liberia,LBR,Nigeria,NGA,141,0,5,0,146
2004,Sudan,SDN,Nigeria,NGA,5,0,0,0,5
2004,Afghanistan,AFG,Norway,NOR,25,358,739,20,1142
2004,Albania,ALB,Norway,NOR,0,5,77,10,92
2004,Algeria,DZA,Norway,NOR,5,5,101,38,149
2004,Angola,AGO,Norway,NOR,5,67,37,11,120
2004,Egypt,EGY,Norway,NOR,0,0,5,5,10
2004,Armenia,ARM,Norway,NOR,0,0,21,5,26
2004,Azerbaijan,AZE,Norway,NOR,0,0,79,5,84
2004,Burundi,BDI,Norway,NOR,11,54,27,0,92
2004,Bangladesh,BGD,Norway,NOR,0,0,14,5,19
2004,Bhutan,BTN,Norway,NOR,0,5,12,0,17
2004,Belarus,BLR,Norway,NOR,0,5,50,16,71
2004,Bosnia and Herzegovina,BIH,Norway,NOR,0,5,67,51,123
2004,Bulgaria,BGR,Norway,NOR,0,0,25,5,30
2004,China,CHN,Norway,NOR,24,18,35,0,77
2004,Cameroon,CMR,Norway,NOR,0,0,66,5,71
2004,Congo,COG,Norway,NOR,0,15,5,0,20
2004,Dem. Rep. of the Congo,COD,Norway,NOR,5,24,29,10,68
2004,Colombia,COL,Norway,NOR,0,10,0,0,10
2004,Cabo Verde,CPV,Norway,NOR,0,0,5,0,5
2004,Czechia,CZE,Norway,NOR,0,0,30,0,30
2004,Ecuador,ECU,Norway,NOR,0,5,0,0,5
2004,Eritrea,ERI,Norway,NOR,12,20,10,5,47
2004,Ethiopia,ETH,Norway,NOR,27,24,96,5,152
2004,Georgia,GEO,Norway,NOR,0,0,41,10,51
2004,Ghana,GHA,Norway,NOR,0,0,13,0,13
2004,Guinea,GIN,Norway,NOR,0,5,58,5,68
2004,Croatia,HRV,Norway,NOR,0,0,23,0,23
2004,Hungary,HUN,Norway,NOR,0,0,13,0,13
2004,Cote d'Ivoire,CIV,Norway,NOR,0,0,16,5,21
2004,India,IND,Norway,NOR,0,0,5,5,10
2004,Iran (Islamic Rep. of),IRN,Norway,NOR,72,20,285,20,397
2004,Iraq,IRQ,Norway,NOR,27,434,364,92,917
2004,Israel,ISR,Norway,NOR,0,0,19,0,19
2004,Jordan,JOR,Norway,NOR,0,0,13,5,18
2004,Kazakhstan,KAZ,Norway,NOR,0,5,20,0,25
2004,Kenya,KEN,Norway,NOR,0,0,5,0,5
2004,Kyrgyzstan,KGZ,Norway,NOR,5,5,24,0,34
2004,Kuwait,KWT,Norway,NOR,0,0,5,0,5
2004,Liberia,LBR,Norway,NOR,0,22,30,5,57
2004,Libya,LBY,Norway,NOR,5,5,165,21,196
2004,Lebanon,LBN,Norway,NOR,0,5,29,5,39
2004,Sri Lanka,LKA,Norway,NOR,0,18,20,5,43
2004,Lithuania,LTU,Norway,NOR,0,0,15,5,20
2004,Mauritania,MRT,Norway,NOR,0,0,5,5,10
2004,North Macedonia,MKD,Norway,NOR,0,0,39,10,49
2004,Rep. of Moldova,MDA,Norway,NOR,0,0,24,5,29
2004,Mongolia,MNG,Norway,NOR,0,5,15,5,25
2004,Morocco,MAR,Norway,NOR,0,5,16,0,21
2004,Mozambique,MOZ,Norway,NOR,0,0,5,0,5
2004,Myanmar,MMR,Norway,NOR,0,0,5,0,5
2004,Nepal,NPL,Norway,NOR,5,0,47,0,52
2004,Niger,NER,Norway,NOR,0,0,16,5,21
2004,Nigeria,NGA,Norway,NOR,0,5,216,18,239
2004,Pakistan,PAK,Norway,NOR,5,10,43,10,68
2004,Poland,POL,Norway,NOR,0,0,5,0,5
2004,Romania,ROU,Norway,NOR,0,0,22,5,27
2004,Russian Federation,RUS,Norway,NOR,85,918,298,29,1330
2004,Rwanda,RWA,Norway,NOR,10,14,24,0,48
2004,Serbia and Kosovo: S/RES/1244 (1999),SRB,Norway,NOR,46,19,456,44,565
2004,Senegal,SEN,Norway,NOR,0,0,5,0,5
2004,Sierra Leone,SLE,Norway,NOR,0,5,24,5,34
2004,Somalia,SOM,Norway,NOR,24,801,513,49,1387
2004,Viet Nam,VNM,Norway,NOR,0,0,27,0,27
2004,Sudan,SDN,Norway,NOR,5,14,32,10,61
2004,Suriname,SUR,Norway,NOR,0,0,5,0,5
2004,Slovakia,SVK,Norway,NOR,0,0,14,0,14
2004,Syrian Arab Rep.,SYR,Norway,NOR,5,10,49,10,74
2004,Tajikistan,TJK,Norway,NOR,0,0,14,0,14
2004,Togo,TGO,Norway,NOR,5,0,12,0,17
2004,Turkey,TUR,Norway,NOR,0,17,95,19,131
2004,Uganda,UGA,Norway,NOR,0,0,12,0,12
2004,Ukraine,UKR,Norway,NOR,0,0,26,5,31
2004,Uzbekistan,UZB,Norway,NOR,0,5,29,10,44
2004,Western Sahara,ESH,Norway,NOR,0,0,14,0,14
2004,Yemen,YEM,Norway,NOR,0,0,5,5,10
2004,Zimbabwe,ZWE,Norway,NOR,0,5,0,0,5
2004,Stateless,XXA,Norway,NOR,41,63,184,47,335
2004,Bangladesh,BGD,New Zealand,NZL,0,0,33,0,33
2004,Brazil,BRA,New Zealand,NZL,0,0,11,0,11
2004,China,CHN,New Zealand,NZL,5,0,44,0,49
2004,Chile,CHL,New Zealand,NZL,0,0,20,0,20
2004,Dem. Rep. of the Congo,COD,New Zealand,NZL,0,0,5,0,5
2004,Czechia,CZE,New Zealand,NZL,0,0,15,0,15
2004,Ethiopia,ETH,New Zealand,NZL,5,0,0,0,5
2004,Fiji,FJI,New Zealand,NZL,0,0,16,0,16
2004,Hungary,HUN,New Zealand,NZL,0,0,19,0,19
2004,India,IND,New Zealand,NZL,0,0,79,0,79
2004,Iran (Islamic Rep. of),IRN,New Zealand,NZL,38,0,83,0,121
2004,Iraq,IRQ,New Zealand,NZL,0,0,16,0,16
2004,Israel,ISR,New Zealand,NZL,0,0,10,0,10
2004,Kyrgyzstan,KGZ,New Zealand,NZL,0,0,5,0,5
2004,Libya,LBY,New Zealand,NZL,5,0,0,0,5
2004,Lebanon,LBN,New Zealand,NZL,0,0,5,0,5
2004,Sri Lanka,LKA,New Zealand,NZL,0,0,26,0,26
2004,Malaysia,MYS,New Zealand,NZL,0,0,21,0,21
2004,Mongolia,MNG,New Zealand,NZL,0,0,5,0,5
2004,Nepal,NPL,New Zealand,NZL,0,0,10,0,10
2004,Pakistan,PAK,New Zealand,NZL,0,0,10,0,10
2004,South Africa,ZAF,New Zealand,NZL,0,0,17,0,17
2004,Saudi Arabia,SAU,New Zealand,NZL,0,0,10,0,10
2004,Somalia,SOM,New Zealand,NZL,5,0,5,0,10
2004,Viet Nam,VNM,New Zealand,NZL,0,0,10,0,10
2004,Syrian Arab Rep.,SYR,New Zealand,NZL,0,0,13,0,13
2004,Thailand,THA,New Zealand,NZL,0,0,36,0,36
2004,Ukraine,UKR,New Zealand,NZL,0,0,5,0,5
2004,Zimbabwe,ZWE,New Zealand,NZL,10,0,22,0,32
2004,Colombia,COL,Panama,PAN,42,0,87,37,166
2004,Cuba,CUB,Panama,PAN,5,0,11,0,16
2004,Colombia,COL,Peru,PER,49,0,5,0,54
2004,Cuba,CUB,Peru,PER,17,0,0,5,22
2004,Palestinian,PSE,Peru,PER,5,0,0,0,5
2004,Iraq,IRQ,Peru,PER,0,0,0,5,5
2004,Rwanda,RWA,Philippines,PHL,0,0,0,5,5
2004,Indonesia,IDN,Papua New Guinea,PNG,0,0,0,114,114
2004,Afghanistan,AFG,Poland,POL,0,23,121,5,149
2004,Algeria,DZA,Poland,POL,0,0,10,0,10
2004,Armenia,ARM,Poland,POL,0,5,37,0,42
2004,Azerbaijan,AZE,Poland,POL,0,0,10,0,10
2004,Bangladesh,BGD,Poland,POL,0,0,5,0,5
2004,Belarus,BLR,Poland,POL,14,5,86,17,122
2004,Bulgaria,BGR,Poland,POL,0,0,11,0,11
2004,China,CHN,Poland,POL,0,0,21,0,21
2004,Cameroon,CMR,Poland,POL,0,5,0,0,5
2004,Congo,COG,Poland,POL,0,0,5,0,5
2004,Dem. Rep. of the Congo,COD,Poland,POL,0,0,5,0,5
2004,Ethiopia,ETH,Poland,POL,0,0,5,0,5
2004,Palestinian,PSE,Poland,POL,0,0,14,0,14
2004,Georgia,GEO,Poland,POL,0,0,29,5,34
2004,India,IND,Poland,POL,0,0,186,5,191
2004,Iran (Islamic Rep. of),IRN,Poland,POL,0,0,12,0,12
2004,Iraq,IRQ,Poland,POL,0,10,28,5,43
2004,Kazakhstan,KAZ,Poland,POL,0,0,12,10,22
2004,Kyrgyzstan,KGZ,Poland,POL,0,0,19,0,19
2004,Liberia,LBR,Poland,POL,0,0,5,0,5
2004,Lebanon,LBN,Poland,POL,0,0,0,5,5
2004,Sri Lanka,LKA,Poland,POL,0,0,13,5,18
2004,Rep. of Moldova,MDA,Poland,POL,0,0,10,5,15
2004,Mongolia,MNG,Poland,POL,0,0,10,0,10
2004,Nigeria,NGA,Poland,POL,0,11,5,0,16
2004,Pakistan,PAK,Poland,POL,5,5,229,0,239
2004,Romania,ROU,Poland,POL,0,0,0,5,5
2004,Russian Federation,RUS,Poland,POL,265,734,930,2678,4607
2004,Serbia and Kosovo: S/RES/1244 (1999),SRB,Poland,POL,0,0,0,5,5
2004,Somalia,SOM,Poland,POL,10,0,24,0,34
2004,Viet Nam,VNM,Poland,POL,0,0,23,0,23
2004,Slovakia,SVK,Poland,POL,0,0,5,0,5
2004,Syrian Arab Rep.,SYR,Poland,POL,0,0,5,0,5
2004,Turkmenistan,TKM,Poland,POL,0,0,5,0,5
2004,Turkey,TUR,Poland,POL,5,10,18,0,33
2004,Ukraine,UKR,Poland,POL,0,10,72,10,92
2004,Zimbabwe,ZWE,Poland,POL,5,0,0,0,5
2004,Stateless,XXA,Poland,POL,5,5,10,0,20
2004,Armenia,ARM,Portugal,PRT,0,0,5,0,5
2004,Bulgaria,BGR,Portugal,PRT,0,0,5,0,5
2004,Cuba,CUB,Portugal,PRT,0,0,5,0,5
2004,Hungary,HUN,Portugal,PRT,0,0,5,0,5
2004,Liberia,LBR,Portugal,PRT,0,0,5,0,5
2004,Pakistan,PAK,Portugal,PRT,0,0,5,0,5
2004,Sierra Leone,SLE,Portugal,PRT,0,0,0,5,5
2004,Turkey,TUR,Portugal,PRT,0,0,5,0,5
2004,Angola,AGO,South Africa,ZAF,34,0,14,0,48
2004,Burundi,BDI,South Africa,ZAF,121,0,0,0,121
2004,Bangladesh,BGD,South Africa,ZAF,0,0,5,0,5
2004,Cameroon,CMR,South Africa,ZAF,11,0,0,0,11
2004,Congo,COG,South Africa,ZAF,58,0,5,0,63
2004,Dem. Rep. of the Congo,COD,South Africa,ZAF,660,0,42,0,702
2004,Ghana,GHA,South Africa,ZAF,0,0,5,0,5
2004,India,IND,South Africa,ZAF,0,0,5,0,5
2004,Kenya,KEN,South Africa,ZAF,0,0,20,0,20
2004,Malawi,MWI,South Africa,ZAF,0,0,17,0,17
2004,Mozambique,MOZ,South Africa,ZAF,0,0,5,0,5
2004,Nigeria,NGA,South Africa,ZAF,0,0,52,0,52
2004,Pakistan,PAK,South Africa,ZAF,0,0,29,0,29
2004,Rwanda,RWA,South Africa,ZAF,82,0,5,0,87
2004,Somalia,SOM,South Africa,ZAF,238,0,0,0,238
2004,Sudan,SDN,South Africa,ZAF,0,0,5,0,5
2004,United Rep. of Tanzania,TZA,South Africa,ZAF,5,0,39,0,44
2004,Uganda,UGA,South Africa,ZAF,15,0,5,0,20
2004,Zimbabwe,ZWE,South Africa,ZAF,24,0,69,0,93
2004,Afghanistan,AFG,Russian Federation,RUS,29,0,590,0,619
2004,Armenia,ARM,Russian Federation,RUS,0,0,5,0,5
2004,Azerbaijan,AZE,Russian Federation,RUS,0,0,11,0,11
2004,Burundi,BDI,Russian Federation,RUS,0,0,5,0,5
2004,Dem. Rep. of the Congo,COD,Russian Federation,RUS,0,0,13,0,13
2004,Ethiopia,ETH,Russian Federation,RUS,0,0,5,0,5
2004,Georgia,GEO,Russian Federation,RUS,0,0,16,0,16
2004,Iraq,IRQ,Russian Federation,RUS,5,0,14,0,19
2004,Kazakhstan,KAZ,Russian Federation,RUS,0,0,11,0,11
2004,Rwanda,RWA,Russian Federation,RUS,5,0,0,0,5
2004,Sierra Leone,SLE,Russian Federation,RUS,0,0,5,0,5
2004,Tajikistan,TJK,Russian Federation,RUS,0,0,24,0,24
2004,Turkmenistan,TKM,Russian Federation,RUS,0,0,5,0,5
2004,Ukraine,UKR,Russian Federation,RUS,0,0,5,0,5
2004,Uzbekistan,UZB,Russian Federation,RUS,0,0,61,0,61
2004,Colombia,COL,El Salvador,SLV,0,0,0,5,5
2004,Burundi,BDI,Senegal,SEN,0,0,5,0,5
2004,Central African Rep.,CAF,Senegal,SEN,0,0,10,0,10
2004,Chad,TCD,Senegal,SEN,0,0,5,0,5
2004,Congo,COG,Senegal,SEN,0,0,13,0,13
2004,Dem. Rep. of the Congo,COD,Senegal,SEN,0,0,28,0,28
2004,Gambia,GMB,Senegal,SEN,5,0,0,0,5
2004,Guinea,GIN,Senegal,SEN,14,0,5,0,19
2004,Cote d'Ivoire,CIV,Senegal,SEN,50,0,16,0,66
2004,Liberia,LBR,Senegal,SEN,41,0,15,0,56
2004,Mauritania,MRT,Senegal,SEN,0,0,35,0,35
2004,Nigeria,NGA,Senegal,SEN,0,0,5,0,5
2004,Rwanda,RWA,Senegal,SEN,0,0,11,0,11
2004,Sierra Leone,SLE,Senegal,SEN,0,0,26,0,26
2004,Togo,TGO,Senegal,SEN,0,0,5,0,5
2004,Afghanistan,AFG,Spain,ESP,0,0,33,14,47
2004,Albania,ALB,Spain,ESP,0,0,0,5,5
2004,Algeria,DZA,Spain,ESP,0,0,32,852,884
2004,Angola,AGO,Spain,ESP,0,0,16,11,27
2004,Armenia,ARM,Spain,ESP,5,13,68,43,129
2004,Azerbaijan,AZE,Spain,ESP,0,0,0,5,5
2004,Burundi,BDI,Spain,ESP,0,0,0,10,10
2004,Benin,BEN,Spain,ESP,0,0,0,32,32
2004,Bangladesh,BGD,Spain,ESP,0,0,5,13,18
2004,Burkina Faso,BFA,Spain,ESP,0,0,0,5,5
2004,Belarus,BLR,Spain,ESP,10,0,5,15,30
2004,Bolivia (Plurinational State of),BOL,Spain,ESP,0,0,0,5,5
2004,Brazil,BRA,Spain,ESP,0,0,0,10,10
2004,Bosnia and Herzegovina,BIH,Spain,ESP,0,0,0,28,28
2004,Bulgaria,BGR,Spain,ESP,0,0,0,5,5
2004,Central African Rep.,CAF,Spain,ESP,0,0,0,17,17
2004,Chad,TCD,Spain,ESP,0,0,0,16,16
2004,China,CHN,Spain,ESP,0,0,12,5,17
2004,Cameroon,CMR,Spain,ESP,5,0,36,73,114
2004,Congo,COG,Spain,ESP,5,0,0,19,24
2004,Dem. Rep. of the Congo,COD,Spain,ESP,5,0,68,179,252
2004,Colombia,COL,Spain,ESP,57,66,670,353,1146
2004,Cuba,CUB,Spain,ESP,10,10,118,42,180
2004,Dominican Rep.,DOM,Spain,ESP,0,0,0,5,5
2004,Ecuador,ECU,Spain,ESP,5,0,0,12,17
2004,Equatorial Guinea,GNQ,Spain,ESP,11,0,21,5,37
2004,Eritrea,ERI,Spain,ESP,0,0,5,0,5
2004,Ethiopia,ETH,Spain,ESP,5,0,26,22,53
2004,Gabon,GAB,Spain,ESP,0,0,0,10,10
2004,Gambia,GMB,Spain,ESP,0,0,5,94,99
2004,Georgia,GEO,Spain,ESP,5,0,21,28,54
2004,Ghana,GHA,Spain,ESP,0,0,0,101,101
2004,Guinea-Bissau,GNB,Spain,ESP,0,0,5,119,124
2004,Guinea,GIN,Spain,ESP,0,0,13,263,276
2004,Haiti,HTI,Spain,ESP,0,0,0,5,5
2004,Cote d'Ivoire,CIV,Spain,ESP,0,5,61,132,198
2004,India,IND,Spain,ESP,0,0,0,18,18
2004,Indonesia,IDN,Spain,ESP,0,0,5,0,5
2004,Iran (Islamic Rep. of),IRN,Spain,ESP,5,0,5,17,27
2004,Iraq,IRQ,Spain,ESP,5,50,68,19,142
2004,Israel,ISR,Spain,ESP,0,0,0,5,5
2004,Jordan,JOR,Spain,ESP,0,0,0,5,5
2004,Kazakhstan,KAZ,Spain,ESP,0,0,0,10,10
2004,Kenya,KEN,Spain,ESP,0,0,0,5,5
2004,Kyrgyzstan,KGZ,Spain,ESP,0,0,0,5,5
2004,Liberia,LBR,Spain,ESP,5,5,10,104,124
2004,Libya,LBY,Spain,ESP,0,0,0,5,5
2004,Lebanon,LBN,Spain,ESP,0,0,0,12,12
2004,Sri Lanka,LKA,Spain,ESP,0,0,0,15,15
2004,Latvia,LVA,Spain,ESP,0,0,5,0,5
2004,Mauritania,MRT,Spain,ESP,0,0,5,36,41
2004,North Macedonia,MKD,Spain,ESP,0,0,0,25,25
2004,Rep. of Moldova,MDA,Spain,ESP,5,0,0,0,5
2004,Mali,MLI,Spain,ESP,0,0,0,279,279
2004,Morocco,MAR,Spain,ESP,0,5,5,18,28
2004,Nepal,NPL,Spain,ESP,0,0,0,5,5
2004,Niger,NER,Spain,ESP,0,0,0,26,26
2004,Nicaragua,NIC,Spain,ESP,0,0,5,0,5
2004,Nigeria,NGA,Spain,ESP,0,5,77,1191,1273
2004,Pakistan,PAK,Spain,ESP,0,11,10,5,26
2004,Peru,PER,Spain,ESP,5,0,0,5,10
2004,Romania,ROU,Spain,ESP,0,0,5,26,31
2004,Russian Federation,RUS,Spain,ESP,28,13,49,38,128
2004,Rwanda,RWA,Spain,ESP,0,0,0,5,5
2004,Senegal,SEN,Spain,ESP,0,0,5,34,39
2004,Sierra Leone,SLE,Spain,ESP,0,0,13,108,121
2004,Somalia,SOM,Spain,ESP,0,0,62,10,72
2004,Viet Nam,VNM,Spain,ESP,0,0,0,5,5
2004,Sudan,SDN,Spain,ESP,0,0,5,22,27
2004,Syrian Arab Rep.,SYR,Spain,ESP,0,5,0,15,20
2004,Tajikistan,TJK,Spain,ESP,0,0,5,0,5
2004,Togo,TGO,Spain,ESP,0,0,0,12,12
2004,Tunisia,TUN,Spain,ESP,5,0,0,5,10
2004,Turkey,TUR,Spain,ESP,0,0,11,12,23
2004,Uganda,UGA,Spain,ESP,0,0,0,10,10
2004,Ukraine,UKR,Spain,ESP,5,0,27,29,61
2004,Uzbekistan,UZB,Spain,ESP,0,0,0,12,12
2004,Venezuela (Bolivarian Republic of),VEN,Spain,ESP,0,0,10,17,27
2004,Zimbabwe,ZWE,Spain,ESP,0,0,0,20,20
2004,Stateless,XXA,Spain,ESP,0,0,18,19,37
2004,Afghanistan,AFG,Slovakia,SVK,0,0,59,449,508
2004,Algeria,DZA,Slovakia,SVK,0,0,0,11,11
2004,Armenia,ARM,Slovakia,SVK,0,0,22,278,300
2004,Azerbaijan,AZE,Slovakia,SVK,0,0,0,15,15
2004,Bangladesh,BGD,Slovakia,SVK,0,0,109,493,602
2004,Belarus,BLR,Slovakia,SVK,0,0,5,5,10
2004,Bulgaria,BGR,Slovakia,SVK,0,0,5,5,10
2004,China,CHN,Slovakia,SVK,0,0,154,1103,1257
2004,Cuba,CUB,Slovakia,SVK,0,0,5,0,5
2004,Czechia,CZE,Slovakia,SVK,0,0,0,5,5
2004,Gambia,GMB,Slovakia,SVK,0,0,0,5,5
2004,Palestinian,PSE,Slovakia,SVK,0,0,5,110,115
2004,Georgia,GEO,Slovakia,SVK,0,0,20,1108,1128
2004,India,IND,Slovakia,SVK,0,0,564,2803,3367
2004,Iran (Islamic Rep. of),IRN,Slovakia,SVK,5,0,5,66,76
2004,Iraq,IRQ,Slovakia,SVK,0,0,5,155,160
2004,Israel,ISR,Slovakia,SVK,0,0,0,48,48
2004,Kazakhstan,KAZ,Slovakia,SVK,0,0,0,5,5
2004,Kyrgyzstan,KGZ,Slovakia,SVK,0,0,10,0,10
2004,Liberia,LBR,Slovakia,SVK,0,0,0,5,5
2004,Lebanon,LBN,Slovakia,SVK,0,0,0,19,19
2004,Sri Lanka,LKA,Slovakia,SVK,0,0,5,67,72
2004,Mauritania,MRT,Slovakia,SVK,0,0,0,5,5
2004,North Macedonia,MKD,Slovakia,SVK,0,0,16,5,21
2004,Rep. of Moldova,MDA,Slovakia,SVK,0,0,41,850,891
2004,Nepal,NPL,Slovakia,SVK,0,0,0,11,11
2004,Nigeria,NGA,Slovakia,SVK,0,0,0,5,5
2004,Pakistan,PAK,Slovakia,SVK,0,0,82,746,828
2004,Poland,POL,Slovakia,SVK,0,0,0,5,5
2004,Romania,ROU,Slovakia,SVK,0,0,0,5,5
2004,Russian Federation,RUS,Slovakia,SVK,5,0,295,2744,3044
2004,Serbia and Kosovo: S/RES/1244 (1999),SRB,Slovakia,SVK,0,0,31,28,59
2004,Senegal,SEN,Slovakia,SVK,0,0,5,13,18
2004,Somalia,SOM,Slovakia,SVK,0,0,0,11,11
2004,Viet Nam,VNM,Slovakia,SVK,0,0,24,130,154
2004,Sudan,SDN,Slovakia,SVK,0,0,0,10,10
2004,Syrian Arab Rep.,SYR,Slovakia,SVK,0,0,17,57,74
2004,Turkey,TUR,Slovakia,SVK,0,0,5,151,156
2004,Ukraine,UKR,Slovakia,SVK,0,0,22,38,60
2004,Uzbekistan,UZB,Slovakia,SVK,0,0,5,5,10
2004,Stateless,XXA,Slovakia,SVK,0,0,0,13,13
2004,Afghanistan,AFG,Slovenia,SVN,0,0,5,0,5
2004,Albania,ALB,Slovenia,SVN,0,0,31,154,185
2004,Algeria,DZA,Slovenia,SVN,0,0,0,24,24
2004,Bangladesh,BGD,Slovenia,SVN,0,0,0,11,11
2004,Bosnia and Herzegovina,BIH,Slovenia,SVN,0,0,35,41,76
2004,Bulgaria,BGR,Slovenia,SVN,0,0,5,0,5
2004,Cuba,CUB,Slovenia,SVN,0,0,0,5,5
2004,Palestinian,PSE,Slovenia,SVN,0,0,0,5,5
2004,Georgia,GEO,Slovenia,SVN,5,0,22,29,56
2004,India,IND,Slovenia,SVN,0,0,5,12,17
2004,Iran (Islamic Rep. of),IRN,Slovenia,SVN,5,0,0,5,10
2004,Iraq,IRQ,Slovenia,SVN,0,0,10,25,35
2004,Liberia,LBR,Slovenia,SVN,0,0,0,5,5
2004,Sri Lanka,LKA,Slovenia,SVN,0,0,0,12,12
2004,North Macedonia,MKD,Slovenia,SVN,0,5,31,42,78
2004,Rep. of Moldova,MDA,Slovenia,SVN,0,0,10,25,35
2004,Pakistan,PAK,Slovenia,SVN,0,0,10,5,15
2004,Romania,ROU,Slovenia,SVN,0,0,11,0,11
2004,Russian Federation,RUS,Slovenia,SVN,0,0,10,5,15
2004,Serbia and Kosovo: S/RES/1244 (1999),SRB,Slovenia,SVN,5,12,131,170,318
2004,Sierra Leone,SLE,Slovenia,SVN,0,5,0,0,5
2004,Turkey,TUR,Slovenia,SVN,0,0,20,160,180
2004,Dem. Rep. of the Congo,COD,Eswatini,SWZ,5,0,0,0,5
2004,Rwanda,RWA,Eswatini,SWZ,13,0,0,0,13
2004,Afghanistan,AFG,Sweden,SWE,16,134,820,82,1052
2004,Albania,ALB,Sweden,SWE,0,0,275,45,320
2004,Algeria,DZA,Sweden,SWE,0,0,278,75,353
2004,Angola,AGO,Sweden,SWE,0,11,100,5,116
2004,Egypt,EGY,Sweden,SWE,0,5,70,5,80
2004,Armenia,ARM,Sweden,SWE,0,22,478,35,535
2004,Azerbaijan,AZE,Sweden,SWE,19,31,1305,98,1453
2004,Burundi,BDI,Sweden,SWE,0,243,24,5,272
2004,Benin,BEN,Sweden,SWE,0,0,13,0,13
2004,Bangladesh,BGD,Sweden,SWE,0,5,148,19,172
2004,Bhutan,BTN,Sweden,SWE,0,0,0,5,5
2004,Belarus,BLR,Sweden,SWE,5,5,734,133,877
2004,Bolivia (Plurinational State of),BOL,Sweden,SWE,0,0,342,32,374
2004,Bosnia and Herzegovina,BIH,Sweden,SWE,10,33,872,66,981
2004,Bulgaria,BGR,Sweden,SWE,0,5,498,52,555
2004,Cambodia,KHM,Sweden,SWE,0,0,5,0,5
2004,Chad,TCD,Sweden,SWE,0,0,10,0,10
2004,China,CHN,Sweden,SWE,11,0,173,57,241
2004,Chile,CHL,Sweden,SWE,0,5,36,5,46
2004,Cameroon,CMR,Sweden,SWE,0,5,56,11,72
2004,Congo,COG,Sweden,SWE,0,5,12,5,22
2004,Dem. Rep. of the Congo,COD,Sweden,SWE,0,11,114,10,135
2004,Colombia,COL,Sweden,SWE,0,5,50,5,60
2004,Costa Rica,CRI,Sweden,SWE,0,0,5,0,5
2004,Cuba,CUB,Sweden,SWE,0,0,18,5,23
2004,Czechia,CZE,Sweden,SWE,0,0,0,11,11
2004,Ecuador,ECU,Sweden,SWE,0,0,63,13,76
2004,Eritrea,ERI,Sweden,SWE,16,65,382,17,480
2004,Estonia,EST,Sweden,SWE,0,0,10,0,10
2004,Ethiopia,ETH,Sweden,SWE,0,10,165,14,189
2004,Gambia,GMB,Sweden,SWE,0,0,11,0,11
2004,Georgia,GEO,Sweden,SWE,0,0,501,107,608
2004,Ghana,GHA,Sweden,SWE,0,0,30,0,30
2004,Guinea-Bissau,GNB,Sweden,SWE,0,0,5,0,5
2004,Guatemala,GTM,Sweden,SWE,0,0,5,0,5
2004,Guinea,GIN,Sweden,SWE,0,5,51,5,61
2004,Honduras,HND,Sweden,SWE,0,0,5,0,5
2004,Croatia,HRV,Sweden,SWE,0,0,107,29,136
2004,Hungary,HUN,Sweden,SWE,0,0,13,0,13
2004,Cote d'Ivoire,CIV,Sweden,SWE,0,5,50,5,60
2004,India,IND,Sweden,SWE,0,0,88,22,110
2004,Iran (Islamic Rep. of),IRN,Sweden,SWE,29,26,744,99,898
2004,Iraq,IRQ,Sweden,SWE,5,244,4495,382,5126
2004,Israel,ISR,Sweden,SWE,0,0,45,14,59
2004,Jordan,JOR,Sweden,SWE,0,0,116,33,149
2004,Japan,JPN,Sweden,SWE,0,0,5,0,5
2004,Kazakhstan,KAZ,Sweden,SWE,0,45,252,33,330
2004,Kenya,KEN,Sweden,SWE,0,5,19,0,24
2004,Kyrgyzstan,KGZ,Sweden,SWE,0,18,223,17,258
2004,Kuwait,KWT,Sweden,SWE,0,0,0,5,5
2004,Lao People's Dem. Rep.,LAO,Sweden,SWE,0,0,5,0,5
2004,Liberia,LBR,Sweden,SWE,0,0,76,10,86
2004,Libya,LBY,Sweden,SWE,0,5,357,85,447
2004,Lebanon,LBN,Sweden,SWE,0,5,367,45,417
2004,Sri Lanka,LKA,Sweden,SWE,0,0,15,5,20
2004,Lithuania,LTU,Sweden,SWE,0,0,10,12,22
2004,Latvia,LVA,Sweden,SWE,0,0,43,5,48
2004,Mauritania,MRT,Sweden,SWE,0,0,0,12,12
2004,North Macedonia,MKD,Sweden,SWE,0,0,390,66,456
2004,Rep. of Moldova,MDA,Sweden,SWE,0,5,93,36,134
2004,Malaysia,MYS,Sweden,SWE,0,0,5,0,5
2004,Mongolia,MNG,Sweden,SWE,0,0,329,38,367
2004,Morocco,MAR,Sweden,SWE,0,0,34,16,50
2004,Myanmar,MMR,Sweden,SWE,0,5,10,5,20
2004,Nepal,NPL,Sweden,SWE,0,0,32,5,37
2004,Netherlands,NLD,Sweden,SWE,0,0,5,0,5
2004,Niger,NER,Sweden,SWE,0,0,15,0,15
2004,Nicaragua,NIC,Sweden,SWE,0,0,5,0,5
2004,Nigeria,NGA,Sweden,SWE,0,0,519,67,586
2004,Pakistan,PAK,Sweden,SWE,0,0,95,24,119
2004,Peru,PER,Sweden,SWE,0,0,68,12,80
2004,Poland,POL,Sweden,SWE,0,0,12,0,12
2004,Romania,ROU,Sweden,SWE,0,0,188,35,223
2004,Russian Federation,RUS,Sweden,SWE,15,95,1204,288,1602
2004,Rwanda,RWA,Sweden,SWE,0,5,32,5,42
2004,El Salvador,SLV,Sweden,SWE,0,0,10,0,10
2004,Saudi Arabia,SAU,Sweden,SWE,0,0,24,5,29
2004,Serbia and Kosovo: S/RES/1244 (1999),SRB,Sweden,SWE,151,175,4064,569,4959
2004,Sierra Leone,SLE,Sweden,SWE,0,0,86,10,96
2004,Somalia,SOM,Sweden,SWE,58,541,2017,144,2760
2004,Viet Nam,VNM,Sweden,SWE,0,5,101,27,133
2004,Sudan,SDN,Sweden,SWE,0,17,63,11,91
2004,Slovakia,SVK,Sweden,SWE,0,0,93,42,135
2004,Sweden,SWE,Sweden,SWE,0,0,0,5,5
2004,Syrian Arab Rep.,SYR,Sweden,SWE,5,16,523,50,594
2004,United Rep. of Tanzania,TZA,Sweden,SWE,0,0,14,5,19
2004,Thailand,THA,Sweden,SWE,0,0,5,0,5
2004,Tajikistan,TJK,Sweden,SWE,0,0,51,5,56
2004,Turkmenistan,TKM,Sweden,SWE,5,5,54,5,69
2004,Togo,TGO,Sweden,SWE,0,0,19,5,24
2004,Tunisia,TUN,Sweden,SWE,0,0,62,16,78
2004,Turkey,TUR,Sweden,SWE,5,21,567,61,654
2004,Uganda,UGA,Sweden,SWE,0,0,27,0,27
2004,Ukraine,UKR,Sweden,SWE,0,10,312,56,378
2004,United States of America,USA,Sweden,SWE,0,0,14,0,14
2004,Uzbekistan,UZB,Sweden,SWE,5,50,438,39,532
2004,Venezuela (Bolivarian Republic of),VEN,Sweden,SWE,0,0,13,0,13
2004,Yemen,YEM,Sweden,SWE,0,5,52,5,62
2004,Zimbabwe,ZWE,Sweden,SWE,0,0,5,0,5
2004,Stateless,XXA,Sweden,SWE,10,378,1280,253,1921
2004,Afghanistan,AFG,Switzerland,CHE,60,205,106,41,412
2004,Albania,ALB,Switzerland,CHE,10,5,21,60,96
2004,Algeria,DZA,Switzerland,CHE,10,51,249,330,640
2004,Angola,AGO,Switzerland,CHE,0,392,345,51,788
2004,Egypt,EGY,Switzerland,CHE,0,0,10,10,20
2004,Armenia,ARM,Switzerland,CHE,0,38,265,118,421
2004,Azerbaijan,AZE,Switzerland,CHE,19,5,61,22,107
2004,Burundi,BDI,Switzerland,CHE,5,28,34,10,77
2004,Belgium,BEL,Switzerland,CHE,0,0,0,5,5
2004,Benin,BEN,Switzerland,CHE,0,0,12,15,27
2004,Bangladesh,BGD,Switzerland,CHE,0,13,184,46,243
2004,Burkina Faso,BFA,Switzerland,CHE,0,0,17,22,39
2004,Belarus,BLR,Switzerland,CHE,0,0,150,80,230
2004,Brazil,BRA,Switzerland,CHE,0,0,0,5,5
2004,Bosnia and Herzegovina,BIH,Switzerland,CHE,97,559,273,118,1047
2004,Bulgaria,BGR,Switzerland,CHE,0,0,244,370,614
2004,Cambodia,KHM,Switzerland,CHE,16,0,0,0,16
2004,Central African Rep.,CAF,Switzerland,CHE,0,0,5,0,5
2004,Chad,TCD,Switzerland,CHE,14,0,5,5,24
2004,China,CHN,Switzerland,CHE,43,85,168,37,333
2004,Cameroon,CMR,Switzerland,CHE,10,11,172,66,259
2004,Congo,COG,Switzerland,CHE,5,5,32,12,54
2004,Dem. Rep. of the Congo,COD,Switzerland,CHE,16,235,335,99,685
2004,Colombia,COL,Switzerland,CHE,12,10,5,5,32
2004,Cuba,CUB,Switzerland,CHE,0,0,13,0,13
2004,Czechia,CZE,Switzerland,CHE,0,0,0,10,10
2004,Dominican Rep.,DOM,Switzerland,CHE,0,5,0,0,5
2004,Ecuador,ECU,Switzerland,CHE,0,0,0,5,5
2004,Equatorial Guinea,GNQ,Switzerland,CHE,0,0,5,0,5
2004,Eritrea,ERI,Switzerland,CHE,5,41,218,48,312
2004,Ethiopia,ETH,Switzerland,CHE,14,37,242,55,348
2004,France,FRA,Switzerland,CHE,0,0,0,5,5
2004,Gabon,GAB,Switzerland,CHE,0,0,12,0,12
2004,Gambia,GMB,Switzerland,CHE,0,0,0,15,15
2004,Georgia,GEO,Switzerland,CHE,5,10,440,364,819
2004,Germany,DEU,Switzerland,CHE,0,0,0,5,5
2004,Ghana,GHA,Switzerland,CHE,0,0,5,11,16
2004,Guinea-Bissau,GNB,Switzerland,CHE,0,0,10,43,53
2004,Guinea,GIN,Switzerland,CHE,5,11,215,260,491
2004,Croatia,HRV,Switzerland,CHE,0,5,10,13,28
2004,Hungary,HUN,Switzerland,CHE,0,0,0,12,12
2004,Cote d'Ivoire,CIV,Switzerland,CHE,14,13,101,91,219
2004,India,IND,Switzerland,CHE,5,5,28,54,92
2004,Iran (Islamic Rep. of),IRN,Switzerland,CHE,43,75,260,76,454
2004,Iraq,IRQ,Switzerland,CHE,175,147,366,431,1119
2004,Israel,ISR,Switzerland,CHE,0,0,0,14,14
2004,Jordan,JOR,Switzerland,CHE,0,0,11,0,11
2004,Kazakhstan,KAZ,Switzerland,CHE,0,5,43,10,58
2004,Kenya,KEN,Switzerland,CHE,0,5,11,0,16
2004,Kyrgyzstan,KGZ,Switzerland,CHE,0,0,15,12,27
2004,Rep. of Korea,KOR,Switzerland,CHE,0,0,0,5,5
2004,Liberia,LBR,Switzerland,CHE,5,5,12,49,71
2004,Libya,LBY,Switzerland,CHE,34,0,42,33,109
2004,Lebanon,LBN,Switzerland,CHE,0,0,15,58,73
2004,Sri Lanka,LKA,Switzerland,CHE,55,148,182,84,469
2004,Lithuania,LTU,Switzerland,CHE,0,0,5,34,39
2004,Latvia,LVA,Switzerland,CHE,0,0,0,11,11
2004,Madagascar,MDG,Switzerland,CHE,0,0,11,0,11
2004,Mauritania,MRT,Switzerland,CHE,0,0,10,19,29
2004,North Macedonia,MKD,Switzerland,CHE,0,38,108,134,280
2004,Rep. of Moldova,MDA,Switzerland,CHE,0,0,76,96,172
2004,Mali,MLI,Switzerland,CHE,0,0,67,58,125
2004,Mongolia,MNG,Switzerland,CHE,0,5,70,81,156
2004,Morocco,MAR,Switzerland,CHE,0,0,5,30,35
2004,Mozambique,MOZ,Switzerland,CHE,0,5,0,0,5
2004,Myanmar,MMR,Switzerland,CHE,0,0,5,0,5
2004,Nepal,NPL,Switzerland,CHE,0,0,22,13,35
2004,Niger,NER,Switzerland,CHE,0,0,15,10,25
2004,Nigeria,NGA,Switzerland,CHE,0,11,272,249,532
2004,Pakistan,PAK,Switzerland,CHE,0,24,298,100,422
2004,Peru,PER,Switzerland,CHE,0,5,0,0,5
2004,Poland,POL,Switzerland,CHE,0,0,0,11,11
2004,Romania,ROU,Switzerland,CHE,0,5,34,182,221
2004,South Africa,ZAF,Switzerland,CHE,0,0,0,14,14
2004,Russian Federation,RUS,Switzerland,CHE,37,81,394,261,773
2004,Rwanda,RWA,Switzerland,CHE,23,5,15,5,48
2004,Serbia and Kosovo: S/RES/1244 (1999),SRB,Switzerland,CHE,85,1134,1383,848,3450
2004,Senegal,SEN,Switzerland,CHE,0,0,5,15,20
2004,Sierra Leone,SLE,Switzerland,CHE,5,5,32,64,106
2004,Somalia,SOM,Switzerland,CHE,10,510,471,68,1059
2004,Viet Nam,VNM,Switzerland,CHE,35,5,16,0,56
2004,Sudan,SDN,Switzerland,CHE,5,5,69,47,126
2004,Suriname,SUR,Switzerland,CHE,0,0,5,0,5
2004,Slovakia,SVK,Switzerland,CHE,0,0,14,68,82
2004,Slovenia,SVN,Switzerland,CHE,0,0,0,5,5
2004,Syrian Arab Rep.,SYR,Switzerland,CHE,11,20,89,84,204
2004,United Rep. of Tanzania,TZA,Switzerland,CHE,0,0,5,0,5
2004,Tajikistan,TJK,Switzerland,CHE,0,0,5,5,10
2004,Turkmenistan,TKM,Switzerland,CHE,0,0,0,5,5
2004,Togo,TGO,Switzerland,CHE,69,5,118,31,223
2004,Tunisia,TUN,Switzerland,CHE,74,0,22,38,134
2004,Turkey,TUR,Switzerland,CHE,496,144,938,314,1892
2004,Uganda,UGA,Switzerland,CHE,0,0,13,0,13
2004,Ukraine,UKR,Switzerland,CHE,0,5,95,50,150
2004,United States of America,USA,Switzerland,CHE,0,0,0,5,5
2004,Uzbekistan,UZB,Switzerland,CHE,0,0,34,24,58
2004,Western Sahara,ESH,Switzerland,CHE,0,0,11,0,11
2004,Yemen,YEM,Switzerland,CHE,10,5,41,5,61
2004,Zimbabwe,ZWE,Switzerland,CHE,0,0,5,18,23
2004,Stateless,XXA,Switzerland,CHE,11,22,348,1219,1600
2004,Rwanda,RWA,United Rep. of Tanzania,TZA,183,0,0,0,183
2004,Burundi,BDI,Uganda,UGA,127,0,0,10,137
2004,Chad,TCD,Uganda,UGA,0,0,0,5,5
2004,Dem. Rep. of the Congo,COD,Uganda,UGA,1702,0,0,48,1750
2004,Eritrea,ERI,Uganda,UGA,5,0,5,0,10
2004,Ethiopia,ETH,Uganda,UGA,53,0,55,36,144
2004,Pakistan,PAK,Uganda,UGA,5,0,0,0,5
2004,Rwanda,RWA,Uganda,UGA,147,0,11,23,181
2004,Somalia,SOM,Uganda,UGA,243,0,51,65,359
2004,Sudan,SDN,Uganda,UGA,116,0,0,29,145
2004,Afghanistan,AFG,Ukraine,UKR,49,0,25,183,257
2004,Algeria,DZA,Ukraine,UKR,0,0,0,5,5
2004,Armenia,ARM,Ukraine,UKR,0,0,14,16,30
2004,Azerbaijan,AZE,Ukraine,UKR,5,0,0,17,22
2004,Bangladesh,BGD,Ukraine,UKR,0,0,0,124,124
2004,China,CHN,Ukraine,UKR,0,0,0,12,12
2004,Dem. Rep. of the Congo,COD,Ukraine,UKR,0,0,0,18,18
2004,Cuba,CUB,Ukraine,UKR,0,0,0,5,5
2004,Ethiopia,ETH,Ukraine,UKR,0,0,0,27,27
2004,Palestinian,PSE,Ukraine,UKR,0,0,10,35,45
2004,Georgia,GEO,Ukraine,UKR,0,0,11,14,25
2004,Ghana,GHA,Ukraine,UKR,0,0,0,5,5
2004,Guinea-Bissau,GNB,Ukraine,UKR,0,0,0,5,5
2004,India,IND,Ukraine,UKR,0,0,0,82,82
2004,Iran (Islamic Rep. of),IRN,Ukraine,UKR,0,0,5,46,51
2004,Iraq,IRQ,Ukraine,UKR,5,0,42,30,77
2004,Jordan,JOR,Ukraine,UKR,0,0,0,5,5
2004,Kyrgyzstan,KGZ,Ukraine,UKR,0,0,0,5,5
2004,Liberia,LBR,Ukraine,UKR,0,0,0,10,10
2004,Lebanon,LBN,Ukraine,UKR,0,0,0,10,10
2004,Sri Lanka,LKA,Ukraine,UKR,0,0,0,19,19
2004,Nigeria,NGA,Ukraine,UKR,0,0,0,33,33
2004,Pakistan,PAK,Ukraine,UKR,0,0,0,142,142
2004,Russian Federation,RUS,Ukraine,UKR,5,0,10,100,115
2004,Sierra Leone,SLE,Ukraine,UKR,0,0,0,5,5
2004,Somalia,SOM,Ukraine,UKR,5,0,5,20,30
2004,Sudan,SDN,Ukraine,UKR,0,0,12,0,12
2004,Syrian Arab Rep.,SYR,Ukraine,UKR,5,0,5,12,22
2004,Tajikistan,TJK,Ukraine,UKR,0,0,0,10,10
2004,Turkey,TUR,Ukraine,UKR,0,0,5,0,5
2004,Uzbekistan,UZB,Ukraine,UKR,0,0,0,5,5
2004,Stateless,XXA,Ukraine,UKR,5,0,0,0,5
2004,Colombia,COL,Venezuela (Bolivarian Republic of),VEN,206,0,188,241,635
2004,Guyana,GUY,Venezuela (Bolivarian Republic of),VEN,5,0,0,0,5
2004,Liberia,LBR,Venezuela (Bolivarian Republic of),VEN,5,0,0,0,5
2004,Burundi,BDI,Zimbabwe,ZWE,350,0,0,0,350
2004,Dem. Rep. of the Congo,COD,Zimbabwe,ZWE,413,0,0,0,413
2004,Rwanda,RWA,Zimbabwe,ZWE,197,0,0,0,197
2005,Serbia and Kosovo: S/RES/1244 (1999),SRB,Albania,ALB,10,0,0,5,15
2005,Cameroon,CMR,Algeria,DZA,0,0,5,0,5
2005,Congo,COG,Algeria,DZA,0,0,5,0,5
2005,Dem. Rep. of the Congo,COD,Algeria,DZA,0,0,21,0,21
2005,Cote d'Ivoire,CIV,Algeria,DZA,0,0,10,0,10
2005,Liberia,LBR,Algeria,DZA,0,0,17,0,17
2005,Albania,ALB,Argentina,ARG,5,0,0,0,5
2005,Armenia,ARM,Argentina,ARG,24,0,5,10,39
2005,Bangladesh,BGD,Argentina,ARG,0,0,0,15,15
2005,Bolivia (Plurinational State of),BOL,Argentina,ARG,0,0,5,0,5
2005,Dem. Rep. of the Congo,COD,Argentina,ARG,5,0,0,0,5
2005,Colombia,COL,Argentina,ARG,12,0,5,10,27
2005,Cuba,CUB,Argentina,ARG,29,0,5,31,65
2005,Ecuador,ECU,Argentina,ARG,0,0,0,5,5
2005,Haiti,HTI,Argentina,ARG,5,0,0,19,24
2005,India,IND,Argentina,ARG,0,0,0,11,11
2005,Kazakhstan,KAZ,Argentina,ARG,10,0,0,0,10
2005,Liberia,LBR,Argentina,ARG,5,0,0,0,5
2005,Nigeria,NGA,Argentina,ARG,0,0,0,11,11
2005,Pakistan,PAK,Argentina,ARG,5,0,0,0,5
2005,Peru,PER,Argentina,ARG,33,0,65,139,237
2005,Romania,ROU,Argentina,ARG,0,0,10,0,10
2005,Russian Federation,RUS,Argentina,ARG,5,0,0,0,5
2005,Senegal,SEN,Argentina,ARG,5,0,31,10,46
2005,Sierra Leone,SLE,Argentina,ARG,5,0,0,11,16
2005,Ukraine,UKR,Argentina,ARG,0,0,0,13,13
2005,Iran (Islamic Rep. of),IRN,Armenia,ARM,0,0,5,5,10
2005,Iraq,IRQ,Armenia,ARM,0,90,0,25,115
2005,Turkey,TUR,Armenia,ARM,0,0,5,0,5
2005,Afghanistan,AFG,Australia,AUS,44,0,30,0,74
2005,Albania,ALB,Australia,AUS,0,0,5,0,5
2005,Egypt,EGY,Australia,AUS,12,0,66,0,78
2005,Bahrain,BHR,Australia,AUS,0,0,5,0,5
2005,Bangladesh,BGD,Australia,AUS,10,0,71,0,81
2005,Bhutan,BTN,Australia,AUS,0,0,5,0,5
2005,Brazil,BRA,Australia,AUS,0,0,14,0,14
2005,Cambodia,KHM,Australia,AUS,5,0,0,0,5
2005,China,CHN,Australia,AUS,27,0,983,15,1025
2005,Congo,COG,Australia,AUS,5,0,0,0,5
2005,Dem. Rep. of the Congo,COD,Australia,AUS,0,0,5,0,5
2005,Colombia,COL,Australia,AUS,13,0,5,0,18
2005,Eritrea,ERI,Australia,AUS,10,0,0,0,10
2005,Ethiopia,ETH,Australia,AUS,17,0,10,0,27
2005,Fiji,FJI,Australia,AUS,0,0,47,0,47
2005,Palestinian,PSE,Australia,AUS,11,0,5,0,16
2005,United Kingdom of Great Britain and Northern Ireland,GBR,Australia,AUS,0,0,11,0,11
2005,Germany,DEU,Australia,AUS,0,0,5,0,5
2005,Greece,GRC,Australia,AUS,0,0,5,0,5
2005,"China, Hong Kong SAR",HKG,Australia,AUS,0,0,13,0,13
2005,Hungary,HUN,Australia,AUS,0,0,5,0,5
2005,India,IND,Australia,AUS,0,0,187,5,192
2005,Indonesia,IDN,Australia,AUS,28,0,138,0,166
2005,Iran (Islamic Rep. of),IRN,Australia,AUS,77,0,28,0,105
2005,Iraq,IRQ,Australia,AUS,66,0,10,0,76
2005,Israel,ISR,Australia,AUS,5,0,10,0,15
2005,Italy,ITA,Australia,AUS,0,0,5,0,5
2005,Jordan,JOR,Australia,AUS,0,0,15,0,15
2005,Japan,JPN,Australia,AUS,0,0,10,0,10
2005,Kenya,KEN,Australia,AUS,0,0,5,0,5
2005,Kyrgyzstan,KGZ,Australia,AUS,0,0,5,0,5
2005,Rep. of Korea,KOR,Australia,AUS,0,0,80,5,85
2005,Dem. People's Rep. of Korea,PRK,Australia,AUS,0,0,5,0,5
2005,Liberia,LBR,Australia,AUS,0,0,5,0,5
2005,Lebanon,LBN,Australia,AUS,0,0,42,5,47
2005,Sri Lanka,LKA,Australia,AUS,131,0,164,5,300
2005,Malaysia,MYS,Australia,AUS,0,0,154,10,164
2005,Mongolia,MNG,Australia,AUS,0,0,40,5,45
2005,Morocco,MAR,Australia,AUS,5,0,0,0,5
2005,Myanmar,MMR,Australia,AUS,18,0,26,0,44
2005,Nepal,NPL,Australia,AUS,5,0,60,0,65
2005,Nigeria,NGA,Australia,AUS,5,0,20,0,25
2005,Pakistan,PAK,Australia,AUS,21,0,81,0,102
2005,Philippines,PHL,Australia,AUS,0,0,66,0,66
2005,Papua New Guinea,PNG,Australia,AUS,5,0,11,0,16
2005,Poland,POL,Australia,AUS,0,0,5,0,5
2005,Russian Federation,RUS,Australia,AUS,0,0,31,0,31
2005,El Salvador,SLV,Australia,AUS,0,0,5,0,5
2005,Saudi Arabia,SAU,Australia,AUS,10,0,0,0,10
2005,Serbia and Kosovo: S/RES/1244 (1999),SRB,Australia,AUS,10,0,10,0,20
2005,Singapore,SGP,Australia,AUS,0,0,5,0,5
2005,Sierra Leone,SLE,Australia,AUS,0,0,10,0,10
2005,Viet Nam,VNM,Australia,AUS,0,0,28,0,28
2005,Sudan,SDN,Australia,AUS,0,0,12,0,12
2005,Syrian Arab Rep.,SYR,Australia,AUS,0,0,5,0,5
2005,Thailand,THA,Australia,AUS,0,0,58,5,63
2005,Turkey,TUR,Australia,AUS,5,0,48,0,53
2005,Uganda,UGA,Australia,AUS,5,0,0,0,5
2005,Ukraine,UKR,Australia,AUS,0,0,5,0,5
2005,United States of America,USA,Australia,AUS,0,0,5,0,5
2005,Samoa,WSM,Australia,AUS,0,0,10,0,10
2005,Zambia,ZMB,Australia,AUS,0,0,10,0,10
2005,Zimbabwe,ZWE,Australia,AUS,13,0,17,0,30
2005,Stateless,XXA,Australia,AUS,0,0,13,0,13
2005,Afghanistan,AFG,Azerbaijan,AZE,0,0,283,5,288
2005,Iran (Islamic Rep. of),IRN,Azerbaijan,AZE,29,0,31,0,60
2005,Iraq,IRQ,Azerbaijan,AZE,0,0,25,0,25
2005,Kazakhstan,KAZ,Azerbaijan,AZE,0,0,5,0,5
2005,Nigeria,NGA,Azerbaijan,AZE,0,0,5,0,5
2005,Pakistan,PAK,Azerbaijan,AZE,0,0,33,0,33
2005,Russian Federation,RUS,Azerbaijan,AZE,0,0,5,0,5
2005,Syrian Arab Rep.,SYR,Azerbaijan,AZE,0,0,5,0,5
2005,Dem. Rep. of the Congo,COD,Burundi,BDI,763,0,28,0,791
2005,Afghanistan,AFG,Belgium,BEL,10,0,18,0,28
2005,Albania,ALB,Belgium,BEL,26,0,73,131,230
2005,Algeria,DZA,Belgium,BEL,0,0,37,10,47
2005,Angola,AGO,Belgium,BEL,18,0,181,40,239
2005,Egypt,EGY,Belgium,BEL,0,0,5,0,5
2005,Armenia,ARM,Belgium,BEL,10,0,0,124,134
2005,Azerbaijan,AZE,Belgium,BEL,12,0,60,28,100
2005,Burundi,BDI,Belgium,BEL,96,0,179,70,345
2005,Benin,BEN,Belgium,BEL,0,0,13,0,13
2005,Bangladesh,BGD,Belgium,BEL,0,0,17,5,22
2005,Bhutan,BTN,Belgium,BEL,0,0,18,43,61
2005,Burkina Faso,BFA,Belgium,BEL,0,0,11,0,11
2005,Belarus,BLR,Belgium,BEL,43,0,66,69,178
2005,Bosnia and Herzegovina,BIH,Belgium,BEL,10,0,15,26,51
2005,Bulgaria,BGR,Belgium,BEL,0,0,24,5,29
2005,Cambodia,KHM,Belgium,BEL,0,0,5,0,5
2005,Central African Rep.,CAF,Belgium,BEL,0,0,5,11,16
2005,Chad,TCD,Belgium,BEL,0,0,5,19,24
2005,China,CHN,Belgium,BEL,66,0,219,14,299
2005,Cameroon,CMR,Belgium,BEL,33,0,603,64,700
2005,Congo,COG,Belgium,BEL,5,0,21,22,48
2005,Dem. Rep. of the Congo,COD,Belgium,BEL,205,0,956,305,1466
2005,Colombia,COL,Belgium,BEL,13,0,11,5,29
2005,Cuba,CUB,Belgium,BEL,0,0,0,5,5
2005,Djibouti,DJI,Belgium,BEL,27,0,68,40,135
2005,Eritrea,ERI,Belgium,BEL,5,0,0,12,17
2005,Ethiopia,ETH,Belgium,BEL,23,0,22,18,63
2005,Gabon,GAB,Belgium,BEL,0,0,5,0,5
2005,Georgia,GEO,Belgium,BEL,0,0,44,31,75
2005,Ghana,GHA,Belgium,BEL,0,0,0,5,5
2005,Guinea-Bissau,GNB,Belgium,BEL,0,0,0,5,5
2005,Guinea,GIN,Belgium,BEL,48,0,281,56,385
2005,Croatia,HRV,Belgium,BEL,5,0,0,5,10
2005,Cote d'Ivoire,CIV,Belgium,BEL,40,0,118,42,200
2005,India,IND,Belgium,BEL,0,0,13,0,13
2005,Iran (Islamic Rep. of),IRN,Belgium,BEL,112,0,462,135,709
2005,Iraq,IRQ,Belgium,BEL,63,0,407,199,669
2005,Israel,ISR,Belgium,BEL,5,0,33,12,50
2005,Jordan,JOR,Belgium,BEL,0,0,0,5,5
2005,Kazakhstan,KAZ,Belgium,BEL,5,0,15,55,75
2005,Kenya,KEN,Belgium,BEL,0,0,0,5,5
2005,Kyrgyzstan,KGZ,Belgium,BEL,13,0,11,46,70
2005,Dem. People's Rep. of Korea,PRK,Belgium,BEL,5,0,0,0,5
2005,Liberia,LBR,Belgium,BEL,0,0,5,5,10
2005,Libya,LBY,Belgium,BEL,0,0,10,0,10
2005,Lebanon,LBN,Belgium,BEL,5,0,65,20,90
2005,Sri Lanka,LKA,Belgium,BEL,0,0,5,13,18
2005,Latvia,LVA,Belgium,BEL,0,0,5,0,5
2005,Madagascar,MDG,Belgium,BEL,5,0,5,0,10
2005,Mauritania,MRT,Belgium,BEL,41,0,137,65,243
2005,North Macedonia,MKD,Belgium,BEL,5,0,27,5,37
2005,Rep. of Moldova,MDA,Belgium,BEL,0,0,5,5,10
2005,Mongolia,MNG,Belgium,BEL,0,0,0,5,5
2005,Morocco,MAR,Belgium,BEL,0,0,5,5,10
2005,Myanmar,MMR,Belgium,BEL,0,0,5,14,19
2005,Nepal,NPL,Belgium,BEL,14,0,326,50,390
2005,Niger,NER,Belgium,BEL,0,0,101,39,140
2005,Nigeria,NGA,Belgium,BEL,5,0,31,5,41
2005,Pakistan,PAK,Belgium,BEL,12,0,71,23,106
2005,Peru,PER,Belgium,BEL,0,0,0,5,5
2005,Romania,ROU,Belgium,BEL,14,0,5,0,19
2005,Russian Federation,RUS,Belgium,BEL,1256,0,488,225,1969
2005,Rwanda,RWA,Belgium,BEL,444,0,276,45,765
2005,Serbia and Kosovo: S/RES/1244 (1999),SRB,Belgium,BEL,166,0,185,362,713
2005,Senegal,SEN,Belgium,BEL,0,0,11,0,11
2005,Sierra Leone,SLE,Belgium,BEL,5,0,20,75,100
2005,Somalia,SOM,Belgium,BEL,22,0,37,57,116
2005,Viet Nam,VNM,Belgium,BEL,0,0,5,0,5
2005,Sudan,SDN,Belgium,BEL,31,0,69,26,126
2005,Slovakia,SVK,Belgium,BEL,0,0,5,0,5
2005,Syrian Arab Rep.,SYR,Belgium,BEL,26,0,73,37,136
2005,United Rep. of Tanzania,TZA,Belgium,BEL,5,0,0,0,5
2005,Tajikistan,TJK,Belgium,BEL,5,0,0,0,5
2005,Togo,TGO,Belgium,BEL,63,0,555,74,692
2005,Tunisia,TUN,Belgium,BEL,5,0,0,0,5
2005,Turkey,TUR,Belgium,BEL,21,0,193,40,254
2005,Uganda,UGA,Belgium,BEL,0,0,5,0,5
2005,Ukraine,UKR,Belgium,BEL,0,0,27,36,63
2005,Uzbekistan,UZB,Belgium,BEL,5,0,37,72,114
2005,Yemen,YEM,Belgium,BEL,0,0,5,0,5
2005,Stateless,XXA,Belgium,BEL,0,0,5,5,10
2005,Angola,AGO,Benin,BEN,5,0,0,0,5
2005,Central African Rep.,CAF,Benin,BEN,0,0,5,0,5
2005,Chad,TCD,Benin,BEN,10,0,0,0,10
2005,Congo,COG,Benin,BEN,5,0,0,0,5
2005,Dem. Rep. of the Congo,COD,Benin,BEN,22,0,5,0,27
2005,Cote d'Ivoire,CIV,Benin,BEN,11,0,0,0,11
2005,Nigeria,NGA,Benin,BEN,5,0,0,11,16
2005,Rwanda,RWA,Benin,BEN,0,0,0,5,5
2005,Togo,TGO,Benin,BEN,34,0,11,5,50
2005,Burundi,BDI,Burkina Faso,BFA,5,0,0,0,5
2005,Central African Rep.,CAF,Burkina Faso,BFA,0,0,5,0,5
2005,Chad,TCD,Burkina Faso,BFA,5,0,5,0,10
2005,Congo,COG,Burkina Faso,BFA,12,0,13,0,25
2005,Dem. Rep. of the Congo,COD,Burkina Faso,BFA,14,0,0,0,14
2005,Togo,TGO,Burkina Faso,BFA,5,0,12,0,17
2005,Afghanistan,AFG,Belarus,BLR,11,5,66,16,98
2005,Armenia,ARM,Belarus,BLR,0,0,10,0,10
2005,Azerbaijan,AZE,Belarus,BLR,5,0,5,0,10
2005,Ethiopia,ETH,Belarus,BLR,0,0,10,0,10
2005,Georgia,GEO,Belarus,BLR,19,0,24,5,48
2005,Iraq,IRQ,Belarus,BLR,0,0,5,0,5
2005,Kyrgyzstan,KGZ,Belarus,BLR,0,0,0,5,5
2005,Sudan,SDN,Belarus,BLR,0,0,5,0,5
2005,Syrian Arab Rep.,SYR,Belarus,BLR,0,0,5,0,5
2005,Tajikistan,TJK,Belarus,BLR,11,0,0,0,11
2005,Turkmenistan,TKM,Belarus,BLR,0,0,5,0,5
2005,Ukraine,UKR,Belarus,BLR,0,0,0,5,5
2005,Uzbekistan,UZB,Belarus,BLR,0,0,0,5,5
2005,Afghanistan,AFG,Bolivia (Plurinational State of),BOL,5,0,0,0,5
2005,Colombia,COL,Bolivia (Plurinational State of),BOL,5,0,5,17,27
2005,Ecuador,ECU,Bolivia (Plurinational State of),BOL,0,0,0,5,5
2005,Peru,PER,Bolivia (Plurinational State of),BOL,0,0,0,5,5
2005,Angola,AGO,Botswana,BWA,0,0,0,386,386
2005,Burundi,BDI,Botswana,BWA,0,0,0,5,5
2005,Dem. Rep. of the Congo,COD,Botswana,BWA,10,0,0,75,85
2005,Eritrea,ERI,Botswana,BWA,0,0,0,5,5
2005,Ethiopia,ETH,Botswana,BWA,0,0,0,20,20
2005,Kenya,KEN,Botswana,BWA,0,0,0,5,5
2005,Namibia,NAM,Botswana,BWA,0,0,0,141,141
2005,Rwanda,RWA,Botswana,BWA,0,0,0,18,18
2005,Somalia,SOM,Botswana,BWA,0,0,0,173,173
2005,Sudan,SDN,Botswana,BWA,0,0,0,19,19
2005,Uganda,UGA,Botswana,BWA,0,0,0,47,47
2005,Zimbabwe,ZWE,Botswana,BWA,10,0,5,63,78
2005,Afghanistan,AFG,Bulgaria,BGR,0,22,143,255,420
2005,Algeria,DZA,Bulgaria,BGR,0,0,10,0,10
2005,Armenia,ARM,Bulgaria,BGR,5,0,46,37,88
2005,Bangladesh,BGD,Bulgaria,BGR,0,5,12,5,22
2005,China,CHN,Bulgaria,BGR,0,0,5,0,5
2005,Congo,COG,Bulgaria,BGR,0,5,0,0,5
2005,Dem. Rep. of the Congo,COD,Bulgaria,BGR,0,0,0,5,5
2005,Cuba,CUB,Bulgaria,BGR,0,0,0,10,10
2005,India,IND,Bulgaria,BGR,0,0,40,36,76
2005,Iran (Islamic Rep. of),IRN,Bulgaria,BGR,0,5,10,15,30
2005,Iraq,IRQ,Bulgaria,BGR,0,25,0,25,50
2005,Kazakhstan,KAZ,Bulgaria,BGR,0,0,5,0,5
2005,Lebanon,LBN,Bulgaria,BGR,0,0,5,0,5
2005,Rep. of Moldova,MDA,Bulgaria,BGR,0,0,5,0,5
2005,Nigeria,NGA,Bulgaria,BGR,0,0,19,5,24
2005,Pakistan,PAK,Bulgaria,BGR,0,0,10,34,44
2005,Russian Federation,RUS,Bulgaria,BGR,0,0,13,0,13
2005,Somalia,SOM,Bulgaria,BGR,0,14,0,0,14
2005,Viet Nam,VNM,Bulgaria,BGR,0,0,0,5,5
2005,Syrian Arab Rep.,SYR,Bulgaria,BGR,0,0,13,5,18
2005,United Rep. of Tanzania,TZA,Bulgaria,BGR,0,0,0,5,5
2005,Turkey,TUR,Bulgaria,BGR,0,5,14,0,19
2005,Ukraine,UKR,Bulgaria,BGR,0,0,5,0,5
2005,Stateless,XXA,Bulgaria,BGR,0,0,32,20,52
2005,Cuba,CUB,Belize,BLZ,0,0,0,5,5
2005,Haiti,HTI,Belize,BLZ,0,0,0,12,12
2005,Afghanistan,AFG,Canada,CAN,138,0,27,22,187
2005,Albania,ALB,Canada,CAN,204,0,160,63,427
2005,Algeria,DZA,Canada,CAN,30,0,27,5,62
2005,Angola,AGO,Canada,CAN,19,0,24,5,48
2005,Antigua and Barbuda,ATG,Canada,CAN,0,0,13,0,13
2005,Egypt,EGY,Canada,CAN,68,0,73,12,153
2005,Argentina,ARG,Canada,CAN,10,0,51,17,78
2005,Armenia,ARM,Canada,CAN,26,0,13,5,44
2005,Australia,AUS,Canada,CAN,0,0,5,0,5
2005,Azerbaijan,AZE,Canada,CAN,82,0,5,0,87
2005,Barbados,BRB,Canada,CAN,0,0,12,5,17
2005,Burundi,BDI,Canada,CAN,150,0,39,5,194
2005,Benin,BEN,Canada,CAN,5,0,0,0,5
2005,Bangladesh,BGD,Canada,CAN,201,0,195,24,420
2005,Burkina Faso,BFA,Canada,CAN,0,0,5,0,5
2005,Belarus,BLR,Canada,CAN,27,0,5,5,37
2005,Bolivia (Plurinational State of),BOL,Canada,CAN,28,0,28,0,56
2005,Botswana,BWA,Canada,CAN,0,0,5,0,5
2005,Brazil,BRA,Canada,CAN,21,0,106,32,159
2005,Bosnia and Herzegovina,BIH,Canada,CAN,12,0,0,5,17
2005,Bulgaria,BGR,Canada,CAN,70,0,30,26,126
2005,Belize,BLZ,Canada,CAN,0,0,5,0,5
2005,Cambodia,KHM,Canada,CAN,18,0,12,0,30
2005,Central African Rep.,CAF,Canada,CAN,5,0,0,0,5
2005,Chad,TCD,Canada,CAN,39,0,16,5,60
2005,China,CHN,Canada,CAN,837,0,682,234,1753
2005,Chile,CHL,Canada,CAN,20,0,77,16,113
2005,Cameroon,CMR,Canada,CAN,79,0,31,5,115
2005,Congo,COG,Canada,CAN,21,0,14,0,35
2005,Dem. Rep. of the Congo,COD,Canada,CAN,214,0,97,39,350
2005,Colombia,COL,Canada,CAN,2595,0,557,119,3271
2005,Costa Rica,CRI,Canada,CAN,57,0,211,64,332
2005,Cuba,CUB,Canada,CAN,115,0,22,29,166
2005,Czechia,CZE,Canada,CAN,0,0,5,14,19
2005,Djibouti,DJI,Canada,CAN,17,0,5,0,22
2005,Dominica,DMA,Canada,CAN,12,0,30,29,71
2005,Dominican Rep.,DOM,Canada,CAN,0,0,10,5,15
2005,Ecuador,ECU,Canada,CAN,38,0,109,24,171
2005,Equatorial Guinea,GNQ,Canada,CAN,5,0,0,0,5
2005,Eritrea,ERI,Canada,CAN,161,0,10,5,176
2005,Estonia,EST,Canada,CAN,5,0,0,0,5
2005,Ethiopia,ETH,Canada,CAN,174,0,46,10,230
2005,Fiji,FJI,Canada,CAN,11,0,14,0,25
2005,France,FRA,Canada,CAN,0,0,14,5,19
2005,Gabon,GAB,Canada,CAN,11,0,0,0,11
2005,Gambia,GMB,Canada,CAN,0,0,5,0,5
2005,Palestinian,PSE,Canada,CAN,62,0,23,13,98
2005,Georgia,GEO,Canada,CAN,44,0,10,0,54
2005,Germany,DEU,Canada,CAN,0,0,5,13,18
2005,Ghana,GHA,Canada,CAN,19,0,60,10,89
2005,Guinea-Bissau,GNB,Canada,CAN,11,0,0,0,11
2005,Greece,GRC,Canada,CAN,5,0,5,0,10
2005,Grenada,GRD,Canada,CAN,28,0,92,14,134
2005,Guatemala,GTM,Canada,CAN,86,0,132,32,250
2005,Guinea,GIN,Canada,CAN,89,0,36,5,130
2005,Guyana,GUY,Canada,CAN,67,0,260,43,370
2005,Haiti,HTI,Canada,CAN,107,0,68,10,185
2005,Honduras,HND,Canada,CAN,51,0,134,100,285
2005,Croatia,HRV,Canada,CAN,13,0,5,5,23
2005,Hungary,HUN,Canada,CAN,51,0,267,64,382
2005,Cote d'Ivoire,CIV,Canada,CAN,40,0,17,5,62
2005,India,IND,Canada,CAN,282,0,608,241,1131
2005,Indonesia,IDN,Canada,CAN,73,0,98,10,181
2005,Ireland,IRL,Canada,CAN,0,0,5,0,5
2005,Iran (Islamic Rep. of),IRN,Canada,CAN,280,0,53,38,371
2005,Iraq,IRQ,Canada,CAN,96,0,11,15,122
2005,Israel,ISR,Canada,CAN,151,0,269,71,491
2005,Italy,ITA,Canada,CAN,0,0,10,0,10
2005,Jamaica,JAM,Canada,CAN,32,0,98,20,150
2005,Jordan,JOR,Canada,CAN,50,0,35,16,101
2005,Japan,JPN,Canada,CAN,0,0,5,0,5
2005,Kazakhstan,KAZ,Canada,CAN,14,0,5,0,19
2005,Kenya,KEN,Canada,CAN,65,0,115,20,200
2005,Kyrgyzstan,KGZ,Canada,CAN,12,0,0,0,12
2005,Rep. of Korea,KOR,Canada,CAN,23,0,147,49,219
2005,Kuwait,KWT,Canada,CAN,18,0,5,0,23
2005,Liberia,LBR,Canada,CAN,15,0,19,0,34
2005,Libya,LBY,Canada,CAN,22,0,5,0,27
2005,Saint Lucia,LCA,Canada,CAN,40,0,115,13,168
2005,Lebanon,LBN,Canada,CAN,130,0,139,26,295
2005,Sri Lanka,LKA,Canada,CAN,500,0,215,36,751
2005,Lithuania,LTU,Canada,CAN,15,0,5,5,25
2005,Latvia,LVA,Canada,CAN,0,0,12,0,12
2005,Mauritania,MRT,Canada,CAN,45,0,23,5,73
2005,North Macedonia,MKD,Canada,CAN,19,0,18,5,42
2005,Rep. of Moldova,MDA,Canada,CAN,13,0,10,0,23
2005,Mexico,MEX,Canada,CAN,697,0,2286,696,3679
2005,Mali,MLI,Canada,CAN,11,0,5,0,16
2005,Malaysia,MYS,Canada,CAN,12,0,67,10,89
2005,Malawi,MWI,Canada,CAN,0,0,5,0,5
2005,Mongolia,MNG,Canada,CAN,15,0,0,0,15
2005,Morocco,MAR,Canada,CAN,16,0,12,5,33
2005,Mauritius,MUS,Canada,CAN,0,0,5,0,5
2005,Myanmar,MMR,Canada,CAN,41,0,0,0,41
2005,Namibia,NAM,Canada,CAN,0,0,12,0,12
2005,Nepal,NPL,Canada,CAN,68,0,5,5,78
2005,Netherlands,NLD,Canada,CAN,0,0,10,5,15
2005,Niger,NER,Canada,CAN,13,0,5,0,18
2005,Nicaragua,NIC,Canada,CAN,12,0,16,0,28
2005,Nigeria,NGA,Canada,CAN,332,0,409,65,806
2005,Norway,NOR,Canada,CAN,0,0,5,0,5
2005,Pakistan,PAK,Canada,CAN,695,0,842,207,1744
2005,Panama,PAN,Canada,CAN,5,0,17,0,22
2005,Paraguay,PRY,Canada,CAN,11,0,5,0,16
2005,Peru,PER,Canada,CAN,228,0,315,38,581
2005,Philippines,PHL,Canada,CAN,25,0,162,10,197
2005,Poland,POL,Canada,CAN,20,0,75,10,105
2005,Portugal,PRT,Canada,CAN,0,0,184,32,216
2005,Romania,ROU,Canada,CAN,84,0,57,19,160
2005,South Africa,ZAF,Canada,CAN,5,0,17,0,22
2005,Russian Federation,RUS,Canada,CAN,145,0,60,27,232
2005,Rwanda,RWA,Canada,CAN,92,0,23,0,115
2005,El Salvador,SLV,Canada,CAN,109,0,181,43,333
2005,Saudi Arabia,SAU,Canada,CAN,13,0,5,0,18
2005,Serbia and Kosovo: S/RES/1244 (1999),SRB,Canada,CAN,46,0,62,21,129
2005,Senegal,SEN,Canada,CAN,12,0,10,0,22
2005,Seychelles,SYC,Canada,CAN,5,0,5,0,10
2005,Singapore,SGP,Canada,CAN,0,0,5,0,5
2005,Sierra Leone,SLE,Canada,CAN,17,0,19,0,36
2005,Somalia,SOM,Canada,CAN,319,0,10,52,381
2005,Spain,ESP,Canada,CAN,0,0,5,0,5
2005,Viet Nam,VNM,Canada,CAN,12,0,33,13,58
2005,Sudan,SDN,Canada,CAN,49,0,14,5,68
2005,Suriname,SUR,Canada,CAN,0,0,11,0,11
2005,Slovakia,SVK,Canada,CAN,0,0,12,5,17
2005,Slovenia,SVN,Canada,CAN,0,0,0,5,5
2005,Eswatini,SWZ,Canada,CAN,0,0,5,0,5
2005,Syrian Arab Rep.,SYR,Canada,CAN,50,0,37,5,92
2005,United Rep. of Tanzania,TZA,Canada,CAN,13,0,15,5,33
2005,Thailand,THA,Canada,CAN,5,0,5,0,10
2005,Tajikistan,TJK,Canada,CAN,5,0,0,0,5
2005,Turkmenistan,TKM,Canada,CAN,10,0,0,0,10
2005,Togo,TGO,Canada,CAN,20,0,11,0,31
2005,Trinidad and Tobago,TTO,Canada,CAN,21,0,110,22,153
2005,Tunisia,TUN,Canada,CAN,30,0,10,5,45
2005,Turkey,TUR,Canada,CAN,174,0,90,40,304
2005,Uganda,UGA,Canada,CAN,40,0,26,0,66
2005,Ukraine,UKR,Canada,CAN,136,0,73,41,250
2005,Uruguay,URY,Canada,CAN,20,0,57,12,89
2005,United States of America,USA,Canada,CAN,0,0,135,97,232
2005,Uzbekistan,UZB,Canada,CAN,25,0,5,0,30
2005,Saint Vincent and the Grenadines,VCT,Canada,CAN,103,0,152,21,276
2005,Venezuela (Bolivarian Republic of),VEN,Canada,CAN,102,0,147,16,265
2005,Yemen,YEM,Canada,CAN,27,0,14,5,46
2005,Zambia,ZMB,Canada,CAN,0,0,12,0,12
2005,Zimbabwe,ZWE,Canada,CAN,100,0,23,5,128
2005,Stateless,XXA,Canada,CAN,0,0,0,5,5
2005,Angola,AGO,Central African Rep.,CAF,5,0,0,0,5
2005,Chad,TCD,Central African Rep.,CAF,75,0,12,0,87
2005,Congo,COG,Central African Rep.,CAF,14,0,0,0,14
2005,Dem. Rep. of the Congo,COD,Central African Rep.,CAF,419,0,41,5,465
2005,Cote d'Ivoire,CIV,Central African Rep.,CAF,15,0,0,5,20
2005,Liberia,LBR,Central African Rep.,CAF,5,0,5,12,22
2005,Mali,MLI,Central African Rep.,CAF,10,0,0,0,10
2005,Rwanda,RWA,Central African Rep.,CAF,23,0,0,0,23
2005,Sierra Leone,SLE,Central African Rep.,CAF,5,0,0,0,5
2005,Sudan,SDN,Central African Rep.,CAF,416,0,11,0,427
2005,Togo,TGO,Central African Rep.,CAF,5,0,0,0,5
2005,Colombia,COL,Chile,CHL,217,0,79,36,332
2005,Cuba,CUB,Chile,CHL,0,0,5,0,5
2005,Ecuador,ECU,Chile,CHL,5,0,0,0,5
2005,Peru,PER,Chile,CHL,0,0,0,5,5
2005,Sierra Leone,SLE,Chile,CHL,0,0,5,0,5
2005,Venezuela (Bolivarian Republic of),VEN,Chile,CHL,5,0,0,0,5
2005,Cuba,CUB,Colombia,COL,22,0,10,0,32
2005,Ecuador,ECU,Colombia,COL,0,0,10,0,10
2005,Venezuela (Bolivarian Republic of),VEN,Colombia,COL,5,0,10,0,15
2005,Afghanistan,AFG,Cyprus,CYP,0,0,12,27,39
2005,Egypt,EGY,Cyprus,CYP,0,0,11,12,23
2005,Armenia,ARM,Cyprus,CYP,0,13,0,0,13
2005,Bangladesh,BGD,Cyprus,CYP,0,0,1327,383,1710
2005,Burkina Faso,BFA,Cyprus,CYP,0,0,5,0,5
2005,Belarus,BLR,Cyprus,CYP,0,0,13,0,13
2005,Bosnia and Herzegovina,BIH,Cyprus,CYP,0,0,5,0,5
2005,Bulgaria,BGR,Cyprus,CYP,0,0,0,14,14
2005,China,CHN,Cyprus,CYP,0,0,87,194,281
2005,Cameroon,CMR,Cyprus,CYP,0,0,5,0,5
2005,Dem. Rep. of the Congo,COD,Cyprus,CYP,0,0,14,0,14
2005,Ethiopia,ETH,Cyprus,CYP,5,0,0,0,5
2005,Gambia,GMB,Cyprus,CYP,0,0,5,0,5
2005,Palestinian,PSE,Cyprus,CYP,0,26,11,42,79
2005,Georgia,GEO,Cyprus,CYP,0,5,353,187,545
2005,Cote d'Ivoire,CIV,Cyprus,CYP,0,0,12,0,12
2005,India,IND,Cyprus,CYP,0,0,141,185,326
2005,Indonesia,IDN,Cyprus,CYP,0,0,0,5,5
2005,Iran (Islamic Rep. of),IRN,Cyprus,CYP,13,29,299,308,649
2005,Iraq,IRQ,Cyprus,CYP,10,0,0,61,71
2005,Jordan,JOR,Cyprus,CYP,0,0,0,13,13
2005,Kazakhstan,KAZ,Cyprus,CYP,0,0,5,0,5
2005,Lebanon,LBN,Cyprus,CYP,0,5,5,26,36
2005,Sri Lanka,LKA,Cyprus,CYP,0,0,207,399,606
2005,Rep. of Moldova,MDA,Cyprus,CYP,0,5,26,22,53
2005,Nepal,NPL,Cyprus,CYP,0,0,0,5,5
2005,Nigeria,NGA,Cyprus,CYP,0,0,13,0,13
2005,Pakistan,PAK,Cyprus,CYP,0,0,223,198,421
2005,Philippines,PHL,Cyprus,CYP,0,0,0,5,5
2005,Romania,ROU,Cyprus,CYP,0,0,0,11,11
2005,Russian Federation,RUS,Cyprus,CYP,5,5,82,47,139
2005,Serbia and Kosovo: S/RES/1244 (1999),SRB,Cyprus,CYP,0,5,0,0,5
2005,Senegal,SEN,Cyprus,CYP,0,0,5,0,5
2005,Syrian Arab Rep.,SYR,Cyprus,CYP,5,15,64,121,205
2005,Turkey,TUR,Cyprus,CYP,10,0,44,40,94
2005,Ukraine,UKR,Cyprus,CYP,0,10,145,185,340
2005,Uzbekistan,UZB,Cyprus,CYP,0,5,0,5,10
2005,Afghanistan,AFG,Czechia,CZE,5,0,0,11,16
2005,Algeria,DZA,Czechia,CZE,0,0,54,5,59
2005,Armenia,ARM,Czechia,CZE,19,0,47,14,80
2005,Azerbaijan,AZE,Czechia,CZE,0,0,0,5,5
2005,Belarus,BLR,Czechia,CZE,47,0,95,72,214
2005,Bosnia and Herzegovina,BIH,Czechia,CZE,0,0,0,5,5
2005,Bulgaria,BGR,Czechia,CZE,0,0,40,12,52
2005,China,CHN,Czechia,CZE,5,0,268,50,323
2005,Georgia,GEO,Czechia,CZE,5,0,38,14,57
2005,Ghana,GHA,Czechia,CZE,0,0,5,0,5
2005,Guinea,GIN,Czechia,CZE,5,0,5,0,10
2005,Cote d'Ivoire,CIV,Czechia,CZE,0,0,12,0,12
2005,India,IND,Czechia,CZE,0,0,221,57,278
2005,Iran (Islamic Rep. of),IRN,Czechia,CZE,5,0,0,5,10
2005,Iraq,IRQ,Czechia,CZE,0,0,5,34,39
2005,Kazakhstan,KAZ,Czechia,CZE,18,0,18,0,36
2005,Kyrgyzstan,KGZ,Czechia,CZE,5,0,40,27,72
2005,Sri Lanka,LKA,Czechia,CZE,0,0,5,0,5
2005,North Macedonia,MKD,Czechia,CZE,0,0,13,0,13
2005,Rep. of Moldova,MDA,Czechia,CZE,5,0,65,11,81
2005,Mongolia,MNG,Czechia,CZE,0,0,131,5,136
2005,Nigeria,NGA,Czechia,CZE,0,0,70,20,90
2005,Pakistan,PAK,Czechia,CZE,0,0,11,0,11
2005,Romania,ROU,Czechia,CZE,0,0,54,5,59
2005,Russian Federation,RUS,Czechia,CZE,69,0,153,167,389
2005,Serbia and Kosovo: S/RES/1244 (1999),SRB,Czechia,CZE,5,0,0,0,5
2005,Senegal,SEN,Czechia,CZE,0,0,5,0,5
2005,Somalia,SOM,Czechia,CZE,0,0,0,5,5
2005,Viet Nam,VNM,Czechia,CZE,0,0,192,35,227
2005,Slovakia,SVK,Czechia,CZE,0,0,0,730,730
2005,Syrian Arab Rep.,SYR,Czechia,CZE,0,0,10,0,10
2005,Turkey,TUR,Czechia,CZE,5,0,5,16,26
2005,Ukraine,UKR,Czechia,CZE,10,0,986,82,1078
2005,Uzbekistan,UZB,Czechia,CZE,18,0,0,18,36
2005,Stateless,XXA,Czechia,CZE,0,0,0,53,53
2005,Afghanistan,AFG,Denmark,DNK,5,25,135,0,165
2005,Albania,ALB,Denmark,DNK,0,0,12,0,12
2005,Burundi,BDI,Denmark,DNK,0,5,10,0,15
2005,Belgium,BEL,Denmark,DNK,0,0,5,0,5
2005,Bosnia and Herzegovina,BIH,Denmark,DNK,0,0,22,0,22
2005,Bulgaria,BGR,Denmark,DNK,0,0,5,0,5
2005,China,CHN,Denmark,DNK,0,0,18,0,18
2005,Cameroon,CMR,Denmark,DNK,0,0,5,0,5
2005,Dem. Rep. of the Congo,COD,Denmark,DNK,0,5,5,0,10
2005,Ethiopia,ETH,Denmark,DNK,0,0,5,0,5
2005,Palestinian,PSE,Denmark,DNK,10,0,55,0,65
2005,Ghana,GHA,Denmark,DNK,0,0,5,0,5
2005,Guinea,GIN,Denmark,DNK,0,0,10,0,10
2005,Croatia,HRV,Denmark,DNK,0,0,5,0,5
2005,Cote d'Ivoire,CIV,Denmark,DNK,0,0,5,0,5
2005,India,IND,Denmark,DNK,0,0,14,0,14
2005,Iran (Islamic Rep. of),IRN,Denmark,DNK,14,14,61,0,89
2005,Iraq,IRQ,Denmark,DNK,5,5,118,0,128
2005,Libya,LBY,Denmark,DNK,0,0,10,0,10
2005,Lebanon,LBN,Denmark,DNK,0,5,5,0,10
2005,Sri Lanka,LKA,Denmark,DNK,0,0,12,0,12
2005,Lithuania,LTU,Denmark,DNK,0,0,5,0,5
2005,Latvia,LVA,Denmark,DNK,0,0,5,0,5
2005,North Macedonia,MKD,Denmark,DNK,0,0,12,0,12
2005,Rep. of Moldova,MDA,Denmark,DNK,0,0,11,0,11
2005,Myanmar,MMR,Denmark,DNK,5,0,0,0,5
2005,Nepal,NPL,Denmark,DNK,0,0,5,0,5
2005,Nigeria,NGA,Denmark,DNK,0,0,28,0,28
2005,Romania,ROU,Denmark,DNK,0,0,5,0,5
2005,Russian Federation,RUS,Denmark,DNK,5,65,14,0,84
2005,Rwanda,RWA,Denmark,DNK,0,0,5,0,5
2005,Serbia and Kosovo: S/RES/1244 (1999),SRB,Denmark,DNK,0,0,316,0,316
2005,Somalia,SOM,Denmark,DNK,0,5,40,0,45
2005,Viet Nam,VNM,Denmark,DNK,0,0,5,0,5
2005,Sudan,SDN,Denmark,DNK,0,5,11,0,16
2005,Syrian Arab Rep.,SYR,Denmark,DNK,21,0,20,0,41
2005,Tunisia,TUN,Denmark,DNK,0,0,5,0,5
2005,Turkey,TUR,Denmark,DNK,0,0,16,0,16
2005,Uganda,UGA,Denmark,DNK,0,0,5,0,5
2005,Ukraine,UKR,Denmark,DNK,0,0,5,0,5
2005,Uzbekistan,UZB,Denmark,DNK,0,0,5,0,5
2005,Stateless,XXA,Denmark,DNK,16,0,5,0,21
2005,Afghanistan,AFG,France,FRA,23,0,108,0,131
2005,Albania,ALB,France,FRA,22,0,389,0,411
2005,Algeria,DZA,France,FRA,86,0,1803,0,1889
2005,Angola,AGO,France,FRA,71,0,976,0,1047
2005,Egypt,EGY,France,FRA,0,0,20,0,20
2005,Armenia,ARM,France,FRA,29,0,1175,0,1204
2005,Azerbaijan,AZE,France,FRA,43,0,546,0,589
2005,Burundi,BDI,France,FRA,23,0,59,0,82
2005,Bangladesh,BGD,France,FRA,20,0,1091,0,1111
2005,Belarus,BLR,France,FRA,11,0,208,0,219
2005,Brazil,BRA,France,FRA,0,0,12,0,12
2005,Bosnia and Herzegovina,BIH,France,FRA,588,0,1910,0,2498
2005,Cambodia,KHM,France,FRA,5,0,85,0,90
2005,Central African Rep.,CAF,France,FRA,36,0,165,0,201
2005,Chad,TCD,France,FRA,37,0,188,0,225
2005,China,CHN,France,FRA,31,0,2904,0,2935
2005,Cameroon,CMR,France,FRA,34,0,433,0,467
2005,Congo,COG,France,FRA,138,0,1331,0,1469
2005,Dem. Rep. of the Congo,COD,France,FRA,265,0,3617,0,3882
2005,Comoros,COM,France,FRA,5,0,106,0,111
2005,Colombia,COL,France,FRA,20,0,39,0,59
2005,Cuba,CUB,France,FRA,13,0,13,0,26
2005,Cabo Verde,CPV,France,FRA,0,0,10,0,10
2005,Djibouti,DJI,France,FRA,0,0,15,0,15
2005,Dominican Rep.,DOM,France,FRA,0,0,97,0,97
2005,Eritrea,ERI,France,FRA,28,0,17,0,45
2005,Ethiopia,ETH,France,FRA,15,0,26,0,41
2005,Palestinian,PSE,France,FRA,0,0,61,0,61
2005,Georgia,GEO,France,FRA,17,0,1306,0,1323
2005,Guinea-Bissau,GNB,France,FRA,17,0,107,0,124
2005,Guinea,GIN,France,FRA,95,0,1122,0,1217
2005,Haiti,HTI,France,FRA,208,0,3447,0,3655
2005,Cote d'Ivoire,CIV,France,FRA,198,0,1027,0,1225
2005,India,IND,France,FRA,5,0,619,0,624
2005,Iran (Islamic Rep. of),IRN,France,FRA,18,0,67,0,85
2005,Iraq,IRQ,France,FRA,22,0,115,0,137
2005,Kazakhstan,KAZ,France,FRA,5,0,85,0,90
2005,Kenya,KEN,France,FRA,0,0,13,0,13
2005,Kyrgyzstan,KGZ,France,FRA,0,0,57,0,57
2005,Liberia,LBR,France,FRA,0,0,142,0,142
2005,Lebanon,LBN,France,FRA,5,0,16,0,21
2005,Sri Lanka,LKA,France,FRA,131,0,2558,0,2689
2005,Madagascar,MDG,France,FRA,31,0,253,0,284
2005,Mauritania,MRT,France,FRA,64,0,1501,0,1565
2005,North Macedonia,MKD,France,FRA,0,0,193,0,193
2005,Rep. of Moldova,MDA,France,FRA,13,0,2345,0,2358
2005,Mali,MLI,France,FRA,5,0,588,0,593
2005,Mongolia,MNG,France,FRA,10,0,514,0,524
2005,Morocco,MAR,France,FRA,0,0,49,0,49
2005,Myanmar,MMR,France,FRA,5,0,15,0,20
2005,Nepal,NPL,France,FRA,5,0,27,0,32
2005,Niger,NER,France,FRA,5,0,24,0,29
2005,Nigeria,NGA,France,FRA,20,0,1499,0,1519
2005,Pakistan,PAK,France,FRA,19,0,531,0,550
2005,Peru,PER,France,FRA,5,0,22,0,27
2005,Philippines,PHL,France,FRA,0,0,5,0,5
2005,Russian Federation,RUS,France,FRA,683,0,1568,0,2251
2005,Rwanda,RWA,France,FRA,188,0,213,0,401
2005,Serbia and Kosovo: S/RES/1244 (1999),SRB,France,FRA,333,0,2348,0,2681
2005,Senegal,SEN,France,FRA,0,0,124,0,124
2005,Sierra Leone,SLE,France,FRA,14,0,220,0,234
2005,Somalia,SOM,France,FRA,21,0,102,0,123
2005,Viet Nam,VNM,France,FRA,10,0,22,0,32
2005,Sudan,SDN,France,FRA,92,0,280,0,372
2005,Syrian Arab Rep.,SYR,France,FRA,5,0,35,0,40
2005,Thailand,THA,France,FRA,0,0,11,0,11
2005,Togo,TGO,France,FRA,41,0,293,0,334
2005,Tunisia,TUN,France,FRA,10,0,20,0,30
2005,Turkey,TUR,France,FRA,198,0,4796,0,4994
2005,Ukraine,UKR,France,FRA,5,0,567,0,572
2005,Uzbekistan,UZB,France,FRA,5,0,34,0,39
2005,Venezuela (Bolivarian Republic of),VEN,France,FRA,0,0,5,0,5
2005,Zimbabwe,ZWE,France,FRA,0,0,14,0,14
2005,Stateless,XXA,France,FRA,79,0,121,0,200
2005,Afghanistan,AFG,United Kingdom of Great Britain and Northern Ireland,GBR,44,499,916,272,1731
2005,Albania,ALB,United Kingdom of Great Britain and Northern Ireland,GBR,0,32,161,23,216
2005,Algeria,DZA,United Kingdom of Great Britain and Northern Ireland,GBR,10,28,263,57,358
2005,Angola,AGO,United Kingdom of Great Britain and Northern Ireland,GBR,10,43,202,25,280
2005,Egypt,EGY,United Kingdom of Great Britain and Northern Ireland,GBR,0,0,58,5,63
2005,Argentina,ARG,United Kingdom of Great Britain and Northern Ireland,GBR,0,0,5,0,5
2005,Armenia,ARM,United Kingdom of Great Britain and Northern Ireland,GBR,5,0,29,5,39
2005,Azerbaijan,AZE,United Kingdom of Great Britain and Northern Ireland,GBR,10,0,70,5,85
2005,Burundi,BDI,United Kingdom of Great Britain and Northern Ireland,GBR,13,33,116,10,172
2005,Benin,BEN,United Kingdom of Great Britain and Northern Ireland,GBR,0,0,12,0,12
2005,Bangladesh,BGD,United Kingdom of Great Britain and Northern Ireland,GBR,5,143,254,32,434
2005,Bhutan,BTN,United Kingdom of Great Britain and Northern Ireland,GBR,0,0,14,5,19
2005,Burkina Faso,BFA,United Kingdom of Great Britain and Northern Ireland,GBR,0,0,10,0,10
2005,Belarus,BLR,United Kingdom of Great Britain and Northern Ireland,GBR,10,0,68,5,83
2005,Bolivia (Plurinational State of),BOL,United Kingdom of Great Britain and Northern Ireland,GBR,0,5,22,0,27
2005,Botswana,BWA,United Kingdom of Great Britain and Northern Ireland,GBR,0,0,5,0,5
2005,Brazil,BRA,United Kingdom of Great Britain and Northern Ireland,GBR,0,0,5,5,10
2005,Bosnia and Herzegovina,BIH,United Kingdom of Great Britain and Northern Ireland,GBR,11,0,26,45,82
2005,Bulgaria,BGR,United Kingdom of Great Britain and Northern Ireland,GBR,0,5,5,0,10
2005,Central African Rep.,CAF,United Kingdom of Great Britain and Northern Ireland,GBR,0,0,0,5,5
2005,Chad,TCD,United Kingdom of Great Britain and Northern Ireland,GBR,5,5,10,0,20
2005,China,CHN,United Kingdom of Great Britain and Northern Ireland,GBR,12,77,1312,419,1820
2005,Cameroon,CMR,United Kingdom of Great Britain and Northern Ireland,GBR,26,34,238,25,323
2005,Congo,COG,United Kingdom of Great Britain and Northern Ireland,GBR,11,10,81,10,112
2005,Dem. Rep. of the Congo,COD,United Kingdom of Great Britain and Northern Ireland,GBR,94,160,1154,100,1508
2005,Colombia,COL,United Kingdom of Great Britain and Northern Ireland,GBR,10,0,82,5,97
2005,Cuba,CUB,United Kingdom of Great Britain and Northern Ireland,GBR,0,0,15,0,15
2005,Cyprus,CYP,United Kingdom of Great Britain and Northern Ireland,GBR,0,0,5,0,5
2005,Czechia,CZE,United Kingdom of Great Britain and Northern Ireland,GBR,0,0,5,0,5
2005,Ecuador,ECU,United Kingdom of Great Britain and Northern Ireland,GBR,0,0,30,5,35
2005,Equatorial Guinea,GNQ,United Kingdom of Great Britain and Northern Ireland,GBR,0,0,0,5,5
2005,Eritrea,ERI,United Kingdom of Great Britain and Northern Ireland,GBR,601,137,798,281,1817
2005,Ethiopia,ETH,United Kingdom of Great Britain and Northern Ireland,GBR,12,39,339,46,436
2005,Gambia,GMB,United Kingdom of Great Britain and Northern Ireland,GBR,0,5,81,16,102
2005,Palestinian,PSE,United Kingdom of Great Britain and Northern Ireland,GBR,5,25,388,113,531
2005,Georgia,GEO,United Kingdom of Great Britain and Northern Ireland,GBR,5,0,96,26,127
2005,Ghana,GHA,United Kingdom of Great Britain and Northern Ireland,GBR,5,14,185,17,221
2005,Guinea,GIN,United Kingdom of Great Britain and Northern Ireland,GBR,5,58,120,15,198
2005,Guyana,GUY,United Kingdom of Great Britain and Northern Ireland,GBR,0,0,5,0,5
2005,Haiti,HTI,United Kingdom of Great Britain and Northern Ireland,GBR,0,0,5,0,5
2005,"China, Hong Kong SAR",HKG,United Kingdom of Great Britain and Northern Ireland,GBR,0,0,0,5,5
2005,Croatia,HRV,United Kingdom of Great Britain and Northern Ireland,GBR,5,0,28,0,33
2005,Hungary,HUN,United Kingdom of Great Britain and Northern Ireland,GBR,0,0,5,0,5
2005,Cote d'Ivoire,CIV,United Kingdom of Great Britain and Northern Ireland,GBR,23,19,170,19,231
2005,India,IND,United Kingdom of Great Britain and Northern Ireland,GBR,0,21,795,180,996
2005,Indonesia,IDN,United Kingdom of Great Britain and Northern Ireland,GBR,0,0,5,0,5
2005,Iran (Islamic Rep. of),IRN,United Kingdom of Great Britain and Northern Ireland,GBR,90,390,2846,393,3719
2005,Iraq,IRQ,United Kingdom of Great Britain and Northern Ireland,GBR,5,179,1583,307,2074
2005,Israel,ISR,United Kingdom of Great Britain and Northern Ireland,GBR,0,0,75,0,75
2005,Jamaica,JAM,United Kingdom of Great Britain and Northern Ireland,GBR,0,17,351,10,378
2005,Jordan,JOR,United Kingdom of Great Britain and Northern Ireland,GBR,0,0,12,0,12
2005,Kazakhstan,KAZ,United Kingdom of Great Britain and Northern Ireland,GBR,0,0,11,0,11
2005,Kenya,KEN,United Kingdom of Great Britain and Northern Ireland,GBR,0,14,100,13,127
2005,Kyrgyzstan,KGZ,United Kingdom of Great Britain and Northern Ireland,GBR,0,0,5,0,5
2005,Dem. People's Rep. of Korea,PRK,United Kingdom of Great Britain and Northern Ireland,GBR,5,12,11,5,33
2005,Kuwait,KWT,United Kingdom of Great Britain and Northern Ireland,GBR,18,0,20,5,43
2005,Liberia,LBR,United Kingdom of Great Britain and Northern Ireland,GBR,0,18,170,46,234
2005,Libya,LBY,United Kingdom of Great Britain and Northern Ireland,GBR,25,5,148,21,199
2005,Lebanon,LBN,United Kingdom of Great Britain and Northern Ireland,GBR,5,5,124,13,147
2005,Sri Lanka,LKA,United Kingdom of Great Britain and Northern Ireland,GBR,11,58,480,74,623
2005,Lithuania,LTU,United Kingdom of Great Britain and Northern Ireland,GBR,0,0,15,0,15
2005,Mauritania,MRT,United Kingdom of Great Britain and Northern Ireland,GBR,0,0,5,5,10
2005,North Macedonia,MKD,United Kingdom of Great Britain and Northern Ireland,GBR,0,0,14,0,14
2005,Rep. of Moldova,MDA,United Kingdom of Great Britain and Northern Ireland,GBR,0,18,66,30,114
2005,Maldives,MDV,United Kingdom of Great Britain and Northern Ireland,GBR,5,0,0,0,5
2005,Mali,MLI,United Kingdom of Great Britain and Northern Ireland,GBR,0,0,5,0,5
2005,Malaysia,MYS,United Kingdom of Great Britain and Northern Ireland,GBR,0,0,13,0,13
2005,Malawi,MWI,United Kingdom of Great Britain and Northern Ireland,GBR,0,5,120,5,130
2005,Mongolia,MNG,United Kingdom of Great Britain and Northern Ireland,GBR,0,0,114,23,137
2005,Morocco,MAR,United Kingdom of Great Britain and Northern Ireland,GBR,0,10,25,5,40
2005,Mozambique,MOZ,United Kingdom of Great Britain and Northern Ireland,GBR,0,0,5,0,5
2005,Mauritius,MUS,United Kingdom of Great Britain and Northern Ireland,GBR,0,0,12,0,12
2005,Myanmar,MMR,United Kingdom of Great Britain and Northern Ireland,GBR,25,5,39,0,69
2005,Nepal,NPL,United Kingdom of Great Britain and Northern Ireland,GBR,0,0,61,11,72
2005,Niger,NER,United Kingdom of Great Britain and Northern Ireland,GBR,0,0,5,0,5
2005,Nigeria,NGA,United Kingdom of Great Britain and Northern Ireland,GBR,0,74,879,130,1083
2005,Pakistan,PAK,United Kingdom of Great Britain and Northern Ireland,GBR,116,78,2046,141,2381
2005,Peru,PER,United Kingdom of Great Britain and Northern Ireland,GBR,0,0,5,0,5
2005,Philippines,PHL,United Kingdom of Great Britain and Northern Ireland,GBR,0,0,5,5,10
2005,Poland,POL,United Kingdom of Great Britain and Northern Ireland,GBR,0,0,16,0,16
2005,Qatar,QAT,United Kingdom of Great Britain and Northern Ireland,GBR,0,0,0,5,5
2005,Romania,ROU,United Kingdom of Great Britain and Northern Ireland,GBR,0,42,142,50,234
2005,South Africa,ZAF,United Kingdom of Great Britain and Northern Ireland,GBR,0,0,120,5,125
2005,Russian Federation,RUS,United Kingdom of Great Britain and Northern Ireland,GBR,34,0,146,26,206
2005,Rwanda,RWA,United Kingdom of Great Britain and Northern Ireland,GBR,0,5,42,11,58
2005,Serbia and Kosovo: S/RES/1244 (1999),SRB,United Kingdom of Great Britain and Northern Ireland,GBR,14,61,489,77,641
2005,Senegal,SEN,United Kingdom of Great Britain and Northern Ireland,GBR,0,0,16,0,16
2005,Seychelles,SYC,United Kingdom of Great Britain and Northern Ireland,GBR,0,0,10,0,10
2005,Singapore,SGP,United Kingdom of Great Britain and Northern Ireland,GBR,0,0,5,0,5
2005,Sierra Leone,SLE,United Kingdom of Great Britain and Northern Ireland,GBR,0,33,135,41,209
2005,Somalia,SOM,United Kingdom of Great Britain and Northern Ireland,GBR,840,205,1050,186,2281
2005,Viet Nam,VNM,United Kingdom of Great Britain and Northern Ireland,GBR,0,134,229,84,447
2005,Sudan,SDN,United Kingdom of Great Britain and Northern Ireland,GBR,86,29,746,222,1083
2005,Eswatini,SWZ,United Kingdom of Great Britain and Northern Ireland,GBR,0,0,5,0,5
2005,Syrian Arab Rep.,SYR,United Kingdom of Great Britain and Northern Ireland,GBR,15,29,324,64,432
2005,United Rep. of Tanzania,TZA,United Kingdom of Great Britain and Northern Ireland,GBR,0,0,36,0,36
2005,Thailand,THA,United Kingdom of Great Britain and Northern Ireland,GBR,0,5,5,0,10
2005,Turkmenistan,TKM,United Kingdom of Great Britain and Northern Ireland,GBR,5,0,10,0,15
2005,Togo,TGO,United Kingdom of Great Britain and Northern Ireland,GBR,0,5,55,5,65
2005,Trinidad and Tobago,TTO,United Kingdom of Great Britain and Northern Ireland,GBR,0,0,5,0,5
2005,Tunisia,TUN,United Kingdom of Great Britain and Northern Ireland,GBR,11,0,17,0,28
2005,Turkey,TUR,United Kingdom of Great Britain and Northern Ireland,GBR,41,67,957,104,1169
2005,Uganda,UGA,United Kingdom of Great Britain and Northern Ireland,GBR,24,21,207,10,262
2005,Ukraine,UKR,United Kingdom of Great Britain and Northern Ireland,GBR,0,0,67,5,72
2005,Uzbekistan,UZB,United Kingdom of Great Britain and Northern Ireland,GBR,5,0,13,0,18
2005,Venezuela (Bolivarian Republic of),VEN,United Kingdom of Great Britain and Northern Ireland,GBR,0,0,20,0,20
2005,Yemen,YEM,United Kingdom of Great Britain and Northern Ireland,GBR,5,11,57,10,83
2005,Zambia,ZMB,United Kingdom of Great Britain and Northern Ireland,GBR,0,0,21,0,21
2005,Zimbabwe,ZWE,United Kingdom of Great Britain and Northern Ireland,GBR,105,23,1122,81,1331
2005,Stateless,XXA,United Kingdom of Great Britain and Northern Ireland,GBR,40,0,83,11,134
2005,Iran (Islamic Rep. of),IRN,Georgia,GEO,0,0,20,0,20
2005,Burkina Faso,BFA,Ghana,GHA,0,0,10,0,10
2005,Dem. Rep. of the Congo,COD,Ghana,GHA,0,0,11,0,11
2005,Rwanda,RWA,Ghana,GHA,5,0,0,0,5
2005,Sierra Leone,SLE,Ghana,GHA,15,0,351,0,366
2005,Sudan,SDN,Ghana,GHA,568,0,5,0,573
2005,Togo,TGO,Ghana,GHA,0,0,0,13595,13595
2005,Burundi,BDI,Guinea-Bissau,GNB,5,0,0,0,5
2005,Congo,COG,Guinea-Bissau,GNB,5,0,0,0,5
2005,Cote d'Ivoire,CIV,Guinea-Bissau,GNB,10,0,0,0,10
2005,Liberia,LBR,Guinea-Bissau,GNB,43,0,0,0,43
2005,Senegal,SEN,Guinea-Bissau,GNB,5,0,0,0,5
2005,Sierra Leone,SLE,Guinea-Bissau,GNB,26,0,68,0,94
2005,Afghanistan,AFG,Greece,GRC,5,5,310,124,444
2005,Albania,ALB,Greece,GRC,0,0,16,10,26
2005,Algeria,DZA,Greece,GRC,0,0,24,10,34
2005,Angola,AGO,Greece,GRC,0,0,0,5,5
2005,Egypt,EGY,Greece,GRC,0,0,94,31,125
2005,Armenia,ARM,Greece,GRC,0,0,11,48,59
2005,Azerbaijan,AZE,Greece,GRC,0,0,14,0,14
2005,Burundi,BDI,Greece,GRC,0,0,10,13,23
2005,Bangladesh,BGD,Greece,GRC,0,0,275,193,468
2005,Belarus,BLR,Greece,GRC,0,0,14,92,106
2005,Bulgaria,BGR,Greece,GRC,0,0,10,145,155
2005,China,CHN,Greece,GRC,0,0,106,192,298
2005,Cameroon,CMR,Greece,GRC,0,0,5,0,5
2005,Dem. Rep. of the Congo,COD,Greece,GRC,5,0,29,5,39
2005,Eritrea,ERI,Greece,GRC,0,0,15,16,31
2005,Ethiopia,ETH,Greece,GRC,5,0,55,62,122
2005,Georgia,GEO,Greece,GRC,0,0,170,1755,1925
2005,Ghana,GHA,Greece,GRC,0,0,21,25,46
2005,Guinea,GIN,Greece,GRC,0,0,5,0,5
2005,Cote d'Ivoire,CIV,Greece,GRC,0,0,31,11,42
2005,India,IND,Greece,GRC,0,0,55,138,193
2005,Indonesia,IDN,Greece,GRC,0,0,0,18,18
2005,Iran (Islamic Rep. of),IRN,Greece,GRC,5,5,195,67,272
2005,Iraq,IRQ,Greece,GRC,0,0,1300,314,1614
2005,Kenya,KEN,Greece,GRC,0,0,5,0,5
2005,Liberia,LBR,Greece,GRC,0,0,10,5,15
2005,Lebanon,LBN,Greece,GRC,0,0,10,0,10
2005,Sri Lanka,LKA,Greece,GRC,0,0,46,69,115
2005,Mauritania,MRT,Greece,GRC,0,0,16,5,21
2005,North Macedonia,MKD,Greece,GRC,0,0,0,5,5
2005,Rep. of Moldova,MDA,Greece,GRC,0,0,16,156,172
2005,Morocco,MAR,Greece,GRC,0,0,13,0,13
2005,Myanmar,MMR,Greece,GRC,0,5,250,30,285
2005,Nigeria,NGA,Greece,GRC,0,5,431,150,586
2005,Pakistan,PAK,Greece,GRC,0,0,381,896,1277
2005,Philippines,PHL,Greece,GRC,0,0,10,31,41
2005,Romania,ROU,Greece,GRC,0,0,32,305,337
2005,Russian Federation,RUS,Greece,GRC,0,10,27,336,373
2005,Rwanda,RWA,Greece,GRC,0,0,18,5,23
2005,Serbia and Kosovo: S/RES/1244 (1999),SRB,Greece,GRC,0,0,0,5,5
2005,Senegal,SEN,Greece,GRC,0,0,0,5,5
2005,Sierra Leone,SLE,Greece,GRC,0,0,33,16,49
2005,Somalia,SOM,Greece,GRC,0,0,94,52,146
2005,Sudan,SDN,Greece,GRC,5,5,80,56,146
2005,Syrian Arab Rep.,SYR,Greece,GRC,0,0,38,18,56
2005,United Rep. of Tanzania,TZA,Greece,GRC,0,0,0,5,5
2005,Turkey,TUR,Greece,GRC,0,0,94,28,122
2005,Uganda,UGA,Greece,GRC,0,0,0,5,5
2005,Ukraine,UKR,Greece,GRC,0,0,16,254,270
2005,Uzbekistan,UZB,Greece,GRC,5,5,5,27,42
2005,Colombia,COL,Guatemala,GTM,0,0,0,5,5
2005,Cuba,CUB,Guatemala,GTM,5,0,0,11,16
2005,Dem. Rep. of the Congo,COD,Guinea,GIN,0,0,0,27,27
2005,Cuba,CUB,Guinea,GIN,0,0,0,5,5
2005,Ghana,GHA,Guinea,GIN,0,0,0,10,10
2005,Cote d'Ivoire,CIV,Guinea,GIN,107,0,16,1188,1311
2005,Liberia,LBR,Guinea,GIN,103,0,42,1236,1381
2005,Nigeria,NGA,Guinea,GIN,0,0,0,10,10
2005,Rwanda,RWA,Guinea,GIN,0,0,0,5,5
2005,Sierra Leone,SLE,Guinea,GIN,84,0,44,2073,2201
2005,Togo,TGO,Guinea,GIN,0,0,5,22,27
2005,Uganda,UGA,Guinea,GIN,5,0,0,0,5
2005,Colombia,COL,Honduras,HND,0,0,0,5,5
2005,Cuba,CUB,Honduras,HND,10,0,0,48,58
2005,Ethiopia,ETH,Honduras,HND,0,0,0,10,10
2005,Albania,ALB,Croatia,HRV,0,0,0,5,5
2005,Bangladesh,BGD,Croatia,HRV,0,0,13,26,39
2005,Bosnia and Herzegovina,BIH,Croatia,HRV,0,0,5,0,5
2005,Ethiopia,ETH,Croatia,HRV,0,0,5,0,5
2005,Palestinian,PSE,Croatia,HRV,0,0,5,0,5
2005,Georgia,GEO,Croatia,HRV,0,0,5,0,5
2005,India,IND,Croatia,HRV,0,0,0,21,21
2005,Sri Lanka,LKA,Croatia,HRV,0,0,0,5,5
2005,North Macedonia,MKD,Croatia,HRV,0,0,14,0,14
2005,Rep. of Moldova,MDA,Croatia,HRV,0,0,0,12,12
2005,Mongolia,MNG,Croatia,HRV,0,0,0,5,5
2005,Pakistan,PAK,Croatia,HRV,0,0,0,5,5
2005,Romania,ROU,Croatia,HRV,0,0,5,5,10
2005,Russian Federation,RUS,Croatia,HRV,0,0,10,0,10
2005,Serbia and Kosovo: S/RES/1244 (1999),SRB,Croatia,HRV,0,0,27,5,32
2005,Turkey,TUR,Croatia,HRV,0,0,5,0,5
2005,Ukraine,UKR,Croatia,HRV,0,0,0,5,5
2005,Uzbekistan,UZB,Croatia,HRV,0,0,5,0,5
2005,Afghanistan,AFG,Hungary,HUN,5,12,0,0,17
2005,Algeria,DZA,Hungary,HUN,0,0,13,0,13
2005,Egypt,EGY,Hungary,HUN,0,0,5,0,5
2005,Armenia,ARM,Hungary,HUN,0,0,5,0,5
2005,Bangladesh,BGD,Hungary,HUN,0,0,15,83,98
2005,Belarus,BLR,Hungary,HUN,0,0,5,5,10
2005,China,CHN,Hungary,HUN,0,0,118,17,135
2005,Cameroon,CMR,Hungary,HUN,0,5,5,0,10
2005,Congo,COG,Hungary,HUN,0,5,0,0,5
2005,Palestinian,PSE,Hungary,HUN,0,0,10,18,28
2005,Georgia,GEO,Hungary,HUN,5,5,25,129,164
2005,India,IND,Hungary,HUN,0,0,17,26,43
2005,Iran (Islamic Rep. of),IRN,Hungary,HUN,10,5,5,10,30
2005,Iraq,IRQ,Hungary,HUN,5,5,0,10,20
2005,Liberia,LBR,Hungary,HUN,0,0,11,0,11
2005,North Macedonia,MKD,Hungary,HUN,0,0,5,10,15
2005,Rep. of Moldova,MDA,Hungary,HUN,0,0,10,14,24
2005,Mongolia,MNG,Hungary,HUN,0,0,0,5,5
2005,Nepal,NPL,Hungary,HUN,0,5,0,0,5
2005,Nigeria,NGA,Hungary,HUN,5,5,48,16,74
2005,Pakistan,PAK,Hungary,HUN,12,11,16,12,51
2005,Romania,ROU,Hungary,HUN,0,0,15,10,25
2005,Russian Federation,RUS,Hungary,HUN,0,5,14,22,41
2005,Serbia and Kosovo: S/RES/1244 (1999),SRB,Hungary,HUN,5,19,82,127,233
2005,Somalia,SOM,Hungary,HUN,11,0,0,0,11
2005,Viet Nam,VNM,Hungary,HUN,0,0,256,11,267
2005,Sudan,SDN,Hungary,HUN,12,0,0,0,12
2005,Slovakia,SVK,Hungary,HUN,0,0,25,0,25
2005,Syrian Arab Rep.,SYR,Hungary,HUN,0,0,5,12,17
2005,Turkey,TUR,Hungary,HUN,5,5,18,35,63
2005,Ukraine,UKR,Hungary,HUN,0,0,5,28,33
2005,Zimbabwe,ZWE,Hungary,HUN,5,0,0,0,5
2005,Stateless,XXA,Hungary,HUN,15,0,0,5,20
2005,Albania,ALB,Iceland,ISL,0,0,5,0,5
2005,Armenia,ARM,Iceland,ISL,0,0,5,0,5
2005,Bulgaria,BGR,Iceland,ISL,0,0,5,0,5
2005,Georgia,GEO,Iceland,ISL,0,0,5,0,5
2005,Iran (Islamic Rep. of),IRN,Iceland,ISL,0,0,5,0,5
2005,Rep. of Moldova,MDA,Iceland,ISL,0,0,5,0,5
2005,Romania,ROU,Iceland,ISL,0,0,22,0,22
2005,Russian Federation,RUS,Iceland,ISL,0,0,5,0,5
2005,Central African Rep.,CAF,Cote d'Ivoire,CIV,0,0,14,0,14
2005,Chad,TCD,Cote d'Ivoire,CIV,0,0,5,0,5
2005,Cameroon,CMR,Cote d'Ivoire,CIV,0,0,5,0,5
2005,Congo,COG,Cote d'Ivoire,CIV,23,0,57,0,80
2005,Dem. Rep. of the Congo,COD,Cote d'Ivoire,CIV,20,0,90,0,110
2005,Rwanda,RWA,Cote d'Ivoire,CIV,12,0,0,0,12
2005,Sierra Leone,SLE,Cote d'Ivoire,CIV,0,0,31,0,31
2005,Sudan,SDN,Cote d'Ivoire,CIV,0,0,5,0,5
2005,Togo,TGO,Cote d'Ivoire,CIV,5,0,33,0,38
2005,Afghanistan,AFG,Ireland,IRL,10,0,128,12,150
2005,Albania,ALB,Ireland,IRL,0,0,72,5,77
2005,Algeria,DZA,Ireland,IRL,0,0,45,16,61
2005,Angola,AGO,Ireland,IRL,10,0,89,0,99
2005,Egypt,EGY,Ireland,IRL,0,0,5,0,5
2005,Argentina,ARG,Ireland,IRL,0,0,5,0,5
2005,Armenia,ARM,Ireland,IRL,5,0,12,0,17
2005,Azerbaijan,AZE,Ireland,IRL,0,0,10,5,15
2005,Burundi,BDI,Ireland,IRL,10,0,27,0,37
2005,Benin,BEN,Ireland,IRL,0,0,5,5,10
2005,Bangladesh,BGD,Ireland,IRL,5,0,22,0,27
2005,Bhutan,BTN,Ireland,IRL,0,0,10,0,10
2005,Belarus,BLR,Ireland,IRL,0,0,17,10,27
2005,Brazil,BRA,Ireland,IRL,0,0,5,0,5
2005,Chad,TCD,Ireland,IRL,5,0,0,0,5
2005,China,CHN,Ireland,IRL,18,0,40,40,98
2005,Cameroon,CMR,Ireland,IRL,5,0,82,10,97
2005,Congo,COG,Ireland,IRL,5,0,23,0,28
2005,Dem. Rep. of the Congo,COD,Ireland,IRL,5,0,215,16,236
2005,Czechia,CZE,Ireland,IRL,0,0,0,5,5
2005,Eritrea,ERI,Ireland,IRL,14,0,19,5,38
2005,Ethiopia,ETH,Ireland,IRL,10,0,23,0,33
2005,Gambia,GMB,Ireland,IRL,0,0,5,0,5
2005,Palestinian,PSE,Ireland,IRL,0,0,21,10,31
2005,United Kingdom of Great Britain and Northern Ireland,GBR,Ireland,IRL,0,0,0,5,5
2005,Georgia,GEO,Ireland,IRL,10,0,149,36,195
2005,Ghana,GHA,Ireland,IRL,0,0,69,5,74
2005,Guinea,GIN,Ireland,IRL,16,0,28,5,49
2005,Croatia,HRV,Ireland,IRL,5,0,114,13,132
2005,Cote d'Ivoire,CIV,Ireland,IRL,5,0,25,0,30
2005,India,IND,Ireland,IRL,0,0,10,5,15
2005,Iran (Islamic Rep. of),IRN,Ireland,IRL,19,0,69,23,111
2005,Iraq,IRQ,Ireland,IRL,10,0,31,10,51
2005,Israel,ISR,Ireland,IRL,13,0,0,0,13
2005,Jamaica,JAM,Ireland,IRL,0,0,0,5,5
2005,Jordan,JOR,Ireland,IRL,0,0,5,0,5
2005,Kazakhstan,KAZ,Ireland,IRL,0,0,14,0,14
2005,Kenya,KEN,Ireland,IRL,10,0,66,5,81
2005,Kyrgyzstan,KGZ,Ireland,IRL,0,0,10,0,10
2005,Kuwait,KWT,Ireland,IRL,10,0,11,0,21
2005,Liberia,LBR,Ireland,IRL,0,0,50,5,55
2005,Libya,LBY,Ireland,IRL,0,0,5,5,10
2005,Lebanon,LBN,Ireland,IRL,0,0,5,0,5
2005,Sri Lanka,LKA,Ireland,IRL,5,0,5,0,10
2005,Lithuania,LTU,Ireland,IRL,0,0,0,5,5
2005,North Macedonia,MKD,Ireland,IRL,0,0,5,0,5
2005,Rep. of Moldova,MDA,Ireland,IRL,0,0,82,55,137
2005,Malawi,MWI,Ireland,IRL,0,0,5,0,5
2005,Mongolia,MNG,Ireland,IRL,0,0,5,0,5
2005,Morocco,MAR,Ireland,IRL,0,0,12,5,17
2005,Mauritius,MUS,Ireland,IRL,0,0,5,0,5
2005,Myanmar,MMR,Ireland,IRL,0,0,5,0,5
2005,Nepal,NPL,Ireland,IRL,0,0,17,0,17
2005,Niger,NER,Ireland,IRL,0,0,5,0,5
2005,Nigeria,NGA,Ireland,IRL,10,0,1289,173,1472
2005,Pakistan,PAK,Ireland,IRL,5,0,55,12,72
2005,Romania,ROU,Ireland,IRL,0,0,205,183,388
2005,South Africa,ZAF,Ireland,IRL,0,0,45,5,50
2005,Russian Federation,RUS,Ireland,IRL,5,0,66,14,85
2005,Rwanda,RWA,Ireland,IRL,22,0,13,0,35
2005,Serbia and Kosovo: S/RES/1244 (1999),SRB,Ireland,IRL,5,0,38,12,55
2005,Sierra Leone,SLE,Ireland,IRL,0,0,25,5,30
2005,Somalia,SOM,Ireland,IRL,86,0,188,24,298
2005,Sudan,SDN,Ireland,IRL,77,0,72,30,179
2005,Syrian Arab Rep.,SYR,Ireland,IRL,5,0,11,10,26
2005,Togo,TGO,Ireland,IRL,0,0,47,0,47
2005,Turkey,TUR,Ireland,IRL,0,0,10,0,10
2005,Uganda,UGA,Ireland,IRL,5,0,28,5,38
2005,Ukraine,UKR,Ireland,IRL,0,0,82,20,102
2005,Uzbekistan,UZB,Ireland,IRL,5,0,11,0,16
2005,Yemen,YEM,Ireland,IRL,0,0,5,0,5
2005,Zimbabwe,ZWE,Ireland,IRL,19,0,64,10,93
2005,Stateless,XXA,Ireland,IRL,11,0,5,0,16
2005,Bangladesh,BGD,Japan,JPN,0,0,29,5,34
2005,China,CHN,Japan,JPN,0,0,12,0,12
2005,Cameroon,CMR,Japan,JPN,0,0,5,0,5
2005,Guinea-Bissau,GNB,Japan,JPN,0,0,5,0,5
2005,India,IND,Japan,JPN,0,0,5,0,5
2005,Indonesia,IDN,Japan,JPN,0,0,5,0,5
2005,Iran (Islamic Rep. of),IRN,Japan,JPN,0,0,5,5,10
2005,Sri Lanka,LKA,Japan,JPN,0,0,10,0,10
2005,Myanmar,MMR,Japan,JPN,27,13,117,10,167
2005,Nepal,NPL,Japan,JPN,0,0,5,0,5
2005,Pakistan,PAK,Japan,JPN,0,0,5,5,10
2005,Turkey,TUR,Japan,JPN,0,0,28,5,33
2005,Afghanistan,AFG,Kazakhstan,KAZ,74,0,5,0,79
2005,Afghanistan,AFG,Kyrgyzstan,KGZ,23,0,57,37,117
2005,Kazakhstan,KAZ,Kyrgyzstan,KGZ,0,0,5,0,5
2005,Russian Federation,RUS,Kyrgyzstan,KGZ,0,0,0,28,28
2005,Uzbekistan,UZB,Kyrgyzstan,KGZ,0,0,5,492,497
2005,Belarus,BLR,Liechtenstein,LIE,0,0,5,0,5
2005,Israel,ISR,Liechtenstein,LIE,0,0,5,0,5
2005,Kazakhstan,KAZ,Liechtenstein,LIE,0,0,5,0,5
2005,Mongolia,MNG,Liechtenstein,LIE,0,0,5,0,5
2005,Russian Federation,RUS,Liechtenstein,LIE,0,0,5,5,10
2005,Serbia and Kosovo: S/RES/1244 (1999),SRB,Liechtenstein,LIE,0,0,12,0,12
2005,Somalia,SOM,Liechtenstein,LIE,0,0,0,5,5
2005,Ukraine,UKR,Liechtenstein,LIE,0,0,5,0,5
2005,Georgia,GEO,Lithuania,LTU,0,0,0,5,5
2005,Iraq,IRQ,Lithuania,LTU,0,0,0,5,5
2005,Russian Federation,RUS,Lithuania,LTU,15,40,10,0,65
2005,Serbia and Kosovo: S/RES/1244 (1999),SRB,North Macedonia,MKD,10,313,130,126,579
2005,Bangladesh,BGD,Mexico,MEX,0,0,0,5,5
2005,Dem. Rep. of the Congo,COD,Mexico,MEX,0,0,5,0,5
2005,Colombia,COL,Mexico,MEX,10,0,10,17,37
2005,Cuba,CUB,Mexico,MEX,0,0,5,61,66
2005,Eritrea,ERI,Mexico,MEX,52,0,12,76,140
2005,Ethiopia,ETH,Mexico,MEX,16,0,10,91,117
2005,Guatemala,GTM,Mexico,MEX,5,0,24,5,34
2005,Guyana,GUY,Mexico,MEX,0,0,0,5,5
2005,Haiti,HTI,Mexico,MEX,13,0,11,0,24
2005,Honduras,HND,Mexico,MEX,0,0,48,17,65
2005,India,IND,Mexico,MEX,0,0,0,23,23
2005,Iraq,IRQ,Mexico,MEX,0,0,5,5,10
2005,Liberia,LBR,Mexico,MEX,0,0,5,0,5
2005,Sri Lanka,LKA,Mexico,MEX,0,0,0,10,10
2005,Myanmar,MMR,Mexico,MEX,5,0,0,0,5
2005,Nepal,NPL,Mexico,MEX,0,0,0,5,5
2005,Nicaragua,NIC,Mexico,MEX,0,0,12,5,17
2005,Peru,PER,Mexico,MEX,0,0,0,5,5
2005,Romania,ROU,Mexico,MEX,0,0,0,5,5
2005,El Salvador,SLV,Mexico,MEX,0,0,28,13,41
2005,Somalia,SOM,Mexico,MEX,15,0,5,5,25
2005,Sudan,SDN,Mexico,MEX,0,0,0,5,5
2005,Central African Rep.,CAF,Mali,MLI,0,0,5,0,5
2005,Congo,COG,Mali,MLI,0,0,11,0,11
2005,Dem. Rep. of the Congo,COD,Mali,MLI,10,0,25,0,35
2005,Cote d'Ivoire,CIV,Mali,MLI,12,0,110,0,122
2005,Liberia,LBR,Mali,MLI,0,0,20,0,20
2005,Mauritania,MRT,Mali,MLI,0,0,10,0,10
2005,Nigeria,NGA,Mali,MLI,0,0,10,0,10
2005,Togo,TGO,Mali,MLI,0,0,10,0,10
2005,Burundi,BDI,Malawi,MWI,397,0,0,16,413
2005,Dem. Rep. of the Congo,COD,Malawi,MWI,356,0,0,25,381
2005,Eritrea,ERI,Malawi,MWI,0,0,0,146,146
2005,Ethiopia,ETH,Malawi,MWI,0,0,0,362,362
2005,Rwanda,RWA,Malawi,MWI,0,0,0,24,24
2005,Somalia,SOM,Malawi,MWI,0,0,13,376,389
2005,Algeria,DZA,Malta,MLT,0,0,5,5,10
2005,Egypt,EGY,Malta,MLT,0,0,5,0,5
2005,Burkina Faso,BFA,Malta,MLT,0,0,10,0,10
2005,Chad,TCD,Malta,MLT,0,0,10,0,10
2005,Dem. Rep. of the Congo,COD,Malta,MLT,0,0,56,5,61
2005,Comoros,COM,Malta,MLT,0,0,0,5,5
2005,Eritrea,ERI,Malta,MLT,5,228,40,0,273
2005,Ethiopia,ETH,Malta,MLT,5,0,15,0,20
2005,Palestinian,PSE,Malta,MLT,15,0,36,11,62
2005,Ghana,GHA,Malta,MLT,0,0,14,0,14
2005,Cote d'Ivoire,CIV,Malta,MLT,0,0,85,5,90
2005,India,IND,Malta,MLT,0,0,5,0,5
2005,Iraq,IRQ,Malta,MLT,5,5,14,5,29
2005,Liberia,LBR,Malta,MLT,0,0,26,0,26
2005,Libya,LBY,Malta,MLT,0,0,10,0,10
2005,Nigeria,NGA,Malta,MLT,0,0,31,0,31
2005,Pakistan,PAK,Malta,MLT,0,0,16,5,21
2005,Russian Federation,RUS,Malta,MLT,0,0,0,5,5
2005,Serbia and Kosovo: S/RES/1244 (1999),SRB,Malta,MLT,0,0,10,0,10
2005,Somalia,SOM,Malta,MLT,0,225,17,5,247
2005,Sudan,SDN,Malta,MLT,0,22,149,5,176
2005,Syrian Arab Rep.,SYR,Malta,MLT,5,0,0,0,5
2005,Togo,TGO,Malta,MLT,0,0,5,0,5
2005,Turkey,TUR,Malta,MLT,0,0,14,0,14
2005,Burundi,BDI,Namibia,NAM,32,0,63,115,210
2005,Cameroon,CMR,Namibia,NAM,0,0,5,0,5
2005,Dem. Rep. of the Congo,COD,Namibia,NAM,287,0,89,360,736
2005,Ethiopia,ETH,Namibia,NAM,0,0,0,5,5
2005,Liberia,LBR,Namibia,NAM,0,0,13,22,35
2005,Rwanda,RWA,Namibia,NAM,5,0,159,37,201
2005,Sierra Leone,SLE,Namibia,NAM,0,0,5,0,5
2005,Somalia,SOM,Namibia,NAM,0,0,0,5,5
2005,Uganda,UGA,Namibia,NAM,5,0,0,0,5
2005,Bhutan,BTN,Nepal,NPL,0,51,19,5,75
2005,Afghanistan,AFG,Netherlands,NLD,83,657,706,150,1596
2005,Albania,ALB,Netherlands,NLD,0,0,29,16,45
2005,Algeria,DZA,Netherlands,NLD,0,5,37,21,63
2005,Angola,AGO,Netherlands,NLD,5,154,309,109,577
2005,Egypt,EGY,Netherlands,NLD,0,10,24,5,39
2005,Armenia,ARM,Netherlands,NLD,35,173,200,47,455
2005,Azerbaijan,AZE,Netherlands,NLD,99,317,265,73,754
2005,Burundi,BDI,Netherlands,NLD,5,387,142,43,577
2005,Benin,BEN,Netherlands,NLD,0,0,14,5,19
2005,Bangladesh,BGD,Netherlands,NLD,0,5,25,5,35
2005,Bhutan,BTN,Netherlands,NLD,0,11,0,0,11
2005,Burkina Faso,BFA,Netherlands,NLD,0,0,5,0,5
2005,Belarus,BLR,Netherlands,NLD,10,12,23,5,50
2005,Bosnia and Herzegovina,BIH,Netherlands,NLD,5,62,67,33,167
2005,Bulgaria,BGR,Netherlands,NLD,0,5,5,0,10
2005,Central African Rep.,CAF,Netherlands,NLD,0,0,5,0,5
2005,Chad,TCD,Netherlands,NLD,0,5,0,5,10
2005,China,CHN,Netherlands,NLD,26,30,225,124,405
2005,Cameroon,CMR,Netherlands,NLD,13,23,61,11,108
2005,Congo,COG,Netherlands,NLD,10,105,95,25,235
2005,Dem. Rep. of the Congo,COD,Netherlands,NLD,25,129,114,36,304
2005,Colombia,COL,Netherlands,NLD,27,111,65,39,242
2005,Cuba,CUB,Netherlands,NLD,0,0,13,0,13
2005,Czechia,CZE,Netherlands,NLD,0,0,10,0,10
2005,Djibouti,DJI,Netherlands,NLD,0,13,0,0,13
2005,Ecuador,ECU,Netherlands,NLD,0,0,5,0,5
2005,Eritrea,ERI,Netherlands,NLD,11,145,105,39,300
2005,Ethiopia,ETH,Netherlands,NLD,5,34,53,16,108
2005,Gabon,GAB,Netherlands,NLD,0,5,0,0,5
2005,Gambia,GMB,Netherlands,NLD,0,0,19,0,19
2005,Palestinian,PSE,Netherlands,NLD,0,0,5,5,10
2005,United Kingdom of Great Britain and Northern Ireland,GBR,Netherlands,NLD,0,0,0,5,5
2005,Georgia,GEO,Netherlands,NLD,5,17,214,34,270
2005,Germany,DEU,Netherlands,NLD,0,0,5,0,5
2005,Ghana,GHA,Netherlands,NLD,0,0,16,5,21
2005,Guinea-Bissau,GNB,Netherlands,NLD,0,0,5,0,5
2005,Guinea,GIN,Netherlands,NLD,5,51,128,37,221
2005,Croatia,HRV,Netherlands,NLD,0,5,13,0,18
2005,Hungary,HUN,Netherlands,NLD,0,0,5,0,5
2005,Cote d'Ivoire,CIV,Netherlands,NLD,0,37,23,13,73
2005,India,IND,Netherlands,NLD,0,0,102,87,189
2005,Indonesia,IDN,Netherlands,NLD,0,0,10,0,10
2005,Iran (Islamic Rep. of),IRN,Netherlands,NLD,72,220,416,96,804
2005,Iraq,IRQ,Netherlands,NLD,47,1852,865,502,3266
2005,Israel,ISR,Netherlands,NLD,0,0,14,5,19
2005,Jordan,JOR,Netherlands,NLD,0,0,5,0,5
2005,Kazakhstan,KAZ,Netherlands,NLD,5,18,22,5,50
2005,Kenya,KEN,Netherlands,NLD,0,0,5,0,5
2005,Kyrgyzstan,KGZ,Netherlands,NLD,10,12,20,5,47
2005,Rep. of Korea,KOR,Netherlands,NLD,5,0,0,0,5
2005,Dem. People's Rep. of Korea,PRK,Netherlands,NLD,0,0,5,0,5
2005,Liberia,LBR,Netherlands,NLD,12,140,258,49,459
2005,Libya,LBY,Netherlands,NLD,5,18,37,10,70
2005,Lebanon,LBN,Netherlands,NLD,0,5,12,10,27
2005,Sri Lanka,LKA,Netherlands,NLD,5,16,74,16,111
2005,Mauritania,MRT,Netherlands,NLD,0,0,13,0,13
2005,North Macedonia,MKD,Netherlands,NLD,0,0,22,0,22
2005,Rep. of Moldova,MDA,Netherlands,NLD,0,0,10,10,20
2005,Mali,MLI,Netherlands,NLD,0,0,5,0,5
2005,Mongolia,MNG,Netherlands,NLD,0,5,89,26,120
2005,Morocco,MAR,Netherlands,NLD,0,0,19,10,29
2005,Myanmar,MMR,Netherlands,NLD,0,5,22,0,27
2005,Nepal,NPL,Netherlands,NLD,15,12,127,35,189
2005,Niger,NER,Netherlands,NLD,0,5,25,5,35
2005,Nigeria,NGA,Netherlands,NLD,0,29,147,35,211
2005,Pakistan,PAK,Netherlands,NLD,15,14,57,10,96
2005,Philippines,PHL,Netherlands,NLD,0,0,0,14,14
2005,Poland,POL,Netherlands,NLD,0,0,5,0,5
2005,Romania,ROU,Netherlands,NLD,5,0,17,5,27
2005,Russian Federation,RUS,Netherlands,NLD,54,160,236,78,528
2005,Rwanda,RWA,Netherlands,NLD,30,75,33,15,153
2005,Saudi Arabia,SAU,Netherlands,NLD,0,10,0,0,10
2005,Serbia and Kosovo: S/RES/1244 (1999),SRB,Netherlands,NLD,10,74,266,70,420
2005,Senegal,SEN,Netherlands,NLD,0,0,5,0,5
2005,Sierra Leone,SLE,Netherlands,NLD,5,139,208,64,416
2005,Somalia,SOM,Netherlands,NLD,60,1221,328,157,1766
2005,Spain,ESP,Netherlands,NLD,0,5,0,0,5
2005,Viet Nam,VNM,Netherlands,NLD,0,5,13,5,23
2005,Sudan,SDN,Netherlands,NLD,49,269,230,77,625
2005,Suriname,SUR,Netherlands,NLD,0,0,5,0,5
2005,Slovakia,SVK,Netherlands,NLD,0,0,20,14,34
2005,Syrian Arab Rep.,SYR,Netherlands,NLD,61,139,167,67,434
2005,United Rep. of Tanzania,TZA,Netherlands,NLD,0,0,5,0,5
2005,Tajikistan,TJK,Netherlands,NLD,0,5,11,0,16
2005,Togo,TGO,Netherlands,NLD,5,29,56,12,102
2005,Tunisia,TUN,Netherlands,NLD,5,10,5,0,20
2005,Turkey,TUR,Netherlands,NLD,17,99,238,94,448
2005,Uganda,UGA,Netherlands,NLD,0,12,16,5,33
2005,Ukraine,UKR,Netherlands,NLD,5,5,38,11,59
2005,United States of America,USA,Netherlands,NLD,0,0,5,5,10
2005,Uzbekistan,UZB,Netherlands,NLD,14,18,33,10,75
2005,Yemen,YEM,Netherlands,NLD,0,0,5,12,17
2005,Zimbabwe,ZWE,Netherlands,NLD,0,5,5,0,10
2005,Stateless,XXA,Netherlands,NLD,17,69,159,57,302
2005,Colombia,COL,Nicaragua,NIC,5,0,0,0,5
2005,Cuba,CUB,Nicaragua,NIC,5,0,0,0,5
2005,Cameroon,CMR,Nigeria,NGA,12,0,0,0,12
2005,Dem. Rep. of the Congo,COD,Nigeria,NGA,515,0,114,0,629
2005,Guinea-Bissau,GNB,Nigeria,NGA,5,0,0,0,5
2005,Guinea,GIN,Nigeria,NGA,12,0,0,0,12
2005,Cote d'Ivoire,CIV,Nigeria,NGA,26,0,0,0,26
2005,Liberia,LBR,Nigeria,NGA,609,0,16,300,925
2005,Rwanda,RWA,Nigeria,NGA,5,0,0,0,5
2005,Sierra Leone,SLE,Nigeria,NGA,193,0,17,23,233
2005,Sudan,SDN,Nigeria,NGA,29,0,0,0,29
2005,Togo,TGO,Nigeria,NGA,5,0,5,0,10
2005,Afghanistan,AFG,Norway,NOR,16,347,343,153,859
2005,Albania,ALB,Norway,NOR,0,5,56,37,98
2005,Algeria,DZA,Norway,NOR,0,0,27,36,63
2005,Angola,AGO,Norway,NOR,0,17,24,5,46
2005,Egypt,EGY,Norway,NOR,0,0,11,5,16
2005,Armenia,ARM,Norway,NOR,0,0,0,14,14
2005,Azerbaijan,AZE,Norway,NOR,0,5,39,52,96
2005,Burundi,BDI,Norway,NOR,38,123,40,13,214
2005,Bangladesh,BGD,Norway,NOR,0,0,11,16,27
2005,Bhutan,BTN,Norway,NOR,0,0,5,5,10
2005,Belarus,BLR,Norway,NOR,0,0,20,17,37
2005,Bosnia and Herzegovina,BIH,Norway,NOR,0,0,39,45,84
2005,Bulgaria,BGR,Norway,NOR,0,0,19,5,24
2005,China,CHN,Norway,NOR,28,23,5,5,61
2005,Chile,CHL,Norway,NOR,0,0,5,0,5
2005,Cameroon,CMR,Norway,NOR,0,0,53,5,58
2005,Congo,COG,Norway,NOR,0,0,13,0,13
2005,Dem. Rep. of the Congo,COD,Norway,NOR,5,64,11,14,94
2005,Colombia,COL,Norway,NOR,0,5,0,0,5
2005,Cuba,CUB,Norway,NOR,0,0,5,0,5
2005,Eritrea,ERI,Norway,NOR,74,81,5,28,188
2005,Ethiopia,ETH,Norway,NOR,33,11,34,11,89
2005,Gambia,GMB,Norway,NOR,0,0,0,5,5
2005,Georgia,GEO,Norway,NOR,0,0,10,13,23
2005,Ghana,GHA,Norway,NOR,0,0,0,5,5
2005,Guinea-Bissau,GNB,Norway,NOR,0,0,0,5,5
2005,Guinea,GIN,Norway,NOR,0,0,13,0,13
2005,Croatia,HRV,Norway,NOR,0,0,18,5,23
2005,Hungary,HUN,Norway,NOR,0,0,5,0,5
2005,Cote d'Ivoire,CIV,Norway,NOR,0,11,0,0,11
2005,India,IND,Norway,NOR,0,0,12,0,12
2005,Indonesia,IDN,Norway,NOR,0,0,5,0,5
2005,Iran (Islamic Rep. of),IRN,Norway,NOR,39,20,227,99,385
2005,Iraq,IRQ,Norway,NOR,32,287,555,294,1168
2005,Israel,ISR,Norway,NOR,0,0,12,5,17
2005,Jordan,JOR,Norway,NOR,0,0,5,5,10
2005,Kazakhstan,KAZ,Norway,NOR,0,0,13,10,23
2005,Kyrgyzstan,KGZ,Norway,NOR,0,0,12,16,28
2005,Rep. of Korea,KOR,Norway,NOR,0,0,0,5,5
2005,Kuwait,KWT,Norway,NOR,0,0,0,5,5
2005,Liberia,LBR,Norway,NOR,0,15,28,14,57
2005,Libya,LBY,Norway,NOR,0,0,28,35,63
2005,Lebanon,LBN,Norway,NOR,0,10,14,12,36
2005,Sri Lanka,LKA,Norway,NOR,10,23,28,18,79
2005,Lithuania,LTU,Norway,NOR,0,0,10,0,10
2005,Madagascar,MDG,Norway,NOR,0,0,0,5,5
2005,North Macedonia,MKD,Norway,NOR,0,0,12,10,22
2005,Rep. of Moldova,MDA,Norway,NOR,0,0,10,10,20
2005,Mongolia,MNG,Norway,NOR,0,0,13,0,13
2005,Morocco,MAR,Norway,NOR,0,0,11,5,16
2005,Malta,MLT,Norway,NOR,0,0,0,5,5
2005,Myanmar,MMR,Norway,NOR,0,5,5,13,23
2005,Nepal,NPL,Norway,NOR,0,0,32,16,48
2005,Niger,NER,Norway,NOR,0,0,11,0,11
2005,Nigeria,NGA,Norway,NOR,0,5,81,52,138
2005,Pakistan,PAK,Norway,NOR,5,0,23,13,41
2005,Russian Federation,RUS,Norway,NOR,28,409,136,191,764
2005,Rwanda,RWA,Norway,NOR,13,22,29,10,74
2005,Serbia and Kosovo: S/RES/1244 (1999),SRB,Norway,NOR,39,10,315,257,621
2005,Sierra Leone,SLE,Norway,NOR,0,0,10,16,26
2005,Somalia,SOM,Norway,NOR,98,331,208,138,775
2005,Viet Nam,VNM,Norway,NOR,0,0,5,14,19
2005,Sudan,SDN,Norway,NOR,12,5,22,11,50
2005,Syrian Arab Rep.,SYR,Norway,NOR,5,10,32,31,78
2005,United Rep. of Tanzania,TZA,Norway,NOR,0,0,5,0,5
2005,Tajikistan,TJK,Norway,NOR,0,0,11,0,11
2005,Turkmenistan,TKM,Norway,NOR,0,0,5,0,5
2005,Togo,TGO,Norway,NOR,5,0,5,0,10
2005,Tunisia,TUN,Norway,NOR,0,0,5,5,10
2005,Turkey,TUR,Norway,NOR,5,5,46,53,109
2005,Uganda,UGA,Norway,NOR,0,0,11,0,11
2005,Ukraine,UKR,Norway,NOR,0,0,13,5,18
2005,Uzbekistan,UZB,Norway,NOR,5,0,17,20,42
2005,Western Sahara,ESH,Norway,NOR,0,0,14,5,19
2005,Yemen,YEM,Norway,NOR,0,0,14,0,14
2005,Zimbabwe,ZWE,Norway,NOR,5,0,0,0,5
2005,Stateless,XXA,Norway,NOR,52,45,98,100,295
2005,Bangladesh,BGD,New Zealand,NZL,0,0,26,0,26
2005,Bulgaria,BGR,New Zealand,NZL,0,0,5,0,5
2005,China,CHN,New Zealand,NZL,5,0,28,0,33
2005,Chile,CHL,New Zealand,NZL,0,0,25,0,25
2005,Dem. Rep. of the Congo,COD,New Zealand,NZL,0,0,5,0,5
2005,Czechia,CZE,New Zealand,NZL,5,0,23,0,28
2005,Ethiopia,ETH,New Zealand,NZL,0,0,5,0,5
2005,Fiji,FJI,New Zealand,NZL,0,0,11,0,11
2005,Hungary,HUN,New Zealand,NZL,0,0,5,0,5
2005,India,IND,New Zealand,NZL,0,0,47,0,47
2005,Iran (Islamic Rep. of),IRN,New Zealand,NZL,20,0,46,0,66
2005,Iraq,IRQ,New Zealand,NZL,10,0,13,0,23
2005,Jordan,JOR,New Zealand,NZL,0,0,13,0,13
2005,Sri Lanka,LKA,New Zealand,NZL,5,0,12,0,17
2005,Malaysia,MYS,New Zealand,NZL,0,0,10,0,10
2005,Myanmar,MMR,New Zealand,NZL,5,0,5,0,10
2005,Nepal,NPL,New Zealand,NZL,0,0,13,0,13
2005,Nigeria,NGA,New Zealand,NZL,0,0,5,0,5
2005,Pakistan,PAK,New Zealand,NZL,0,0,11,0,11
2005,South Africa,ZAF,New Zealand,NZL,0,0,5,0,5
2005,El Salvador,SLV,New Zealand,NZL,0,0,5,0,5
2005,Singapore,SGP,New Zealand,NZL,0,0,5,0,5
2005,Somalia,SOM,New Zealand,NZL,0,0,13,0,13
2005,Sudan,SDN,New Zealand,NZL,0,0,5,0,5
2005,Syrian Arab Rep.,SYR,New Zealand,NZL,14,0,0,0,14
2005,Zimbabwe,ZWE,New Zealand,NZL,5,0,0,0,5
2005,Cuba,CUB,Paraguay,PRY,5,0,0,0,5
2005,Colombia,COL,Peru,PER,51,0,20,5,76
2005,Cuba,CUB,Peru,PER,27,0,0,0,27
2005,Iraq,IRQ,Peru,PER,0,0,0,5,5
2005,Somalia,SOM,Peru,PER,0,0,0,5,5
2005,Afghanistan,AFG,Poland,POL,5,12,13,0,30
2005,Algeria,DZA,Poland,POL,0,0,5,0,5
2005,Egypt,EGY,Poland,POL,0,0,5,0,5
2005,Armenia,ARM,Poland,POL,0,5,21,13,39
2005,Azerbaijan,AZE,Poland,POL,0,0,11,0,11
2005,Belarus,BLR,Poland,POL,10,5,30,16,61
2005,Bosnia and Herzegovina,BIH,Poland,POL,0,0,0,10,10
2005,Bulgaria,BGR,Poland,POL,0,0,10,5,15
2005,China,CHN,Poland,POL,0,0,12,0,12
2005,Cameroon,CMR,Poland,POL,0,0,5,0,5
2005,Congo,COG,Poland,POL,0,5,0,0,5
2005,Palestinian,PSE,Poland,POL,0,0,0,5,5
2005,Georgia,GEO,Poland,POL,0,0,46,16,62
2005,Guinea,GIN,Poland,POL,0,0,11,0,11
2005,India,IND,Poland,POL,0,0,18,24,42
2005,Iran (Islamic Rep. of),IRN,Poland,POL,5,0,5,0,10
2005,Iraq,IRQ,Poland,POL,0,0,5,11,16
2005,Kazakhstan,KAZ,Poland,POL,0,0,24,18,42
2005,Kyrgyzstan,KGZ,Poland,POL,0,0,14,5,19
2005,Lebanon,LBN,Poland,POL,0,0,0,5,5
2005,Sri Lanka,LKA,Poland,POL,5,0,0,0,5
2005,Rep. of Moldova,MDA,Poland,POL,0,0,15,11,26
2005,Nepal,NPL,Poland,POL,0,0,5,0,5
2005,Nigeria,NGA,Poland,POL,0,0,11,0,11
2005,Pakistan,PAK,Poland,POL,0,0,62,34,96
2005,Romania,ROU,Poland,POL,0,0,5,0,5
2005,Russian Federation,RUS,Poland,POL,285,1767,1862,4158,8072
2005,Serbia and Kosovo: S/RES/1244 (1999),SRB,Poland,POL,0,0,0,18,18
2005,Somalia,SOM,Poland,POL,5,12,0,0,17
2005,Viet Nam,VNM,Poland,POL,0,0,16,0,16
2005,Syrian Arab Rep.,SYR,Poland,POL,0,0,5,0,5
2005,Togo,TGO,Poland,POL,0,0,5,0,5
2005,Turkey,TUR,Poland,POL,0,11,0,0,11
2005,Ukraine,UKR,Poland,POL,0,0,52,46,98
2005,Stateless,XXA,Poland,POL,0,0,10,5,15
2005,Angola,AGO,Portugal,PRT,0,0,5,0,5
2005,Dem. Rep. of the Congo,COD,Portugal,PRT,0,0,5,0,5
2005,Colombia,COL,Portugal,PRT,0,11,0,0,11
2005,Cuba,CUB,Portugal,PRT,0,0,5,0,5
2005,India,IND,Portugal,PRT,0,0,5,0,5
2005,Turkey,TUR,Portugal,PRT,5,0,0,0,5
2005,Afghanistan,AFG,South Africa,ZAF,5,0,0,0,5
2005,Angola,AGO,South Africa,ZAF,11,0,14,32,57
2005,Egypt,EGY,South Africa,ZAF,0,0,5,0,5
2005,Burundi,BDI,South Africa,ZAF,129,0,60,25,214
2005,Bangladesh,BGD,South Africa,ZAF,0,0,35,0,35
2005,Cameroon,CMR,South Africa,ZAF,14,0,5,0,19
2005,Congo,COG,South Africa,ZAF,49,0,32,0,81
2005,Dem. Rep. of the Congo,COD,South Africa,ZAF,1149,0,263,68,1480
2005,Comoros,COM,South Africa,ZAF,0,0,10,0,10
2005,Eritrea,ERI,South Africa,ZAF,16,0,10,0,26
2005,Ethiopia,ETH,South Africa,ZAF,59,0,154,5,218
2005,Ghana,GHA,South Africa,ZAF,5,0,5,0,10
2005,Cote d'Ivoire,CIV,South Africa,ZAF,0,0,5,0,5
2005,India,IND,South Africa,ZAF,0,0,20,0,20
2005,Kenya,KEN,South Africa,ZAF,0,0,25,0,25
2005,Liberia,LBR,South Africa,ZAF,0,0,5,0,5
2005,Malawi,MWI,South Africa,ZAF,5,0,19,0,24
2005,Mozambique,MOZ,South Africa,ZAF,0,0,5,0,5
2005,Nigeria,NGA,South Africa,ZAF,5,0,46,0,51
2005,Pakistan,PAK,South Africa,ZAF,0,0,21,0,21
2005,Rwanda,RWA,South Africa,ZAF,35,0,10,32,77
2005,Somalia,SOM,South Africa,ZAF,447,0,122,17,586
2005,Sudan,SDN,South Africa,ZAF,5,0,0,11,16
2005,United Rep. of Tanzania,TZA,South Africa,ZAF,127,0,63,0,190
2005,Uganda,UGA,South Africa,ZAF,19,0,49,5,73
2005,Zambia,ZMB,South Africa,ZAF,5,0,0,0,5
2005,Zimbabwe,ZWE,South Africa,ZAF,84,0,187,0,271
2005,Afghanistan,AFG,Russian Federation,RUS,11,0,691,0,702
2005,Angola,AGO,Russian Federation,RUS,0,0,5,0,5
2005,China,CHN,Russian Federation,RUS,0,0,5,0,5
2005,Congo,COG,Russian Federation,RUS,0,0,5,0,5
2005,Dem. Rep. of the Congo,COD,Russian Federation,RUS,0,0,5,0,5
2005,Cuba,CUB,Russian Federation,RUS,0,0,5,0,5
2005,Eritrea,ERI,Russian Federation,RUS,0,0,5,0,5
2005,Ethiopia,ETH,Russian Federation,RUS,0,0,16,0,16
2005,Georgia,GEO,Russian Federation,RUS,0,0,32,0,32
2005,Guinea,GIN,Russian Federation,RUS,0,0,5,0,5
2005,Iraq,IRQ,Russian Federation,RUS,5,0,14,0,19
2005,Kazakhstan,KAZ,Russian Federation,RUS,0,0,12,0,12
2005,Kyrgyzstan,KGZ,Russian Federation,RUS,0,0,11,0,11
2005,Rep. of Moldova,MDA,Russian Federation,RUS,0,0,5,0,5
2005,Nigeria,NGA,Russian Federation,RUS,0,0,5,0,5
2005,Rwanda,RWA,Russian Federation,RUS,5,0,0,0,5
2005,Somalia,SOM,Russian Federation,RUS,0,0,5,0,5
2005,Sudan,SDN,Russian Federation,RUS,0,0,5,0,5
2005,Tajikistan,TJK,Russian Federation,RUS,0,0,5,0,5
2005,Turkmenistan,TKM,Russian Federation,RUS,0,0,12,0,12
2005,Uzbekistan,UZB,Russian Federation,RUS,0,0,89,0,89
2005,Burundi,BDI,Rwanda,RWA,11,0,0,0,11
2005,Dem. Rep. of the Congo,COD,Rwanda,RWA,12,0,0,0,12
2005,Uganda,UGA,Rwanda,RWA,5,0,0,0,5
2005,Burundi,BDI,Senegal,SEN,0,0,5,0,5
2005,Central African Rep.,CAF,Senegal,SEN,0,0,5,0,5
2005,Chad,TCD,Senegal,SEN,0,0,11,0,11
2005,Congo,COG,Senegal,SEN,0,0,5,0,5
2005,Dem. Rep. of the Congo,COD,Senegal,SEN,0,0,33,0,33
2005,Gambia,GMB,Senegal,SEN,10,0,0,0,10
2005,Guinea,GIN,Senegal,SEN,5,0,15,0,20
2005,Cote d'Ivoire,CIV,Senegal,SEN,15,0,45,0,60
2005,Liberia,LBR,Senegal,SEN,16,0,38,0,54
2005,Sri Lanka,LKA,Senegal,SEN,0,0,5,0,5
2005,Mauritania,MRT,Senegal,SEN,0,0,15,0,15
2005,Nigeria,NGA,Senegal,SEN,0,0,5,0,5
2005,Rwanda,RWA,Senegal,SEN,0,0,5,0,5
2005,Sierra Leone,SLE,Senegal,SEN,0,0,25,0,25
2005,Togo,TGO,Senegal,SEN,0,0,18,0,18
2005,Afghanistan,AFG,Slovakia,SVK,0,0,40,79,119
2005,Armenia,ARM,Slovakia,SVK,0,0,5,12,17
2005,Azerbaijan,AZE,Slovakia,SVK,0,0,0,5,5
2005,Bangladesh,BGD,Slovakia,SVK,0,0,71,213,284
2005,Belarus,BLR,Slovakia,SVK,0,0,0,14,14
2005,Bulgaria,BGR,Slovakia,SVK,0,0,0,5,5
2005,China,CHN,Slovakia,SVK,0,0,123,263,386
2005,Cameroon,CMR,Slovakia,SVK,0,0,0,5,5
2005,Dem. Rep. of the Congo,COD,Slovakia,SVK,5,0,0,0,5
2005,Cuba,CUB,Slovakia,SVK,0,0,0,5,5
2005,Czechia,CZE,Slovakia,SVK,0,0,0,5,5
2005,Palestinian,PSE,Slovakia,SVK,0,0,25,56,81
2005,Georgia,GEO,Slovakia,SVK,0,0,42,230,272
2005,Ghana,GHA,Slovakia,SVK,0,0,5,0,5
2005,India,IND,Slovakia,SVK,0,0,93,392,485
2005,Iran (Islamic Rep. of),IRN,Slovakia,SVK,0,0,10,0,10
2005,Iraq,IRQ,Slovakia,SVK,0,0,22,28,50
2005,Israel,ISR,Slovakia,SVK,0,0,5,0,5
2005,Liberia,LBR,Slovakia,SVK,0,0,0,5,5
2005,Sri Lanka,LKA,Slovakia,SVK,0,0,10,0,10
2005,North Macedonia,MKD,Slovakia,SVK,0,0,0,5,5
2005,Rep. of Moldova,MDA,Slovakia,SVK,0,0,28,322,350
2005,Nigeria,NGA,Slovakia,SVK,0,0,0,24,24
2005,Pakistan,PAK,Slovakia,SVK,0,0,58,164,222
2005,Russian Federation,RUS,Slovakia,SVK,0,0,120,918,1038
2005,Serbia and Kosovo: S/RES/1244 (1999),SRB,Slovakia,SVK,5,0,18,18,41
2005,Senegal,SEN,Slovakia,SVK,0,0,0,5,5
2005,Somalia,SOM,Slovakia,SVK,0,0,5,15,20
2005,Viet Nam,VNM,Slovakia,SVK,0,0,65,46,111
2005,Sudan,SDN,Slovakia,SVK,0,0,0,5,5
2005,Syrian Arab Rep.,SYR,Slovakia,SVK,0,0,14,16,30
2005,Turkey,TUR,Slovakia,SVK,0,0,5,40,45
2005,Ukraine,UKR,Slovakia,SVK,12,0,32,15,59
2005,Stateless,XXA,Slovakia,SVK,0,0,0,10,10
2005,Afghanistan,AFG,Slovenia,SVN,0,0,5,5,10
2005,Albania,ALB,Slovenia,SVN,0,0,18,141,159
2005,Algeria,DZA,Slovenia,SVN,0,0,0,5,5
2005,Bangladesh,BGD,Slovenia,SVN,0,0,35,133,168
2005,Bosnia and Herzegovina,BIH,Slovenia,SVN,0,0,206,118,324
2005,Gambia,GMB,Slovenia,SVN,0,0,10,0,10
2005,Palestinian,PSE,Slovenia,SVN,0,0,0,5,5
2005,Georgia,GEO,Slovenia,SVN,0,0,14,0,14
2005,Croatia,HRV,Slovenia,SVN,0,0,5,0,5
2005,India,IND,Slovenia,SVN,0,0,0,33,33
2005,Iran (Islamic Rep. of),IRN,Slovenia,SVN,0,0,0,11,11
2005,Iraq,IRQ,Slovenia,SVN,0,0,0,14,14
2005,Liberia,LBR,Slovenia,SVN,0,0,10,0,10
2005,Sri Lanka,LKA,Slovenia,SVN,0,0,0,5,5
2005,North Macedonia,MKD,Slovenia,SVN,0,0,23,62,85
2005,Rep. of Moldova,MDA,Slovenia,SVN,0,0,24,38,62
2005,Mongolia,MNG,Slovenia,SVN,0,0,0,5,5
2005,Pakistan,PAK,Slovenia,SVN,0,0,10,16,26
2005,Romania,ROU,Slovenia,SVN,0,0,0,11,11
2005,Russian Federation,RUS,Slovenia,SVN,0,0,5,10,15
2005,Serbia and Kosovo: S/RES/1244 (1999),SRB,Slovenia,SVN,10,10,301,376,697
2005,Tunisia,TUN,Slovenia,SVN,0,0,5,0,5
2005,Turkey,TUR,Slovenia,SVN,0,0,17,232,249
2005,Ukraine,UKR,Slovenia,SVN,0,0,0,5,5
2005,Uzbekistan,UZB,Slovenia,SVN,0,0,0,5,5
2005,Congo,COG,Eswatini,SWZ,0,0,0,13,13
2005,Dem. Rep. of the Congo,COD,Eswatini,SWZ,0,0,0,10,10
2005,Liberia,LBR,Eswatini,SWZ,0,0,0,10,10
2005,Sierra Leone,SLE,Eswatini,SWZ,0,0,0,5,5
2005,Somalia,SOM,Eswatini,SWZ,0,0,0,17,17
2005,Afghanistan,AFG,Sweden,SWE,0,121,565,57,743
2005,Albania,ALB,Sweden,SWE,0,5,147,20,172
2005,Algeria,DZA,Sweden,SWE,0,10,183,52,245
2005,Angola,AGO,Sweden,SWE,0,5,61,5,71
2005,Egypt,EGY,Sweden,SWE,0,0,65,5,70
2005,Armenia,ARM,Sweden,SWE,0,37,274,59,370
2005,Azerbaijan,AZE,Sweden,SWE,5,35,693,75,808
2005,Bahrain,BHR,Sweden,SWE,0,0,5,0,5
2005,Burundi,BDI,Sweden,SWE,0,402,43,5,450
2005,Belgium,BEL,Sweden,SWE,5,0,0,0,5
2005,Benin,BEN,Sweden,SWE,0,0,5,0,5
2005,Bangladesh,BGD,Sweden,SWE,0,5,117,19,141
2005,Belarus,BLR,Sweden,SWE,0,13,380,71,464
2005,Bolivia (Plurinational State of),BOL,Sweden,SWE,0,0,279,28,307
2005,Bosnia and Herzegovina,BIH,Sweden,SWE,0,21,334,43,398
2005,Bulgaria,BGR,Sweden,SWE,0,0,747,118,865
2005,Canada,CAN,Sweden,SWE,0,0,5,0,5
2005,China,CHN,Sweden,SWE,5,0,68,92,165
2005,Chile,CHL,Sweden,SWE,0,0,13,0,13
2005,Cameroon,CMR,Sweden,SWE,0,5,44,16,65
2005,Congo,COG,Sweden,SWE,0,5,14,0,19
2005,Dem. Rep. of the Congo,COD,Sweden,SWE,0,21,73,11,105
2005,Colombia,COL,Sweden,SWE,0,0,25,0,25
2005,Cuba,CUB,Sweden,SWE,0,5,16,0,21
2005,Ecuador,ECU,Sweden,SWE,0,0,27,13,40
2005,Eritrea,ERI,Sweden,SWE,22,205,210,27,464
2005,Estonia,EST,Sweden,SWE,0,0,5,0,5
2005,Ethiopia,ETH,Sweden,SWE,0,18,115,10,143
2005,Gambia,GMB,Sweden,SWE,0,0,14,0,14
2005,United Kingdom of Great Britain and Northern Ireland,GBR,Sweden,SWE,0,0,5,0,5
2005,Georgia,GEO,Sweden,SWE,0,5,197,40,242
2005,Ghana,GHA,Sweden,SWE,0,0,15,0,15
2005,Guinea,GIN,Sweden,SWE,0,0,47,5,52
2005,Honduras,HND,Sweden,SWE,0,0,11,0,11
2005,Croatia,HRV,Sweden,SWE,0,0,85,5,90
2005,Cote d'Ivoire,CIV,Sweden,SWE,0,5,43,5,53
2005,India,IND,Sweden,SWE,0,5,79,37,121
2005,Indonesia,IDN,Sweden,SWE,0,0,5,0,5
2005,Iran (Islamic Rep. of),IRN,Sweden,SWE,40,44,442,84,610
2005,Iraq,IRQ,Sweden,SWE,15,465,1597,214,2291
2005,Israel,ISR,Sweden,SWE,5,0,38,0,43
2005,Jordan,JOR,Sweden,SWE,0,11,111,15,137
2005,Kazakhstan,KAZ,Sweden,SWE,0,13,122,16,151
2005,Kenya,KEN,Sweden,SWE,0,5,25,0,30
2005,Kyrgyzstan,KGZ,Sweden,SWE,0,5,73,10,88
2005,Rep. of Korea,KOR,Sweden,SWE,5,0,0,0,5
2005,Dem. People's Rep. of Korea,PRK,Sweden,SWE,5,0,0,0,5
2005,Kuwait,KWT,Sweden,SWE,5,0,5,0,10
2005,Lao People's Dem. Rep.,LAO,Sweden,SWE,0,0,10,0,10
2005,Liberia,LBR,Sweden,SWE,0,5,28,15,48
2005,Libya,LBY,Sweden,SWE,0,11,415,77,503
2005,Lebanon,LBN,Sweden,SWE,0,16,237,53,306
2005,Sri Lanka,LKA,Sweden,SWE,0,0,11,5,16
2005,Lithuania,LTU,Sweden,SWE,0,0,12,5,17
2005,Latvia,LVA,Sweden,SWE,0,0,0,5,5
2005,North Macedonia,MKD,Sweden,SWE,0,5,135,28,168
2005,Rep. of Moldova,MDA,Sweden,SWE,0,0,67,34,101
2005,Mali,MLI,Sweden,SWE,0,0,5,0,5
2005,Malaysia,MYS,Sweden,SWE,0,0,0,5,5
2005,Mongolia,MNG,Sweden,SWE,0,0,253,19,272
2005,Morocco,MAR,Sweden,SWE,0,5,26,16,47
2005,Myanmar,MMR,Sweden,SWE,0,0,14,0,14
2005,Nepal,NPL,Sweden,SWE,0,0,36,0,36
2005,Niger,NER,Sweden,SWE,0,0,5,0,5
2005,Nigeria,NGA,Sweden,SWE,0,10,213,41,264
2005,Pakistan,PAK,Sweden,SWE,0,5,46,14,65
2005,Panama,PAN,Sweden,SWE,0,0,5,0,5
2005,Peru,PER,Sweden,SWE,0,5,24,5,34
2005,Philippines,PHL,Sweden,SWE,0,0,5,0,5
2005,Poland,POL,Sweden,SWE,0,0,0,10,10
2005,Romania,ROU,Sweden,SWE,0,0,89,37,126
2005,Russian Federation,RUS,Sweden,SWE,5,88,939,170,1202
2005,Rwanda,RWA,Sweden,SWE,0,0,27,0,27
2005,El Salvador,SLV,Sweden,SWE,0,0,12,0,12
2005,Saudi Arabia,SAU,Sweden,SWE,0,0,0,5,5
2005,Serbia and Kosovo: S/RES/1244 (1999),SRB,Sweden,SWE,107,206,2534,378,3225
2005,Senegal,SEN,Sweden,SWE,0,0,5,0,5
2005,Sierra Leone,SLE,Sweden,SWE,0,5,29,5,39
2005,Somalia,SOM,Sweden,SWE,87,336,819,89,1331
2005,Viet Nam,VNM,Sweden,SWE,0,0,42,14,56
2005,Sudan,SDN,Sweden,SWE,0,10,44,17,71
2005,Slovakia,SVK,Sweden,SWE,0,0,5,5,10
2005,Syrian Arab Rep.,SYR,Sweden,SWE,5,34,251,43,333
2005,United Rep. of Tanzania,TZA,Sweden,SWE,0,0,12,0,12
2005,Thailand,THA,Sweden,SWE,0,0,5,0,5
2005,Tajikistan,TJK,Sweden,SWE,0,0,42,5,47
2005,Turkmenistan,TKM,Sweden,SWE,0,0,24,10,34
2005,Togo,TGO,Sweden,SWE,0,0,12,0,12
2005,Tunisia,TUN,Sweden,SWE,0,5,47,11,63
2005,Turkey,TUR,Sweden,SWE,5,31,366,43,445
2005,Uganda,UGA,Sweden,SWE,0,5,16,5,26
2005,Ukraine,UKR,Sweden,SWE,0,0,114,32,146
2005,United States of America,USA,Sweden,SWE,0,0,5,0,5
2005,Uzbekistan,UZB,Sweden,SWE,0,68,91,32,191
2005,Venezuela (Bolivarian Republic of),VEN,Sweden,SWE,0,0,5,0,5
2005,Yemen,YEM,Sweden,SWE,0,5,33,5,43
2005,Zimbabwe,ZWE,Sweden,SWE,0,0,5,0,5
2005,Stateless,XXA,Sweden,SWE,5,168,1133,158,1464
2005,Afghanistan,AFG,Switzerland,CHE,39,144,176,42,401
2005,Albania,ALB,Switzerland,CHE,0,5,18,32,55
2005,Algeria,DZA,Switzerland,CHE,26,18,79,142,265
2005,Angola,AGO,Switzerland,CHE,0,266,146,31,443
2005,Egypt,EGY,Switzerland,CHE,5,0,0,5,10
2005,Armenia,ARM,Switzerland,CHE,0,27,146,46,219
2005,Azerbaijan,AZE,Switzerland,CHE,10,0,34,23,67
2005,Burundi,BDI,Switzerland,CHE,5,15,14,5,39
2005,Benin,BEN,Switzerland,CHE,5,0,13,5,23
2005,Bangladesh,BGD,Switzerland,CHE,0,0,63,24,87
2005,Burkina Faso,BFA,Switzerland,CHE,0,0,10,0,10
2005,Belarus,BLR,Switzerland,CHE,0,5,57,45,107
2005,Bosnia and Herzegovina,BIH,Switzerland,CHE,44,310,140,112,606
2005,Bulgaria,BGR,Switzerland,CHE,0,0,199,320,519
2005,Cambodia,KHM,Switzerland,CHE,14,0,0,0,14
2005,Chad,TCD,Switzerland,CHE,0,0,5,0,5
2005,China,CHN,Switzerland,CHE,56,49,73,39,217
2005,Cameroon,CMR,Switzerland,CHE,5,10,114,55,184
2005,Congo,COG,Switzerland,CHE,0,10,12,0,22
2005,Dem. Rep. of the Congo,COD,Switzerland,CHE,22,262,242,60,586
2005,Colombia,COL,Switzerland,CHE,40,5,5,5,55
2005,Cuba,CUB,Switzerland,CHE,0,13,0,0,13
2005,Czechia,CZE,Switzerland,CHE,0,0,0,5,5
2005,Ecuador,ECU,Switzerland,CHE,0,0,0,5,5
2005,Eritrea,ERI,Switzerland,CHE,12,69,150,20,251
2005,Ethiopia,ETH,Switzerland,CHE,10,54,96,21,181
2005,France,FRA,Switzerland,CHE,0,0,0,5,5
2005,Gabon,GAB,Switzerland,CHE,0,0,0,5,5
2005,Gambia,GMB,Switzerland,CHE,0,0,0,12,12
2005,Georgia,GEO,Switzerland,CHE,0,22,206,233,461
2005,Germany,DEU,Switzerland,CHE,0,0,0,10,10
2005,Ghana,GHA,Switzerland,CHE,0,0,0,5,5
2005,Guinea-Bissau,GNB,Switzerland,CHE,0,5,12,14,31
2005,Guinea,GIN,Switzerland,CHE,5,14,111,113,243
2005,Haiti,HTI,Switzerland,CHE,0,0,0,5,5
2005,Croatia,HRV,Switzerland,CHE,5,0,0,14,19
2005,Hungary,HUN,Switzerland,CHE,0,0,0,5,5
2005,Cote d'Ivoire,CIV,Switzerland,CHE,16,10,125,57,208
2005,India,IND,Switzerland,CHE,0,10,25,48,83
2005,Iran (Islamic Rep. of),IRN,Switzerland,CHE,53,161,275,43,532
2005,Iraq,IRQ,Switzerland,CHE,140,958,1247,290,2635
2005,Israel,ISR,Switzerland,CHE,0,0,0,10,10
2005,Jordan,JOR,Switzerland,CHE,0,0,0,11,11
2005,Kazakhstan,KAZ,Switzerland,CHE,0,5,12,0,17
2005,Kenya,KEN,Switzerland,CHE,0,0,13,0,13
2005,Kyrgyzstan,KGZ,Switzerland,CHE,0,5,5,0,10
2005,Lao People's Dem. Rep.,LAO,Switzerland,CHE,5,0,0,0,5
2005,Liberia,LBR,Switzerland,CHE,5,12,53,25,95
2005,Libya,LBY,Switzerland,CHE,33,0,17,10,60
2005,Lebanon,LBN,Switzerland,CHE,0,5,10,38,53
2005,Sri Lanka,LKA,Switzerland,CHE,58,116,131,64,369
2005,Lithuania,LTU,Switzerland,CHE,0,0,0,14,14
2005,Latvia,LVA,Switzerland,CHE,0,0,0,10,10
2005,Madagascar,MDG,Switzerland,CHE,0,0,5,0,5
2005,Mauritania,MRT,Switzerland,CHE,0,0,10,10,20
2005,North Macedonia,MKD,Switzerland,CHE,0,25,48,102,175
2005,Rep. of Moldova,MDA,Switzerland,CHE,0,5,23,46,74
2005,Maldives,MDV,Switzerland,CHE,5,0,0,0,5
2005,Mali,MLI,Switzerland,CHE,0,0,13,19,32
2005,Mongolia,MNG,Switzerland,CHE,0,5,37,40,82
2005,Morocco,MAR,Switzerland,CHE,5,0,5,18,28
2005,Myanmar,MMR,Switzerland,CHE,0,14,0,0,14
2005,Nepal,NPL,Switzerland,CHE,0,5,10,19,34
2005,Niger,NER,Switzerland,CHE,0,5,5,13,23
2005,Nigeria,NGA,Switzerland,CHE,5,18,140,111,274
2005,Pakistan,PAK,Switzerland,CHE,5,13,80,35,133
2005,Poland,POL,Switzerland,CHE,0,0,0,5,5
2005,Romania,ROU,Switzerland,CHE,0,0,25,67,92
2005,South Africa,ZAF,Switzerland,CHE,0,0,5,0,5
2005,Russian Federation,RUS,Switzerland,CHE,19,77,259,160,515
2005,Rwanda,RWA,Switzerland,CHE,21,5,5,5,36
2005,Serbia and Kosovo: S/RES/1244 (1999),SRB,Switzerland,CHE,78,792,800,593,2263
2005,Senegal,SEN,Switzerland,CHE,0,0,13,19,32
2005,Sierra Leone,SLE,Switzerland,CHE,0,5,23,21,49
2005,Somalia,SOM,Switzerland,CHE,19,517,431,42,1009
2005,Viet Nam,VNM,Switzerland,CHE,40,5,10,0,55
2005,Sudan,SDN,Switzerland,CHE,10,14,46,32,102
2005,Slovakia,SVK,Switzerland,CHE,0,0,5,0,5
2005,Syrian Arab Rep.,SYR,Switzerland,CHE,23,140,112,60,335
2005,United Rep. of Tanzania,TZA,Switzerland,CHE,0,0,12,0,12
2005,Tajikistan,TJK,Switzerland,CHE,0,0,5,0,5
2005,Turkmenistan,TKM,Switzerland,CHE,0,0,5,5,10
2005,Togo,TGO,Switzerland,CHE,117,0,43,16,176
2005,Tunisia,TUN,Switzerland,CHE,71,0,22,33,126
2005,Turkey,TUR,Switzerland,CHE,433,138,470,203,1244
2005,Uganda,UGA,Switzerland,CHE,0,0,5,5,10
2005,Ukraine,UKR,Switzerland,CHE,0,11,32,33,76
2005,United States of America,USA,Switzerland,CHE,0,0,0,5,5
2005,Uzbekistan,UZB,Switzerland,CHE,0,0,0,5,5
2005,Western Sahara,ESH,Switzerland,CHE,0,0,0,5,5
2005,Yemen,YEM,Switzerland,CHE,10,10,15,0,35
2005,Zimbabwe,ZWE,Switzerland,CHE,0,0,17,15,32
2005,Stateless,XXA,Switzerland,CHE,13,61,170,405,649
2005,Ethiopia,ETH,United Rep. of Tanzania,TZA,0,0,0,5,5
2005,Rwanda,RWA,United Rep. of Tanzania,TZA,0,0,5,0,5
2005,Myanmar,MMR,Thailand,THA,0,14619,17,0,14636
2005,Dem. Rep. of the Congo,COD,Togo,TGO,12,0,32,0,44
2005,Cote d'Ivoire,CIV,Togo,TGO,24,0,0,0,24
2005,Afghanistan,AFG,Ukraine,UKR,27,0,130,79,236
2005,Algeria,DZA,Ukraine,UKR,0,0,0,5,5
2005,Angola,AGO,Ukraine,UKR,0,0,14,0,14
2005,Armenia,ARM,Ukraine,UKR,0,0,15,13,28
2005,Azerbaijan,AZE,Ukraine,UKR,0,0,5,23,28
2005,Bangladesh,BGD,Ukraine,UKR,0,0,10,136,146
2005,Burkina Faso,BFA,Ukraine,UKR,0,0,0,5,5
2005,Belarus,BLR,Ukraine,UKR,0,0,0,5,5
2005,Cameroon,CMR,Ukraine,UKR,0,0,0,5,5
2005,Congo,COG,Ukraine,UKR,0,0,5,0,5
2005,Dem. Rep. of the Congo,COD,Ukraine,UKR,0,0,5,5,10
2005,Cuba,CUB,Ukraine,UKR,0,0,0,5,5
2005,Ethiopia,ETH,Ukraine,UKR,0,0,5,5,10
2005,Palestinian,PSE,Ukraine,UKR,0,0,33,73,106
2005,Georgia,GEO,Ukraine,UKR,5,0,0,14,19
2005,Cote d'Ivoire,CIV,Ukraine,UKR,5,0,0,0,5
2005,India,IND,Ukraine,UKR,0,0,5,308,313
2005,Iran (Islamic Rep. of),IRN,Ukraine,UKR,5,0,13,10,28
2005,Iraq,IRQ,Ukraine,UKR,5,0,27,89,121
2005,Kazakhstan,KAZ,Ukraine,UKR,0,0,0,10,10
2005,Liberia,LBR,Ukraine,UKR,0,0,0,5,5
2005,Lebanon,LBN,Ukraine,UKR,0,0,0,5,5
2005,Sri Lanka,LKA,Ukraine,UKR,0,0,5,5,10
2005,Rep. of Moldova,MDA,Ukraine,UKR,0,0,0,5,5
2005,Nigeria,NGA,Ukraine,UKR,0,0,0,11,11
2005,Pakistan,PAK,Ukraine,UKR,0,0,5,135,140
2005,Russian Federation,RUS,Ukraine,UKR,0,0,43,110,153
2005,Somalia,SOM,Ukraine,UKR,5,0,16,5,26
2005,Sudan,SDN,Ukraine,UKR,0,0,5,12,17
2005,Syrian Arab Rep.,SYR,Ukraine,UKR,0,0,13,13,26
2005,Tajikistan,TJK,Ukraine,UKR,0,0,0,5,5
2005,Uganda,UGA,Ukraine,UKR,0,0,0,5,5
2005,Uzbekistan,UZB,Ukraine,UKR,0,0,5,0,5
2005,Stateless,XXA,Ukraine,UKR,0,0,5,5,10
2005,Colombia,COL,Uruguay,URY,17,0,0,0,17
2005,Nigeria,NGA,Uruguay,URY,5,0,0,0,5
2005,Peru,PER,Uruguay,URY,5,0,0,0,5
2005,Colombia,COL,Venezuela (Bolivarian Republic of),VEN,195,0,240,0,435
2005,Haiti,HTI,Venezuela (Bolivarian Republic of),VEN,5,0,0,0,5
2006,Armenia,ARM,Argentina,ARG,0,0,5,0,5
2006,Cameroon,CMR,Argentina,ARG,0,0,5,0,5
2006,Congo,COG,Argentina,ARG,5,0,0,0,5
2006,Colombia,COL,Argentina,ARG,12,0,15,0,27
2006,Cuba,CUB,Argentina,ARG,5,0,12,0,17
2006,Ghana,GHA,Argentina,ARG,5,0,0,0,5
2006,Guinea,GIN,Argentina,ARG,5,0,0,0,5
2006,India,IND,Argentina,ARG,5,0,0,0,5
2006,Liberia,LBR,Argentina,ARG,5,0,0,0,5
2006,Nigeria,NGA,Argentina,ARG,5,0,5,0,10
2006,Paraguay,PRY,Argentina,ARG,0,0,5,0,5
2006,Peru,PER,Argentina,ARG,15,0,63,5,83
2006,Russian Federation,RUS,Argentina,ARG,0,0,10,0,10
2006,Senegal,SEN,Argentina,ARG,0,0,118,0,118
2006,Iran (Islamic Rep. of),IRN,Armenia,ARM,5,0,5,0,10
2006,Iraq,IRQ,Armenia,ARM,0,239,0,5,244
2006,Israel,ISR,Armenia,ARM,0,5,0,55,60
2006,Lebanon,LBN,Armenia,ARM,0,14,0,267,281
2006,Syrian Arab Rep.,SYR,Armenia,ARM,0,0,5,0,5
2006,Turkey,TUR,Armenia,ARM,5,0,0,0,5
2006,Afghanistan,AFG,Australia,AUS,10,0,0,0,10
2006,Albania,ALB,Australia,AUS,0,0,12,0,12
2006,Egypt,EGY,Australia,AUS,5,0,42,0,47
2006,Argentina,ARG,Australia,AUS,0,0,5,0,5
2006,Bahrain,BHR,Australia,AUS,0,0,17,0,17
2006,Bangladesh,BGD,Australia,AUS,15,0,44,0,59
2006,Cambodia,KHM,Australia,AUS,0,0,10,0,10
2006,China,CHN,Australia,AUS,87,0,949,12,1048
2006,Cameroon,CMR,Australia,AUS,5,0,10,0,15
2006,Congo,COG,Australia,AUS,5,0,0,0,5
2006,Colombia,COL,Australia,AUS,5,0,12,0,17
2006,Eritrea,ERI,Australia,AUS,10,0,0,0,10
2006,Ethiopia,ETH,Australia,AUS,13,0,17,0,30
2006,Fiji,FJI,Australia,AUS,0,0,27,5,32
2006,France,FRA,Australia,AUS,5,0,0,0,5
2006,Palestinian,PSE,Australia,AUS,13,0,0,0,13
2006,United Kingdom of Great Britain and Northern Ireland,GBR,Australia,AUS,0,0,11,0,11
2006,Ghana,GHA,Australia,AUS,0,0,10,0,10
2006,"China, Hong Kong SAR",HKG,Australia,AUS,0,0,16,0,16
2006,India,IND,Australia,AUS,0,0,310,5,315
2006,Indonesia,IDN,Australia,AUS,56,0,247,0,303
2006,Iran (Islamic Rep. of),IRN,Australia,AUS,45,0,19,0,64
2006,Iraq,IRQ,Australia,AUS,118,0,5,15,138
2006,Israel,ISR,Australia,AUS,10,0,14,0,24
2006,Italy,ITA,Australia,AUS,0,0,5,0,5
2006,Jordan,JOR,Australia,AUS,0,0,5,0,5
2006,Japan,JPN,Australia,AUS,0,0,5,0,5
2006,Rep. of Korea,KOR,Australia,AUS,0,0,95,5,100
2006,Dem. People's Rep. of Korea,PRK,Australia,AUS,0,0,5,0,5
2006,Lebanon,LBN,Australia,AUS,5,0,51,5,61
2006,Sri Lanka,LKA,Australia,AUS,160,0,103,0,263
2006,Latvia,LVA,Australia,AUS,0,0,5,0,5
2006,North Macedonia,MKD,Australia,AUS,0,0,5,0,5
2006,Malaysia,MYS,Australia,AUS,0,0,109,5,114
2006,Mongolia,MNG,Australia,AUS,0,0,15,0,15
2006,Morocco,MAR,Australia,AUS,5,0,5,0,10
2006,Myanmar,MMR,Australia,AUS,11,0,13,0,24
2006,Nepal,NPL,Australia,AUS,5,0,36,0,41
2006,Nigeria,NGA,Australia,AUS,5,0,28,0,33
2006,Pakistan,PAK,Australia,AUS,39,0,57,0,96
2006,Philippines,PHL,Australia,AUS,0,0,73,0,73
2006,Papua New Guinea,PNG,Australia,AUS,0,0,20,0,20
2006,Portugal,PRT,Australia,AUS,0,0,0,12,12
2006,South Africa,ZAF,Australia,AUS,0,0,10,0,10
2006,Russian Federation,RUS,Australia,AUS,5,0,14,0,19
2006,Singapore,SGP,Australia,AUS,0,0,5,0,5
2006,Sierra Leone,SLE,Australia,AUS,16,0,0,0,16
2006,Solomon Islands,SLB,Australia,AUS,11,0,5,0,16
2006,Somalia,SOM,Australia,AUS,5,0,0,0,5
2006,Viet Nam,VNM,Australia,AUS,0,0,27,0,27
2006,Slovenia,SVN,Australia,AUS,0,0,5,0,5
2006,Syrian Arab Rep.,SYR,Australia,AUS,5,0,0,0,5
2006,Thailand,THA,Australia,AUS,0,0,38,0,38
2006,Timor-Leste,TLS,Australia,AUS,0,0,10,0,10
2006,Tonga,TON,Australia,AUS,0,0,5,0,5
2006,Turkey,TUR,Australia,AUS,5,0,17,0,22
2006,Uganda,UGA,Australia,AUS,0,0,5,0,5
2006,Ukraine,UKR,Australia,AUS,0,0,11,0,11
2006,Uruguay,URY,Australia,AUS,0,0,5,0,5
2006,Uzbekistan,UZB,Australia,AUS,0,0,5,0,5
2006,Zimbabwe,ZWE,Australia,AUS,24,0,11,0,35
2006,Stateless,XXA,Australia,AUS,5,0,5,0,10
2006,Afghanistan,AFG,Azerbaijan,AZE,5,0,111,25,141
2006,Algeria,DZA,Azerbaijan,AZE,0,0,5,0,5
2006,Palestinian,PSE,Azerbaijan,AZE,0,0,5,0,5
2006,Georgia,GEO,Azerbaijan,AZE,0,0,5,0,5
2006,India,IND,Azerbaijan,AZE,0,0,5,0,5
2006,Iran (Islamic Rep. of),IRN,Azerbaijan,AZE,24,0,53,12,89
2006,Iraq,IRQ,Azerbaijan,AZE,0,0,19,0,19
2006,Pakistan,PAK,Azerbaijan,AZE,0,0,33,0,33
2006,Syrian Arab Rep.,SYR,Azerbaijan,AZE,0,0,5,0,5
2006,Dem. Rep. of the Congo,COD,Burundi,BDI,825,0,805,3156,4786
2006,Afghanistan,AFG,Belgium,BEL,5,0,20,5,30
2006,Albania,ALB,Belgium,BEL,10,0,24,58,92
2006,Algeria,DZA,Belgium,BEL,5,0,27,5,37
2006,Angola,AGO,Belgium,BEL,15,0,150,12,177
2006,Egypt,EGY,Belgium,BEL,0,0,15,0,15
2006,Armenia,ARM,Belgium,BEL,11,0,154,39,204
2006,Azerbaijan,AZE,Belgium,BEL,5,0,31,18,54
2006,Burundi,BDI,Belgium,BEL,41,0,146,45,232
2006,Benin,BEN,Belgium,BEL,0,0,13,0,13
2006,Bangladesh,BGD,Belgium,BEL,0,0,11,5,16
2006,Bhutan,BTN,Belgium,BEL,0,0,5,14,19
2006,Burkina Faso,BFA,Belgium,BEL,5,0,5,12,22
2006,Belarus,BLR,Belgium,BEL,50,0,54,32,136
2006,Bosnia and Herzegovina,BIH,Belgium,BEL,11,0,12,5,28
2006,Bulgaria,BGR,Belgium,BEL,0,0,11,0,11
2006,Central African Rep.,CAF,Belgium,BEL,0,0,5,12,17
2006,Chad,TCD,Belgium,BEL,10,0,17,5,32
2006,China,CHN,Belgium,BEL,56,0,36,5,97
2006,Cameroon,CMR,Belgium,BEL,23,0,207,5,235
2006,Congo,COG,Belgium,BEL,16,0,37,24,77
2006,Dem. Rep. of the Congo,COD,Belgium,BEL,295,0,725,165,1185
2006,Colombia,COL,Belgium,BEL,0,0,13,0,13
2006,Czechia,CZE,Belgium,BEL,0,0,0,5,5
2006,Djibouti,DJI,Belgium,BEL,16,0,38,27,81
2006,Equatorial Guinea,GNQ,Belgium,BEL,0,0,5,0,5
2006,Eritrea,ERI,Belgium,BEL,5,0,14,5,24
2006,Ethiopia,ETH,Belgium,BEL,10,0,36,15,61
2006,Gabon,GAB,Belgium,BEL,14,0,0,5,19
2006,Gambia,GMB,Belgium,BEL,5,0,0,0,5
2006,Palestinian,PSE,Belgium,BEL,0,0,14,10,24
2006,Georgia,GEO,Belgium,BEL,0,0,35,11,46
2006,Guinea-Bissau,GNB,Belgium,BEL,0,0,5,0,5
2006,Guinea,GIN,Belgium,BEL,114,0,346,29,489
2006,Haiti,HTI,Belgium,BEL,5,0,0,0,5
2006,Croatia,HRV,Belgium,BEL,5,0,0,5,10
2006,Cote d'Ivoire,CIV,Belgium,BEL,123,0,287,53,463
2006,India,IND,Belgium,BEL,0,0,5,5,10
2006,Iran (Islamic Rep. of),IRN,Belgium,BEL,46,0,143,73,262
2006,Iraq,IRQ,Belgium,BEL,43,5,316,157,521
2006,Israel,ISR,Belgium,BEL,0,0,13,11,24
2006,Jordan,JOR,Belgium,BEL,0,0,5,0,5
2006,Kazakhstan,KAZ,Belgium,BEL,5,0,10,18,33
2006,Kenya,KEN,Belgium,BEL,0,0,14,0,14
2006,Kyrgyzstan,KGZ,Belgium,BEL,0,0,21,10,31
2006,Liberia,LBR,Belgium,BEL,0,0,81,12,93
2006,Libya,LBY,Belgium,BEL,0,0,10,0,10
2006,Lebanon,LBN,Belgium,BEL,0,0,17,5,22
2006,Sri Lanka,LKA,Belgium,BEL,0,0,17,5,22
2006,Mauritania,MRT,Belgium,BEL,35,0,216,58,309
2006,North Macedonia,MKD,Belgium,BEL,0,0,15,10,25
2006,Rep. of Moldova,MDA,Belgium,BEL,0,0,0,5,5
2006,Mali,MLI,Belgium,BEL,0,0,5,5,10
2006,Malawi,MWI,Belgium,BEL,0,0,5,0,5
2006,Mongolia,MNG,Belgium,BEL,0,0,5,0,5
2006,Morocco,MAR,Belgium,BEL,0,0,11,0,11
2006,Montenegro,MNE,Belgium,BEL,0,0,0,12,12
2006,Myanmar,MMR,Belgium,BEL,5,0,0,11,16
2006,Nepal,NPL,Belgium,BEL,5,0,128,10,143
2006,Niger,NER,Belgium,BEL,10,0,106,25,141
2006,Nigeria,NGA,Belgium,BEL,5,0,18,5,28
2006,Pakistan,PAK,Belgium,BEL,0,0,61,11,72
2006,Romania,ROU,Belgium,BEL,0,0,5,0,5
2006,Russian Federation,RUS,Belgium,BEL,442,0,366,88,896
2006,Rwanda,RWA,Belgium,BEL,281,0,281,46,608
2006,Serbia and Kosovo: S/RES/1244 (1999),SRB,Belgium,BEL,87,0,104,168,359
2006,Senegal,SEN,Belgium,BEL,0,0,0,12,12
2006,Sierra Leone,SLE,Belgium,BEL,5,0,51,42,98
2006,Somalia,SOM,Belgium,BEL,22,0,34,17,73
2006,Viet Nam,VNM,Belgium,BEL,0,0,5,0,5
2006,Sudan,SDN,Belgium,BEL,5,0,33,5,43
2006,Slovakia,SVK,Belgium,BEL,0,0,0,14,14
2006,Syrian Arab Rep.,SYR,Belgium,BEL,5,0,57,14,76
2006,Togo,TGO,Belgium,BEL,20,0,144,5,169
2006,Tunisia,TUN,Belgium,BEL,0,0,5,0,5
2006,Turkey,TUR,Belgium,BEL,10,0,93,19,122
2006,Uganda,UGA,Belgium,BEL,5,0,16,5,26
2006,Ukraine,UKR,Belgium,BEL,0,0,16,18,34
2006,Uzbekistan,UZB,Belgium,BEL,5,0,23,31,59
2006,Zimbabwe,ZWE,Belgium,BEL,5,0,5,0,10
2006,Stateless,XXA,Belgium,BEL,0,0,5,0,5
2006,Angola,AGO,Benin,BEN,0,0,0,5,5
2006,Burundi,BDI,Benin,BEN,5,0,0,0,5
2006,Burkina Faso,BFA,Benin,BEN,0,0,0,10,10
2006,Central African Rep.,CAF,Benin,BEN,0,0,5,21,26
2006,Chad,TCD,Benin,BEN,26,0,5,77,108
2006,Cameroon,CMR,Benin,BEN,5,0,10,36,51
2006,Congo,COG,Benin,BEN,10,0,39,51,100
2006,Dem. Rep. of the Congo,COD,Benin,BEN,40,0,222,262,524
2006,Comoros,COM,Benin,BEN,0,0,0,5,5
2006,Guinea,GIN,Benin,BEN,5,0,0,0,5
2006,Cote d'Ivoire,CIV,Benin,BEN,53,0,26,164,243
2006,Liberia,LBR,Benin,BEN,0,0,0,48,48
2006,Mauritania,MRT,Benin,BEN,0,0,0,5,5
2006,Nigeria,NGA,Benin,BEN,21,0,71,40,132
2006,Rwanda,RWA,Benin,BEN,5,0,0,0,5
2006,Sierra Leone,SLE,Benin,BEN,0,0,0,5,5
2006,Somalia,SOM,Benin,BEN,0,0,0,5,5
2006,Sudan,SDN,Benin,BEN,0,0,0,30,30
2006,Togo,TGO,Benin,BEN,53,0,53,22,128
2006,Benin,BEN,Burkina Faso,BFA,0,0,0,5,5
2006,Central African Rep.,CAF,Burkina Faso,BFA,0,0,0,5,5
2006,Guinea,GIN,Burkina Faso,BFA,0,0,0,10,10
2006,Cote d'Ivoire,CIV,Burkina Faso,BFA,0,0,0,52,52
2006,Iran (Islamic Rep. of),IRN,Burkina Faso,BFA,0,0,0,5,5
2006,Liberia,LBR,Burkina Faso,BFA,0,0,0,89,89
2006,Sierra Leone,SLE,Burkina Faso,BFA,0,0,0,10,10
2006,Togo,TGO,Burkina Faso,BFA,0,0,0,62,62
2006,Afghanistan,AFG,Belarus,BLR,0,10,38,10,58
2006,Armenia,ARM,Belarus,BLR,0,0,5,0,5
2006,Georgia,GEO,Belarus,BLR,10,0,10,0,20
2006,Iraq,IRQ,Belarus,BLR,0,0,10,0,10
2006,Israel,ISR,Belarus,BLR,0,0,5,0,5
2006,Poland,POL,Belarus,BLR,0,0,0,5,5
2006,Ukraine,UKR,Belarus,BLR,0,0,5,5,10
2006,Colombia,COL,Bolivia (Plurinational State of),BOL,24,0,0,5,29
2006,Peru,PER,Bolivia (Plurinational State of),BOL,5,0,0,0,5
2006,Burundi,BDI,Botswana,BWA,10,0,0,0,10
2006,Dem. Rep. of the Congo,COD,Botswana,BWA,5,0,0,5,10
2006,Namibia,NAM,Botswana,BWA,5,0,0,0,5
2006,Rwanda,RWA,Botswana,BWA,10,0,0,0,10
2006,Somalia,SOM,Botswana,BWA,10,0,0,0,10
2006,Zimbabwe,ZWE,Botswana,BWA,18,0,0,0,18
2006,Angola,AGO,Brazil,BRA,13,0,25,11,49
2006,Argentina,ARG,Brazil,BRA,0,0,0,5,5
2006,Burundi,BDI,Brazil,BRA,5,0,5,0,10
2006,Cameroon,CMR,Brazil,BRA,0,0,10,0,10
2006,Dem. Rep. of the Congo,COD,Brazil,BRA,55,0,17,5,77
2006,Colombia,COL,Brazil,BRA,75,5,26,10,116
2006,Cuba,CUB,Brazil,BRA,5,0,52,5,62
2006,Ecuador,ECU,Brazil,BRA,0,0,5,0,5
2006,Eritrea,ERI,Brazil,BRA,5,0,0,0,5
2006,Ethiopia,ETH,Brazil,BRA,12,0,0,0,12
2006,Palestinian,PSE,Brazil,BRA,0,0,5,0,5
2006,Guinea-Bissau,GNB,Brazil,BRA,0,0,10,0,10
2006,Guinea,GIN,Brazil,BRA,0,0,5,0,5
2006,Cote d'Ivoire,CIV,Brazil,BRA,0,0,5,0,5
2006,Iran (Islamic Rep. of),IRN,Brazil,BRA,5,0,0,0,5
2006,Iraq,IRQ,Brazil,BRA,23,0,0,0,23
2006,Liberia,LBR,Brazil,BRA,0,0,0,5,5
2006,Lebanon,LBN,Brazil,BRA,0,0,249,0,249
2006,Nigeria,NGA,Brazil,BRA,0,0,10,0,10
2006,Peru,PER,Brazil,BRA,0,0,16,5,21
2006,Romania,ROU,Brazil,BRA,0,0,5,51,56
2006,Sierra Leone,SLE,Brazil,BRA,0,0,5,0,5
2006,Somalia,SOM,Brazil,BRA,11,0,0,0,11
2006,Afghanistan,AFG,Bulgaria,BGR,5,34,122,126,287
2006,Algeria,DZA,Bulgaria,BGR,0,0,5,5,10
2006,Armenia,ARM,Bulgaria,BGR,0,5,13,34,52
2006,Bangladesh,BGD,Bulgaria,BGR,0,0,5,5,10
2006,China,CHN,Bulgaria,BGR,0,0,5,0,5
2006,Congo,COG,Bulgaria,BGR,0,0,0,5,5
2006,India,IND,Bulgaria,BGR,0,0,0,11,11
2006,Iran (Islamic Rep. of),IRN,Bulgaria,BGR,5,5,5,16,31
2006,Iraq,IRQ,Bulgaria,BGR,0,31,0,5,36
2006,Lebanon,LBN,Bulgaria,BGR,0,0,0,5,5
2006,Nepal,NPL,Bulgaria,BGR,0,0,0,5,5
2006,Nigeria,NGA,Bulgaria,BGR,0,0,12,10,22
2006,Pakistan,PAK,Bulgaria,BGR,0,0,0,14,14
2006,Russian Federation,RUS,Bulgaria,BGR,0,0,0,12,12
2006,Somalia,SOM,Bulgaria,BGR,0,5,0,0,5
2006,Viet Nam,VNM,Bulgaria,BGR,0,0,0,5,5
2006,Syrian Arab Rep.,SYR,Bulgaria,BGR,0,0,5,5,10
2006,United Rep. of Tanzania,TZA,Bulgaria,BGR,0,0,0,5,5
2006,Turkey,TUR,Bulgaria,BGR,0,0,5,5,10
2006,Ukraine,UKR,Bulgaria,BGR,0,0,5,0,5
2006,Stateless,XXA,Bulgaria,BGR,0,0,16,5,21
2006,Haiti,HTI,Belize,BLZ,0,0,0,14,14
2006,Afghanistan,AFG,Canada,CAN,162,0,12,24,198
2006,Albania,ALB,Canada,CAN,170,0,127,28,325
2006,Algeria,DZA,Canada,CAN,18,0,13,5,36
2006,Angola,AGO,Canada,CAN,11,0,12,0,23
2006,Antigua and Barbuda,ATG,Canada,CAN,5,0,5,0,10
2006,Egypt,EGY,Canada,CAN,36,0,35,5,76
2006,Argentina,ARG,Canada,CAN,5,0,40,5,50
2006,Armenia,ARM,Canada,CAN,14,0,13,0,27
2006,Azerbaijan,AZE,Canada,CAN,37,0,0,0,37
2006,Barbados,BRB,Canada,CAN,5,0,10,0,15
2006,Burundi,BDI,Canada,CAN,149,0,32,0,181
2006,Bangladesh,BGD,Canada,CAN,110,0,123,10,243
2006,Burkina Faso,BFA,Canada,CAN,5,0,0,0,5
2006,Belarus,BLR,Canada,CAN,24,0,0,5,29
2006,Bolivia (Plurinational State of),BOL,Canada,CAN,12,0,5,0,17
2006,Botswana,BWA,Canada,CAN,13,0,0,0,13
2006,Brazil,BRA,Canada,CAN,23,0,78,15,116
2006,Bosnia and Herzegovina,BIH,Canada,CAN,16,0,5,5,26
2006,Bulgaria,BGR,Canada,CAN,42,0,16,5,63
2006,Belize,BLZ,Canada,CAN,5,0,0,0,5
2006,Cambodia,KHM,Canada,CAN,11,0,15,0,26
2006,Central African Rep.,CAF,Canada,CAN,5,0,12,0,17
2006,Chad,TCD,Canada,CAN,34,0,15,0,49
2006,China,CHN,Canada,CAN,768,0,593,191,1552
2006,Chile,CHL,Canada,CAN,5,0,33,5,43
2006,Cameroon,CMR,Canada,CAN,47,0,30,5,82
2006,Congo,COG,Canada,CAN,14,0,5,0,19
2006,Dem. Rep. of the Congo,COD,Canada,CAN,203,0,108,11,322
2006,Colombia,COL,Canada,CAN,1084,0,239,87,1410
2006,Costa Rica,CRI,Canada,CAN,12,0,75,16,103
2006,Cuba,CUB,Canada,CAN,124,0,22,22,168
2006,Czechia,CZE,Canada,CAN,5,0,5,0,10
2006,Denmark,DNK,Canada,CAN,5,0,0,0,5
2006,Djibouti,DJI,Canada,CAN,10,0,0,0,10
2006,Dominica,DMA,Canada,CAN,5,0,0,5,10
2006,Dominican Rep.,DOM,Canada,CAN,16,0,30,23,69
2006,Ecuador,ECU,Canada,CAN,20,0,18,5,43
2006,Eritrea,ERI,Canada,CAN,117,0,16,0,133
2006,Ethiopia,ETH,Canada,CAN,130,0,43,10,183
2006,Fiji,FJI,Canada,CAN,20,0,10,5,35
2006,France,FRA,Canada,CAN,0,0,10,5,15
2006,Gabon,GAB,Canada,CAN,0,0,5,0,5
2006,Gambia,GMB,Canada,CAN,5,0,0,0,5
2006,Palestinian,PSE,Canada,CAN,23,0,10,10,43
2006,United Kingdom of Great Britain and Northern Ireland,GBR,Canada,CAN,0,0,13,0,13
2006,Georgia,GEO,Canada,CAN,35,0,15,5,55
2006,Germany,DEU,Canada,CAN,0,0,18,10,28
2006,Ghana,GHA,Canada,CAN,17,0,41,5,63
2006,Greece,GRC,Canada,CAN,5,0,5,5,15
2006,Grenada,GRD,Canada,CAN,21,0,81,10,112
2006,Guatemala,GTM,Canada,CAN,49,0,57,11,117
2006,Guinea,GIN,Canada,CAN,38,0,43,0,81
2006,Guyana,GUY,Canada,CAN,97,0,189,38,324
2006,Haiti,HTI,Canada,CAN,208,0,166,20,394
2006,"China, Hong Kong SAR",HKG,Canada,CAN,0,0,0,5,5
2006,Honduras,HND,Canada,CAN,42,0,59,51,152
2006,Croatia,HRV,Canada,CAN,18,0,5,0,23
2006,Hungary,HUN,Canada,CAN,67,0,41,18,126
2006,Cote d'Ivoire,CIV,Canada,CAN,30,0,27,0,57
2006,India,IND,Canada,CAN,236,0,262,183,681
2006,Indonesia,IDN,Canada,CAN,27,0,77,16,120
2006,Ireland,IRL,Canada,CAN,5,0,0,0,5
2006,Iran (Islamic Rep. of),IRN,Canada,CAN,228,0,45,26,299
2006,Iraq,IRQ,Canada,CAN,91,0,5,10,106
2006,Israel,ISR,Canada,CAN,45,0,148,57,250
2006,Italy,ITA,Canada,CAN,0,0,10,5,15
2006,Jamaica,JAM,Canada,CAN,47,0,115,15,177
2006,Jordan,JOR,Canada,CAN,34,0,19,5,58
2006,Japan,JPN,Canada,CAN,0,0,0,5,5
2006,Kazakhstan,KAZ,Canada,CAN,13,0,0,0,13
2006,Kenya,KEN,Canada,CAN,34,0,28,5,67
2006,Kyrgyzstan,KGZ,Canada,CAN,5,0,0,0,5
2006,Rep. of Korea,KOR,Canada,CAN,40,0,120,33,193
2006,Kuwait,KWT,Canada,CAN,5,0,0,0,5
2006,Liberia,LBR,Canada,CAN,0,0,12,0,12
2006,Libya,LBY,Canada,CAN,22,0,5,0,27
2006,Saint Lucia,LCA,Canada,CAN,49,0,149,23,221
2006,Lebanon,LBN,Canada,CAN,78,0,55,38,171
2006,Sri Lanka,LKA,Canada,CAN,661,0,202,39,902
2006,Lithuania,LTU,Canada,CAN,5,0,0,5,10
2006,Latvia,LVA,Canada,CAN,5,0,0,0,5
2006,Mauritania,MRT,Canada,CAN,30,0,33,5,68
2006,North Macedonia,MKD,Canada,CAN,19,0,5,5,29
2006,Rep. of Moldova,MDA,Canada,CAN,16,0,11,0,27
2006,Mexico,MEX,Canada,CAN,931,0,1693,659,3283
2006,Malaysia,MYS,Canada,CAN,19,0,39,10,68
2006,Mongolia,MNG,Canada,CAN,10,0,5,0,15
2006,Morocco,MAR,Canada,CAN,16,0,18,0,34
2006,Myanmar,MMR,Canada,CAN,24,0,5,0,29
2006,Namibia,NAM,Canada,CAN,11,0,0,0,11
2006,Nepal,NPL,Canada,CAN,72,0,0,5,77
2006,Netherlands,NLD,Canada,CAN,10,0,14,0,24
2006,Niger,NER,Canada,CAN,10,0,0,0,10
2006,Nicaragua,NIC,Canada,CAN,5,0,15,5,25
2006,Nigeria,NGA,Canada,CAN,189,0,236,45,470
2006,Norway,NOR,Canada,CAN,0,0,0,10,10
2006,New Zealand,NZL,Canada,CAN,0,0,0,5,5
2006,Pakistan,PAK,Canada,CAN,431,0,455,60,946
2006,Panama,PAN,Canada,CAN,5,0,23,0,28
2006,Paraguay,PRY,Canada,CAN,0,0,5,0,5
2006,Peru,PER,Canada,CAN,52,0,108,19,179
2006,Philippines,PHL,Canada,CAN,16,0,97,5,118
2006,Poland,POL,Canada,CAN,10,0,37,5,52
2006,Portugal,PRT,Canada,CAN,5,0,77,10,92
2006,Romania,ROU,Canada,CAN,70,0,25,29,124
2006,South Africa,ZAF,Canada,CAN,0,0,11,0,11
2006,Russian Federation,RUS,Canada,CAN,115,0,37,24,176
2006,Rwanda,RWA,Canada,CAN,96,0,32,5,133
2006,El Salvador,SLV,Canada,CAN,57,0,109,5,171
2006,Saudi Arabia,SAU,Canada,CAN,14,0,5,0,19
2006,Serbia and Kosovo: S/RES/1244 (1999),SRB,Canada,CAN,40,0,30,11,81
2006,Senegal,SEN,Canada,CAN,11,0,10,0,21
2006,Singapore,SGP,Canada,CAN,12,0,0,0,12
2006,Sierra Leone,SLE,Canada,CAN,10,0,13,0,23
2006,Solomon Islands,SLB,Canada,CAN,10,0,0,0,10
2006,Somalia,SOM,Canada,CAN,95,0,20,22,137
2006,Spain,ESP,Canada,CAN,11,0,0,0,11
2006,Viet Nam,VNM,Canada,CAN,5,0,18,10,33
2006,Sudan,SDN,Canada,CAN,30,0,5,10,45
2006,Slovakia,SVK,Canada,CAN,0,0,13,0,13
2006,Sweden,SWE,Canada,CAN,0,0,0,5,5
2006,Syrian Arab Rep.,SYR,Canada,CAN,42,0,11,10,63
2006,United Rep. of Tanzania,TZA,Canada,CAN,12,0,5,0,17
2006,Thailand,THA,Canada,CAN,12,0,0,0,12
2006,Tajikistan,TJK,Canada,CAN,5,0,0,0,5
2006,Togo,TGO,Canada,CAN,12,0,19,0,31
2006,Trinidad and Tobago,TTO,Canada,CAN,45,0,116,33,194
2006,Tunisia,TUN,Canada,CAN,11,0,12,5,28
2006,Turkey,TUR,Canada,CAN,96,0,89,36,221
2006,Uganda,UGA,Canada,CAN,26,0,10,10,46
2006,Ukraine,UKR,Canada,CAN,124,0,81,34,239
2006,Uruguay,URY,Canada,CAN,5,0,11,0,16
2006,United States of America,USA,Canada,CAN,10,0,146,99,255
2006,Uzbekistan,UZB,Canada,CAN,29,0,0,0,29
2006,Saint Vincent and the Grenadines,VCT,Canada,CAN,147,0,224,39,410
2006,Venezuela (Bolivarian Republic of),VEN,Canada,CAN,34,0,53,5,92
2006,Yemen,YEM,Canada,CAN,11,0,15,0,26
2006,Zambia,ZMB,Canada,CAN,0,0,13,0,13
2006,Zimbabwe,ZWE,Canada,CAN,455,0,219,25,699
2006,Stateless,XXA,Canada,CAN,0,0,5,0,5
2006,Angola,AGO,Central African Rep.,CAF,13,0,0,0,13
2006,Chad,TCD,Central African Rep.,CAF,109,0,12,0,121
2006,Dem. Rep. of the Congo,COD,Central African Rep.,CAF,247,0,0,0,247
2006,Cote d'Ivoire,CIV,Central African Rep.,CAF,5,0,0,15,20
2006,Liberia,LBR,Central African Rep.,CAF,5,0,0,17,22
2006,Rwanda,RWA,Central African Rep.,CAF,17,0,0,0,17
2006,Sudan,SDN,Central African Rep.,CAF,72,0,0,0,72
2006,Colombia,COL,Chile,CHL,267,0,39,18,324
2006,Costa Rica,CRI,Chile,CHL,5,0,0,0,5
2006,Ecuador,ECU,Chile,CHL,5,0,0,0,5
2006,Haiti,HTI,Chile,CHL,5,0,0,0,5
2006,Peru,PER,Chile,CHL,0,0,0,5,5
2006,Cuba,CUB,Colombia,COL,0,0,17,0,17
2006,Venezuela (Bolivarian Republic of),VEN,Colombia,COL,0,0,0,5,5
2006,Afghanistan,AFG,Cyprus,CYP,0,0,19,33,52
2006,Algeria,DZA,Cyprus,CYP,0,0,5,0,5
2006,Egypt,EGY,Cyprus,CYP,0,0,5,25,30
2006,Armenia,ARM,Cyprus,CYP,0,0,0,26,26
2006,Bangladesh,BGD,Cyprus,CYP,0,0,372,357,729
2006,Belarus,BLR,Cyprus,CYP,0,0,0,5,5
2006,Bulgaria,BGR,Cyprus,CYP,0,0,0,5,5
2006,China,CHN,Cyprus,CYP,0,0,38,229,267
2006,Cameroon,CMR,Cyprus,CYP,0,0,14,0,14
2006,Dem. Rep. of the Congo,COD,Cyprus,CYP,0,0,5,0,5
2006,Palestinian,PSE,Cyprus,CYP,5,44,13,124,186
2006,Georgia,GEO,Cyprus,CYP,0,32,250,344,626
2006,Ghana,GHA,Cyprus,CYP,0,0,5,5,10
2006,India,IND,Cyprus,CYP,0,0,68,196,264
2006,Indonesia,IDN,Cyprus,CYP,0,0,0,5,5
2006,Iran (Islamic Rep. of),IRN,Cyprus,CYP,21,5,173,243,442
2006,Iraq,IRQ,Cyprus,CYP,0,48,11,50,109
2006,Jordan,JOR,Cyprus,CYP,0,0,0,18,18
2006,Kazakhstan,KAZ,Cyprus,CYP,0,0,5,24,29
2006,Kenya,KEN,Cyprus,CYP,0,0,0,5,5
2006,Lebanon,LBN,Cyprus,CYP,0,0,5,26,31
2006,Sri Lanka,LKA,Cyprus,CYP,0,0,276,346,622
2006,North Macedonia,MKD,Cyprus,CYP,0,0,0,10,10
2006,Rep. of Moldova,MDA,Cyprus,CYP,0,5,12,54,71
2006,Morocco,MAR,Cyprus,CYP,0,0,0,5,5
2006,Nepal,NPL,Cyprus,CYP,0,0,10,15,25
2006,Nigeria,NGA,Cyprus,CYP,0,0,0,5,5
2006,Pakistan,PAK,Cyprus,CYP,0,0,203,458,661
2006,Philippines,PHL,Cyprus,CYP,0,0,0,5,5
2006,Romania,ROU,Cyprus,CYP,0,0,0,5,5
2006,Russian Federation,RUS,Cyprus,CYP,0,11,53,197,261
2006,Senegal,SEN,Cyprus,CYP,0,0,5,5,10
2006,Syrian Arab Rep.,SYR,Cyprus,CYP,5,5,126,256,392
2006,Tunisia,TUN,Cyprus,CYP,0,0,0,5,5
2006,Turkey,TUR,Cyprus,CYP,5,5,48,157,215
2006,Ukraine,UKR,Cyprus,CYP,0,0,45,386,431
2006,Uzbekistan,UZB,Cyprus,CYP,0,0,5,10,15
2006,Afghanistan,AFG,Czechia,CZE,5,0,0,0,5
2006,Algeria,DZA,Czechia,CZE,0,0,56,5,61
2006,Angola,AGO,Czechia,CZE,0,0,5,0,5
2006,Egypt,EGY,Czechia,CZE,0,0,396,0,396
2006,Armenia,ARM,Czechia,CZE,5,0,52,0,57
2006,Azerbaijan,AZE,Czechia,CZE,5,0,0,0,5
2006,Belarus,BLR,Czechia,CZE,66,0,13,98,177
2006,Bosnia and Herzegovina,BIH,Czechia,CZE,5,0,0,0,5
2006,Bulgaria,BGR,Czechia,CZE,0,0,13,0,13
2006,China,CHN,Czechia,CZE,0,0,112,20,132
2006,Cameroon,CMR,Czechia,CZE,0,0,15,0,15
2006,Dem. Rep. of the Congo,COD,Czechia,CZE,0,0,0,11,11
2006,Cuba,CUB,Czechia,CZE,0,0,0,11,11
2006,Georgia,GEO,Czechia,CZE,0,0,34,10,44
2006,Ghana,GHA,Czechia,CZE,0,0,10,0,10
2006,Guinea,GIN,Czechia,CZE,0,0,12,0,12
2006,India,IND,Czechia,CZE,0,0,80,42,122
2006,Iraq,IRQ,Czechia,CZE,5,0,11,40,56
2006,Kazakhstan,KAZ,Czechia,CZE,31,0,43,0,74
2006,Kyrgyzstan,KGZ,Czechia,CZE,5,0,54,0,59
2006,Sri Lanka,LKA,Czechia,CZE,0,0,12,5,17
2006,North Macedonia,MKD,Czechia,CZE,0,0,11,0,11
2006,Rep. of Moldova,MDA,Czechia,CZE,0,0,27,5,32
2006,Mongolia,MNG,Czechia,CZE,0,0,96,0,96
2006,Morocco,MAR,Czechia,CZE,0,0,5,0,5
2006,Nigeria,NGA,Czechia,CZE,0,0,69,0,69
2006,Pakistan,PAK,Czechia,CZE,5,0,29,10,44
2006,Russian Federation,RUS,Czechia,CZE,51,0,117,32,200
2006,Senegal,SEN,Czechia,CZE,0,0,10,0,10
2006,Sierra Leone,SLE,Czechia,CZE,0,0,10,0,10
2006,Somalia,SOM,Czechia,CZE,13,0,0,0,13
2006,Viet Nam,VNM,Czechia,CZE,0,0,122,18,140
2006,Syrian Arab Rep.,SYR,Czechia,CZE,0,0,5,13,18
2006,Tunisia,TUN,Czechia,CZE,0,0,5,5,10
2006,Turkey,TUR,Czechia,CZE,0,0,44,23,67
2006,Ukraine,UKR,Czechia,CZE,31,0,562,48,641
2006,Uzbekistan,UZB,Czechia,CZE,0,0,0,19,19
2006,Stateless,XXA,Czechia,CZE,23,0,70,12,105
2006,Afghanistan,AFG,Denmark,DNK,0,14,84,0,98
2006,Albania,ALB,Denmark,DNK,0,0,0,5,5
2006,Armenia,ARM,Denmark,DNK,0,0,11,0,11
2006,Azerbaijan,AZE,Denmark,DNK,0,0,10,0,10
2006,Burundi,BDI,Denmark,DNK,0,0,19,0,19
2006,Bosnia and Herzegovina,BIH,Denmark,DNK,0,0,5,13,18
2006,Bulgaria,BGR,Denmark,DNK,0,0,0,10,10
2006,Dem. Rep. of the Congo,COD,Denmark,DNK,0,10,21,0,31
2006,Cabo Verde,CPV,Denmark,DNK,0,0,15,5,20
2006,Eritrea,ERI,Denmark,DNK,0,0,5,0,5
2006,Ethiopia,ETH,Denmark,DNK,0,0,11,0,11
2006,Gambia,GMB,Denmark,DNK,0,0,0,5,5
2006,Palestinian,PSE,Denmark,DNK,15,0,18,15,48
2006,Ghana,GHA,Denmark,DNK,0,0,5,5,10
2006,Cote d'Ivoire,CIV,Denmark,DNK,0,0,5,0,5
2006,India,IND,Denmark,DNK,0,0,10,0,10
2006,Iran (Islamic Rep. of),IRN,Denmark,DNK,24,5,40,0,69
2006,Iraq,IRQ,Denmark,DNK,0,0,103,0,103
2006,Israel,ISR,Denmark,DNK,0,0,0,5,5
2006,Jordan,JOR,Denmark,DNK,0,0,5,0,5
2006,Libya,LBY,Denmark,DNK,0,0,10,0,10
2006,Lebanon,LBN,Denmark,DNK,13,0,0,0,13
2006,Sri Lanka,LKA,Denmark,DNK,0,0,16,5,21
2006,Latvia,LVA,Denmark,DNK,0,0,0,5,5
2006,North Macedonia,MKD,Denmark,DNK,0,0,0,10,10
2006,Morocco,MAR,Denmark,DNK,0,0,0,5,5
2006,Myanmar,MMR,Denmark,DNK,5,0,18,0,23
2006,Nigeria,NGA,Denmark,DNK,0,0,12,14,26
2006,Pakistan,PAK,Denmark,DNK,0,0,11,0,11
2006,Poland,POL,Denmark,DNK,0,0,0,5,5
2006,Romania,ROU,Denmark,DNK,0,0,0,5,5
2006,Russian Federation,RUS,Denmark,DNK,0,19,20,0,39
2006,Rwanda,RWA,Denmark,DNK,0,0,10,0,10
2006,Serbia and Kosovo: S/RES/1244 (1999),SRB,Denmark,DNK,0,0,56,82,138
2006,Somalia,SOM,Denmark,DNK,0,10,37,0,47
2006,Syrian Arab Rep.,SYR,Denmark,DNK,22,0,5,0,27
2006,Turkey,TUR,Denmark,DNK,0,0,5,14,19
2006,Uganda,UGA,Denmark,DNK,0,0,5,0,5
2006,Stateless,XXA,Denmark,DNK,5,0,0,0,5
2006,Afghanistan,AFG,Finland,FIN,0,131,50,5,186
2006,Albania,ALB,Finland,FIN,0,0,16,0,16
2006,Algeria,DZA,Finland,FIN,0,5,22,0,27
2006,Angola,AGO,Finland,FIN,0,11,23,0,34
2006,Egypt,EGY,Finland,FIN,0,0,5,0,5
2006,Armenia,ARM,Finland,FIN,0,0,30,5,35
2006,Azerbaijan,AZE,Finland,FIN,5,0,20,0,25
2006,Bangladesh,BGD,Finland,FIN,0,0,19,13,32
2006,Belarus,BLR,Finland,FIN,0,0,64,23,87
2006,Bosnia and Herzegovina,BIH,Finland,FIN,0,10,14,5,29
2006,Bulgaria,BGR,Finland,FIN,0,0,399,58,457
2006,China,CHN,Finland,FIN,0,11,0,0,11
2006,Cameroon,CMR,Finland,FIN,0,5,22,5,32
2006,Dem. Rep. of the Congo,COD,Finland,FIN,0,12,27,0,39
2006,Cuba,CUB,Finland,FIN,0,0,5,0,5
2006,Ethiopia,ETH,Finland,FIN,0,11,0,0,11
2006,Gambia,GMB,Finland,FIN,0,0,11,0,11
2006,Georgia,GEO,Finland,FIN,0,0,33,0,33
2006,Ghana,GHA,Finland,FIN,0,0,5,5,10
2006,Guinea,GIN,Finland,FIN,0,5,0,0,5
2006,Croatia,HRV,Finland,FIN,0,0,12,0,12
2006,India,IND,Finland,FIN,0,0,15,11,26
2006,Iran (Islamic Rep. of),IRN,Finland,FIN,0,25,37,10,72
2006,Iraq,IRQ,Finland,FIN,12,113,73,36,234
2006,Israel,ISR,Finland,FIN,0,0,5,0,5
2006,Kazakhstan,KAZ,Finland,FIN,0,0,0,5,5
2006,Kyrgyzstan,KGZ,Finland,FIN,0,0,12,0,12
2006,Liberia,LBR,Finland,FIN,0,0,5,0,5
2006,Libya,LBY,Finland,FIN,0,0,14,0,14
2006,Lebanon,LBN,Finland,FIN,0,5,0,0,5
2006,Sri Lanka,LKA,Finland,FIN,0,0,16,0,16
2006,Latvia,LVA,Finland,FIN,0,0,0,5,5
2006,Mauritania,MRT,Finland,FIN,0,0,5,0,5
2006,North Macedonia,MKD,Finland,FIN,0,0,17,10,27
2006,Rep. of Moldova,MDA,Finland,FIN,0,0,14,0,14
2006,Mongolia,MNG,Finland,FIN,0,0,0,5,5
2006,Myanmar,MMR,Finland,FIN,0,5,0,0,5
2006,Nepal,NPL,Finland,FIN,0,0,5,0,5
2006,Nigeria,NGA,Finland,FIN,0,5,61,10,76
2006,Pakistan,PAK,Finland,FIN,0,5,5,0,10
2006,Romania,ROU,Finland,FIN,0,0,13,5,18
2006,Russian Federation,RUS,Finland,FIN,20,25,89,21,155
2006,Rwanda,RWA,Finland,FIN,0,0,5,0,5
2006,Serbia and Kosovo: S/RES/1244 (1999),SRB,Finland,FIN,0,31,185,13,229
2006,Somalia,SOM,Finland,FIN,0,185,20,5,210
2006,Sudan,SDN,Finland,FIN,0,0,5,0,5
2006,Slovakia,SVK,Finland,FIN,0,0,5,0,5
2006,Syrian Arab Rep.,SYR,Finland,FIN,0,0,11,0,11
2006,Tunisia,TUN,Finland,FIN,0,0,5,0,5
2006,Turkey,TUR,Finland,FIN,0,14,38,0,52
2006,Ukraine,UKR,Finland,FIN,0,0,5,0,5
2006,United States of America,USA,Finland,FIN,0,0,5,0,5
2006,Uzbekistan,UZB,Finland,FIN,0,13,0,0,13
2006,Stateless,XXA,Finland,FIN,0,5,29,0,34
2006,Afghanistan,AFG,France,FRA,21,0,84,0,105
2006,Albania,ALB,France,FRA,11,10,386,0,407
2006,Algeria,DZA,France,FRA,34,18,1141,0,1193
2006,Angola,AGO,France,FRA,45,0,702,0,747
2006,Egypt,EGY,France,FRA,5,0,22,0,27
2006,Armenia,ARM,France,FRA,37,5,1293,0,1335
2006,Azerbaijan,AZE,France,FRA,47,0,500,0,547
2006,Burundi,BDI,France,FRA,5,0,18,0,23
2006,Bangladesh,BGD,France,FRA,26,0,1133,0,1159
2006,Belarus,BLR,France,FRA,0,5,161,0,166
2006,Brazil,BRA,France,FRA,5,5,5,0,15
2006,Bosnia and Herzegovina,BIH,France,FRA,31,5,456,0,492
2006,Central African Rep.,CAF,France,FRA,35,0,161,0,196
2006,Chad,TCD,France,FRA,17,0,169,0,186
2006,China,CHN,France,FRA,39,0,1226,0,1265
2006,Cameroon,CMR,France,FRA,22,0,267,0,289
2006,Congo,COG,France,FRA,99,0,910,0,1009
2006,Dem. Rep. of the Congo,COD,France,FRA,235,5,2662,0,2902
2006,Comoros,COM,France,FRA,5,0,95,0,100
2006,Colombia,COL,France,FRA,29,5,119,0,153
2006,Cuba,CUB,France,FRA,13,0,40,0,53
2006,Djibouti,DJI,France,FRA,5,0,11,0,16
2006,Dominican Rep.,DOM,France,FRA,0,0,74,0,74
2006,Eritrea,ERI,France,FRA,31,0,14,0,45
2006,Ethiopia,ETH,France,FRA,25,0,40,0,65
2006,Palestinian,PSE,France,FRA,0,5,49,0,54
2006,Georgia,GEO,France,FRA,33,5,536,0,574
2006,Ghana,GHA,France,FRA,0,0,44,0,44
2006,Guinea-Bissau,GNB,France,FRA,16,0,74,0,90
2006,Guinea,GIN,France,FRA,90,0,934,0,1024
2006,Haiti,HTI,France,FRA,232,63,3695,0,3990
2006,Cote d'Ivoire,CIV,France,FRA,116,0,959,0,1075
2006,India,IND,France,FRA,5,0,148,0,153
2006,Iran (Islamic Rep. of),IRN,France,FRA,31,0,98,0,129
2006,Iraq,IRQ,France,FRA,14,17,103,0,134
2006,Kazakhstan,KAZ,France,FRA,5,0,98,0,103
2006,Kenya,KEN,France,FRA,0,0,10,0,10
2006,Kyrgyzstan,KGZ,France,FRA,5,0,40,0,45
2006,Lao People's Dem. Rep.,LAO,France,FRA,0,0,12,0,12
2006,Liberia,LBR,France,FRA,5,0,41,0,46
2006,Sri Lanka,LKA,France,FRA,143,0,2658,0,2801
2006,Madagascar,MDG,France,FRA,13,0,128,0,141
2006,Mauritania,MRT,France,FRA,65,0,1041,0,1106
2006,North Macedonia,MKD,France,FRA,5,0,150,0,155
2006,Rep. of Moldova,MDA,France,FRA,5,0,645,0,650
2006,Mali,MLI,France,FRA,20,0,149,0,169
2006,Mongolia,MNG,France,FRA,5,0,125,0,130
2006,Morocco,MAR,France,FRA,5,0,39,0,44
2006,Myanmar,MMR,France,FRA,5,0,24,0,29
2006,Nepal,NPL,France,FRA,5,0,25,0,30
2006,Nigeria,NGA,France,FRA,10,0,648,0,658
2006,Pakistan,PAK,France,FRA,5,0,426,0,431
2006,Peru,PER,France,FRA,5,0,43,0,48
2006,Russian Federation,RUS,France,FRA,353,17,1727,0,2097
2006,Rwanda,RWA,France,FRA,142,0,131,0,273
2006,Serbia and Kosovo: S/RES/1244 (1999),SRB,France,FRA,79,0,2476,0,2555
2006,Senegal,SEN,France,FRA,0,0,59,0,59
2006,Sierra Leone,SLE,France,FRA,5,0,117,0,122
2006,Somalia,SOM,France,FRA,15,0,26,0,41
2006,Viet Nam,VNM,France,FRA,14,0,5,0,19
2006,Sudan,SDN,France,FRA,114,0,220,0,334
2006,Syrian Arab Rep.,SYR,France,FRA,5,0,21,0,26
2006,Togo,TGO,France,FRA,33,0,229,0,262
2006,Tunisia,TUN,France,FRA,14,0,23,0,37
2006,Turkey,TUR,France,FRA,207,0,4286,0,4493
2006,Ukraine,UKR,France,FRA,5,0,160,0,165
2006,Uzbekistan,UZB,France,FRA,5,0,41,0,46
2006,Stateless,XXA,France,FRA,75,0,144,0,219
2006,Cote d'Ivoire,CIV,Gambia,GMB,41,0,0,0,41
2006,Afghanistan,AFG,United Kingdom of Great Britain and Northern Ireland,GBR,62,775,1179,371,2387
2006,Albania,ALB,United Kingdom of Great Britain and Northern Ireland,GBR,0,38,107,13,158
2006,Algeria,DZA,United Kingdom of Great Britain and Northern Ireland,GBR,0,33,144,62,239
2006,Angola,AGO,United Kingdom of Great Britain and Northern Ireland,GBR,12,15,61,17,105
2006,Egypt,EGY,United Kingdom of Great Britain and Northern Ireland,GBR,5,0,18,5,28
2006,Armenia,ARM,United Kingdom of Great Britain and Northern Ireland,GBR,0,0,23,0,23
2006,Azerbaijan,AZE,United Kingdom of Great Britain and Northern Ireland,GBR,5,0,37,15,57
2006,Burundi,BDI,United Kingdom of Great Britain and Northern Ireland,GBR,5,5,29,13,52
2006,Benin,BEN,United Kingdom of Great Britain and Northern Ireland,GBR,0,5,5,0,10
2006,Bangladesh,BGD,United Kingdom of Great Britain and Northern Ireland,GBR,5,84,263,40,392
2006,Bhutan,BTN,United Kingdom of Great Britain and Northern Ireland,GBR,0,0,13,0,13
2006,Belarus,BLR,United Kingdom of Great Britain and Northern Ireland,GBR,14,0,62,0,76
2006,Bolivia (Plurinational State of),BOL,United Kingdom of Great Britain and Northern Ireland,GBR,0,0,12,0,12
2006,Botswana,BWA,United Kingdom of Great Britain and Northern Ireland,GBR,0,0,5,0,5
2006,Brazil,BRA,United Kingdom of Great Britain and Northern Ireland,GBR,0,0,5,0,5
2006,Bosnia and Herzegovina,BIH,United Kingdom of Great Britain and Northern Ireland,GBR,0,5,27,20,52
2006,Bulgaria,BGR,United Kingdom of Great Britain and Northern Ireland,GBR,0,5,5,0,10
2006,Central African Rep.,CAF,United Kingdom of Great Britain and Northern Ireland,GBR,0,0,5,0,5
2006,Chad,TCD,United Kingdom of Great Britain and Northern Ireland,GBR,0,0,11,5,16
2006,China,CHN,United Kingdom of Great Britain and Northern Ireland,GBR,16,114,954,708,1792
2006,Chile,CHL,United Kingdom of Great Britain and Northern Ireland,GBR,0,0,5,0,5
2006,Cameroon,CMR,United Kingdom of Great Britain and Northern Ireland,GBR,11,19,191,21,242
2006,Congo,COG,United Kingdom of Great Britain and Northern Ireland,GBR,0,10,37,0,47
2006,Dem. Rep. of the Congo,COD,United Kingdom of Great Britain and Northern Ireland,GBR,60,83,559,70,772
2006,Colombia,COL,United Kingdom of Great Britain and Northern Ireland,GBR,5,0,51,5,61
2006,Cuba,CUB,United Kingdom of Great Britain and Northern Ireland,GBR,0,0,17,0,17
2006,Czechia,CZE,United Kingdom of Great Britain and Northern Ireland,GBR,0,0,5,0,5
2006,Djibouti,DJI,United Kingdom of Great Britain and Northern Ireland,GBR,0,0,0,5,5
2006,Ecuador,ECU,United Kingdom of Great Britain and Northern Ireland,GBR,0,0,15,0,15
2006,Eritrea,ERI,United Kingdom of Great Britain and Northern Ireland,GBR,819,77,776,638,2310
2006,Ethiopia,ETH,United Kingdom of Great Britain and Northern Ireland,GBR,22,20,159,49,250
2006,Gambia,GMB,United Kingdom of Great Britain and Northern Ireland,GBR,10,5,109,5,129
2006,Palestinian,PSE,United Kingdom of Great Britain and Northern Ireland,GBR,0,5,203,73,281
2006,Georgia,GEO,United Kingdom of Great Britain and Northern Ireland,GBR,0,0,53,12,65
2006,Ghana,GHA,United Kingdom of Great Britain and Northern Ireland,GBR,0,5,92,5,102
2006,Guinea-Bissau,GNB,United Kingdom of Great Britain and Northern Ireland,GBR,0,0,5,0,5
2006,Grenada,GRD,United Kingdom of Great Britain and Northern Ireland,GBR,0,0,5,0,5
2006,Guinea,GIN,United Kingdom of Great Britain and Northern Ireland,GBR,0,40,79,15,134
2006,Guyana,GUY,United Kingdom of Great Britain and Northern Ireland,GBR,0,0,5,0,5
2006,"China, Hong Kong SAR",HKG,United Kingdom of Great Britain and Northern Ireland,GBR,0,0,5,0,5
2006,Croatia,HRV,United Kingdom of Great Britain and Northern Ireland,GBR,0,0,14,5,19
2006,Cote d'Ivoire,CIV,United Kingdom of Great Britain and Northern Ireland,GBR,10,21,140,15,186
2006,India,IND,United Kingdom of Great Britain and Northern Ireland,GBR,0,18,521,82,621
2006,Indonesia,IDN,United Kingdom of Great Britain and Northern Ireland,GBR,0,0,5,0,5
2006,Iran (Islamic Rep. of),IRN,United Kingdom of Great Britain and Northern Ireland,GBR,106,272,1876,275,2529
2006,Iraq,IRQ,United Kingdom of Great Britain and Northern Ireland,GBR,44,63,746,120,973
2006,Israel,ISR,United Kingdom of Great Britain and Northern Ireland,GBR,0,0,22,0,22
2006,Jamaica,JAM,United Kingdom of Great Britain and Northern Ireland,GBR,0,10,185,10,205
2006,Jordan,JOR,United Kingdom of Great Britain and Northern Ireland,GBR,0,0,14,0,14
2006,Kazakhstan,KAZ,United Kingdom of Great Britain and Northern Ireland,GBR,0,0,5,0,5
2006,Kenya,KEN,United Kingdom of Great Britain and Northern Ireland,GBR,0,10,89,5,104
2006,Kyrgyzstan,KGZ,United Kingdom of Great Britain and Northern Ireland,GBR,5,0,5,0,10
2006,Dem. People's Rep. of Korea,PRK,United Kingdom of Great Britain and Northern Ireland,GBR,18,10,10,5,43
2006,Kuwait,KWT,United Kingdom of Great Britain and Northern Ireland,GBR,59,5,90,16,170
2006,Liberia,LBR,United Kingdom of Great Britain and Northern Ireland,GBR,5,5,41,5,56
2006,Libya,LBY,United Kingdom of Great Britain and Northern Ireland,GBR,12,5,102,13,132
2006,Lebanon,LBN,United Kingdom of Great Britain and Northern Ireland,GBR,0,12,166,15,193
2006,Sri Lanka,LKA,United Kingdom of Great Britain and Northern Ireland,GBR,5,60,401,39,505
2006,Rep. of Moldova,MDA,United Kingdom of Great Britain and Northern Ireland,GBR,0,10,31,17,58
2006,Mali,MLI,United Kingdom of Great Britain and Northern Ireland,GBR,0,0,10,0,10
2006,Malaysia,MYS,United Kingdom of Great Britain and Northern Ireland,GBR,0,0,11,0,11
2006,Malawi,MWI,United Kingdom of Great Britain and Northern Ireland,GBR,0,5,61,5,71
2006,Mongolia,MNG,United Kingdom of Great Britain and Northern Ireland,GBR,0,5,30,13,48
2006,Morocco,MAR,United Kingdom of Great Britain and Northern Ireland,GBR,0,0,15,11,26
2006,Mozambique,MOZ,United Kingdom of Great Britain and Northern Ireland,GBR,0,0,5,0,5
2006,Mauritius,MUS,United Kingdom of Great Britain and Northern Ireland,GBR,0,5,14,0,19
2006,Myanmar,MMR,United Kingdom of Great Britain and Northern Ireland,GBR,30,5,44,0,79
2006,Namibia,NAM,United Kingdom of Great Britain and Northern Ireland,GBR,0,0,10,0,10
2006,Nepal,NPL,United Kingdom of Great Britain and Northern Ireland,GBR,0,0,48,0,48
2006,Niger,NER,United Kingdom of Great Britain and Northern Ireland,GBR,0,0,0,5,5
2006,Nigeria,NGA,United Kingdom of Great Britain and Northern Ireland,GBR,5,59,656,84,804
2006,Pakistan,PAK,United Kingdom of Great Britain and Northern Ireland,GBR,134,76,1327,117,1654
2006,Peru,PER,United Kingdom of Great Britain and Northern Ireland,GBR,0,0,5,0,5
2006,Philippines,PHL,United Kingdom of Great Britain and Northern Ireland,GBR,0,0,5,0,5
2006,Poland,POL,United Kingdom of Great Britain and Northern Ireland,GBR,0,0,5,0,5
2006,Romania,ROU,United Kingdom of Great Britain and Northern Ireland,GBR,0,12,29,22,63
2006,South Africa,ZAF,United Kingdom of Great Britain and Northern Ireland,GBR,0,0,86,5,91
2006,Russian Federation,RUS,United Kingdom of Great Britain and Northern Ireland,GBR,23,0,105,15,143
2006,Rwanda,RWA,United Kingdom of Great Britain and Northern Ireland,GBR,0,0,16,5,21
2006,Serbia and Kosovo: S/RES/1244 (1999),SRB,United Kingdom of Great Britain and Northern Ireland,GBR,5,28,161,19,213
2006,Senegal,SEN,United Kingdom of Great Britain and Northern Ireland,GBR,0,0,15,0,15
2006,Sierra Leone,SLE,United Kingdom of Great Britain and Northern Ireland,GBR,0,21,84,17,122
2006,Somalia,SOM,United Kingdom of Great Britain and Northern Ireland,GBR,775,165,861,225,2026
2006,Viet Nam,VNM,United Kingdom of Great Britain and Northern Ireland,GBR,0,22,30,30,82
2006,Sudan,SDN,United Kingdom of Great Britain and Northern Ireland,GBR,35,40,430,142,647
2006,Eswatini,SWZ,United Kingdom of Great Britain and Northern Ireland,GBR,0,0,5,0,5
2006,Syrian Arab Rep.,SYR,United Kingdom of Great Britain and Northern Ireland,GBR,25,16,131,30,202
2006,United Rep. of Tanzania,TZA,United Kingdom of Great Britain and Northern Ireland,GBR,0,0,18,0,18
2006,Turkmenistan,TKM,United Kingdom of Great Britain and Northern Ireland,GBR,5,0,12,0,17
2006,Togo,TGO,United Kingdom of Great Britain and Northern Ireland,GBR,5,0,16,5,26
2006,Trinidad and Tobago,TTO,United Kingdom of Great Britain and Northern Ireland,GBR,0,0,5,0,5
2006,Tunisia,TUN,United Kingdom of Great Britain and Northern Ireland,GBR,0,0,13,5,18
2006,Turkey,TUR,United Kingdom of Great Britain and Northern Ireland,GBR,18,37,434,53,542
2006,United Arab Emirates,ARE,United Kingdom of Great Britain and Northern Ireland,GBR,5,0,0,0,5
2006,Uganda,UGA,United Kingdom of Great Britain and Northern Ireland,GBR,5,17,134,10,166
2006,Ukraine,UKR,United Kingdom of Great Britain and Northern Ireland,GBR,0,5,35,0,40
2006,Uzbekistan,UZB,United Kingdom of Great Britain and Northern Ireland,GBR,10,0,14,0,24
2006,Venezuela (Bolivarian Republic of),VEN,United Kingdom of Great Britain and Northern Ireland,GBR,0,0,5,5,10
2006,Yemen,YEM,United Kingdom of Great Britain and Northern Ireland,GBR,5,5,52,5,67
2006,Zambia,ZMB,United Kingdom of Great Britain and Northern Ireland,GBR,0,0,21,0,21
2006,Zimbabwe,ZWE,United Kingdom of Great Britain and Northern Ireland,GBR,191,46,1901,82,2220
2006,Stateless,XXA,United Kingdom of Great Britain and Northern Ireland,GBR,36,0,28,16,80
2006,Burkina Faso,BFA,Ghana,GHA,0,0,5,0,5
2006,Somalia,SOM,Ghana,GHA,0,0,0,5,5
2006,Congo,COG,Guinea-Bissau,GNB,5,0,0,0,5
2006,Cote d'Ivoire,CIV,Guinea-Bissau,GNB,22,0,0,0,22
2006,Liberia,LBR,Guinea-Bissau,GNB,49,0,0,0,49
2006,Senegal,SEN,Guinea-Bissau,GNB,134,0,0,0,134
2006,Sierra Leone,SLE,Guinea-Bissau,GNB,5,0,22,0,27
2006,Cuba,CUB,Guatemala,GTM,0,0,0,13,13
2006,Honduras,HND,Guatemala,GTM,0,0,0,12,12
2006,El Salvador,SLV,Guatemala,GTM,5,0,0,0,5
2006,Congo,COG,Guinea,GIN,11,0,0,0,11
2006,Cote d'Ivoire,CIV,Guinea,GIN,233,0,86,0,319
2006,Liberia,LBR,Guinea,GIN,72,0,148,0,220
2006,Sierra Leone,SLE,Guinea,GIN,212,0,386,0,598
2006,Colombia,COL,Honduras,HND,0,0,0,10,10
2006,Cuba,CUB,Honduras,HND,0,0,25,26,51
2006,Eritrea,ERI,Honduras,HND,0,0,0,5,5
2006,Armenia,ARM,Croatia,HRV,0,0,5,0,5
2006,Bosnia and Herzegovina,BIH,Croatia,HRV,0,0,5,0,5
2006,China,CHN,Croatia,HRV,0,0,5,0,5
2006,Palestinian,PSE,Croatia,HRV,0,0,27,0,27
2006,Iraq,IRQ,Croatia,HRV,0,0,5,0,5
2006,Pakistan,PAK,Croatia,HRV,0,0,10,0,10
2006,Russian Federation,RUS,Croatia,HRV,0,0,0,5,5
2006,Serbia and Kosovo: S/RES/1244 (1999),SRB,Croatia,HRV,0,0,18,0,18
2006,Stateless,XXA,Croatia,HRV,0,0,5,0,5
2006,Afghanistan,AFG,Hungary,HUN,5,13,0,0,18
2006,Albania,ALB,Hungary,HUN,0,0,0,5,5
2006,Algeria,DZA,Hungary,HUN,0,0,16,5,21
2006,Angola,AGO,Hungary,HUN,0,0,0,5,5
2006,Egypt,EGY,Hungary,HUN,0,5,5,15,25
2006,Armenia,ARM,Hungary,HUN,0,12,0,0,12
2006,Bangladesh,BGD,Hungary,HUN,0,0,0,14,14
2006,Belarus,BLR,Hungary,HUN,0,0,5,0,5
2006,Bosnia and Herzegovina,BIH,Hungary,HUN,0,0,5,0,5
2006,China,CHN,Hungary,HUN,0,10,233,18,261
2006,Cameroon,CMR,Hungary,HUN,5,0,0,0,5
2006,Cuba,CUB,Hungary,HUN,0,5,0,0,5
2006,Ethiopia,ETH,Hungary,HUN,5,0,0,5,10
2006,Palestinian,PSE,Hungary,HUN,0,0,20,20,40
2006,Georgia,GEO,Hungary,HUN,0,0,25,113,138
2006,Ghana,GHA,Hungary,HUN,0,0,5,0,5
2006,Guinea,GIN,Hungary,HUN,0,5,0,0,5
2006,India,IND,Hungary,HUN,0,0,20,0,20
2006,Iran (Islamic Rep. of),IRN,Hungary,HUN,5,0,14,0,19
2006,Iraq,IRQ,Hungary,HUN,16,11,0,27,54
2006,Kenya,KEN,Hungary,HUN,0,0,5,0,5
2006,Liberia,LBR,Hungary,HUN,0,5,0,0,5
2006,North Macedonia,MKD,Hungary,HUN,0,0,0,14,14
2006,Rep. of Moldova,MDA,Hungary,HUN,0,0,10,21,31
2006,Mongolia,MNG,Hungary,HUN,0,0,20,11,31
2006,Morocco,MAR,Hungary,HUN,0,0,0,5,5
2006,Nepal,NPL,Hungary,HUN,5,0,0,0,5
2006,Nigeria,NGA,Hungary,HUN,5,0,79,32,116
2006,Pakistan,PAK,Hungary,HUN,0,0,10,5,15
2006,Romania,ROU,Hungary,HUN,0,0,19,10,29
2006,Russian Federation,RUS,Hungary,HUN,5,0,19,40,64
2006,Serbia and Kosovo: S/RES/1244 (1999),SRB,Hungary,HUN,0,26,136,190,352
2006,Sierra Leone,SLE,Hungary,HUN,0,0,5,0,5
2006,Somalia,SOM,Hungary,HUN,28,0,0,10,38
2006,Viet Nam,VNM,Hungary,HUN,0,0,354,5,359
2006,Sudan,SDN,Hungary,HUN,0,0,5,0,5
2006,Slovakia,SVK,Hungary,HUN,0,0,19,5,24
2006,Syrian Arab Rep.,SYR,Hungary,HUN,0,0,18,5,23
2006,Turkey,TUR,Hungary,HUN,5,5,27,5,42
2006,Ukraine,UKR,Hungary,HUN,0,0,14,18,32
2006,Stateless,XXA,Hungary,HUN,5,0,0,0,5
2006,Romania,ROU,Iceland,ISL,0,0,10,0,10
2006,Russian Federation,RUS,Iceland,ISL,0,0,5,0,5
2006,Afghanistan,AFG,Cote d'Ivoire,CIV,10,0,0,0,10
2006,Burundi,BDI,Cote d'Ivoire,CIV,0,0,5,0,5
2006,Central African Rep.,CAF,Cote d'Ivoire,CIV,0,0,24,0,24
2006,Chad,TCD,Cote d'Ivoire,CIV,0,0,5,0,5
2006,Cameroon,CMR,Cote d'Ivoire,CIV,0,0,5,0,5
2006,Congo,COG,Cote d'Ivoire,CIV,5,0,81,0,86
2006,Dem. Rep. of the Congo,COD,Cote d'Ivoire,CIV,29,0,161,0,190
2006,Rwanda,RWA,Cote d'Ivoire,CIV,13,0,0,0,13
2006,Sierra Leone,SLE,Cote d'Ivoire,CIV,0,0,12,0,12
2006,Togo,TGO,Cote d'Ivoire,CIV,5,0,70,0,75
2006,Afghanistan,AFG,Ireland,IRL,5,0,102,11,118
2006,Albania,ALB,Ireland,IRL,0,0,36,10,46
2006,Algeria,DZA,Ireland,IRL,0,0,45,10,55
2006,Angola,AGO,Ireland,IRL,0,0,33,5,38
2006,Egypt,EGY,Ireland,IRL,0,0,5,0,5
2006,Armenia,ARM,Ireland,IRL,0,0,5,0,5
2006,Azerbaijan,AZE,Ireland,IRL,5,0,5,0,10
2006,Burundi,BDI,Ireland,IRL,5,0,12,0,17
2006,Benin,BEN,Ireland,IRL,0,0,5,0,5
2006,Bangladesh,BGD,Ireland,IRL,5,0,0,0,5
2006,Bhutan,BTN,Ireland,IRL,0,0,13,0,13
2006,Belarus,BLR,Ireland,IRL,0,0,32,10,42
2006,Brazil,BRA,Ireland,IRL,0,0,0,12,12
2006,Chad,TCD,Ireland,IRL,0,0,5,0,5
2006,China,CHN,Ireland,IRL,5,0,47,76,128
2006,Cameroon,CMR,Ireland,IRL,0,0,63,5,68
2006,Congo,COG,Ireland,IRL,0,0,13,0,13
2006,Dem. Rep. of the Congo,COD,Ireland,IRL,15,0,100,5,120
2006,Eritrea,ERI,Ireland,IRL,5,0,21,0,26
2006,Ethiopia,ETH,Ireland,IRL,10,0,15,0,25
2006,Palestinian,PSE,Ireland,IRL,5,0,31,5,41
2006,United Kingdom of Great Britain and Northern Ireland,GBR,Ireland,IRL,0,0,0,5,5
2006,Georgia,GEO,Ireland,IRL,0,0,177,10,187
2006,Ghana,GHA,Ireland,IRL,0,0,79,0,79
2006,Guinea,GIN,Ireland,IRL,5,0,25,0,30
2006,Guyana,GUY,Ireland,IRL,0,0,5,0,5
2006,Croatia,HRV,Ireland,IRL,0,0,16,0,16
2006,Cote d'Ivoire,CIV,Ireland,IRL,0,0,24,0,24
2006,India,IND,Ireland,IRL,0,0,13,0,13
2006,Iran (Islamic Rep. of),IRN,Ireland,IRL,12,0,157,27,196
2006,Iraq,IRQ,Ireland,IRL,64,0,62,10,136
2006,Israel,ISR,Ireland,IRL,0,0,48,0,48
2006,Kazakhstan,KAZ,Ireland,IRL,0,0,5,0,5
2006,Kenya,KEN,Ireland,IRL,5,0,38,5,48
2006,Kuwait,KWT,Ireland,IRL,14,0,24,0,38
2006,Liberia,LBR,Ireland,IRL,0,0,32,0,32
2006,Libya,LBY,Ireland,IRL,0,0,5,5,10
2006,Lebanon,LBN,Ireland,IRL,0,0,14,0,14
2006,Sri Lanka,LKA,Ireland,IRL,0,0,5,0,5
2006,Rep. of Moldova,MDA,Ireland,IRL,5,0,57,28,90
2006,Malaysia,MYS,Ireland,IRL,0,0,5,0,5
2006,Malawi,MWI,Ireland,IRL,0,0,10,0,10
2006,Mongolia,MNG,Ireland,IRL,0,0,5,0,5
2006,Morocco,MAR,Ireland,IRL,0,0,10,0,10
2006,Nepal,NPL,Ireland,IRL,0,0,10,0,10
2006,Niger,NER,Ireland,IRL,5,0,5,0,10
2006,Nigeria,NGA,Ireland,IRL,10,0,990,78,1078
2006,Pakistan,PAK,Ireland,IRL,5,0,97,16,118
2006,Romania,ROU,Ireland,IRL,0,0,149,199,348
2006,South Africa,ZAF,Ireland,IRL,0,0,35,5,40
2006,Russian Federation,RUS,Ireland,IRL,5,0,43,15,63
2006,Rwanda,RWA,Ireland,IRL,5,0,11,0,16
2006,Serbia and Kosovo: S/RES/1244 (1999),SRB,Ireland,IRL,0,0,17,5,22
2006,Sierra Leone,SLE,Ireland,IRL,5,0,15,0,20
2006,Somalia,SOM,Ireland,IRL,60,0,129,13,202
2006,Sudan,SDN,Ireland,IRL,109,0,163,13,285
2006,Syrian Arab Rep.,SYR,Ireland,IRL,0,0,13,5,18
2006,Togo,TGO,Ireland,IRL,5,0,14,0,19
2006,Turkey,TUR,Ireland,IRL,0,0,5,0,5
2006,Uganda,UGA,Ireland,IRL,10,0,18,0,28
2006,Ukraine,UKR,Ireland,IRL,0,0,35,5,40
2006,United States of America,USA,Ireland,IRL,0,0,5,0,5
2006,Zimbabwe,ZWE,Ireland,IRL,11,0,51,5,67
2006,Bangladesh,BGD,Japan,JPN,0,0,12,5,17
2006,China,CHN,Japan,JPN,0,13,0,0,13
2006,Ethiopia,ETH,Japan,JPN,0,0,0,5,5
2006,Iran (Islamic Rep. of),IRN,Japan,JPN,13,0,0,0,13
2006,Sri Lanka,LKA,Japan,JPN,0,0,5,0,5
2006,Myanmar,MMR,Japan,JPN,16,13,245,5,279
2006,Nigeria,NGA,Japan,JPN,0,0,0,5,5
2006,Pakistan,PAK,Japan,JPN,0,0,5,0,5
2006,Turkey,TUR,Japan,JPN,0,0,76,15,91
2006,Afghanistan,AFG,Kazakhstan,KAZ,30,0,46,10,86
2006,Armenia,ARM,Liechtenstein,LIE,0,5,0,0,5
2006,Belarus,BLR,Liechtenstein,LIE,0,0,0,5,5
2006,Kazakhstan,KAZ,Liechtenstein,LIE,0,0,0,5,5
2006,Kyrgyzstan,KGZ,Liechtenstein,LIE,0,0,0,5,5
2006,North Macedonia,MKD,Liechtenstein,LIE,0,0,5,0,5
2006,Russian Federation,RUS,Liechtenstein,LIE,0,0,0,5,5
2006,Serbia and Kosovo: S/RES/1244 (1999),SRB,Liechtenstein,LIE,0,33,0,5,38
2006,Somalia,SOM,Liechtenstein,LIE,0,0,5,0,5
2006,Belarus,BLR,Lithuania,LTU,5,0,0,0,5
2006,Ghana,GHA,Lithuania,LTU,0,0,5,0,5
2006,Nigeria,NGA,Lithuania,LTU,0,0,10,0,10
2006,Russian Federation,RUS,Lithuania,LTU,11,78,0,0,89
2006,Ukraine,UKR,Lithuania,LTU,0,0,5,0,5
2006,Albania,ALB,Luxembourg,LUX,5,0,0,0,5
2006,Bosnia and Herzegovina,BIH,Luxembourg,LUX,5,0,0,0,5
2006,Iran (Islamic Rep. of),IRN,Luxembourg,LUX,5,0,0,0,5
2006,Serbia and Kosovo: S/RES/1244 (1999),SRB,Luxembourg,LUX,12,0,0,0,12
2006,Serbia and Kosovo: S/RES/1244 (1999),SRB,North Macedonia,MKD,0,131,255,184,570
2006,Turkey,TUR,North Macedonia,MKD,0,0,0,5,5
2006,Bangladesh,BGD,Mexico,MEX,0,0,0,5,5
2006,Brazil,BRA,Mexico,MEX,0,0,0,5,5
2006,Central African Rep.,CAF,Mexico,MEX,0,0,5,0,5
2006,China,CHN,Mexico,MEX,0,0,0,13,13
2006,Cameroon,CMR,Mexico,MEX,0,0,12,0,12
2006,Colombia,COL,Mexico,MEX,30,0,5,5,40
2006,Cuba,CUB,Mexico,MEX,0,0,17,69,86
2006,Eritrea,ERI,Mexico,MEX,5,0,0,53,58
2006,Ethiopia,ETH,Mexico,MEX,0,0,12,63,75
2006,Georgia,GEO,Mexico,MEX,0,0,0,5,5
2006,Guatemala,GTM,Mexico,MEX,0,0,11,10,21
2006,Haiti,HTI,Mexico,MEX,12,0,5,5,22
2006,Honduras,HND,Mexico,MEX,0,0,5,14,19
2006,India,IND,Mexico,MEX,0,0,0,13,13
2006,Iraq,IRQ,Mexico,MEX,0,0,0,22,22
2006,Liberia,LBR,Mexico,MEX,0,0,5,0,5
2006,Lebanon,LBN,Mexico,MEX,0,0,0,5,5
2006,Sri Lanka,LKA,Mexico,MEX,0,0,0,14,14
2006,Rep. of Moldova,MDA,Mexico,MEX,0,0,5,0,5
2006,Myanmar,MMR,Mexico,MEX,10,0,0,0,10
2006,Nepal,NPL,Mexico,MEX,5,0,0,5,10
2006,Russian Federation,RUS,Mexico,MEX,0,0,0,5,5
2006,El Salvador,SLV,Mexico,MEX,0,0,11,0,11
2006,Somalia,SOM,Mexico,MEX,13,0,0,5,18
2006,Sudan,SDN,Mexico,MEX,0,0,0,5,5
2006,Turkey,TUR,Mexico,MEX,0,0,5,0,5
2006,Venezuela (Bolivarian Republic of),VEN,Mexico,MEX,5,0,0,0,5
2006,Dem. Rep. of the Congo,COD,Mali,MLI,10,0,5,0,15
2006,Cote d'Ivoire,CIV,Mali,MLI,38,0,38,0,76
2006,Togo,TGO,Mali,MLI,0,0,10,0,10
2006,Burundi,BDI,Malawi,MWI,5,0,0,826,831
2006,Dem. Rep. of the Congo,COD,Malawi,MWI,5,0,0,430,435
2006,Eritrea,ERI,Malawi,MWI,0,0,0,282,282
2006,Ethiopia,ETH,Malawi,MWI,0,0,0,1098,1098
2006,Rwanda,RWA,Malawi,MWI,198,0,612,123,933
2006,Somalia,SOM,Malawi,MWI,0,0,0,861,861
2006,Sudan,SDN,Malawi,MWI,0,0,0,5,5
2006,Algeria,DZA,Malta,MLT,0,0,12,0,12
2006,Egypt,EGY,Malta,MLT,0,0,5,0,5
2006,Burkina Faso,BFA,Malta,MLT,0,0,10,0,10
2006,Chad,TCD,Malta,MLT,0,0,5,0,5
2006,Eritrea,ERI,Malta,MLT,10,251,110,0,371
2006,Ethiopia,ETH,Malta,MLT,5,0,102,0,107
2006,Palestinian,PSE,Malta,MLT,0,0,16,0,16
2006,Ghana,GHA,Malta,MLT,0,0,30,0,30
2006,Cote d'Ivoire,CIV,Malta,MLT,0,5,34,0,39
2006,Iraq,IRQ,Malta,MLT,0,0,12,0,12
2006,Liberia,LBR,Malta,MLT,0,0,16,0,16
2006,Mali,MLI,Malta,MLT,0,0,5,0,5
2006,Morocco,MAR,Malta,MLT,0,0,5,0,5
2006,Niger,NER,Malta,MLT,0,0,65,0,65
2006,Nigeria,NGA,Malta,MLT,0,0,37,0,37
2006,Sierra Leone,SLE,Malta,MLT,0,0,10,0,10
2006,Somalia,SOM,Malta,MLT,10,130,10,0,150
2006,Sudan,SDN,Malta,MLT,0,137,106,5,248
2006,Syrian Arab Rep.,SYR,Malta,MLT,5,0,5,0,10
2006,Togo,TGO,Malta,MLT,0,0,40,0,40
2006,Turkey,TUR,Malta,MLT,0,0,5,0,5
2006,Burundi,BDI,Namibia,NAM,17,0,0,0,17
2006,Dem. Rep. of the Congo,COD,Namibia,NAM,123,0,28,0,151
2006,Liberia,LBR,Namibia,NAM,0,0,5,0,5
2006,Rwanda,RWA,Namibia,NAM,5,0,10,0,15
2006,Sierra Leone,SLE,Namibia,NAM,0,0,11,0,11
2006,Bhutan,BTN,Nepal,NPL,0,25,0,0,25
2006,Afghanistan,AFG,Netherlands,NLD,19,347,448,119,933
2006,Albania,ALB,Netherlands,NLD,0,5,13,10,28
2006,Algeria,DZA,Netherlands,NLD,0,5,30,16,51
2006,Angola,AGO,Netherlands,NLD,0,36,183,34,253
2006,Egypt,EGY,Netherlands,NLD,0,0,11,0,11
2006,Armenia,ARM,Netherlands,NLD,5,33,180,29,247
2006,Azerbaijan,AZE,Netherlands,NLD,10,68,248,62,388
2006,Burundi,BDI,Netherlands,NLD,13,313,173,28,527
2006,Benin,BEN,Netherlands,NLD,0,0,10,0,10
2006,Bangladesh,BGD,Netherlands,NLD,5,0,17,0,22
2006,Bhutan,BTN,Netherlands,NLD,5,5,0,0,10
2006,Burkina Faso,BFA,Netherlands,NLD,0,0,11,0,11
2006,Belarus,BLR,Netherlands,NLD,5,5,39,10,59
2006,Brazil,BRA,Netherlands,NLD,0,0,5,0,5
2006,Bosnia and Herzegovina,BIH,Netherlands,NLD,0,5,90,17,112
2006,Bulgaria,BGR,Netherlands,NLD,0,0,11,0,11
2006,Central African Rep.,CAF,Netherlands,NLD,0,5,0,0,5
2006,Chad,TCD,Netherlands,NLD,0,0,10,0,10
2006,China,CHN,Netherlands,NLD,33,39,181,83,336
2006,Cameroon,CMR,Netherlands,NLD,0,29,40,5,74
2006,Congo,COG,Netherlands,NLD,5,48,73,34,160
2006,Dem. Rep. of the Congo,COD,Netherlands,NLD,28,120,95,39,282
2006,Colombia,COL,Netherlands,NLD,0,56,103,65,224
2006,Cuba,CUB,Netherlands,NLD,0,0,19,5,24
2006,Ecuador,ECU,Netherlands,NLD,0,0,5,0,5
2006,Eritrea,ERI,Netherlands,NLD,12,131,41,21,205
2006,Ethiopia,ETH,Netherlands,NLD,15,90,76,19,200
2006,Gambia,GMB,Netherlands,NLD,0,0,10,0,10
2006,Palestinian,PSE,Netherlands,NLD,0,0,11,13,24
2006,Georgia,GEO,Netherlands,NLD,0,0,125,19,144
2006,Ghana,GHA,Netherlands,NLD,0,0,10,5,15
2006,Guinea-Bissau,GNB,Netherlands,NLD,0,0,5,0,5
2006,Guinea,GIN,Netherlands,NLD,0,42,97,12,151
2006,Croatia,HRV,Netherlands,NLD,0,0,11,0,11
2006,Hungary,HUN,Netherlands,NLD,0,0,0,5,5
2006,Cote d'Ivoire,CIV,Netherlands,NLD,5,141,49,12,207
2006,India,IND,Netherlands,NLD,0,0,55,44,99
2006,Indonesia,IDN,Netherlands,NLD,0,21,5,0,26
2006,Iran (Islamic Rep. of),IRN,Netherlands,NLD,38,109,305,105,557
2006,Iraq,IRQ,Netherlands,NLD,27,365,1677,619,2688
2006,Israel,ISR,Netherlands,NLD,0,0,0,5,5
2006,Jamaica,JAM,Netherlands,NLD,5,0,0,0,5
2006,Jordan,JOR,Netherlands,NLD,0,0,0,5,5
2006,Kazakhstan,KAZ,Netherlands,NLD,0,0,35,5,40
2006,Kenya,KEN,Netherlands,NLD,0,0,13,0,13
2006,Kyrgyzstan,KGZ,Netherlands,NLD,0,0,18,5,23
2006,Dem. People's Rep. of Korea,PRK,Netherlands,NLD,0,0,5,5,10
2006,Liberia,LBR,Netherlands,NLD,5,40,112,15,172
2006,Libya,LBY,Netherlands,NLD,0,5,14,10,29
2006,Lebanon,LBN,Netherlands,NLD,0,10,23,10,43
2006,Sri Lanka,LKA,Netherlands,NLD,5,12,78,30,125
2006,Mauritania,MRT,Netherlands,NLD,0,0,10,0,10
2006,Rep. of Moldova,MDA,Netherlands,NLD,0,0,12,0,12
2006,Mali,MLI,Netherlands,NLD,0,0,0,5,5
2006,Mongolia,MNG,Netherlands,NLD,0,0,113,19,132
2006,Morocco,MAR,Netherlands,NLD,0,5,12,5,22
2006,Mozambique,MOZ,Netherlands,NLD,0,0,5,0,5
2006,Myanmar,MMR,Netherlands,NLD,11,89,5,5,110
2006,Nepal,NPL,Netherlands,NLD,17,23,72,13,125
2006,Niger,NER,Netherlands,NLD,0,0,13,0,13
2006,Nigeria,NGA,Netherlands,NLD,0,20,161,75,256
2006,Pakistan,PAK,Netherlands,NLD,5,21,76,12,114
2006,Peru,PER,Netherlands,NLD,0,0,5,0,5
2006,Philippines,PHL,Netherlands,NLD,0,11,0,0,11
2006,Romania,ROU,Netherlands,NLD,0,5,11,5,21
2006,Russian Federation,RUS,Netherlands,NLD,5,72,185,33,295
2006,Rwanda,RWA,Netherlands,NLD,0,24,46,17,87
2006,Saudi Arabia,SAU,Netherlands,NLD,0,0,5,0,5
2006,Serbia and Kosovo: S/RES/1244 (1999),SRB,Netherlands,NLD,0,27,251,74,352
2006,Sierra Leone,SLE,Netherlands,NLD,0,82,142,32,256
2006,Somalia,SOM,Netherlands,NLD,25,872,331,81,1309
2006,Viet Nam,VNM,Netherlands,NLD,0,5,18,0,23
2006,Sudan,SDN,Netherlands,NLD,13,121,148,44,326
2006,Slovakia,SVK,Netherlands,NLD,0,0,13,0,13
2006,Sweden,SWE,Netherlands,NLD,0,0,0,5,5
2006,Syrian Arab Rep.,SYR,Netherlands,NLD,16,32,169,25,242
2006,United Rep. of Tanzania,TZA,Netherlands,NLD,0,0,15,0,15
2006,Tajikistan,TJK,Netherlands,NLD,0,0,0,5,5
2006,Turkmenistan,TKM,Netherlands,NLD,5,12,0,0,17
2006,Togo,TGO,Netherlands,NLD,0,15,23,5,43
2006,Tunisia,TUN,Netherlands,NLD,0,0,5,5,10
2006,Turkey,TUR,Netherlands,NLD,0,29,176,65,270
2006,Uganda,UGA,Netherlands,NLD,0,21,18,5,44
2006,Ukraine,UKR,Netherlands,NLD,0,5,39,5,49
2006,Uzbekistan,UZB,Netherlands,NLD,5,27,13,5,50
2006,Yemen,YEM,Netherlands,NLD,0,0,12,0,12
2006,Zimbabwe,ZWE,Netherlands,NLD,0,0,5,0,5
2006,Stateless,XXA,Netherlands,NLD,5,34,125,32,196
2006,Central African Rep.,CAF,Niger,NER,0,0,5,0,5
2006,Dem. Rep. of the Congo,COD,Niger,NER,0,0,5,5,10
2006,Cote d'Ivoire,CIV,Niger,NER,5,0,0,5,10
2006,Liberia,LBR,Niger,NER,0,0,0,5,5
2006,Cuba,CUB,Nicaragua,NIC,5,0,0,19,24
2006,Viet Nam,VNM,Nicaragua,NIC,0,0,0,5,5
2006,Central African Rep.,CAF,Nigeria,NGA,0,0,0,5,5
2006,Chad,TCD,Nigeria,NGA,0,0,0,5,5
2006,Cameroon,CMR,Nigeria,NGA,0,0,0,5,5
2006,Cote d'Ivoire,CIV,Nigeria,NGA,0,0,0,13,13
2006,Liberia,LBR,Nigeria,NGA,0,0,0,106,106
2006,Sierra Leone,SLE,Nigeria,NGA,0,0,0,89,89
2006,Sudan,SDN,Nigeria,NGA,0,0,0,5,5
2006,Afghanistan,AFG,Norway,NOR,14,148,37,63,262
2006,Albania,ALB,Norway,NOR,5,0,30,14,49
2006,Algeria,DZA,Norway,NOR,0,0,13,24,37
2006,Angola,AGO,Norway,NOR,0,10,0,5,15
2006,Egypt,EGY,Norway,NOR,0,0,0,5,5
2006,Armenia,ARM,Norway,NOR,0,5,5,14,24
2006,Azerbaijan,AZE,Norway,NOR,0,0,38,15,53
2006,Burundi,BDI,Norway,NOR,0,28,5,17,50
2006,Bangladesh,BGD,Norway,NOR,0,0,0,13,13
2006,Belarus,BLR,Norway,NOR,0,0,5,28,33
2006,Bosnia and Herzegovina,BIH,Norway,NOR,0,0,25,26,51
2006,China,CHN,Norway,NOR,10,13,5,5,33
2006,Cameroon,CMR,Norway,NOR,0,0,5,5,10
2006,Congo,COG,Norway,NOR,0,0,5,0,5
2006,Dem. Rep. of the Congo,COD,Norway,NOR,5,20,5,5,35
2006,Colombia,COL,Norway,NOR,0,5,0,0,5
2006,Czechia,CZE,Norway,NOR,0,0,5,0,5
2006,Eritrea,ERI,Norway,NOR,111,110,5,42,268
2006,Ethiopia,ETH,Norway,NOR,12,0,13,23,48
2006,Georgia,GEO,Norway,NOR,0,0,0,13,13
2006,Ghana,GHA,Norway,NOR,0,0,5,5,10
2006,Guinea,GIN,Norway,NOR,0,0,0,10,10
2006,Croatia,HRV,Norway,NOR,0,0,10,5,15
2006,Cote d'Ivoire,CIV,Norway,NOR,0,5,0,5,10
2006,India,IND,Norway,NOR,0,0,0,10,10
2006,Iran (Islamic Rep. of),IRN,Norway,NOR,5,15,80,46,146
2006,Iraq,IRQ,Norway,NOR,16,274,232,229,751
2006,Israel,ISR,Norway,NOR,0,0,14,0,14
2006,Kazakhstan,KAZ,Norway,NOR,0,0,5,5,10
2006,Kenya,KEN,Norway,NOR,0,0,10,0,10
2006,Kyrgyzstan,KGZ,Norway,NOR,0,0,13,0,13
2006,Dem. People's Rep. of Korea,PRK,Norway,NOR,0,0,0,10,10
2006,Liberia,LBR,Norway,NOR,0,5,5,5,15
2006,Libya,LBY,Norway,NOR,0,0,0,5,5
2006,Lebanon,LBN,Norway,NOR,0,0,5,13,18
2006,Sri Lanka,LKA,Norway,NOR,0,5,5,11,21
2006,North Macedonia,MKD,Norway,NOR,0,0,15,10,25
2006,Rep. of Moldova,MDA,Norway,NOR,0,0,5,0,5
2006,Mongolia,MNG,Norway,NOR,0,0,12,5,17
2006,Morocco,MAR,Norway,NOR,0,0,11,14,25
2006,Myanmar,MMR,Norway,NOR,5,0,0,0,5
2006,Nepal,NPL,Norway,NOR,0,0,70,24,94
2006,Niger,NER,Norway,NOR,0,0,0,5,5
2006,Nigeria,NGA,Norway,NOR,0,5,17,17,39
2006,Pakistan,PAK,Norway,NOR,0,0,5,13,18
2006,Romania,ROU,Norway,NOR,0,0,5,5,10
2006,Russian Federation,RUS,Norway,NOR,21,305,72,100,498
2006,Rwanda,RWA,Norway,NOR,10,18,5,5,38
2006,Serbia and Kosovo: S/RES/1244 (1999),SRB,Norway,NOR,30,10,227,105,372
2006,Sierra Leone,SLE,Norway,NOR,0,0,5,5,10
2006,Somalia,SOM,Norway,NOR,152,177,29,106,464
2006,Viet Nam,VNM,Norway,NOR,0,0,5,10,15
2006,Sudan,SDN,Norway,NOR,0,0,13,0,13
2006,Syrian Arab Rep.,SYR,Norway,NOR,0,5,26,29,60
2006,Togo,TGO,Norway,NOR,0,0,0,5,5
2006,Turkey,TUR,Norway,NOR,0,0,31,31,62
2006,Uganda,UGA,Norway,NOR,0,0,0,5,5
2006,Ukraine,UKR,Norway,NOR,0,0,5,19,24
2006,Uzbekistan,UZB,Norway,NOR,0,0,45,10,55
2006,Venezuela (Bolivarian Republic of),VEN,Norway,NOR,0,0,5,0,5
2006,Western Sahara,ESH,Norway,NOR,0,0,12,0,12
2006,Yemen,YEM,Norway,NOR,5,0,0,0,5
2006,Zimbabwe,ZWE,Norway,NOR,0,0,5,0,5
2006,Stateless,XXA,Norway,NOR,53,49,43,46,191
2006,Egypt,EGY,New Zealand,NZL,5,0,0,0,5
2006,Bangladesh,BGD,New Zealand,NZL,0,0,18,0,18
2006,Brazil,BRA,New Zealand,NZL,0,0,5,0,5
2006,Bulgaria,BGR,New Zealand,NZL,0,0,5,0,5
2006,China,CHN,New Zealand,NZL,12,0,5,0,17
2006,Chile,CHL,New Zealand,NZL,0,0,5,0,5
2006,Czechia,CZE,New Zealand,NZL,0,0,20,0,20
2006,Eritrea,ERI,New Zealand,NZL,5,0,0,0,5
2006,Ethiopia,ETH,New Zealand,NZL,0,0,5,0,5
2006,Fiji,FJI,New Zealand,NZL,0,0,10,0,10
2006,India,IND,New Zealand,NZL,0,0,21,0,21
2006,Iran (Islamic Rep. of),IRN,New Zealand,NZL,10,0,23,0,33
2006,Iraq,IRQ,New Zealand,NZL,30,0,5,0,35
2006,Kyrgyzstan,KGZ,New Zealand,NZL,0,0,5,0,5
2006,Sri Lanka,LKA,New Zealand,NZL,0,0,20,0,20
2006,Myanmar,MMR,New Zealand,NZL,5,0,0,0,5
2006,Nepal,NPL,New Zealand,NZL,0,0,11,0,11
2006,Pakistan,PAK,New Zealand,NZL,0,0,10,0,10
2006,Romania,ROU,New Zealand,NZL,0,0,10,0,10
2006,South Africa,ZAF,New Zealand,NZL,0,0,5,0,5
2006,Saudi Arabia,SAU,New Zealand,NZL,0,0,5,0,5
2006,Somalia,SOM,New Zealand,NZL,5,0,5,0,10
2006,Slovakia,SVK,New Zealand,NZL,0,0,10,0,10
2006,Syrian Arab Rep.,SYR,New Zealand,NZL,0,0,5,0,5
2006,Turkey,TUR,New Zealand,NZL,5,0,0,0,5
2006,Colombia,COL,Panama,PAN,128,0,40,408,576
2006,Cuba,CUB,Panama,PAN,5,0,5,0,10
2006,Ecuador,ECU,Panama,PAN,0,0,5,0,5
2006,Haiti,HTI,Panama,PAN,5,0,0,0,5
2006,Liberia,LBR,Panama,PAN,0,0,0,5,5
2006,Nigeria,NGA,Panama,PAN,0,0,0,5,5
2006,Romania,ROU,Panama,PAN,0,0,0,5,5
2006,Sierra Leone,SLE,Panama,PAN,0,0,0,5,5
2006,Cuba,CUB,Paraguay,PRY,13,0,0,5,18
2006,Colombia,COL,Peru,PER,40,0,12,22,74
2006,Cuba,CUB,Peru,PER,35,0,5,0,40
2006,Iraq,IRQ,Peru,PER,0,0,0,5,5
2006,Israel,ISR,Peru,PER,0,0,0,5,5
2006,Sierra Leone,SLE,Peru,PER,0,0,0,5,5
2006,Somalia,SOM,Peru,PER,0,0,0,5,5
2006,Burundi,BDI,Philippines,PHL,0,0,0,5,5
2006,Palestinian,PSE,Philippines,PHL,0,0,0,5,5
2006,Iran (Islamic Rep. of),IRN,Philippines,PHL,0,0,0,5,5
2006,Liberia,LBR,Philippines,PHL,0,0,0,5,5
2006,Afghanistan,AFG,Poland,POL,0,5,0,16,21
2006,Algeria,DZA,Poland,POL,0,0,10,0,10
2006,Egypt,EGY,Poland,POL,0,0,5,5,10
2006,Armenia,ARM,Poland,POL,0,0,24,10,34
2006,Azerbaijan,AZE,Poland,POL,5,0,0,11,16
2006,Burundi,BDI,Poland,POL,0,0,5,0,5
2006,Bangladesh,BGD,Poland,POL,0,0,13,0,13
2006,Belarus,BLR,Poland,POL,18,5,31,25,79
2006,China,CHN,Poland,POL,0,5,0,0,5
2006,Cameroon,CMR,Poland,POL,0,0,5,5,10
2006,Congo,COG,Poland,POL,0,0,0,5,5
2006,Dem. Rep. of the Congo,COD,Poland,POL,0,0,0,5,5
2006,Palestinian,PSE,Poland,POL,0,0,0,5,5
2006,Georgia,GEO,Poland,POL,0,0,15,27,42
2006,Cote d'Ivoire,CIV,Poland,POL,0,0,5,0,5
2006,India,IND,Poland,POL,0,0,13,5,18
2006,Iraq,IRQ,Poland,POL,0,10,0,10,20
2006,Kazakhstan,KAZ,Poland,POL,0,0,5,21,26
2006,Kenya,KEN,Poland,POL,0,0,5,0,5
2006,Kyrgyzstan,KGZ,Poland,POL,0,0,11,28,39
2006,Liberia,LBR,Poland,POL,0,0,5,0,5
2006,Sri Lanka,LKA,Poland,POL,0,5,0,0,5
2006,Lithuania,LTU,Poland,POL,0,0,0,5,5
2006,Rep. of Moldova,MDA,Poland,POL,0,0,11,5,16
2006,Mongolia,MNG,Poland,POL,0,0,11,0,11
2006,Nepal,NPL,Poland,POL,0,0,5,5,10
2006,Nigeria,NGA,Poland,POL,0,0,12,0,12
2006,Pakistan,PAK,Poland,POL,0,0,28,28,56
2006,Russian Federation,RUS,Poland,POL,383,2015,634,3593,6625
2006,Serbia and Kosovo: S/RES/1244 (1999),SRB,Poland,POL,0,0,5,0,5
2006,Senegal,SEN,Poland,POL,0,5,0,0,5
2006,Sierra Leone,SLE,Poland,POL,0,0,0,5,5
2006,Somalia,SOM,Poland,POL,5,0,0,0,5
2006,Viet Nam,VNM,Poland,POL,0,0,23,5,28
2006,Syrian Arab Rep.,SYR,Poland,POL,0,0,5,5,10
2006,Togo,TGO,Poland,POL,0,0,0,5,5
2006,Tunisia,TUN,Poland,POL,0,0,5,0,5
2006,Turkey,TUR,Poland,POL,12,0,0,5,17
2006,Ukraine,UKR,Poland,POL,0,0,39,19,58
2006,Stateless,XXA,Poland,POL,0,0,5,10,15
2006,Angola,AGO,Portugal,PRT,0,0,5,0,5
2006,Belarus,BLR,Portugal,PRT,0,0,5,0,5
2006,Dem. Rep. of the Congo,COD,Portugal,PRT,5,0,11,0,16
2006,Colombia,COL,Portugal,PRT,0,0,5,0,5
2006,Cuba,CUB,Portugal,PRT,0,0,5,0,5
2006,Eritrea,ERI,Portugal,PRT,5,0,0,0,5
2006,Guinea-Bissau,GNB,Portugal,PRT,0,0,5,0,5
2006,Guinea,GIN,Portugal,PRT,0,0,5,0,5
2006,Cote d'Ivoire,CIV,Portugal,PRT,5,0,0,0,5
2006,Liberia,LBR,Portugal,PRT,5,0,0,0,5
2006,Nepal,NPL,Portugal,PRT,0,0,5,0,5
2006,Nigeria,NGA,Portugal,PRT,0,0,5,0,5
2006,Russian Federation,RUS,Portugal,PRT,5,0,0,0,5
2006,Sierra Leone,SLE,Portugal,PRT,0,0,5,0,5
2006,Turkey,TUR,Portugal,PRT,0,0,5,0,5
2006,Angola,AGO,South Africa,ZAF,0,0,161,0,161
2006,Burundi,BDI,South Africa,ZAF,45,0,15,0,60
2006,Bangladesh,BGD,South Africa,ZAF,0,0,66,0,66
2006,China,CHN,South Africa,ZAF,0,0,56,0,56
2006,Cameroon,CMR,South Africa,ZAF,27,0,11,0,38
2006,Congo,COG,South Africa,ZAF,44,0,37,0,81
2006,Dem. Rep. of the Congo,COD,South Africa,ZAF,204,0,191,0,395
2006,Cuba,CUB,South Africa,ZAF,5,0,0,0,5
2006,Eritrea,ERI,South Africa,ZAF,5,0,5,0,10
2006,Ethiopia,ETH,South Africa,ZAF,50,0,82,0,132
2006,Ghana,GHA,South Africa,ZAF,0,0,5,0,5
2006,India,IND,South Africa,ZAF,0,0,44,0,44
2006,Jordan,JOR,South Africa,ZAF,0,0,18,0,18
2006,Kenya,KEN,South Africa,ZAF,10,0,40,0,50
2006,Liberia,LBR,South Africa,ZAF,0,0,12,0,12
2006,Lesotho,LSO,South Africa,ZAF,0,0,5,0,5
2006,Mali,MLI,South Africa,ZAF,0,0,5,0,5
2006,Malawi,MWI,South Africa,ZAF,0,0,1049,0,1049
2006,Mozambique,MOZ,South Africa,ZAF,0,0,313,0,313
2006,Nigeria,NGA,South Africa,ZAF,0,0,81,0,81
2006,Pakistan,PAK,South Africa,ZAF,0,0,48,0,48
2006,Russian Federation,RUS,South Africa,ZAF,13,0,0,0,13
2006,Rwanda,RWA,South Africa,ZAF,5,0,5,0,10
2006,Senegal,SEN,South Africa,ZAF,0,0,5,0,5
2006,Somalia,SOM,South Africa,ZAF,275,0,24,0,299
2006,United Rep. of Tanzania,TZA,South Africa,ZAF,0,0,266,0,266
2006,Uganda,UGA,South Africa,ZAF,15,0,59,0,74
2006,Zambia,ZMB,South Africa,ZAF,0,0,53,0,53
2006,Zimbabwe,ZWE,South Africa,ZAF,103,0,1878,0,1981
2006,Afghanistan,AFG,Russian Federation,RUS,30,0,792,0,822
2006,Armenia,ARM,Russian Federation,RUS,0,0,10,0,10
2006,Azerbaijan,AZE,Russian Federation,RUS,5,0,17,0,22
2006,Congo,COG,Russian Federation,RUS,0,0,5,0,5
2006,Cuba,CUB,Russian Federation,RUS,0,0,14,0,14
2006,Eritrea,ERI,Russian Federation,RUS,0,0,5,0,5
2006,Ethiopia,ETH,Russian Federation,RUS,0,0,10,0,10
2006,Georgia,GEO,Russian Federation,RUS,0,0,129,0,129
2006,Iraq,IRQ,Russian Federation,RUS,0,0,13,0,13
2006,Kazakhstan,KAZ,Russian Federation,RUS,0,0,5,0,5
2006,Dem. People's Rep. of Korea,PRK,Russian Federation,RUS,0,0,5,0,5
2006,Rep. of Moldova,MDA,Russian Federation,RUS,0,0,5,0,5
2006,Nigeria,NGA,Russian Federation,RUS,0,0,10,0,10
2006,Sudan,SDN,Russian Federation,RUS,0,0,5,0,5
2006,Tajikistan,TJK,Russian Federation,RUS,0,0,5,0,5
2006,Turkmenistan,TKM,Russian Federation,RUS,0,0,16,0,16
2006,Ukraine,UKR,Russian Federation,RUS,0,0,5,0,5
2006,Uzbekistan,UZB,Russian Federation,RUS,0,0,58,0,58
2006,Dem. Rep. of the Congo,COD,Rwanda,RWA,13,0,5,0,18
2006,Colombia,COL,El Salvador,SLV,0,0,0,5,5
2006,Sri Lanka,LKA,El Salvador,SLV,5,0,0,0,5
2006,Chad,TCD,Senegal,SEN,0,0,5,0,5
2006,Congo,COG,Senegal,SEN,0,0,5,0,5
2006,Dem. Rep. of the Congo,COD,Senegal,SEN,0,0,15,0,15
2006,Gambia,GMB,Senegal,SEN,5,0,0,0,5
2006,Guinea,GIN,Senegal,SEN,0,0,16,0,16
2006,Cote d'Ivoire,CIV,Senegal,SEN,5,0,83,0,88
2006,Liberia,LBR,Senegal,SEN,0,0,23,0,23
2006,Mauritania,MRT,Senegal,SEN,0,0,5,0,5
2006,Rwanda,RWA,Senegal,SEN,0,0,10,0,10
2006,Sierra Leone,SLE,Senegal,SEN,0,0,46,0,46
2006,Togo,TGO,Senegal,SEN,0,0,35,0,35
2006,Afghanistan,AFG,Spain,ESP,0,0,0,11,11
2006,Albania,ALB,Spain,ESP,0,0,0,5,5
2006,Algeria,DZA,Spain,ESP,0,0,62,22,84
2006,Angola,AGO,Spain,ESP,0,0,10,0,10
2006,Egypt,EGY,Spain,ESP,0,0,0,5,5
2006,Armenia,ARM,Spain,ESP,0,0,25,5,30
2006,Azerbaijan,AZE,Spain,ESP,5,0,0,0,5
2006,Burundi,BDI,Spain,ESP,0,0,5,0,5
2006,Bangladesh,BGD,Spain,ESP,0,0,134,0,134
2006,Belarus,BLR,Spain,ESP,0,0,5,0,5
2006,Bolivia (Plurinational State of),BOL,Spain,ESP,0,0,14,0,14
2006,Chad,TCD,Spain,ESP,0,0,5,0,5
2006,China,CHN,Spain,ESP,5,0,0,0,5
2006,Cameroon,CMR,Spain,ESP,0,5,21,15,41
2006,Congo,COG,Spain,ESP,0,0,14,0,14
2006,Dem. Rep. of the Congo,COD,Spain,ESP,5,0,78,61,144
2006,Colombia,COL,Spain,ESP,41,5,639,1881,2566
2006,Cuba,CUB,Spain,ESP,0,18,82,23,123
2006,Ecuador,ECU,Spain,ESP,0,0,5,0,5
2006,Equatorial Guinea,GNQ,Spain,ESP,10,10,28,0,48
2006,Eritrea,ERI,Spain,ESP,0,0,5,0,5
2006,Ethiopia,ETH,Spain,ESP,5,0,20,0,25
2006,Gabon,GAB,Spain,ESP,5,0,0,0,5
2006,Gambia,GMB,Spain,ESP,0,0,0,5,5
2006,Georgia,GEO,Spain,ESP,0,0,15,5,20
2006,Ghana,GHA,Spain,ESP,0,0,5,0,5
2006,Guinea-Bissau,GNB,Spain,ESP,0,0,5,0,5
2006,Guinea,GIN,Spain,ESP,0,0,13,11,24
2006,Haiti,HTI,Spain,ESP,0,0,5,0,5
2006,Cote d'Ivoire,CIV,Spain,ESP,10,69,12,19,110
2006,India,IND,Spain,ESP,0,0,5,10,15
2006,Iran (Islamic Rep. of),IRN,Spain,ESP,0,0,24,5,29
2006,Iraq,IRQ,Spain,ESP,13,22,5,17,57
2006,Liberia,LBR,Spain,ESP,0,0,19,10,29
2006,Lebanon,LBN,Spain,ESP,0,0,0,5,5
2006,Sri Lanka,LKA,Spain,ESP,0,0,0,10,10
2006,Mauritania,MRT,Spain,ESP,0,0,5,0,5
2006,Mali,MLI,Spain,ESP,0,0,0,12,12
2006,Mongolia,MNG,Spain,ESP,0,0,5,0,5
2006,Morocco,MAR,Spain,ESP,0,0,13,10,23
2006,Nepal,NPL,Spain,ESP,0,5,10,11,26
2006,Nigeria,NGA,Spain,ESP,0,0,39,31,70
2006,Pakistan,PAK,Spain,ESP,11,0,0,10,21
2006,Peru,PER,Spain,ESP,0,0,0,10,10
2006,Philippines,PHL,Spain,ESP,0,0,0,5,5
2006,Romania,ROU,Spain,ESP,0,5,13,0,18
2006,Russian Federation,RUS,Spain,ESP,14,10,31,13,68
2006,Senegal,SEN,Spain,ESP,0,0,0,5,5
2006,Sierra Leone,SLE,Spain,ESP,0,0,5,5,10
2006,Somalia,SOM,Spain,ESP,5,0,0,13,18
2006,Sudan,SDN,Spain,ESP,0,0,24,0,24
2006,Syrian Arab Rep.,SYR,Spain,ESP,0,0,0,12,12
2006,Turkey,TUR,Spain,ESP,5,0,20,12,37
2006,Ukraine,UKR,Spain,ESP,0,0,17,0,17
2006,Uzbekistan,UZB,Spain,ESP,0,0,5,0,5
2006,Venezuela (Bolivarian Republic of),VEN,Spain,ESP,19,0,5,0,24
2006,Stateless,XXA,Spain,ESP,5,14,5,97,121
2006,Afghanistan,AFG,Slovakia,SVK,0,0,26,29,55
2006,Armenia,ARM,Slovakia,SVK,0,0,0,11,11
2006,Bangladesh,BGD,Slovakia,SVK,0,0,65,125,190
2006,Belarus,BLR,Slovakia,SVK,0,0,0,11,11
2006,China,CHN,Slovakia,SVK,0,0,74,104,178
2006,Cuba,CUB,Slovakia,SVK,0,0,5,0,5
2006,Palestinian,PSE,Slovakia,SVK,0,0,10,19,29
2006,Georgia,GEO,Slovakia,SVK,0,0,74,153,227
2006,India,IND,Slovakia,SVK,0,0,197,480,677
2006,Iran (Islamic Rep. of),IRN,Slovakia,SVK,5,0,0,5,10
2006,Iraq,IRQ,Slovakia,SVK,0,0,62,115,177
2006,Kazakhstan,KAZ,Slovakia,SVK,0,0,0,5,5
2006,Lebanon,LBN,Slovakia,SVK,0,0,0,5,5
2006,Sri Lanka,LKA,Slovakia,SVK,0,0,5,5,10
2006,North Macedonia,MKD,Slovakia,SVK,0,0,0,5,5
2006,Rep. of Moldova,MDA,Slovakia,SVK,0,0,98,275,373
2006,Nepal,NPL,Slovakia,SVK,0,0,0,5,5
2006,Nigeria,NGA,Slovakia,SVK,0,0,14,0,14
2006,Pakistan,PAK,Slovakia,SVK,0,0,78,132,210
2006,Russian Federation,RUS,Slovakia,SVK,0,0,106,367,473
2006,Serbia and Kosovo: S/RES/1244 (1999),SRB,Slovakia,SVK,0,0,5,11,16
2006,Somalia,SOM,Slovakia,SVK,0,0,5,0,5
2006,Viet Nam,VNM,Slovakia,SVK,0,0,16,42,58
2006,Syrian Arab Rep.,SYR,Slovakia,SVK,0,0,0,5,5
2006,Turkey,TUR,Slovakia,SVK,0,0,5,23,28
2006,Ukraine,UKR,Slovakia,SVK,0,0,15,14,29
2006,Stateless,XXA,Slovakia,SVK,0,0,0,5,5
2006,Afghanistan,AFG,Sweden,SWE,15,90,173,72,350
2006,Albania,ALB,Sweden,SWE,0,5,49,21,75
2006,Algeria,DZA,Sweden,SWE,0,0,55,48,103
2006,Angola,AGO,Sweden,SWE,0,0,13,0,13
2006,Egypt,EGY,Sweden,SWE,5,5,25,11,46
2006,Argentina,ARG,Sweden,SWE,0,0,10,0,10
2006,Armenia,ARM,Sweden,SWE,0,32,139,69,240
2006,Azerbaijan,AZE,Sweden,SWE,5,57,148,43,253
2006,Burundi,BDI,Sweden,SWE,5,226,36,14,281
2006,Benin,BEN,Sweden,SWE,0,0,0,5,5
2006,Bangladesh,BGD,Sweden,SWE,0,5,44,10,59
2006,Belarus,BLR,Sweden,SWE,0,10,130,141,281
2006,Bolivia (Plurinational State of),BOL,Sweden,SWE,0,5,513,73,591
2006,Brazil,BRA,Sweden,SWE,0,0,10,0,10
2006,Bosnia and Herzegovina,BIH,Sweden,SWE,0,36,164,72,272
2006,Bulgaria,BGR,Sweden,SWE,0,5,585,147,737
2006,China,CHN,Sweden,SWE,5,0,28,33,66
2006,Chile,CHL,Sweden,SWE,0,5,52,0,57
2006,Cameroon,CMR,Sweden,SWE,0,0,16,5,21
2006,Congo,COG,Sweden,SWE,0,0,12,0,12
2006,Dem. Rep. of the Congo,COD,Sweden,SWE,0,10,61,10,81
2006,Colombia,COL,Sweden,SWE,0,5,14,0,19
2006,Cuba,CUB,Sweden,SWE,5,0,13,0,18
2006,Ecuador,ECU,Sweden,SWE,0,5,22,5,32
2006,Eritrea,ERI,Sweden,SWE,62,187,142,65,456
2006,Estonia,EST,Sweden,SWE,0,0,5,5,10
2006,Ethiopia,ETH,Sweden,SWE,5,5,43,5,58
2006,Gambia,GMB,Sweden,SWE,0,0,5,5,10
2006,Georgia,GEO,Sweden,SWE,0,10,75,51,136
2006,Ghana,GHA,Sweden,SWE,0,0,5,5,10
2006,Guinea,GIN,Sweden,SWE,0,0,20,5,25
2006,Honduras,HND,Sweden,SWE,0,0,5,5,10
2006,Croatia,HRV,Sweden,SWE,0,5,42,12,59
2006,Hungary,HUN,Sweden,SWE,0,0,147,204,351
2006,Cote d'Ivoire,CIV,Sweden,SWE,0,0,22,10,32
2006,India,IND,Sweden,SWE,0,0,59,71,130
2006,Iran (Islamic Rep. of),IRN,Sweden,SWE,26,60,206,99,391
2006,Iraq,IRQ,Sweden,SWE,184,3853,430,617,5084
2006,Israel,ISR,Sweden,SWE,0,11,14,5,30
2006,Italy,ITA,Sweden,SWE,0,0,5,0,5
2006,Jordan,JOR,Sweden,SWE,5,5,40,12,62
2006,Kazakhstan,KAZ,Sweden,SWE,0,30,50,34,114
2006,Kenya,KEN,Sweden,SWE,0,0,12,5,17
2006,Kyrgyzstan,KGZ,Sweden,SWE,0,5,29,10,44
2006,Rep. of Korea,KOR,Sweden,SWE,0,0,0,5,5
2006,Dem. People's Rep. of Korea,PRK,Sweden,SWE,0,0,0,5,5
2006,Kuwait,KWT,Sweden,SWE,0,0,0,5,5
2006,Liberia,LBR,Sweden,SWE,0,5,10,5,20
2006,Libya,LBY,Sweden,SWE,0,5,114,90,209
2006,Lebanon,LBN,Sweden,SWE,0,12,104,70,186
2006,Sri Lanka,LKA,Sweden,SWE,0,0,12,12,24
2006,Latvia,LVA,Sweden,SWE,0,0,5,5,10
2006,Mauritania,MRT,Sweden,SWE,0,0,5,0,5
2006,North Macedonia,MKD,Sweden,SWE,0,0,51,34,85
2006,Rep. of Moldova,MDA,Sweden,SWE,0,0,28,51,79
2006,Mali,MLI,Sweden,SWE,0,0,5,0,5
2006,Mongolia,MNG,Sweden,SWE,0,10,267,87,364
2006,Morocco,MAR,Sweden,SWE,0,5,14,13,32
2006,Montenegro,MNE,Sweden,SWE,0,5,12,5,22
2006,Myanmar,MMR,Sweden,SWE,5,5,0,0,10
2006,Nepal,NPL,Sweden,SWE,0,0,14,5,19
2006,Netherlands,NLD,Sweden,SWE,0,5,0,0,5
2006,Niger,NER,Sweden,SWE,0,0,5,0,5
2006,Nicaragua,NIC,Sweden,SWE,0,0,5,0,5
2006,Nigeria,NGA,Sweden,SWE,0,0,73,30,103
2006,Pakistan,PAK,Sweden,SWE,5,0,27,10,42
2006,Peru,PER,Sweden,SWE,0,5,12,5,22
2006,Romania,ROU,Sweden,SWE,0,0,204,76,280
2006,Russian Federation,RUS,Sweden,SWE,13,263,354,268,898
2006,Rwanda,RWA,Sweden,SWE,0,0,11,5,16
2006,El Salvador,SLV,Sweden,SWE,0,10,29,5,44
2006,Serbia and Kosovo: S/RES/1244 (1999),SRB,Sweden,SWE,113,273,981,495,1862
2006,Senegal,SEN,Sweden,SWE,0,0,5,0,5
2006,Sierra Leone,SLE,Sweden,SWE,0,5,5,20,30
2006,Somalia,SOM,Sweden,SWE,89,643,108,91,931
2006,Viet Nam,VNM,Sweden,SWE,0,0,25,17,42
2006,Sudan,SDN,Sweden,SWE,5,5,25,11,46
2006,Slovakia,SVK,Sweden,SWE,0,0,5,0,5
2006,Syrian Arab Rep.,SYR,Sweden,SWE,22,31,121,82,256
2006,United Rep. of Tanzania,TZA,Sweden,SWE,0,0,12,0,12
2006,Thailand,THA,Sweden,SWE,0,0,5,0,5
2006,Tajikistan,TJK,Sweden,SWE,0,0,0,14,14
2006,Turkmenistan,TKM,Sweden,SWE,0,0,14,0,14
2006,Togo,TGO,Sweden,SWE,0,0,11,0,11
2006,Tunisia,TUN,Sweden,SWE,0,0,26,14,40
2006,Turkey,TUR,Sweden,SWE,0,26,140,66,232
2006,Uganda,UGA,Sweden,SWE,0,10,11,5,26
2006,Ukraine,UKR,Sweden,SWE,0,15,48,35,98
2006,Uruguay,URY,Sweden,SWE,0,0,5,0,5
2006,United States of America,USA,Sweden,SWE,0,0,11,0,11
2006,Uzbekistan,UZB,Sweden,SWE,0,231,42,67,340
2006,Venezuela (Bolivarian Republic of),VEN,Sweden,SWE,0,0,0,5,5
2006,Yemen,YEM,Sweden,SWE,13,0,10,5,28
2006,Zimbabwe,ZWE,Sweden,SWE,0,5,5,0,10
2006,Stateless,XXA,Sweden,SWE,23,213,280,133,649
2006,Afghanistan,AFG,Switzerland,CHE,23,261,180,42,506
2006,Albania,ALB,Switzerland,CHE,0,0,18,20,38
2006,Algeria,DZA,Switzerland,CHE,5,13,48,120,186
2006,Angola,AGO,Switzerland,CHE,0,176,74,10,260
2006,Egypt,EGY,Switzerland,CHE,0,0,10,10,20
2006,Armenia,ARM,Switzerland,CHE,0,18,72,67,157
2006,Azerbaijan,AZE,Switzerland,CHE,5,12,19,17,53
2006,Burundi,BDI,Switzerland,CHE,5,11,15,0,31
2006,Benin,BEN,Switzerland,CHE,0,0,5,13,18
2006,Bangladesh,BGD,Switzerland,CHE,5,11,35,10,61
2006,Burkina Faso,BFA,Switzerland,CHE,0,0,5,0,5
2006,Belarus,BLR,Switzerland,CHE,0,5,25,30,60
2006,Bolivia (Plurinational State of),BOL,Switzerland,CHE,0,10,5,0,15
2006,Brazil,BRA,Switzerland,CHE,0,0,5,0,5
2006,Bosnia and Herzegovina,BIH,Switzerland,CHE,52,390,174,122,738
2006,Bulgaria,BGR,Switzerland,CHE,0,5,56,124,185
2006,Cambodia,KHM,Switzerland,CHE,19,0,0,0,19
2006,Chad,TCD,Switzerland,CHE,12,0,0,0,12
2006,China,CHN,Switzerland,CHE,73,389,590,26,1078
2006,Cameroon,CMR,Switzerland,CHE,20,13,93,52,178
2006,Congo,COG,Switzerland,CHE,5,0,14,5,24
2006,Dem. Rep. of the Congo,COD,Switzerland,CHE,15,192,149,34,390
2006,Colombia,COL,Switzerland,CHE,28,5,0,5,38
2006,Cuba,CUB,Switzerland,CHE,0,14,0,0,14
2006,Czechia,CZE,Switzerland,CHE,0,0,0,5,5
2006,Ecuador,ECU,Switzerland,CHE,0,0,0,14,14
2006,Equatorial Guinea,GNQ,Switzerland,CHE,0,5,0,0,5
2006,Eritrea,ERI,Switzerland,CHE,398,127,55,100,680
2006,Ethiopia,ETH,Switzerland,CHE,31,116,71,28,246
2006,Gabon,GAB,Switzerland,CHE,0,0,0,5,5
2006,Gambia,GMB,Switzerland,CHE,5,0,12,0,17
2006,United Kingdom of Great Britain and Northern Ireland,GBR,Switzerland,CHE,0,0,0,5,5
2006,Georgia,GEO,Switzerland,CHE,0,12,121,165,298
2006,Ghana,GHA,Switzerland,CHE,0,0,0,11,11
2006,Guinea-Bissau,GNB,Switzerland,CHE,0,0,16,16,32
2006,Guinea,GIN,Switzerland,CHE,5,10,64,40,119
2006,Croatia,HRV,Switzerland,CHE,0,16,0,18,34
2006,Cote d'Ivoire,CIV,Switzerland,CHE,14,10,118,35,177
2006,India,IND,Switzerland,CHE,0,0,10,24,34
2006,Iran (Islamic Rep. of),IRN,Switzerland,CHE,29,153,249,48,479
2006,Iraq,IRQ,Switzerland,CHE,111,1281,579,191,2162
2006,Israel,ISR,Switzerland,CHE,0,0,5,5,10
2006,Jordan,JOR,Switzerland,CHE,0,10,0,0,10
2006,Kazakhstan,KAZ,Switzerland,CHE,0,11,5,0,16
2006,Kenya,KEN,Switzerland,CHE,0,0,12,0,12
2006,Dem. People's Rep. of Korea,PRK,Switzerland,CHE,0,11,0,0,11
2006,Lao People's Dem. Rep.,LAO,Switzerland,CHE,11,0,0,0,11
2006,Liberia,LBR,Switzerland,CHE,0,5,24,15,44
2006,Libya,LBY,Switzerland,CHE,14,5,5,22,46
2006,Lebanon,LBN,Switzerland,CHE,5,5,18,35,63
2006,Sri Lanka,LKA,Switzerland,CHE,64,105,132,42,343
2006,Lithuania,LTU,Switzerland,CHE,0,0,0,5,5
2006,Latvia,LVA,Switzerland,CHE,0,5,0,5,10
2006,Madagascar,MDG,Switzerland,CHE,0,0,5,0,5
2006,Mauritania,MRT,Switzerland,CHE,0,0,0,5,5
2006,North Macedonia,MKD,Switzerland,CHE,0,27,39,52,118
2006,Rep. of Moldova,MDA,Switzerland,CHE,0,0,15,40,55
2006,Mali,MLI,Switzerland,CHE,0,0,16,21,37
2006,Mongolia,MNG,Switzerland,CHE,0,18,131,75,224
2006,Morocco,MAR,Switzerland,CHE,5,5,5,30,45
2006,Montenegro,MNE,Switzerland,CHE,0,0,14,0,14
2006,Myanmar,MMR,Switzerland,CHE,0,5,5,0,10
2006,Nepal,NPL,Switzerland,CHE,0,0,143,11,154
2006,Niger,NER,Switzerland,CHE,0,5,10,5,20
2006,Nigeria,NGA,Switzerland,CHE,0,5,118,112,235
2006,Pakistan,PAK,Switzerland,CHE,0,23,39,41,103
2006,Poland,POL,Switzerland,CHE,0,0,5,15,20
2006,Romania,ROU,Switzerland,CHE,0,0,24,46,70
2006,South Africa,ZAF,Switzerland,CHE,0,0,0,11,11
2006,Russian Federation,RUS,Switzerland,CHE,17,119,191,176,503
2006,Rwanda,RWA,Switzerland,CHE,34,10,15,0,59
2006,Serbia and Kosovo: S/RES/1244 (1999),SRB,Switzerland,CHE,60,704,793,470,2027
2006,Senegal,SEN,Switzerland,CHE,0,0,13,11,24
2006,Sierra Leone,SLE,Switzerland,CHE,0,15,22,20,57
2006,Somalia,SOM,Switzerland,CHE,20,356,263,66,705
2006,Viet Nam,VNM,Switzerland,CHE,29,0,0,0,29
2006,Sudan,SDN,Switzerland,CHE,5,22,43,35,105
2006,Slovakia,SVK,Switzerland,CHE,0,0,0,5,5
2006,Syrian Arab Rep.,SYR,Switzerland,CHE,42,104,105,47,298
2006,Turkmenistan,TKM,Switzerland,CHE,0,5,0,0,5
2006,Togo,TGO,Switzerland,CHE,131,19,92,27,269
2006,Tunisia,TUN,Switzerland,CHE,64,0,20,19,103
2006,Turkey,TUR,Switzerland,CHE,455,220,372,137,1184
2006,Uganda,UGA,Switzerland,CHE,0,0,15,10,25
2006,Ukraine,UKR,Switzerland,CHE,0,10,5,25,40
2006,Uzbekistan,UZB,Switzerland,CHE,11,5,5,0,21
2006,Western Sahara,ESH,Switzerland,CHE,0,0,0,5,5
2006,Yemen,YEM,Switzerland,CHE,5,15,11,0,31
2006,Zimbabwe,ZWE,Switzerland,CHE,0,0,18,26,44
2006,Indonesia,IDN,Timor-Leste,TLS,0,0,0,5,5
2006,Central African Rep.,CAF,Togo,TGO,10,0,0,0,10
2006,Dem. Rep. of the Congo,COD,Togo,TGO,5,0,10,0,15
2006,Cote d'Ivoire,CIV,Togo,TGO,31,0,17,0,48
2006,Rwanda,RWA,Togo,TGO,14,0,0,0,14
2006,Burundi,BDI,Uganda,UGA,75,0,40,0,115
2006,Dem. Rep. of the Congo,COD,Uganda,UGA,373,0,0,0,373
2006,Eritrea,ERI,Uganda,UGA,5,0,23,0,28
2006,Ethiopia,ETH,Uganda,UGA,23,0,56,0,79
2006,Kenya,KEN,Uganda,UGA,12,0,5,0,17
2006,Pakistan,PAK,Uganda,UGA,0,0,5,0,5
2006,Rwanda,RWA,Uganda,UGA,1066,0,1630,0,2696
2006,Somalia,SOM,Uganda,UGA,2046,0,0,0,2046
2006,Sudan,SDN,Uganda,UGA,42,0,5,0,47
2006,Afghanistan,AFG,Ukraine,UKR,32,0,114,38,184
2006,Algeria,DZA,Ukraine,UKR,0,0,0,5,5
2006,Angola,AGO,Ukraine,UKR,0,0,0,11,11
2006,Armenia,ARM,Ukraine,UKR,0,0,13,30,43
2006,Azerbaijan,AZE,Ukraine,UKR,0,0,22,11,33
2006,Bangladesh,BGD,Ukraine,UKR,0,0,22,221,243
2006,Belarus,BLR,Ukraine,UKR,0,0,0,11,11
2006,Bulgaria,BGR,Ukraine,UKR,0,0,0,5,5
2006,China,CHN,Ukraine,UKR,0,0,0,11,11
2006,Cameroon,CMR,Ukraine,UKR,0,0,0,11,11
2006,Congo,COG,Ukraine,UKR,0,0,11,0,11
2006,Dem. Rep. of the Congo,COD,Ukraine,UKR,0,0,12,5,17
2006,Cuba,CUB,Ukraine,UKR,0,0,0,5,5
2006,Eritrea,ERI,Ukraine,UKR,0,0,0,5,5
2006,Ethiopia,ETH,Ukraine,UKR,0,0,11,10,21
2006,Palestinian,PSE,Ukraine,UKR,0,0,19,137,156
2006,Georgia,GEO,Ukraine,UKR,0,0,13,54,67
2006,Ghana,GHA,Ukraine,UKR,0,0,0,20,20
2006,Guinea,GIN,Ukraine,UKR,0,0,0,5,5
2006,Cote d'Ivoire,CIV,Ukraine,UKR,0,0,0,11,11
2006,India,IND,Ukraine,UKR,0,0,0,634,634
2006,Iran (Islamic Rep. of),IRN,Ukraine,UKR,5,0,36,0,41
2006,Iraq,IRQ,Ukraine,UKR,0,0,24,91,115
2006,Jordan,JOR,Ukraine,UKR,0,0,5,5,10
2006,Kazakhstan,KAZ,Ukraine,UKR,0,0,0,14,14
2006,Kyrgyzstan,KGZ,Ukraine,UKR,0,0,0,18,18
2006,Liberia,LBR,Ukraine,UKR,0,0,5,0,5
2006,Lebanon,LBN,Ukraine,UKR,0,0,0,12,12
2006,Sri Lanka,LKA,Ukraine,UKR,0,0,5,30,35
2006,Rep. of Moldova,MDA,Ukraine,UKR,0,0,0,24,24
2006,Mongolia,MNG,Ukraine,UKR,0,0,0,5,5
2006,Nigeria,NGA,Ukraine,UKR,0,0,27,26,53
2006,Pakistan,PAK,Ukraine,UKR,0,0,16,428,444
2006,Russian Federation,RUS,Ukraine,UKR,0,0,25,131,156
2006,Somalia,SOM,Ukraine,UKR,0,0,58,49,107
2006,Viet Nam,VNM,Ukraine,UKR,0,0,0,24,24
2006,Sudan,SDN,Ukraine,UKR,0,0,12,5,17
2006,Syrian Arab Rep.,SYR,Ukraine,UKR,0,0,18,23,41
2006,Tajikistan,TJK,Ukraine,UKR,0,0,0,10,10
2006,Turkmenistan,TKM,Ukraine,UKR,0,0,5,5,10
2006,Togo,TGO,Ukraine,UKR,0,0,0,10,10
2006,Turkey,TUR,Ukraine,UKR,0,0,10,0,10
2006,Uganda,UGA,Ukraine,UKR,0,0,0,5,5
2006,Uzbekistan,UZB,Ukraine,UKR,5,0,10,64,79
2006,Stateless,XXA,Ukraine,UKR,0,0,5,0,5
2006,Colombia,COL,Uruguay,URY,0,0,5,0,5
2006,Colombia,COL,Venezuela (Bolivarian Republic of),VEN,326,0,49,0,375
2006,Haiti,HTI,Venezuela (Bolivarian Republic of),VEN,5,0,0,0,5
2006,Peru,PER,Venezuela (Bolivarian Republic of),VEN,5,0,0,0,5
2007,Benin,BEN,Argentina,ARG,0,0,0,5,5
2007,Cameroon,CMR,Argentina,ARG,0,0,5,0,5
2007,Colombia,COL,Argentina,ARG,15,0,29,5,49
2007,Cuba,CUB,Argentina,ARG,0,0,14,0,14
2007,Guinea-Bissau,GNB,Argentina,ARG,0,0,5,0,5
2007,Haiti,HTI,Argentina,ARG,5,0,5,0,10
2007,Cote d'Ivoire,CIV,Argentina,ARG,10,0,0,0,10
2007,India,IND,Argentina,ARG,0,0,5,0,5
2007,Kazakhstan,KAZ,Argentina,ARG,5,0,0,0,5
2007,Liberia,LBR,Argentina,ARG,5,0,0,0,5
2007,Nigeria,NGA,Argentina,ARG,0,0,12,0,12
2007,Peru,PER,Argentina,ARG,10,0,35,5,50
2007,Russian Federation,RUS,Argentina,ARG,0,0,5,0,5
2007,Senegal,SEN,Argentina,ARG,0,0,131,0,131
2007,Cuba,CUB,Armenia,ARM,0,0,5,0,5
2007,Iran (Islamic Rep. of),IRN,Armenia,ARM,0,0,5,5,10
2007,Iraq,IRQ,Armenia,ARM,0,253,0,11,264
2007,Afghanistan,AFG,Australia,AUS,23,0,0,0,23
2007,Albania,ALB,Australia,AUS,0,0,13,0,13
2007,Egypt,EGY,Australia,AUS,26,0,15,0,41
2007,Bahrain,BHR,Australia,AUS,0,0,5,0,5
2007,Burundi,BDI,Australia,AUS,5,0,0,0,5
2007,Bangladesh,BGD,Australia,AUS,11,0,49,0,60
2007,China,CHN,Australia,AUS,140,0,867,10,1017
2007,Chile,CHL,Australia,AUS,0,0,12,0,12
2007,Cameroon,CMR,Australia,AUS,0,0,5,0,5
2007,Colombia,COL,Australia,AUS,11,0,18,0,29
2007,Eritrea,ERI,Australia,AUS,13,0,0,0,13
2007,Ethiopia,ETH,Australia,AUS,12,0,13,0,25
2007,Fiji,FJI,Australia,AUS,26,0,52,0,78
2007,Palestinian,PSE,Australia,AUS,5,0,5,0,10
2007,Ghana,GHA,Australia,AUS,0,0,16,0,16
2007,"China, Hong Kong SAR",HKG,Australia,AUS,0,0,11,0,11
2007,Croatia,HRV,Australia,AUS,5,0,0,0,5
2007,India,IND,Australia,AUS,12,0,339,5,356
2007,Indonesia,IDN,Australia,AUS,5,0,162,0,167
2007,Iran (Islamic Rep. of),IRN,Australia,AUS,46,0,28,5,79
2007,Iraq,IRQ,Australia,AUS,223,0,10,0,233
2007,Israel,ISR,Australia,AUS,0,0,12,0,12
2007,Kenya,KEN,Australia,AUS,0,0,5,0,5
2007,Rep. of Korea,KOR,Australia,AUS,0,0,68,0,68
2007,Dem. People's Rep. of Korea,PRK,Australia,AUS,5,0,0,0,5
2007,Liberia,LBR,Australia,AUS,5,0,0,0,5
2007,Lebanon,LBN,Australia,AUS,10,0,71,5,86
2007,Sri Lanka,LKA,Australia,AUS,425,0,55,0,480
2007,Malaysia,MYS,Australia,AUS,5,0,119,0,124
2007,Mongolia,MNG,Australia,AUS,5,0,15,0,20
2007,Morocco,MAR,Australia,AUS,0,0,12,0,12
2007,Myanmar,MMR,Australia,AUS,33,0,10,0,43
2007,Nepal,NPL,Australia,AUS,5,0,36,0,41
2007,Netherlands,NLD,Australia,AUS,0,0,0,5,5
2007,Nigeria,NGA,Australia,AUS,0,0,13,0,13
2007,New Zealand,NZL,Australia,AUS,0,0,5,5,10
2007,Pakistan,PAK,Australia,AUS,63,0,58,0,121
2007,Philippines,PHL,Australia,AUS,0,0,37,0,37
2007,Papua New Guinea,PNG,Australia,AUS,10,0,10,0,20
2007,Portugal,PRT,Australia,AUS,0,0,10,0,10
2007,Romania,ROU,Australia,AUS,0,0,5,0,5
2007,South Africa,ZAF,Australia,AUS,0,0,12,0,12
2007,Russian Federation,RUS,Australia,AUS,5,0,16,0,21
2007,Saudi Arabia,SAU,Australia,AUS,5,0,0,0,5
2007,Serbia and Kosovo: S/RES/1244 (1999),SRB,Australia,AUS,5,0,5,0,10
2007,Somalia,SOM,Australia,AUS,5,0,0,0,5
2007,Viet Nam,VNM,Australia,AUS,0,0,32,0,32
2007,Sudan,SDN,Australia,AUS,12,0,0,0,12
2007,United Rep. of Tanzania,TZA,Australia,AUS,0,0,5,0,5
2007,Thailand,THA,Australia,AUS,0,0,23,5,28
2007,Timor-Leste,TLS,Australia,AUS,0,0,19,0,19
2007,Tonga,TON,Australia,AUS,0,0,14,0,14
2007,Turkey,TUR,Australia,AUS,0,0,26,0,26
2007,Uzbekistan,UZB,Australia,AUS,0,0,5,0,5
2007,Zimbabwe,ZWE,Australia,AUS,42,0,42,5,89
2007,Stateless,XXA,Australia,AUS,5,0,5,0,10
2007,Tibetan,TIB,Australia,AUS,0,0,5,0,5
2007,Afghanistan,AFG,Azerbaijan,AZE,0,0,146,5,151
2007,Iran (Islamic Rep. of),IRN,Azerbaijan,AZE,15,0,31,5,51
2007,Iraq,IRQ,Azerbaijan,AZE,5,0,15,0,20
2007,Jordan,JOR,Azerbaijan,AZE,0,0,0,5,5
2007,Pakistan,PAK,Azerbaijan,AZE,0,0,18,0,18
2007,Russian Federation,RUS,Azerbaijan,AZE,0,0,5,0,5
2007,Dem. Rep. of the Congo,COD,Burundi,BDI,167,0,395,659,1221
2007,Afghanistan,AFG,Belgium,BEL,29,16,282,10,337
2007,Albania,ALB,Belgium,BEL,49,0,66,30,145
2007,Algeria,DZA,Belgium,BEL,11,0,72,20,103
2007,Angola,AGO,Belgium,BEL,13,0,180,5,198
2007,Egypt,EGY,Belgium,BEL,0,0,28,0,28
2007,Armenia,ARM,Belgium,BEL,5,0,241,17,263
2007,Azerbaijan,AZE,Belgium,BEL,12,0,23,5,40
2007,Burundi,BDI,Belgium,BEL,54,0,93,15,162
2007,Benin,BEN,Belgium,BEL,0,0,13,0,13
2007,Bangladesh,BGD,Belgium,BEL,5,0,56,0,61
2007,Bhutan,BTN,Belgium,BEL,0,0,13,0,13
2007,Burkina Faso,BFA,Belgium,BEL,5,0,10,5,20
2007,Belarus,BLR,Belgium,BEL,18,0,54,10,82
2007,Bosnia and Herzegovina,BIH,Belgium,BEL,10,0,33,11,54
2007,Bulgaria,BGR,Belgium,BEL,0,0,16,5,21
2007,Central African Rep.,CAF,Belgium,BEL,5,0,0,0,5
2007,Chad,TCD,Belgium,BEL,18,0,10,0,28
2007,China,CHN,Belgium,BEL,103,0,101,5,209
2007,Cameroon,CMR,Belgium,BEL,53,0,221,10,284
2007,Congo,COG,Belgium,BEL,5,0,35,5,45
2007,Dem. Rep. of the Congo,COD,Belgium,BEL,148,0,901,70,1119
2007,Colombia,COL,Belgium,BEL,5,0,0,0,5
2007,Cuba,CUB,Belgium,BEL,0,0,5,0,5
2007,Djibouti,DJI,Belgium,BEL,20,0,40,16,76
2007,Eritrea,ERI,Belgium,BEL,14,10,10,0,34
2007,Ethiopia,ETH,Belgium,BEL,14,0,21,0,35
2007,Gabon,GAB,Belgium,BEL,0,0,5,0,5
2007,Gambia,GMB,Belgium,BEL,0,0,10,0,10
2007,Palestinian,PSE,Belgium,BEL,14,0,5,5,24
2007,Georgia,GEO,Belgium,BEL,0,0,79,10,89
2007,Ghana,GHA,Belgium,BEL,0,0,10,0,10
2007,Guinea-Bissau,GNB,Belgium,BEL,5,0,0,0,5
2007,Guatemala,GTM,Belgium,BEL,0,0,5,0,5
2007,Guinea,GIN,Belgium,BEL,116,0,317,13,446
2007,Haiti,HTI,Belgium,BEL,5,0,0,0,5
2007,Croatia,HRV,Belgium,BEL,0,0,0,5,5
2007,Cote d'Ivoire,CIV,Belgium,BEL,55,0,196,11,262
2007,India,IND,Belgium,BEL,0,0,28,5,33
2007,Iran (Islamic Rep. of),IRN,Belgium,BEL,58,0,345,51,454
2007,Iraq,IRQ,Belgium,BEL,206,238,241,67,752
2007,Israel,ISR,Belgium,BEL,0,0,11,5,16
2007,Jamaica,JAM,Belgium,BEL,0,0,5,0,5
2007,Jordan,JOR,Belgium,BEL,0,0,13,0,13
2007,Kazakhstan,KAZ,Belgium,BEL,0,0,23,16,39
2007,Kenya,KEN,Belgium,BEL,5,0,33,0,38
2007,Kyrgyzstan,KGZ,Belgium,BEL,0,0,24,0,24
2007,Dem. People's Rep. of Korea,PRK,Belgium,BEL,5,0,0,0,5
2007,Liberia,LBR,Belgium,BEL,0,0,13,5,18
2007,Libya,LBY,Belgium,BEL,10,0,24,0,34
2007,Lebanon,LBN,Belgium,BEL,17,0,139,0,156
2007,Sri Lanka,LKA,Belgium,BEL,25,0,19,5,49
2007,Madagascar,MDG,Belgium,BEL,5,0,5,0,10
2007,Mauritania,MRT,Belgium,BEL,13,0,53,5,71
2007,North Macedonia,MKD,Belgium,BEL,5,0,22,0,27
2007,Rep. of Moldova,MDA,Belgium,BEL,5,0,13,0,18
2007,Mali,MLI,Belgium,BEL,0,0,5,0,5
2007,Mongolia,MNG,Belgium,BEL,0,0,17,0,17
2007,Morocco,MAR,Belgium,BEL,0,0,18,0,18
2007,Montenegro,MNE,Belgium,BEL,0,0,5,0,5
2007,Myanmar,MMR,Belgium,BEL,0,0,11,0,11
2007,Nepal,NPL,Belgium,BEL,5,0,169,5,179
2007,Niger,NER,Belgium,BEL,5,0,39,5,49
2007,Nigeria,NGA,Belgium,BEL,0,0,31,5,36
2007,Pakistan,PAK,Belgium,BEL,10,0,118,12,140
2007,Peru,PER,Belgium,BEL,5,0,0,0,5
2007,Romania,ROU,Belgium,BEL,0,0,23,5,28
2007,Russian Federation,RUS,Belgium,BEL,679,0,776,78,1533
2007,Rwanda,RWA,Belgium,BEL,254,0,587,13,854
2007,Serbia and Kosovo: S/RES/1244 (1999),SRB,Belgium,BEL,295,0,570,80,945
2007,Senegal,SEN,Belgium,BEL,13,0,5,0,18
2007,Sierra Leone,SLE,Belgium,BEL,5,0,15,0,20
2007,Somalia,SOM,Belgium,BEL,20,38,47,5,110
2007,Viet Nam,VNM,Belgium,BEL,0,0,5,0,5
2007,Sudan,SDN,Belgium,BEL,12,0,25,0,37
2007,Slovakia,SVK,Belgium,BEL,0,0,10,23,33
2007,Syrian Arab Rep.,SYR,Belgium,BEL,66,0,258,28,352
2007,United Rep. of Tanzania,TZA,Belgium,BEL,0,0,23,5,28
2007,Tajikistan,TJK,Belgium,BEL,0,0,0,5,5
2007,Togo,TGO,Belgium,BEL,14,0,112,5,131
2007,Tunisia,TUN,Belgium,BEL,16,0,5,0,21
2007,Turkey,TUR,Belgium,BEL,41,0,239,15,295
2007,Uganda,UGA,Belgium,BEL,0,0,10,0,10
2007,Ukraine,UKR,Belgium,BEL,5,0,25,10,40
2007,Uzbekistan,UZB,Belgium,BEL,12,0,19,13,44
2007,Yemen,YEM,Belgium,BEL,0,0,11,0,11
2007,Stateless,XXA,Belgium,BEL,0,0,5,5,10
2007,Central African Rep.,CAF,Benin,BEN,0,0,21,5,26
2007,Chad,TCD,Benin,BEN,5,0,43,14,62
2007,Cameroon,CMR,Benin,BEN,0,0,17,0,17
2007,Congo,COG,Benin,BEN,0,0,88,0,88
2007,Dem. Rep. of the Congo,COD,Benin,BEN,5,0,360,87,452
2007,Guinea,GIN,Benin,BEN,0,0,5,0,5
2007,Cote d'Ivoire,CIV,Benin,BEN,11,0,27,26,64
2007,Iraq,IRQ,Benin,BEN,5,0,0,0,5
2007,Nigeria,NGA,Benin,BEN,0,0,186,0,186
2007,Rwanda,RWA,Benin,BEN,0,0,14,0,14
2007,Togo,TGO,Benin,BEN,5,0,115,0,120
2007,Burundi,BDI,Burkina Faso,BFA,5,0,0,0,5
2007,Central African Rep.,CAF,Burkina Faso,BFA,0,0,5,0,5
2007,Chad,TCD,Burkina Faso,BFA,5,0,5,0,10
2007,Cameroon,CMR,Burkina Faso,BFA,0,0,0,5,5
2007,Dem. Rep. of the Congo,COD,Burkina Faso,BFA,5,0,5,0,10
2007,Guinea,GIN,Burkina Faso,BFA,5,0,0,0,5
2007,Cote d'Ivoire,CIV,Burkina Faso,BFA,17,0,5,0,22
2007,Liberia,LBR,Burkina Faso,BFA,0,0,0,98,98
2007,Rwanda,RWA,Burkina Faso,BFA,5,0,0,0,5
2007,Sierra Leone,SLE,Burkina Faso,BFA,0,0,0,30,30
2007,Togo,TGO,Burkina Faso,BFA,0,0,21,0,21
2007,Afghanistan,AFG,Belarus,BLR,0,0,32,5,37
2007,Bangladesh,BGD,Belarus,BLR,0,0,0,5,5
2007,Georgia,GEO,Belarus,BLR,0,0,5,0,5
2007,Latvia,LVA,Belarus,BLR,0,0,5,0,5
2007,Colombia,COL,Bolivia (Plurinational State of),BOL,17,0,0,5,22
2007,Eritrea,ERI,Bolivia (Plurinational State of),BOL,0,0,0,5,5
2007,Somalia,SOM,Bolivia (Plurinational State of),BOL,0,0,0,5,5
2007,Burundi,BDI,Botswana,BWA,5,0,0,0,5
2007,Dem. Rep. of the Congo,COD,Botswana,BWA,5,0,0,0,5
2007,Ethiopia,ETH,Botswana,BWA,0,0,0,5,5
2007,Namibia,NAM,Botswana,BWA,18,0,0,0,18
2007,Rwanda,RWA,Botswana,BWA,5,0,0,0,5
2007,Somalia,SOM,Botswana,BWA,5,0,0,0,5
2007,Zimbabwe,ZWE,Botswana,BWA,11,0,0,0,11
2007,Angola,AGO,Brazil,BRA,0,0,13,0,13
2007,Dem. Rep. of the Congo,COD,Brazil,BRA,24,0,34,0,58
2007,Colombia,COL,Brazil,BRA,50,0,61,5,116
2007,Cuba,CUB,Brazil,BRA,12,0,15,10,37
2007,Ethiopia,ETH,Brazil,BRA,0,0,5,0,5
2007,Ghana,GHA,Brazil,BRA,0,0,5,0,5
2007,Guinea-Bissau,GNB,Brazil,BRA,0,0,11,0,11
2007,Guinea,GIN,Brazil,BRA,0,0,5,0,5
2007,Cote d'Ivoire,CIV,Brazil,BRA,5,0,5,0,10
2007,Iraq,IRQ,Brazil,BRA,45,5,0,0,50
2007,Liberia,LBR,Brazil,BRA,0,0,12,0,12
2007,Lebanon,LBN,Brazil,BRA,0,0,172,0,172
2007,Mozambique,MOZ,Brazil,BRA,0,0,5,0,5
2007,Nigeria,NGA,Brazil,BRA,0,0,10,0,10
2007,Peru,PER,Brazil,BRA,5,0,12,0,17
2007,Romania,ROU,Brazil,BRA,0,0,10,0,10
2007,Sudan,SDN,Brazil,BRA,5,0,0,0,5
2007,Burkina Faso,BFA,Central African Rep.,CAF,5,0,0,0,5
2007,Chad,TCD,Central African Rep.,CAF,87,0,21,0,108
2007,Cameroon,CMR,Central African Rep.,CAF,5,0,0,0,5
2007,Congo,COG,Central African Rep.,CAF,5,0,0,0,5
2007,Dem. Rep. of the Congo,COD,Central African Rep.,CAF,208,0,0,0,208
2007,Cote d'Ivoire,CIV,Central African Rep.,CAF,5,0,0,0,5
2007,Rwanda,RWA,Central African Rep.,CAF,5,0,0,0,5
2007,Sierra Leone,SLE,Central African Rep.,CAF,5,0,0,0,5
2007,Sudan,SDN,Central African Rep.,CAF,32,0,0,0,32
2007,Dem. Rep. of the Congo,COD,Chile,CHL,10,0,0,0,10
2007,Colombia,COL,Chile,CHL,223,0,285,31,539
2007,Cuba,CUB,Chile,CHL,5,0,0,0,5
2007,Ecuador,ECU,Chile,CHL,0,0,10,0,10
2007,Peru,PER,Chile,CHL,0,0,5,0,5
2007,Cuba,CUB,Colombia,COL,11,0,75,0,86
2007,Ethiopia,ETH,Colombia,COL,5,0,0,0,5
2007,Iran (Islamic Rep. of),IRN,Colombia,COL,0,0,5,0,5
2007,Venezuela (Bolivarian Republic of),VEN,Colombia,COL,11,0,0,0,11
2007,Afghanistan,AFG,Cyprus,CYP,0,0,62,30,92
2007,Algeria,DZA,Cyprus,CYP,0,0,5,0,5
2007,Egypt,EGY,Cyprus,CYP,0,0,20,49,69
2007,Armenia,ARM,Cyprus,CYP,0,0,153,95,248
2007,Bangladesh,BGD,Cyprus,CYP,0,0,177,148,325
2007,Belarus,BLR,Cyprus,CYP,0,0,5,18,23
2007,Bosnia and Herzegovina,BIH,Cyprus,CYP,0,0,0,5,5
2007,Bulgaria,BGR,Cyprus,CYP,0,0,0,110,110
2007,China,CHN,Cyprus,CYP,0,0,21,78,99
2007,Cameroon,CMR,Cyprus,CYP,0,0,27,17,44
2007,Dem. Rep. of the Congo,COD,Cyprus,CYP,0,0,0,5,5
2007,Ethiopia,ETH,Cyprus,CYP,0,0,0,5,5
2007,Palestinian,PSE,Cyprus,CYP,0,40,12,71,123
2007,Georgia,GEO,Cyprus,CYP,0,5,183,280,468
2007,Ghana,GHA,Cyprus,CYP,0,0,5,0,5
2007,India,IND,Cyprus,CYP,0,0,54,134,188
2007,Indonesia,IDN,Cyprus,CYP,0,0,5,5,10
2007,Iran (Islamic Rep. of),IRN,Cyprus,CYP,10,5,108,161,284
2007,Iraq,IRQ,Cyprus,CYP,10,125,18,88,241
2007,Jordan,JOR,Cyprus,CYP,0,0,12,55,67
2007,Kazakhstan,KAZ,Cyprus,CYP,0,0,0,21,21
2007,Liberia,LBR,Cyprus,CYP,0,0,5,0,5
2007,Lebanon,LBN,Cyprus,CYP,0,5,0,29,34
2007,Sri Lanka,LKA,Cyprus,CYP,0,0,147,157,304
2007,Mauritania,MRT,Cyprus,CYP,0,0,0,5,5
2007,North Macedonia,MKD,Cyprus,CYP,0,0,30,42,72
2007,Rep. of Moldova,MDA,Cyprus,CYP,0,0,42,77,119
2007,Mongolia,MNG,Cyprus,CYP,0,0,0,5,5
2007,Morocco,MAR,Cyprus,CYP,0,0,5,5,10
2007,Nepal,NPL,Cyprus,CYP,0,0,25,25,50
2007,Nigeria,NGA,Cyprus,CYP,0,0,13,0,13
2007,Pakistan,PAK,Cyprus,CYP,0,0,311,372,683
2007,Philippines,PHL,Cyprus,CYP,0,0,22,77,99
2007,Romania,ROU,Cyprus,CYP,0,0,0,38,38
2007,Russian Federation,RUS,Cyprus,CYP,0,0,15,385,400
2007,Somalia,SOM,Cyprus,CYP,5,0,0,0,5
2007,Viet Nam,VNM,Cyprus,CYP,0,0,0,5,5
2007,Syrian Arab Rep.,SYR,Cyprus,CYP,0,0,761,1518,2279
2007,Tunisia,TUN,Cyprus,CYP,0,0,0,5,5
2007,Turkey,TUR,Cyprus,CYP,13,5,25,57,100
2007,Ukraine,UKR,Cyprus,CYP,0,0,44,398,442
2007,Uzbekistan,UZB,Cyprus,CYP,0,0,5,52,57
2007,Afghanistan,AFG,Czechia,CZE,10,5,0,5,16
2007,Algeria,DZA,Czechia,CZE,0,0,14,0,14
2007,Angola,AGO,Czechia,CZE,0,0,5,0,5
2007,Armenia,ARM,Czechia,CZE,5,0,33,11,48
2007,Azerbaijan,AZE,Czechia,CZE,5,0,0,0,5
2007,Bangladesh,BGD,Czechia,CZE,0,0,14,5,19
2007,Belarus,BLR,Czechia,CZE,32,52,80,27,185
2007,Bosnia and Herzegovina,BIH,Czechia,CZE,5,0,0,0,5
2007,China,CHN,Czechia,CZE,0,0,41,15,56
2007,Cameroon,CMR,Czechia,CZE,0,0,13,0,13
2007,Dem. Rep. of the Congo,COD,Czechia,CZE,0,0,14,0,14
2007,Cuba,CUB,Czechia,CZE,10,21,0,12,43
2007,Georgia,GEO,Czechia,CZE,5,5,42,5,53
2007,Ghana,GHA,Czechia,CZE,0,0,10,0,10
2007,Guinea,GIN,Czechia,CZE,0,0,5,0,5
2007,Cote d'Ivoire,CIV,Czechia,CZE,0,0,15,5,20
2007,India,IND,Czechia,CZE,0,0,13,5,18
2007,Iran (Islamic Rep. of),IRN,Czechia,CZE,0,0,5,0,5
2007,Iraq,IRQ,Czechia,CZE,17,33,10,20,78
2007,Israel,ISR,Czechia,CZE,0,0,0,5,5
2007,Kazakhstan,KAZ,Czechia,CZE,5,0,145,0,146
2007,Kyrgyzstan,KGZ,Czechia,CZE,5,0,73,0,78
2007,Sri Lanka,LKA,Czechia,CZE,0,0,27,11,38
2007,North Macedonia,MKD,Czechia,CZE,0,0,10,0,10
2007,Rep. of Moldova,MDA,Czechia,CZE,0,0,21,5,26
2007,Mongolia,MNG,Czechia,CZE,0,0,149,0,149
2007,Myanmar,MMR,Czechia,CZE,5,0,0,0,5
2007,Nepal,NPL,Czechia,CZE,0,0,5,0,5
2007,Nigeria,NGA,Czechia,CZE,0,0,60,28,88
2007,Pakistan,PAK,Czechia,CZE,0,0,20,5,25
2007,Russian Federation,RUS,Czechia,CZE,31,31,96,26,177
2007,Serbia and Kosovo: S/RES/1244 (1999),SRB,Czechia,CZE,0,0,13,29,42
2007,Somalia,SOM,Czechia,CZE,11,5,0,0,16
2007,Viet Nam,VNM,Czechia,CZE,0,0,95,5,100
2007,Slovakia,SVK,Czechia,CZE,0,0,0,5,5
2007,Syrian Arab Rep.,SYR,Czechia,CZE,0,5,10,23,35
2007,Turkey,TUR,Czechia,CZE,0,0,146,15,161
2007,Ukraine,UKR,Czechia,CZE,19,0,281,10,309
2007,Uzbekistan,UZB,Czechia,CZE,11,10,20,0,41
2007,Stateless,XXA,Czechia,CZE,5,5,37,14,55
2007,Afghanistan,AFG,Denmark,DNK,5,16,25,0,46
2007,Albania,ALB,Denmark,DNK,0,0,5,0,5
2007,Armenia,ARM,Denmark,DNK,0,0,5,0,5
2007,Azerbaijan,AZE,Denmark,DNK,0,0,5,0,5
2007,Burundi,BDI,Denmark,DNK,5,0,0,0,5
2007,Belarus,BLR,Denmark,DNK,0,0,5,0,5
2007,Bosnia and Herzegovina,BIH,Denmark,DNK,0,0,15,0,15
2007,Bulgaria,BGR,Denmark,DNK,0,0,5,0,5
2007,Cambodia,KHM,Denmark,DNK,0,0,5,0,5
2007,China,CHN,Denmark,DNK,5,0,19,0,24
2007,Palestinian,PSE,Denmark,DNK,11,0,13,0,24
2007,Georgia,GEO,Denmark,DNK,0,0,5,0,5
2007,India,IND,Denmark,DNK,0,0,11,0,11
2007,Iran (Islamic Rep. of),IRN,Denmark,DNK,23,13,22,0,58
2007,Iraq,IRQ,Denmark,DNK,0,28,44,0,72
2007,Kazakhstan,KAZ,Denmark,DNK,0,0,5,0,5
2007,Liberia,LBR,Denmark,DNK,0,0,5,0,5
2007,Lebanon,LBN,Denmark,DNK,0,0,10,0,10
2007,Sri Lanka,LKA,Denmark,DNK,0,5,17,0,22
2007,North Macedonia,MKD,Denmark,DNK,0,0,5,0,5
2007,Morocco,MAR,Denmark,DNK,0,0,5,0,5
2007,Myanmar,MMR,Denmark,DNK,5,0,0,0,5
2007,Netherlands,NLD,Denmark,DNK,0,0,5,0,5
2007,Nigeria,NGA,Denmark,DNK,0,0,20,0,20
2007,Pakistan,PAK,Denmark,DNK,5,0,5,0,10
2007,Poland,POL,Denmark,DNK,0,0,5,0,5
2007,Russian Federation,RUS,Denmark,DNK,0,17,17,0,34
2007,Serbia and Kosovo: S/RES/1244 (1999),SRB,Denmark,DNK,0,0,37,0,37
2007,Somalia,SOM,Denmark,DNK,0,0,12,0,12
2007,Syrian Arab Rep.,SYR,Denmark,DNK,15,5,10,0,30
2007,Turkey,TUR,Denmark,DNK,0,0,10,0,10
2007,Uganda,UGA,Denmark,DNK,0,0,5,0,5
2007,Stateless,XXA,Denmark,DNK,5,0,0,0,5
2007,Belarus,BLR,Estonia,EST,0,0,0,5,5
2007,Russian Federation,RUS,Estonia,EST,0,0,5,0,5
2007,Afghanistan,AFG,Finland,FIN,5,103,24,12,144
2007,Albania,ALB,Finland,FIN,0,0,5,10,15
2007,Algeria,DZA,Finland,FIN,0,0,0,22,22
2007,Angola,AGO,Finland,FIN,0,18,5,5,28
2007,Egypt,EGY,Finland,FIN,0,0,0,5,5
2007,Armenia,ARM,Finland,FIN,0,0,0,14,14
2007,Azerbaijan,AZE,Finland,FIN,0,5,0,0,5
2007,Bangladesh,BGD,Finland,FIN,0,0,0,14,14
2007,Belarus,BLR,Finland,FIN,0,0,20,48,68
2007,Bosnia and Herzegovina,BIH,Finland,FIN,0,5,0,18,23
2007,Bulgaria,BGR,Finland,FIN,0,0,0,33,33
2007,Cambodia,KHM,Finland,FIN,0,5,0,0,5
2007,China,CHN,Finland,FIN,5,5,0,0,10
2007,Cameroon,CMR,Finland,FIN,0,5,13,5,23
2007,Dem. Rep. of the Congo,COD,Finland,FIN,0,21,10,5,36
2007,Ethiopia,ETH,Finland,FIN,5,13,0,5,23
2007,Gambia,GMB,Finland,FIN,0,14,0,5,19
2007,Georgia,GEO,Finland,FIN,0,0,0,10,10
2007,Ghana,GHA,Finland,FIN,0,5,5,0,10
2007,Guinea,GIN,Finland,FIN,0,5,0,0,5
2007,Honduras,HND,Finland,FIN,0,5,0,0,5
2007,Cote d'Ivoire,CIV,Finland,FIN,0,0,5,0,5
2007,India,IND,Finland,FIN,0,5,0,12,17
2007,Iran (Islamic Rep. of),IRN,Finland,FIN,5,33,27,27,92
2007,Iraq,IRQ,Finland,FIN,19,192,0,99,310
2007,Israel,ISR,Finland,FIN,0,0,5,5,10
2007,Jordan,JOR,Finland,FIN,0,5,0,0,5
2007,Kazakhstan,KAZ,Finland,FIN,0,0,0,10,10
2007,Kyrgyzstan,KGZ,Finland,FIN,0,0,14,0,14
2007,Libya,LBY,Finland,FIN,0,0,5,16,21
2007,Lebanon,LBN,Finland,FIN,0,5,0,5,10
2007,Sri Lanka,LKA,Finland,FIN,0,5,30,5,40
2007,Lithuania,LTU,Finland,FIN,0,0,0,5,5
2007,North Macedonia,MKD,Finland,FIN,0,0,5,5,10
2007,Rep. of Moldova,MDA,Finland,FIN,0,0,0,24,24
2007,Mali,MLI,Finland,FIN,0,0,0,5,5
2007,Mongolia,MNG,Finland,FIN,0,0,0,5,5
2007,Morocco,MAR,Finland,FIN,0,0,0,5,5
2007,Myanmar,MMR,Finland,FIN,5,0,0,0,5
2007,Nepal,NPL,Finland,FIN,0,0,0,5,5
2007,Nigeria,NGA,Finland,FIN,0,5,19,23,47
2007,Pakistan,PAK,Finland,FIN,5,0,0,5,10
2007,Romania,ROU,Finland,FIN,0,0,0,5,5
2007,Russian Federation,RUS,Finland,FIN,27,5,29,110,171
2007,Rwanda,RWA,Finland,FIN,0,5,0,0,5
2007,Serbia and Kosovo: S/RES/1244 (1999),SRB,Finland,FIN,0,39,30,124,193
2007,Senegal,SEN,Finland,FIN,0,0,0,5,5
2007,Somalia,SOM,Finland,FIN,0,232,0,12,244
2007,Sudan,SDN,Finland,FIN,0,0,0,5,5
2007,Slovakia,SVK,Finland,FIN,0,0,0,10,10
2007,Syrian Arab Rep.,SYR,Finland,FIN,0,11,0,5,16
2007,United Rep. of Tanzania,TZA,Finland,FIN,0,0,0,5,5
2007,Tajikistan,TJK,Finland,FIN,0,5,0,0,5
2007,Turkey,TUR,Finland,FIN,0,10,11,31,52
2007,Ukraine,UKR,Finland,FIN,0,0,5,5,10
2007,United States of America,USA,Finland,FIN,0,0,0,5,5
2007,Uzbekistan,UZB,Finland,FIN,0,5,5,0,10
2007,Stateless,XXA,Finland,FIN,0,0,0,12,12
2007,Afghanistan,AFG,France,FRA,37,0,82,0,119
2007,Albania,ALB,France,FRA,5,10,187,0,202
2007,Algeria,DZA,France,FRA,35,24,973,0,1032
2007,Angola,AGO,France,FRA,35,0,446,0,481
2007,Egypt,EGY,France,FRA,10,0,20,0,30
2007,Armenia,ARM,France,FRA,53,0,1607,0,1660
2007,Azerbaijan,AZE,France,FRA,80,0,421,0,501
2007,Burundi,BDI,France,FRA,10,0,15,0,25
2007,Bangladesh,BGD,France,FRA,35,0,1050,0,1085
2007,Burkina Faso,BFA,France,FRA,0,0,14,0,14
2007,Belarus,BLR,France,FRA,5,0,109,0,114
2007,Bolivia (Plurinational State of),BOL,France,FRA,0,0,13,0,13
2007,Bosnia and Herzegovina,BIH,France,FRA,14,0,168,0,182
2007,Cambodia,KHM,France,FRA,0,5,28,0,33
2007,Central African Rep.,CAF,France,FRA,22,0,153,0,175
2007,Chad,TCD,France,FRA,22,0,122,0,144
2007,China,CHN,France,FRA,71,0,1401,0,1472
2007,Cameroon,CMR,France,FRA,19,0,167,0,186
2007,Congo,COG,France,FRA,64,0,762,0,826
2007,Dem. Rep. of the Congo,COD,France,FRA,206,5,1875,0,2086
2007,Comoros,COM,France,FRA,0,0,68,0,68
2007,Colombia,COL,France,FRA,29,0,84,0,113
2007,Cuba,CUB,France,FRA,5,0,21,0,26
2007,Dominican Rep.,DOM,France,FRA,0,0,10,0,10
2007,Eritrea,ERI,France,FRA,50,0,17,0,67
2007,Ethiopia,ETH,France,FRA,30,0,23,0,53
2007,Gabon,GAB,France,FRA,0,0,12,0,12
2007,Gambia,GMB,France,FRA,0,0,27,0,27
2007,Palestinian,PSE,France,FRA,5,0,51,0,56
2007,Georgia,GEO,France,FRA,22,5,289,0,316
2007,Guinea-Bissau,GNB,France,FRA,5,0,66,0,71
2007,Guinea,GIN,France,FRA,277,0,847,0,1124
2007,Haiti,HTI,France,FRA,75,39,1102,0,1216
2007,Cote d'Ivoire,CIV,France,FRA,106,0,542,0,648
2007,India,IND,France,FRA,0,0,67,0,67
2007,Iran (Islamic Rep. of),IRN,France,FRA,31,0,89,0,120
2007,Iraq,IRQ,France,FRA,44,26,75,0,145
2007,Kazakhstan,KAZ,France,FRA,0,0,36,0,36
2007,Kyrgyzstan,KGZ,France,FRA,5,0,39,0,44
2007,Liberia,LBR,France,FRA,0,0,19,0,19
2007,Sri Lanka,LKA,France,FRA,537,0,2640,0,3177
2007,Madagascar,MDG,France,FRA,5,0,35,0,40
2007,Mauritania,MRT,France,FRA,56,0,616,0,672
2007,North Macedonia,MKD,France,FRA,0,0,103,0,103
2007,Rep. of Moldova,MDA,France,FRA,0,0,336,0,336
2007,Mali,MLI,France,FRA,207,0,57,0,264
2007,Mongolia,MNG,France,FRA,5,0,104,0,109
2007,Morocco,MAR,France,FRA,0,0,40,0,40
2007,Myanmar,MMR,France,FRA,5,0,21,0,26
2007,Niger,NER,France,FRA,0,0,5,0,5
2007,Nigeria,NGA,France,FRA,13,5,503,0,521
2007,Pakistan,PAK,France,FRA,15,0,385,0,400
2007,Peru,PER,France,FRA,0,0,60,0,60
2007,Romania,ROU,France,FRA,0,0,42,0,42
2007,South Africa,ZAF,France,FRA,0,0,5,0,5
2007,Russian Federation,RUS,France,FRA,302,0,1377,0,1679
2007,Rwanda,RWA,France,FRA,144,0,107,0,251
2007,Serbia and Kosovo: S/RES/1244 (1999),SRB,France,FRA,63,0,2472,0,2535
2007,Senegal,SEN,France,FRA,10,0,39,0,49
2007,Sierra Leone,SLE,France,FRA,19,0,92,0,111
2007,Somalia,SOM,France,FRA,31,0,33,0,64
2007,Sudan,SDN,France,FRA,160,0,322,0,482
2007,Syrian Arab Rep.,SYR,France,FRA,5,0,17,0,22
2007,Tajikistan,TJK,France,FRA,0,0,5,0,5
2007,Togo,TGO,France,FRA,14,0,126,0,140
2007,Tunisia,TUN,France,FRA,10,0,22,0,32
2007,Turkey,TUR,France,FRA,149,0,2702,0,2851
2007,Ukraine,UKR,France,FRA,5,0,93,0,98
2007,United States of America,USA,France,FRA,0,0,10,0,10
2007,Uzbekistan,UZB,France,FRA,0,0,29,0,29
2007,Zimbabwe,ZWE,France,FRA,5,0,5,0,10
2007,Stateless,XXA,France,FRA,51,0,122,0,173
2007,Senegal,SEN,Gambia,GMB,0,0,0,600,600
2007,Afghanistan,AFG,United Kingdom of Great Britain and Northern Ireland,GBR,137,810,1309,505,2761
2007,Albania,ALB,United Kingdom of Great Britain and Northern Ireland,GBR,0,39,132,59,230
2007,Algeria,DZA,United Kingdom of Great Britain and Northern Ireland,GBR,5,15,235,101,356
2007,Angola,AGO,United Kingdom of Great Britain and Northern Ireland,GBR,33,23,69,11,136
2007,Egypt,EGY,United Kingdom of Great Britain and Northern Ireland,GBR,5,0,45,13,63
2007,Armenia,ARM,United Kingdom of Great Britain and Northern Ireland,GBR,0,5,14,0,19
2007,Azerbaijan,AZE,United Kingdom of Great Britain and Northern Ireland,GBR,5,0,45,5,55
2007,Bahrain,BHR,United Kingdom of Great Britain and Northern Ireland,GBR,0,0,5,5,10
2007,Burundi,BDI,United Kingdom of Great Britain and Northern Ireland,GBR,5,10,25,5,45
2007,Benin,BEN,United Kingdom of Great Britain and Northern Ireland,GBR,0,0,5,0,5
2007,Bangladesh,BGD,United Kingdom of Great Britain and Northern Ireland,GBR,5,119,310,128,562
2007,Bhutan,BTN,United Kingdom of Great Britain and Northern Ireland,GBR,5,0,18,0,23
2007,Burkina Faso,BFA,United Kingdom of Great Britain and Northern Ireland,GBR,0,0,5,0,5
2007,Belarus,BLR,United Kingdom of Great Britain and Northern Ireland,GBR,16,0,55,12,83
2007,Bolivia (Plurinational State of),BOL,United Kingdom of Great Britain and Northern Ireland,GBR,0,0,19,0,19
2007,Botswana,BWA,United Kingdom of Great Britain and Northern Ireland,GBR,0,0,5,0,5
2007,Brazil,BRA,United Kingdom of Great Britain and Northern Ireland,GBR,0,0,25,5,30
2007,Bosnia and Herzegovina,BIH,United Kingdom of Great Britain and Northern Ireland,GBR,5,0,19,5,29
2007,Bulgaria,BGR,United Kingdom of Great Britain and Northern Ireland,GBR,0,5,0,0,5
2007,Belize,BLZ,United Kingdom of Great Britain and Northern Ireland,GBR,0,0,5,0,5
2007,Canada,CAN,United Kingdom of Great Britain and Northern Ireland,GBR,0,0,0,5,5
2007,Chad,TCD,United Kingdom of Great Britain and Northern Ireland,GBR,11,0,0,0,11
2007,China,CHN,United Kingdom of Great Britain and Northern Ireland,GBR,80,95,915,1094,2184
2007,Cameroon,CMR,United Kingdom of Great Britain and Northern Ireland,GBR,31,19,180,19,249
2007,Congo,COG,United Kingdom of Great Britain and Northern Ireland,GBR,5,0,27,5,37
2007,Dem. Rep. of the Congo,COD,United Kingdom of Great Britain and Northern Ireland,GBR,106,64,386,54,610
2007,Colombia,COL,United Kingdom of Great Britain and Northern Ireland,GBR,5,0,40,11,56
2007,Cuba,CUB,United Kingdom of Great Britain and Northern Ireland,GBR,0,0,10,5,15
2007,Czechia,CZE,United Kingdom of Great Britain and Northern Ireland,GBR,0,0,0,13,13
2007,Ecuador,ECU,United Kingdom of Great Britain and Northern Ireland,GBR,0,0,19,10,29
2007,Eritrea,ERI,United Kingdom of Great Britain and Northern Ireland,GBR,1150,79,450,352,2031
2007,Ethiopia,ETH,United Kingdom of Great Britain and Northern Ireland,GBR,28,10,73,12,123
2007,Gambia,GMB,United Kingdom of Great Britain and Northern Ireland,GBR,21,5,93,13,132
2007,Palestinian,PSE,United Kingdom of Great Britain and Northern Ireland,GBR,19,13,247,151,430
2007,Georgia,GEO,United Kingdom of Great Britain and Northern Ireland,GBR,0,0,44,29,73
2007,Ghana,GHA,United Kingdom of Great Britain and Northern Ireland,GBR,0,5,103,37,145
2007,Guinea-Bissau,GNB,United Kingdom of Great Britain and Northern Ireland,GBR,0,0,12,0,12
2007,Grenada,GRD,United Kingdom of Great Britain and Northern Ireland,GBR,0,0,5,0,5
2007,Guatemala,GTM,United Kingdom of Great Britain and Northern Ireland,GBR,0,0,5,5,10
2007,Guinea,GIN,United Kingdom of Great Britain and Northern Ireland,GBR,13,37,98,25,173
2007,Guyana,GUY,United Kingdom of Great Britain and Northern Ireland,GBR,0,0,5,0,5
2007,"China, Hong Kong SAR",HKG,United Kingdom of Great Britain and Northern Ireland,GBR,0,0,0,5,5
2007,Croatia,HRV,United Kingdom of Great Britain and Northern Ireland,GBR,0,0,12,10,22
2007,Cote d'Ivoire,CIV,United Kingdom of Great Britain and Northern Ireland,GBR,14,5,140,18,177
2007,India,IND,United Kingdom of Great Britain and Northern Ireland,GBR,0,14,363,202,579
2007,Indonesia,IDN,United Kingdom of Great Britain and Northern Ireland,GBR,0,0,5,0,5
2007,Iran (Islamic Rep. of),IRN,United Kingdom of Great Britain and Northern Ireland,GBR,293,220,1669,257,2439
2007,Iraq,IRQ,United Kingdom of Great Britain and Northern Ireland,GBR,207,138,1090,240,1675
2007,Israel,ISR,United Kingdom of Great Britain and Northern Ireland,GBR,0,0,24,5,29
2007,Jamaica,JAM,United Kingdom of Great Britain and Northern Ireland,GBR,5,10,236,71,322
2007,Jordan,JOR,United Kingdom of Great Britain and Northern Ireland,GBR,0,0,21,5,26
2007,Japan,JPN,United Kingdom of Great Britain and Northern Ireland,GBR,0,0,5,0,5
2007,Kazakhstan,KAZ,United Kingdom of Great Britain and Northern Ireland,GBR,0,0,10,0,10
2007,Kenya,KEN,United Kingdom of Great Britain and Northern Ireland,GBR,5,16,98,22,141
2007,Kyrgyzstan,KGZ,United Kingdom of Great Britain and Northern Ireland,GBR,0,0,5,0,5
2007,Rep. of Korea,KOR,United Kingdom of Great Britain and Northern Ireland,GBR,0,0,14,5,19
2007,Dem. People's Rep. of Korea,PRK,United Kingdom of Great Britain and Northern Ireland,GBR,204,19,19,15,257
2007,Kuwait,KWT,United Kingdom of Great Britain and Northern Ireland,GBR,89,5,76,22,192
2007,Liberia,LBR,United Kingdom of Great Britain and Northern Ireland,GBR,0,0,36,11,47
2007,Libya,LBY,United Kingdom of Great Britain and Northern Ireland,GBR,5,5,46,5,61
2007,Saint Lucia,LCA,United Kingdom of Great Britain and Northern Ireland,GBR,0,0,5,0,5
2007,Lebanon,LBN,United Kingdom of Great Britain and Northern Ireland,GBR,5,5,74,11,95
2007,Sri Lanka,LKA,United Kingdom of Great Britain and Northern Ireland,GBR,95,60,925,105,1185
2007,Lithuania,LTU,United Kingdom of Great Britain and Northern Ireland,GBR,0,0,12,0,12
2007,Latvia,LVA,United Kingdom of Great Britain and Northern Ireland,GBR,0,0,0,5,5
2007,Mauritania,MRT,United Kingdom of Great Britain and Northern Ireland,GBR,5,0,0,0,5
2007,North Macedonia,MKD,United Kingdom of Great Britain and Northern Ireland,GBR,0,0,19,15,34
2007,Rep. of Moldova,MDA,United Kingdom of Great Britain and Northern Ireland,GBR,0,5,20,18,43
2007,Malaysia,MYS,United Kingdom of Great Britain and Northern Ireland,GBR,5,0,12,13,30
2007,Malawi,MWI,United Kingdom of Great Britain and Northern Ireland,GBR,0,5,71,10,86
2007,Mongolia,MNG,United Kingdom of Great Britain and Northern Ireland,GBR,0,0,23,15,38
2007,Morocco,MAR,United Kingdom of Great Britain and Northern Ireland,GBR,0,0,18,14,32
2007,Mauritius,MUS,United Kingdom of Great Britain and Northern Ireland,GBR,0,0,24,5,29
2007,Myanmar,MMR,United Kingdom of Great Britain and Northern Ireland,GBR,111,22,62,5,200
2007,Namibia,NAM,United Kingdom of Great Britain and Northern Ireland,GBR,0,0,5,0,5
2007,Nepal,NPL,United Kingdom of Great Britain and Northern Ireland,GBR,5,0,21,13,39
2007,Niger,NER,United Kingdom of Great Britain and Northern Ireland,GBR,0,0,0,5,5
2007,Nicaragua,NIC,United Kingdom of Great Britain and Northern Ireland,GBR,0,0,5,0,5
2007,Nigeria,NGA,United Kingdom of Great Britain and Northern Ireland,GBR,5,38,727,171,941
2007,Oman,OMN,United Kingdom of Great Britain and Northern Ireland,GBR,0,5,0,0,5
2007,Pakistan,PAK,United Kingdom of Great Britain and Northern Ireland,GBR,179,79,1373,249,1880
2007,Philippines,PHL,United Kingdom of Great Britain and Northern Ireland,GBR,0,0,10,0,10
2007,Poland,POL,United Kingdom of Great Britain and Northern Ireland,GBR,0,0,0,5,5
2007,Romania,ROU,United Kingdom of Great Britain and Northern Ireland,GBR,0,0,13,22,35
2007,South Africa,ZAF,United Kingdom of Great Britain and Northern Ireland,GBR,0,5,100,42,147
2007,Russian Federation,RUS,United Kingdom of Great Britain and Northern Ireland,GBR,12,0,120,16,148
2007,Rwanda,RWA,United Kingdom of Great Britain and Northern Ireland,GBR,0,5,36,0,41
2007,Serbia and Kosovo: S/RES/1244 (1999),SRB,United Kingdom of Great Britain and Northern Ireland,GBR,0,22,90,72,184
2007,Senegal,SEN,United Kingdom of Great Britain and Northern Ireland,GBR,0,0,19,5,24
2007,Sierra Leone,SLE,United Kingdom of Great Britain and Northern Ireland,GBR,14,19,93,12,138
2007,Somalia,SOM,United Kingdom of Great Britain and Northern Ireland,GBR,990,109,734,163,1996
2007,Viet Nam,VNM,United Kingdom of Great Britain and Northern Ireland,GBR,5,13,55,74,147
2007,Sudan,SDN,United Kingdom of Great Britain and Northern Ireland,GBR,89,17,304,69,479
2007,Eswatini,SWZ,United Kingdom of Great Britain and Northern Ireland,GBR,0,0,10,0,10
2007,Syrian Arab Rep.,SYR,United Kingdom of Great Britain and Northern Ireland,GBR,31,12,113,32,188
2007,United Rep. of Tanzania,TZA,United Kingdom of Great Britain and Northern Ireland,GBR,0,0,21,10,31
2007,Thailand,THA,United Kingdom of Great Britain and Northern Ireland,GBR,0,0,0,5,5
2007,Turkmenistan,TKM,United Kingdom of Great Britain and Northern Ireland,GBR,13,0,0,0,13
2007,Togo,TGO,United Kingdom of Great Britain and Northern Ireland,GBR,5,0,19,5,29
2007,Trinidad and Tobago,TTO,United Kingdom of Great Britain and Northern Ireland,GBR,0,0,5,5,10
2007,Tunisia,TUN,United Kingdom of Great Britain and Northern Ireland,GBR,0,0,5,5,10
2007,Turkey,TUR,United Kingdom of Great Britain and Northern Ireland,GBR,28,36,332,65,461
2007,Uganda,UGA,United Kingdom of Great Britain and Northern Ireland,GBR,5,17,132,19,173
2007,Ukraine,UKR,United Kingdom of Great Britain and Northern Ireland,GBR,0,0,47,18,65
2007,United States of America,USA,United Kingdom of Great Britain and Northern Ireland,GBR,0,0,16,5,21
2007,Uzbekistan,UZB,United Kingdom of Great Britain and Northern Ireland,GBR,0,0,23,5,28
2007,Saint Vincent and the Grenadines,VCT,United Kingdom of Great Britain and Northern Ireland,GBR,0,0,5,0,5
2007,Venezuela (Bolivarian Republic of),VEN,United Kingdom of Great Britain and Northern Ireland,GBR,0,0,10,0,10
2007,Yemen,YEM,United Kingdom of Great Britain and Northern Ireland,GBR,5,5,52,5,67
2007,Zambia,ZMB,United Kingdom of Great Britain and Northern Ireland,GBR,5,0,10,5,20
2007,Zimbabwe,ZWE,United Kingdom of Great Britain and Northern Ireland,GBR,337,26,1518,65,1946
2007,Cote d'Ivoire,CIV,Ghana,GHA,0,0,0,155,155
2007,Liberia,LBR,Ghana,GHA,0,0,0,1051,1051
2007,Sierra Leone,SLE,Ghana,GHA,0,0,0,343,343
2007,Somalia,SOM,Ghana,GHA,0,0,0,5,5
2007,Sudan,SDN,Ghana,GHA,17,0,0,0,17
2007,Togo,TGO,Ghana,GHA,0,0,0,3684,3684
2007,Cote d'Ivoire,CIV,Guinea-Bissau,GNB,5,0,0,0,5
2007,Liberia,LBR,Guinea-Bissau,GNB,21,0,0,0,21
2007,Nigeria,NGA,Guinea-Bissau,GNB,0,0,10,0,10
2007,Senegal,SEN,Guinea-Bissau,GNB,34,0,0,0,34
2007,Sierra Leone,SLE,Guinea-Bissau,GNB,11,0,26,0,37
2007,Afghanistan,AFG,Greece,GRC,0,0,974,19,993
2007,Albania,ALB,Greece,GRC,0,0,21,0,21
2007,Algeria,DZA,Greece,GRC,0,0,11,0,11
2007,Egypt,EGY,Greece,GRC,0,0,47,0,47
2007,Armenia,ARM,Greece,GRC,0,0,25,0,25
2007,Burundi,BDI,Greece,GRC,0,0,5,0,5
2007,Bangladesh,BGD,Greece,GRC,0,0,3651,10,3661
2007,Burkina Faso,BFA,Greece,GRC,0,0,32,0,32
2007,China,CHN,Greece,GRC,0,0,18,5,23
2007,Dem. Rep. of the Congo,COD,Greece,GRC,0,0,5,0,5
2007,Eritrea,ERI,Greece,GRC,0,0,13,0,13
2007,Ethiopia,ETH,Greece,GRC,0,0,125,0,125
2007,Georgia,GEO,Greece,GRC,0,0,1084,5,1089
2007,Ghana,GHA,Greece,GRC,0,0,68,0,68
2007,Guinea-Bissau,GNB,Greece,GRC,0,0,27,0,27
2007,Guinea,GIN,Greece,GRC,0,0,36,0,36
2007,Cote d'Ivoire,CIV,Greece,GRC,0,0,42,0,42
2007,India,IND,Greece,GRC,0,0,225,5,230
2007,Indonesia,IDN,Greece,GRC,0,0,41,0,41
2007,Iran (Islamic Rep. of),IRN,Greece,GRC,0,0,337,5,342
2007,Iraq,IRQ,Greece,GRC,0,0,3947,10,3957
2007,Kazakhstan,KAZ,Greece,GRC,0,0,5,0,5
2007,Kenya,KEN,Greece,GRC,0,0,47,0,47
2007,Lebanon,LBN,Greece,GRC,0,0,43,0,43
2007,Sri Lanka,LKA,Greece,GRC,0,0,112,0,112
2007,Mauritania,MRT,Greece,GRC,0,0,95,0,95
2007,Rep. of Moldova,MDA,Greece,GRC,0,0,51,0,51
2007,Morocco,MAR,Greece,GRC,0,0,5,0,5
2007,Nepal,NPL,Greece,GRC,0,0,5,0,5
2007,Nigeria,NGA,Greece,GRC,0,0,228,5,233
2007,Pakistan,PAK,Greece,GRC,0,0,7737,29,7766
2007,Philippines,PHL,Greece,GRC,0,0,21,0,21
2007,Romania,ROU,Greece,GRC,0,0,5,0,5
2007,Russian Federation,RUS,Greece,GRC,0,0,27,5,32
2007,Rwanda,RWA,Greece,GRC,0,0,5,0,5
2007,Serbia and Kosovo: S/RES/1244 (1999),SRB,Greece,GRC,0,0,0,12,12
2007,Senegal,SEN,Greece,GRC,0,0,164,0,164
2007,Sierra Leone,SLE,Greece,GRC,0,0,10,0,10
2007,Somalia,SOM,Greece,GRC,0,0,118,5,123
2007,Sudan,SDN,Greece,GRC,0,0,109,0,109
2007,Syrian Arab Rep.,SYR,Greece,GRC,0,0,925,5,930
2007,United Rep. of Tanzania,TZA,Greece,GRC,0,0,5,0,5
2007,Tunisia,TUN,Greece,GRC,0,0,5,0,5
2007,Turkey,TUR,Greece,GRC,0,0,84,0,84
2007,Uganda,UGA,Greece,GRC,0,0,5,0,5
2007,Ukraine,UKR,Greece,GRC,0,0,25,0,25
2007,Uzbekistan,UZB,Greece,GRC,0,0,5,0,5
2007,Cuba,CUB,Guatemala,GTM,0,0,12,22,34
2007,Mexico,MEX,Guatemala,GTM,0,0,10,5,15
2007,Cote d'Ivoire,CIV,Guinea,GIN,159,0,36,0,195
2007,Liberia,LBR,Guinea,GIN,87,0,100,0,187
2007,Rwanda,RWA,Guinea,GIN,5,0,0,0,5
2007,Sierra Leone,SLE,Guinea,GIN,117,0,82,0,199
2007,Colombia,COL,Honduras,HND,0,0,0,5,5
2007,Cuba,CUB,Honduras,HND,0,0,0,5,5
2007,Somalia,SOM,Honduras,HND,0,0,0,5,5
2007,Albania,ALB,Croatia,HRV,0,0,5,5,10
2007,Bosnia and Herzegovina,BIH,Croatia,HRV,0,0,10,0,10
2007,Georgia,GEO,Croatia,HRV,0,0,5,0,5
2007,India,IND,Croatia,HRV,0,0,5,0,5
2007,Iran (Islamic Rep. of),IRN,Croatia,HRV,0,0,0,5,5
2007,Iraq,IRQ,Croatia,HRV,0,0,0,5,5
2007,Sri Lanka,LKA,Croatia,HRV,0,0,5,0,5
2007,North Macedonia,MKD,Croatia,HRV,0,0,5,5,10
2007,Nigeria,NGA,Croatia,HRV,0,0,5,0,5
2007,Pakistan,PAK,Croatia,HRV,0,0,0,11,11
2007,Russian Federation,RUS,Croatia,HRV,0,0,0,5,5
2007,Serbia and Kosovo: S/RES/1244 (1999),SRB,Croatia,HRV,0,0,22,39,61
2007,Afghanistan,AFG,Hungary,HUN,0,5,5,10,20
2007,Albania,ALB,Hungary,HUN,0,0,0,13,13
2007,Algeria,DZA,Hungary,HUN,0,0,28,14,42
2007,Egypt,EGY,Hungary,HUN,0,0,10,5,15
2007,Armenia,ARM,Hungary,HUN,0,0,10,0,10
2007,Bangladesh,BGD,Hungary,HUN,0,0,11,0,11
2007,Belarus,BLR,Hungary,HUN,0,0,0,5,5
2007,China,CHN,Hungary,HUN,0,0,237,35,272
2007,Cameroon,CMR,Hungary,HUN,0,0,16,0,16
2007,Dem. Rep. of the Congo,COD,Hungary,HUN,0,0,5,0,5
2007,Cuba,CUB,Hungary,HUN,27,0,5,0,32
2007,Ethiopia,ETH,Hungary,HUN,0,5,5,0,10
2007,Palestinian,PSE,Hungary,HUN,0,0,11,15,26
2007,Georgia,GEO,Hungary,HUN,0,0,58,107,165
2007,Ghana,GHA,Hungary,HUN,0,0,5,0,5
2007,Guinea,GIN,Hungary,HUN,5,0,0,0,5
2007,Cote d'Ivoire,CIV,Hungary,HUN,0,10,0,0,10
2007,India,IND,Hungary,HUN,0,0,0,5,5
2007,Iran (Islamic Rep. of),IRN,Hungary,HUN,5,0,13,0,18
2007,Iraq,IRQ,Hungary,HUN,65,5,5,45,120
2007,Kenya,KEN,Hungary,HUN,0,0,5,0,5
2007,Lebanon,LBN,Hungary,HUN,5,0,0,0,5
2007,Sri Lanka,LKA,Hungary,HUN,0,0,5,0,5
2007,North Macedonia,MKD,Hungary,HUN,0,0,10,26,36
2007,Rep. of Moldova,MDA,Hungary,HUN,0,0,12,38,50
2007,Mongolia,MNG,Hungary,HUN,0,0,61,5,66
2007,Morocco,MAR,Hungary,HUN,0,0,5,0,5
2007,Myanmar,MMR,Hungary,HUN,5,0,0,0,5
2007,Nigeria,NGA,Hungary,HUN,0,5,53,23,81
2007,Romania,ROU,Hungary,HUN,5,0,5,0,10
2007,Russian Federation,RUS,Hungary,HUN,0,0,12,40,52
2007,Serbia and Kosovo: S/RES/1244 (1999),SRB,Hungary,HUN,0,18,0,0,18
2007,Senegal,SEN,Hungary,HUN,0,0,5,0,5
2007,Somalia,SOM,Hungary,HUN,31,0,0,10,41
2007,Viet Nam,VNM,Hungary,HUN,0,0,487,27,514
2007,Sudan,SDN,Hungary,HUN,0,0,5,5,10
2007,Slovakia,SVK,Hungary,HUN,0,0,14,0,14
2007,Syrian Arab Rep.,SYR,Hungary,HUN,0,0,31,5,36
2007,Togo,TGO,Hungary,HUN,0,0,0,5,5
2007,Turkey,TUR,Hungary,HUN,5,5,22,24,56
2007,Uganda,UGA,Hungary,HUN,0,0,5,0,5
2007,Ukraine,UKR,Hungary,HUN,0,0,13,13,26
2007,Uzbekistan,UZB,Hungary,HUN,5,0,0,5,10
2007,Stateless,XXA,Hungary,HUN,5,0,5,0,10
2007,Belarus,BLR,Iceland,ISL,0,0,0,5,5
2007,Russian Federation,RUS,Iceland,ISL,0,0,0,5,5
2007,Syrian Arab Rep.,SYR,Iceland,ISL,0,0,0,5,5
2007,Ukraine,UKR,Iceland,ISL,0,0,0,5,5
2007,Angola,AGO,Cote d'Ivoire,CIV,0,0,5,0,5
2007,Benin,BEN,Cote d'Ivoire,CIV,0,0,5,0,5
2007,Central African Rep.,CAF,Cote d'Ivoire,CIV,0,0,25,10,35
2007,Chad,TCD,Cote d'Ivoire,CIV,0,0,10,0,10
2007,Congo,COG,Cote d'Ivoire,CIV,5,0,94,42,141
2007,Dem. Rep. of the Congo,COD,Cote d'Ivoire,CIV,10,0,167,68,245
2007,Nigeria,NGA,Cote d'Ivoire,CIV,0,0,60,0,60
2007,Rwanda,RWA,Cote d'Ivoire,CIV,5,0,10,10,25
2007,Sierra Leone,SLE,Cote d'Ivoire,CIV,0,0,45,29,74
2007,Somalia,SOM,Cote d'Ivoire,CIV,5,0,0,0,5
2007,Togo,TGO,Cote d'Ivoire,CIV,10,0,65,25,100
2007,Afghanistan,AFG,Ireland,IRL,0,0,53,29,82
2007,Albania,ALB,Ireland,IRL,10,0,31,5,46
2007,Algeria,DZA,Ireland,IRL,0,0,26,19,45
2007,Angola,AGO,Ireland,IRL,0,0,34,5,39
2007,Egypt,EGY,Ireland,IRL,0,0,0,5,5
2007,Armenia,ARM,Ireland,IRL,0,0,14,5,19
2007,Azerbaijan,AZE,Ireland,IRL,0,0,0,5,5
2007,Bahrain,BHR,Ireland,IRL,0,0,5,0,5
2007,Burundi,BDI,Ireland,IRL,0,0,13,5,18
2007,Benin,BEN,Ireland,IRL,0,0,5,0,5
2007,Bangladesh,BGD,Ireland,IRL,0,0,17,0,17
2007,Bhutan,BTN,Ireland,IRL,0,0,10,0,10
2007,Belarus,BLR,Ireland,IRL,0,0,10,13,23
2007,Botswana,BWA,Ireland,IRL,0,0,5,0,5
2007,Brazil,BRA,Ireland,IRL,0,0,11,0,11
2007,Chad,TCD,Ireland,IRL,0,0,0,5,5
2007,China,CHN,Ireland,IRL,5,0,57,161,223
2007,Cameroon,CMR,Ireland,IRL,5,0,35,10,50
2007,Congo,COG,Ireland,IRL,0,0,13,0,13
2007,Dem. Rep. of the Congo,COD,Ireland,IRL,12,0,118,21,151
2007,Eritrea,ERI,Ireland,IRL,20,0,10,11,41
2007,Ethiopia,ETH,Ireland,IRL,0,0,12,5,17
2007,Gambia,GMB,Ireland,IRL,0,0,5,0,5
2007,Palestinian,PSE,Ireland,IRL,5,0,17,10,32
2007,Georgia,GEO,Ireland,IRL,5,0,133,28,166
2007,Ghana,GHA,Ireland,IRL,0,0,65,11,76
2007,Guinea,GIN,Ireland,IRL,5,0,12,5,22
2007,Croatia,HRV,Ireland,IRL,0,0,5,5,10
2007,Cote d'Ivoire,CIV,Ireland,IRL,0,0,18,10,28
2007,India,IND,Ireland,IRL,0,0,14,5,19
2007,Iran (Islamic Rep. of),IRN,Ireland,IRL,12,0,37,49,98
2007,Iraq,IRQ,Ireland,IRL,101,0,105,36,242
2007,Israel,ISR,Ireland,IRL,0,0,19,0,19
2007,Jamaica,JAM,Ireland,IRL,0,0,5,0,5
2007,Kenya,KEN,Ireland,IRL,5,0,29,10,44
2007,Kyrgyzstan,KGZ,Ireland,IRL,0,0,5,0,5
2007,Kuwait,KWT,Ireland,IRL,19,0,20,5,44
2007,Liberia,LBR,Ireland,IRL,0,0,23,5,28
2007,Libya,LBY,Ireland,IRL,0,0,0,5,5
2007,Lebanon,LBN,Ireland,IRL,0,0,10,0,10
2007,Lesotho,LSO,Ireland,IRL,0,0,5,0,5
2007,Sri Lanka,LKA,Ireland,IRL,0,0,5,5,10
2007,Rep. of Moldova,MDA,Ireland,IRL,0,0,69,54,123
2007,Malaysia,MYS,Ireland,IRL,0,0,13,5,18
2007,Malawi,MWI,Ireland,IRL,0,0,12,0,12
2007,Mongolia,MNG,Ireland,IRL,0,0,0,14,14
2007,Morocco,MAR,Ireland,IRL,0,0,14,0,14
2007,Mauritius,MUS,Ireland,IRL,0,0,10,0,10
2007,Niger,NER,Ireland,IRL,0,0,5,0,5
2007,Nigeria,NGA,Ireland,IRL,10,0,1003,74,1087
2007,Pakistan,PAK,Ireland,IRL,17,0,109,14,140
2007,Romania,ROU,Ireland,IRL,0,0,16,5,21
2007,South Africa,ZAF,Ireland,IRL,0,0,35,5,40
2007,Russian Federation,RUS,Ireland,IRL,5,0,27,13,45
2007,Rwanda,RWA,Ireland,IRL,0,0,12,5,17
2007,Serbia and Kosovo: S/RES/1244 (1999),SRB,Ireland,IRL,5,0,22,5,32
2007,Sierra Leone,SLE,Ireland,IRL,0,0,26,5,31
2007,Somalia,SOM,Ireland,IRL,28,0,44,44,116
2007,Viet Nam,VNM,Ireland,IRL,0,0,5,5,10
2007,Sudan,SDN,Ireland,IRL,61,0,51,47,159
2007,Syrian Arab Rep.,SYR,Ireland,IRL,0,0,0,11,11
2007,Togo,TGO,Ireland,IRL,5,0,10,0,15
2007,Uganda,UGA,Ireland,IRL,11,0,20,0,31
2007,Ukraine,UKR,Ireland,IRL,0,0,21,5,26
2007,Uzbekistan,UZB,Ireland,IRL,0,0,5,0,5
2007,Zimbabwe,ZWE,Ireland,IRL,11,0,65,5,81
2007,Afghanistan,AFG,Italy,ITA,151,501,11,0,663
2007,Albania,ALB,Italy,ITA,5,5,13,0,23
2007,Algeria,DZA,Italy,ITA,0,10,59,0,69
2007,Angola,AGO,Italy,ITA,11,0,0,0,11
2007,Egypt,EGY,Italy,ITA,0,5,48,0,53
2007,Armenia,ARM,Italy,ITA,5,16,0,0,21
2007,Azerbaijan,AZE,Italy,ITA,0,11,0,0,11
2007,Benin,BEN,Italy,ITA,5,5,10,0,20
2007,Bangladesh,BGD,Italy,ITA,10,48,257,0,315
2007,Burkina Faso,BFA,Italy,ITA,14,54,124,0,192
2007,Belarus,BLR,Italy,ITA,0,0,11,0,11
2007,Bolivia (Plurinational State of),BOL,Italy,ITA,0,5,0,0,5
2007,Brazil,BRA,Italy,ITA,0,0,11,0,11
2007,Bosnia and Herzegovina,BIH,Italy,ITA,0,5,5,0,10
2007,Chad,TCD,Italy,ITA,5,5,0,0,10
2007,China,CHN,Italy,ITA,0,13,0,0,13
2007,Cameroon,CMR,Italy,ITA,32,42,46,0,120
2007,Congo,COG,Italy,ITA,27,58,12,0,97
2007,Dem. Rep. of the Congo,COD,Italy,ITA,12,20,5,0,37
2007,Colombia,COL,Italy,ITA,5,44,17,0,66
2007,Cuba,CUB,Italy,ITA,5,14,11,0,30
2007,Eritrea,ERI,Italy,ITA,193,2055,12,0,2260
2007,Ethiopia,ETH,Italy,ITA,132,238,29,0,399
2007,Gambia,GMB,Italy,ITA,16,34,92,0,142
2007,Palestinian,PSE,Italy,ITA,10,5,66,0,81
2007,Georgia,GEO,Italy,ITA,5,5,10,0,20
2007,Ghana,GHA,Italy,ITA,5,66,602,0,673
2007,Guinea-Bissau,GNB,Italy,ITA,0,0,23,0,23
2007,Guinea,GIN,Italy,ITA,35,110,72,0,217
2007,Croatia,HRV,Italy,ITA,0,0,5,0,5
2007,Cote d'Ivoire,CIV,Italy,ITA,72,728,182,0,982
2007,India,IND,Italy,ITA,5,0,57,0,62
2007,Iran (Islamic Rep. of),IRN,Italy,ITA,40,24,5,0,69
2007,Iraq,IRQ,Italy,ITA,99,63,27,0,189
2007,Kenya,KEN,Italy,ITA,0,5,0,0,5
2007,Kuwait,KWT,Italy,ITA,0,5,0,0,5
2007,Liberia,LBR,Italy,ITA,5,19,63,0,87
2007,Lebanon,LBN,Italy,ITA,14,62,29,0,105
2007,Sri Lanka,LKA,Italy,ITA,31,173,20,0,224
2007,Mauritania,MRT,Italy,ITA,12,5,12,0,29
2007,North Macedonia,MKD,Italy,ITA,0,5,59,0,64
2007,Rep. of Moldova,MDA,Italy,ITA,0,10,19,0,29
2007,Mali,MLI,Italy,ITA,0,32,236,0,268
2007,Morocco,MAR,Italy,ITA,5,0,20,0,25
2007,Nepal,NPL,Italy,ITA,0,5,0,0,5
2007,Niger,NER,Italy,ITA,0,11,60,0,71
2007,Nigeria,NGA,Italy,ITA,33,213,1090,0,1336
2007,Pakistan,PAK,Italy,ITA,20,33,123,0,176
2007,Peru,PER,Italy,ITA,0,0,5,0,5
2007,Romania,ROU,Italy,ITA,0,0,5,0,5
2007,Russian Federation,RUS,Italy,ITA,5,18,13,0,36
2007,Rwanda,RWA,Italy,ITA,5,0,0,0,5
2007,El Salvador,SLV,Italy,ITA,0,5,12,0,17
2007,Serbia and Kosovo: S/RES/1244 (1999),SRB,Italy,ITA,28,242,843,0,1113
2007,Senegal,SEN,Italy,ITA,0,20,47,0,67
2007,Sierra Leone,SLE,Italy,ITA,0,13,38,0,51
2007,Somalia,SOM,Italy,ITA,86,637,34,0,757
2007,Sudan,SDN,Italy,ITA,121,221,41,0,383
2007,Syrian Arab Rep.,SYR,Italy,ITA,12,10,5,0,27
2007,Togo,TGO,Italy,ITA,50,200,105,0,355
2007,Tunisia,TUN,Italy,ITA,0,0,14,0,14
2007,Turkey,TUR,Italy,ITA,80,169,145,0,394
2007,Uganda,UGA,Italy,ITA,5,0,5,0,10
2007,Ukraine,UKR,Italy,ITA,0,5,21,0,26
2007,Afghanistan,AFG,Japan,JPN,0,0,0,5,5
2007,Burundi,BDI,Japan,JPN,0,0,5,0,5
2007,Bangladesh,BGD,Japan,JPN,0,0,11,5,16
2007,China,CHN,Japan,JPN,0,0,13,0,13
2007,Cameroon,CMR,Japan,JPN,0,0,5,5,10
2007,Dem. Rep. of the Congo,COD,Japan,JPN,0,0,10,0,10
2007,Ethiopia,ETH,Japan,JPN,0,0,5,0,5
2007,Iran (Islamic Rep. of),IRN,Japan,JPN,5,0,21,0,26
2007,Sri Lanka,LKA,Japan,JPN,0,0,34,0,34
2007,Myanmar,MMR,Japan,JPN,31,49,251,17,348
2007,Nepal,NPL,Japan,JPN,0,0,10,0,10
2007,Nigeria,NGA,Japan,JPN,0,0,5,0,5
2007,Pakistan,PAK,Japan,JPN,0,0,5,11,16
2007,Philippines,PHL,Japan,JPN,0,0,5,0,5
2007,Sudan,SDN,Japan,JPN,0,0,0,5,5
2007,Turkey,TUR,Japan,JPN,0,5,52,10,67
2007,Uganda,UGA,Japan,JPN,0,0,5,0,5
2007,Afghanistan,AFG,Kazakhstan,KAZ,20,0,22,15,57
2007,Togo,TGO,Liberia,LBR,0,0,0,10,10
2007,Dem. Rep. of the Congo,COD,Liechtenstein,LIE,0,0,0,5,5
2007,Iran (Islamic Rep. of),IRN,Liechtenstein,LIE,5,0,0,0,5
2007,Iraq,IRQ,Liechtenstein,LIE,0,0,5,0,5
2007,Russian Federation,RUS,Liechtenstein,LIE,0,0,5,5,10
2007,Serbia and Kosovo: S/RES/1244 (1999),SRB,Liechtenstein,LIE,0,5,0,0,5
2007,Somalia,SOM,Liechtenstein,LIE,0,0,0,5,5
2007,Armenia,ARM,Lithuania,LTU,0,0,0,5,5
2007,Belarus,BLR,Lithuania,LTU,0,0,5,5,10
2007,Eritrea,ERI,Lithuania,LTU,5,0,0,0,5
2007,Ethiopia,ETH,Lithuania,LTU,0,5,0,0,5
2007,Georgia,GEO,Lithuania,LTU,0,0,0,14,14
2007,Kazakhstan,KAZ,Lithuania,LTU,0,0,5,0,5
2007,Morocco,MAR,Lithuania,LTU,0,0,0,5,5
2007,Nepal,NPL,Lithuania,LTU,0,0,5,0,5
2007,Pakistan,PAK,Lithuania,LTU,0,0,5,0,5
2007,Russian Federation,RUS,Lithuania,LTU,0,36,17,10,63
2007,Viet Nam,VNM,Lithuania,LTU,0,0,5,0,5
2007,Uzbekistan,UZB,Lithuania,LTU,5,5,0,0,10
2007,Azerbaijan,AZE,Latvia,LVA,5,0,0,0,5
2007,Russian Federation,RUS,Latvia,LVA,0,0,5,0,5
2007,India,IND,North Macedonia,MKD,0,0,0,5,5
2007,Serbia and Kosovo: S/RES/1244 (1999),SRB,North Macedonia,MKD,0,5,56,0,61
2007,Bangladesh,BGD,Mexico,MEX,0,0,26,5,31
2007,China,CHN,Mexico,MEX,0,0,0,5,5
2007,Cameroon,CMR,Mexico,MEX,0,0,0,5,5
2007,Colombia,COL,Mexico,MEX,30,0,14,16,60
2007,Cuba,CUB,Mexico,MEX,0,0,10,23,33
2007,Eritrea,ERI,Mexico,MEX,0,0,0,34,34
2007,Ethiopia,ETH,Mexico,MEX,0,0,0,15,15
2007,Guatemala,GTM,Mexico,MEX,0,0,10,17,27
2007,Guinea,GIN,Mexico,MEX,0,0,5,0,5
2007,Haiti,HTI,Mexico,MEX,24,0,13,0,37
2007,Honduras,HND,Mexico,MEX,0,0,13,27,40
2007,Iran (Islamic Rep. of),IRN,Mexico,MEX,0,0,0,5,5
2007,Iraq,IRQ,Mexico,MEX,5,0,0,12,17
2007,Liberia,LBR,Mexico,MEX,0,0,0,5,5
2007,Myanmar,MMR,Mexico,MEX,5,0,0,0,5
2007,Nicaragua,NIC,Mexico,MEX,0,0,0,5,5
2007,Nigeria,NGA,Mexico,MEX,0,0,13,0,13
2007,El Salvador,SLV,Mexico,MEX,0,0,20,31,51
2007,Somalia,SOM,Mexico,MEX,5,0,0,17,22
2007,Sudan,SDN,Mexico,MEX,0,0,0,5,5
2007,Turkey,TUR,Mexico,MEX,0,0,0,5,5
2007,Venezuela (Bolivarian Republic of),VEN,Mexico,MEX,5,0,0,0,5
2007,Dem. Rep. of the Congo,COD,Mali,MLI,32,0,10,0,42
2007,Cote d'Ivoire,CIV,Mali,MLI,23,0,13,0,36
2007,Togo,TGO,Mali,MLI,0,0,5,0,5
2007,Burundi,BDI,Mozambique,MOZ,67,0,102,0,169
2007,Congo,COG,Mozambique,MOZ,0,0,0,11,11
2007,Dem. Rep. of the Congo,COD,Mozambique,MOZ,0,0,5,711,716
2007,Rwanda,RWA,Mozambique,MOZ,61,0,43,25,129
2007,Somalia,SOM,Mozambique,MOZ,0,0,0,5,5
2007,Cameroon,CMR,Malta,MLT,0,0,5,0,5
2007,Congo,COG,Malta,MLT,0,0,13,0,13
2007,Eritrea,ERI,Malta,MLT,0,211,35,0,246
2007,Ethiopia,ETH,Malta,MLT,5,5,44,0,54
2007,Palestinian,PSE,Malta,MLT,0,0,10,0,10
2007,Ghana,GHA,Malta,MLT,0,0,10,0,10
2007,Cote d'Ivoire,CIV,Malta,MLT,0,0,53,0,53
2007,Iraq,IRQ,Malta,MLT,0,5,0,0,5
2007,Libya,LBY,Malta,MLT,0,0,5,0,5
2007,Mali,MLI,Malta,MLT,0,0,34,0,34
2007,Niger,NER,Malta,MLT,0,0,18,0,18
2007,Nigeria,NGA,Malta,MLT,0,0,25,10,35
2007,Sierra Leone,SLE,Malta,MLT,0,0,5,0,5
2007,Somalia,SOM,Malta,MLT,5,371,5,0,381
2007,Sudan,SDN,Malta,MLT,0,32,32,0,64
2007,Togo,TGO,Malta,MLT,0,0,5,0,5
2007,Burundi,BDI,Namibia,NAM,0,5,15,16,36
2007,Dem. Rep. of the Congo,COD,Namibia,NAM,0,5,67,16,88
2007,Liberia,LBR,Namibia,NAM,0,0,5,0,5
2007,Rwanda,RWA,Namibia,NAM,0,0,5,190,195
2007,Sierra Leone,SLE,Namibia,NAM,0,0,5,0,5
2007,Sudan,SDN,Namibia,NAM,0,0,0,5,5
2007,Bhutan,BTN,Nepal,NPL,0,0,0,1007,1007
2007,Afghanistan,AFG,Netherlands,NLD,11,174,246,269,700
2007,Albania,ALB,Netherlands,NLD,0,0,5,11,16
2007,Algeria,DZA,Netherlands,NLD,0,0,22,25,47
2007,Angola,AGO,Netherlands,NLD,0,20,64,99,183
2007,Egypt,EGY,Netherlands,NLD,0,0,14,0,14
2007,Argentina,ARG,Netherlands,NLD,0,0,0,5,5
2007,Armenia,ARM,Netherlands,NLD,0,15,126,117,258
2007,Azerbaijan,AZE,Netherlands,NLD,5,22,81,202,310
2007,Burundi,BDI,Netherlands,NLD,0,145,123,27,295
2007,Benin,BEN,Netherlands,NLD,0,0,5,0,5
2007,Bangladesh,BGD,Netherlands,NLD,0,0,0,14,14
2007,Bhutan,BTN,Netherlands,NLD,0,5,0,0,5
2007,Belarus,BLR,Netherlands,NLD,5,0,14,10,29
2007,Bosnia and Herzegovina,BIH,Netherlands,NLD,0,5,17,70,92
2007,Cambodia,KHM,Netherlands,NLD,14,0,0,0,14
2007,Chad,TCD,Netherlands,NLD,0,0,5,0,5
2007,China,CHN,Netherlands,NLD,27,50,156,119,352
2007,Cameroon,CMR,Netherlands,NLD,0,14,24,13,51
2007,Congo,COG,Netherlands,NLD,0,35,33,15,83
2007,Dem. Rep. of the Congo,COD,Netherlands,NLD,24,55,50,34,163
2007,Colombia,COL,Netherlands,NLD,0,14,52,5,71
2007,Cuba,CUB,Netherlands,NLD,0,0,22,10,32
2007,Czechia,CZE,Netherlands,NLD,0,0,0,10,10
2007,Dominican Rep.,DOM,Netherlands,NLD,0,0,12,18,30
2007,Eritrea,ERI,Netherlands,NLD,15,120,28,23,186
2007,Ethiopia,ETH,Netherlands,NLD,20,77,29,33,159
2007,France,FRA,Netherlands,NLD,0,0,5,0,5
2007,Gambia,GMB,Netherlands,NLD,0,5,15,0,20
2007,Palestinian,PSE,Netherlands,NLD,0,0,18,17,35
2007,Georgia,GEO,Netherlands,NLD,0,0,65,44,109
2007,Ghana,GHA,Netherlands,NLD,0,0,14,5,19
2007,Guinea-Bissau,GNB,Netherlands,NLD,0,0,10,0,10
2007,Guinea,GIN,Netherlands,NLD,0,5,35,38,78
2007,Croatia,HRV,Netherlands,NLD,0,0,5,18,23
2007,Cote d'Ivoire,CIV,Netherlands,NLD,0,84,32,11,127
2007,India,IND,Netherlands,NLD,0,0,60,34,94
2007,Indonesia,IDN,Netherlands,NLD,0,0,0,13,13
2007,Iran (Islamic Rep. of),IRN,Netherlands,NLD,32,106,164,526,828
2007,Iraq,IRQ,Netherlands,NLD,231,1263,474,454,2422
2007,Israel,ISR,Netherlands,NLD,0,0,5,0,5
2007,Jamaica,JAM,Netherlands,NLD,0,0,0,5,5
2007,Jordan,JOR,Netherlands,NLD,5,0,0,0,5
2007,Kazakhstan,KAZ,Netherlands,NLD,0,5,5,21,31
2007,Kyrgyzstan,KGZ,Netherlands,NLD,0,5,5,11,21
2007,Dem. People's Rep. of Korea,PRK,Netherlands,NLD,0,5,5,0,10
2007,Liberia,LBR,Netherlands,NLD,0,58,64,20,142
2007,Libya,LBY,Netherlands,NLD,0,26,10,15,51
2007,Lebanon,LBN,Netherlands,NLD,0,0,26,24,50
2007,Sri Lanka,LKA,Netherlands,NLD,12,0,61,79,152
2007,Mauritania,MRT,Netherlands,NLD,0,0,0,5,5
2007,North Macedonia,MKD,Netherlands,NLD,0,0,5,13,18
2007,Rep. of Moldova,MDA,Netherlands,NLD,0,0,5,5,10
2007,Malaysia,MYS,Netherlands,NLD,0,0,5,0,5
2007,Malawi,MWI,Netherlands,NLD,0,0,5,0,5
2007,Mongolia,MNG,Netherlands,NLD,0,0,97,20,117
2007,Morocco,MAR,Netherlands,NLD,0,0,12,0,12
2007,Myanmar,MMR,Netherlands,NLD,5,70,5,5,85
2007,Nepal,NPL,Netherlands,NLD,5,51,51,5,112
2007,Niger,NER,Netherlands,NLD,0,12,5,0,17
2007,Nigeria,NGA,Netherlands,NLD,0,14,164,49,227
2007,Pakistan,PAK,Netherlands,NLD,0,5,32,32,69
2007,Philippines,PHL,Netherlands,NLD,0,0,5,0,5
2007,Romania,ROU,Netherlands,NLD,0,0,5,5,10
2007,South Africa,ZAF,Netherlands,NLD,0,5,0,0,5
2007,Russian Federation,RUS,Netherlands,NLD,10,23,75,42,150
2007,Rwanda,RWA,Netherlands,NLD,0,10,24,32,66
2007,El Salvador,SLV,Netherlands,NLD,0,0,5,0,5
2007,Serbia and Kosovo: S/RES/1244 (1999),SRB,Netherlands,NLD,0,14,77,414,505
2007,Senegal,SEN,Netherlands,NLD,0,0,12,0,12
2007,Sierra Leone,SLE,Netherlands,NLD,0,77,97,48,222
2007,Somalia,SOM,Netherlands,NLD,30,1039,450,147,1666
2007,Viet Nam,VNM,Netherlands,NLD,0,5,5,11,21
2007,Sudan,SDN,Netherlands,NLD,5,33,67,62,167
2007,Syrian Arab Rep.,SYR,Netherlands,NLD,5,21,57,164,247
2007,United Rep. of Tanzania,TZA,Netherlands,NLD,0,0,5,0,5
2007,Tajikistan,TJK,Netherlands,NLD,0,0,0,5,5
2007,Togo,TGO,Netherlands,NLD,0,10,14,5,29
2007,Tunisia,TUN,Netherlands,NLD,0,0,5,0,5
2007,Turkey,TUR,Netherlands,NLD,5,28,108,157,298
2007,Uganda,UGA,Netherlands,NLD,0,5,14,5,24
2007,Ukraine,UKR,Netherlands,NLD,0,0,18,22,40
2007,United States of America,USA,Netherlands,NLD,0,0,5,0,5
2007,Uzbekistan,UZB,Netherlands,NLD,0,28,17,15,60
2007,Yemen,YEM,Netherlands,NLD,0,0,5,5,10
2007,Zimbabwe,ZWE,Netherlands,NLD,0,0,14,0,14
2007,Stateless,XXA,Netherlands,NLD,5,15,58,41,119
2007,Dem. Rep. of the Congo,COD,Niger,NER,5,0,5,0,10
2007,Cote d'Ivoire,CIV,Niger,NER,0,0,5,0,5
2007,Colombia,COL,Nicaragua,NIC,0,0,0,5,5
2007,Cuba,CUB,Nicaragua,NIC,0,0,0,12,12
2007,Guatemala,GTM,Nicaragua,NIC,5,0,0,0,5
2007,Peru,PER,Nicaragua,NIC,0,0,0,5,5
2007,El Salvador,SLV,Nicaragua,NIC,0,0,0,10,10
2007,Somalia,SOM,Nicaragua,NIC,0,0,0,5,5
2007,Chad,TCD,Nigeria,NGA,0,0,0,5,5
2007,Cameroon,CMR,Nigeria,NGA,0,0,5,0,5
2007,Dem. Rep. of the Congo,COD,Nigeria,NGA,19,0,100,105,224
2007,Ethiopia,ETH,Nigeria,NGA,0,0,0,5,5
2007,Guinea,GIN,Nigeria,NGA,0,0,0,5,5
2007,Cote d'Ivoire,CIV,Nigeria,NGA,0,0,10,13,23
2007,Togo,TGO,Nigeria,NGA,0,0,0,5,5
2007,Afghanistan,AFG,Norway,NOR,16,97,10,27,150
2007,Albania,ALB,Norway,NOR,0,0,20,10,30
2007,Algeria,DZA,Norway,NOR,0,0,18,15,33
2007,Angola,AGO,Norway,NOR,5,5,11,0,21
2007,Egypt,EGY,Norway,NOR,0,0,0,5,5
2007,Armenia,ARM,Norway,NOR,0,0,11,0,11
2007,Azerbaijan,AZE,Norway,NOR,0,0,5,12,17
2007,Burundi,BDI,Norway,NOR,5,10,59,21,95
2007,Bangladesh,BGD,Norway,NOR,0,0,14,10,24
2007,Bhutan,BTN,Norway,NOR,0,0,43,5,48
2007,Belarus,BLR,Norway,NOR,0,0,10,10,20
2007,Bosnia and Herzegovina,BIH,Norway,NOR,0,0,10,17,27
2007,Bulgaria,BGR,Norway,NOR,0,0,5,0,5
2007,China,CHN,Norway,NOR,40,14,10,5,69
2007,Cameroon,CMR,Norway,NOR,0,0,13,0,13
2007,Congo,COG,Norway,NOR,0,0,0,5,5
2007,Dem. Rep. of the Congo,COD,Norway,NOR,19,14,27,5,65
2007,Colombia,COL,Norway,NOR,0,5,0,0,5
2007,Cuba,CUB,Norway,NOR,0,0,0,5,5
2007,Eritrea,ERI,Norway,NOR,119,241,18,127,505
2007,Ethiopia,ETH,Norway,NOR,97,20,154,27,298
2007,Gambia,GMB,Norway,NOR,0,0,0,10,10
2007,United Kingdom of Great Britain and Northern Ireland,GBR,Norway,NOR,0,0,0,5,5
2007,Georgia,GEO,Norway,NOR,0,0,5,0,5
2007,Ghana,GHA,Norway,NOR,0,0,0,12,12
2007,Guinea,GIN,Norway,NOR,5,0,5,0,10
2007,Cote d'Ivoire,CIV,Norway,NOR,0,5,5,0,10
2007,India,IND,Norway,NOR,0,0,12,52,64
2007,Iran (Islamic Rep. of),IRN,Norway,NOR,21,44,187,52,304
2007,Iraq,IRQ,Norway,NOR,54,471,387,228,1140
2007,Israel,ISR,Norway,NOR,0,0,0,5,5
2007,Jordan,JOR,Norway,NOR,0,0,0,10,10
2007,Kazakhstan,KAZ,Norway,NOR,0,5,0,0,5
2007,Kenya,KEN,Norway,NOR,0,0,5,0,5
2007,Kyrgyzstan,KGZ,Norway,NOR,0,0,14,0,14
2007,Rep. of Korea,KOR,Norway,NOR,0,0,0,5,5
2007,Dem. People's Rep. of Korea,PRK,Norway,NOR,5,0,0,14,19
2007,Kuwait,KWT,Norway,NOR,0,0,0,5,5
2007,Liberia,LBR,Norway,NOR,0,5,17,0,22
2007,Libya,LBY,Norway,NOR,5,0,0,20,25
2007,Lebanon,LBN,Norway,NOR,0,5,45,17,67
2007,Sri Lanka,LKA,Norway,NOR,0,44,147,41,232
2007,North Macedonia,MKD,Norway,NOR,0,0,12,5,17
2007,Rep. of Moldova,MDA,Norway,NOR,0,0,5,0,5
2007,Mongolia,MNG,Norway,NOR,0,0,5,5,10
2007,Morocco,MAR,Norway,NOR,0,0,14,5,19
2007,Montenegro,MNE,Norway,NOR,0,0,5,0,5
2007,Myanmar,MMR,Norway,NOR,12,5,5,5,27
2007,Nepal,NPL,Norway,NOR,0,0,79,5,84
2007,Niger,NER,Norway,NOR,0,0,5,0,5
2007,Nigeria,NGA,Norway,NOR,0,0,29,19,48
2007,Pakistan,PAK,Norway,NOR,0,5,30,12,47
2007,Philippines,PHL,Norway,NOR,0,0,5,0,5
2007,Romania,ROU,Norway,NOR,0,0,12,0,12
2007,Russian Federation,RUS,Norway,NOR,21,412,142,127,702
2007,Rwanda,RWA,Norway,NOR,5,0,14,0,19
2007,Serbia and Kosovo: S/RES/1244 (1999),SRB,Norway,NOR,124,11,160,87,382
2007,Sierra Leone,SLE,Norway,NOR,0,0,0,13,13
2007,Somalia,SOM,Norway,NOR,250,382,104,53,789
2007,Viet Nam,VNM,Norway,NOR,0,0,5,13,18
2007,Sudan,SDN,Norway,NOR,19,0,16,10,45
2007,Slovakia,SVK,Norway,NOR,0,0,15,0,15
2007,Syrian Arab Rep.,SYR,Norway,NOR,15,0,13,13,41
2007,Turkmenistan,TKM,Norway,NOR,0,0,5,0,5
2007,Togo,TGO,Norway,NOR,0,0,0,5,5
2007,Tunisia,TUN,Norway,NOR,0,0,0,5,5
2007,Turkey,TUR,Norway,NOR,0,0,27,33,60
2007,Uganda,UGA,Norway,NOR,5,0,11,0,16
2007,Ukraine,UKR,Norway,NOR,0,0,5,5,10
2007,Uzbekistan,UZB,Norway,NOR,0,0,26,10,36
2007,Western Sahara,ESH,Norway,NOR,0,0,0,5,5
2007,Yemen,YEM,Norway,NOR,16,10,0,5,31
2007,Zimbabwe,ZWE,Norway,NOR,5,0,14,0,19
2007,Stateless,XXA,Norway,NOR,150,110,48,90,398
2007,Bangladesh,BGD,New Zealand,NZL,0,0,20,0,20
2007,China,CHN,New Zealand,NZL,19,0,17,0,36
2007,Czechia,CZE,New Zealand,NZL,0,0,10,0,10
2007,Fiji,FJI,New Zealand,NZL,0,0,10,0,10
2007,Palestinian,PSE,New Zealand,NZL,0,0,5,0,5
2007,Hungary,HUN,New Zealand,NZL,0,0,10,0,10
2007,India,IND,New Zealand,NZL,0,0,10,0,10
2007,Iran (Islamic Rep. of),IRN,New Zealand,NZL,5,0,23,0,28
2007,Iraq,IRQ,New Zealand,NZL,23,0,5,0,28
2007,Sri Lanka,LKA,New Zealand,NZL,5,0,18,0,23
2007,Malaysia,MYS,New Zealand,NZL,0,0,5,0,5
2007,Myanmar,MMR,New Zealand,NZL,5,0,0,0,5
2007,Pakistan,PAK,New Zealand,NZL,0,0,11,0,11
2007,Poland,POL,New Zealand,NZL,0,0,5,0,5
2007,Russian Federation,RUS,New Zealand,NZL,0,0,5,0,5
2007,Sierra Leone,SLE,New Zealand,NZL,0,0,5,0,5
2007,Somalia,SOM,New Zealand,NZL,0,0,10,0,10
2007,Turkey,TUR,New Zealand,NZL,0,0,5,0,5
2007,Colombia,COL,Panama,PAN,43,0,23,0,66
2007,Sudan,SDN,Panama,PAN,5,0,0,0,5
2007,Colombia,COL,Paraguay,PRY,5,0,0,0,5
2007,Cuba,CUB,Paraguay,PRY,5,0,5,5,15
2007,Bolivia (Plurinational State of),BOL,Peru,PER,5,0,0,0,5
2007,Colombia,COL,Peru,PER,48,0,19,15,82
2007,Cuba,CUB,Peru,PER,19,0,50,5,74
2007,Eritrea,ERI,Peru,PER,0,0,0,5,5
2007,Palestinian,PSE,Peru,PER,10,0,0,0,10
2007,Haiti,HTI,Peru,PER,0,0,0,5,5
2007,Iraq,IRQ,Peru,PER,15,0,0,5,20
2007,Serbia and Kosovo: S/RES/1244 (1999),SRB,Peru,PER,0,0,0,5,5
2007,Somalia,SOM,Peru,PER,0,0,0,5,5
2007,Venezuela (Bolivarian Republic of),VEN,Peru,PER,5,0,0,0,5
2007,Palestinian,PSE,Philippines,PHL,5,0,0,0,5
2007,Iraq,IRQ,Philippines,PHL,0,0,0,5,5
2007,Myanmar,MMR,Philippines,PHL,0,0,0,5,5
2007,Viet Nam,VNM,Philippines,PHL,5,0,5,0,10
2007,Afghanistan,AFG,Poland,POL,0,0,5,5,10
2007,Algeria,DZA,Poland,POL,0,0,5,5,10
2007,Egypt,EGY,Poland,POL,0,0,5,5,10
2007,Armenia,ARM,Poland,POL,0,0,35,15,50
2007,Azerbaijan,AZE,Poland,POL,0,0,5,0,5
2007,Bangladesh,BGD,Poland,POL,0,0,15,5,20
2007,Belarus,BLR,Poland,POL,5,0,56,13,74
2007,China,CHN,Poland,POL,0,0,22,0,22
2007,Cameroon,CMR,Poland,POL,0,0,21,0,21
2007,Congo,COG,Poland,POL,0,0,10,0,10
2007,Dem. Rep. of the Congo,COD,Poland,POL,0,0,5,5,10
2007,Eritrea,ERI,Poland,POL,0,0,0,5,5
2007,Georgia,GEO,Poland,POL,0,0,25,5,30
2007,Ghana,GHA,Poland,POL,0,0,5,0,5
2007,India,IND,Poland,POL,0,0,32,5,37
2007,Iraq,IRQ,Poland,POL,5,18,15,5,43
2007,Kazakhstan,KAZ,Poland,POL,0,0,0,10,10
2007,Kyrgyzstan,KGZ,Poland,POL,0,0,15,10,25
2007,Sri Lanka,LKA,Poland,POL,0,10,10,5,25
2007,Lithuania,LTU,Poland,POL,0,0,5,0,5
2007,Rep. of Moldova,MDA,Poland,POL,0,0,11,0,11
2007,Mali,MLI,Poland,POL,0,0,5,0,5
2007,Mongolia,MNG,Poland,POL,0,0,10,0,10
2007,Nepal,NPL,Poland,POL,0,0,5,5,10
2007,Nigeria,NGA,Poland,POL,0,0,23,5,28
2007,Pakistan,PAK,Poland,POL,0,0,46,13,59
2007,Russian Federation,RUS,Poland,POL,136,2832,1289,1182,5439
2007,Senegal,SEN,Poland,POL,0,0,5,0,5
2007,Viet Nam,VNM,Poland,POL,0,0,43,5,48
2007,Sudan,SDN,Poland,POL,0,0,5,0,5
2007,Syrian Arab Rep.,SYR,Poland,POL,0,0,5,0,5
2007,Togo,TGO,Poland,POL,0,0,5,0,5
2007,Turkey,TUR,Poland,POL,0,0,14,5,19
2007,Ukraine,UKR,Poland,POL,0,0,45,5,50
2007,Stateless,XXA,Poland,POL,0,5,11,0,16
2007,Afghanistan,AFG,Portugal,PRT,0,0,5,0,5
2007,Angola,AGO,Portugal,PRT,0,0,5,0,5
2007,Belarus,BLR,Portugal,PRT,0,5,0,0,5
2007,Bosnia and Herzegovina,BIH,Portugal,PRT,0,0,5,0,5
2007,Dem. Rep. of the Congo,COD,Portugal,PRT,0,0,5,0,5
2007,Colombia,COL,Portugal,PRT,0,19,33,0,52
2007,Guinea,GIN,Portugal,PRT,0,0,10,0,10
2007,India,IND,Portugal,PRT,0,5,0,0,5
2007,Nigeria,NGA,Portugal,PRT,0,0,5,0,5
2007,Russian Federation,RUS,Portugal,PRT,0,0,5,0,5
2007,Sierra Leone,SLE,Portugal,PRT,0,0,5,0,5
2007,Angola,AGO,South Africa,ZAF,5,0,0,0,5
2007,Egypt,EGY,South Africa,ZAF,0,0,31,0,31
2007,Burundi,BDI,South Africa,ZAF,41,0,58,0,99
2007,Bangladesh,BGD,South Africa,ZAF,5,0,188,0,193
2007,China,CHN,South Africa,ZAF,0,0,11,0,11
2007,Cameroon,CMR,South Africa,ZAF,22,0,36,0,58
2007,Congo,COG,South Africa,ZAF,93,0,57,0,150
2007,Dem. Rep. of the Congo,COD,South Africa,ZAF,380,0,375,0,755
2007,Eritrea,ERI,South Africa,ZAF,21,0,36,0,57
2007,Ethiopia,ETH,South Africa,ZAF,99,0,111,0,210
2007,Gabon,GAB,South Africa,ZAF,0,0,10,0,10
2007,Ghana,GHA,South Africa,ZAF,0,0,23,0,23
2007,India,IND,South Africa,ZAF,0,0,99,0,99
2007,Kenya,KEN,South Africa,ZAF,10,0,51,0,61
2007,Malawi,MWI,South Africa,ZAF,5,0,641,0,646
2007,Mozambique,MOZ,South Africa,ZAF,0,0,41,0,41
2007,Nigeria,NGA,South Africa,ZAF,5,0,137,0,142
2007,Pakistan,PAK,South Africa,ZAF,0,0,197,0,197
2007,Poland,POL,South Africa,ZAF,5,0,0,0,5
2007,Rwanda,RWA,South Africa,ZAF,10,0,28,0,38
2007,Senegal,SEN,South Africa,ZAF,0,0,11,0,11
2007,Sierra Leone,SLE,South Africa,ZAF,0,0,5,0,5
2007,Somalia,SOM,South Africa,ZAF,747,0,18,0,765
2007,United Rep. of Tanzania,TZA,South Africa,ZAF,0,0,209,0,209
2007,Uganda,UGA,South Africa,ZAF,11,0,92,0,103
2007,Zambia,ZMB,South Africa,ZAF,0,0,39,0,39
2007,Zimbabwe,ZWE,South Africa,ZAF,271,0,1623,0,1894
2007,Afghanistan,AFG,Russian Federation,RUS,57,312,0,0,369
2007,Angola,AGO,Russian Federation,RUS,0,5,0,0,5
2007,Azerbaijan,AZE,Russian Federation,RUS,0,5,0,0,5
2007,China,CHN,Russian Federation,RUS,0,5,0,0,5
2007,Georgia,GEO,Russian Federation,RUS,68,49,0,0,117
2007,Iraq,IRQ,Russian Federation,RUS,0,5,0,0,5
2007,Pakistan,PAK,Russian Federation,RUS,5,0,0,0,5
2007,Tajikistan,TJK,Russian Federation,RUS,0,5,0,0,5
2007,Uzbekistan,UZB,Russian Federation,RUS,0,5,0,0,5
2007,Burundi,BDI,Rwanda,RWA,0,419,0,0,419
2007,Dem. Rep. of the Congo,COD,Rwanda,RWA,157,2637,0,0,2794
2007,Burundi,BDI,Senegal,SEN,0,0,5,0,5
2007,Central African Rep.,CAF,Senegal,SEN,0,0,5,0,5
2007,Chad,TCD,Senegal,SEN,0,0,5,0,5
2007,Congo,COG,Senegal,SEN,0,0,5,0,5
2007,Dem. Rep. of the Congo,COD,Senegal,SEN,0,0,15,0,15
2007,Gambia,GMB,Senegal,SEN,14,0,0,0,14
2007,Guinea,GIN,Senegal,SEN,0,0,21,0,21
2007,Cote d'Ivoire,CIV,Senegal,SEN,0,0,51,0,51
2007,Liberia,LBR,Senegal,SEN,0,0,46,0,46
2007,Sri Lanka,LKA,Senegal,SEN,0,0,11,0,11
2007,Mauritania,MRT,Senegal,SEN,0,0,17,0,17
2007,Niger,NER,Senegal,SEN,0,0,5,0,5
2007,Nigeria,NGA,Senegal,SEN,0,0,5,0,5
2007,Rwanda,RWA,Senegal,SEN,0,0,5,0,5
2007,Sierra Leone,SLE,Senegal,SEN,0,0,61,0,61
2007,Sudan,SDN,Senegal,SEN,0,0,5,0,5
2007,Togo,TGO,Senegal,SEN,0,0,20,0,20
2007,Eritrea,ERI,Sudan,SDN,9558,0,10,1932,11500
2007,Ethiopia,ETH,Sudan,SDN,658,0,5,39,702
2007,Somalia,SOM,Sudan,SDN,1109,0,0,5,1114
2007,Afghanistan,AFG,Slovakia,SVK,0,5,30,41,76
2007,Armenia,ARM,Slovakia,SVK,0,5,0,18,23
2007,Bangladesh,BGD,Slovakia,SVK,0,0,68,67,135
2007,Bhutan,BTN,Slovakia,SVK,0,0,0,5,5
2007,Belarus,BLR,Slovakia,SVK,0,0,0,10,10
2007,China,CHN,Slovakia,SVK,0,0,69,26,95
2007,Cameroon,CMR,Slovakia,SVK,0,0,5,0,5
2007,Cuba,CUB,Slovakia,SVK,5,0,0,0,5
2007,Palestinian,PSE,Slovakia,SVK,0,0,18,36,54
2007,Georgia,GEO,Slovakia,SVK,0,0,32,103,135
2007,India,IND,Slovakia,SVK,0,0,331,441,772
2007,Iran (Islamic Rep. of),IRN,Slovakia,SVK,5,0,0,0,5
2007,Iraq,IRQ,Slovakia,SVK,0,42,19,82,143
2007,Kazakhstan,KAZ,Slovakia,SVK,0,0,0,5,5
2007,Sri Lanka,LKA,Slovakia,SVK,0,0,5,15,20
2007,North Macedonia,MKD,Slovakia,SVK,0,0,0,5,5
2007,Rep. of Moldova,MDA,Slovakia,SVK,0,0,90,130,220
2007,Morocco,MAR,Slovakia,SVK,0,0,5,0,5
2007,Nepal,NPL,Slovakia,SVK,0,0,5,5,10
2007,Nigeria,NGA,Slovakia,SVK,0,0,13,0,13
2007,Pakistan,PAK,Slovakia,SVK,0,0,301,368,669
2007,Russian Federation,RUS,Slovakia,SVK,0,0,97,252,349
2007,Serbia and Kosovo: S/RES/1244 (1999),SRB,Slovakia,SVK,0,0,5,5,10
2007,Somalia,SOM,Slovakia,SVK,0,11,0,0,11
2007,Viet Nam,VNM,Slovakia,SVK,0,0,40,22,62
2007,Syrian Arab Rep.,SYR,Slovakia,SVK,0,11,10,22,43
2007,Tajikistan,TJK,Slovakia,SVK,0,0,0,5,5
2007,Turkey,TUR,Slovakia,SVK,0,0,5,5,10
2007,Ukraine,UKR,Slovakia,SVK,0,0,20,21,41
2007,Stateless,XXA,Slovakia,SVK,0,0,0,5,5
2007,Afghanistan,AFG,Slovenia,SVN,0,0,13,0,13
2007,Albania,ALB,Slovenia,SVN,0,0,5,16,21
2007,Bosnia and Herzegovina,BIH,Slovenia,SVN,0,0,39,11,50
2007,Palestinian,PSE,Slovenia,SVN,0,0,0,5,5
2007,Georgia,GEO,Slovenia,SVN,0,0,5,0,5
2007,Croatia,HRV,Slovenia,SVN,0,0,5,0,5
2007,India,IND,Slovenia,SVN,0,0,0,5,5
2007,Iraq,IRQ,Slovenia,SVN,0,0,5,0,5
2007,North Macedonia,MKD,Slovenia,SVN,0,0,5,16,21
2007,Rep. of Moldova,MDA,Slovenia,SVN,0,0,0,5,5
2007,Montenegro,MNE,Slovenia,SVN,0,0,0,5,5
2007,Pakistan,PAK,Slovenia,SVN,0,0,12,0,12
2007,Russian Federation,RUS,Slovenia,SVN,0,0,0,5,5
2007,Serbia and Kosovo: S/RES/1244 (1999),SRB,Slovenia,SVN,0,5,211,115,331
2007,Sierra Leone,SLE,Slovenia,SVN,0,0,0,5,5
2007,Turkey,TUR,Slovenia,SVN,0,0,10,38,48
2007,Ukraine,UKR,Slovenia,SVN,0,0,0,5,5
2007,Afghanistan,AFG,Sweden,SWE,24,253,375,315,967
2007,Albania,ALB,Sweden,SWE,5,15,52,51,123
2007,Algeria,DZA,Sweden,SWE,0,5,100,96,201
2007,Angola,AGO,Sweden,SWE,0,27,32,10,69
2007,Egypt,EGY,Sweden,SWE,5,13,110,29,157
2007,Armenia,ARM,Sweden,SWE,0,119,156,52,327
2007,Azerbaijan,AZE,Sweden,SWE,12,183,173,70,438
2007,Burundi,BDI,Sweden,SWE,0,60,126,14,200
2007,Benin,BEN,Sweden,SWE,0,5,5,0,10
2007,Bangladesh,BGD,Sweden,SWE,5,26,61,5,97
2007,Bhutan,BTN,Sweden,SWE,0,0,0,5,5
2007,Belarus,BLR,Sweden,SWE,5,46,264,175,490
2007,Bolivia (Plurinational State of),BOL,Sweden,SWE,0,5,694,102,801
2007,Brazil,BRA,Sweden,SWE,0,0,0,5,5
2007,Bosnia and Herzegovina,BIH,Sweden,SWE,5,44,147,86,282
2007,Bulgaria,BGR,Sweden,SWE,0,0,57,39,96
2007,Cambodia,KHM,Sweden,SWE,0,5,0,0,5
2007,Canada,CAN,Sweden,SWE,0,0,5,0,5
2007,China,CHN,Sweden,SWE,5,10,53,68,136
2007,Chile,CHL,Sweden,SWE,0,5,25,5,35
2007,Cameroon,CMR,Sweden,SWE,5,5,29,11,50
2007,Congo,COG,Sweden,SWE,5,5,5,0,15
2007,Dem. Rep. of the Congo,COD,Sweden,SWE,5,5,69,11,90
2007,Colombia,COL,Sweden,SWE,0,5,10,5,20
2007,Cuba,CUB,Sweden,SWE,0,5,17,5,27
2007,Ecuador,ECU,Sweden,SWE,0,0,11,5,16
2007,Eritrea,ERI,Sweden,SWE,98,391,286,167,942
2007,Estonia,EST,Sweden,SWE,0,0,5,0,5
2007,Ethiopia,ETH,Sweden,SWE,12,41,82,17,152
2007,Gambia,GMB,Sweden,SWE,0,0,13,5,18
2007,Georgia,GEO,Sweden,SWE,0,31,105,60,196
2007,Ghana,GHA,Sweden,SWE,0,0,20,0,20
2007,Guatemala,GTM,Sweden,SWE,0,0,10,0,10
2007,Guinea,GIN,Sweden,SWE,0,5,14,5,24
2007,Honduras,HND,Sweden,SWE,0,0,10,0,10
2007,Croatia,HRV,Sweden,SWE,0,5,23,14,42
2007,Hungary,HUN,Sweden,SWE,0,0,16,48,64
2007,Cote d'Ivoire,CIV,Sweden,SWE,5,5,16,0,26
2007,India,IND,Sweden,SWE,0,16,44,60,120
2007,Iran (Islamic Rep. of),IRN,Sweden,SWE,49,113,372,138,672
2007,Iraq,IRQ,Sweden,SWE,168,9708,2380,3025,15281
2007,Israel,ISR,Sweden,SWE,0,5,12,10,27
2007,Italy,ITA,Sweden,SWE,0,0,5,0,5
2007,Jordan,JOR,Sweden,SWE,0,114,45,31,190
2007,Kazakhstan,KAZ,Sweden,SWE,0,35,63,42,140
2007,Kenya,KEN,Sweden,SWE,0,5,18,5,28
2007,Kyrgyzstan,KGZ,Sweden,SWE,0,29,50,16,95
2007,Dem. People's Rep. of Korea,PRK,Sweden,SWE,0,0,5,0,5
2007,Kuwait,KWT,Sweden,SWE,0,0,5,0,5
2007,Liberia,LBR,Sweden,SWE,0,5,5,12,22
2007,Libya,LBY,Sweden,SWE,17,16,343,158,534
2007,Lebanon,LBN,Sweden,SWE,0,88,587,198,873
2007,Sri Lanka,LKA,Sweden,SWE,0,5,11,5,21
2007,Lithuania,LTU,Sweden,SWE,0,0,5,5,10
2007,North Macedonia,MKD,Sweden,SWE,0,20,51,71,142
2007,Rep. of Moldova,MDA,Sweden,SWE,0,0,14,110,124
2007,Mexico,MEX,Sweden,SWE,0,0,5,0,5
2007,Mongolia,MNG,Sweden,SWE,0,39,409,105,553
2007,Morocco,MAR,Sweden,SWE,5,0,55,42,102
2007,Montenegro,MNE,Sweden,SWE,0,17,64,41,122
2007,Myanmar,MMR,Sweden,SWE,5,0,0,0,5
2007,Nepal,NPL,Sweden,SWE,0,0,13,0,13
2007,Netherlands,NLD,Sweden,SWE,0,0,5,0,5
2007,Niger,NER,Sweden,SWE,0,0,5,0,5
2007,Nicaragua,NIC,Sweden,SWE,0,0,21,5,26
2007,Nigeria,NGA,Sweden,SWE,0,5,71,61,137
2007,Pakistan,PAK,Sweden,SWE,5,10,49,15,79
2007,Peru,PER,Sweden,SWE,0,0,22,5,27
2007,Philippines,PHL,Sweden,SWE,0,11,5,0,16
2007,Poland,POL,Sweden,SWE,0,0,0,5,5
2007,Romania,ROU,Sweden,SWE,0,5,63,176,244
2007,Russian Federation,RUS,Sweden,SWE,5,325,457,358,1145
2007,Rwanda,RWA,Sweden,SWE,5,0,5,0,10
2007,El Salvador,SLV,Sweden,SWE,0,0,44,11,55
2007,Saudi Arabia,SAU,Sweden,SWE,0,0,0,13,13
2007,Serbia and Kosovo: S/RES/1244 (1999),SRB,Sweden,SWE,185,337,1323,727,2572
2007,Senegal,SEN,Sweden,SWE,0,0,10,0,10
2007,Sierra Leone,SLE,Sweden,SWE,0,0,18,16,34
2007,Somalia,SOM,Sweden,SWE,117,1433,271,361,2182
2007,Viet Nam,VNM,Sweden,SWE,0,11,37,5,53
2007,Sudan,SDN,Sweden,SWE,10,17,21,10,58
2007,Slovakia,SVK,Sweden,SWE,0,0,0,5,5
2007,Sweden,SWE,Sweden,SWE,0,0,0,5,5
2007,Syrian Arab Rep.,SYR,Sweden,SWE,36,71,353,121,581
2007,Thailand,THA,Sweden,SWE,0,0,5,0,5
2007,Tajikistan,TJK,Sweden,SWE,0,17,5,5,27
2007,Turkmenistan,TKM,Sweden,SWE,0,5,12,5,22
2007,Togo,TGO,Sweden,SWE,0,0,12,0,12
2007,Tunisia,TUN,Sweden,SWE,5,0,36,34,75
2007,Turkey,TUR,Sweden,SWE,5,63,274,91,433
2007,Uganda,UGA,Sweden,SWE,5,5,15,0,25
2007,Ukraine,UKR,Sweden,SWE,0,18,73,30,121
2007,United States of America,USA,Sweden,SWE,0,0,10,5,15
2007,Uzbekistan,UZB,Sweden,SWE,19,283,459,79,840
2007,Venezuela (Bolivarian Republic of),VEN,Sweden,SWE,0,0,5,5,10
2007,Yemen,YEM,Sweden,SWE,5,14,37,5,61
2007,Zimbabwe,ZWE,Sweden,SWE,0,0,0,11,11
2007,Stateless,XXA,Sweden,SWE,67,549,520,277,1413
2007,Afghanistan,AFG,Switzerland,CHE,32,135,142,82,391
2007,Albania,ALB,Switzerland,CHE,0,0,0,25,25
2007,Algeria,DZA,Switzerland,CHE,5,10,16,108,139
2007,Angola,AGO,Switzerland,CHE,0,125,32,25,182
2007,Egypt,EGY,Switzerland,CHE,5,0,0,14,19
2007,Armenia,ARM,Switzerland,CHE,0,5,24,30,59
2007,Azerbaijan,AZE,Switzerland,CHE,0,0,11,18,29
2007,Burundi,BDI,Switzerland,CHE,0,11,0,5,16
2007,Benin,BEN,Switzerland,CHE,0,5,10,12,27
2007,Bangladesh,BGD,Switzerland,CHE,0,5,5,22,32
2007,Bhutan,BTN,Switzerland,CHE,0,0,5,0,5
2007,Burkina Faso,BFA,Switzerland,CHE,0,0,0,5,5
2007,Belarus,BLR,Switzerland,CHE,5,5,10,27,47
2007,Bolivia (Plurinational State of),BOL,Switzerland,CHE,0,5,0,0,5
2007,Bosnia and Herzegovina,BIH,Switzerland,CHE,27,133,50,61,271
2007,Bulgaria,BGR,Switzerland,CHE,0,5,10,93,108
2007,Cambodia,KHM,Switzerland,CHE,5,0,0,0,5
2007,Central African Rep.,CAF,Switzerland,CHE,5,0,0,0,5
2007,Chad,TCD,Switzerland,CHE,0,5,0,0,5
2007,China,CHN,Switzerland,CHE,29,187,192,113,521
2007,Chile,CHL,Switzerland,CHE,0,0,0,5,5
2007,Cameroon,CMR,Switzerland,CHE,10,19,56,57,142
2007,Congo,COG,Switzerland,CHE,14,0,0,0,14
2007,Dem. Rep. of the Congo,COD,Switzerland,CHE,19,194,145,55,413
2007,Colombia,COL,Switzerland,CHE,35,0,10,0,45
2007,Cuba,CUB,Switzerland,CHE,0,5,5,0,10
2007,Cabo Verde,CPV,Switzerland,CHE,0,0,0,5,5
2007,Czechia,CZE,Switzerland,CHE,0,0,0,5,5
2007,Equatorial Guinea,GNQ,Switzerland,CHE,0,0,5,0,5
2007,Eritrea,ERI,Switzerland,CHE,443,86,151,214,894
2007,Ethiopia,ETH,Switzerland,CHE,32,83,123,89,327
2007,France,FRA,Switzerland,CHE,0,0,0,5,5
2007,Gambia,GMB,Switzerland,CHE,0,0,5,12,17
2007,Georgia,GEO,Switzerland,CHE,0,5,21,203,229
2007,Germany,DEU,Switzerland,CHE,0,0,0,5,5
2007,Ghana,GHA,Switzerland,CHE,0,0,0,5,5
2007,Guinea-Bissau,GNB,Switzerland,CHE,0,0,10,15,25
2007,Guinea,GIN,Switzerland,CHE,0,5,13,76,94
2007,Haiti,HTI,Switzerland,CHE,0,0,0,5,5
2007,Croatia,HRV,Switzerland,CHE,0,0,5,17,22
2007,Cote d'Ivoire,CIV,Switzerland,CHE,10,5,67,86,168
2007,India,IND,Switzerland,CHE,0,5,0,28,33
2007,Iran (Islamic Rep. of),IRN,Switzerland,CHE,41,96,180,64,381
2007,Iraq,IRQ,Switzerland,CHE,118,455,326,363,1262
2007,Israel,ISR,Switzerland,CHE,0,0,5,5,10
2007,Jordan,JOR,Switzerland,CHE,0,0,0,5,5
2007,Kenya,KEN,Switzerland,CHE,0,5,0,5,10
2007,Kyrgyzstan,KGZ,Switzerland,CHE,5,0,0,5,10
2007,Rep. of Korea,KOR,Switzerland,CHE,0,0,0,5,5
2007,Dem. People's Rep. of Korea,PRK,Switzerland,CHE,0,0,0,10,10
2007,Liberia,LBR,Switzerland,CHE,0,5,5,11,21
2007,Libya,LBY,Switzerland,CHE,14,0,15,15,44
2007,Lebanon,LBN,Switzerland,CHE,0,0,14,47,61
2007,Sri Lanka,LKA,Switzerland,CHE,92,91,144,99,426
2007,Lithuania,LTU,Switzerland,CHE,0,0,0,5,5
2007,Mauritania,MRT,Switzerland,CHE,0,0,0,5,5
2007,North Macedonia,MKD,Switzerland,CHE,0,24,24,47,95
2007,Rep. of Moldova,MDA,Switzerland,CHE,0,0,0,38,38
2007,Mali,MLI,Switzerland,CHE,0,0,0,13,13
2007,Mongolia,MNG,Switzerland,CHE,0,10,13,96,119
2007,Morocco,MAR,Switzerland,CHE,0,0,10,27,37
2007,Mozambique,MOZ,Switzerland,CHE,0,5,5,0,10
2007,Montenegro,MNE,Switzerland,CHE,0,5,12,22,39
2007,Myanmar,MMR,Switzerland,CHE,5,5,0,0,10
2007,Nepal,NPL,Switzerland,CHE,0,0,5,10,15
2007,Niger,NER,Switzerland,CHE,0,0,5,5,10
2007,Nigeria,NGA,Switzerland,CHE,0,13,47,261,321
2007,Pakistan,PAK,Switzerland,CHE,5,5,12,28,50
2007,Peru,PER,Switzerland,CHE,0,0,0,5,5
2007,Poland,POL,Switzerland,CHE,0,0,10,5,15
2007,Romania,ROU,Switzerland,CHE,0,0,16,538,554
2007,South Africa,ZAF,Switzerland,CHE,0,0,0,5,5
2007,Russian Federation,RUS,Switzerland,CHE,13,78,96,216,403
2007,Rwanda,RWA,Switzerland,CHE,5,5,5,0,15
2007,Serbia and Kosovo: S/RES/1244 (1999),SRB,Switzerland,CHE,43,365,517,558,1483
2007,Senegal,SEN,Switzerland,CHE,0,0,5,21,26
2007,Sierra Leone,SLE,Switzerland,CHE,0,0,5,14,19
2007,Somalia,SOM,Switzerland,CHE,21,262,183,62,528
2007,Spain,ESP,Switzerland,CHE,0,0,0,5,5
2007,Viet Nam,VNM,Switzerland,CHE,25,0,11,0,36
2007,Sudan,SDN,Switzerland,CHE,5,5,28,41,79
2007,Slovakia,SVK,Switzerland,CHE,0,0,0,10,10
2007,Syrian Arab Rep.,SYR,Switzerland,CHE,22,79,87,19,207
2007,Togo,TGO,Switzerland,CHE,95,13,52,30,190
2007,Tunisia,TUN,Switzerland,CHE,43,5,5,41,94
2007,Turkey,TUR,Switzerland,CHE,307,98,220,165,790
2007,Uganda,UGA,Switzerland,CHE,0,0,0,14,14
2007,Ukraine,UKR,Switzerland,CHE,0,0,5,21,26
2007,Uzbekistan,UZB,Switzerland,CHE,10,5,5,5,25
2007,Yemen,YEM,Switzerland,CHE,15,13,20,10,58
2007,Zimbabwe,ZWE,Switzerland,CHE,5,0,0,17,22
2007,Burundi,BDI,Togo,TGO,0,0,0,5,5
2007,Central African Rep.,CAF,Togo,TGO,0,0,0,11,11
2007,Chad,TCD,Togo,TGO,0,0,0,5,5
2007,Congo,COG,Togo,TGO,0,0,0,10,10
2007,Dem. Rep. of the Congo,COD,Togo,TGO,5,0,15,0,20
2007,Guinea,GIN,Togo,TGO,0,0,0,22,22
2007,Cote d'Ivoire,CIV,Togo,TGO,0,0,25,193,218
2007,Iraq,IRQ,Togo,TGO,0,0,0,10,10
2007,Liberia,LBR,Togo,TGO,0,0,0,45,45
2007,Lebanon,LBN,Togo,TGO,0,0,0,5,5
2007,Sri Lanka,LKA,Togo,TGO,0,0,0,5,5
2007,Nigeria,NGA,Togo,TGO,0,0,0,5,5
2007,Rwanda,RWA,Togo,TGO,0,0,0,24,24
2007,Burundi,BDI,Uganda,UGA,151,0,271,0,422
2007,Dem. Rep. of the Congo,COD,Uganda,UGA,1669,0,64,0,1733
2007,Eritrea,ERI,Uganda,UGA,200,0,33,0,233
2007,Ethiopia,ETH,Uganda,UGA,170,0,63,0,233
2007,Pakistan,PAK,Uganda,UGA,5,0,0,0,5
2007,Rwanda,RWA,Uganda,UGA,235,0,1048,0,1283
2007,Somalia,SOM,Uganda,UGA,645,0,0,0,645
2007,Sudan,SDN,Uganda,UGA,5,0,5,0,10
2007,Afghanistan,AFG,Ukraine,UKR,12,0,12,58,82
2007,Algeria,DZA,Ukraine,UKR,0,0,0,5,5
2007,Egypt,EGY,Ukraine,UKR,0,0,0,10,10
2007,Armenia,ARM,Ukraine,UKR,5,0,0,5,10
2007,Azerbaijan,AZE,Ukraine,UKR,0,0,0,14,14
2007,Bangladesh,BGD,Ukraine,UKR,0,0,0,177,177
2007,Belarus,BLR,Ukraine,UKR,5,0,0,0,5
2007,China,CHN,Ukraine,UKR,0,0,0,5,5
2007,Dem. Rep. of the Congo,COD,Ukraine,UKR,0,0,0,10,10
2007,Palestinian,PSE,Ukraine,UKR,0,0,0,30,30
2007,Georgia,GEO,Ukraine,UKR,0,0,0,42,42
2007,Ghana,GHA,Ukraine,UKR,0,0,0,5,5
2007,India,IND,Ukraine,UKR,0,0,0,452,452
2007,Iran (Islamic Rep. of),IRN,Ukraine,UKR,0,0,0,15,15
2007,Iraq,IRQ,Ukraine,UKR,5,0,21,125,151
2007,Jordan,JOR,Ukraine,UKR,0,0,0,5,5
2007,Kazakhstan,KAZ,Ukraine,UKR,0,0,0,5,5
2007,Kyrgyzstan,KGZ,Ukraine,UKR,0,0,0,5,5
2007,Lebanon,LBN,Ukraine,UKR,0,0,0,5,5
2007,Sri Lanka,LKA,Ukraine,UKR,0,0,0,10,10
2007,Rep. of Moldova,MDA,Ukraine,UKR,0,0,0,10,10
2007,Nepal,NPL,Ukraine,UKR,0,0,0,10,10
2007,Nigeria,NGA,Ukraine,UKR,0,0,0,5,5
2007,Pakistan,PAK,Ukraine,UKR,0,0,0,532,532
2007,Russian Federation,RUS,Ukraine,UKR,0,0,5,52,57
2007,Somalia,SOM,Ukraine,UKR,0,0,29,66,95
2007,Viet Nam,VNM,Ukraine,UKR,0,0,0,58,58
2007,Sudan,SDN,Ukraine,UKR,0,0,5,0,5
2007,Tajikistan,TJK,Ukraine,UKR,0,0,0,5,5
2007,Turkmenistan,TKM,Ukraine,UKR,0,0,0,5,5
2007,Uzbekistan,UZB,Ukraine,UKR,0,0,0,49,49
2007,Stateless,XXA,Ukraine,UKR,0,0,0,10,10
2007,Cameroon,CMR,Uruguay,URY,5,0,0,0,5
2007,Colombia,COL,Uruguay,URY,10,0,0,0,10
2007,Nigeria,NGA,Uruguay,URY,5,0,0,0,5
2007,Colombia,COL,Venezuela (Bolivarian Republic of),VEN,218,0,287,0,505
2007,Iraq,IRQ,Venezuela (Bolivarian Republic of),VEN,5,0,0,0,5
2007,Nigeria,NGA,Venezuela (Bolivarian Republic of),VEN,5,0,0,0,5
2007,Burundi,BDI,Zimbabwe,ZWE,81,0,0,0,81
2007,Dem. Rep. of the Congo,COD,Zimbabwe,ZWE,592,0,12,154,758
2007,Eritrea,ERI,Zimbabwe,ZWE,0,0,0,11,11
2007,Ethiopia,ETH,Zimbabwe,ZWE,5,0,0,1844,1849
2007,Rwanda,RWA,Zimbabwe,ZWE,90,0,0,0,90
2007,Somalia,SOM,Zimbabwe,ZWE,5,0,0,1314,1319
2008,Iran (Islamic Rep. of),IRN,Armenia,ARM,0,5,0,0,5
2008,Iraq,IRQ,Armenia,ARM,0,123,0,5,128
2008,Afghanistan,AFG,Australia,AUS,31,0,5,0,36
2008,Albania,ALB,Australia,AUS,0,0,12,0,12
2008,Algeria,DZA,Australia,AUS,5,0,0,0,5
2008,Egypt,EGY,Australia,AUS,28,0,46,0,74
2008,Burundi,BDI,Australia,AUS,5,0,0,0,5
2008,Bangladesh,BGD,Australia,AUS,34,0,79,5,118
2008,Brazil,BRA,Australia,AUS,0,0,5,0,5
2008,China,CHN,Australia,AUS,183,0,1092,14,1289
2008,Cameroon,CMR,Australia,AUS,5,0,10,0,15
2008,Dem. Rep. of the Congo,COD,Australia,AUS,5,0,0,0,5
2008,Colombia,COL,Australia,AUS,5,0,12,0,17
2008,Eritrea,ERI,Australia,AUS,12,0,0,0,12
2008,Ethiopia,ETH,Australia,AUS,17,0,12,0,29
2008,Fiji,FJI,Australia,AUS,10,0,59,0,69
2008,Palestinian,PSE,Australia,AUS,10,0,10,0,20
2008,United Kingdom of Great Britain and Northern Ireland,GBR,Australia,AUS,0,0,5,5,10
2008,Germany,DEU,Australia,AUS,0,0,5,0,5
2008,Ghana,GHA,Australia,AUS,0,0,12,0,12
2008,"China, Hong Kong SAR",HKG,Australia,AUS,0,0,5,0,5
2008,India,IND,Australia,AUS,5,0,295,5,305
2008,Indonesia,IDN,Australia,AUS,5,0,214,0,219
2008,Iran (Islamic Rep. of),IRN,Australia,AUS,99,0,28,0,127
2008,Iraq,IRQ,Australia,AUS,154,0,17,10,181
2008,Israel,ISR,Australia,AUS,5,0,5,0,10
2008,Jordan,JOR,Australia,AUS,13,0,0,0,13
2008,Kenya,KEN,Australia,AUS,10,0,40,0,50
2008,Rep. of Korea,KOR,Australia,AUS,5,0,114,0,119
2008,Lebanon,LBN,Australia,AUS,13,0,68,0,81
2008,Sri Lanka,LKA,Australia,AUS,309,0,61,5,375
2008,Latvia,LVA,Australia,AUS,0,0,5,0,5
2008,Malaysia,MYS,Australia,AUS,0,0,231,5,236
2008,Myanmar,MMR,Australia,AUS,67,0,14,0,81
2008,Nepal,NPL,Australia,AUS,10,0,31,0,41
2008,Nigeria,NGA,Australia,AUS,0,0,19,0,19
2008,New Zealand,NZL,Australia,AUS,0,0,10,0,10
2008,Pakistan,PAK,Australia,AUS,134,0,67,0,201
2008,Peru,PER,Australia,AUS,0,0,5,0,5
2008,Philippines,PHL,Australia,AUS,5,0,12,0,17
2008,Papua New Guinea,PNG,Australia,AUS,15,0,15,0,30
2008,South Africa,ZAF,Australia,AUS,0,0,19,5,24
2008,Russian Federation,RUS,Australia,AUS,0,0,11,5,16
2008,Serbia and Kosovo: S/RES/1244 (1999),SRB,Australia,AUS,0,0,10,0,10
2008,Somalia,SOM,Australia,AUS,12,0,0,0,12
2008,Viet Nam,VNM,Australia,AUS,0,0,51,0,51
2008,Sudan,SDN,Australia,AUS,0,0,12,0,12
2008,Sweden,SWE,Australia,AUS,0,0,0,5,5
2008,Syrian Arab Rep.,SYR,Australia,AUS,5,0,5,0,10
2008,Thailand,THA,Australia,AUS,0,0,5,0,5
2008,Timor-Leste,TLS,Australia,AUS,0,0,11,0,11
2008,Turkey,TUR,Australia,AUS,23,0,16,0,39
2008,Uganda,UGA,Australia,AUS,5,0,10,0,15
2008,United States of America,USA,Australia,AUS,5,0,0,0,5
2008,Zimbabwe,ZWE,Australia,AUS,125,0,50,0,175
2008,Stateless,XXA,Australia,AUS,14,0,0,0,14
2008,Tibetan,TIB,Australia,AUS,5,0,0,0,5
2008,Afghanistan,AFG,Azerbaijan,AZE,0,0,149,0,149
2008,Iran (Islamic Rep. of),IRN,Azerbaijan,AZE,0,0,25,0,25
2008,Iraq,IRQ,Azerbaijan,AZE,0,0,15,0,15
2008,Pakistan,PAK,Azerbaijan,AZE,0,0,29,0,29
2008,Dem. Rep. of the Congo,COD,Burundi,BDI,3237,0,311,2270,5818
2008,Rwanda,RWA,Burundi,BDI,14,0,0,0,14
2008,Afghanistan,AFG,Belgium,BEL,107,92,459,32,690
2008,Albania,ALB,Belgium,BEL,38,5,107,19,169
2008,Algeria,DZA,Belgium,BEL,0,0,103,18,121
2008,Angola,AGO,Belgium,BEL,21,0,113,0,134
2008,Egypt,EGY,Belgium,BEL,5,0,13,0,18
2008,Armenia,ARM,Belgium,BEL,5,0,243,22,270
2008,Azerbaijan,AZE,Belgium,BEL,0,0,42,5,47
2008,Burundi,BDI,Belgium,BEL,57,0,39,5,101
2008,Benin,BEN,Belgium,BEL,0,0,5,0,5
2008,Bangladesh,BGD,Belgium,BEL,0,0,49,0,49
2008,Bhutan,BTN,Belgium,BEL,0,0,27,0,27
2008,Burkina Faso,BFA,Belgium,BEL,0,0,12,0,12
2008,Belarus,BLR,Belgium,BEL,5,0,31,0,36
2008,Brazil,BRA,Belgium,BEL,0,0,5,0,0
2008,Bosnia and Herzegovina,BIH,Belgium,BEL,11,0,70,10,91
2008,Bulgaria,BGR,Belgium,BEL,0,0,45,0,45
2008,Central African Rep.,CAF,Belgium,BEL,10,0,0,0,10
2008,Chad,TCD,Belgium,BEL,11,0,0,0,11
2008,China,CHN,Belgium,BEL,80,0,35,0,115
2008,Cameroon,CMR,Belgium,BEL,65,0,186,5,256
2008,Congo,COG,Belgium,BEL,5,0,23,0,28
2008,Dem. Rep. of the Congo,COD,Belgium,BEL,126,14,604,46,790
2008,Colombia,COL,Belgium,BEL,5,0,5,5,15
2008,Cuba,CUB,Belgium,BEL,0,0,5,0,5
2008,Czechia,CZE,Belgium,BEL,0,0,47,0,47
2008,Djibouti,DJI,Belgium,BEL,22,0,10,0,32
2008,Eritrea,ERI,Belgium,BEL,24,0,10,0,34
2008,Ethiopia,ETH,Belgium,BEL,26,0,54,0,80
2008,Gambia,GMB,Belgium,BEL,5,0,19,0,24
2008,Palestinian,PSE,Belgium,BEL,10,5,0,0,15
2008,Georgia,GEO,Belgium,BEL,0,0,73,10,83
2008,Ghana,GHA,Belgium,BEL,0,0,14,0,14
2008,Guinea,GIN,Belgium,BEL,360,0,384,37,781
2008,Haiti,HTI,Belgium,BEL,0,0,5,0,5
2008,Croatia,HRV,Belgium,BEL,0,0,5,0,5
2008,Hungary,HUN,Belgium,BEL,0,0,10,0,10
2008,Cote d'Ivoire,CIV,Belgium,BEL,30,0,55,0,85
2008,India,IND,Belgium,BEL,0,0,38,5,43
2008,Iran (Islamic Rep. of),IRN,Belgium,BEL,64,0,294,22,380
2008,Iraq,IRQ,Belgium,BEL,336,267,282,57,942
2008,Israel,ISR,Belgium,BEL,0,5,5,0,10
2008,Jordan,JOR,Belgium,BEL,0,0,13,0,13
2008,Kazakhstan,KAZ,Belgium,BEL,0,0,12,10,22
2008,Kenya,KEN,Belgium,BEL,10,0,11,0,21
2008,Kyrgyzstan,KGZ,Belgium,BEL,0,0,16,5,21
2008,Dem. People's Rep. of Korea,PRK,Belgium,BEL,5,0,0,0,5
2008,Liberia,LBR,Belgium,BEL,0,0,11,0,11
2008,Libya,LBY,Belgium,BEL,0,0,10,0,10
2008,Lebanon,LBN,Belgium,BEL,5,0,89,15,109
2008,Sri Lanka,LKA,Belgium,BEL,89,0,80,5,174
2008,Mauritania,MRT,Belgium,BEL,42,0,53,5,100
2008,North Macedonia,MKD,Belgium,BEL,0,0,62,20,82
2008,Rep. of Moldova,MDA,Belgium,BEL,0,0,13,0,13
2008,Mali,MLI,Belgium,BEL,5,0,0,0,5
2008,Mongolia,MNG,Belgium,BEL,5,0,24,0,29
2008,Morocco,MAR,Belgium,BEL,0,0,24,0,24
2008,Montenegro,MNE,Belgium,BEL,10,0,89,10,109
2008,Myanmar,MMR,Belgium,BEL,5,0,5,0,10
2008,Nepal,NPL,Belgium,BEL,5,0,42,5,52
2008,Niger,NER,Belgium,BEL,16,0,28,0,44
2008,Nigeria,NGA,Belgium,BEL,5,0,30,0,35
2008,Pakistan,PAK,Belgium,BEL,10,0,82,0,92
2008,Poland,POL,Belgium,BEL,0,0,5,0,5
2008,Romania,ROU,Belgium,BEL,0,0,44,0,44
2008,Russian Federation,RUS,Belgium,BEL,582,0,1331,117,2030
2008,Rwanda,RWA,Belgium,BEL,141,0,135,5,281
2008,Serbia and Kosovo: S/RES/1244 (1999),SRB,Belgium,BEL,387,0,675,120,1182
2008,Senegal,SEN,Belgium,BEL,12,0,0,0,12
2008,Sierra Leone,SLE,Belgium,BEL,17,0,21,0,38
2008,Somalia,SOM,Belgium,BEL,25,52,55,14,146
2008,Viet Nam,VNM,Belgium,BEL,0,0,10,0,10
2008,Sudan,SDN,Belgium,BEL,20,12,34,0,66
2008,Slovakia,SVK,Belgium,BEL,0,0,432,5,437
2008,Syrian Arab Rep.,SYR,Belgium,BEL,83,0,158,5,246
2008,United Rep. of Tanzania,TZA,Belgium,BEL,5,0,18,0,23
2008,Tajikistan,TJK,Belgium,BEL,0,0,5,5,10
2008,Turkmenistan,TKM,Belgium,BEL,0,0,5,0,0
2008,Togo,TGO,Belgium,BEL,27,0,115,5,147
2008,Tunisia,TUN,Belgium,BEL,0,0,5,0,5
2008,Turkey,TUR,Belgium,BEL,40,0,144,17,201
2008,Uganda,UGA,Belgium,BEL,0,0,15,0,15
2008,Ukraine,UKR,Belgium,BEL,0,0,23,5,28
2008,Uzbekistan,UZB,Belgium,BEL,18,0,20,5,43
2008,Yemen,YEM,Belgium,BEL,0,0,30,0,30
2008,Zimbabwe,ZWE,Belgium,BEL,5,0,0,0,5
2008,Stateless,XXA,Belgium,BEL,0,13,12,0,25
2008,Central African Rep.,CAF,Benin,BEN,0,0,17,11,28
2008,Chad,TCD,Benin,BEN,51,0,91,0,142
2008,Cameroon,CMR,Benin,BEN,0,0,5,5,10
2008,Congo,COG,Benin,BEN,5,0,11,5,21
2008,Dem. Rep. of the Congo,COD,Benin,BEN,5,0,112,155,272
2008,Equatorial Guinea,GNQ,Benin,BEN,0,0,5,0,5
2008,Haiti,HTI,Benin,BEN,0,0,5,0,5
2008,Cote d'Ivoire,CIV,Benin,BEN,0,0,5,0,5
2008,Kenya,KEN,Benin,BEN,0,0,5,0,5
2008,Nigeria,NGA,Benin,BEN,5,0,55,0,60
2008,Rwanda,RWA,Benin,BEN,5,0,10,5,20
2008,Sudan,SDN,Benin,BEN,0,0,5,0,5
2008,Togo,TGO,Benin,BEN,22,0,95,0,117
2008,Burundi,BDI,Burkina Faso,BFA,5,0,0,0,5
2008,Chad,TCD,Burkina Faso,BFA,15,0,5,0,20
2008,Congo,COG,Burkina Faso,BFA,0,0,14,0,14
2008,Dem. Rep. of the Congo,COD,Burkina Faso,BFA,5,0,5,0,10
2008,Cote d'Ivoire,CIV,Burkina Faso,BFA,0,0,10,0,10
2008,Afghanistan,AFG,Belarus,BLR,0,5,11,0,16
2008,Georgia,GEO,Belarus,BLR,0,0,5,5,10
2008,Iran (Islamic Rep. of),IRN,Belarus,BLR,0,0,5,0,5
2008,Iraq,IRQ,Belarus,BLR,0,0,0,5,5
2008,Pakistan,PAK,Belarus,BLR,0,0,0,5,5
2008,Ukraine,UKR,Belarus,BLR,0,0,0,5,5
2008,Colombia,COL,Bolivia (Plurinational State of),BOL,30,0,5,15,50
2008,Cuba,CUB,Bolivia (Plurinational State of),BOL,0,0,5,0,5
2008,Ecuador,ECU,Bolivia (Plurinational State of),BOL,5,0,0,0,5
2008,Eritrea,ERI,Bolivia (Plurinational State of),BOL,0,0,5,39,44
2008,Ethiopia,ETH,Bolivia (Plurinational State of),BOL,0,0,0,10,10
2008,Romania,ROU,Bolivia (Plurinational State of),BOL,0,0,0,5,5
2008,Somalia,SOM,Botswana,BWA,16,0,0,0,16
2008,Zimbabwe,ZWE,Botswana,BWA,731,0,0,0,731
2008,Angola,AGO,Brazil,BRA,5,0,10,0,15
2008,Burundi,BDI,Brazil,BRA,0,0,5,0,5
2008,Dem. Rep. of the Congo,COD,Brazil,BRA,51,10,31,5,97
2008,Colombia,COL,Brazil,BRA,14,5,26,30,75
2008,Cuba,CUB,Brazil,BRA,5,0,32,24,61
2008,Eritrea,ERI,Brazil,BRA,0,0,0,16,16
2008,Ethiopia,ETH,Brazil,BRA,0,0,0,13,13
2008,Palestinian,PSE,Brazil,BRA,0,0,0,5,5
2008,Ghana,GHA,Brazil,BRA,0,0,0,5,5
2008,Guinea-Bissau,GNB,Brazil,BRA,0,0,11,12,23
2008,Guinea,GIN,Brazil,BRA,0,0,16,0,16
2008,Cote d'Ivoire,CIV,Brazil,BRA,0,0,0,5,5
2008,Iraq,IRQ,Brazil,BRA,13,0,0,5,18
2008,Israel,ISR,Brazil,BRA,0,0,5,13,18
2008,Lebanon,LBN,Brazil,BRA,0,0,10,5,15
2008,Nigeria,NGA,Brazil,BRA,0,0,15,0,15
2008,Peru,PER,Brazil,BRA,0,0,0,5,5
2008,Senegal,SEN,Brazil,BRA,0,0,5,0,5
2008,Sierra Leone,SLE,Brazil,BRA,0,0,5,0,5
2008,Somalia,SOM,Brazil,BRA,0,0,5,39,44
2008,Sudan,SDN,Brazil,BRA,0,0,0,5,5
2008,Ukraine,UKR,Brazil,BRA,0,0,5,0,5
2008,Afghanistan,AFG,Bulgaria,BGR,5,17,25,11,58
2008,Albania,ALB,Bulgaria,BGR,0,0,5,0,5
2008,Algeria,DZA,Bulgaria,BGR,0,0,5,0,5
2008,Egypt,EGY,Bulgaria,BGR,0,0,10,0,10
2008,Armenia,ARM,Bulgaria,BGR,0,5,67,0,72
2008,Bangladesh,BGD,Bulgaria,BGR,0,0,0,5,5
2008,China,CHN,Bulgaria,BGR,0,0,10,0,10
2008,Congo,COG,Bulgaria,BGR,0,0,5,0,5
2008,Cuba,CUB,Bulgaria,BGR,0,0,5,0,5
2008,Georgia,GEO,Bulgaria,BGR,0,0,5,0,5
2008,Iran (Islamic Rep. of),IRN,Bulgaria,BGR,5,0,14,0,19
2008,Iraq,IRQ,Bulgaria,BGR,11,219,128,31,389
2008,Lebanon,LBN,Bulgaria,BGR,0,0,0,5,5
2008,Sri Lanka,LKA,Bulgaria,BGR,0,0,5,5,10
2008,North Macedonia,MKD,Bulgaria,BGR,0,0,5,0,5
2008,Nigeria,NGA,Bulgaria,BGR,0,0,19,0,19
2008,Russian Federation,RUS,Bulgaria,BGR,0,0,5,0,5
2008,Somalia,SOM,Bulgaria,BGR,0,5,5,0,10
2008,Viet Nam,VNM,Bulgaria,BGR,0,0,5,0,5
2008,Sudan,SDN,Bulgaria,BGR,0,5,0,0,5
2008,Syrian Arab Rep.,SYR,Bulgaria,BGR,0,0,16,0,16
2008,United Rep. of Tanzania,TZA,Bulgaria,BGR,0,0,5,0,5
2008,Turkey,TUR,Bulgaria,BGR,0,0,5,0,5
2008,Stateless,XXA,Bulgaria,BGR,5,5,35,5,50
2008,Afghanistan,AFG,Canada,CAN,230,0,10,40,280
2008,Albania,ALB,Canada,CAN,25,0,52,5,82
2008,Algeria,DZA,Canada,CAN,16,0,32,10,58
2008,Angola,AGO,Canada,CAN,14,0,0,0,14
2008,Egypt,EGY,Canada,CAN,14,0,12,5,31
2008,Argentina,ARG,Canada,CAN,5,0,11,0,16
2008,Armenia,ARM,Canada,CAN,5,0,10,5,20
2008,Austria,AUT,Canada,CAN,0,0,0,5,5
2008,Azerbaijan,AZE,Canada,CAN,10,0,5,5,20
2008,Barbados,BRB,Canada,CAN,5,0,14,0,19
2008,Burundi,BDI,Canada,CAN,225,0,84,0,309
2008,Belgium,BEL,Canada,CAN,0,0,5,0,5
2008,Benin,BEN,Canada,CAN,0,0,5,0,5
2008,Bangladesh,BGD,Canada,CAN,39,0,17,10,66
2008,Bahamas,BHS,Canada,CAN,0,0,5,5,10
2008,Bhutan,BTN,Canada,CAN,5,0,0,0,5
2008,Burkina Faso,BFA,Canada,CAN,5,0,5,0,10
2008,Belarus,BLR,Canada,CAN,15,0,0,10,25
2008,Bolivia (Plurinational State of),BOL,Canada,CAN,13,0,5,0,18
2008,Botswana,BWA,Canada,CAN,12,0,0,0,12
2008,Brazil,BRA,Canada,CAN,10,0,25,16,51
2008,Bosnia and Herzegovina,BIH,Canada,CAN,0,0,0,11,11
2008,Bulgaria,BGR,Canada,CAN,5,0,0,13,18
2008,Belize,BLZ,Canada,CAN,0,0,5,0,5
2008,Cambodia,KHM,Canada,CAN,5,0,11,0,16
2008,Central African Rep.,CAF,Canada,CAN,5,0,0,0,5
2008,Chad,TCD,Canada,CAN,41,0,25,0,66
2008,China,CHN,Canada,CAN,598,0,284,98,980
2008,Chile,CHL,Canada,CAN,12,0,10,5,27
2008,Cameroon,CMR,Canada,CAN,42,0,21,5,68
2008,Congo,COG,Canada,CAN,16,0,5,0,21
2008,Dem. Rep. of the Congo,COD,Canada,CAN,144,0,63,21,228
2008,Colombia,COL,Canada,CAN,1217,0,198,125,1540
2008,Costa Rica,CRI,Canada,CAN,0,0,10,5,15
2008,Cuba,CUB,Canada,CAN,93,0,22,25,140
2008,Czechia,CZE,Canada,CAN,84,0,5,106,195
2008,Djibouti,DJI,Canada,CAN,15,0,0,0,15
2008,Dominican Rep.,DOM,Canada,CAN,5,0,20,10,35
2008,Ecuador,ECU,Canada,CAN,10,0,11,10,31
2008,Eritrea,ERI,Canada,CAN,59,0,0,12,71
2008,Ethiopia,ETH,Canada,CAN,59,0,16,5,80
2008,Fiji,FJI,Canada,CAN,11,0,5,0,16
2008,France,FRA,Canada,CAN,0,0,5,12,17
2008,Gambia,GMB,Canada,CAN,5,0,0,0,5
2008,Palestinian,PSE,Canada,CAN,17,0,0,5,22
2008,United Kingdom of Great Britain and Northern Ireland,GBR,Canada,CAN,0,0,0,5,5
2008,Georgia,GEO,Canada,CAN,25,0,5,0,30
2008,Germany,DEU,Canada,CAN,0,0,0,14,14
2008,Ghana,GHA,Canada,CAN,5,0,13,11,29
2008,Grenada,GRD,Canada,CAN,13,0,16,5,34
2008,Guatemala,GTM,Canada,CAN,74,0,34,17,125
2008,Guinea,GIN,Canada,CAN,35,0,10,5,50
2008,Guyana,GUY,Canada,CAN,24,0,56,14,94
2008,Haiti,HTI,Canada,CAN,311,0,351,93,755
2008,"China, Hong Kong SAR",HKG,Canada,CAN,0,0,0,5,5
2008,Honduras,HND,Canada,CAN,31,0,52,48,131
2008,Croatia,HRV,Canada,CAN,0,0,0,5,5
2008,Hungary,HUN,Canada,CAN,22,0,13,47,82
2008,Cote d'Ivoire,CIV,Canada,CAN,20,0,5,5,30
2008,India,IND,Canada,CAN,102,0,179,132,413
2008,Indonesia,IDN,Canada,CAN,5,0,34,14,53
2008,Iran (Islamic Rep. of),IRN,Canada,CAN,108,0,10,20,138
2008,Iraq,IRQ,Canada,CAN,147,0,5,24,176
2008,Israel,ISR,Canada,CAN,12,0,124,73,209
2008,Italy,ITA,Canada,CAN,0,0,0,5,5
2008,Jamaica,JAM,Canada,CAN,32,0,22,24,78
2008,Jordan,JOR,Canada,CAN,11,0,10,32,53
2008,Kazakhstan,KAZ,Canada,CAN,5,0,12,0,17
2008,Kenya,KEN,Canada,CAN,42,0,21,5,68
2008,Kyrgyzstan,KGZ,Canada,CAN,0,0,5,0,5
2008,Rep. of Korea,KOR,Canada,CAN,5,0,59,44,108
2008,Dem. People's Rep. of Korea,PRK,Canada,CAN,10,0,0,20,30
2008,Kuwait,KWT,Canada,CAN,5,0,0,0,5
2008,Liberia,LBR,Canada,CAN,11,0,0,5,16
2008,Libya,LBY,Canada,CAN,16,0,5,0,21
2008,Saint Lucia,LCA,Canada,CAN,29,0,50,16,95
2008,Lebanon,LBN,Canada,CAN,74,0,76,43,193
2008,Sri Lanka,LKA,Canada,CAN,988,0,27,41,1056
2008,Lithuania,LTU,Canada,CAN,0,0,0,5,5
2008,Mauritania,MRT,Canada,CAN,12,0,5,0,17
2008,North Macedonia,MKD,Canada,CAN,5,0,0,5,10
2008,Rep. of Moldova,MDA,Canada,CAN,11,0,0,0,11
2008,Mexico,MEX,Canada,CAN,606,0,3368,1680,5654
2008,Mali,MLI,Canada,CAN,11,0,0,0,11
2008,Malaysia,MYS,Canada,CAN,0,0,13,5,18
2008,Mongolia,MNG,Canada,CAN,5,0,0,0,5
2008,Morocco,MAR,Canada,CAN,15,0,5,14,34
2008,Myanmar,MMR,Canada,CAN,10,0,0,0,10
2008,Namibia,NAM,Canada,CAN,0,0,5,0,5
2008,Nepal,NPL,Canada,CAN,49,0,0,10,59
2008,Netherlands,NLD,Canada,CAN,0,0,5,5,10
2008,Niger,NER,Canada,CAN,0,0,5,0,5
2008,Nicaragua,NIC,Canada,CAN,5,0,13,5,23
2008,Nigeria,NGA,Canada,CAN,210,0,128,46,384
2008,Pakistan,PAK,Canada,CAN,161,0,114,48,323
2008,Panama,PAN,Canada,CAN,0,0,5,0,5
2008,Paraguay,PRY,Canada,CAN,11,0,0,0,11
2008,Peru,PER,Canada,CAN,41,0,36,17,94
2008,Philippines,PHL,Canada,CAN,11,0,46,14,71
2008,Poland,POL,Canada,CAN,13,0,5,5,23
2008,Portugal,PRT,Canada,CAN,0,0,18,10,28
2008,Romania,ROU,Canada,CAN,19,0,10,32,61
2008,South Africa,ZAF,Canada,CAN,0,0,12,0,12
2008,Russian Federation,RUS,Canada,CAN,61,0,29,26,116
2008,Rwanda,RWA,Canada,CAN,150,0,35,5,190
2008,El Salvador,SLV,Canada,CAN,95,0,71,18,184
2008,Saudi Arabia,SAU,Canada,CAN,0,0,0,12,12
2008,Serbia and Kosovo: S/RES/1244 (1999),SRB,Canada,CAN,5,0,11,19,35
2008,Senegal,SEN,Canada,CAN,11,0,0,0,11
2008,Singapore,SGP,Canada,CAN,0,0,0,5,5
2008,Solomon Islands,SLB,Canada,CAN,22,0,0,0,22
2008,Somalia,SOM,Canada,CAN,146,0,10,44,200
2008,Viet Nam,VNM,Canada,CAN,0,0,12,0,12
2008,Saint Kitts and Nevis,KNA,Canada,CAN,5,0,0,0,5
2008,Sudan,SDN,Canada,CAN,13,0,5,5,23
2008,Suriname,SUR,Canada,CAN,5,0,0,0,5
2008,Slovakia,SVK,Canada,CAN,0,0,0,23,23
2008,Sweden,SWE,Canada,CAN,0,0,0,5,5
2008,Syrian Arab Rep.,SYR,Canada,CAN,15,0,5,5,25
2008,United Rep. of Tanzania,TZA,Canada,CAN,5,0,5,0,10
2008,Thailand,THA,Canada,CAN,5,0,36,53,94
2008,Togo,TGO,Canada,CAN,5,0,0,0,5
2008,Trinidad and Tobago,TTO,Canada,CAN,27,0,23,12,62
2008,Tunisia,TUN,Canada,CAN,12,0,10,5,27
2008,Turkey,TUR,Canada,CAN,82,0,32,22,136
2008,Uganda,UGA,Canada,CAN,68,0,25,0,93
2008,Ukraine,UKR,Canada,CAN,58,0,32,28,118
2008,Uruguay,URY,Canada,CAN,0,0,0,5,5
2008,United States of America,USA,Canada,CAN,5,0,205,114,324
2008,Uzbekistan,UZB,Canada,CAN,17,0,5,5,27
2008,Saint Vincent and the Grenadines,VCT,Canada,CAN,93,0,117,48,258
2008,Venezuela (Bolivarian Republic of),VEN,Canada,CAN,30,0,10,14,54
2008,Yemen,YEM,Canada,CAN,14,0,0,0,14
2008,Zambia,ZMB,Canada,CAN,5,0,5,0,10
2008,Zimbabwe,ZWE,Canada,CAN,188,0,60,14,262
2008,Angola,AGO,Central African Rep.,CAF,5,0,0,12,17
2008,Chad,TCD,Central African Rep.,CAF,90,0,0,295,385
2008,Cameroon,CMR,Central African Rep.,CAF,0,0,0,5,5
2008,Congo,COG,Central African Rep.,CAF,5,0,0,52,57
2008,Dem. Rep. of the Congo,COD,Central African Rep.,CAF,239,0,0,0,239
2008,Guinea-Bissau,GNB,Central African Rep.,CAF,0,0,0,5,5
2008,Cote d'Ivoire,CIV,Central African Rep.,CAF,5,0,0,5,10
2008,Liberia,LBR,Central African Rep.,CAF,0,0,0,29,29
2008,Nigeria,NGA,Central African Rep.,CAF,5,0,0,0,5
2008,Rwanda,RWA,Central African Rep.,CAF,70,0,0,0,70
2008,Sudan,SDN,Central African Rep.,CAF,18,0,0,551,569
2008,Colombia,COL,Chile,CHL,114,0,348,5,467
2008,Ecuador,ECU,Chile,CHL,0,0,10,0,10
2008,Ghana,GHA,Chile,CHL,5,0,0,0,5
2008,Haiti,HTI,Chile,CHL,0,0,5,0,5
2008,Peru,PER,Chile,CHL,5,0,5,0,10
2008,Cuba,CUB,Colombia,COL,0,0,66,0,66
2008,Ecuador,ECU,Colombia,COL,0,0,5,0,5
2008,Somalia,SOM,Colombia,COL,0,0,18,0,18
2008,Venezuela (Bolivarian Republic of),VEN,Colombia,COL,5,0,0,0,5
2008,Afghanistan,AFG,Cyprus,CYP,0,0,5,5,10
2008,Egypt,EGY,Cyprus,CYP,0,0,116,100,216
2008,Armenia,ARM,Cyprus,CYP,0,0,0,14,14
2008,Bangladesh,BGD,Cyprus,CYP,0,0,332,222,554
2008,Belarus,BLR,Cyprus,CYP,0,0,0,5,5
2008,China,CHN,Cyprus,CYP,0,0,94,112,206
2008,Cameroon,CMR,Cyprus,CYP,0,0,100,34,134
2008,Dem. Rep. of the Congo,COD,Cyprus,CYP,0,0,5,5,10
2008,Ethiopia,ETH,Cyprus,CYP,0,0,5,5,10
2008,Palestinian,PSE,Cyprus,CYP,11,17,11,220,259
2008,Georgia,GEO,Cyprus,CYP,0,10,197,300,507
2008,Ghana,GHA,Cyprus,CYP,0,0,21,10,31
2008,Cote d'Ivoire,CIV,Cyprus,CYP,0,0,0,5,5
2008,India,IND,Cyprus,CYP,0,0,266,253,519
2008,Iran (Islamic Rep. of),IRN,Cyprus,CYP,10,0,113,104,227
2008,Iraq,IRQ,Cyprus,CYP,25,126,0,39,190
2008,Jordan,JOR,Cyprus,CYP,0,0,23,77,100
2008,Kenya,KEN,Cyprus,CYP,0,0,0,5,5
2008,Kyrgyzstan,KGZ,Cyprus,CYP,0,0,5,0,5
2008,Lebanon,LBN,Cyprus,CYP,0,0,16,61,77
2008,Sri Lanka,LKA,Cyprus,CYP,0,0,610,381,991
2008,North Macedonia,MKD,Cyprus,CYP,0,0,5,5,10
2008,Rep. of Moldova,MDA,Cyprus,CYP,0,0,21,22,43
2008,Morocco,MAR,Cyprus,CYP,0,0,0,12,12
2008,Nepal,NPL,Cyprus,CYP,0,0,103,61,164
2008,Nigeria,NGA,Cyprus,CYP,0,0,207,60,267
2008,Pakistan,PAK,Cyprus,CYP,0,0,350,193,543
2008,Philippines,PHL,Cyprus,CYP,0,0,75,26,101
2008,Russian Federation,RUS,Cyprus,CYP,0,0,82,129,211
2008,Somalia,SOM,Cyprus,CYP,0,0,5,0,5
2008,Viet Nam,VNM,Cyprus,CYP,0,0,59,49,108
2008,Sudan,SDN,Cyprus,CYP,0,0,0,5,5
2008,Syrian Arab Rep.,SYR,Cyprus,CYP,0,0,1042,1006,2048
2008,Turkey,TUR,Cyprus,CYP,20,0,57,21,98
2008,Ukraine,UKR,Cyprus,CYP,0,0,23,102,125
2008,Uzbekistan,UZB,Cyprus,CYP,0,0,36,42,78
2008,Afghanistan,AFG,Czechia,CZE,0,0,5,24,29
2008,Algeria,DZA,Czechia,CZE,0,0,5,12,17
2008,Angola,AGO,Czechia,CZE,0,0,5,0,5
2008,Armenia,ARM,Czechia,CZE,5,0,17,5,27
2008,Bangladesh,BGD,Czechia,CZE,0,0,5,0,5
2008,Belarus,BLR,Czechia,CZE,19,13,64,38,134
2008,China,CHN,Czechia,CZE,0,0,18,19,37
2008,Cameroon,CMR,Czechia,CZE,5,0,5,0,10
2008,Congo,COG,Czechia,CZE,0,0,5,0,5
2008,Dem. Rep. of the Congo,COD,Czechia,CZE,0,0,17,5,22
2008,Cuba,CUB,Czechia,CZE,5,60,0,16,81
2008,Georgia,GEO,Czechia,CZE,0,0,28,11,39
2008,Ghana,GHA,Czechia,CZE,0,0,0,5,5
2008,Guinea,GIN,Czechia,CZE,0,0,0,5,5
2008,India,IND,Czechia,CZE,0,0,5,5,10
2008,Iran (Islamic Rep. of),IRN,Czechia,CZE,5,0,0,0,5
2008,Iraq,IRQ,Czechia,CZE,10,21,0,10,41
2008,Kazakhstan,KAZ,Czechia,CZE,14,0,66,38,118
2008,Kyrgyzstan,KGZ,Czechia,CZE,0,0,22,22,44
2008,Libya,LBY,Czechia,CZE,5,0,0,0,5
2008,Sri Lanka,LKA,Czechia,CZE,0,0,12,0,12
2008,Rep. of Moldova,MDA,Czechia,CZE,10,0,13,5,28
2008,Mongolia,MNG,Czechia,CZE,0,0,123,72,195
2008,Morocco,MAR,Czechia,CZE,0,0,5,0,5
2008,Myanmar,MMR,Czechia,CZE,26,0,0,0,26
2008,Nepal,NPL,Czechia,CZE,0,0,0,5,5
2008,Nigeria,NGA,Czechia,CZE,0,0,44,10,54
2008,Pakistan,PAK,Czechia,CZE,5,0,5,5,15
2008,Russian Federation,RUS,Czechia,CZE,18,5,33,45,101
2008,Serbia and Kosovo: S/RES/1244 (1999),SRB,Czechia,CZE,0,0,19,11,30
2008,Somalia,SOM,Czechia,CZE,0,10,0,0,10
2008,Viet Nam,VNM,Czechia,CZE,0,0,64,40,104
2008,Sudan,SDN,Czechia,CZE,0,0,5,0,5
2008,Syrian Arab Rep.,SYR,Czechia,CZE,5,0,5,5,15
2008,Turkey,TUR,Czechia,CZE,0,0,222,89,311
2008,Ukraine,UKR,Czechia,CZE,17,5,189,153,364
2008,Uzbekistan,UZB,Czechia,CZE,0,0,11,10,21
2008,Stateless,XXA,Czechia,CZE,11,17,15,11,54
2008,Afghanistan,AFG,Denmark,DNK,5,51,56,0,112
2008,Albania,ALB,Denmark,DNK,0,0,5,0,5
2008,Azerbaijan,AZE,Denmark,DNK,5,0,14,0,19
2008,Burundi,BDI,Denmark,DNK,0,0,5,0,5
2008,Bangladesh,BGD,Denmark,DNK,0,0,5,0,5
2008,Bosnia and Herzegovina,BIH,Denmark,DNK,0,0,29,0,29
2008,China,CHN,Denmark,DNK,0,0,15,0,15
2008,Dem. Rep. of the Congo,COD,Denmark,DNK,5,0,0,0,5
2008,Eritrea,ERI,Denmark,DNK,0,5,0,0,5
2008,Ethiopia,ETH,Denmark,DNK,5,0,0,0,5
2008,Palestinian,PSE,Denmark,DNK,5,0,22,0,27
2008,Croatia,HRV,Denmark,DNK,0,0,5,0,5
2008,Cote d'Ivoire,CIV,Denmark,DNK,0,0,5,0,5
2008,India,IND,Denmark,DNK,0,0,5,0,5
2008,Iran (Islamic Rep. of),IRN,Denmark,DNK,62,13,24,0,99
2008,Iraq,IRQ,Denmark,DNK,15,125,95,0,235
2008,Sri Lanka,LKA,Denmark,DNK,5,0,20,0,25
2008,North Macedonia,MKD,Denmark,DNK,0,0,5,0,5
2008,Morocco,MAR,Denmark,DNK,0,0,5,0,5
2008,Myanmar,MMR,Denmark,DNK,11,0,5,0,16
2008,Nigeria,NGA,Denmark,DNK,0,0,18,0,18
2008,Russian Federation,RUS,Denmark,DNK,12,95,31,0,138
2008,Rwanda,RWA,Denmark,DNK,5,0,0,0,5
2008,Serbia and Kosovo: S/RES/1244 (1999),SRB,Denmark,DNK,0,0,61,0,61
2008,Somalia,SOM,Denmark,DNK,0,0,11,0,11
2008,Sudan,SDN,Denmark,DNK,5,0,0,0,5
2008,Syrian Arab Rep.,SYR,Denmark,DNK,44,13,5,0,62
2008,Tunisia,TUN,Denmark,DNK,0,0,5,0,5
2008,Turkey,TUR,Denmark,DNK,0,0,15,0,15
2008,Uganda,UGA,Denmark,DNK,0,0,5,0,5
2008,Zimbabwe,ZWE,Denmark,DNK,5,0,0,0,5
2008,Stateless,XXA,Denmark,DNK,10,0,0,0,10
2008,Belarus,BLR,Estonia,EST,5,0,0,0,5
2008,Afghanistan,AFG,Finland,FIN,0,71,5,16,92
2008,Albania,ALB,Finland,FIN,0,0,0,10,10
2008,Algeria,DZA,Finland,FIN,0,5,0,26,31
2008,Angola,AGO,Finland,FIN,0,28,5,0,33
2008,Egypt,EGY,Finland,FIN,0,0,5,0,5
2008,Armenia,ARM,Finland,FIN,0,0,0,13,13
2008,Azerbaijan,AZE,Finland,FIN,0,0,0,5,5
2008,Bangladesh,BGD,Finland,FIN,0,0,0,13,13
2008,Belarus,BLR,Finland,FIN,0,0,14,39,53
2008,Bosnia and Herzegovina,BIH,Finland,FIN,0,0,0,5,5
2008,Bulgaria,BGR,Finland,FIN,0,0,5,74,79
2008,China,CHN,Finland,FIN,0,5,0,0,5
2008,Cameroon,CMR,Finland,FIN,0,0,12,0,12
2008,Dem. Rep. of the Congo,COD,Finland,FIN,5,24,5,5,39
2008,Ethiopia,ETH,Finland,FIN,0,5,12,0,17
2008,Gambia,GMB,Finland,FIN,0,0,0,5,5
2008,Georgia,GEO,Finland,FIN,0,0,0,10,10
2008,Ghana,GHA,Finland,FIN,0,0,0,12,12
2008,Guinea,GIN,Finland,FIN,0,0,5,0,5
2008,Honduras,HND,Finland,FIN,0,0,5,0,5
2008,Croatia,HRV,Finland,FIN,0,13,0,0,13
2008,Cote d'Ivoire,CIV,Finland,FIN,0,5,0,0,5
2008,India,IND,Finland,FIN,0,0,0,13,13
2008,Iran (Islamic Rep. of),IRN,Finland,FIN,5,34,11,24,74
2008,Iraq,IRQ,Finland,FIN,42,227,0,228,497
2008,Israel,ISR,Finland,FIN,0,0,0,5,5
2008,Libya,LBY,Finland,FIN,0,0,0,5,5
2008,Lebanon,LBN,Finland,FIN,0,0,0,5,5
2008,Sri Lanka,LKA,Finland,FIN,0,40,5,0,45
2008,Rep. of Moldova,MDA,Finland,FIN,0,0,0,5,5
2008,Morocco,MAR,Finland,FIN,0,0,0,10,10
2008,Nigeria,NGA,Finland,FIN,0,10,14,30,54
2008,Pakistan,PAK,Finland,FIN,0,5,0,0,5
2008,Poland,POL,Finland,FIN,0,0,0,5,5
2008,Romania,ROU,Finland,FIN,0,0,0,17,17
2008,Russian Federation,RUS,Finland,FIN,40,5,45,86,176
2008,Serbia and Kosovo: S/RES/1244 (1999),SRB,Finland,FIN,0,24,25,59,108
2008,Senegal,SEN,Finland,FIN,0,5,0,0,5
2008,Somalia,SOM,Finland,FIN,0,149,5,169,323
2008,Slovakia,SVK,Finland,FIN,0,0,0,5,5
2008,Syrian Arab Rep.,SYR,Finland,FIN,0,0,0,13,13
2008,Togo,TGO,Finland,FIN,0,0,0,5,5
2008,Turkey,TUR,Finland,FIN,0,13,32,32,77
2008,Ukraine,UKR,Finland,FIN,0,0,5,5,10
2008,Zimbabwe,ZWE,Finland,FIN,0,0,5,0,5
2008,Stateless,XXA,Finland,FIN,0,0,0,13,13
2008,Afghanistan,AFG,France,FRA,90,14,146,0,250
2008,Albania,ALB,France,FRA,51,36,185,0,272
2008,Algeria,DZA,France,FRA,83,63,806,0,952
2008,Angola,AGO,France,FRA,138,11,327,0,476
2008,Egypt,EGY,France,FRA,10,0,25,0,35
2008,Armenia,ARM,France,FRA,450,85,1923,0,2458
2008,Azerbaijan,AZE,France,FRA,328,0,473,0,801
2008,Burundi,BDI,France,FRA,14,0,19,0,33
2008,Bangladesh,BGD,France,FRA,303,5,1626,0,1934
2008,Bhutan,BTN,France,FRA,10,0,12,0,22
2008,Burkina Faso,BFA,France,FRA,0,5,14,0,19
2008,Belarus,BLR,France,FRA,36,0,84,0,120
2008,Brazil,BRA,France,FRA,0,0,16,0,16
2008,Bosnia and Herzegovina,BIH,France,FRA,94,5,146,0,245
2008,Cambodia,KHM,France,FRA,12,0,23,0,35
2008,Central African Rep.,CAF,France,FRA,45,5,97,0,147
2008,Chad,TCD,France,FRA,77,0,121,0,198
2008,China,CHN,France,FRA,102,5,506,0,613
2008,Cameroon,CMR,France,FRA,48,11,158,0,217
2008,Congo,COG,France,FRA,183,22,715,0,920
2008,Dem. Rep. of the Congo,COD,France,FRA,744,54,1668,0,2466
2008,Comoros,COM,France,FRA,61,0,408,0,469
2008,Colombia,COL,France,FRA,24,15,53,0,92
2008,Cuba,CUB,France,FRA,5,0,15,0,20
2008,Djibouti,DJI,France,FRA,10,0,5,0,15
2008,Dominican Rep.,DOM,France,FRA,0,0,18,0,18
2008,Eritrea,ERI,France,FRA,62,0,24,0,86
2008,Ethiopia,ETH,France,FRA,29,0,31,0,60
2008,Gambia,GMB,France,FRA,5,12,56,0,73
2008,Palestinian,PSE,France,FRA,18,0,35,0,53
2008,Georgia,GEO,France,FRA,114,18,327,0,459
2008,Ghana,GHA,France,FRA,0,5,22,0,27
2008,Guinea-Bissau,GNB,France,FRA,5,5,55,0,65
2008,Guinea,GIN,France,FRA,451,79,933,0,1463
2008,Haiti,HTI,France,FRA,138,58,1000,0,1196
2008,Cote d'Ivoire,CIV,France,FRA,149,34,512,0,695
2008,India,IND,France,FRA,5,0,85,0,90
2008,Iran (Islamic Rep. of),IRN,France,FRA,73,0,88,0,161
2008,Iraq,IRQ,France,FRA,262,39,61,0,362
2008,Kazakhstan,KAZ,France,FRA,18,5,38,0,61
2008,Kyrgyzstan,KGZ,France,FRA,16,5,22,0,43
2008,Liberia,LBR,France,FRA,10,0,14,0,24
2008,Sri Lanka,LKA,France,FRA,1209,498,2666,0,4373
2008,Madagascar,MDG,France,FRA,10,0,11,0,21
2008,Mauritania,MRT,France,FRA,177,23,927,0,1127
2008,North Macedonia,MKD,France,FRA,16,0,76,0,92
2008,Rep. of Moldova,MDA,France,FRA,10,11,174,0,195
2008,Mali,MLI,France,FRA,662,327,1108,0,2097
2008,Mongolia,MNG,France,FRA,5,13,67,0,85
2008,Morocco,MAR,France,FRA,5,5,42,0,52
2008,Montenegro,MNE,France,FRA,10,5,73,0,88
2008,Myanmar,MMR,France,FRA,20,0,22,0,42
2008,Nepal,NPL,France,FRA,5,0,35,0,40
2008,Nigeria,NGA,France,FRA,50,30,388,0,468
2008,Pakistan,PAK,France,FRA,45,5,348,0,398
2008,South Africa,ZAF,France,FRA,0,0,5,0,5
2008,Russian Federation,RUS,France,FRA,1163,76,2074,0,3313
2008,Rwanda,RWA,France,FRA,183,0,108,0,291
2008,Serbia and Kosovo: S/RES/1244 (1999),SRB,France,FRA,590,94,1889,0,2573
2008,Senegal,SEN,France,FRA,32,34,171,0,237
2008,Sierra Leone,SLE,France,FRA,22,10,129,0,161
2008,Somalia,SOM,France,FRA,40,5,24,0,69
2008,Viet Nam,VNM,France,FRA,5,0,19,0,24
2008,Sudan,SDN,France,FRA,185,10,218,0,413
2008,Syrian Arab Rep.,SYR,France,FRA,20,0,24,0,44
2008,Togo,TGO,France,FRA,50,0,120,0,170
2008,Tunisia,TUN,France,FRA,10,0,23,0,33
2008,Turkey,TUR,France,FRA,683,21,2455,0,3159
2008,Uganda,UGA,France,FRA,11,0,0,0,11
2008,Ukraine,UKR,France,FRA,14,5,65,0,84
2008,Uzbekistan,UZB,France,FRA,10,0,13,0,23
2008,Stateless,XXA,France,FRA,65,0,152,0,217
2008,Afghanistan,AFG,United Kingdom of Great Britain and Northern Ireland,GBR,154,892,843,985,2874
2008,Albania,ALB,United Kingdom of Great Britain and Northern Ireland,GBR,0,39,90,34,163
2008,Algeria,DZA,United Kingdom of Great Britain and Northern Ireland,GBR,5,15,151,131,302
2008,Angola,AGO,United Kingdom of Great Britain and Northern Ireland,GBR,10,16,62,19,107
2008,Egypt,EGY,United Kingdom of Great Britain and Northern Ireland,GBR,5,0,32,28,65
2008,Armenia,ARM,United Kingdom of Great Britain and Northern Ireland,GBR,0,0,10,0,10
2008,Azerbaijan,AZE,United Kingdom of Great Britain and Northern Ireland,GBR,5,0,10,5,20
2008,Burundi,BDI,United Kingdom of Great Britain and Northern Ireland,GBR,0,0,12,0,12
2008,Bangladesh,BGD,United Kingdom of Great Britain and Northern Ireland,GBR,5,93,262,137,497
2008,Bhutan,BTN,United Kingdom of Great Britain and Northern Ireland,GBR,15,0,13,0,28
2008,Burkina Faso,BFA,United Kingdom of Great Britain and Northern Ireland,GBR,0,0,5,0,5
2008,Belarus,BLR,United Kingdom of Great Britain and Northern Ireland,GBR,35,0,18,10,63
2008,Bolivia (Plurinational State of),BOL,United Kingdom of Great Britain and Northern Ireland,GBR,0,0,28,13,41
2008,Botswana,BWA,United Kingdom of Great Britain and Northern Ireland,GBR,0,5,5,0,10
2008,Brazil,BRA,United Kingdom of Great Britain and Northern Ireland,GBR,0,0,17,18,35
2008,Bosnia and Herzegovina,BIH,United Kingdom of Great Britain and Northern Ireland,GBR,5,5,5,0,15
2008,Canada,CAN,United Kingdom of Great Britain and Northern Ireland,GBR,0,0,0,5,5
2008,Chad,TCD,United Kingdom of Great Britain and Northern Ireland,GBR,14,0,0,0,14
2008,China,CHN,United Kingdom of Great Britain and Northern Ireland,GBR,74,59,589,672,1394
2008,Cameroon,CMR,United Kingdom of Great Britain and Northern Ireland,GBR,15,5,103,10,133
2008,Congo,COG,United Kingdom of Great Britain and Northern Ireland,GBR,0,0,23,5,28
2008,Dem. Rep. of the Congo,COD,United Kingdom of Great Britain and Northern Ireland,GBR,72,28,200,28,328
2008,Colombia,COL,United Kingdom of Great Britain and Northern Ireland,GBR,5,5,14,5,29
2008,Cuba,CUB,United Kingdom of Great Britain and Northern Ireland,GBR,0,0,10,0,10
2008,Cyprus,CYP,United Kingdom of Great Britain and Northern Ireland,GBR,0,0,0,5,5
2008,Czechia,CZE,United Kingdom of Great Britain and Northern Ireland,GBR,0,0,0,16,16
2008,Ecuador,ECU,United Kingdom of Great Britain and Northern Ireland,GBR,0,0,11,10,21
2008,Eritrea,ERI,United Kingdom of Great Britain and Northern Ireland,GBR,1212,65,313,544,2134
2008,Ethiopia,ETH,United Kingdom of Great Britain and Northern Ireland,GBR,19,5,64,16,104
2008,Gambia,GMB,United Kingdom of Great Britain and Northern Ireland,GBR,29,11,93,13,146
2008,Palestinian,PSE,United Kingdom of Great Britain and Northern Ireland,GBR,17,17,116,133,283
2008,Georgia,GEO,United Kingdom of Great Britain and Northern Ireland,GBR,0,0,53,20,73
2008,Ghana,GHA,United Kingdom of Great Britain and Northern Ireland,GBR,0,0,114,39,153
2008,Guinea-Bissau,GNB,United Kingdom of Great Britain and Northern Ireland,GBR,0,0,5,0,5
2008,Guinea,GIN,United Kingdom of Great Britain and Northern Ireland,GBR,19,11,43,5,78
2008,Guyana,GUY,United Kingdom of Great Britain and Northern Ireland,GBR,0,0,16,0,16
2008,Croatia,HRV,United Kingdom of Great Britain and Northern Ireland,GBR,0,0,5,0,5
2008,Cote d'Ivoire,CIV,United Kingdom of Great Britain and Northern Ireland,GBR,0,5,67,11,83
2008,India,IND,United Kingdom of Great Britain and Northern Ireland,GBR,5,14,272,408,699
2008,Ireland,IRL,United Kingdom of Great Britain and Northern Ireland,GBR,0,0,5,0,5
2008,Iran (Islamic Rep. of),IRN,United Kingdom of Great Britain and Northern Ireland,GBR,290,222,1360,312,2184
2008,Iraq,IRQ,United Kingdom of Great Britain and Northern Ireland,GBR,249,220,1006,285,1760
2008,Israel,ISR,United Kingdom of Great Britain and Northern Ireland,GBR,0,5,10,5,20
2008,Jamaica,JAM,United Kingdom of Great Britain and Northern Ireland,GBR,10,0,183,56,249
2008,Jordan,JOR,United Kingdom of Great Britain and Northern Ireland,GBR,0,0,18,5,23
2008,Kenya,KEN,United Kingdom of Great Britain and Northern Ireland,GBR,5,10,128,23,166
2008,Rep. of Korea,KOR,United Kingdom of Great Britain and Northern Ireland,GBR,0,0,11,5,16
2008,Dem. People's Rep. of Korea,PRK,United Kingdom of Great Britain and Northern Ireland,GBR,279,10,77,68,434
2008,Kuwait,KWT,United Kingdom of Great Britain and Northern Ireland,GBR,97,5,77,16,195
2008,Liberia,LBR,United Kingdom of Great Britain and Northern Ireland,GBR,0,5,11,10,26
2008,Libya,LBY,United Kingdom of Great Britain and Northern Ireland,GBR,10,0,42,10,62
2008,Saint Lucia,LCA,United Kingdom of Great Britain and Northern Ireland,GBR,0,0,5,0,5
2008,Lebanon,LBN,United Kingdom of Great Britain and Northern Ireland,GBR,5,5,50,10,70
2008,Sri Lanka,LKA,United Kingdom of Great Britain and Northern Ireland,GBR,166,65,803,129,1163
2008,North Macedonia,MKD,United Kingdom of Great Britain and Northern Ireland,GBR,0,0,10,20,30
2008,Rep. of Moldova,MDA,United Kingdom of Great Britain and Northern Ireland,GBR,0,0,15,11,26
2008,Mali,MLI,United Kingdom of Great Britain and Northern Ireland,GBR,12,0,0,0,12
2008,Malaysia,MYS,United Kingdom of Great Britain and Northern Ireland,GBR,0,0,21,12,33
2008,Malawi,MWI,United Kingdom of Great Britain and Northern Ireland,GBR,5,0,95,26,126
2008,Mongolia,MNG,United Kingdom of Great Britain and Northern Ireland,GBR,5,0,24,5,34
2008,Morocco,MAR,United Kingdom of Great Britain and Northern Ireland,GBR,5,0,16,10,31
2008,Mozambique,MOZ,United Kingdom of Great Britain and Northern Ireland,GBR,0,0,5,0,5
2008,Mauritius,MUS,United Kingdom of Great Britain and Northern Ireland,GBR,0,0,27,5,32
2008,Myanmar,MMR,United Kingdom of Great Britain and Northern Ireland,GBR,120,21,57,5,203
2008,Namibia,NAM,United Kingdom of Great Britain and Northern Ireland,GBR,0,0,5,0,5
2008,Nepal,NPL,United Kingdom of Great Britain and Northern Ireland,GBR,0,0,23,5,28
2008,Niger,NER,United Kingdom of Great Britain and Northern Ireland,GBR,0,0,0,5,5
2008,Nicaragua,NIC,United Kingdom of Great Britain and Northern Ireland,GBR,0,0,5,0,5
2008,Nigeria,NGA,United Kingdom of Great Britain and Northern Ireland,GBR,5,51,702,213,971
2008,Oman,OMN,United Kingdom of Great Britain and Northern Ireland,GBR,0,5,0,0,5
2008,Pakistan,PAK,United Kingdom of Great Britain and Northern Ireland,GBR,144,57,1228,265,1694
2008,Philippines,PHL,United Kingdom of Great Britain and Northern Ireland,GBR,0,0,5,0,5
2008,Poland,POL,United Kingdom of Great Britain and Northern Ireland,GBR,0,0,0,10,10
2008,Romania,ROU,United Kingdom of Great Britain and Northern Ireland,GBR,0,0,0,10,10
2008,South Africa,ZAF,United Kingdom of Great Britain and Northern Ireland,GBR,5,5,102,41,153
2008,Russian Federation,RUS,United Kingdom of Great Britain and Northern Ireland,GBR,27,5,36,20,88
2008,Rwanda,RWA,United Kingdom of Great Britain and Northern Ireland,GBR,0,0,15,5,20
2008,Saudi Arabia,SAU,United Kingdom of Great Britain and Northern Ireland,GBR,0,0,27,5,32
2008,Serbia and Kosovo: S/RES/1244 (1999),SRB,United Kingdom of Great Britain and Northern Ireland,GBR,5,15,43,49,112
2008,Senegal,SEN,United Kingdom of Great Britain and Northern Ireland,GBR,0,0,14,0,14
2008,Sierra Leone,SLE,United Kingdom of Great Britain and Northern Ireland,GBR,5,5,34,16,60
2008,Somalia,SOM,United Kingdom of Great Britain and Northern Ireland,GBR,634,73,542,137,1386
2008,Viet Nam,VNM,United Kingdom of Great Britain and Northern Ireland,GBR,0,13,55,126,194
2008,Sudan,SDN,United Kingdom of Great Britain and Northern Ireland,GBR,51,10,113,77,251
2008,Eswatini,SWZ,United Kingdom of Great Britain and Northern Ireland,GBR,0,0,14,0,14
2008,Syrian Arab Rep.,SYR,United Kingdom of Great Britain and Northern Ireland,GBR,20,10,84,20,134
2008,United Rep. of Tanzania,TZA,United Kingdom of Great Britain and Northern Ireland,GBR,0,0,25,5,30
2008,Thailand,THA,United Kingdom of Great Britain and Northern Ireland,GBR,0,0,0,12,12
2008,Tajikistan,TJK,United Kingdom of Great Britain and Northern Ireland,GBR,0,0,5,0,5
2008,Turkmenistan,TKM,United Kingdom of Great Britain and Northern Ireland,GBR,0,0,13,0,13
2008,Togo,TGO,United Kingdom of Great Britain and Northern Ireland,GBR,0,0,21,0,21
2008,Trinidad and Tobago,TTO,United Kingdom of Great Britain and Northern Ireland,GBR,0,0,12,0,12
2008,Tunisia,TUN,United Kingdom of Great Britain and Northern Ireland,GBR,0,0,14,5,19
2008,Turkey,TUR,United Kingdom of Great Britain and Northern Ireland,GBR,17,12,152,69,250
2008,Uganda,UGA,United Kingdom of Great Britain and Northern Ireland,GBR,11,10,96,22,139
2008,Ukraine,UKR,United Kingdom of Great Britain and Northern Ireland,GBR,0,5,24,14,43
2008,United States of America,USA,United Kingdom of Great Britain and Northern Ireland,GBR,0,0,13,5,18
2008,Uzbekistan,UZB,United Kingdom of Great Britain and Northern Ireland,GBR,5,0,10,5,20
2008,Western Sahara,ESH,United Kingdom of Great Britain and Northern Ireland,GBR,0,0,0,5,5
2008,Yemen,YEM,United Kingdom of Great Britain and Northern Ireland,GBR,15,10,49,0,74
2008,Zambia,ZMB,United Kingdom of Great Britain and Northern Ireland,GBR,0,0,14,5,19
2008,Zimbabwe,ZWE,United Kingdom of Great Britain and Northern Ireland,GBR,796,151,2802,86,3835
2008,Chad,TCD,Ghana,GHA,0,5,10,5,20
2008,Cameroon,CMR,Ghana,GHA,0,5,5,0,10
2008,Congo,COG,Ghana,GHA,0,0,0,5,5
2008,Dem. Rep. of the Congo,COD,Ghana,GHA,11,0,0,0,11
2008,Cote d'Ivoire,CIV,Ghana,GHA,36,0,0,0,36
2008,Nigeria,NGA,Ghana,GHA,0,0,0,11,11
2008,Sudan,SDN,Ghana,GHA,0,0,5,0,5
2008,Togo,TGO,Ghana,GHA,0,0,5,0,5
2008,Cote d'Ivoire,CIV,Guinea-Bissau,GNB,5,0,0,0,5
2008,Liberia,LBR,Guinea-Bissau,GNB,14,0,5,0,19
2008,Sierra Leone,SLE,Guinea-Bissau,GNB,5,0,76,0,81
2008,Afghanistan,AFG,Greece,GRC,5,0,1808,13,1826
2008,Albania,ALB,Greece,GRC,0,0,173,10,183
2008,Algeria,DZA,Greece,GRC,0,0,17,0,17
2008,Egypt,EGY,Greece,GRC,0,0,112,0,112
2008,Armenia,ARM,Greece,GRC,0,0,89,0,89
2008,Azerbaijan,AZE,Greece,GRC,0,0,5,0,5
2008,Bangladesh,BGD,Greece,GRC,0,0,1836,0,1836
2008,Burkina Faso,BFA,Greece,GRC,0,0,133,0,133
2008,Belarus,BLR,Greece,GRC,0,0,10,0,10
2008,China,CHN,Greece,GRC,0,0,59,0,59
2008,Cameroon,CMR,Greece,GRC,0,0,31,0,31
2008,Dem. Rep. of the Congo,COD,Greece,GRC,0,0,10,0,10
2008,Dominican Rep.,DOM,Greece,GRC,0,0,5,0,5
2008,Eritrea,ERI,Greece,GRC,0,0,32,0,32
2008,Ethiopia,ETH,Greece,GRC,0,0,111,0,111
2008,Gambia,GMB,Greece,GRC,0,0,34,0,34
2008,Georgia,GEO,Greece,GRC,0,0,1933,20,1953
2008,Ghana,GHA,Greece,GRC,0,0,83,0,83
2008,Guinea,GIN,Greece,GRC,0,0,142,0,142
2008,Cote d'Ivoire,CIV,Greece,GRC,0,0,51,0,51
2008,India,IND,Greece,GRC,0,0,246,0,246
2008,Indonesia,IDN,Greece,GRC,0,0,31,0,31
2008,Iran (Islamic Rep. of),IRN,Greece,GRC,0,0,274,5,279
2008,Iraq,IRQ,Greece,GRC,5,0,2784,23,2812
2008,Kazakhstan,KAZ,Greece,GRC,0,0,5,0,5
2008,Kenya,KEN,Greece,GRC,0,0,85,0,85
2008,Liberia,LBR,Greece,GRC,0,0,5,0,5
2008,Libya,LBY,Greece,GRC,0,0,5,0,5
2008,Lebanon,LBN,Greece,GRC,0,0,41,0,41
2008,Sri Lanka,LKA,Greece,GRC,0,0,134,5,139
2008,Mauritania,MRT,Greece,GRC,0,0,49,0,49
2008,Rep. of Moldova,MDA,Greece,GRC,0,0,101,5,106
2008,Mali,MLI,Greece,GRC,0,0,5,0,5
2008,Morocco,MAR,Greece,GRC,0,0,16,0,16
2008,Myanmar,MMR,Greece,GRC,0,0,5,0,5
2008,Nepal,NPL,Greece,GRC,0,0,5,0,5
2008,Nigeria,NGA,Greece,GRC,0,0,712,5,717
2008,Pakistan,PAK,Greece,GRC,0,0,8810,5,8815
2008,Philippines,PHL,Greece,GRC,0,0,55,0,55
2008,Russian Federation,RUS,Greece,GRC,0,0,108,0,108
2008,Rwanda,RWA,Greece,GRC,0,0,54,0,54
2008,Serbia and Kosovo: S/RES/1244 (1999),SRB,Greece,GRC,0,0,5,0,5
2008,Senegal,SEN,Greece,GRC,0,0,431,0,431
2008,Sierra Leone,SLE,Greece,GRC,0,0,15,0,15
2008,Somalia,SOM,Greece,GRC,0,0,79,0,79
2008,Sudan,SDN,Greece,GRC,0,0,104,0,104
2008,Syrian Arab Rep.,SYR,Greece,GRC,0,0,1073,0,1073
2008,United Rep. of Tanzania,TZA,Greece,GRC,0,0,23,0,23
2008,Tunisia,TUN,Greece,GRC,0,0,5,0,5
2008,Turkey,TUR,Greece,GRC,0,0,56,0,56
2008,Uganda,UGA,Greece,GRC,0,0,10,0,10
2008,Ukraine,UKR,Greece,GRC,0,0,45,5,50
2008,Uzbekistan,UZB,Greece,GRC,0,0,35,0,35
2008,Mexico,MEX,Guatemala,GTM,0,0,5,0,5
2008,Nicaragua,NIC,Guatemala,GTM,5,0,0,0,5
2008,Colombia,COL,Honduras,HND,5,0,0,5,10
2008,Cuba,CUB,Honduras,HND,0,0,0,17,17
2008,Eritrea,ERI,Honduras,HND,0,0,0,12,12
2008,Ethiopia,ETH,Honduras,HND,0,0,0,10,10
2008,Somalia,SOM,Honduras,HND,0,0,0,12,12
2008,Albania,ALB,Croatia,HRV,0,0,5,0,5
2008,Belarus,BLR,Croatia,HRV,0,0,0,5,5
2008,Bosnia and Herzegovina,BIH,Croatia,HRV,0,0,5,0,5
2008,Iran (Islamic Rep. of),IRN,Croatia,HRV,0,0,14,0,14
2008,Sri Lanka,LKA,Croatia,HRV,0,0,0,10,10
2008,North Macedonia,MKD,Croatia,HRV,0,0,0,5,5
2008,Pakistan,PAK,Croatia,HRV,0,0,11,0,11
2008,Serbia and Kosovo: S/RES/1244 (1999),SRB,Croatia,HRV,0,0,28,50,78
2008,Turkey,TUR,Croatia,HRV,0,0,0,11,11
2008,Afghanistan,AFG,Hungary,HUN,5,53,18,5,81
2008,Albania,ALB,Hungary,HUN,0,0,0,12,12
2008,Algeria,DZA,Hungary,HUN,0,0,5,5,10
2008,Egypt,EGY,Hungary,HUN,0,0,11,31,42
2008,Armenia,ARM,Hungary,HUN,0,0,5,5,10
2008,Bangladesh,BGD,Hungary,HUN,0,0,12,21,33
2008,Bosnia and Herzegovina,BIH,Hungary,HUN,0,0,0,11,11
2008,China,CHN,Hungary,HUN,0,0,19,10,29
2008,Cameroon,CMR,Hungary,HUN,0,0,5,0,5
2008,Cuba,CUB,Hungary,HUN,14,0,0,0,14
2008,Ethiopia,ETH,Hungary,HUN,5,0,0,0,5
2008,Palestinian,PSE,Hungary,HUN,0,10,5,21,36
2008,Georgia,GEO,Hungary,HUN,0,5,33,78,116
2008,India,IND,Hungary,HUN,0,0,0,18,18
2008,Iran (Islamic Rep. of),IRN,Hungary,HUN,0,0,0,5,5
2008,Iraq,IRQ,Hungary,HUN,21,36,17,31,105
2008,Lebanon,LBN,Hungary,HUN,0,0,0,5,5
2008,Sri Lanka,LKA,Hungary,HUN,0,0,0,11,11
2008,North Macedonia,MKD,Hungary,HUN,0,0,5,28,33
2008,Rep. of Moldova,MDA,Hungary,HUN,0,0,0,25,25
2008,Mongolia,MNG,Hungary,HUN,0,0,17,0,17
2008,Montenegro,MNE,Hungary,HUN,0,0,0,5,5
2008,Nigeria,NGA,Hungary,HUN,0,0,12,22,34
2008,Pakistan,PAK,Hungary,HUN,0,0,43,180,223
2008,Russian Federation,RUS,Hungary,HUN,5,0,5,10,20
2008,Serbia and Kosovo: S/RES/1244 (1999),SRB,Hungary,HUN,0,15,119,877,1011
2008,Sierra Leone,SLE,Hungary,HUN,0,0,5,0,5
2008,Somalia,SOM,Hungary,HUN,105,0,0,12,117
2008,Viet Nam,VNM,Hungary,HUN,0,0,22,5,27
2008,Sudan,SDN,Hungary,HUN,0,0,5,0,5
2008,Syrian Arab Rep.,SYR,Hungary,HUN,0,0,0,11,11
2008,Tunisia,TUN,Hungary,HUN,0,0,0,5,5
2008,Turkey,TUR,Hungary,HUN,0,0,15,34,49
2008,Ukraine,UKR,Hungary,HUN,0,0,5,0,5
2008,Uzbekistan,UZB,Hungary,HUN,0,5,0,0,5
2008,Zimbabwe,ZWE,Hungary,HUN,0,0,5,0,5
2008,Albania,ALB,Iceland,ISL,0,0,0,5,5
2008,Azerbaijan,AZE,Iceland,ISL,0,0,0,5,5
2008,Georgia,GEO,Iceland,ISL,0,0,0,5,5
2008,Iran (Islamic Rep. of),IRN,Iceland,ISL,0,0,0,5,5
2008,Iraq,IRQ,Iceland,ISL,0,0,0,5,5
2008,Sri Lanka,LKA,Iceland,ISL,5,0,0,0,5
2008,Nigeria,NGA,Iceland,ISL,0,0,0,5,5
2008,Russian Federation,RUS,Iceland,ISL,0,5,0,0,5
2008,Serbia and Kosovo: S/RES/1244 (1999),SRB,Iceland,ISL,0,0,11,0,11
2008,Afghanistan,AFG,Ireland,IRL,5,0,61,19,85
2008,Albania,ALB,Ireland,IRL,0,0,64,5,69
2008,Algeria,DZA,Ireland,IRL,0,0,31,12,43
2008,Angola,AGO,Ireland,IRL,0,0,28,5,33
2008,Egypt,EGY,Ireland,IRL,0,0,5,15,20
2008,Armenia,ARM,Ireland,IRL,5,0,5,0,10
2008,Azerbaijan,AZE,Ireland,IRL,0,0,5,0,5
2008,Burundi,BDI,Ireland,IRL,0,0,21,0,21
2008,Benin,BEN,Ireland,IRL,0,0,14,0,14
2008,Bangladesh,BGD,Ireland,IRL,5,0,22,0,27
2008,Bhutan,BTN,Ireland,IRL,0,0,29,5,34
2008,Belarus,BLR,Ireland,IRL,0,0,14,0,14
2008,Brazil,BRA,Ireland,IRL,0,0,13,0,13
2008,Chad,TCD,Ireland,IRL,0,0,5,0,5
2008,China,CHN,Ireland,IRL,0,0,61,151,212
2008,Cameroon,CMR,Ireland,IRL,0,0,60,10,70
2008,Congo,COG,Ireland,IRL,0,0,15,5,20
2008,Dem. Rep. of the Congo,COD,Ireland,IRL,5,0,146,14,165
2008,Eritrea,ERI,Ireland,IRL,18,0,20,12,50
2008,Ethiopia,ETH,Ireland,IRL,0,0,14,0,14
2008,Gambia,GMB,Ireland,IRL,0,0,10,0,10
2008,Palestinian,PSE,Ireland,IRL,5,0,25,5,35
2008,Georgia,GEO,Ireland,IRL,0,0,110,40,150
2008,Ghana,GHA,Ireland,IRL,0,0,78,10,88
2008,Guinea,GIN,Ireland,IRL,0,0,18,5,23
2008,Croatia,HRV,Ireland,IRL,0,0,13,0,13
2008,Cote d'Ivoire,CIV,Ireland,IRL,0,0,20,0,20
2008,India,IND,Ireland,IRL,0,0,14,0,14
2008,Iran (Islamic Rep. of),IRN,Ireland,IRL,10,0,39,17,66
2008,Iraq,IRQ,Ireland,IRL,110,0,100,30,240
2008,Israel,ISR,Ireland,IRL,0,0,10,0,10
2008,Jordan,JOR,Ireland,IRL,0,0,5,0,5
2008,Kenya,KEN,Ireland,IRL,0,0,35,5,40
2008,Kuwait,KWT,Ireland,IRL,10,0,5,5,20
2008,Liberia,LBR,Ireland,IRL,0,0,23,0,23
2008,Libya,LBY,Ireland,IRL,0,0,5,0,5
2008,Sri Lanka,LKA,Ireland,IRL,0,0,14,0,14
2008,Rep. of Moldova,MDA,Ireland,IRL,0,0,99,54,153
2008,Malaysia,MYS,Ireland,IRL,0,0,0,5,5
2008,Malawi,MWI,Ireland,IRL,0,0,17,5,22
2008,Mongolia,MNG,Ireland,IRL,0,0,5,13,18
2008,Morocco,MAR,Ireland,IRL,0,0,10,0,10
2008,Mauritius,MUS,Ireland,IRL,0,0,19,5,24
2008,Myanmar,MMR,Ireland,IRL,0,0,5,0,5
2008,Nigeria,NGA,Ireland,IRL,5,0,989,79,1073
2008,Pakistan,PAK,Ireland,IRL,15,0,145,27,187
2008,South Africa,ZAF,Ireland,IRL,0,0,61,5,66
2008,Russian Federation,RUS,Ireland,IRL,5,0,21,12,38
2008,Serbia and Kosovo: S/RES/1244 (1999),SRB,Ireland,IRL,0,0,42,11,53
2008,Sierra Leone,SLE,Ireland,IRL,0,0,18,0,18
2008,Somalia,SOM,Ireland,IRL,23,0,42,11,76
2008,Viet Nam,VNM,Ireland,IRL,0,0,10,0,10
2008,Sudan,SDN,Ireland,IRL,35,0,98,44,177
2008,Syrian Arab Rep.,SYR,Ireland,IRL,0,0,5,11,16
2008,United Rep. of Tanzania,TZA,Ireland,IRL,0,0,5,0,5
2008,Togo,TGO,Ireland,IRL,0,0,16,0,16
2008,Turkey,TUR,Ireland,IRL,0,0,5,0,5
2008,Uganda,UGA,Ireland,IRL,11,0,34,0,45
2008,Ukraine,UKR,Ireland,IRL,0,0,17,10,27
2008,United States of America,USA,Ireland,IRL,0,0,5,0,5
2008,Uzbekistan,UZB,Ireland,IRL,5,0,0,0,5
2008,Zimbabwe,ZWE,Ireland,IRL,5,0,100,10,115
2008,Stateless,XXA,Ireland,IRL,0,0,5,0,5
2008,Afghanistan,AFG,Italy,ITA,208,969,582,22,1781
2008,Albania,ALB,Italy,ITA,5,5,22,5,37
2008,Algeria,DZA,Italy,ITA,5,5,110,10,130
2008,Angola,AGO,Italy,ITA,0,0,12,0,12
2008,Egypt,EGY,Italy,ITA,0,5,59,12,76
2008,Armenia,ARM,Italy,ITA,5,10,14,0,29
2008,Burundi,BDI,Italy,ITA,5,0,0,0,5
2008,Benin,BEN,Italy,ITA,0,12,40,0,52
2008,Bangladesh,BGD,Italy,ITA,10,50,890,46,996
2008,Burkina Faso,BFA,Italy,ITA,15,83,340,31,469
2008,Belarus,BLR,Italy,ITA,5,0,5,0,10
2008,Bolivia (Plurinational State of),BOL,Italy,ITA,0,0,5,0,5
2008,Brazil,BRA,Italy,ITA,0,0,5,0,5
2008,Bosnia and Herzegovina,BIH,Italy,ITA,0,5,11,0,16
2008,Central African Rep.,CAF,Italy,ITA,0,5,0,0,5
2008,Chad,TCD,Italy,ITA,5,22,15,0,42
2008,China,CHN,Italy,ITA,10,0,21,5,36
2008,Chile,CHL,Italy,ITA,0,0,5,0,5
2008,Cameroon,CMR,Italy,ITA,34,42,88,5,169
2008,Congo,COG,Italy,ITA,5,13,15,5,38
2008,Dem. Rep. of the Congo,COD,Italy,ITA,16,15,14,0,45
2008,Colombia,COL,Italy,ITA,5,5,13,5,28
2008,Cuba,CUB,Italy,ITA,0,16,26,0,42
2008,Ecuador,ECU,Italy,ITA,0,5,0,0,5
2008,Eritrea,ERI,Italy,ITA,202,1427,174,64,1867
2008,Ethiopia,ETH,Italy,ITA,65,135,77,10,287
2008,Gambia,GMB,Italy,ITA,18,23,120,5,166
2008,Palestinian,PSE,Italy,ITA,15,5,79,12,111
2008,Georgia,GEO,Italy,ITA,0,15,18,0,33
2008,Ghana,GHA,Italy,ITA,10,124,1074,22,1230
2008,Guinea-Bissau,GNB,Italy,ITA,0,0,12,0,12
2008,Guatemala,GTM,Italy,ITA,5,0,0,0,5
2008,Guinea,GIN,Italy,ITA,41,105,249,5,400
2008,Cote d'Ivoire,CIV,Italy,ITA,90,468,829,40,1427
2008,India,IND,Italy,ITA,0,5,56,10,71
2008,Iran (Islamic Rep. of),IRN,Italy,ITA,44,31,19,5,99
2008,Iraq,IRQ,Italy,ITA,210,224,57,24,515
2008,Kenya,KEN,Italy,ITA,5,24,37,0,66
2008,Liberia,LBR,Italy,ITA,0,19,75,24,118
2008,Libya,LBY,Italy,ITA,0,0,5,0,5
2008,Lebanon,LBN,Italy,ITA,17,20,65,5,107
2008,Sri Lanka,LKA,Italy,ITA,12,67,63,12,154
2008,Mauritania,MRT,Italy,ITA,5,14,10,0,29
2008,North Macedonia,MKD,Italy,ITA,0,5,0,0,5
2008,Rep. of Moldova,MDA,Italy,ITA,0,10,17,0,27
2008,Mali,MLI,Italy,ITA,5,27,285,10,327
2008,Mongolia,MNG,Italy,ITA,0,0,5,0,5
2008,Morocco,MAR,Italy,ITA,5,12,93,11,121
2008,Myanmar,MMR,Italy,ITA,5,0,0,0,5
2008,Niger,NER,Italy,ITA,5,12,76,0,93
2008,Nigeria,NGA,Italy,ITA,41,366,2738,253,3398
2008,Pakistan,PAK,Italy,ITA,43,111,500,52,706
2008,Peru,PER,Italy,ITA,0,0,5,0,5
2008,Philippines,PHL,Italy,ITA,0,0,5,0,5
2008,Russian Federation,RUS,Italy,ITA,0,5,0,0,5
2008,Rwanda,RWA,Italy,ITA,0,5,0,0,5
2008,El Salvador,SLV,Italy,ITA,0,0,12,0,12
2008,Saudi Arabia,SAU,Italy,ITA,5,0,0,0,5
2008,Serbia and Kosovo: S/RES/1244 (1999),SRB,Italy,ITA,13,28,40,128,209
2008,Senegal,SEN,Italy,ITA,10,22,63,0,95
2008,Sierra Leone,SLE,Italy,ITA,5,11,45,10,71
2008,Somalia,SOM,Italy,ITA,342,3210,153,13,3718
2008,Sudan,SDN,Italy,ITA,121,146,126,29,422
2008,Syrian Arab Rep.,SYR,Italy,ITA,11,18,5,0,34
2008,Togo,TGO,Italy,ITA,37,114,359,5,515
2008,Tunisia,TUN,Italy,ITA,0,0,56,11,67
2008,Turkey,TUR,Italy,ITA,58,116,177,41,392
2008,Uganda,UGA,Italy,ITA,0,5,5,0,10
2008,Ukraine,UKR,Italy,ITA,0,0,13,0,13
2008,Zimbabwe,ZWE,Italy,ITA,0,5,18,5,28
2008,Afghanistan,AFG,Japan,JPN,0,0,0,5,5
2008,Burundi,BDI,Japan,JPN,0,0,5,0,5
2008,Bangladesh,BGD,Japan,JPN,0,0,11,5,16
2008,China,CHN,Japan,JPN,0,0,5,0,5
2008,Cameroon,CMR,Japan,JPN,0,0,5,0,5
2008,Dem. Rep. of the Congo,COD,Japan,JPN,0,0,5,0,5
2008,Colombia,COL,Japan,JPN,0,0,5,0,5
2008,Ethiopia,ETH,Japan,JPN,0,0,13,0,13
2008,Iran (Islamic Rep. of),IRN,Japan,JPN,0,0,22,5,27
2008,Sri Lanka,LKA,Japan,JPN,0,5,43,5,48
2008,Myanmar,MMR,Japan,JPN,38,312,491,24,553
2008,Nepal,NPL,Japan,JPN,0,0,12,0,12
2008,Nigeria,NGA,Japan,JPN,0,0,10,0,10
2008,Pakistan,PAK,Japan,JPN,0,0,16,5,21
2008,Sudan,SDN,Japan,JPN,0,0,0,5,5
2008,Turkey,TUR,Japan,JPN,0,0,119,13,132
2008,Uganda,UGA,Japan,JPN,0,0,5,0,5
2008,Afghanistan,AFG,Kyrgyzstan,KGZ,5,0,262,84,351
2008,Iran (Islamic Rep. of),IRN,Kyrgyzstan,KGZ,0,0,11,0,11
2008,Iraq,IRQ,Kyrgyzstan,KGZ,0,0,0,5,5
2008,Kazakhstan,KAZ,Kyrgyzstan,KGZ,0,0,5,0,5
2008,Russian Federation,RUS,Kyrgyzstan,KGZ,0,0,0,46,46
2008,Sudan,SDN,Kyrgyzstan,KGZ,0,0,0,5,5
2008,Turkmenistan,TKM,Kyrgyzstan,KGZ,0,0,5,0,5
2008,Uzbekistan,UZB,Kyrgyzstan,KGZ,0,0,0,167,167
2008,Angola,AGO,Liechtenstein,LIE,0,0,0,5,5
2008,Belarus,BLR,Liechtenstein,LIE,0,0,0,5,5
2008,Germany,DEU,Liechtenstein,LIE,0,0,5,0,5
2008,Russian Federation,RUS,Liechtenstein,LIE,0,0,5,0,5
2008,Belarus,BLR,Lithuania,LTU,0,0,5,5,10
2008,Cameroon,CMR,Lithuania,LTU,0,5,0,0,5
2008,Dem. Rep. of the Congo,COD,Lithuania,LTU,0,0,5,0,5
2008,Cuba,CUB,Lithuania,LTU,0,5,0,0,5
2008,Georgia,GEO,Lithuania,LTU,0,0,0,5,5
2008,India,IND,Lithuania,LTU,0,0,5,0,5
2008,Russian Federation,RUS,Lithuania,LTU,5,45,10,20,80
2008,Syrian Arab Rep.,SYR,Lithuania,LTU,0,0,0,5,5
2008,Turkey,TUR,Lithuania,LTU,0,0,0,5,5
2008,Ukraine,UKR,Lithuania,LTU,0,0,5,0,5
2008,Uzbekistan,UZB,Lithuania,LTU,5,0,0,0,5
2008,Afghanistan,AFG,Luxembourg,LUX,0,11,0,0,11
2008,Albania,ALB,Luxembourg,LUX,0,5,11,11,27
2008,Algeria,DZA,Luxembourg,LUX,0,0,0,5,5
2008,Angola,AGO,Luxembourg,LUX,10,10,0,0,20
2008,Burundi,BDI,Luxembourg,LUX,0,10,0,0,10
2008,Belarus,BLR,Luxembourg,LUX,0,0,0,5,5
2008,Bosnia and Herzegovina,BIH,Luxembourg,LUX,0,10,13,5,28
2008,China,CHN,Luxembourg,LUX,5,0,0,0,5
2008,Cameroon,CMR,Luxembourg,LUX,0,0,11,0,11
2008,Dem. Rep. of the Congo,COD,Luxembourg,LUX,5,11,0,5,21
2008,Eritrea,ERI,Luxembourg,LUX,0,0,5,5,10
2008,Ethiopia,ETH,Luxembourg,LUX,0,12,0,0,12
2008,Guinea,GIN,Luxembourg,LUX,0,5,0,0,5
2008,Iran (Islamic Rep. of),IRN,Luxembourg,LUX,11,13,12,5,41
2008,Iraq,IRQ,Luxembourg,LUX,5,0,0,0,5
2008,Israel,ISR,Luxembourg,LUX,0,0,0,5,5
2008,Liberia,LBR,Luxembourg,LUX,0,10,0,0,10
2008,North Macedonia,MKD,Luxembourg,LUX,0,5,5,0,10
2008,Rep. of Moldova,MDA,Luxembourg,LUX,0,0,5,0,5
2008,Mongolia,MNG,Luxembourg,LUX,0,5,0,0,5
2008,Montenegro,MNE,Luxembourg,LUX,0,37,23,10,70
2008,Nigeria,NGA,Luxembourg,LUX,0,43,5,5,53
2008,Russian Federation,RUS,Luxembourg,LUX,0,16,22,11,49
2008,Serbia and Kosovo: S/RES/1244 (1999),SRB,Luxembourg,LUX,12,121,97,50,280
2008,Somalia,SOM,Luxembourg,LUX,5,5,0,0,10
2008,Tajikistan,TJK,Luxembourg,LUX,0,0,0,5,5
2008,Togo,TGO,Luxembourg,LUX,0,13,0,0,13
2008,Turkey,TUR,Luxembourg,LUX,0,5,0,0,5
2008,Ukraine,UKR,Luxembourg,LUX,0,0,0,5,5
2008,Armenia,ARM,Latvia,LVA,0,0,5,0,5
2008,Bangladesh,BGD,Latvia,LVA,0,0,10,0,10
2008,Angola,AGO,Mexico,MEX,0,0,0,5,5
2008,Colombia,COL,Mexico,MEX,21,0,10,13,44
2008,Cuba,CUB,Mexico,MEX,0,0,0,10,10
2008,Ecuador,ECU,Mexico,MEX,0,0,0,5,5
2008,Ethiopia,ETH,Mexico,MEX,0,0,0,5,5
2008,Ghana,GHA,Mexico,MEX,5,0,0,0,5
2008,Guatemala,GTM,Mexico,MEX,0,0,5,11,16
2008,Haiti,HTI,Mexico,MEX,46,0,13,5,64
2008,Honduras,HND,Mexico,MEX,0,0,25,35,60
2008,India,IND,Mexico,MEX,0,0,0,5,5
2008,Iraq,IRQ,Mexico,MEX,20,0,0,0,20
2008,Sri Lanka,LKA,Mexico,MEX,5,0,0,0,5
2008,North Macedonia,MKD,Mexico,MEX,0,0,0,5,5
2008,Nepal,NPL,Mexico,MEX,0,0,5,5,10
2008,Nicaragua,NIC,Mexico,MEX,0,0,5,5,10
2008,Romania,ROU,Mexico,MEX,0,0,0,5,5
2008,El Salvador,SLV,Mexico,MEX,0,0,22,25,47
2008,Somalia,SOM,Mexico,MEX,0,0,0,5,5
2008,Burundi,BDI,Mali,MLI,0,0,5,0,5
2008,Chad,TCD,Mali,MLI,0,0,5,0,5
2008,Dem. Rep. of the Congo,COD,Mali,MLI,10,0,0,0,10
2008,Cote d'Ivoire,CIV,Mali,MLI,5,0,18,0,23
2008,Burundi,BDI,Mozambique,MOZ,29,0,73,76,178
2008,Dem. Rep. of the Congo,COD,Mozambique,MOZ,403,0,474,366,1243
2008,Rwanda,RWA,Mozambique,MOZ,17,0,0,10,27
2008,Somalia,SOM,Mozambique,MOZ,5,0,0,0,5
2008,Burkina Faso,BFA,Malta,MLT,0,0,31,0,31
2008,Chad,TCD,Malta,MLT,0,0,5,0,5
2008,Cameroon,CMR,Malta,MLT,0,0,5,0,5
2008,Dem. Rep. of the Congo,COD,Malta,MLT,0,0,5,0,5
2008,Eritrea,ERI,Malta,MLT,10,251,18,0,279
2008,Ethiopia,ETH,Malta,MLT,5,5,117,5,132
2008,Gambia,GMB,Malta,MLT,0,0,37,0,37
2008,Palestinian,PSE,Malta,MLT,0,0,5,0,5
2008,Ghana,GHA,Malta,MLT,0,0,92,5,97
2008,Guinea-Bissau,GNB,Malta,MLT,0,0,11,0,11
2008,Guinea,GIN,Malta,MLT,0,0,34,0,34
2008,Cote d'Ivoire,CIV,Malta,MLT,0,0,243,5,248
2008,Iraq,IRQ,Malta,MLT,0,0,5,0,5
2008,Liberia,LBR,Malta,MLT,0,0,19,0,19
2008,Sri Lanka,LKA,Malta,MLT,0,5,0,0,5
2008,Mauritania,MRT,Malta,MLT,0,0,5,0,5
2008,Mali,MLI,Malta,MLT,0,0,169,0,169
2008,Niger,NER,Malta,MLT,0,0,92,0,92
2008,Nigeria,NGA,Malta,MLT,0,5,202,0,207
2008,Senegal,SEN,Malta,MLT,0,0,15,0,15
2008,Sierra Leone,SLE,Malta,MLT,0,0,26,0,26
2008,Somalia,SOM,Malta,MLT,5,1116,21,5,1147
2008,Sudan,SDN,Malta,MLT,0,15,29,0,44
2008,Togo,TGO,Malta,MLT,0,0,74,0,74
2008,Tunisia,TUN,Malta,MLT,0,0,5,0,5
2008,Burundi,BDI,Namibia,NAM,10,0,19,0,29
2008,Congo,COG,Namibia,NAM,5,0,0,0,5
2008,Dem. Rep. of the Congo,COD,Namibia,NAM,21,0,96,0,117
2008,Rwanda,RWA,Namibia,NAM,0,0,5,0,5
2008,Sudan,SDN,Namibia,NAM,0,0,5,0,5
2008,United Rep. of Tanzania,TZA,Namibia,NAM,0,0,5,0,5
2008,Uganda,UGA,Namibia,NAM,0,0,0,5,5
2008,Bhutan,BTN,Nepal,NPL,0,684,0,0,684
2008,Afghanistan,AFG,Netherlands,NLD,5,158,267,0,430
2008,Albania,ALB,Netherlands,NLD,0,5,5,0,10
2008,Algeria,DZA,Netherlands,NLD,0,0,36,0,36
2008,Angola,AGO,Netherlands,NLD,0,5,35,0,40
2008,Egypt,EGY,Netherlands,NLD,0,0,19,0,19
2008,Armenia,ARM,Netherlands,NLD,5,13,97,0,115
2008,Azerbaijan,AZE,Netherlands,NLD,0,18,75,0,93
2008,Burundi,BDI,Netherlands,NLD,5,90,93,0,188
2008,Benin,BEN,Netherlands,NLD,0,0,5,0,5
2008,Bangladesh,BGD,Netherlands,NLD,0,0,13,0,13
2008,Bhutan,BTN,Netherlands,NLD,5,30,5,0,40
2008,Burkina Faso,BFA,Netherlands,NLD,0,0,5,0,5
2008,Belarus,BLR,Netherlands,NLD,11,0,0,0,11
2008,Bosnia and Herzegovina,BIH,Netherlands,NLD,0,0,11,0,11
2008,Chad,TCD,Netherlands,NLD,0,0,5,0,5
2008,China,CHN,Netherlands,NLD,52,47,437,0,536
2008,Cameroon,CMR,Netherlands,NLD,0,10,40,0,50
2008,Congo,COG,Netherlands,NLD,5,51,39,0,95
2008,Dem. Rep. of the Congo,COD,Netherlands,NLD,11,77,30,0,118
2008,Colombia,COL,Netherlands,NLD,0,16,42,0,58
2008,Cuba,CUB,Netherlands,NLD,0,0,5,0,5
2008,Eritrea,ERI,Netherlands,NLD,16,139,66,0,221
2008,Ethiopia,ETH,Netherlands,NLD,39,59,49,0,147
2008,Gambia,GMB,Netherlands,NLD,0,5,10,0,15
2008,Palestinian,PSE,Netherlands,NLD,0,5,20,0,25
2008,Georgia,GEO,Netherlands,NLD,0,0,50,0,50
2008,Ghana,GHA,Netherlands,NLD,0,0,28,0,28
2008,Guinea,GIN,Netherlands,NLD,24,79,145,0,248
2008,Cote d'Ivoire,CIV,Netherlands,NLD,5,52,21,0,78
2008,India,IND,Netherlands,NLD,0,0,32,0,32
2008,Indonesia,IDN,Netherlands,NLD,0,0,5,0,5
2008,Iran (Islamic Rep. of),IRN,Netherlands,NLD,46,112,201,0,359
2008,Iraq,IRQ,Netherlands,NLD,180,2044,1099,0,3323
2008,Jamaica,JAM,Netherlands,NLD,0,0,5,0,5
2008,Jordan,JOR,Netherlands,NLD,0,5,0,0,5
2008,Kazakhstan,KAZ,Netherlands,NLD,0,0,15,0,15
2008,Kenya,KEN,Netherlands,NLD,0,0,18,0,18
2008,Kyrgyzstan,KGZ,Netherlands,NLD,0,0,5,0,5
2008,Dem. People's Rep. of Korea,PRK,Netherlands,NLD,0,5,0,0,5
2008,Liberia,LBR,Netherlands,NLD,0,14,44,0,58
2008,Libya,LBY,Netherlands,NLD,0,28,10,0,38
2008,Lebanon,LBN,Netherlands,NLD,0,5,16,0,21
2008,Sri Lanka,LKA,Netherlands,NLD,13,41,129,0,183
2008,North Macedonia,MKD,Netherlands,NLD,0,0,10,0,10
2008,Rep. of Moldova,MDA,Netherlands,NLD,0,0,5,0,5
2008,Mali,MLI,Netherlands,NLD,0,0,5,0,5
2008,Malawi,MWI,Netherlands,NLD,0,0,5,0,5
2008,Mongolia,MNG,Netherlands,NLD,0,0,77,0,77
2008,Morocco,MAR,Netherlands,NLD,0,0,12,0,12
2008,Myanmar,MMR,Netherlands,NLD,5,159,5,0,169
2008,Nepal,NPL,Netherlands,NLD,5,51,30,0,86
2008,Niger,NER,Netherlands,NLD,0,0,5,0,5
2008,Nigeria,NGA,Netherlands,NLD,0,13,98,0,111
2008,Pakistan,PAK,Netherlands,NLD,0,0,42,0,42
2008,Philippines,PHL,Netherlands,NLD,0,0,5,0,5
2008,South Africa,ZAF,Netherlands,NLD,0,0,5,0,5
2008,Russian Federation,RUS,Netherlands,NLD,5,26,93,0,124
2008,Rwanda,RWA,Netherlands,NLD,0,11,10,0,21
2008,Serbia and Kosovo: S/RES/1244 (1999),SRB,Netherlands,NLD,0,5,35,0,40
2008,Senegal,SEN,Netherlands,NLD,0,0,5,0,5
2008,Sierra Leone,SLE,Netherlands,NLD,0,79,114,0,193
2008,Somalia,SOM,Netherlands,NLD,35,1451,817,0,2303
2008,Viet Nam,VNM,Netherlands,NLD,0,0,5,0,5
2008,Sudan,SDN,Netherlands,NLD,0,26,71,0,97
2008,Syrian Arab Rep.,SYR,Netherlands,NLD,5,5,61,0,71
2008,United Rep. of Tanzania,TZA,Netherlands,NLD,0,0,5,0,5
2008,Tajikistan,TJK,Netherlands,NLD,0,0,13,0,13
2008,Togo,TGO,Netherlands,NLD,0,10,18,0,28
2008,Tunisia,TUN,Netherlands,NLD,0,0,12,0,12
2008,Turkey,TUR,Netherlands,NLD,10,5,116,0,131
2008,Uganda,UGA,Netherlands,NLD,5,13,16,0,34
2008,Ukraine,UKR,Netherlands,NLD,0,0,5,0,5
2008,United States of America,USA,Netherlands,NLD,0,0,5,0,5
2008,Uzbekistan,UZB,Netherlands,NLD,5,18,13,0,36
2008,Yemen,YEM,Netherlands,NLD,0,0,5,0,5
2008,Zimbabwe,ZWE,Netherlands,NLD,0,5,5,0,10
2008,Stateless,XXA,Netherlands,NLD,5,50,57,0,112
2008,Central African Rep.,CAF,Niger,NER,0,0,5,0,5
2008,Chad,TCD,Niger,NER,5,0,0,0,5
2008,Cuba,CUB,Nicaragua,NIC,5,0,0,5,10
2008,Eritrea,ERI,Nicaragua,NIC,0,0,0,31,31
2008,Ethiopia,ETH,Nicaragua,NIC,0,0,0,26,26
2008,Nepal,NPL,Nicaragua,NIC,0,0,0,5,5
2008,Pakistan,PAK,Nicaragua,NIC,0,0,0,5,5
2008,Somalia,SOM,Nicaragua,NIC,0,0,0,21,21
2008,Chad,TCD,Nigeria,NGA,0,54,0,5,59
2008,Cameroon,CMR,Nigeria,NGA,0,0,30,0,30
2008,Dem. Rep. of the Congo,COD,Nigeria,NGA,23,0,37,0,60
2008,Guinea,GIN,Nigeria,NGA,0,0,0,5,5
2008,Cote d'Ivoire,CIV,Nigeria,NGA,0,0,12,0,12
2008,Togo,TGO,Nigeria,NGA,0,0,0,5,5
2008,Afghanistan,AFG,Norway,NOR,20,301,23,59,403
2008,Albania,ALB,Norway,NOR,0,0,27,19,46
2008,Algeria,DZA,Norway,NOR,0,0,21,48,69
2008,Angola,AGO,Norway,NOR,11,10,23,5,49
2008,Egypt,EGY,Norway,NOR,0,0,5,5,10
2008,Armenia,ARM,Norway,NOR,0,0,5,0,5
2008,Azerbaijan,AZE,Norway,NOR,0,0,35,5,40
2008,Burundi,BDI,Norway,NOR,0,5,98,5,108
2008,Benin,BEN,Norway,NOR,0,0,0,5,5
2008,Bhutan,BTN,Norway,NOR,0,0,12,0,12
2008,Burkina Faso,BFA,Norway,NOR,0,5,0,5,10
2008,Belarus,BLR,Norway,NOR,0,0,14,0,14
2008,Bosnia and Herzegovina,BIH,Norway,NOR,0,0,0,13,13
2008,Bulgaria,BGR,Norway,NOR,0,0,5,0,5
2008,Chad,TCD,Norway,NOR,0,0,0,5,5
2008,China,CHN,Norway,NOR,12,5,0,5,22
2008,Cameroon,CMR,Norway,NOR,0,0,26,11,37
2008,Congo,COG,Norway,NOR,0,0,15,0,15
2008,Dem. Rep. of the Congo,COD,Norway,NOR,18,16,71,13,118
2008,Colombia,COL,Norway,NOR,0,5,0,0,5
2008,Eritrea,ERI,Norway,NOR,310,401,34,327,1072
2008,Ethiopia,ETH,Norway,NOR,106,35,129,44,314
2008,Gambia,GMB,Norway,NOR,0,0,16,5,21
2008,Georgia,GEO,Norway,NOR,0,0,14,0,14
2008,Ghana,GHA,Norway,NOR,0,0,19,34,53
2008,Guinea-Bissau,GNB,Norway,NOR,0,0,0,5,5
2008,Guatemala,GTM,Norway,NOR,0,0,5,0,5
2008,Guinea,GIN,Norway,NOR,5,0,21,5,31
2008,Croatia,HRV,Norway,NOR,0,0,5,5,10
2008,Cote d'Ivoire,CIV,Norway,NOR,0,13,0,5,18
2008,India,IND,Norway,NOR,0,5,0,75,80
2008,Iran (Islamic Rep. of),IRN,Norway,NOR,59,53,186,53,351
2008,Iraq,IRQ,Norway,NOR,113,452,935,344,1844
2008,Israel,ISR,Norway,NOR,0,0,5,5,10
2008,Jordan,JOR,Norway,NOR,0,0,11,5,16
2008,Kazakhstan,KAZ,Norway,NOR,0,5,0,5,10
2008,Kenya,KEN,Norway,NOR,5,0,16,0,21
2008,Kyrgyzstan,KGZ,Norway,NOR,0,0,12,0,12
2008,Rep. of Korea,KOR,Norway,NOR,0,0,57,16,73
2008,Dem. People's Rep. of Korea,PRK,Norway,NOR,0,5,21,16,42
2008,Kuwait,KWT,Norway,NOR,0,10,0,0,10
2008,Liberia,LBR,Norway,NOR,0,0,26,19,45
2008,Libya,LBY,Norway,NOR,0,0,52,36,88
2008,Lebanon,LBN,Norway,NOR,0,5,33,34,72
2008,Sri Lanka,LKA,Norway,NOR,5,42,95,30,172
2008,Mauritania,MRT,Norway,NOR,0,0,10,5,15
2008,North Macedonia,MKD,Norway,NOR,0,0,11,5,16
2008,Rep. of Moldova,MDA,Norway,NOR,0,0,0,5,5
2008,Mongolia,MNG,Norway,NOR,0,0,5,5,10
2008,Morocco,MAR,Norway,NOR,0,0,15,17,32
2008,Montenegro,MNE,Norway,NOR,0,0,0,5,5
2008,Myanmar,MMR,Norway,NOR,0,5,0,0,5
2008,Nepal,NPL,Norway,NOR,0,0,32,10,42
2008,Netherlands,NLD,Norway,NOR,0,0,5,0,5
2008,Nicaragua,NIC,Norway,NOR,0,0,0,5,5
2008,Nigeria,NGA,Norway,NOR,0,0,147,105,252
2008,Pakistan,PAK,Norway,NOR,0,5,5,5,15
2008,Romania,ROU,Norway,NOR,0,0,5,0,5
2008,Russian Federation,RUS,Norway,NOR,16,121,829,220,1186
2008,Rwanda,RWA,Norway,NOR,11,0,12,5,28
2008,Serbia and Kosovo: S/RES/1244 (1999),SRB,Norway,NOR,34,20,724,130,908
2008,Senegal,SEN,Norway,NOR,0,0,5,0,5
2008,Sierra Leone,SLE,Norway,NOR,0,0,13,5,18
2008,Somalia,SOM,Norway,NOR,141,168,58,225,592
2008,Viet Nam,VNM,Norway,NOR,0,5,5,11,21
2008,Sudan,SDN,Norway,NOR,27,5,10,10,52
2008,Syrian Arab Rep.,SYR,Norway,NOR,5,10,34,26,75
2008,Tajikistan,TJK,Norway,NOR,0,0,5,0,5
2008,Togo,TGO,Norway,NOR,0,0,0,11,11
2008,Tunisia,TUN,Norway,NOR,0,0,0,11,11
2008,Turkey,TUR,Norway,NOR,10,5,40,28,83
2008,Uganda,UGA,Norway,NOR,5,0,20,5,30
2008,Ukraine,UKR,Norway,NOR,0,0,10,5,15
2008,Uzbekistan,UZB,Norway,NOR,0,5,95,10,110
2008,Western Sahara,ESH,Norway,NOR,0,0,10,0,10
2008,Yemen,YEM,Norway,NOR,5,5,13,0,23
2008,Zimbabwe,ZWE,Norway,NOR,0,0,14,0,14
2008,Stateless,XXA,Norway,NOR,154,258,141,118,671
2008,Afghanistan,AFG,New Zealand,NZL,0,0,5,0,5
2008,Egypt,EGY,New Zealand,NZL,0,0,5,0,5
2008,Bangladesh,BGD,New Zealand,NZL,0,0,5,0,5
2008,China,CHN,New Zealand,NZL,5,0,12,0,17
2008,United Kingdom of Great Britain and Northern Ireland,GBR,New Zealand,NZL,0,0,5,0,5
2008,Hungary,HUN,New Zealand,NZL,0,0,5,0,5
2008,Iran (Islamic Rep. of),IRN,New Zealand,NZL,5,0,22,0,27
2008,Iraq,IRQ,New Zealand,NZL,37,0,5,0,42
2008,Sri Lanka,LKA,New Zealand,NZL,16,0,20,0,36
2008,Mexico,MEX,New Zealand,NZL,0,0,5,0,5
2008,Malaysia,MYS,New Zealand,NZL,0,0,10,0,10
2008,Myanmar,MMR,New Zealand,NZL,5,0,5,0,10
2008,Nepal,NPL,New Zealand,NZL,0,0,5,0,5
2008,Poland,POL,New Zealand,NZL,0,0,5,0,5
2008,Saudi Arabia,SAU,New Zealand,NZL,5,0,0,0,5
2008,Somalia,SOM,New Zealand,NZL,0,0,5,0,5
2008,Zimbabwe,ZWE,New Zealand,NZL,10,0,0,0,10
2008,Dem. Rep. of the Congo,COD,Panama,PAN,5,0,0,0,5
2008,Colombia,COL,Panama,PAN,30,0,17,71,118
2008,Guatemala,GTM,Panama,PAN,0,0,10,0,10
2008,Colombia,COL,Paraguay,PRY,5,0,0,0,5
2008,Cuba,CUB,Paraguay,PRY,5,0,0,12,17
2008,Colombia,COL,Peru,PER,40,0,11,0,51
2008,Cuba,CUB,Peru,PER,42,0,40,0,82
2008,Haiti,HTI,Peru,PER,5,0,0,13,18
2008,Venezuela (Bolivarian Republic of),VEN,Peru,PER,5,0,0,0,5
2008,Afghanistan,AFG,Poland,POL,5,0,5,0,10
2008,Algeria,DZA,Poland,POL,0,0,0,5,5
2008,Egypt,EGY,Poland,POL,0,0,0,5,5
2008,Armenia,ARM,Poland,POL,0,5,32,13,50
2008,Azerbaijan,AZE,Poland,POL,0,0,0,5,5
2008,Burundi,BDI,Poland,POL,0,0,5,0,5
2008,Bangladesh,BGD,Poland,POL,0,0,5,20,25
2008,Belarus,BLR,Poland,POL,14,5,18,44,81
2008,China,CHN,Poland,POL,0,0,0,10,10
2008,Cameroon,CMR,Poland,POL,0,0,18,10,28
2008,Dem. Rep. of the Congo,COD,Poland,POL,0,0,0,11,11
2008,Ethiopia,ETH,Poland,POL,0,0,0,5,5
2008,Palestinian,PSE,Poland,POL,0,0,0,5,5
2008,Georgia,GEO,Poland,POL,0,0,10,20,30
2008,Ghana,GHA,Poland,POL,0,0,0,5,5
2008,Guinea,GIN,Poland,POL,0,0,12,5,17
2008,India,IND,Poland,POL,0,0,12,14,26
2008,Iran (Islamic Rep. of),IRN,Poland,POL,0,0,5,0,5
2008,Iraq,IRQ,Poland,POL,29,5,0,5,39
2008,Kazakhstan,KAZ,Poland,POL,0,0,5,19,24
2008,Kyrgyzstan,KGZ,Poland,POL,0,0,0,12,12
2008,Liberia,LBR,Poland,POL,0,0,0,5,5
2008,Sri Lanka,LKA,Poland,POL,0,16,5,5,26
2008,Madagascar,MDG,Poland,POL,0,0,5,0,5
2008,Rep. of Moldova,MDA,Poland,POL,0,0,15,5,20
2008,Mongolia,MNG,Poland,POL,0,0,14,0,14
2008,Nepal,NPL,Poland,POL,0,0,12,0,12
2008,Nigeria,NGA,Poland,POL,0,0,12,12,24
2008,Pakistan,PAK,Poland,POL,0,0,21,12,33
2008,Russian Federation,RUS,Poland,POL,129,2543,1120,5309,9101
2008,Serbia and Kosovo: S/RES/1244 (1999),SRB,Poland,POL,0,0,5,5,10
2008,Senegal,SEN,Poland,POL,0,0,0,5,5
2008,Sierra Leone,SLE,Poland,POL,0,0,0,5,5
2008,Somalia,SOM,Poland,POL,5,0,0,0,5
2008,Viet Nam,VNM,Poland,POL,0,0,57,5,62
2008,Sudan,SDN,Poland,POL,0,0,0,5,5
2008,Syrian Arab Rep.,SYR,Poland,POL,0,0,0,5,5
2008,Togo,TGO,Poland,POL,0,0,0,5,5
2008,Tunisia,TUN,Poland,POL,0,0,0,5,5
2008,Turkey,TUR,Poland,POL,0,0,5,5,10
2008,Uganda,UGA,Poland,POL,0,0,0,5,5
2008,Ukraine,UKR,Poland,POL,0,0,22,25,47
2008,Uzbekistan,UZB,Poland,POL,0,5,0,5,10
2008,Stateless,XXA,Poland,POL,0,0,12,5,17
2008,Afghanistan,AFG,Russian Federation,RUS,261,298,2719,0,3278
2008,Algeria,DZA,Russian Federation,RUS,0,0,5,0,5
2008,Angola,AGO,Russian Federation,RUS,0,0,12,0,12
2008,Armenia,ARM,Russian Federation,RUS,0,0,19,0,19
2008,Azerbaijan,AZE,Russian Federation,RUS,5,12,43,0,60
2008,Burundi,BDI,Russian Federation,RUS,0,0,5,0,5
2008,Bangladesh,BGD,Russian Federation,RUS,13,0,0,0,13
2008,Belarus,BLR,Russian Federation,RUS,0,0,24,0,24
2008,Cambodia,KHM,Russian Federation,RUS,0,0,10,0,10
2008,China,CHN,Russian Federation,RUS,0,0,5,0,5
2008,Congo,COG,Russian Federation,RUS,0,0,30,0,30
2008,Dem. Rep. of the Congo,COD,Russian Federation,RUS,0,0,43,0,43
2008,Cuba,CUB,Russian Federation,RUS,0,0,15,0,15
2008,Eritrea,ERI,Russian Federation,RUS,0,0,12,0,12
2008,Estonia,EST,Russian Federation,RUS,0,0,5,0,5
2008,Ethiopia,ETH,Russian Federation,RUS,0,0,16,0,16
2008,Palestinian,PSE,Russian Federation,RUS,0,5,0,0,5
2008,Georgia,GEO,Russian Federation,RUS,46,444,2047,0,2537
2008,Ghana,GHA,Russian Federation,RUS,0,0,5,0,5
2008,Guinea,GIN,Russian Federation,RUS,0,0,5,0,5
2008,Iran (Islamic Rep. of),IRN,Russian Federation,RUS,0,0,5,0,5
2008,Iraq,IRQ,Russian Federation,RUS,5,5,61,0,71
2008,Kazakhstan,KAZ,Russian Federation,RUS,0,0,10,0,10
2008,Kyrgyzstan,KGZ,Russian Federation,RUS,0,0,5,0,5
2008,Dem. People's Rep. of Korea,PRK,Russian Federation,RUS,0,5,23,0,28
2008,Liberia,LBR,Russian Federation,RUS,0,0,5,0,5
2008,Lebanon,LBN,Russian Federation,RUS,0,0,5,0,5
2008,Sri Lanka,LKA,Russian Federation,RUS,0,0,5,0,5
2008,Rep. of Moldova,MDA,Russian Federation,RUS,0,0,13,0,13
2008,Nigeria,NGA,Russian Federation,RUS,0,0,5,0,5
2008,Pakistan,PAK,Russian Federation,RUS,0,0,5,0,5
2008,Somalia,SOM,Russian Federation,RUS,0,0,5,0,5
2008,Sudan,SDN,Russian Federation,RUS,0,0,19,0,19
2008,Syrian Arab Rep.,SYR,Russian Federation,RUS,0,0,14,0,14
2008,Tajikistan,TJK,Russian Federation,RUS,0,5,57,0,62
2008,Turkmenistan,TKM,Russian Federation,RUS,0,5,44,0,49
2008,Ukraine,UKR,Russian Federation,RUS,5,0,31,0,36
2008,Uzbekistan,UZB,Russian Federation,RUS,10,11,80,0,101
2008,Burundi,BDI,Rwanda,RWA,0,0,23,0,23
2008,Dem. Rep. of the Congo,COD,Rwanda,RWA,16,0,16,296,328
2008,Albania,ALB,Serbia and Kosovo: S/RES/1244 (1999),SRB,0,0,0,5,5
2008,Ethiopia,ETH,Serbia and Kosovo: S/RES/1244 (1999),SRB,0,0,5,0,5
2008,Georgia,GEO,Serbia and Kosovo: S/RES/1244 (1999),SRB,0,0,0,12,12
2008,Iraq,IRQ,Serbia and Kosovo: S/RES/1244 (1999),SRB,0,11,0,0,11
2008,North Macedonia,MKD,Serbia and Kosovo: S/RES/1244 (1999),SRB,0,0,5,0,5
2008,Syrian Arab Rep.,SYR,Serbia and Kosovo: S/RES/1244 (1999),SRB,0,0,0,5,5
2008,Chad,TCD,Senegal,SEN,0,0,21,0,21
2008,Dem. Rep. of the Congo,COD,Senegal,SEN,0,0,5,0,5
2008,Gambia,GMB,Senegal,SEN,0,0,5,0,5
2008,Guinea-Bissau,GNB,Senegal,SEN,0,0,5,0,5
2008,Guinea,GIN,Senegal,SEN,0,0,5,0,5
2008,Cote d'Ivoire,CIV,Senegal,SEN,0,0,5,0,5
2008,Liberia,LBR,Senegal,SEN,0,0,13,0,13
2008,Mauritania,MRT,Senegal,SEN,0,0,5,0,5
2008,Rwanda,RWA,Senegal,SEN,0,0,5,0,5
2008,Sierra Leone,SLE,Senegal,SEN,0,0,13,0,13
2008,Sudan,SDN,Senegal,SEN,0,0,5,0,5
2008,Togo,TGO,Senegal,SEN,0,0,5,0,5
2008,Afghanistan,AFG,Spain,ESP,5,5,10,5,25
2008,Algeria,DZA,Spain,ESP,0,0,117,103,220
2008,Angola,AGO,Spain,ESP,0,5,0,5,10
2008,Argentina,ARG,Spain,ESP,0,0,0,5,5
2008,Armenia,ARM,Spain,ESP,0,0,25,27,52
2008,Azerbaijan,AZE,Spain,ESP,0,0,5,5,10
2008,Burundi,BDI,Spain,ESP,0,5,0,0,5
2008,Benin,BEN,Spain,ESP,0,0,0,10,10
2008,Bangladesh,BGD,Spain,ESP,0,0,10,30,40
2008,Burkina Faso,BFA,Spain,ESP,0,0,0,10,10
2008,Belarus,BLR,Spain,ESP,0,0,12,10,22
2008,Bolivia (Plurinational State of),BOL,Spain,ESP,0,0,0,5,5
2008,Brazil,BRA,Spain,ESP,0,0,0,11,11
2008,Bosnia and Herzegovina,BIH,Spain,ESP,0,0,10,0,10
2008,Chad,TCD,Spain,ESP,0,0,0,12,12
2008,China,CHN,Spain,ESP,0,0,0,5,5
2008,Cameroon,CMR,Spain,ESP,0,0,13,48,61
2008,Congo,COG,Spain,ESP,0,0,0,18,18
2008,Dem. Rep. of the Congo,COD,Spain,ESP,12,0,23,52,87
2008,Colombia,COL,Spain,ESP,16,5,1083,429,1533
2008,Cuba,CUB,Spain,ESP,10,5,47,70,132
2008,Dominican Rep.,DOM,Spain,ESP,0,0,0,5,5
2008,Ecuador,ECU,Spain,ESP,0,0,5,5,10
2008,Equatorial Guinea,GNQ,Spain,ESP,5,5,10,13,33
2008,Eritrea,ERI,Spain,ESP,0,0,14,15,29
2008,Ethiopia,ETH,Spain,ESP,5,0,5,11,21
2008,Gambia,GMB,Spain,ESP,0,0,11,29,40
2008,Palestinian,PSE,Spain,ESP,20,0,0,12,32
2008,Georgia,GEO,Spain,ESP,0,0,10,11,21
2008,Ghana,GHA,Spain,ESP,0,0,0,30,30
2008,Guinea-Bissau,GNB,Spain,ESP,0,0,0,5,5
2008,Guatemala,GTM,Spain,ESP,0,0,11,0,11
2008,Guinea,GIN,Spain,ESP,0,0,5,80,85
2008,Haiti,HTI,Spain,ESP,5,0,0,0,5
2008,Honduras,HND,Spain,ESP,0,0,0,10,10
2008,Cote d'Ivoire,CIV,Spain,ESP,0,10,183,256,449
2008,India,IND,Spain,ESP,0,0,0,43,43
2008,Iran (Islamic Rep. of),IRN,Spain,ESP,5,0,17,23,45
2008,Iraq,IRQ,Spain,ESP,10,53,46,20,129
2008,Jordan,JOR,Spain,ESP,0,0,0,5,5
2008,Kenya,KEN,Spain,ESP,0,0,0,27,27
2008,Liberia,LBR,Spain,ESP,0,0,0,20,20
2008,Lebanon,LBN,Spain,ESP,0,0,11,5,16
2008,Sri Lanka,LKA,Spain,ESP,0,0,5,0,5
2008,Mauritania,MRT,Spain,ESP,0,0,10,22,32
2008,Mexico,MEX,Spain,ESP,0,0,0,5,5
2008,Mali,MLI,Spain,ESP,0,0,0,12,12
2008,Morocco,MAR,Spain,ESP,5,0,140,81,226
2008,Nepal,NPL,Spain,ESP,0,0,5,5,10
2008,Niger,NER,Spain,ESP,0,0,0,11,11
2008,Nigeria,NGA,Spain,ESP,0,5,97,692,794
2008,Pakistan,PAK,Spain,ESP,5,0,5,17,27
2008,Peru,PER,Spain,ESP,0,0,0,5,5
2008,Russian Federation,RUS,Spain,ESP,14,5,40,30,89
2008,Rwanda,RWA,Spain,ESP,0,0,0,5,5
2008,El Salvador,SLV,Spain,ESP,0,0,5,5,10
2008,Serbia and Kosovo: S/RES/1244 (1999),SRB,Spain,ESP,0,0,0,5,5
2008,Senegal,SEN,Spain,ESP,0,0,5,20,25
2008,Sierra Leone,SLE,Spain,ESP,5,0,5,27,37
2008,Somalia,SOM,Spain,ESP,0,10,13,18,41
2008,Sudan,SDN,Spain,ESP,5,0,128,55,188
2008,Syrian Arab Rep.,SYR,Spain,ESP,14,0,69,46,129
2008,Togo,TGO,Spain,ESP,0,0,0,11,11
2008,Tunisia,TUN,Spain,ESP,0,0,0,5,5
2008,Turkey,TUR,Spain,ESP,0,0,10,17,27
2008,Uganda,UGA,Spain,ESP,0,0,5,10,15
2008,Ukraine,UKR,Spain,ESP,0,0,11,0,11
2008,United States of America,USA,Spain,ESP,0,0,0,5,5
2008,Uzbekistan,UZB,Spain,ESP,0,0,0,5,5
2008,Venezuela (Bolivarian Republic of),VEN,Spain,ESP,0,0,10,16,26
2008,Zimbabwe,ZWE,Spain,ESP,0,0,0,10,10
2008,Stateless,XXA,Spain,ESP,14,10,5,5,34
2008,Central African Rep.,CAF,Sudan,SDN,0,0,0,18,18
2008,Eritrea,ERI,Sudan,SDN,3571,6110,54,24493,34228
2008,Ethiopia,ETH,Sudan,SDN,986,298,10,81,1375
2008,Somalia,SOM,Sudan,SDN,25,312,0,94,431
2008,Afghanistan,AFG,Slovakia,SVK,0,28,25,10,63
2008,Algeria,DZA,Slovakia,SVK,0,0,5,0,5
2008,Armenia,ARM,Slovakia,SVK,0,0,12,14,26
2008,Bangladesh,BGD,Slovakia,SVK,0,0,22,12,34
2008,China,CHN,Slovakia,SVK,0,0,36,10,46
2008,Cuba,CUB,Slovakia,SVK,10,0,0,0,10
2008,Palestinian,PSE,Slovakia,SVK,5,0,0,5,10
2008,Georgia,GEO,Slovakia,SVK,0,0,43,76,119
2008,Croatia,HRV,Slovakia,SVK,0,0,0,5,5
2008,India,IND,Slovakia,SVK,0,0,46,42,88
2008,Iraq,IRQ,Slovakia,SVK,10,25,0,24,59
2008,Sri Lanka,LKA,Slovakia,SVK,0,0,0,5,5
2008,North Macedonia,MKD,Slovakia,SVK,0,0,0,5,5
2008,Rep. of Moldova,MDA,Slovakia,SVK,0,0,45,70,115
2008,Nigeria,NGA,Slovakia,SVK,0,0,5,0,5
2008,Pakistan,PAK,Slovakia,SVK,0,0,67,44,111
2008,Russian Federation,RUS,Slovakia,SVK,0,0,34,84,118
2008,Serbia and Kosovo: S/RES/1244 (1999),SRB,Slovakia,SVK,0,0,0,14,14
2008,Viet Nam,VNM,Slovakia,SVK,0,0,20,23,43
2008,Syrian Arab Rep.,SYR,Slovakia,SVK,0,0,0,5,5
2008,Tajikistan,TJK,Slovakia,SVK,0,0,5,0,5
2008,Turkey,TUR,Slovakia,SVK,0,0,5,0,5
2008,Ukraine,UKR,Slovakia,SVK,0,5,20,11,36
2008,Albania,ALB,Slovenia,SVN,0,0,0,5,5
2008,Bosnia and Herzegovina,BIH,Slovenia,SVN,0,0,15,11,26
2008,Cuba,CUB,Slovenia,SVN,0,0,0,5,5
2008,Croatia,HRV,Slovenia,SVN,0,0,5,0,5
2008,India,IND,Slovenia,SVN,0,0,5,0,5
2008,Iran (Islamic Rep. of),IRN,Slovenia,SVN,0,0,11,5,16
2008,Kazakhstan,KAZ,Slovenia,SVN,0,0,11,0,11
2008,North Macedonia,MKD,Slovenia,SVN,0,0,5,5,10
2008,Nigeria,NGA,Slovenia,SVN,0,0,5,0,5
2008,Pakistan,PAK,Slovenia,SVN,0,0,0,5,5
2008,Russian Federation,RUS,Slovenia,SVN,0,0,11,0,11
2008,Serbia and Kosovo: S/RES/1244 (1999),SRB,Slovenia,SVN,0,0,64,58,122
2008,Turkey,TUR,Slovenia,SVN,0,0,19,54,73
2008,Afghanistan,AFG,Sweden,SWE,50,332,326,24,732
2008,Albania,ALB,Sweden,SWE,0,0,93,20,113
2008,Algeria,DZA,Sweden,SWE,0,10,80,31,121
2008,Angola,AGO,Sweden,SWE,0,10,14,0,24
2008,Egypt,EGY,Sweden,SWE,0,0,81,11,92
2008,Argentina,ARG,Sweden,SWE,0,0,5,0,5
2008,Armenia,ARM,Sweden,SWE,0,56,175,35,266
2008,Azerbaijan,AZE,Sweden,SWE,14,52,256,56,378
2008,Bahrain,BHR,Sweden,SWE,0,0,0,5,5
2008,Burundi,BDI,Sweden,SWE,5,21,157,10,193
2008,Bangladesh,BGD,Sweden,SWE,5,10,79,5,99
2008,Bhutan,BTN,Sweden,SWE,5,0,0,0,5
2008,Burkina Faso,BFA,Sweden,SWE,0,0,5,0,5
2008,Belarus,BLR,Sweden,SWE,0,10,225,128,363
2008,Bolivia (Plurinational State of),BOL,Sweden,SWE,0,5,105,13,123
2008,Bosnia and Herzegovina,BIH,Sweden,SWE,0,24,120,24,168
2008,Bulgaria,BGR,Sweden,SWE,0,0,18,0,18
2008,China,CHN,Sweden,SWE,5,5,41,13,64
2008,Chile,CHL,Sweden,SWE,0,5,48,5,58
2008,Cameroon,CMR,Sweden,SWE,5,0,33,5,43
2008,Congo,COG,Sweden,SWE,0,0,15,0,15
2008,Dem. Rep. of the Congo,COD,Sweden,SWE,5,5,59,5,74
2008,Colombia,COL,Sweden,SWE,5,0,5,0,10
2008,Cuba,CUB,Sweden,SWE,0,10,16,0,26
2008,Czechia,CZE,Sweden,SWE,0,0,5,0,5
2008,Ecuador,ECU,Sweden,SWE,0,0,15,0,15
2008,Eritrea,ERI,Sweden,SWE,157,455,202,36,850
2008,Estonia,EST,Sweden,SWE,0,0,5,0,5
2008,Ethiopia,ETH,Sweden,SWE,13,24,149,5,191
2008,Gambia,GMB,Sweden,SWE,0,5,14,0,19
2008,Georgia,GEO,Sweden,SWE,0,10,83,17,110
2008,Ghana,GHA,Sweden,SWE,0,0,16,5,21
2008,Guatemala,GTM,Sweden,SWE,0,0,5,0,5
2008,Guinea,GIN,Sweden,SWE,5,5,27,0,37
2008,Croatia,HRV,Sweden,SWE,0,0,20,0,20
2008,Hungary,HUN,Sweden,SWE,0,0,5,0,5
2008,Cote d'Ivoire,CIV,Sweden,SWE,0,0,36,0,36
2008,India,IND,Sweden,SWE,0,5,43,26,74
2008,Indonesia,IDN,Sweden,SWE,0,0,25,5,30
2008,Iran (Islamic Rep. of),IRN,Sweden,SWE,100,46,461,65,672
2008,Iraq,IRQ,Sweden,SWE,680,3196,7461,1122,12459
2008,Israel,ISR,Sweden,SWE,0,5,28,0,33
2008,Jordan,JOR,Sweden,SWE,5,54,77,22,158
2008,Kazakhstan,KAZ,Sweden,SWE,0,14,131,25,170
2008,Kenya,KEN,Sweden,SWE,0,5,39,5,49
2008,Kyrgyzstan,KGZ,Sweden,SWE,0,5,40,5,50
2008,Dem. People's Rep. of Korea,PRK,Sweden,SWE,0,0,0,5,5
2008,Liberia,LBR,Sweden,SWE,0,0,12,0,12
2008,Libya,LBY,Sweden,SWE,5,5,339,138,487
2008,Lebanon,LBN,Sweden,SWE,0,14,407,77,498
2008,Sri Lanka,LKA,Sweden,SWE,0,12,21,5,38
2008,Latvia,LVA,Sweden,SWE,0,0,12,0,12
2008,North Macedonia,MKD,Sweden,SWE,0,0,29,19,48
2008,Rep. of Moldova,MDA,Sweden,SWE,0,0,14,5,19
2008,Mali,MLI,Sweden,SWE,0,0,5,0,5
2008,Mongolia,MNG,Sweden,SWE,0,12,702,42,756
2008,Morocco,MAR,Sweden,SWE,0,0,43,14,57
2008,Montenegro,MNE,Sweden,SWE,0,5,50,10,65
2008,Myanmar,MMR,Sweden,SWE,0,0,5,0,5
2008,Nepal,NPL,Sweden,SWE,0,0,43,5,48
2008,Niger,NER,Sweden,SWE,0,0,5,0,5
2008,Nicaragua,NIC,Sweden,SWE,0,0,49,0,49
2008,Nigeria,NGA,Sweden,SWE,0,16,95,29,140
2008,Pakistan,PAK,Sweden,SWE,0,16,38,14,68
2008,Paraguay,PRY,Sweden,SWE,0,0,10,0,10
2008,Peru,PER,Sweden,SWE,0,0,19,0,19
2008,Philippines,PHL,Sweden,SWE,0,0,0,5,5
2008,Romania,ROU,Sweden,SWE,0,5,19,5,29
2008,Russian Federation,RUS,Sweden,SWE,16,104,504,142,766
2008,Rwanda,RWA,Sweden,SWE,0,5,12,0,17
2008,El Salvador,SLV,Sweden,SWE,0,0,61,5,66
2008,Serbia and Kosovo: S/RES/1244 (1999),SRB,Sweden,SWE,54,212,1646,304,2216
2008,Senegal,SEN,Sweden,SWE,0,0,16,0,16
2008,Sierra Leone,SLE,Sweden,SWE,0,5,13,5,23
2008,Somalia,SOM,Sweden,SWE,355,1178,663,171,2367
2008,Viet Nam,VNM,Sweden,SWE,0,11,53,10,74
2008,Sudan,SDN,Sweden,SWE,29,12,31,0,72
2008,Slovakia,SVK,Sweden,SWE,0,0,0,5,5
2008,Syrian Arab Rep.,SYR,Sweden,SWE,36,27,411,45,519
2008,United Rep. of Tanzania,TZA,Sweden,SWE,0,0,11,0,11
2008,Thailand,THA,Sweden,SWE,0,0,11,0,11
2008,Tajikistan,TJK,Sweden,SWE,0,0,12,0,12
2008,Turkmenistan,TKM,Sweden,SWE,0,0,11,0,11
2008,Togo,TGO,Sweden,SWE,0,5,13,0,18
2008,Tunisia,TUN,Sweden,SWE,0,0,59,19,78
2008,Turkey,TUR,Sweden,SWE,5,23,218,50,296
2008,Uganda,UGA,Sweden,SWE,5,0,30,5,40
2008,Ukraine,UKR,Sweden,SWE,0,5,35,14,54
2008,United States of America,USA,Sweden,SWE,0,0,5,0,5
2008,Uzbekistan,UZB,Sweden,SWE,5,27,535,70,637
2008,Venezuela (Bolivarian Republic of),VEN,Sweden,SWE,0,0,10,0,10
2008,Yemen,YEM,Sweden,SWE,12,0,63,14,89
2008,Zimbabwe,ZWE,Sweden,SWE,5,0,11,0,16
2008,Stateless,XXA,Sweden,SWE,137,308,562,136,1143
2008,Afghanistan,AFG,Switzerland,CHE,21,182,228,80,511
2008,Albania,ALB,Switzerland,CHE,5,0,10,22,37
2008,Algeria,DZA,Switzerland,CHE,5,10,18,157,190
2008,Angola,AGO,Switzerland,CHE,0,146,102,19,267
2008,Egypt,EGY,Switzerland,CHE,5,0,0,10,15
2008,Armenia,ARM,Switzerland,CHE,0,13,46,24,83
2008,Azerbaijan,AZE,Switzerland,CHE,0,10,13,14,37
2008,Burundi,BDI,Switzerland,CHE,0,0,11,0,11
2008,Benin,BEN,Switzerland,CHE,5,5,0,18,28
2008,Bangladesh,BGD,Switzerland,CHE,0,11,21,19,51
2008,Bhutan,BTN,Switzerland,CHE,0,0,0,5,5
2008,Burkina Faso,BFA,Switzerland,CHE,0,0,5,13,18
2008,Belarus,BLR,Switzerland,CHE,0,0,10,26,36
2008,Bolivia (Plurinational State of),BOL,Switzerland,CHE,0,0,5,0,5
2008,Bosnia and Herzegovina,BIH,Switzerland,CHE,14,162,78,54,308
2008,Bulgaria,BGR,Switzerland,CHE,0,5,0,10,15
2008,Cambodia,KHM,Switzerland,CHE,5,0,0,0,5
2008,Central African Rep.,CAF,Switzerland,CHE,0,5,0,0,5
2008,Chad,TCD,Switzerland,CHE,0,0,0,5,5
2008,China,CHN,Switzerland,CHE,27,260,200,20,507
2008,Cameroon,CMR,Switzerland,CHE,16,28,67,24,135
2008,Congo,COG,Switzerland,CHE,5,5,12,0,22
2008,Dem. Rep. of the Congo,COD,Switzerland,CHE,5,200,178,57,440
2008,Colombia,COL,Switzerland,CHE,40,5,5,5,55
2008,Cuba,CUB,Switzerland,CHE,0,12,0,0,12
2008,Czechia,CZE,Switzerland,CHE,0,0,0,5,5
2008,Eritrea,ERI,Switzerland,CHE,950,492,435,141,2018
2008,Ethiopia,ETH,Switzerland,CHE,28,147,221,63,459
2008,France,FRA,Switzerland,CHE,0,0,0,5,5
2008,Gabon,GAB,Switzerland,CHE,0,0,0,5,5
2008,Gambia,GMB,Switzerland,CHE,0,0,38,100,138
2008,Georgia,GEO,Switzerland,CHE,0,5,40,315,360
2008,Ghana,GHA,Switzerland,CHE,0,0,0,14,14
2008,Guinea-Bissau,GNB,Switzerland,CHE,0,0,5,31,36
2008,Guinea,GIN,Switzerland,CHE,5,5,39,131,180
2008,Haiti,HTI,Switzerland,CHE,0,5,0,0,5
2008,Croatia,HRV,Switzerland,CHE,0,0,0,5,5
2008,Cote d'Ivoire,CIV,Switzerland,CHE,0,14,49,76,139
2008,India,IND,Switzerland,CHE,0,5,0,15,20
2008,Iran (Islamic Rep. of),IRN,Switzerland,CHE,51,110,159,97,417
2008,Iraq,IRQ,Switzerland,CHE,164,574,360,376,1474
2008,Israel,ISR,Switzerland,CHE,0,0,0,5,5
2008,Italy,ITA,Switzerland,CHE,0,0,0,5,5
2008,Jamaica,JAM,Switzerland,CHE,0,0,0,5,5
2008,Jordan,JOR,Switzerland,CHE,0,14,0,0,14
2008,Kazakhstan,KAZ,Switzerland,CHE,0,0,0,5,5
2008,Kenya,KEN,Switzerland,CHE,0,0,5,13,18
2008,Kyrgyzstan,KGZ,Switzerland,CHE,5,5,0,0,10
2008,Liberia,LBR,Switzerland,CHE,5,12,5,19,41
2008,Libya,LBY,Switzerland,CHE,10,5,16,13,44
2008,Lebanon,LBN,Switzerland,CHE,0,13,5,38,56
2008,Sri Lanka,LKA,Switzerland,CHE,170,354,243,107,874
2008,Mauritania,MRT,Switzerland,CHE,0,0,5,12,17
2008,North Macedonia,MKD,Switzerland,CHE,0,28,28,57,113
2008,Rep. of Moldova,MDA,Switzerland,CHE,0,0,5,14,19
2008,Mexico,MEX,Switzerland,CHE,0,0,5,0,5
2008,Mali,MLI,Switzerland,CHE,0,0,0,24,24
2008,Mongolia,MNG,Switzerland,CHE,0,10,43,88,141
2008,Morocco,MAR,Switzerland,CHE,5,5,5,30,45
2008,Montenegro,MNE,Switzerland,CHE,0,5,0,27,32
2008,Myanmar,MMR,Switzerland,CHE,0,5,5,0,10
2008,Nepal,NPL,Switzerland,CHE,0,11,5,5,21
2008,Niger,NER,Switzerland,CHE,0,0,0,13,13
2008,Nigeria,NGA,Switzerland,CHE,0,14,58,607,679
2008,Pakistan,PAK,Switzerland,CHE,10,19,26,31,86
2008,Romania,ROU,Switzerland,CHE,5,0,5,25,35
2008,South Africa,ZAF,Switzerland,CHE,0,5,12,5,22
2008,Russian Federation,RUS,Switzerland,CHE,27,93,68,142,330
2008,Rwanda,RWA,Switzerland,CHE,5,13,5,0,23
2008,Serbia and Kosovo: S/RES/1244 (1999),SRB,Switzerland,CHE,37,395,589,371,1392
2008,Senegal,SEN,Switzerland,CHE,0,0,0,31,31
2008,Sierra Leone,SLE,Switzerland,CHE,0,5,0,17,22
2008,Somalia,SOM,Switzerland,CHE,18,305,284,109,716
2008,Spain,ESP,Switzerland,CHE,0,0,0,5,5
2008,Viet Nam,VNM,Switzerland,CHE,11,5,0,0,16
2008,Sudan,SDN,Switzerland,CHE,5,19,31,31,86
2008,Slovakia,SVK,Switzerland,CHE,0,0,0,5,5
2008,Switzerland,CHE,Switzerland,CHE,0,0,0,5,5
2008,Syrian Arab Rep.,SYR,Switzerland,CHE,57,180,171,51,459
2008,Turkmenistan,TKM,Switzerland,CHE,0,5,0,0,5
2008,Togo,TGO,Switzerland,CHE,54,5,48,11,118
2008,Tunisia,TUN,Switzerland,CHE,23,10,13,41,87
2008,Turkey,TUR,Switzerland,CHE,302,192,189,119,802
2008,Uganda,UGA,Switzerland,CHE,0,0,0,13,13
2008,Ukraine,UKR,Switzerland,CHE,0,5,18,14,37
2008,United States of America,USA,Switzerland,CHE,0,5,0,0,5
2008,Uzbekistan,UZB,Switzerland,CHE,5,0,0,5,10
2008,Western Sahara,ESH,Switzerland,CHE,0,0,5,0,5
2008,Yemen,YEM,Switzerland,CHE,30,38,24,10,102
2008,Zimbabwe,ZWE,Switzerland,CHE,0,5,0,28,33
2008,Stateless,XXA,Switzerland,CHE,11,17,18,35,81
2008,Central African Rep.,CAF,Togo,TGO,0,0,5,0,5
2008,Chad,TCD,Togo,TGO,0,0,11,0,11
2008,Congo,COG,Togo,TGO,0,0,10,0,10
2008,Dem. Rep. of the Congo,COD,Togo,TGO,0,0,34,0,34
2008,Cote d'Ivoire,CIV,Togo,TGO,5,0,11,0,16
2008,Sri Lanka,LKA,Togo,TGO,10,0,0,0,10
2008,Rwanda,RWA,Togo,TGO,5,0,0,0,5
2008,Burundi,BDI,Uganda,UGA,804,0,262,0,1066
2008,Dem. Rep. of the Congo,COD,Uganda,UGA,3650,0,159,0,3809
2008,Eritrea,ERI,Uganda,UGA,1079,0,19,0,1098
2008,Ethiopia,ETH,Uganda,UGA,349,0,164,0,513
2008,Kenya,KEN,Uganda,UGA,16,0,5,0,21
2008,Pakistan,PAK,Uganda,UGA,5,0,0,0,5
2008,Rwanda,RWA,Uganda,UGA,194,0,373,1402,1775
2008,Somalia,SOM,Uganda,UGA,1330,0,70,0,1400
2008,Sudan,SDN,Uganda,UGA,176,0,22,0,198
2008,Afghanistan,AFG,Ukraine,UKR,57,0,153,211,421
2008,Algeria,DZA,Ukraine,UKR,0,0,0,10,10
2008,Armenia,ARM,Ukraine,UKR,5,0,11,5,21
2008,Azerbaijan,AZE,Ukraine,UKR,5,0,5,11,21
2008,Bangladesh,BGD,Ukraine,UKR,5,0,18,104,127
2008,Belarus,BLR,Ukraine,UKR,13,0,0,5,18
2008,Cameroon,CMR,Ukraine,UKR,0,0,5,5,10
2008,Congo,COG,Ukraine,UKR,0,0,13,0,13
2008,Dem. Rep. of the Congo,COD,Ukraine,UKR,0,0,10,13,23
2008,Cuba,CUB,Ukraine,UKR,0,0,0,5,5
2008,Ethiopia,ETH,Ukraine,UKR,0,0,0,5,5
2008,Palestinian,PSE,Ukraine,UKR,0,0,14,44,58
2008,Georgia,GEO,Ukraine,UKR,0,0,17,27,44
2008,Ghana,GHA,Ukraine,UKR,0,0,0,5,5
2008,Guinea,GIN,Ukraine,UKR,0,0,5,0,5
2008,Cote d'Ivoire,CIV,Ukraine,UKR,0,0,5,0,5
2008,India,IND,Ukraine,UKR,0,0,0,175,175
2008,Iran (Islamic Rep. of),IRN,Ukraine,UKR,0,0,20,10,30
2008,Iraq,IRQ,Ukraine,UKR,10,0,70,58,138
2008,Jordan,JOR,Ukraine,UKR,0,0,0,5,5
2008,Kenya,KEN,Ukraine,UKR,0,0,0,5,5
2008,Liberia,LBR,Ukraine,UKR,0,0,5,0,5
2008,Lebanon,LBN,Ukraine,UKR,0,0,0,11,11
2008,Sri Lanka,LKA,Ukraine,UKR,0,0,14,38,52
2008,Rep. of Moldova,MDA,Ukraine,UKR,0,0,0,5,5
2008,Nigeria,NGA,Ukraine,UKR,0,0,14,5,19
2008,Pakistan,PAK,Ukraine,UKR,0,0,10,578,588
2008,Russian Federation,RUS,Ukraine,UKR,13,0,31,30,74
2008,Somalia,SOM,Ukraine,UKR,0,0,68,100,168
2008,Viet Nam,VNM,Ukraine,UKR,0,0,0,63,63
2008,Sudan,SDN,Ukraine,UKR,0,0,10,5,15
2008,Syrian Arab Rep.,SYR,Ukraine,UKR,5,0,16,5,26
2008,Turkmenistan,TKM,Ukraine,UKR,0,0,0,5,5
2008,Tunisia,TUN,Ukraine,UKR,0,0,0,5,5
2008,Turkey,TUR,Ukraine,UKR,0,0,5,5,10
2008,Uzbekistan,UZB,Ukraine,UKR,5,0,24,26,55
2008,Zimbabwe,ZWE,Ukraine,UKR,0,0,0,5,5
2008,Stateless,XXA,Ukraine,UKR,0,0,5,5,10
2008,Colombia,COL,Uruguay,URY,0,0,5,0,5
2008,Nigeria,NGA,Uruguay,URY,0,0,5,0,5
2008,Colombia,COL,Venezuela (Bolivarian Republic of),VEN,287,0,324,0,611
2008,Ecuador,ECU,Venezuela (Bolivarian Republic of),VEN,5,0,0,0,5
2008,Palestinian,PSE,Venezuela (Bolivarian Republic of),VEN,0,0,5,0,5
2008,Burundi,BDI,Zimbabwe,ZWE,19,0,0,65,84
2008,Dem. Rep. of the Congo,COD,Zimbabwe,ZWE,194,0,0,584,778
2008,Eritrea,ERI,Zimbabwe,ZWE,0,0,0,5,5
2008,Rwanda,RWA,Zimbabwe,ZWE,5,0,0,38,43
2008,Somalia,SOM,Zimbabwe,ZWE,0,0,0,5,5
2008,Uganda,UGA,Zimbabwe,ZWE,5,0,0,0,5
2009,Chad,TCD,Angola,AGO,11,0,31,0,42
2009,Congo,COG,Angola,AGO,0,0,0,59,59
2009,Dem. Rep. of the Congo,COD,Angola,AGO,0,0,5,0,5
2009,Eritrea,ERI,Angola,AGO,0,0,10,95,105
2009,Guinea-Bissau,GNB,Angola,AGO,0,0,5,0,5
2009,Guinea,GIN,Angola,AGO,10,0,20,0,30
2009,Cote d'Ivoire,CIV,Angola,AGO,37,0,72,286,395
2009,Liberia,LBR,Angola,AGO,0,0,13,0,13
2009,Mauritania,MRT,Angola,AGO,40,0,58,0,98
2009,Rwanda,RWA,Angola,AGO,137,0,0,0,137
2009,Sierra Leone,SLE,Angola,AGO,5,0,5,0,10
2009,Somalia,SOM,Angola,AGO,5,0,11,0,16
2009,Sudan,SDN,Angola,AGO,36,0,38,0,74
2009,United Rep. of Tanzania,TZA,Angola,AGO,0,0,0,14,14
2009,Western Sahara,ESH,Angola,AGO,0,0,13,0,13
2009,Armenia,ARM,Argentina,ARG,5,0,0,0,5
2009,Burundi,BDI,Argentina,ARG,5,0,0,0,5
2009,Bangladesh,BGD,Argentina,ARG,0,0,15,0,15
2009,Bolivia (Plurinational State of),BOL,Argentina,ARG,0,0,5,0,5
2009,China,CHN,Argentina,ARG,0,0,5,0,5
2009,Chile,CHL,Argentina,ARG,0,0,0,5,5
2009,Cameroon,CMR,Argentina,ARG,0,0,0,10,10
2009,Congo,COG,Argentina,ARG,0,0,0,5,5
2009,Colombia,COL,Argentina,ARG,29,0,20,50,99
2009,Cuba,CUB,Argentina,ARG,14,0,10,13,37
2009,Dominican Rep.,DOM,Argentina,ARG,0,0,258,10,268
2009,Eritrea,ERI,Argentina,ARG,0,0,0,5,5
2009,Ghana,GHA,Argentina,ARG,5,0,0,0,5
2009,Guinea,GIN,Argentina,ARG,5,0,0,0,5
2009,Haiti,HTI,Argentina,ARG,5,0,12,0,17
2009,Cote d'Ivoire,CIV,Argentina,ARG,12,0,0,0,12
2009,India,IND,Argentina,ARG,0,0,0,11,11
2009,Iraq,IRQ,Argentina,ARG,5,0,0,0,5
2009,Kazakhstan,KAZ,Argentina,ARG,5,0,0,0,5
2009,Sri Lanka,LKA,Argentina,ARG,5,0,0,0,5
2009,Mexico,MEX,Argentina,ARG,0,0,0,5,5
2009,Nigeria,NGA,Argentina,ARG,11,0,0,12,23
2009,Pakistan,PAK,Argentina,ARG,5,0,0,5,10
2009,Peru,PER,Argentina,ARG,5,0,5,16,26
2009,Russian Federation,RUS,Argentina,ARG,0,0,0,5,5
2009,Senegal,SEN,Argentina,ARG,0,0,134,72,206
2009,Georgia,GEO,Armenia,ARM,0,5,107,10,122
2009,Iran (Islamic Rep. of),IRN,Armenia,ARM,13,0,0,5,18
2009,Iraq,IRQ,Armenia,ARM,0,33,0,23,56
2009,Afghanistan,AFG,Australia,AUS,912,0,0,5,917
2009,Albania,ALB,Australia,AUS,5,0,13,5,23
2009,Algeria,DZA,Australia,AUS,0,0,5,5,10
2009,Egypt,EGY,Australia,AUS,56,0,60,61,177
2009,Argentina,ARG,Australia,AUS,0,0,0,5,5
2009,Bahrain,BHR,Australia,AUS,5,0,0,0,5
2009,Burundi,BDI,Australia,AUS,5,0,0,0,5
2009,Bangladesh,BGD,Australia,AUS,23,0,50,49,122
2009,Brazil,BRA,Australia,AUS,0,0,5,5,10
2009,Bulgaria,BGR,Australia,AUS,0,0,0,11,11
2009,Cambodia,KHM,Australia,AUS,5,0,5,0,10
2009,China,CHN,Australia,AUS,211,0,913,925,2049
2009,Cameroon,CMR,Australia,AUS,13,0,5,5,23
2009,Congo,COG,Australia,AUS,5,0,0,5,10
2009,Colombia,COL,Australia,AUS,10,0,20,22,52
2009,Eritrea,ERI,Australia,AUS,10,0,0,0,10
2009,Ethiopia,ETH,Australia,AUS,18,0,14,14,46
2009,Fiji,FJI,Australia,AUS,11,0,134,136,281
2009,France,FRA,Australia,AUS,0,0,0,5,5
2009,Gambia,GMB,Australia,AUS,0,0,0,5,5
2009,Palestinian,PSE,Australia,AUS,11,0,5,5,21
2009,United Kingdom of Great Britain and Northern Ireland,GBR,Australia,AUS,0,0,5,12,17
2009,Georgia,GEO,Australia,AUS,5,0,0,0,5
2009,Germany,DEU,Australia,AUS,0,0,10,13,23
2009,Ghana,GHA,Australia,AUS,0,0,11,12,23
2009,Guinea,GIN,Australia,AUS,0,0,5,5,10
2009,"China, Hong Kong SAR",HKG,Australia,AUS,0,0,5,5,10
2009,India,IND,Australia,AUS,5,0,250,254,509
2009,Indonesia,IDN,Australia,AUS,32,0,173,178,383
2009,Iran (Islamic Rep. of),IRN,Australia,AUS,207,0,21,21,249
2009,Iraq,IRQ,Australia,AUS,258,0,16,23,297
2009,Israel,ISR,Australia,AUS,0,0,11,12,23
2009,Italy,ITA,Australia,AUS,0,0,0,5,5
2009,Jordan,JOR,Australia,AUS,12,0,19,19,50
2009,Japan,JPN,Australia,AUS,0,0,0,5,5
2009,Kenya,KEN,Australia,AUS,0,0,18,18,36
2009,Rep. of Korea,KOR,Australia,AUS,5,0,108,109,222
2009,Dem. People's Rep. of Korea,PRK,Australia,AUS,0,0,21,22,43
2009,Kuwait,KWT,Australia,AUS,5,0,0,0,5
2009,Liberia,LBR,Australia,AUS,5,0,0,0,5
2009,Libya,LBY,Australia,AUS,5,0,0,0,5
2009,Lebanon,LBN,Australia,AUS,14,0,90,95,199
2009,Sri Lanka,LKA,Australia,AUS,408,0,99,103,610
2009,North Macedonia,MKD,Australia,AUS,0,0,5,13,18
2009,Malaysia,MYS,Australia,AUS,0,0,217,219,436
2009,Mongolia,MNG,Australia,AUS,5,0,12,13,30
2009,Morocco,MAR,Australia,AUS,0,0,5,5,10
2009,Mauritius,MUS,Australia,AUS,0,0,5,0,5
2009,Myanmar,MMR,Australia,AUS,72,0,21,22,115
2009,Namibia,NAM,Australia,AUS,0,0,5,0,5
2009,Nepal,NPL,Australia,AUS,15,0,11,11,37
2009,Nigeria,NGA,Australia,AUS,17,0,27,27,71
2009,New Zealand,NZL,Australia,AUS,0,0,10,0,10
2009,Pakistan,PAK,Australia,AUS,151,0,67,70,288
2009,Peru,PER,Australia,AUS,0,0,0,14,14
2009,Philippines,PHL,Australia,AUS,0,0,34,34,68
2009,Papua New Guinea,PNG,Australia,AUS,23,0,5,10,38
2009,Romania,ROU,Australia,AUS,5,0,0,10,15
2009,South Africa,ZAF,Australia,AUS,5,0,18,19,42
2009,Russian Federation,RUS,Australia,AUS,0,0,5,12,17
2009,Rwanda,RWA,Australia,AUS,0,0,5,12,17
2009,El Salvador,SLV,Australia,AUS,0,0,5,5,10
2009,Serbia and Kosovo: S/RES/1244 (1999),SRB,Australia,AUS,0,0,0,5,5
2009,Sierra Leone,SLE,Australia,AUS,5,0,10,11,26
2009,Somalia,SOM,Australia,AUS,14,0,5,5,24
2009,Viet Nam,VNM,Australia,AUS,5,0,32,33,70
2009,Sudan,SDN,Australia,AUS,5,0,0,5,10
2009,Syrian Arab Rep.,SYR,Australia,AUS,5,0,10,11,26
2009,United Rep. of Tanzania,TZA,Australia,AUS,0,0,5,10,15
2009,Thailand,THA,Australia,AUS,0,0,0,14,14
2009,Tonga,TON,Australia,AUS,0,0,20,21,41
2009,Turkey,TUR,Australia,AUS,21,0,27,27,75
2009,Uganda,UGA,Australia,AUS,5,0,0,5,10
2009,Ukraine,UKR,Australia,AUS,0,0,0,5,5
2009,United States of America,USA,Australia,AUS,0,0,5,12,17
2009,Uzbekistan,UZB,Australia,AUS,0,0,0,14,14
2009,Venezuela (Bolivarian Republic of),VEN,Australia,AUS,5,0,0,0,5
2009,Zambia,ZMB,Australia,AUS,0,0,0,5,5
2009,Zimbabwe,ZWE,Australia,AUS,244,0,80,86,410
2009,Stateless,XXA,Australia,AUS,50,0,5,10,65
2009,Tibetan,TIB,Australia,AUS,5,0,0,0,5
2009,Afghanistan,AFG,Azerbaijan,AZE,0,0,108,0,108
2009,Iran (Islamic Rep. of),IRN,Azerbaijan,AZE,5,0,17,0,22
2009,Iraq,IRQ,Azerbaijan,AZE,0,0,5,0,5
2009,Pakistan,PAK,Azerbaijan,AZE,0,0,76,0,76
2009,Dem. Rep. of the Congo,COD,Burundi,BDI,2630,0,237,5,2872
2009,Rwanda,RWA,Burundi,BDI,0,5,0,0,5
2009,Afghanistan,AFG,Belgium,BEL,172,113,314,10,609
2009,Albania,ALB,Belgium,BEL,38,0,141,14,193
2009,Algeria,DZA,Belgium,BEL,10,0,130,26,166
2009,Angola,AGO,Belgium,BEL,10,0,106,0,116
2009,Egypt,EGY,Belgium,BEL,0,0,29,0,29
2009,Armenia,ARM,Belgium,BEL,12,5,725,43,785
2009,Azerbaijan,AZE,Belgium,BEL,0,0,19,5,24
2009,Burundi,BDI,Belgium,BEL,43,0,39,0,82
2009,Benin,BEN,Belgium,BEL,0,0,14,0,14
2009,Bangladesh,BGD,Belgium,BEL,0,0,45,5,50
2009,Bhutan,BTN,Belgium,BEL,0,0,10,0,10
2009,Burkina Faso,BFA,Belgium,BEL,10,0,19,0,29
2009,Belarus,BLR,Belgium,BEL,10,0,22,5,37
2009,Bosnia and Herzegovina,BIH,Belgium,BEL,5,5,50,5,65
2009,Bulgaria,BGR,Belgium,BEL,0,0,85,5,90
2009,Central African Rep.,CAF,Belgium,BEL,5,0,0,0,5
2009,Chad,TCD,Belgium,BEL,14,0,0,0,14
2009,China,CHN,Belgium,BEL,127,0,34,5,166
2009,Cameroon,CMR,Belgium,BEL,84,0,239,15,338
2009,Congo,COG,Belgium,BEL,0,0,13,0,13
2009,Dem. Rep. of the Congo,COD,Belgium,BEL,107,10,515,25,657
2009,Colombia,COL,Belgium,BEL,5,0,0,0,5
2009,Cuba,CUB,Belgium,BEL,0,0,5,0,5
2009,Cyprus,CYP,Belgium,BEL,0,0,0,5,5
2009,Czechia,CZE,Belgium,BEL,0,0,26,5,31
2009,Djibouti,DJI,Belgium,BEL,12,0,16,5,33
2009,Dominican Rep.,DOM,Belgium,BEL,0,0,10,0,10
2009,Equatorial Guinea,GNQ,Belgium,BEL,0,0,5,0,5
2009,Eritrea,ERI,Belgium,BEL,27,0,5,0,32
2009,Ethiopia,ETH,Belgium,BEL,13,0,30,0,43
2009,Gambia,GMB,Belgium,BEL,5,0,17,0,22
2009,Palestinian,PSE,Belgium,BEL,0,0,10,5,15
2009,Georgia,GEO,Belgium,BEL,5,0,80,19,104
2009,Ghana,GHA,Belgium,BEL,5,0,5,0,10
2009,Guatemala,GTM,Belgium,BEL,0,0,5,0,5
2009,Guinea,GIN,Belgium,BEL,261,5,362,15,643
2009,Croatia,HRV,Belgium,BEL,0,0,5,0,5
2009,Hungary,HUN,Belgium,BEL,0,0,124,14,138
2009,Cote d'Ivoire,CIV,Belgium,BEL,24,0,35,0,59
2009,India,IND,Belgium,BEL,0,0,37,0,37
2009,Iran (Islamic Rep. of),IRN,Belgium,BEL,95,0,211,11,317
2009,Iraq,IRQ,Belgium,BEL,312,299,204,40,855
2009,Israel,ISR,Belgium,BEL,11,0,0,0,11
2009,Jordan,JOR,Belgium,BEL,5,0,5,0,10
2009,Kazakhstan,KAZ,Belgium,BEL,0,0,14,0,14
2009,Kenya,KEN,Belgium,BEL,10,0,50,0,60
2009,Dem. People's Rep. of Korea,PRK,Belgium,BEL,5,0,0,0,5
2009,Liberia,LBR,Belgium,BEL,5,0,14,0,19
2009,Lebanon,LBN,Belgium,BEL,11,0,61,10,82
2009,Sri Lanka,LKA,Belgium,BEL,68,0,40,0,108
2009,Mauritania,MRT,Belgium,BEL,43,0,122,5,170
2009,North Macedonia,MKD,Belgium,BEL,0,0,109,34,143
2009,Rep. of Moldova,MDA,Belgium,BEL,0,0,5,5,10
2009,Mali,MLI,Belgium,BEL,0,0,5,0,5
2009,Mongolia,MNG,Belgium,BEL,0,0,37,5,42
2009,Morocco,MAR,Belgium,BEL,5,0,12,10,27
2009,Montenegro,MNE,Belgium,BEL,10,0,10,5,25
2009,Nepal,NPL,Belgium,BEL,0,0,26,0,26
2009,Niger,NER,Belgium,BEL,21,0,27,5,53
2009,Nigeria,NGA,Belgium,BEL,0,0,65,0,65
2009,Pakistan,PAK,Belgium,BEL,5,0,99,10,114
2009,Poland,POL,Belgium,BEL,0,0,5,0,5
2009,Romania,ROU,Belgium,BEL,0,0,94,0,94
2009,Russian Federation,RUS,Belgium,BEL,302,0,1163,67,1532
2009,Rwanda,RWA,Belgium,BEL,139,0,108,10,257
2009,Serbia and Kosovo: S/RES/1244 (1999),SRB,Belgium,BEL,129,0,996,111,1236
2009,Senegal,SEN,Belgium,BEL,25,0,42,0,67
2009,Sierra Leone,SLE,Belgium,BEL,5,0,20,0,25
2009,Somalia,SOM,Belgium,BEL,25,21,80,5,131
2009,Viet Nam,VNM,Belgium,BEL,0,0,10,0,10
2009,Sudan,SDN,Belgium,BEL,19,11,29,10,69
2009,Slovakia,SVK,Belgium,BEL,0,0,304,17,321
2009,Syrian Arab Rep.,SYR,Belgium,BEL,50,0,116,12,178
2009,United Rep. of Tanzania,TZA,Belgium,BEL,10,0,29,0,39
2009,Tajikistan,TJK,Belgium,BEL,0,0,5,0,5
2009,Togo,TGO,Belgium,BEL,16,0,124,5,145
2009,Tunisia,TUN,Belgium,BEL,0,0,12,0,12
2009,Turkey,TUR,Belgium,BEL,56,0,207,30,293
2009,Uganda,UGA,Belgium,BEL,5,0,13,0,18
2009,Ukraine,UKR,Belgium,BEL,0,0,20,10,30
2009,Uzbekistan,UZB,Belgium,BEL,5,0,5,5,15
2009,Yemen,YEM,Belgium,BEL,0,0,12,0,12
2009,Zimbabwe,ZWE,Belgium,BEL,10,0,0,0,10
2009,Stateless,XXA,Belgium,BEL,0,0,5,0,5
2009,Central African Rep.,CAF,Benin,BEN,5,0,5,0,10
2009,Chad,TCD,Benin,BEN,10,0,22,31,63
2009,Cameroon,CMR,Benin,BEN,0,0,5,0,5
2009,Congo,COG,Benin,BEN,11,0,5,5,21
2009,Dem. Rep. of the Congo,COD,Benin,BEN,10,0,26,0,36
2009,Comoros,COM,Benin,BEN,0,0,5,0,5
2009,Equatorial Guinea,GNQ,Benin,BEN,0,0,0,5,5
2009,Guinea,GIN,Benin,BEN,0,0,5,0,5
2009,Niger,NER,Benin,BEN,0,0,5,5,10
2009,Nigeria,NGA,Benin,BEN,0,0,35,35,70
2009,Rwanda,RWA,Benin,BEN,0,0,5,0,5
2009,Somalia,SOM,Benin,BEN,5,0,0,0,5
2009,Sudan,SDN,Benin,BEN,0,0,0,5,5
2009,Togo,TGO,Benin,BEN,10,0,24,40,74
2009,Central African Rep.,CAF,Burkina Faso,BFA,0,0,0,5,5
2009,Chad,TCD,Burkina Faso,BFA,5,0,13,5,23
2009,Cameroon,CMR,Burkina Faso,BFA,0,0,0,5,5
2009,Congo,COG,Burkina Faso,BFA,0,0,5,5,10
2009,Dem. Rep. of the Congo,COD,Burkina Faso,BFA,0,0,0,14,14
2009,Cote d'Ivoire,CIV,Burkina Faso,BFA,0,0,5,12,17
2009,Rwanda,RWA,Burkina Faso,BFA,0,0,0,10,10
2009,Togo,TGO,Burkina Faso,BFA,0,0,5,0,5
2009,Afghanistan,AFG,Belarus,BLR,12,0,29,10,51
2009,Congo,COG,Belarus,BLR,0,0,0,5,5
2009,Georgia,GEO,Belarus,BLR,0,0,10,15,25
2009,Iran (Islamic Rep. of),IRN,Belarus,BLR,5,0,5,0,10
2009,Pakistan,PAK,Belarus,BLR,0,0,0,5,5
2009,Russian Federation,RUS,Belarus,BLR,0,0,5,0,5
2009,Ukraine,UKR,Belarus,BLR,0,0,5,5,10
2009,Colombia,COL,Bolivia (Plurinational State of),BOL,13,0,0,14,27
2009,Eritrea,ERI,Bolivia (Plurinational State of),BOL,0,0,0,49,49
2009,Ethiopia,ETH,Bolivia (Plurinational State of),BOL,0,0,0,11,11
2009,Peru,PER,Bolivia (Plurinational State of),BOL,0,0,0,5,5
2009,Burundi,BDI,Botswana,BWA,0,0,5,5,10
2009,Dem. Rep. of the Congo,COD,Botswana,BWA,0,0,37,5,42
2009,Zimbabwe,ZWE,Botswana,BWA,47,0,0,5,52
2009,Angola,AGO,Brazil,BRA,0,0,5,0,5
2009,Bangladesh,BGD,Brazil,BRA,0,0,5,0,5
2009,Bolivia (Plurinational State of),BOL,Brazil,BRA,119,0,5,0,124
2009,Dem. Rep. of the Congo,COD,Brazil,BRA,56,0,66,0,122
2009,Colombia,COL,Brazil,BRA,36,0,17,0,53
2009,Cuba,CUB,Brazil,BRA,0,0,22,0,22
2009,Eritrea,ERI,Brazil,BRA,5,0,0,0,5
2009,Guinea-Bissau,GNB,Brazil,BRA,0,0,10,0,10
2009,Guinea,GIN,Brazil,BRA,5,0,0,0,5
2009,Cote d'Ivoire,CIV,Brazil,BRA,5,0,5,0,10
2009,Iraq,IRQ,Brazil,BRA,17,0,0,0,17
2009,Liberia,LBR,Brazil,BRA,0,0,5,0,5
2009,Nigeria,NGA,Brazil,BRA,0,0,5,0,5
2009,Senegal,SEN,Brazil,BRA,0,0,10,0,10
2009,Sierra Leone,SLE,Brazil,BRA,0,0,5,0,5
2009,Somalia,SOM,Brazil,BRA,5,0,0,0,5
2009,Sudan,SDN,Brazil,BRA,5,0,0,0,5
2009,Afghanistan,AFG,Bulgaria,BGR,12,15,15,5,47
2009,Albania,ALB,Bulgaria,BGR,0,0,5,0,5
2009,Algeria,DZA,Bulgaria,BGR,0,0,12,5,17
2009,Egypt,EGY,Bulgaria,BGR,0,0,5,0,5
2009,Armenia,ARM,Bulgaria,BGR,0,5,40,0,45
2009,Bosnia and Herzegovina,BIH,Bulgaria,BGR,0,0,5,0,5
2009,China,CHN,Bulgaria,BGR,0,0,5,0,5
2009,Congo,COG,Bulgaria,BGR,0,5,0,0,5
2009,Ethiopia,ETH,Bulgaria,BGR,5,0,0,0,5
2009,Georgia,GEO,Bulgaria,BGR,0,0,0,14,14
2009,Ghana,GHA,Bulgaria,BGR,0,0,5,0,5
2009,Cote d'Ivoire,CIV,Bulgaria,BGR,0,0,5,0,5
2009,Iran (Islamic Rep. of),IRN,Bulgaria,BGR,0,0,19,10,29
2009,Iraq,IRQ,Bulgaria,BGR,16,183,99,28,326
2009,Kazakhstan,KAZ,Bulgaria,BGR,0,0,5,0,5
2009,Liberia,LBR,Bulgaria,BGR,0,0,5,0,5
2009,Lebanon,LBN,Bulgaria,BGR,0,0,10,0,10
2009,Sri Lanka,LKA,Bulgaria,BGR,0,0,14,5,19
2009,Morocco,MAR,Bulgaria,BGR,0,0,5,5,10
2009,Nigeria,NGA,Bulgaria,BGR,0,0,18,0,18
2009,Russian Federation,RUS,Bulgaria,BGR,0,0,5,5,10
2009,Somalia,SOM,Bulgaria,BGR,0,5,0,0,5
2009,Viet Nam,VNM,Bulgaria,BGR,0,0,5,0,5
2009,Syrian Arab Rep.,SYR,Bulgaria,BGR,0,5,19,0,24
2009,United Rep. of Tanzania,TZA,Bulgaria,BGR,0,0,5,0,5
2009,Turkey,TUR,Bulgaria,BGR,5,0,15,0,20
2009,Stateless,XXA,Bulgaria,BGR,5,11,38,20,74
2009,Guatemala,GTM,Belize,BLZ,0,5,0,0,5
2009,El Salvador,SLV,Belize,BLZ,0,0,0,5,5
2009,Afghanistan,AFG,Canada,CAN,275,0,18,44,337
2009,Albania,ALB,Canada,CAN,108,0,139,30,277
2009,Algeria,DZA,Canada,CAN,5,0,30,15,50
2009,Angola,AGO,Canada,CAN,0,0,0,5,5
2009,Antigua and Barbuda,ATG,Canada,CAN,0,0,5,0,5
2009,Egypt,EGY,Canada,CAN,25,0,13,5,43
2009,Argentina,ARG,Canada,CAN,10,0,5,14,29
2009,Armenia,ARM,Canada,CAN,19,0,13,0,32
2009,Australia,AUS,Canada,CAN,0,0,0,5,5
2009,Azerbaijan,AZE,Canada,CAN,5,0,5,0,10
2009,Bahrain,BHR,Canada,CAN,5,0,0,0,5
2009,Barbados,BRB,Canada,CAN,0,0,14,0,14
2009,Burundi,BDI,Canada,CAN,211,0,52,5,268
2009,Belgium,BEL,Canada,CAN,5,0,0,11,16
2009,Benin,BEN,Canada,CAN,0,0,0,5,5
2009,Bangladesh,BGD,Canada,CAN,29,0,29,10,68
2009,Bahamas,BHS,Canada,CAN,5,0,0,5,10
2009,Bhutan,BTN,Canada,CAN,5,0,0,0,5
2009,Burkina Faso,BFA,Canada,CAN,5,0,0,0,5
2009,Belarus,BLR,Canada,CAN,26,0,0,5,31
2009,Bolivia (Plurinational State of),BOL,Canada,CAN,14,0,0,0,14
2009,Botswana,BWA,Canada,CAN,19,0,10,18,47
2009,Brazil,BRA,Canada,CAN,0,0,35,35,70
2009,Bosnia and Herzegovina,BIH,Canada,CAN,5,0,14,0,19
2009,Bulgaria,BGR,Canada,CAN,23,0,5,5,33
2009,Cambodia,KHM,Canada,CAN,5,0,5,0,10
2009,Central African Rep.,CAF,Canada,CAN,5,0,0,0,5
2009,Chad,TCD,Canada,CAN,34,0,5,5,44
2009,China,CHN,Canada,CAN,991,0,547,178,1716
2009,Chile,CHL,Canada,CAN,5,0,5,15,25
2009,Cameroon,CMR,Canada,CAN,83,0,36,10,129
2009,Congo,COG,Canada,CAN,14,0,13,5,32
2009,Dem. Rep. of the Congo,COD,Canada,CAN,178,0,88,20,286
2009,Colombia,COL,Canada,CAN,2431,0,657,122,3210
2009,Costa Rica,CRI,Canada,CAN,0,0,14,5,19
2009,Cuba,CUB,Canada,CAN,46,0,35,25,106
2009,Czechia,CZE,Canada,CAN,90,0,76,734,900
2009,Denmark,DNK,Canada,CAN,0,0,5,5,10
2009,Djibouti,DJI,Canada,CAN,11,0,5,0,16
2009,Dominican Rep.,DOM,Canada,CAN,5,0,14,20,39
2009,Ecuador,ECU,Canada,CAN,0,0,11,12,23
2009,Eritrea,ERI,Canada,CAN,237,0,0,10,247
2009,Ethiopia,ETH,Canada,CAN,147,0,13,15,175
2009,Fiji,FJI,Canada,CAN,23,0,11,10,44
2009,France,FRA,Canada,CAN,0,0,13,10,23
2009,Gabon,GAB,Canada,CAN,5,0,0,0,5
2009,Gambia,GMB,Canada,CAN,5,0,0,5,10
2009,Palestinian,PSE,Canada,CAN,39,0,18,5,62
2009,United Kingdom of Great Britain and Northern Ireland,GBR,Canada,CAN,0,0,0,10,10
2009,Georgia,GEO,Canada,CAN,24,0,25,12,61
2009,Germany,DEU,Canada,CAN,0,0,12,19,31
2009,Ghana,GHA,Canada,CAN,16,0,16,5,37
2009,Greece,GRC,Canada,CAN,0,0,0,5,5
2009,Grenada,GRD,Canada,CAN,5,0,12,0,17
2009,Guatemala,GTM,Canada,CAN,55,0,75,27,157
2009,Guinea,GIN,Canada,CAN,37,0,33,5,75
2009,Guyana,GUY,Canada,CAN,14,0,43,5,62
2009,Haiti,HTI,Canada,CAN,1040,0,1256,160,2456
2009,"China, Hong Kong SAR",HKG,Canada,CAN,0,0,11,16,27
2009,Honduras,HND,Canada,CAN,98,0,175,71,344
2009,Croatia,HRV,Canada,CAN,0,0,0,5,5
2009,Hungary,HUN,Canada,CAN,5,0,5,257,267
2009,Cote d'Ivoire,CIV,Canada,CAN,23,0,5,5,33
2009,India,IND,Canada,CAN,188,0,284,107,579
2009,Indonesia,IDN,Canada,CAN,21,0,41,10,72
2009,Iran (Islamic Rep. of),IRN,Canada,CAN,192,0,22,34,248
2009,Iraq,IRQ,Canada,CAN,189,0,33,31,253
2009,Israel,ISR,Canada,CAN,14,0,198,79,291
2009,Italy,ITA,Canada,CAN,0,0,0,5,5
2009,Jamaica,JAM,Canada,CAN,12,0,56,27,95
2009,Jordan,JOR,Canada,CAN,25,0,30,23,78
2009,Japan,JPN,Canada,CAN,0,0,0,5,5
2009,Kazakhstan,KAZ,Canada,CAN,5,0,5,0,10
2009,Kenya,KEN,Canada,CAN,46,0,5,5,56
2009,Kyrgyzstan,KGZ,Canada,CAN,11,0,0,0,11
2009,Rep. of Korea,KOR,Canada,CAN,25,0,174,65,264
2009,Dem. People's Rep. of Korea,PRK,Canada,CAN,65,0,10,40,115
2009,Kuwait,KWT,Canada,CAN,5,0,5,0,10
2009,Liberia,LBR,Canada,CAN,14,0,5,0,19
2009,Libya,LBY,Canada,CAN,12,0,0,0,12
2009,Saint Lucia,LCA,Canada,CAN,28,0,38,34,100
2009,Lebanon,LBN,Canada,CAN,97,0,88,43,228
2009,Sri Lanka,LKA,Canada,CAN,981,0,60,41,1082
2009,Latvia,LVA,Canada,CAN,0,0,0,5,5
2009,Mauritania,MRT,Canada,CAN,5,0,0,0,5
2009,North Macedonia,MKD,Canada,CAN,5,0,0,5,10
2009,Rep. of Moldova,MDA,Canada,CAN,11,0,5,10,26
2009,Mexico,MEX,Canada,CAN,516,0,3382,2167,6065
2009,Mali,MLI,Canada,CAN,0,0,13,0,13
2009,Malaysia,MYS,Canada,CAN,5,0,11,0,16
2009,Malawi,MWI,Canada,CAN,0,0,5,0,5
2009,Mongolia,MNG,Canada,CAN,12,0,0,10,22
2009,Morocco,MAR,Canada,CAN,16,0,10,5,31
2009,Mauritius,MUS,Canada,CAN,0,0,5,0,5
2009,Myanmar,MMR,Canada,CAN,24,0,0,0,24
2009,Namibia,NAM,Canada,CAN,5,0,5,0,10
2009,Nepal,NPL,Canada,CAN,24,0,5,10,39
2009,Netherlands,NLD,Canada,CAN,0,0,13,0,13
2009,Niger,NER,Canada,CAN,5,0,0,0,5
2009,Nicaragua,NIC,Canada,CAN,5,0,22,5,32
2009,Nigeria,NGA,Canada,CAN,440,0,148,76,664
2009,Pakistan,PAK,Canada,CAN,247,0,119,51,417
2009,Panama,PAN,Canada,CAN,5,0,5,5,15
2009,Paraguay,PRY,Canada,CAN,0,0,5,0,5
2009,Peru,PER,Canada,CAN,40,0,32,25,97
2009,Philippines,PHL,Canada,CAN,11,0,50,16,77
2009,Poland,POL,Canada,CAN,37,0,13,27,77
2009,Portugal,PRT,Canada,CAN,0,0,19,12,31
2009,Romania,ROU,Canada,CAN,5,0,14,16,35
2009,South Africa,ZAF,Canada,CAN,0,0,0,5,5
2009,Russian Federation,RUS,Canada,CAN,81,0,56,33,170
2009,Rwanda,RWA,Canada,CAN,241,0,31,10,282
2009,El Salvador,SLV,Canada,CAN,63,0,111,39,213
2009,Saudi Arabia,SAU,Canada,CAN,0,0,0,5,5
2009,Serbia and Kosovo: S/RES/1244 (1999),SRB,Canada,CAN,46,0,40,25,111
2009,Senegal,SEN,Canada,CAN,10,0,5,0,15
2009,Singapore,SGP,Canada,CAN,5,0,0,0,5
2009,Sierra Leone,SLE,Canada,CAN,14,0,0,0,14
2009,Solomon Islands,SLB,Canada,CAN,5,0,0,0,5
2009,Somalia,SOM,Canada,CAN,171,0,5,32,208
2009,Spain,ESP,Canada,CAN,0,0,5,5,10
2009,Viet Nam,VNM,Canada,CAN,0,0,5,11,16
2009,Sudan,SDN,Canada,CAN,21,0,5,10,36
2009,Suriname,SUR,Canada,CAN,5,0,0,0,5
2009,Slovakia,SVK,Canada,CAN,5,0,5,44,54
2009,Eswatini,SWZ,Canada,CAN,5,0,5,0,10
2009,Sweden,SWE,Canada,CAN,0,0,5,0,5
2009,Syrian Arab Rep.,SYR,Canada,CAN,13,0,10,12,35
2009,United Rep. of Tanzania,TZA,Canada,CAN,10,0,0,0,10
2009,Thailand,THA,Canada,CAN,0,0,24,30,54
2009,Togo,TGO,Canada,CAN,12,0,0,0,12
2009,Trinidad and Tobago,TTO,Canada,CAN,13,0,38,21,72
2009,Tunisia,TUN,Canada,CAN,10,0,11,5,26
2009,Turkey,TUR,Canada,CAN,101,0,31,37,169
2009,United Arab Emirates,ARE,Canada,CAN,5,0,0,0,5
2009,Uganda,UGA,Canada,CAN,44,0,10,5,59
2009,Ukraine,UKR,Canada,CAN,70,0,65,50,185
2009,Uruguay,URY,Canada,CAN,0,0,5,0,5
2009,United States of America,USA,Canada,CAN,5,0,522,198,725
2009,Uzbekistan,UZB,Canada,CAN,11,0,13,0,24
2009,Saint Vincent and the Grenadines,VCT,Canada,CAN,130,0,144,49,323
2009,Venezuela (Bolivarian Republic of),VEN,Canada,CAN,32,0,32,11,75
2009,Yemen,YEM,Canada,CAN,5,0,5,0,10
2009,Zambia,ZMB,Canada,CAN,5,0,0,5,10
2009,Zimbabwe,ZWE,Canada,CAN,219,0,29,14,262
2009,Chad,TCD,Central African Rep.,CAF,151,0,20,0,171
2009,Dem. Rep. of the Congo,COD,Central African Rep.,CAF,139,0,33,0,172
2009,Rwanda,RWA,Central African Rep.,CAF,38,0,0,0,38
2009,Sudan,SDN,Central African Rep.,CAF,22,0,0,0,22
2009,Cuba,CUB,Colombia,COL,0,0,19,0,19
2009,Eritrea,ERI,Colombia,COL,5,0,116,0,121
2009,Ethiopia,ETH,Colombia,COL,11,0,39,0,50
2009,Ghana,GHA,Colombia,COL,0,0,5,0,5
2009,Sri Lanka,LKA,Colombia,COL,5,0,0,0,5
2009,Nepal,NPL,Colombia,COL,0,0,5,0,5
2009,Somalia,SOM,Colombia,COL,10,0,83,0,93
2009,Venezuela (Bolivarian Republic of),VEN,Colombia,COL,0,0,13,0,13
2009,Afghanistan,AFG,Cyprus,CYP,0,0,50,40,90
2009,Algeria,DZA,Cyprus,CYP,0,0,5,0,5
2009,Egypt,EGY,Cyprus,CYP,0,5,236,148,389
2009,Armenia,ARM,Cyprus,CYP,0,0,10,23,33
2009,Benin,BEN,Cyprus,CYP,0,0,0,5,5
2009,Bangladesh,BGD,Cyprus,CYP,0,0,162,0,162
2009,Burkina Faso,BFA,Cyprus,CYP,0,0,5,0,5
2009,Bosnia and Herzegovina,BIH,Cyprus,CYP,0,0,5,15,20
2009,China,CHN,Cyprus,CYP,0,0,176,122,298
2009,Cameroon,CMR,Cyprus,CYP,0,0,41,20,61
2009,Dem. Rep. of the Congo,COD,Cyprus,CYP,0,0,14,16,30
2009,Eritrea,ERI,Cyprus,CYP,0,0,0,5,5
2009,Ethiopia,ETH,Cyprus,CYP,0,0,12,0,12
2009,Palestinian,PSE,Cyprus,CYP,10,1102,15,0,1127
2009,Georgia,GEO,Cyprus,CYP,0,5,120,236,361
2009,Ghana,GHA,Cyprus,CYP,0,0,16,5,21
2009,Guinea,GIN,Cyprus,CYP,0,0,5,12,17
2009,Cote d'Ivoire,CIV,Cyprus,CYP,0,0,5,5,10
2009,India,IND,Cyprus,CYP,0,0,395,211,606
2009,Indonesia,IDN,Cyprus,CYP,0,0,0,11,11
2009,Iran (Islamic Rep. of),IRN,Cyprus,CYP,15,0,237,390,642
2009,Iraq,IRQ,Cyprus,CYP,0,182,14,40,236
2009,Jordan,JOR,Cyprus,CYP,0,0,54,36,90
2009,Kazakhstan,KAZ,Cyprus,CYP,0,0,0,14,14
2009,Kenya,KEN,Cyprus,CYP,0,0,11,0,11
2009,Kyrgyzstan,KGZ,Cyprus,CYP,0,0,5,0,5
2009,Lebanon,LBN,Cyprus,CYP,0,0,66,112,178
2009,Sri Lanka,LKA,Cyprus,CYP,0,0,277,124,401
2009,North Macedonia,MKD,Cyprus,CYP,0,0,12,25,37
2009,Rep. of Moldova,MDA,Cyprus,CYP,0,0,20,27,47
2009,Mali,MLI,Cyprus,CYP,0,0,0,5,5
2009,Mongolia,MNG,Cyprus,CYP,0,0,62,27,89
2009,Morocco,MAR,Cyprus,CYP,0,0,22,5,27
2009,Nepal,NPL,Cyprus,CYP,0,0,97,56,153
2009,Nigeria,NGA,Cyprus,CYP,0,0,113,0,113
2009,Pakistan,PAK,Cyprus,CYP,0,0,254,95,349
2009,Philippines,PHL,Cyprus,CYP,0,5,90,23,118
2009,Romania,ROU,Cyprus,CYP,0,0,0,5,5
2009,Russian Federation,RUS,Cyprus,CYP,5,0,30,86,121
2009,Serbia and Kosovo: S/RES/1244 (1999),SRB,Cyprus,CYP,0,0,5,0,5
2009,Sierra Leone,SLE,Cyprus,CYP,0,0,5,0,5
2009,Somalia,SOM,Cyprus,CYP,0,0,0,5,5
2009,Viet Nam,VNM,Cyprus,CYP,0,0,86,12,98
2009,Sudan,SDN,Cyprus,CYP,0,0,0,5,5
2009,Syrian Arab Rep.,SYR,Cyprus,CYP,0,5,416,393,814
2009,Tunisia,TUN,Cyprus,CYP,0,0,0,14,14
2009,Turkey,TUR,Cyprus,CYP,20,0,50,0,70
2009,Ukraine,UKR,Cyprus,CYP,0,5,65,211,281
2009,Uzbekistan,UZB,Cyprus,CYP,0,0,22,45,67
2009,Afghanistan,AFG,Czechia,CZE,14,0,0,0,14
2009,Algeria,DZA,Czechia,CZE,0,0,5,5,10
2009,Armenia,ARM,Czechia,CZE,0,0,0,13,13
2009,Bangladesh,BGD,Czechia,CZE,0,0,0,5,5
2009,Belarus,BLR,Czechia,CZE,0,0,35,31,66
2009,China,CHN,Czechia,CZE,0,0,5,10,15
2009,Cameroon,CMR,Czechia,CZE,0,0,0,5,5
2009,Dem. Rep. of the Congo,COD,Czechia,CZE,5,0,0,5,10
2009,Cuba,CUB,Czechia,CZE,0,5,0,0,5
2009,Georgia,GEO,Czechia,CZE,0,0,10,16,26
2009,Ghana,GHA,Czechia,CZE,0,0,0,5,5
2009,Guinea,GIN,Czechia,CZE,0,0,0,5,5
2009,India,IND,Czechia,CZE,0,0,0,5,5
2009,Iran (Islamic Rep. of),IRN,Czechia,CZE,5,0,0,0,5
2009,Iraq,IRQ,Czechia,CZE,0,5,0,10,15
2009,Kazakhstan,KAZ,Czechia,CZE,5,0,10,74,89
2009,Kyrgyzstan,KGZ,Czechia,CZE,0,0,14,10,24
2009,Sri Lanka,LKA,Czechia,CZE,0,0,10,0,10
2009,Rep. of Moldova,MDA,Czechia,CZE,0,0,13,0,13
2009,Mongolia,MNG,Czechia,CZE,0,0,94,59,153
2009,Myanmar,MMR,Czechia,CZE,22,0,0,0,22
2009,Nigeria,NGA,Czechia,CZE,0,0,10,13,23
2009,Russian Federation,RUS,Czechia,CZE,0,5,11,19,35
2009,Serbia and Kosovo: S/RES/1244 (1999),SRB,Czechia,CZE,5,0,13,17,35
2009,Viet Nam,VNM,Czechia,CZE,10,0,26,32,68
2009,Syrian Arab Rep.,SYR,Czechia,CZE,0,0,20,18,38
2009,Tunisia,TUN,Czechia,CZE,0,0,5,0,5
2009,Turkey,TUR,Czechia,CZE,0,0,5,37,42
2009,Ukraine,UKR,Czechia,CZE,10,0,92,88,190
2009,Uzbekistan,UZB,Czechia,CZE,5,0,0,0,5
2009,Stateless,XXA,Czechia,CZE,0,5,5,26,36
2009,Afghanistan,AFG,Denmark,DNK,5,188,166,0,359
2009,Albania,ALB,Denmark,DNK,0,5,5,0,10
2009,Algeria,DZA,Denmark,DNK,0,0,5,0,5
2009,Armenia,ARM,Denmark,DNK,0,0,12,0,12
2009,Azerbaijan,AZE,Denmark,DNK,0,0,12,0,12
2009,Bangladesh,BGD,Denmark,DNK,0,0,10,0,10
2009,Bosnia and Herzegovina,BIH,Denmark,DNK,0,0,38,0,38
2009,Bulgaria,BGR,Denmark,DNK,0,0,5,0,5
2009,China,CHN,Denmark,DNK,0,0,11,0,11
2009,Cameroon,CMR,Denmark,DNK,0,0,5,0,5
2009,Congo,COG,Denmark,DNK,0,0,5,0,5
2009,Dem. Rep. of the Congo,COD,Denmark,DNK,0,0,14,0,14
2009,Eritrea,ERI,Denmark,DNK,0,5,0,0,5
2009,Georgia,GEO,Denmark,DNK,0,0,5,0,5
2009,Ghana,GHA,Denmark,DNK,0,0,17,0,17
2009,Guinea,GIN,Denmark,DNK,0,0,5,0,5
2009,Croatia,HRV,Denmark,DNK,0,0,5,0,5
2009,India,IND,Denmark,DNK,0,0,10,0,10
2009,Iran (Islamic Rep. of),IRN,Denmark,DNK,118,12,76,0,206
2009,Iraq,IRQ,Denmark,DNK,35,52,101,0,188
2009,Jordan,JOR,Denmark,DNK,0,5,0,0,5
2009,Liberia,LBR,Denmark,DNK,0,0,5,0,5
2009,Libya,LBY,Denmark,DNK,0,5,0,0,5
2009,Sri Lanka,LKA,Denmark,DNK,0,0,11,0,11
2009,North Macedonia,MKD,Denmark,DNK,0,0,5,0,5
2009,Rep. of Moldova,MDA,Denmark,DNK,0,0,5,0,5
2009,Myanmar,MMR,Denmark,DNK,5,0,5,0,10
2009,Nepal,NPL,Denmark,DNK,0,0,5,0,5
2009,Nigeria,NGA,Denmark,DNK,0,0,16,0,16
2009,Pakistan,PAK,Denmark,DNK,0,0,10,0,10
2009,Poland,POL,Denmark,DNK,0,0,5,0,5
2009,Romania,ROU,Denmark,DNK,0,0,10,0,10
2009,Russian Federation,RUS,Denmark,DNK,29,40,30,0,99
2009,Rwanda,RWA,Denmark,DNK,0,0,5,0,5
2009,Serbia and Kosovo: S/RES/1244 (1999),SRB,Denmark,DNK,0,0,108,0,108
2009,Senegal,SEN,Denmark,DNK,0,0,5,0,5
2009,Somalia,SOM,Denmark,DNK,0,17,16,0,33
2009,Sudan,SDN,Denmark,DNK,0,0,14,0,14
2009,Syrian Arab Rep.,SYR,Denmark,DNK,119,13,60,0,192
2009,Turkey,TUR,Denmark,DNK,0,0,10,0,10
2009,Uganda,UGA,Denmark,DNK,0,0,11,0,11
2009,Zimbabwe,ZWE,Denmark,DNK,0,0,10,0,10
2009,Stateless,XXA,Denmark,DNK,16,0,30,0,46
2009,Belarus,BLR,Estonia,EST,0,0,5,0,5
2009,Russian Federation,RUS,Estonia,EST,0,0,5,0,5
2009,Syrian Arab Rep.,SYR,Estonia,EST,0,0,5,0,5
2009,Afghanistan,AFG,Finland,FIN,10,86,31,114,241
2009,Albania,ALB,Finland,FIN,0,0,0,14,14
2009,Algeria,DZA,Finland,FIN,0,5,0,19,24
2009,Angola,AGO,Finland,FIN,0,12,0,0,12
2009,Egypt,EGY,Finland,FIN,0,0,0,5,5
2009,Armenia,ARM,Finland,FIN,0,0,0,5,5
2009,Burundi,BDI,Finland,FIN,0,0,0,5,5
2009,Bangladesh,BGD,Finland,FIN,0,0,5,5,10
2009,Belarus,BLR,Finland,FIN,0,0,10,64,74
2009,Bosnia and Herzegovina,BIH,Finland,FIN,0,0,0,16,16
2009,Bulgaria,BGR,Finland,FIN,0,0,5,514,519
2009,China,CHN,Finland,FIN,0,5,0,0,5
2009,Cameroon,CMR,Finland,FIN,0,0,13,0,13
2009,Congo,COG,Finland,FIN,0,0,0,5,5
2009,Dem. Rep. of the Congo,COD,Finland,FIN,0,13,11,5,29
2009,Cuba,CUB,Finland,FIN,0,0,0,5,5
2009,Ecuador,ECU,Finland,FIN,0,5,0,0,5
2009,Eritrea,ERI,Finland,FIN,0,0,0,5,5
2009,Ethiopia,ETH,Finland,FIN,0,0,0,14,14
2009,Gambia,GMB,Finland,FIN,0,0,5,18,23
2009,Georgia,GEO,Finland,FIN,0,0,0,13,13
2009,Ghana,GHA,Finland,FIN,0,0,12,15,27
2009,Guinea,GIN,Finland,FIN,0,0,0,11,11
2009,Croatia,HRV,Finland,FIN,0,0,0,5,5
2009,Cote d'Ivoire,CIV,Finland,FIN,0,5,0,0,5
2009,India,IND,Finland,FIN,0,0,0,15,15
2009,Iran (Islamic Rep. of),IRN,Finland,FIN,10,22,35,59,126
2009,Iraq,IRQ,Finland,FIN,39,451,60,471,1021
2009,Israel,ISR,Finland,FIN,0,0,0,5,5
2009,Libya,LBY,Finland,FIN,0,0,0,14,14
2009,Lebanon,LBN,Finland,FIN,0,0,0,5,5
2009,Sri Lanka,LKA,Finland,FIN,0,12,5,10,27
2009,Mauritania,MRT,Finland,FIN,0,0,0,5,5
2009,Morocco,MAR,Finland,FIN,0,0,0,23,23
2009,Niger,NER,Finland,FIN,5,0,0,0,5
2009,Nigeria,NGA,Finland,FIN,0,10,37,32,79
2009,Pakistan,PAK,Finland,FIN,0,0,5,0,5
2009,Romania,ROU,Finland,FIN,0,0,0,53,53
2009,Russian Federation,RUS,Finland,FIN,37,28,28,139,232
2009,Serbia and Kosovo: S/RES/1244 (1999),SRB,Finland,FIN,0,5,24,85,114
2009,Senegal,SEN,Finland,FIN,0,0,0,5,5
2009,Sierra Leone,SLE,Finland,FIN,0,0,0,5,5
2009,Somalia,SOM,Finland,FIN,0,541,23,671,1235
2009,Sudan,SDN,Finland,FIN,0,0,0,5,5
2009,Syrian Arab Rep.,SYR,Finland,FIN,0,0,5,14,19
2009,Tunisia,TUN,Finland,FIN,0,0,0,5,5
2009,Turkey,TUR,Finland,FIN,5,10,18,20,53
2009,Ukraine,UKR,Finland,FIN,0,0,0,10,10
2009,United States of America,USA,Finland,FIN,0,0,0,5,5
2009,Stateless,XXA,Finland,FIN,0,5,0,12,17
2009,Afghanistan,AFG,France,FRA,121,14,227,0,362
2009,Albania,ALB,France,FRA,10,5,301,0,316
2009,Algeria,DZA,France,FRA,36,5,931,0,972
2009,Angola,AGO,France,FRA,49,0,400,0,449
2009,Egypt,EGY,France,FRA,5,0,63,0,68
2009,Armenia,ARM,France,FRA,93,11,1893,0,1997
2009,Azerbaijan,AZE,France,FRA,63,0,439,0,502
2009,Burundi,BDI,France,FRA,10,0,20,0,30
2009,Benin,BEN,France,FRA,0,0,13,0,13
2009,Bangladesh,BGD,France,FRA,34,0,1747,0,1781
2009,Bhutan,BTN,France,FRA,5,0,22,0,27
2009,Burkina Faso,BFA,France,FRA,0,5,29,0,34
2009,Belarus,BLR,France,FRA,5,0,60,0,65
2009,Brazil,BRA,France,FRA,0,0,12,0,12
2009,Bosnia and Herzegovina,BIH,France,FRA,16,0,223,0,239
2009,Bulgaria,BGR,France,FRA,0,0,5,0,5
2009,Central African Rep.,CAF,France,FRA,14,5,125,0,144
2009,Chad,TCD,France,FRA,36,0,185,0,221
2009,China,CHN,France,FRA,179,0,1212,0,1391
2009,Cameroon,CMR,France,FRA,5,5,154,0,164
2009,Congo,COG,France,FRA,48,5,785,0,838
2009,Dem. Rep. of the Congo,COD,France,FRA,338,5,2076,0,2419
2009,Comoros,COM,France,FRA,66,0,724,0,790
2009,Colombia,COL,France,FRA,18,0,72,0,90
2009,Cuba,CUB,France,FRA,5,0,10,0,15
2009,Dominica,DMA,France,FRA,0,0,5,0,5
2009,Dominican Rep.,DOM,France,FRA,0,0,105,0,105
2009,Eritrea,ERI,France,FRA,122,13,59,0,194
2009,Ethiopia,ETH,France,FRA,24,5,27,0,56
2009,Gambia,GMB,France,FRA,5,12,42,0,59
2009,Palestinian,PSE,France,FRA,32,0,57,0,89
2009,Georgia,GEO,France,FRA,34,0,401,0,435
2009,Guinea-Bissau,GNB,France,FRA,12,5,94,0,111
2009,Guinea,GIN,France,FRA,124,177,1374,0,1675
2009,Guyana,GUY,France,FRA,0,0,5,0,5
2009,Haiti,HTI,France,FRA,93,24,1467,0,1584
2009,Hungary,HUN,France,FRA,0,0,10,0,10
2009,Cote d'Ivoire,CIV,France,FRA,43,54,505,0,602
2009,Iran (Islamic Rep. of),IRN,France,FRA,53,0,70,0,123
2009,Iraq,IRQ,France,FRA,421,18,96,0,535
2009,Jamaica,JAM,France,FRA,0,0,5,0,5
2009,Kazakhstan,KAZ,France,FRA,5,0,110,0,115
2009,Kyrgyzstan,KGZ,France,FRA,0,0,22,0,22
2009,Liberia,LBR,France,FRA,5,0,39,0,44
2009,Libya,LBY,France,FRA,0,0,5,0,5
2009,Lebanon,LBN,France,FRA,5,0,29,0,34
2009,Sri Lanka,LKA,France,FRA,630,5,2001,0,2636
2009,Mauritania,MRT,France,FRA,101,29,1132,0,1262
2009,North Macedonia,MKD,France,FRA,5,0,45,0,50
2009,Rep. of Moldova,MDA,France,FRA,5,0,208,0,213
2009,Mali,MLI,France,FRA,28,546,303,0,877
2009,Mongolia,MNG,France,FRA,11,0,186,0,197
2009,Myanmar,MMR,France,FRA,5,0,14,0,19
2009,Nepal,NPL,France,FRA,0,0,61,0,61
2009,Nigeria,NGA,France,FRA,10,17,692,0,719
2009,Pakistan,PAK,France,FRA,23,0,552,0,575
2009,Philippines,PHL,France,FRA,0,0,5,0,5
2009,Romania,ROU,France,FRA,0,0,25,0,25
2009,Russian Federation,RUS,France,FRA,302,10,1720,0,2032
2009,Rwanda,RWA,France,FRA,63,0,86,0,149
2009,Serbia and Kosovo: S/RES/1244 (1999),SRB,France,FRA,128,11,2942,0,3081
2009,Senegal,SEN,France,FRA,17,72,78,0,167
2009,Sierra Leone,SLE,France,FRA,5,10,176,0,191
2009,Somalia,SOM,France,FRA,51,47,31,0,129
2009,Viet Nam,VNM,France,FRA,5,0,23,0,28
2009,Sudan,SDN,France,FRA,133,5,365,0,503
2009,Syrian Arab Rep.,SYR,France,FRA,10,0,24,0,34
2009,Togo,TGO,France,FRA,21,5,146,0,172
2009,Tunisia,TUN,France,FRA,5,0,32,0,37
2009,Turkey,TUR,France,FRA,126,0,2306,0,2432
2009,Ukraine,UKR,France,FRA,5,0,54,0,59
2009,Uzbekistan,UZB,France,FRA,10,0,21,0,31
2009,Stateless,XXA,France,FRA,59,0,106,0,165
2009,Afghanistan,AFG,United Kingdom of Great Britain and Northern Ireland,GBR,220,1227,1388,1144,3979
2009,Albania,ALB,United Kingdom of Great Britain and Northern Ireland,GBR,5,44,110,54,213
2009,Algeria,DZA,United Kingdom of Great Britain and Northern Ireland,GBR,5,15,141,114,275
2009,Angola,AGO,United Kingdom of Great Britain and Northern Ireland,GBR,5,0,59,5,69
2009,Egypt,EGY,United Kingdom of Great Britain and Northern Ireland,GBR,5,10,53,19,87
2009,Armenia,ARM,United Kingdom of Great Britain and Northern Ireland,GBR,5,0,5,0,10
2009,Australia,AUS,United Kingdom of Great Britain and Northern Ireland,GBR,0,0,0,5,5
2009,Azerbaijan,AZE,United Kingdom of Great Britain and Northern Ireland,GBR,5,0,26,0,31
2009,Burundi,BDI,United Kingdom of Great Britain and Northern Ireland,GBR,0,5,16,0,21
2009,Benin,BEN,United Kingdom of Great Britain and Northern Ireland,GBR,0,0,5,0,5
2009,Bangladesh,BGD,United Kingdom of Great Britain and Northern Ireland,GBR,5,43,321,119,488
2009,Bhutan,BTN,United Kingdom of Great Britain and Northern Ireland,GBR,10,0,21,5,36
2009,Belarus,BLR,United Kingdom of Great Britain and Northern Ireland,GBR,14,0,25,5,44
2009,Bolivia (Plurinational State of),BOL,United Kingdom of Great Britain and Northern Ireland,GBR,0,0,12,0,12
2009,Botswana,BWA,United Kingdom of Great Britain and Northern Ireland,GBR,0,0,11,0,11
2009,Brazil,BRA,United Kingdom of Great Britain and Northern Ireland,GBR,0,0,28,10,38
2009,Bosnia and Herzegovina,BIH,United Kingdom of Great Britain and Northern Ireland,GBR,5,0,0,12,17
2009,Canada,CAN,United Kingdom of Great Britain and Northern Ireland,GBR,0,0,5,5,10
2009,Chad,TCD,United Kingdom of Great Britain and Northern Ireland,GBR,0,0,14,0,14
2009,China,CHN,United Kingdom of Great Britain and Northern Ireland,GBR,79,52,993,519,1643
2009,Cameroon,CMR,United Kingdom of Great Britain and Northern Ireland,GBR,13,5,81,10,109
2009,Congo,COG,United Kingdom of Great Britain and Northern Ireland,GBR,0,5,24,5,34
2009,Dem. Rep. of the Congo,COD,United Kingdom of Great Britain and Northern Ireland,GBR,45,28,247,18,338
2009,Colombia,COL,United Kingdom of Great Britain and Northern Ireland,GBR,5,0,12,5,22
2009,Cuba,CUB,United Kingdom of Great Britain and Northern Ireland,GBR,0,0,13,0,13
2009,Djibouti,DJI,United Kingdom of Great Britain and Northern Ireland,GBR,0,0,5,0,5
2009,Ecuador,ECU,United Kingdom of Great Britain and Northern Ireland,GBR,0,0,12,5,17
2009,Eritrea,ERI,United Kingdom of Great Britain and Northern Ireland,GBR,874,70,389,565,1898
2009,Ethiopia,ETH,United Kingdom of Great Britain and Northern Ireland,GBR,36,5,75,14,130
2009,Fiji,FJI,United Kingdom of Great Britain and Northern Ireland,GBR,0,0,5,0,5
2009,France,FRA,United Kingdom of Great Britain and Northern Ireland,GBR,0,0,0,5,5
2009,Gambia,GMB,United Kingdom of Great Britain and Northern Ireland,GBR,46,24,239,39,348
2009,Palestinian,PSE,United Kingdom of Great Britain and Northern Ireland,GBR,5,15,212,100,332
2009,Georgia,GEO,United Kingdom of Great Britain and Northern Ireland,GBR,5,0,75,18,98
2009,Ghana,GHA,United Kingdom of Great Britain and Northern Ireland,GBR,0,11,141,47,199
2009,Guinea-Bissau,GNB,United Kingdom of Great Britain and Northern Ireland,GBR,0,0,5,0,5
2009,Grenada,GRD,United Kingdom of Great Britain and Northern Ireland,GBR,0,0,5,0,5
2009,Guatemala,GTM,United Kingdom of Great Britain and Northern Ireland,GBR,0,0,5,0,5
2009,Guinea,GIN,United Kingdom of Great Britain and Northern Ireland,GBR,22,10,66,19,117
2009,Guyana,GUY,United Kingdom of Great Britain and Northern Ireland,GBR,0,0,13,5,18
2009,"China, Hong Kong SAR",HKG,United Kingdom of Great Britain and Northern Ireland,GBR,0,0,0,5,5
2009,Croatia,HRV,United Kingdom of Great Britain and Northern Ireland,GBR,0,0,5,0,5
2009,Cote d'Ivoire,CIV,United Kingdom of Great Britain and Northern Ireland,GBR,0,13,46,5,64
2009,India,IND,United Kingdom of Great Britain and Northern Ireland,GBR,5,16,329,377,727
2009,Indonesia,IDN,United Kingdom of Great Britain and Northern Ireland,GBR,0,0,0,5,5
2009,Iran (Islamic Rep. of),IRN,United Kingdom of Great Britain and Northern Ireland,GBR,292,172,1835,269,2568
2009,Iraq,IRQ,United Kingdom of Great Britain and Northern Ireland,GBR,124,160,1097,256,1637
2009,Israel,ISR,United Kingdom of Great Britain and Northern Ireland,GBR,0,0,0,5,5
2009,Jamaica,JAM,United Kingdom of Great Britain and Northern Ireland,GBR,10,12,173,40,235
2009,Jordan,JOR,United Kingdom of Great Britain and Northern Ireland,GBR,0,10,15,5,30
2009,Kazakhstan,KAZ,United Kingdom of Great Britain and Northern Ireland,GBR,0,0,0,5,5
2009,Kenya,KEN,United Kingdom of Great Britain and Northern Ireland,GBR,5,11,99,26,141
2009,Kyrgyzstan,KGZ,United Kingdom of Great Britain and Northern Ireland,GBR,0,0,0,5,5
2009,Rep. of Korea,KOR,United Kingdom of Great Britain and Northern Ireland,GBR,0,0,10,0,10
2009,Dem. People's Rep. of Korea,PRK,United Kingdom of Great Britain and Northern Ireland,GBR,5,0,59,42,106
2009,Kuwait,KWT,United Kingdom of Great Britain and Northern Ireland,GBR,52,0,79,22,153
2009,Liberia,LBR,United Kingdom of Great Britain and Northern Ireland,GBR,0,0,15,5,20
2009,Libya,LBY,United Kingdom of Great Britain and Northern Ireland,GBR,19,12,61,10,102
2009,Saint Lucia,LCA,United Kingdom of Great Britain and Northern Ireland,GBR,0,0,5,0,5
2009,Lebanon,LBN,United Kingdom of Great Britain and Northern Ireland,GBR,0,5,29,11,45
2009,Sri Lanka,LKA,United Kingdom of Great Britain and Northern Ireland,GBR,167,60,1343,119,1689
2009,Mauritania,MRT,United Kingdom of Great Britain and Northern Ireland,GBR,0,0,5,0,5
2009,North Macedonia,MKD,United Kingdom of Great Britain and Northern Ireland,GBR,0,0,5,0,5
2009,Rep. of Moldova,MDA,United Kingdom of Great Britain and Northern Ireland,GBR,0,0,11,12,23
2009,Mexico,MEX,United Kingdom of Great Britain and Northern Ireland,GBR,0,0,0,5,5
2009,Mali,MLI,United Kingdom of Great Britain and Northern Ireland,GBR,0,0,0,5,5
2009,Malaysia,MYS,United Kingdom of Great Britain and Northern Ireland,GBR,5,0,28,18,51
2009,Malawi,MWI,United Kingdom of Great Britain and Northern Ireland,GBR,5,10,206,17,238
2009,Mongolia,MNG,United Kingdom of Great Britain and Northern Ireland,GBR,0,10,26,5,41
2009,Morocco,MAR,United Kingdom of Great Britain and Northern Ireland,GBR,5,5,25,19,54
2009,Mozambique,MOZ,United Kingdom of Great Britain and Northern Ireland,GBR,0,0,10,0,10
2009,Mauritius,MUS,United Kingdom of Great Britain and Northern Ireland,GBR,0,0,20,5,25
2009,Myanmar,MMR,United Kingdom of Great Britain and Northern Ireland,GBR,114,14,107,0,235
2009,Namibia,NAM,United Kingdom of Great Britain and Northern Ireland,GBR,0,0,15,5,20
2009,Nepal,NPL,United Kingdom of Great Britain and Northern Ireland,GBR,0,0,17,5,22
2009,Niger,NER,United Kingdom of Great Britain and Northern Ireland,GBR,0,0,5,0,5
2009,Nicaragua,NIC,United Kingdom of Great Britain and Northern Ireland,GBR,0,0,5,0,5
2009,Nigeria,NGA,United Kingdom of Great Britain and Northern Ireland,GBR,20,37,727,214,998
2009,New Zealand,NZL,United Kingdom of Great Britain and Northern Ireland,GBR,0,0,5,0,5
2009,Pakistan,PAK,United Kingdom of Great Britain and Northern Ireland,GBR,134,32,1767,246,2179
2009,Peru,PER,United Kingdom of Great Britain and Northern Ireland,GBR,0,0,5,0,5
2009,Philippines,PHL,United Kingdom of Great Britain and Northern Ireland,GBR,0,0,5,5,10
2009,Romania,ROU,United Kingdom of Great Britain and Northern Ireland,GBR,0,0,0,5,5
2009,South Africa,ZAF,United Kingdom of Great Britain and Northern Ireland,GBR,10,19,184,25,238
2009,Russian Federation,RUS,United Kingdom of Great Britain and Northern Ireland,GBR,15,0,61,24,100
2009,Rwanda,RWA,United Kingdom of Great Britain and Northern Ireland,GBR,0,5,25,5,35
2009,Saudi Arabia,SAU,United Kingdom of Great Britain and Northern Ireland,GBR,0,5,27,10,42
2009,Serbia and Kosovo: S/RES/1244 (1999),SRB,United Kingdom of Great Britain and Northern Ireland,GBR,10,10,25,28,73
2009,Senegal,SEN,United Kingdom of Great Britain and Northern Ireland,GBR,0,0,32,5,37
2009,Seychelles,SYC,United Kingdom of Great Britain and Northern Ireland,GBR,0,0,5,0,5
2009,Sierra Leone,SLE,United Kingdom of Great Britain and Northern Ireland,GBR,5,10,61,14,90
2009,Somalia,SOM,United Kingdom of Great Britain and Northern Ireland,GBR,535,85,590,116,1326
2009,Viet Nam,VNM,United Kingdom of Great Britain and Northern Ireland,GBR,0,23,72,340,435
2009,Sudan,SDN,United Kingdom of Great Britain and Northern Ireland,GBR,102,5,161,57,325
2009,Slovakia,SVK,United Kingdom of Great Britain and Northern Ireland,GBR,0,0,0,5,5
2009,Eswatini,SWZ,United Kingdom of Great Britain and Northern Ireland,GBR,0,0,5,0,5
2009,Syrian Arab Rep.,SYR,United Kingdom of Great Britain and Northern Ireland,GBR,42,10,134,19,205
2009,United Rep. of Tanzania,TZA,United Kingdom of Great Britain and Northern Ireland,GBR,0,5,35,5,45
2009,Thailand,THA,United Kingdom of Great Britain and Northern Ireland,GBR,0,5,10,0,15
2009,Tajikistan,TJK,United Kingdom of Great Britain and Northern Ireland,GBR,5,0,0,0,5
2009,Turkmenistan,TKM,United Kingdom of Great Britain and Northern Ireland,GBR,0,5,5,0,10
2009,Togo,TGO,United Kingdom of Great Britain and Northern Ireland,GBR,0,0,14,0,14
2009,Trinidad and Tobago,TTO,United Kingdom of Great Britain and Northern Ireland,GBR,0,5,23,0,28
2009,Tunisia,TUN,United Kingdom of Great Britain and Northern Ireland,GBR,0,0,19,10,29
2009,Turkey,TUR,United Kingdom of Great Britain and Northern Ireland,GBR,17,10,135,35,197
2009,Uganda,UGA,United Kingdom of Great Britain and Northern Ireland,GBR,5,5,156,10,176
2009,Ukraine,UKR,United Kingdom of Great Britain and Northern Ireland,GBR,0,0,31,27,58
2009,United States of America,USA,United Kingdom of Great Britain and Northern Ireland,GBR,5,0,16,5,26
2009,Uzbekistan,UZB,United Kingdom of Great Britain and Northern Ireland,GBR,0,0,14,0,14
2009,Saint Vincent and the Grenadines,VCT,United Kingdom of Great Britain and Northern Ireland,GBR,0,0,0,5,5
2009,Venezuela (Bolivarian Republic of),VEN,United Kingdom of Great Britain and Northern Ireland,GBR,0,0,5,0,5
2009,Western Sahara,ESH,United Kingdom of Great Britain and Northern Ireland,GBR,0,0,5,0,5
2009,Yemen,YEM,United Kingdom of Great Britain and Northern Ireland,GBR,28,5,44,0,77
2009,Zambia,ZMB,United Kingdom of Great Britain and Northern Ireland,GBR,5,0,38,0,43
2009,Zimbabwe,ZWE,United Kingdom of Great Britain and Northern Ireland,GBR,2386,430,5451,166,8433
2009,Central African Rep.,CAF,Ghana,GHA,0,0,5,0,5
2009,Chad,TCD,Ghana,GHA,0,0,23,0,23
2009,Cameroon,CMR,Ghana,GHA,0,0,5,0,5
2009,Congo,COG,Ghana,GHA,12,0,0,0,12
2009,Dem. Rep. of the Congo,COD,Ghana,GHA,14,0,5,0,19
2009,Palestinian,PSE,Ghana,GHA,0,0,0,5,5
2009,Cote d'Ivoire,CIV,Ghana,GHA,5,0,10,0,15
2009,Nigeria,NGA,Ghana,GHA,0,0,10,0,10
2009,Rwanda,RWA,Ghana,GHA,5,0,0,0,5
2009,Somalia,SOM,Ghana,GHA,18,0,0,0,18
2009,Sudan,SDN,Ghana,GHA,23,0,0,0,23
2009,Togo,TGO,Ghana,GHA,10,0,0,0,10
2009,Congo,COG,Guinea-Bissau,GNB,5,0,0,0,5
2009,Liberia,LBR,Guinea-Bissau,GNB,10,0,0,0,10
2009,Sierra Leone,SLE,Guinea-Bissau,GNB,5,0,27,0,32
2009,Afghanistan,AFG,Greece,GRC,0,0,1580,39,1619
2009,Albania,ALB,Greece,GRC,0,0,466,44,510
2009,Algeria,DZA,Greece,GRC,0,0,28,0,28
2009,Egypt,EGY,Greece,GRC,0,0,102,5,107
2009,Armenia,ARM,Greece,GRC,0,0,77,5,82
2009,Burundi,BDI,Greece,GRC,0,0,5,0,5
2009,Bangladesh,BGD,Greece,GRC,0,0,1672,0,1672
2009,Burkina Faso,BFA,Greece,GRC,0,0,60,0,60
2009,Belarus,BLR,Greece,GRC,0,0,11,0,11
2009,Brazil,BRA,Greece,GRC,0,0,5,0,5
2009,Bulgaria,BGR,Greece,GRC,0,0,5,0,5
2009,China,CHN,Greece,GRC,0,0,223,5,228
2009,Chile,CHL,Greece,GRC,0,0,5,0,5
2009,Cameroon,CMR,Greece,GRC,0,0,28,0,28
2009,Dem. Rep. of the Congo,COD,Greece,GRC,0,0,14,0,14
2009,Cuba,CUB,Greece,GRC,0,0,5,0,5
2009,Dominica,DMA,Greece,GRC,0,0,10,0,10
2009,Dominican Rep.,DOM,Greece,GRC,0,0,28,0,28
2009,Eritrea,ERI,Greece,GRC,0,0,28,5,33
2009,Ethiopia,ETH,Greece,GRC,0,0,166,0,166
2009,Gambia,GMB,Greece,GRC,0,0,13,0,13
2009,Georgia,GEO,Greece,GRC,0,0,1665,92,1757
2009,Ghana,GHA,Greece,GRC,0,0,164,5,169
2009,Guinea,GIN,Greece,GRC,0,0,100,5,105
2009,Cote d'Ivoire,CIV,Greece,GRC,0,0,23,0,23
2009,India,IND,Greece,GRC,0,0,132,5,137
2009,Indonesia,IDN,Greece,GRC,0,0,129,0,129
2009,Iran (Islamic Rep. of),IRN,Greece,GRC,0,17,299,0,316
2009,Iraq,IRQ,Greece,GRC,0,0,878,26,904
2009,Kazakhstan,KAZ,Greece,GRC,0,0,10,0,10
2009,Kenya,KEN,Greece,GRC,0,0,67,0,67
2009,Liberia,LBR,Greece,GRC,0,0,5,0,5
2009,Libya,LBY,Greece,GRC,0,0,5,0,5
2009,Lebanon,LBN,Greece,GRC,0,0,21,0,21
2009,Sri Lanka,LKA,Greece,GRC,0,0,121,0,121
2009,Mauritania,MRT,Greece,GRC,0,0,38,0,38
2009,Rep. of Moldova,MDA,Greece,GRC,0,0,86,5,91
2009,Mali,MLI,Greece,GRC,0,0,5,0,5
2009,Morocco,MAR,Greece,GRC,0,0,99,0,99
2009,Myanmar,MMR,Greece,GRC,0,0,22,5,27
2009,Nepal,NPL,Greece,GRC,0,0,5,0,5
2009,Niger,NER,Greece,GRC,0,0,5,0,5
2009,Nigeria,NGA,Greece,GRC,0,0,710,66,776
2009,Pakistan,PAK,Greece,GRC,0,0,3080,26,3106
2009,Philippines,PHL,Greece,GRC,0,0,77,5,82
2009,Russian Federation,RUS,Greece,GRC,0,0,84,20,104
2009,Rwanda,RWA,Greece,GRC,0,0,13,0,13
2009,Serbia and Kosovo: S/RES/1244 (1999),SRB,Greece,GRC,0,0,5,0,5
2009,Senegal,SEN,Greece,GRC,0,0,355,0,355
2009,Sierra Leone,SLE,Greece,GRC,0,0,33,0,33
2009,Somalia,SOM,Greece,GRC,0,0,128,0,128
2009,Sudan,SDN,Greece,GRC,0,0,120,0,120
2009,Syrian Arab Rep.,SYR,Greece,GRC,0,0,889,10,899
2009,United Rep. of Tanzania,TZA,Greece,GRC,0,0,17,0,17
2009,Togo,TGO,Greece,GRC,0,0,5,0,5
2009,Tunisia,TUN,Greece,GRC,0,0,5,0,5
2009,Turkey,TUR,Greece,GRC,0,0,46,10,56
2009,Uganda,UGA,Greece,GRC,0,0,5,0,5
2009,Ukraine,UKR,Greece,GRC,0,0,50,0,50
2009,Uzbekistan,UZB,Greece,GRC,0,0,5,0,5
2009,Bhutan,BTN,Guatemala,GTM,0,0,0,5,5
2009,China,CHN,Guatemala,GTM,0,0,0,5,5
2009,Colombia,COL,Guatemala,GTM,0,0,0,5,5
2009,Cuba,CUB,Guatemala,GTM,0,0,0,10,10
2009,Nepal,NPL,Guatemala,GTM,0,0,0,5,5
2009,Somalia,SOM,Guatemala,GTM,0,0,0,5,5
2009,Bangladesh,BGD,Honduras,HND,0,0,0,5,5
2009,Colombia,COL,Honduras,HND,5,0,0,5,10
2009,Cuba,CUB,Honduras,HND,0,0,0,5,5
2009,Nepal,NPL,Honduras,HND,0,0,0,5,5
2009,Somalia,SOM,Honduras,HND,0,0,0,14,14
2009,Afghanistan,AFG,Croatia,HRV,0,0,0,17,17
2009,Albania,ALB,Croatia,HRV,0,0,0,5,5
2009,Bosnia and Herzegovina,BIH,Croatia,HRV,0,0,14,0,14
2009,Congo,COG,Croatia,HRV,0,0,5,0,5
2009,Czechia,CZE,Croatia,HRV,0,0,14,0,14
2009,Georgia,GEO,Croatia,HRV,0,0,0,5,5
2009,Iran (Islamic Rep. of),IRN,Croatia,HRV,0,0,0,14,14
2009,North Macedonia,MKD,Croatia,HRV,0,0,0,5,5
2009,Nigeria,NGA,Croatia,HRV,0,0,5,0,5
2009,Pakistan,PAK,Croatia,HRV,0,0,15,5,20
2009,Russian Federation,RUS,Croatia,HRV,0,0,10,0,10
2009,Serbia and Kosovo: S/RES/1244 (1999),SRB,Croatia,HRV,0,0,15,18,33
2009,Turkey,TUR,Croatia,HRV,0,0,0,5,5
2009,Ukraine,UKR,Croatia,HRV,0,0,5,0,5
2009,Uzbekistan,UZB,Croatia,HRV,5,0,0,0,5
2009,Stateless,XXA,Croatia,HRV,0,0,0,5,5
2009,Afghanistan,AFG,Iceland,ISL,0,0,0,5,5
2009,Albania,ALB,Iceland,ISL,0,5,0,5,10
2009,Iran (Islamic Rep. of),IRN,Iceland,ISL,5,0,0,0,5
2009,Serbia and Kosovo: S/RES/1244 (1999),SRB,Iceland,ISL,0,5,0,0,5
2009,Syrian Arab Rep.,SYR,Iceland,ISL,0,0,0,5,5
2009,Afghanistan,AFG,Ireland,IRL,0,0,59,5,64
2009,Albania,ALB,Ireland,IRL,0,0,53,14,67
2009,Algeria,DZA,Ireland,IRL,0,0,67,18,85
2009,Angola,AGO,Ireland,IRL,0,0,26,5,31
2009,Egypt,EGY,Ireland,IRL,0,0,20,25,45
2009,Burundi,BDI,Ireland,IRL,0,0,5,0,5
2009,Benin,BEN,Ireland,IRL,0,0,10,0,10
2009,Bangladesh,BGD,Ireland,IRL,0,0,52,0,52
2009,Bhutan,BTN,Ireland,IRL,0,0,16,0,16
2009,Belarus,BLR,Ireland,IRL,0,0,12,5,17
2009,Botswana,BWA,Ireland,IRL,0,0,5,0,5
2009,Brazil,BRA,Ireland,IRL,0,0,12,5,17
2009,Bosnia and Herzegovina,BIH,Ireland,IRL,0,0,0,5,5
2009,Chad,TCD,Ireland,IRL,0,0,5,0,5
2009,China,CHN,Ireland,IRL,5,0,67,152,224
2009,Cameroon,CMR,Ireland,IRL,0,0,46,5,51
2009,Congo,COG,Ireland,IRL,0,0,13,0,13
2009,Dem. Rep. of the Congo,COD,Ireland,IRL,0,0,124,24,148
2009,Cabo Verde,CPV,Ireland,IRL,0,0,5,0,5
2009,Eritrea,ERI,Ireland,IRL,10,0,36,25,71
2009,Ethiopia,ETH,Ireland,IRL,5,0,12,0,17
2009,Palestinian,PSE,Ireland,IRL,5,0,14,12,31
2009,Georgia,GEO,Ireland,IRL,0,0,122,45,167
2009,Ghana,GHA,Ireland,IRL,0,0,114,10,124
2009,Guinea,GIN,Ireland,IRL,0,0,15,5,20
2009,Guyana,GUY,Ireland,IRL,0,0,5,0,5
2009,Croatia,HRV,Ireland,IRL,0,0,10,0,10
2009,Cote d'Ivoire,CIV,Ireland,IRL,0,0,13,0,13
2009,India,IND,Ireland,IRL,0,0,19,14,33
2009,Iran (Islamic Rep. of),IRN,Ireland,IRL,5,0,33,21,59
2009,Iraq,IRQ,Ireland,IRL,21,0,85,36,142
2009,Israel,ISR,Ireland,IRL,0,0,12,0,12
2009,Kenya,KEN,Ireland,IRL,0,0,23,0,23
2009,Dem. People's Rep. of Korea,PRK,Ireland,IRL,0,0,0,5,5
2009,Kuwait,KWT,Ireland,IRL,0,0,5,5,10
2009,Liberia,LBR,Ireland,IRL,0,0,22,5,27
2009,Sri Lanka,LKA,Ireland,IRL,0,0,10,5,15
2009,Rep. of Moldova,MDA,Ireland,IRL,0,0,92,32,124
2009,Malaysia,MYS,Ireland,IRL,0,0,5,0,5
2009,Malawi,MWI,Ireland,IRL,0,0,10,5,15
2009,Mongolia,MNG,Ireland,IRL,0,0,5,15,20
2009,Morocco,MAR,Ireland,IRL,0,0,14,0,14
2009,Mauritius,MUS,Ireland,IRL,0,0,17,0,17
2009,Myanmar,MMR,Ireland,IRL,0,0,10,0,10
2009,Nepal,NPL,Ireland,IRL,0,0,11,0,11
2009,Nigeria,NGA,Ireland,IRL,0,0,521,92,613
2009,Pakistan,PAK,Ireland,IRL,5,0,239,68,312
2009,South Africa,ZAF,Ireland,IRL,0,0,55,10,65
2009,Russian Federation,RUS,Ireland,IRL,0,0,27,10,37
2009,Serbia and Kosovo: S/RES/1244 (1999),SRB,Ireland,IRL,0,0,29,5,34
2009,Sierra Leone,SLE,Ireland,IRL,0,0,23,5,28
2009,Somalia,SOM,Ireland,IRL,12,0,115,48,175
2009,Sudan,SDN,Ireland,IRL,16,0,75,22,113
2009,Syrian Arab Rep.,SYR,Ireland,IRL,0,0,5,0,5
2009,Togo,TGO,Ireland,IRL,0,0,14,0,14
2009,Uganda,UGA,Ireland,IRL,5,0,32,5,42
2009,Ukraine,UKR,Ireland,IRL,0,0,20,5,25
2009,United States of America,USA,Ireland,IRL,0,0,0,5,5
2009,Zimbabwe,ZWE,Ireland,IRL,5,0,104,10,119
2009,Benin,BEN,Israel,ISR,0,0,5,0,5
2009,Burkina Faso,BFA,Israel,ISR,0,0,5,0,5
2009,Cameroon,CMR,Israel,ISR,0,0,5,0,5
2009,Colombia,COL,Israel,ISR,0,0,32,0,32
2009,Ethiopia,ETH,Israel,ISR,0,0,35,0,35
2009,Georgia,GEO,Israel,ISR,0,0,275,0,275
2009,Ghana,GHA,Israel,ISR,0,0,132,0,132
2009,Guinea-Bissau,GNB,Israel,ISR,0,0,5,0,5
2009,Guinea,GIN,Israel,ISR,0,0,26,0,26
2009,Cote d'Ivoire,CIV,Israel,ISR,0,0,163,0,163
2009,India,IND,Israel,ISR,0,0,10,0,10
2009,Sri Lanka,LKA,Israel,ISR,0,0,10,0,10
2009,Mali,MLI,Israel,ISR,0,0,10,0,10
2009,Nepal,NPL,Israel,ISR,0,0,5,0,5
2009,Niger,NER,Israel,ISR,0,0,10,0,10
2009,Nigeria,NGA,Israel,ISR,0,0,239,0,239
2009,Philippines,PHL,Israel,ISR,0,0,28,0,28
2009,Togo,TGO,Israel,ISR,0,0,5,0,5
2009,Turkey,TUR,Israel,ISR,0,0,40,0,40
2009,Afghanistan,AFG,Italy,ITA,214,526,111,73,924
2009,Albania,ALB,Italy,ITA,10,29,35,0,74
2009,Algeria,DZA,Italy,ITA,14,15,352,10,391
2009,Angola,AGO,Italy,ITA,0,12,0,0,12
2009,Egypt,EGY,Italy,ITA,0,5,30,5,40
2009,Armenia,ARM,Italy,ITA,0,13,0,0,13
2009,Azerbaijan,AZE,Italy,ITA,12,0,0,0,12
2009,Benin,BEN,Italy,ITA,5,14,35,5,59
2009,Bangladesh,BGD,Italy,ITA,16,126,792,967,1901
2009,Burkina Faso,BFA,Italy,ITA,17,82,360,15,474
2009,Belarus,BLR,Italy,ITA,0,5,0,0,5
2009,Bolivia (Plurinational State of),BOL,Italy,ITA,0,0,5,0,5
2009,Brazil,BRA,Italy,ITA,0,5,12,5,22
2009,Bosnia and Herzegovina,BIH,Italy,ITA,0,25,5,5,35
2009,Central African Rep.,CAF,Italy,ITA,0,5,0,0,5
2009,Chad,TCD,Italy,ITA,5,11,10,0,26
2009,China,CHN,Italy,ITA,21,5,17,0,43
2009,Cameroon,CMR,Italy,ITA,42,46,61,13,162
2009,Congo,COG,Italy,ITA,26,26,26,5,83
2009,Dem. Rep. of the Congo,COD,Italy,ITA,28,10,11,0,49
2009,Colombia,COL,Italy,ITA,10,11,5,0,26
2009,Cuba,CUB,Italy,ITA,5,28,10,0,43
2009,Ecuador,ECU,Italy,ITA,0,0,5,0,5
2009,Eritrea,ERI,Italy,ITA,411,935,352,25,1723
2009,Ethiopia,ETH,Italy,ITA,55,68,43,5,171
2009,Gabon,GAB,Italy,ITA,0,0,5,0,5
2009,Gambia,GMB,Italy,ITA,13,71,419,13,516
2009,Palestinian,PSE,Italy,ITA,142,16,34,5,197
2009,Georgia,GEO,Italy,ITA,5,30,44,5,84
2009,Ghana,GHA,Italy,ITA,10,152,1027,52,1241
2009,Guinea-Bissau,GNB,Italy,ITA,0,5,16,5,26
2009,Guatemala,GTM,Italy,ITA,0,0,5,0,5
2009,Guinea,GIN,Italy,ITA,54,90,188,14,346
2009,Croatia,HRV,Italy,ITA,0,13,0,0,13
2009,Cote d'Ivoire,CIV,Italy,ITA,76,370,502,35,983
2009,India,IND,Italy,ITA,5,25,152,20,202
2009,Iran (Islamic Rep. of),IRN,Italy,ITA,103,37,25,12,177
2009,Iraq,IRQ,Italy,ITA,148,260,77,44,529
2009,Jordan,JOR,Italy,ITA,0,0,5,0,5
2009,Kenya,KEN,Italy,ITA,10,15,35,0,60
2009,Liberia,LBR,Italy,ITA,0,29,95,13,137
2009,Libya,LBY,Italy,ITA,0,11,0,0,11
2009,Lebanon,LBN,Italy,ITA,17,18,32,5,72
2009,Sri Lanka,LKA,Italy,ITA,25,89,61,10,185
2009,Madagascar,MDG,Italy,ITA,0,5,0,0,5
2009,Mauritania,MRT,Italy,ITA,10,20,29,5,64
2009,North Macedonia,MKD,Italy,ITA,0,0,11,5,16
2009,Rep. of Moldova,MDA,Italy,ITA,0,11,14,5,30
2009,Mali,MLI,Italy,ITA,5,31,217,10,263
2009,Morocco,MAR,Italy,ITA,5,29,146,15,195
2009,Montenegro,MNE,Italy,ITA,0,13,5,0,18
2009,Myanmar,MMR,Italy,ITA,0,5,0,0,5
2009,Nepal,NPL,Italy,ITA,0,15,0,5,20
2009,Niger,NER,Italy,ITA,5,22,72,0,99
2009,Nigeria,NGA,Italy,ITA,45,656,4643,158,5502
2009,Pakistan,PAK,Italy,ITA,67,304,916,227,1514
2009,Peru,PER,Italy,ITA,0,5,16,0,21
2009,Russian Federation,RUS,Italy,ITA,5,18,5,0,28
2009,El Salvador,SLV,Italy,ITA,0,10,12,5,27
2009,Serbia and Kosovo: S/RES/1244 (1999),SRB,Italy,ITA,27,187,212,43,469
2009,Senegal,SEN,Italy,ITA,16,29,101,5,151
2009,Sierra Leone,SLE,Italy,ITA,5,18,65,5,93
2009,Somalia,SOM,Italy,ITA,252,2248,123,24,2647
2009,Sudan,SDN,Italy,ITA,78,47,82,5,212
2009,Syrian Arab Rep.,SYR,Italy,ITA,54,26,21,0,101
2009,Togo,TGO,Italy,ITA,37,61,130,10,238
2009,Tunisia,TUN,Italy,ITA,5,29,294,21,349
2009,Turkey,TUR,Italy,ITA,84,270,172,31,557
2009,Uganda,UGA,Italy,ITA,0,5,5,0,10
2009,Ukraine,UKR,Italy,ITA,0,14,5,0,19
2009,Uzbekistan,UZB,Italy,ITA,0,5,0,0,5
2009,Zimbabwe,ZWE,Italy,ITA,5,5,13,5,28
2009,Afghanistan,AFG,Japan,JPN,0,0,14,0,14
2009,Bangladesh,BGD,Japan,JPN,0,5,14,5,17
2009,China,CHN,Japan,JPN,0,17,30,0,31
2009,Cameroon,CMR,Japan,JPN,0,5,20,0,22
2009,Dem. Rep. of the Congo,COD,Japan,JPN,0,0,10,0,10
2009,Colombia,COL,Japan,JPN,0,0,5,0,5
2009,Ethiopia,ETH,Japan,JPN,0,0,36,5,41
2009,Ghana,GHA,Japan,JPN,0,0,5,0,5
2009,Guinea,GIN,Japan,JPN,0,0,5,0,5
2009,India,IND,Japan,JPN,0,0,16,10,26
2009,Iran (Islamic Rep. of),IRN,Japan,JPN,0,0,47,10,57
2009,Iraq,IRQ,Japan,JPN,0,0,0,5,5
2009,Sri Lanka,LKA,Japan,JPN,0,0,102,27,129
2009,Myanmar,MMR,Japan,JPN,15,460,1092,16,1123
2009,Nepal,NPL,Japan,JPN,0,0,18,0,18
2009,Nigeria,NGA,Japan,JPN,0,0,15,5,20
2009,Pakistan,PAK,Japan,JPN,0,0,60,10,70
2009,Philippines,PHL,Japan,JPN,0,0,11,0,11
2009,Viet Nam,VNM,Japan,JPN,0,0,5,0,5
2009,Sudan,SDN,Japan,JPN,0,0,15,0,15
2009,Turkey,TUR,Japan,JPN,0,0,124,18,142
2009,Uganda,UGA,Japan,JPN,0,0,15,0,15
2009,Afghanistan,AFG,Kyrgyzstan,KGZ,5,0,143,12,160
2009,Kazakhstan,KAZ,Kyrgyzstan,KGZ,0,0,5,0,5
2009,Pakistan,PAK,Kyrgyzstan,KGZ,0,0,5,0,5
2009,Russian Federation,RUS,Kyrgyzstan,KGZ,0,0,0,80,80
2009,Uzbekistan,UZB,Kyrgyzstan,KGZ,0,0,5,101,106
2009,Azerbaijan,AZE,Liechtenstein,LIE,0,0,0,5,5
2009,Czechia,CZE,Liechtenstein,LIE,0,0,5,0,5
2009,Eritrea,ERI,Liechtenstein,LIE,0,0,29,65,94
2009,Germany,DEU,Liechtenstein,LIE,0,0,5,0,5
2009,Kyrgyzstan,KGZ,Liechtenstein,LIE,0,0,5,0,5
2009,Russian Federation,RUS,Liechtenstein,LIE,0,0,5,15,20
2009,Serbia and Kosovo: S/RES/1244 (1999),SRB,Liechtenstein,LIE,0,0,5,5,10
2009,Somalia,SOM,Liechtenstein,LIE,0,0,25,76,101
2009,Syrian Arab Rep.,SYR,Liechtenstein,LIE,0,0,0,5,5
2009,Ukraine,UKR,Liechtenstein,LIE,0,0,0,5,5
2009,Afghanistan,AFG,Lithuania,LTU,0,5,0,0,5
2009,Belarus,BLR,Lithuania,LTU,0,0,5,5,10
2009,Cuba,CUB,Lithuania,LTU,0,0,5,0,5
2009,Georgia,GEO,Lithuania,LTU,0,0,18,31,49
2009,India,IND,Lithuania,LTU,0,0,0,5,5
2009,Iraq,IRQ,Lithuania,LTU,0,0,0,10,10
2009,Sri Lanka,LKA,Lithuania,LTU,0,5,0,0,5
2009,Pakistan,PAK,Lithuania,LTU,0,0,5,0,5
2009,Russian Federation,RUS,Lithuania,LTU,5,21,61,28,115
2009,Syrian Arab Rep.,SYR,Lithuania,LTU,0,0,0,5,5
2009,Uzbekistan,UZB,Lithuania,LTU,0,0,5,0,5
2009,Stateless,XXA,Lithuania,LTU,0,0,5,0,5
2009,Albania,ALB,Luxembourg,LUX,11,0,15,5,31
2009,Algeria,DZA,Luxembourg,LUX,0,0,0,11,11
2009,Benin,BEN,Luxembourg,LUX,0,0,5,0,5
2009,Belarus,BLR,Luxembourg,LUX,0,0,5,0,5
2009,Bosnia and Herzegovina,BIH,Luxembourg,LUX,0,0,15,14,29
2009,Cameroon,CMR,Luxembourg,LUX,0,0,0,5,5
2009,Eritrea,ERI,Luxembourg,LUX,0,0,5,5,10
2009,Ethiopia,ETH,Luxembourg,LUX,0,0,0,5,5
2009,Georgia,GEO,Luxembourg,LUX,0,0,0,5,5
2009,Guinea,GIN,Luxembourg,LUX,0,0,0,5,5
2009,Iran (Islamic Rep. of),IRN,Luxembourg,LUX,10,0,0,14,24
2009,Iraq,IRQ,Luxembourg,LUX,25,0,0,11,36
2009,Israel,ISR,Luxembourg,LUX,0,0,5,0,5
2009,Montenegro,MNE,Luxembourg,LUX,0,0,5,5,10
2009,Niger,NER,Luxembourg,LUX,0,0,0,10,10
2009,Nigeria,NGA,Luxembourg,LUX,0,0,0,5,5
2009,Romania,ROU,Luxembourg,LUX,0,0,0,5,5
2009,Russian Federation,RUS,Luxembourg,LUX,12,0,10,18,40
2009,Serbia and Kosovo: S/RES/1244 (1999),SRB,Luxembourg,LUX,13,0,108,61,182
2009,Senegal,SEN,Luxembourg,LUX,0,0,0,5,5
2009,Somalia,SOM,Luxembourg,LUX,5,0,0,5,10
2009,Togo,TGO,Luxembourg,LUX,0,0,5,0,5
2009,Tunisia,TUN,Luxembourg,LUX,5,0,0,0,5
2009,Uzbekistan,UZB,Luxembourg,LUX,0,0,5,0,5
2009,Afghanistan,AFG,Latvia,LVA,0,0,5,0,5
2009,Georgia,GEO,Latvia,LVA,0,0,0,5,5
2009,Russian Federation,RUS,Latvia,LVA,5,0,0,0,5
2009,Syrian Arab Rep.,SYR,Latvia,LVA,0,0,5,0,5
2009,China,CHN,Mexico,MEX,0,0,0,5,5
2009,Dem. Rep. of the Congo,COD,Mexico,MEX,5,0,0,0,5
2009,Colombia,COL,Mexico,MEX,24,0,10,10,44
2009,Cuba,CUB,Mexico,MEX,0,0,22,14,36
2009,Ghana,GHA,Mexico,MEX,0,0,5,0,5
2009,Guatemala,GTM,Mexico,MEX,5,0,15,20,40
2009,Haiti,HTI,Mexico,MEX,27,0,24,5,56
2009,Honduras,HND,Mexico,MEX,5,0,72,100,177
2009,India,IND,Mexico,MEX,5,0,0,18,23
2009,Iran (Islamic Rep. of),IRN,Mexico,MEX,5,0,0,0,5
2009,Iraq,IRQ,Mexico,MEX,5,0,0,0,5
2009,Sri Lanka,LKA,Mexico,MEX,10,0,0,0,10
2009,Nicaragua,NIC,Mexico,MEX,0,0,13,16,29
2009,Nigeria,NGA,Mexico,MEX,5,0,5,0,10
2009,Peru,PER,Mexico,MEX,0,0,5,5,10
2009,South Africa,ZAF,Mexico,MEX,0,0,0,5,5
2009,El Salvador,SLV,Mexico,MEX,12,0,63,40,115
2009,United States of America,USA,Mexico,MEX,0,0,5,0,5
2009,Dem. Rep. of the Congo,COD,Mali,MLI,5,0,0,0,5
2009,Cote d'Ivoire,CIV,Mali,MLI,5,0,0,0,5
2009,Sierra Leone,SLE,Mali,MLI,0,0,0,364,364
2009,Burundi,BDI,Malawi,MWI,112,0,61,1042,1215
2009,Dem. Rep. of the Congo,COD,Malawi,MWI,303,0,23,610,936
2009,Ethiopia,ETH,Malawi,MWI,0,0,10,0,10
2009,Kenya,KEN,Malawi,MWI,0,0,0,5,5
2009,Rwanda,RWA,Malawi,MWI,91,0,82,1603,1776
2009,Somalia,SOM,Malawi,MWI,28,0,0,10,38
2009,Zambia,ZMB,Malawi,MWI,0,0,5,0,5
2009,Zimbabwe,ZWE,Malawi,MWI,0,0,0,5,5
2009,Angola,AGO,Mozambique,MOZ,5,0,0,0,5
2009,Burundi,BDI,Mozambique,MOZ,150,0,42,283,475
2009,Dem. Rep. of the Congo,COD,Mozambique,MOZ,322,0,197,538,1057
2009,Rwanda,RWA,Mozambique,MOZ,24,0,27,69,120
2009,Somalia,SOM,Mozambique,MOZ,5,0,0,67,72
2009,Uganda,UGA,Mozambique,MOZ,0,0,0,10,10
2009,Algeria,DZA,Malta,MLT,0,0,5,0,5
2009,Bangladesh,BGD,Malta,MLT,0,0,19,0,19
2009,Burkina Faso,BFA,Malta,MLT,0,0,19,5,24
2009,Chad,TCD,Malta,MLT,0,0,5,0,5
2009,Eritrea,ERI,Malta,MLT,5,195,24,0,224
2009,Ethiopia,ETH,Malta,MLT,5,0,17,0,22
2009,Gambia,GMB,Malta,MLT,0,0,17,0,17
2009,Palestinian,PSE,Malta,MLT,0,0,16,0,16
2009,Georgia,GEO,Malta,MLT,0,5,0,0,5
2009,Ghana,GHA,Malta,MLT,0,0,39,5,44
2009,Guinea,GIN,Malta,MLT,0,0,25,5,30
2009,Cote d'Ivoire,CIV,Malta,MLT,0,0,77,18,95
2009,India,IND,Malta,MLT,0,0,10,0,10
2009,Iraq,IRQ,Malta,MLT,0,0,5,0,5
2009,Liberia,LBR,Malta,MLT,0,0,11,0,11
2009,Mali,MLI,Malta,MLT,0,5,132,18,155
2009,Morocco,MAR,Malta,MLT,0,0,5,0,5
2009,Niger,NER,Malta,MLT,0,0,23,5,28
2009,Nigeria,NGA,Malta,MLT,0,0,278,11,289
2009,Somalia,SOM,Malta,MLT,5,1445,130,5,1585
2009,Sudan,SDN,Malta,MLT,0,24,22,0,46
2009,Syrian Arab Rep.,SYR,Malta,MLT,5,0,0,0,5
2009,Togo,TGO,Malta,MLT,0,0,17,0,17
2009,Burundi,BDI,Namibia,NAM,19,0,5,0,24
2009,Dem. Rep. of the Congo,COD,Namibia,NAM,114,0,101,23,238
2009,Rwanda,RWA,Namibia,NAM,0,0,18,0,18
2009,Sudan,SDN,Namibia,NAM,5,0,0,0,5
2009,United Rep. of Tanzania,TZA,Namibia,NAM,0,0,5,0,5
2009,Zimbabwe,ZWE,Namibia,NAM,5,0,23,0,28
2009,Bhutan,BTN,Nepal,NPL,0,17,0,5,22
2009,Afghanistan,AFG,Netherlands,NLD,22,263,591,0,876
2009,Albania,ALB,Netherlands,NLD,0,0,13,0,13
2009,Algeria,DZA,Netherlands,NLD,0,0,30,0,30
2009,Angola,AGO,Netherlands,NLD,0,20,57,0,77
2009,Egypt,EGY,Netherlands,NLD,5,13,20,0,38
2009,Argentina,ARG,Netherlands,NLD,0,0,5,0,5
2009,Armenia,ARM,Netherlands,NLD,10,62,217,0,289
2009,Azerbaijan,AZE,Netherlands,NLD,12,43,61,0,116
2009,Burundi,BDI,Netherlands,NLD,0,60,74,0,134
2009,Benin,BEN,Netherlands,NLD,0,0,5,0,5
2009,Bangladesh,BGD,Netherlands,NLD,0,0,14,0,14
2009,Bhutan,BTN,Netherlands,NLD,25,24,5,0,54
2009,Burkina Faso,BFA,Netherlands,NLD,0,0,15,0,15
2009,Belarus,BLR,Netherlands,NLD,5,0,11,0,16
2009,Bosnia and Herzegovina,BIH,Netherlands,NLD,0,0,13,0,13
2009,Cambodia,KHM,Netherlands,NLD,0,5,0,0,5
2009,Central African Rep.,CAF,Netherlands,NLD,0,0,5,0,5
2009,Chad,TCD,Netherlands,NLD,0,0,5,0,5
2009,China,CHN,Netherlands,NLD,55,59,152,0,266
2009,Cameroon,CMR,Netherlands,NLD,0,10,21,0,31
2009,Congo,COG,Netherlands,NLD,5,48,66,0,119
2009,Dem. Rep. of the Congo,COD,Netherlands,NLD,5,43,25,0,73
2009,Colombia,COL,Netherlands,NLD,0,15,31,0,46
2009,Cuba,CUB,Netherlands,NLD,0,0,5,0,5
2009,Ecuador,ECU,Netherlands,NLD,0,0,5,0,5
2009,Eritrea,ERI,Netherlands,NLD,18,223,149,0,390
2009,Ethiopia,ETH,Netherlands,NLD,23,54,40,0,117
2009,Gambia,GMB,Netherlands,NLD,0,0,17,0,17
2009,Palestinian,PSE,Netherlands,NLD,0,14,36,0,50
2009,Georgia,GEO,Netherlands,NLD,0,5,98,0,103
2009,Ghana,GHA,Netherlands,NLD,0,0,25,0,25
2009,Guinea,GIN,Netherlands,NLD,5,95,186,0,286
2009,Cote d'Ivoire,CIV,Netherlands,NLD,5,56,37,0,98
2009,India,IND,Netherlands,NLD,0,0,33,0,33
2009,Indonesia,IDN,Netherlands,NLD,0,0,10,0,10
2009,Iran (Islamic Rep. of),IRN,Netherlands,NLD,91,138,279,0,508
2009,Iraq,IRQ,Netherlands,NLD,200,1643,2510,0,4353
2009,Israel,ISR,Netherlands,NLD,0,0,5,0,5
2009,Jamaica,JAM,Netherlands,NLD,5,0,0,0,5
2009,Kazakhstan,KAZ,Netherlands,NLD,0,5,12,0,17
2009,Kenya,KEN,Netherlands,NLD,0,5,26,0,31
2009,Kyrgyzstan,KGZ,Netherlands,NLD,0,0,5,0,5
2009,Dem. People's Rep. of Korea,PRK,Netherlands,NLD,0,5,0,0,5
2009,Liberia,LBR,Netherlands,NLD,0,20,23,0,43
2009,Libya,LBY,Netherlands,NLD,5,91,15,0,111
2009,Lebanon,LBN,Netherlands,NLD,0,0,13,0,13
2009,Sri Lanka,LKA,Netherlands,NLD,15,59,170,0,244
2009,Mauritania,MRT,Netherlands,NLD,0,0,5,0,5
2009,Mali,MLI,Netherlands,NLD,0,0,5,0,5
2009,Malawi,MWI,Netherlands,NLD,0,0,5,0,5
2009,Mongolia,MNG,Netherlands,NLD,0,5,123,0,128
2009,Morocco,MAR,Netherlands,NLD,0,0,19,0,19
2009,Myanmar,MMR,Netherlands,NLD,10,84,14,0,108
2009,Nepal,NPL,Netherlands,NLD,12,30,60,0,102
2009,Niger,NER,Netherlands,NLD,0,5,5,0,10
2009,Nigeria,NGA,Netherlands,NLD,0,20,123,0,143
2009,Pakistan,PAK,Netherlands,NLD,5,5,31,0,41
2009,Peru,PER,Netherlands,NLD,0,5,0,0,5
2009,South Africa,ZAF,Netherlands,NLD,0,0,5,0,5
2009,Russian Federation,RUS,Netherlands,NLD,0,21,107,0,128
2009,Rwanda,RWA,Netherlands,NLD,0,18,10,0,28
2009,Serbia and Kosovo: S/RES/1244 (1999),SRB,Netherlands,NLD,0,10,69,0,79
2009,Senegal,SEN,Netherlands,NLD,0,0,5,0,5
2009,Sierra Leone,SLE,Netherlands,NLD,0,105,131,0,236
2009,Somalia,SOM,Netherlands,NLD,93,3443,1925,0,5461
2009,Viet Nam,VNM,Netherlands,NLD,0,0,13,0,13
2009,Sudan,SDN,Netherlands,NLD,5,37,83,0,125
2009,Suriname,SUR,Netherlands,NLD,0,0,5,0,5
2009,Syrian Arab Rep.,SYR,Netherlands,NLD,10,16,68,0,94
2009,United Rep. of Tanzania,TZA,Netherlands,NLD,0,0,5,0,5
2009,Tajikistan,TJK,Netherlands,NLD,0,0,5,0,5
2009,Togo,TGO,Netherlands,NLD,0,5,17,0,22
2009,Tunisia,TUN,Netherlands,NLD,0,0,12,0,12
2009,Turkey,TUR,Netherlands,NLD,5,5,61,0,71
2009,Uganda,UGA,Netherlands,NLD,0,14,38,0,52
2009,Ukraine,UKR,Netherlands,NLD,0,0,18,0,18
2009,Uzbekistan,UZB,Netherlands,NLD,0,5,19,0,24
2009,Venezuela (Bolivarian Republic of),VEN,Netherlands,NLD,0,0,5,0,5
2009,Yemen,YEM,Netherlands,NLD,0,10,0,0,10
2009,Zimbabwe,ZWE,Netherlands,NLD,0,11,0,0,11
2009,Stateless,XXA,Netherlands,NLD,5,33,61,0,99
2009,Chad,TCD,Niger,NER,0,0,0,5,5
2009,Colombia,COL,Nicaragua,NIC,5,0,0,0,5
2009,Eritrea,ERI,Nicaragua,NIC,0,0,0,89,89
2009,Ethiopia,ETH,Nicaragua,NIC,0,0,0,17,17
2009,Honduras,HND,Nicaragua,NIC,50,0,0,0,50
2009,Nepal,NPL,Nicaragua,NIC,0,0,0,18,18
2009,Somalia,SOM,Nicaragua,NIC,14,0,0,75,89
2009,Afghanistan,AFG,Norway,NOR,138,841,996,862,2837
2009,Albania,ALB,Norway,NOR,0,0,23,13,36
2009,Algeria,DZA,Norway,NOR,0,0,58,88,146
2009,Angola,AGO,Norway,NOR,0,0,11,0,11
2009,Egypt,EGY,Norway,NOR,0,0,5,14,19
2009,Armenia,ARM,Norway,NOR,0,0,10,19,29
2009,Azerbaijan,AZE,Norway,NOR,0,0,40,13,53
2009,Burundi,BDI,Norway,NOR,5,0,24,11,40
2009,Bangladesh,BGD,Norway,NOR,0,0,5,0,5
2009,Bhutan,BTN,Norway,NOR,0,0,13,0,13
2009,Burkina Faso,BFA,Norway,NOR,0,0,0,5,5
2009,Belarus,BLR,Norway,NOR,0,0,5,5,10
2009,Bosnia and Herzegovina,BIH,Norway,NOR,0,0,12,5,17
2009,Bulgaria,BGR,Norway,NOR,0,0,12,0,12
2009,China,CHN,Norway,NOR,29,16,5,5,55
2009,Chile,CHL,Norway,NOR,0,0,5,0,5
2009,Cameroon,CMR,Norway,NOR,0,0,21,15,36
2009,Congo,COG,Norway,NOR,0,0,0,5,5
2009,Dem. Rep. of the Congo,COD,Norway,NOR,14,5,20,26,65
2009,Colombia,COL,Norway,NOR,0,0,0,11,11
2009,Czechia,CZE,Norway,NOR,0,0,5,5,10
2009,Eritrea,ERI,Norway,NOR,604,776,87,707,2174
2009,Ethiopia,ETH,Norway,NOR,180,37,201,97,515
2009,Gabon,GAB,Norway,NOR,0,0,0,5,5
2009,Gambia,GMB,Norway,NOR,0,0,30,16,46
2009,Georgia,GEO,Norway,NOR,0,0,14,18,32
2009,Ghana,GHA,Norway,NOR,0,0,12,34,46
2009,Guinea-Bissau,GNB,Norway,NOR,0,0,0,5,5
2009,Guinea,GIN,Norway,NOR,0,0,31,19,50
2009,Honduras,HND,Norway,NOR,0,0,5,0,5
2009,Croatia,HRV,Norway,NOR,0,0,14,0,14
2009,Hungary,HUN,Norway,NOR,0,0,29,0,29
2009,Cote d'Ivoire,CIV,Norway,NOR,0,0,5,14,19
2009,India,IND,Norway,NOR,0,0,37,20,57
2009,Iran (Islamic Rep. of),IRN,Norway,NOR,118,50,331,137,636
2009,Iraq,IRQ,Norway,NOR,145,222,1545,537,2449
2009,Israel,ISR,Norway,NOR,0,0,11,5,16
2009,Italy,ITA,Norway,NOR,0,0,5,0,5
2009,Jordan,JOR,Norway,NOR,0,0,11,10,21
2009,Kazakhstan,KAZ,Norway,NOR,0,0,10,11,21
2009,Kenya,KEN,Norway,NOR,0,0,5,0,5
2009,Kyrgyzstan,KGZ,Norway,NOR,0,0,17,0,17
2009,Rep. of Korea,KOR,Norway,NOR,0,0,0,5,5
2009,Dem. People's Rep. of Korea,PRK,Norway,NOR,0,0,10,0,10
2009,Kuwait,KWT,Norway,NOR,0,0,0,5,5
2009,Liberia,LBR,Norway,NOR,0,0,13,14,27
2009,Libya,LBY,Norway,NOR,0,0,33,47,80
2009,Lebanon,LBN,Norway,NOR,0,5,10,19,34
2009,Sri Lanka,LKA,Norway,NOR,5,39,264,26,334
2009,Lithuania,LTU,Norway,NOR,0,0,5,0,5
2009,Mauritania,MRT,Norway,NOR,0,0,15,14,29
2009,North Macedonia,MKD,Norway,NOR,0,0,5,19,24
2009,Rep. of Moldova,MDA,Norway,NOR,0,0,5,10,15
2009,Morocco,MAR,Norway,NOR,0,0,21,29,50
2009,Myanmar,MMR,Norway,NOR,5,11,5,5,26
2009,Nepal,NPL,Norway,NOR,0,0,218,13,231
2009,Niger,NER,Norway,NOR,0,0,13,0,13
2009,Nigeria,NGA,Norway,NOR,0,10,366,215,591
2009,Pakistan,PAK,Norway,NOR,0,0,48,37,85
2009,Poland,POL,Norway,NOR,0,0,5,0,5
2009,Russian Federation,RUS,Norway,NOR,5,47,466,226,744
2009,Rwanda,RWA,Norway,NOR,0,5,5,0,10
2009,Serbia and Kosovo: S/RES/1244 (1999),SRB,Norway,NOR,0,5,219,164,388
2009,Senegal,SEN,Norway,NOR,0,0,11,11,22
2009,Sierra Leone,SLE,Norway,NOR,0,0,10,10,20
2009,Somalia,SOM,Norway,NOR,296,350,64,834,1544
2009,Viet Nam,VNM,Norway,NOR,0,0,13,10,23
2009,Sudan,SDN,Norway,NOR,53,0,12,77,142
2009,Syrian Arab Rep.,SYR,Norway,NOR,5,0,71,76,152
2009,Tajikistan,TJK,Norway,NOR,0,0,0,5,5
2009,Turkmenistan,TKM,Norway,NOR,5,0,0,0,5
2009,Tunisia,TUN,Norway,NOR,0,0,10,15,25
2009,Turkey,TUR,Norway,NOR,0,0,29,34,63
2009,Uganda,UGA,Norway,NOR,0,0,13,5,18
2009,Ukraine,UKR,Norway,NOR,0,0,5,21,26
2009,United States of America,USA,Norway,NOR,0,0,0,5,5
2009,Uzbekistan,UZB,Norway,NOR,0,0,88,17,105
2009,Western Sahara,ESH,Norway,NOR,0,0,0,5,5
2009,Yemen,YEM,Norway,NOR,5,21,71,15,112
2009,Zimbabwe,ZWE,Norway,NOR,0,0,13,5,18
2009,Stateless,XXA,Norway,NOR,129,299,386,255,1069
2009,Algeria,DZA,New Zealand,NZL,0,0,5,0,5
2009,Bangladesh,BGD,New Zealand,NZL,0,0,12,0,12
2009,Brazil,BRA,New Zealand,NZL,0,0,5,0,5
2009,China,CHN,New Zealand,NZL,12,0,10,0,22
2009,Chile,CHL,New Zealand,NZL,0,0,5,0,5
2009,Dem. Rep. of the Congo,COD,New Zealand,NZL,0,0,5,0,5
2009,Czechia,CZE,New Zealand,NZL,0,0,25,0,25
2009,Ethiopia,ETH,New Zealand,NZL,0,0,5,0,5
2009,Fiji,FJI,New Zealand,NZL,0,0,28,0,28
2009,Ghana,GHA,New Zealand,NZL,0,0,5,0,5
2009,India,IND,New Zealand,NZL,0,0,31,0,31
2009,Iran (Islamic Rep. of),IRN,New Zealand,NZL,5,0,21,0,26
2009,Iraq,IRQ,New Zealand,NZL,14,0,5,0,19
2009,Sri Lanka,LKA,New Zealand,NZL,12,0,10,0,22
2009,Nigeria,NGA,New Zealand,NZL,0,0,5,0,5
2009,South Africa,ZAF,New Zealand,NZL,0,0,10,0,10
2009,Saudi Arabia,SAU,New Zealand,NZL,0,0,5,0,5
2009,Somalia,SOM,New Zealand,NZL,0,0,5,0,5
2009,Slovakia,SVK,New Zealand,NZL,0,0,5,0,5
2009,Syrian Arab Rep.,SYR,New Zealand,NZL,0,0,10,0,10
2009,Zimbabwe,ZWE,New Zealand,NZL,5,0,0,0,5
2009,Colombia,COL,Panama,PAN,25,0,119,37,181
2009,Cuba,CUB,Panama,PAN,0,0,11,0,11
2009,Eritrea,ERI,Panama,PAN,0,0,0,13,13
2009,Ethiopia,ETH,Panama,PAN,0,0,0,10,10
2009,Guatemala,GTM,Panama,PAN,10,0,0,0,10
2009,Somalia,SOM,Panama,PAN,0,0,0,13,13
2009,Bolivia (Plurinational State of),BOL,Peru,PER,5,0,0,5,10
2009,Colombia,COL,Peru,PER,43,0,19,225,287
2009,Cuba,CUB,Peru,PER,18,0,13,24,55
2009,Palestinian,PSE,Peru,PER,0,0,0,5,5
2009,Haiti,HTI,Peru,PER,5,0,0,0,5
2009,Nepal,NPL,Peru,PER,0,0,0,5,5
2009,Serbia and Kosovo: S/RES/1244 (1999),SRB,Peru,PER,5,0,0,0,5
2009,Venezuela (Bolivarian Republic of),VEN,Peru,PER,5,0,0,5,10
2009,China,CHN,Philippines,PHL,0,0,0,5,5
2009,Liberia,LBR,Philippines,PHL,0,0,0,5,5
2009,Sri Lanka,LKA,Philippines,PHL,0,0,0,5,5
2009,Nigeria,NGA,Philippines,PHL,0,0,0,5,5
2009,Somalia,SOM,Philippines,PHL,0,0,0,5,5
2009,Viet Nam,VNM,Philippines,PHL,0,0,0,5,5
2009,Afghanistan,AFG,Poland,POL,0,0,0,11,11
2009,Algeria,DZA,Poland,POL,0,0,12,10,22
2009,Egypt,EGY,Poland,POL,0,0,5,5,10
2009,Armenia,ARM,Poland,POL,0,5,58,72,135
2009,Azerbaijan,AZE,Poland,POL,0,0,5,13,18
2009,Burundi,BDI,Poland,POL,0,0,0,5,5
2009,Bangladesh,BGD,Poland,POL,0,0,13,5,18
2009,Belarus,BLR,Poland,POL,21,0,25,25,71
2009,China,CHN,Poland,POL,0,0,13,5,18
2009,Cameroon,CMR,Poland,POL,0,0,0,14,14
2009,Congo,COG,Poland,POL,0,0,0,5,5
2009,Cuba,CUB,Poland,POL,0,0,5,0,5
2009,Palestinian,PSE,Poland,POL,0,5,0,5,10
2009,Georgia,GEO,Poland,POL,0,0,1482,2577,4059
2009,Ghana,GHA,Poland,POL,0,0,5,0,5
2009,Guinea,GIN,Poland,POL,0,0,0,5,5
2009,India,IND,Poland,POL,0,0,17,12,29
2009,Iran (Islamic Rep. of),IRN,Poland,POL,5,0,0,0,5
2009,Iraq,IRQ,Poland,POL,0,24,5,22,51
2009,Kazakhstan,KAZ,Poland,POL,0,0,0,13,13
2009,Kyrgyzstan,KGZ,Poland,POL,0,0,5,5,10
2009,Libya,LBY,Poland,POL,0,0,5,0,5
2009,Lebanon,LBN,Poland,POL,0,0,0,5,5
2009,Sri Lanka,LKA,Poland,POL,0,16,0,22,38
2009,Rep. of Moldova,MDA,Poland,POL,0,0,10,0,10
2009,Mongolia,MNG,Poland,POL,0,0,17,10,27
2009,Morocco,MAR,Poland,POL,0,0,5,0,5
2009,Nepal,NPL,Poland,POL,0,0,0,5,5
2009,Nigeria,NGA,Poland,POL,0,0,13,10,23
2009,Pakistan,PAK,Poland,POL,0,0,17,10,27
2009,Russian Federation,RUS,Poland,POL,102,2307,2144,5928,10481
2009,Sierra Leone,SLE,Poland,POL,0,0,0,5,5
2009,Somalia,SOM,Poland,POL,5,5,0,0,10
2009,Viet Nam,VNM,Poland,POL,0,5,62,10,77
2009,Syrian Arab Rep.,SYR,Poland,POL,0,0,13,5,18
2009,Togo,TGO,Poland,POL,0,0,10,0,10
2009,Tunisia,TUN,Poland,POL,0,0,0,5,5
2009,Turkey,TUR,Poland,POL,0,0,21,5,26
2009,Ukraine,UKR,Poland,POL,0,5,28,14,47
2009,Uzbekistan,UZB,Poland,POL,0,0,10,22,32
2009,Stateless,XXA,Poland,POL,0,0,11,15,26
2009,Bosnia and Herzegovina,BIH,Portugal,PRT,0,0,5,0,5
2009,Dem. Rep. of the Congo,COD,Portugal,PRT,0,12,0,0,12
2009,Colombia,COL,Portugal,PRT,0,16,0,0,16
2009,Eritrea,ERI,Portugal,PRT,0,5,5,0,10
2009,Georgia,GEO,Portugal,PRT,0,5,0,0,5
2009,Guinea-Bissau,GNB,Portugal,PRT,0,0,5,0,5
2009,Guinea,GIN,Portugal,PRT,0,0,12,0,12
2009,Sri Lanka,LKA,Portugal,PRT,0,5,0,0,5
2009,Mauritania,MRT,Portugal,PRT,0,0,10,0,10
2009,Nigeria,NGA,Portugal,PRT,0,0,5,0,5
2009,Somalia,SOM,Portugal,PRT,0,5,0,0,5
2009,Algeria,DZA,South Africa,ZAF,5,0,48,0,53
2009,Angola,AGO,South Africa,ZAF,5,0,134,0,139
2009,Burundi,BDI,South Africa,ZAF,133,0,367,14,514
2009,Benin,BEN,South Africa,ZAF,0,0,19,0,19
2009,Bangladesh,BGD,South Africa,ZAF,31,0,3310,0,3341
2009,Burkina Faso,BFA,South Africa,ZAF,0,0,12,0,12
2009,Chad,TCD,South Africa,ZAF,0,0,5,0,5
2009,China,CHN,South Africa,ZAF,0,0,1634,0,1634
2009,Cameroon,CMR,South Africa,ZAF,10,0,428,0,438
2009,Congo,COG,South Africa,ZAF,613,0,1391,0,2004
2009,Dem. Rep. of the Congo,COD,South Africa,ZAF,779,0,1706,28,2513
2009,Eritrea,ERI,South Africa,ZAF,202,0,71,0,273
2009,Ethiopia,ETH,South Africa,ZAF,1307,0,3130,0,4437
2009,Ghana,GHA,South Africa,ZAF,0,0,648,0,648
2009,Cote d'Ivoire,CIV,South Africa,ZAF,0,0,33,0,33
2009,India,IND,South Africa,ZAF,0,0,1046,0,1046
2009,Iraq,IRQ,South Africa,ZAF,5,0,0,0,5
2009,Kenya,KEN,South Africa,ZAF,5,0,275,0,280
2009,Lesotho,LSO,South Africa,ZAF,0,0,54,0,54
2009,Mali,MLI,South Africa,ZAF,0,0,42,0,42
2009,Malawi,MWI,South Africa,ZAF,0,0,7749,0,7749
2009,Mozambique,MOZ,South Africa,ZAF,0,0,882,0,882
2009,Niger,NER,South Africa,ZAF,0,0,1071,0,1071
2009,Nigeria,NGA,South Africa,ZAF,0,0,2046,0,2046
2009,Pakistan,PAK,South Africa,ZAF,0,0,1772,0,1772
2009,Rwanda,RWA,South Africa,ZAF,17,0,68,0,85
2009,Senegal,SEN,South Africa,ZAF,0,0,74,0,74
2009,Somalia,SOM,South Africa,ZAF,1213,0,638,0,1851
2009,Sudan,SDN,South Africa,ZAF,5,0,0,0,5
2009,United Rep. of Tanzania,TZA,South Africa,ZAF,0,0,603,0,603
2009,Uganda,UGA,South Africa,ZAF,20,0,759,0,779
2009,Zambia,ZMB,South Africa,ZAF,5,0,264,0,269
2009,Zimbabwe,ZWE,South Africa,ZAF,200,0,15370,131,15701
2009,Afghanistan,AFG,Russian Federation,RUS,115,366,1291,0,1772
2009,Angola,AGO,Russian Federation,RUS,0,0,5,0,5
2009,Armenia,ARM,Russian Federation,RUS,0,0,10,0,10
2009,Azerbaijan,AZE,Russian Federation,RUS,0,0,13,0,13
2009,Bangladesh,BGD,Russian Federation,RUS,0,0,5,0,5
2009,Belarus,BLR,Russian Federation,RUS,0,0,5,0,5
2009,Cambodia,KHM,Russian Federation,RUS,0,0,5,0,5
2009,China,CHN,Russian Federation,RUS,0,0,5,0,5
2009,Congo,COG,Russian Federation,RUS,0,0,12,0,12
2009,Dem. Rep. of the Congo,COD,Russian Federation,RUS,0,0,19,0,19
2009,Cuba,CUB,Russian Federation,RUS,0,0,5,0,5
2009,Eritrea,ERI,Russian Federation,RUS,0,0,10,0,10
2009,Ethiopia,ETH,Russian Federation,RUS,0,0,10,0,10
2009,Palestinian,PSE,Russian Federation,RUS,5,10,35,0,50
2009,Georgia,GEO,Russian Federation,RUS,60,1782,1578,0,3420
2009,Guinea,GIN,Russian Federation,RUS,0,0,5,0,5
2009,Iran (Islamic Rep. of),IRN,Russian Federation,RUS,0,0,10,0,10
2009,Iraq,IRQ,Russian Federation,RUS,0,20,26,0,46
2009,Kazakhstan,KAZ,Russian Federation,RUS,0,0,10,0,10
2009,Kyrgyzstan,KGZ,Russian Federation,RUS,0,0,5,0,5
2009,Dem. People's Rep. of Korea,PRK,Russian Federation,RUS,0,5,42,0,47
2009,Lithuania,LTU,Russian Federation,RUS,0,0,5,0,5
2009,Rep. of Moldova,MDA,Russian Federation,RUS,0,5,0,0,5
2009,Nigeria,NGA,Russian Federation,RUS,0,5,5,0,10
2009,Pakistan,PAK,Russian Federation,RUS,0,0,11,0,11
2009,Somalia,SOM,Russian Federation,RUS,0,5,0,0,5
2009,Sudan,SDN,Russian Federation,RUS,0,0,17,0,17
2009,Syrian Arab Rep.,SYR,Russian Federation,RUS,0,0,5,0,5
2009,Tajikistan,TJK,Russian Federation,RUS,5,5,32,0,42
2009,Turkmenistan,TKM,Russian Federation,RUS,0,10,19,0,29
2009,Ukraine,UKR,Russian Federation,RUS,0,0,13,0,13
2009,Uzbekistan,UZB,Russian Federation,RUS,0,45,98,0,143
2009,Burundi,BDI,Rwanda,RWA,0,0,97,0,97
2009,Dem. Rep. of the Congo,COD,Rwanda,RWA,0,39,0,0,39
2009,Ethiopia,ETH,Rwanda,RWA,0,0,0,5,5
2009,Sudan,SDN,Rwanda,RWA,0,0,0,10,10
2009,Afghanistan,AFG,Serbia and Kosovo: S/RES/1244 (1999),SRB,0,0,0,220,220
2009,Albania,ALB,Serbia and Kosovo: S/RES/1244 (1999),SRB,0,0,0,5,5
2009,Armenia,ARM,Serbia and Kosovo: S/RES/1244 (1999),SRB,0,0,5,0,5
2009,Cameroon,CMR,Serbia and Kosovo: S/RES/1244 (1999),SRB,0,0,0,5,5
2009,Ethiopia,ETH,Serbia and Kosovo: S/RES/1244 (1999),SRB,0,0,0,5,5
2009,Palestinian,PSE,Serbia and Kosovo: S/RES/1244 (1999),SRB,0,0,0,5,5
2009,Georgia,GEO,Serbia and Kosovo: S/RES/1244 (1999),SRB,0,0,0,5,5
2009,Guinea,GIN,Serbia and Kosovo: S/RES/1244 (1999),SRB,0,0,0,5,5
2009,Cote d'Ivoire,CIV,Serbia and Kosovo: S/RES/1244 (1999),SRB,0,0,0,19,19
2009,Iran (Islamic Rep. of),IRN,Serbia and Kosovo: S/RES/1244 (1999),SRB,0,0,0,13,13
2009,Iraq,IRQ,Serbia and Kosovo: S/RES/1244 (1999),SRB,0,0,0,5,5
2009,Sri Lanka,LKA,Serbia and Kosovo: S/RES/1244 (1999),SRB,0,0,0,17,17
2009,Nigeria,NGA,Serbia and Kosovo: S/RES/1244 (1999),SRB,0,0,0,5,5
2009,Central African Rep.,CAF,Senegal,SEN,0,0,5,0,5
2009,Chad,TCD,Senegal,SEN,0,0,5,0,5
2009,Dem. Rep. of the Congo,COD,Senegal,SEN,5,0,20,0,25
2009,Gambia,GMB,Senegal,SEN,0,0,11,0,11
2009,Cote d'Ivoire,CIV,Senegal,SEN,0,0,10,0,10
2009,Liberia,LBR,Senegal,SEN,0,0,13,0,13
2009,Mauritania,MRT,Senegal,SEN,0,0,5,0,5
2009,Nigeria,NGA,Senegal,SEN,0,0,5,0,5
2009,Rwanda,RWA,Senegal,SEN,5,0,0,0,5
2009,Sierra Leone,SLE,Senegal,SEN,0,0,10,0,10
2009,Guinea,GIN,Sierra Leone,SLE,0,0,0,5,5
2009,Liberia,LBR,Sierra Leone,SLE,0,0,0,160,160
2009,Nigeria,NGA,Sierra Leone,SLE,0,0,0,11,11
2009,Afghanistan,AFG,Spain,ESP,0,5,49,0,54
2009,Albania,ALB,Spain,ESP,0,0,5,0,5
2009,Algeria,DZA,Spain,ESP,0,5,330,0,335
2009,Angola,AGO,Spain,ESP,0,0,10,0,10
2009,Egypt,EGY,Spain,ESP,0,0,14,0,14
2009,Argentina,ARG,Spain,ESP,0,0,13,0,13
2009,Armenia,ARM,Spain,ESP,0,0,45,0,45
2009,Azerbaijan,AZE,Spain,ESP,5,0,19,0,24
2009,Burundi,BDI,Spain,ESP,0,0,5,0,5
2009,Benin,BEN,Spain,ESP,0,0,12,0,12
2009,Bangladesh,BGD,Spain,ESP,5,0,29,0,34
2009,Burkina Faso,BFA,Spain,ESP,0,0,5,0,5
2009,Belarus,BLR,Spain,ESP,0,0,13,0,13
2009,Bolivia (Plurinational State of),BOL,Spain,ESP,0,0,12,0,12
2009,Brazil,BRA,Spain,ESP,0,0,17,0,17
2009,Bosnia and Herzegovina,BIH,Spain,ESP,0,0,10,0,10
2009,Central African Rep.,CAF,Spain,ESP,0,0,5,0,5
2009,Chad,TCD,Spain,ESP,0,0,21,0,21
2009,China,CHN,Spain,ESP,0,0,14,0,14
2009,Cameroon,CMR,Spain,ESP,0,0,80,0,80
2009,Congo,COG,Spain,ESP,0,0,5,0,5
2009,Dem. Rep. of the Congo,COD,Spain,ESP,17,10,99,0,126
2009,Colombia,COL,Spain,ESP,14,10,1005,0,1029
2009,Costa Rica,CRI,Spain,ESP,0,0,5,0,5
2009,Cuba,CUB,Spain,ESP,5,42,88,0,135
2009,Dominican Rep.,DOM,Spain,ESP,0,0,5,0,5
2009,Ecuador,ECU,Spain,ESP,0,0,10,0,10
2009,Equatorial Guinea,GNQ,Spain,ESP,10,0,21,0,31
2009,Eritrea,ERI,Spain,ESP,0,0,35,0,35
2009,Ethiopia,ETH,Spain,ESP,0,0,22,0,22
2009,Gabon,GAB,Spain,ESP,0,0,5,0,5
2009,Gambia,GMB,Spain,ESP,5,0,54,0,59
2009,Georgia,GEO,Spain,ESP,0,0,30,0,30
2009,Ghana,GHA,Spain,ESP,0,0,17,0,17
2009,Guinea-Bissau,GNB,Spain,ESP,0,0,13,0,13
2009,Guatemala,GTM,Spain,ESP,0,0,13,0,13
2009,Guinea,GIN,Spain,ESP,0,0,83,0,83
2009,Haiti,HTI,Spain,ESP,5,0,0,0,5
2009,Honduras,HND,Spain,ESP,0,0,5,0,5
2009,Cote d'Ivoire,CIV,Spain,ESP,0,27,366,0,393
2009,India,IND,Spain,ESP,0,0,23,0,23
2009,Iran (Islamic Rep. of),IRN,Spain,ESP,10,0,59,0,69
2009,Iraq,IRQ,Spain,ESP,13,21,10,0,44
2009,Israel,ISR,Spain,ESP,0,0,5,0,5
2009,Jordan,JOR,Spain,ESP,5,0,0,0,5
2009,Kenya,KEN,Spain,ESP,0,0,14,0,14
2009,Liberia,LBR,Spain,ESP,0,0,37,0,37
2009,Lebanon,LBN,Spain,ESP,0,0,10,0,10
2009,Sri Lanka,LKA,Spain,ESP,0,22,10,0,32
2009,Mauritania,MRT,Spain,ESP,0,0,27,0,27
2009,North Macedonia,MKD,Spain,ESP,0,0,10,0,10
2009,Mexico,MEX,Spain,ESP,5,0,15,0,20
2009,Mali,MLI,Spain,ESP,0,0,27,0,27
2009,Morocco,MAR,Spain,ESP,0,5,99,0,104
2009,Mozambique,MOZ,Spain,ESP,0,0,5,0,5
2009,Nepal,NPL,Spain,ESP,0,0,10,0,10
2009,Niger,NER,Spain,ESP,0,0,17,0,17
2009,Nicaragua,NIC,Spain,ESP,0,0,5,0,5
2009,Nigeria,NGA,Spain,ESP,0,0,592,0,592
2009,Pakistan,PAK,Spain,ESP,10,0,52,0,62
2009,Paraguay,PRY,Spain,ESP,0,0,14,0,14
2009,Peru,PER,Spain,ESP,0,0,10,0,10
2009,Russian Federation,RUS,Spain,ESP,10,0,75,0,85
2009,Rwanda,RWA,Spain,ESP,0,0,5,0,5
2009,El Salvador,SLV,Spain,ESP,0,0,5,0,5
2009,Serbia and Kosovo: S/RES/1244 (1999),SRB,Spain,ESP,0,0,16,0,16
2009,Senegal,SEN,Spain,ESP,0,0,20,0,20
2009,Sierra Leone,SLE,Spain,ESP,0,0,35,0,35
2009,Somalia,SOM,Spain,ESP,0,5,51,0,56
2009,Viet Nam,VNM,Spain,ESP,0,0,5,0,5
2009,Sudan,SDN,Spain,ESP,0,0,106,0,106
2009,Syrian Arab Rep.,SYR,Spain,ESP,5,0,36,0,41
2009,United Rep. of Tanzania,TZA,Spain,ESP,0,0,5,0,5
2009,Tajikistan,TJK,Spain,ESP,0,0,5,0,5
2009,Togo,TGO,Spain,ESP,0,0,16,0,16
2009,Turkey,TUR,Spain,ESP,0,0,23,0,23
2009,Uganda,UGA,Spain,ESP,0,0,16,0,16
2009,Ukraine,UKR,Spain,ESP,0,0,13,0,13
2009,Venezuela (Bolivarian Republic of),VEN,Spain,ESP,5,0,24,0,29
2009,Zimbabwe,ZWE,Spain,ESP,0,0,20,0,20
2009,Afghanistan,AFG,Slovakia,SVK,0,47,5,10,62
2009,Algeria,DZA,Slovakia,SVK,0,5,0,0,5
2009,Armenia,ARM,Slovakia,SVK,0,5,5,14,24
2009,Azerbaijan,AZE,Slovakia,SVK,0,0,0,10,10
2009,Bangladesh,BGD,Slovakia,SVK,0,0,14,5,19
2009,Belarus,BLR,Slovakia,SVK,0,0,0,5,5
2009,China,CHN,Slovakia,SVK,0,0,28,13,41
2009,Cuba,CUB,Slovakia,SVK,5,0,0,0,5
2009,Palestinian,PSE,Slovakia,SVK,0,0,5,0,5
2009,Georgia,GEO,Slovakia,SVK,0,0,25,79,104
2009,India,IND,Slovakia,SVK,0,0,27,37,64
2009,Iran (Islamic Rep. of),IRN,Slovakia,SVK,5,5,5,0,15
2009,Iraq,IRQ,Slovakia,SVK,0,12,5,0,17
2009,Sri Lanka,LKA,Slovakia,SVK,0,0,5,16,21
2009,North Macedonia,MKD,Slovakia,SVK,0,0,5,0,5
2009,Rep. of Moldova,MDA,Slovakia,SVK,0,0,27,50,77
2009,Nigeria,NGA,Slovakia,SVK,0,0,5,5,10
2009,Pakistan,PAK,Slovakia,SVK,0,0,95,72,167
2009,Romania,ROU,Slovakia,SVK,0,0,0,12,12
2009,Russian Federation,RUS,Slovakia,SVK,0,0,11,76,87
2009,Serbia and Kosovo: S/RES/1244 (1999),SRB,Slovakia,SVK,0,0,13,0,13
2009,Somalia,SOM,Slovakia,SVK,0,11,0,0,11
2009,Viet Nam,VNM,Slovakia,SVK,0,0,39,22,61
2009,Syrian Arab Rep.,SYR,Slovakia,SVK,0,0,0,14,14
2009,Turkey,TUR,Slovakia,SVK,0,0,5,5,10
2009,Ukraine,UKR,Slovakia,SVK,0,0,13,0,13
2009,Stateless,XXA,Slovakia,SVK,0,5,0,0,5
2009,Afghanistan,AFG,Slovenia,SVN,0,0,0,13,13
2009,Albania,ALB,Slovenia,SVN,0,0,0,5,5
2009,Bosnia and Herzegovina,BIH,Slovenia,SVN,0,0,20,21,41
2009,China,CHN,Slovenia,SVN,0,0,0,5,5
2009,Croatia,HRV,Slovenia,SVN,0,0,10,0,10
2009,Iran (Islamic Rep. of),IRN,Slovenia,SVN,0,0,0,5,5
2009,Iraq,IRQ,Slovenia,SVN,0,0,0,5,5
2009,Kazakhstan,KAZ,Slovenia,SVN,5,0,0,0,5
2009,North Macedonia,MKD,Slovenia,SVN,0,0,0,5,5
2009,Montenegro,MNE,Slovenia,SVN,0,0,5,0,5
2009,Nigeria,NGA,Slovenia,SVN,0,0,0,5,5
2009,Pakistan,PAK,Slovenia,SVN,0,0,0,5,5
2009,Russian Federation,RUS,Slovenia,SVN,0,0,5,0,5
2009,Serbia and Kosovo: S/RES/1244 (1999),SRB,Slovenia,SVN,12,0,17,16,45
2009,Turkey,TUR,Slovenia,SVN,0,0,5,11,16
2009,Afghanistan,AFG,Sweden,SWE,122,545,245,59,971
2009,Albania,ALB,Sweden,SWE,0,10,71,16,97
2009,Algeria,DZA,Sweden,SWE,5,0,83,49,137
2009,Angola,AGO,Sweden,SWE,0,0,10,0,10
2009,Egypt,EGY,Sweden,SWE,0,5,82,12,99
2009,Argentina,ARG,Sweden,SWE,0,0,0,5,5
2009,Armenia,ARM,Sweden,SWE,0,17,222,29,268
2009,Azerbaijan,AZE,Sweden,SWE,19,29,281,62,391
2009,Bahrain,BHR,Sweden,SWE,0,0,0,5,5
2009,Burundi,BDI,Sweden,SWE,10,5,44,5,64
2009,Bangladesh,BGD,Sweden,SWE,5,5,77,5,92
2009,Bhutan,BTN,Sweden,SWE,0,5,10,0,15
2009,Belarus,BLR,Sweden,SWE,0,5,214,105,324
2009,Bolivia (Plurinational State of),BOL,Sweden,SWE,0,5,37,5,47
2009,Brazil,BRA,Sweden,SWE,0,0,5,0,5
2009,Bosnia and Herzegovina,BIH,Sweden,SWE,0,17,76,23,116
2009,Bulgaria,BGR,Sweden,SWE,0,0,19,11,30
2009,Chad,TCD,Sweden,SWE,0,0,5,0,5
2009,China,CHN,Sweden,SWE,10,5,57,25,97
2009,Chile,CHL,Sweden,SWE,0,0,24,5,29
2009,Cameroon,CMR,Sweden,SWE,5,0,32,0,37
2009,Congo,COG,Sweden,SWE,0,0,14,0,14
2009,Dem. Rep. of the Congo,COD,Sweden,SWE,15,15,39,5,74
2009,Colombia,COL,Sweden,SWE,0,0,12,0,12
2009,Cuba,CUB,Sweden,SWE,0,11,18,5,34
2009,Denmark,DNK,Sweden,SWE,0,0,0,5,5
2009,Djibouti,DJI,Sweden,SWE,0,0,5,0,5
2009,Ecuador,ECU,Sweden,SWE,0,0,15,5,20
2009,Eritrea,ERI,Sweden,SWE,151,647,69,27,894
2009,Estonia,EST,Sweden,SWE,0,0,5,0,5
2009,Ethiopia,ETH,Sweden,SWE,15,17,134,5,171
2009,Gambia,GMB,Sweden,SWE,0,0,29,10,39
2009,Georgia,GEO,Sweden,SWE,5,10,178,41,234
2009,Ghana,GHA,Sweden,SWE,0,0,27,10,37
2009,Guinea-Bissau,GNB,Sweden,SWE,0,0,5,0,5
2009,Guinea,GIN,Sweden,SWE,0,5,31,5,41
2009,Haiti,HTI,Sweden,SWE,0,0,5,0,5
2009,Honduras,HND,Sweden,SWE,0,5,5,0,10
2009,Croatia,HRV,Sweden,SWE,0,0,15,14,29
2009,Cote d'Ivoire,CIV,Sweden,SWE,0,0,23,5,28
2009,India,IND,Sweden,SWE,0,0,65,18,83
2009,Indonesia,IDN,Sweden,SWE,0,0,13,0,13
2009,Iran (Islamic Rep. of),IRN,Sweden,SWE,124,51,580,84,839
2009,Iraq,IRQ,Sweden,SWE,303,746,2929,290,4268
2009,Israel,ISR,Sweden,SWE,0,5,26,5,36
2009,Jordan,JOR,Sweden,SWE,10,11,76,28,125
2009,Kazakhstan,KAZ,Sweden,SWE,5,10,177,24,216
2009,Kenya,KEN,Sweden,SWE,0,5,66,0,71
2009,Kyrgyzstan,KGZ,Sweden,SWE,0,5,126,20,151
2009,Rep. of Korea,KOR,Sweden,SWE,0,0,0,5,5
2009,Dem. People's Rep. of Korea,PRK,Sweden,SWE,0,0,5,0,5
2009,Kuwait,KWT,Sweden,SWE,0,0,5,0,5
2009,Liberia,LBR,Sweden,SWE,0,0,12,0,12
2009,Libya,LBY,Sweden,SWE,10,5,395,150,560
2009,Lebanon,LBN,Sweden,SWE,0,11,152,35,198
2009,Sri Lanka,LKA,Sweden,SWE,5,0,41,16,62
2009,Lithuania,LTU,Sweden,SWE,0,0,0,5,5
2009,Mauritania,MRT,Sweden,SWE,0,0,5,0,5
2009,North Macedonia,MKD,Sweden,SWE,0,0,25,15,40
2009,Rep. of Moldova,MDA,Sweden,SWE,0,0,14,0,14
2009,Mali,MLI,Sweden,SWE,5,0,0,0,5
2009,Malawi,MWI,Sweden,SWE,0,0,5,0,5
2009,Mongolia,MNG,Sweden,SWE,0,12,681,69,762
2009,Morocco,MAR,Sweden,SWE,0,5,30,22,57
2009,Montenegro,MNE,Sweden,SWE,0,5,38,0,43
2009,Myanmar,MMR,Sweden,SWE,5,0,0,0,5
2009,Nepal,NPL,Sweden,SWE,0,0,69,5,74
2009,Nicaragua,NIC,Sweden,SWE,0,0,50,5,55
2009,Nigeria,NGA,Sweden,SWE,5,13,176,42,236
2009,Pakistan,PAK,Sweden,SWE,5,5,61,29,100
2009,Peru,PER,Sweden,SWE,0,0,23,0,23
2009,Romania,ROU,Sweden,SWE,0,0,13,0,13
2009,Russian Federation,RUS,Sweden,SWE,33,83,530,99,745
2009,Rwanda,RWA,Sweden,SWE,0,0,5,0,5
2009,El Salvador,SLV,Sweden,SWE,0,0,50,5,55
2009,Saudi Arabia,SAU,Sweden,SWE,0,0,0,5,5
2009,Serbia and Kosovo: S/RES/1244 (1999),SRB,Sweden,SWE,15,145,1246,229,1635
2009,Senegal,SEN,Sweden,SWE,0,5,12,0,17
2009,Sierra Leone,SLE,Sweden,SWE,0,0,25,5,30
2009,Somalia,SOM,Sweden,SWE,472,3202,644,215,4533
2009,Viet Nam,VNM,Sweden,SWE,0,12,88,21,121
2009,Sudan,SDN,Sweden,SWE,14,25,35,10,84
2009,Slovakia,SVK,Sweden,SWE,0,0,5,0,5
2009,Sweden,SWE,Sweden,SWE,0,0,0,5,5
2009,Syrian Arab Rep.,SYR,Sweden,SWE,16,19,399,55,489
2009,United Rep. of Tanzania,TZA,Sweden,SWE,0,0,31,10,41
2009,Thailand,THA,Sweden,SWE,0,0,14,0,14
2009,Tajikistan,TJK,Sweden,SWE,0,0,17,10,27
2009,Turkmenistan,TKM,Sweden,SWE,0,0,0,5,5
2009,Togo,TGO,Sweden,SWE,0,0,11,0,11
2009,Tunisia,TUN,Sweden,SWE,0,0,47,24,71
2009,Turkey,TUR,Sweden,SWE,10,12,170,44,236
2009,Uganda,UGA,Sweden,SWE,5,0,39,5,49
2009,Ukraine,UKR,Sweden,SWE,0,0,53,25,78
2009,United States of America,USA,Sweden,SWE,0,0,5,5,10
2009,Uzbekistan,UZB,Sweden,SWE,21,19,416,43,499
2009,Venezuela (Bolivarian Republic of),VEN,Sweden,SWE,0,0,11,0,11
2009,Yemen,YEM,Sweden,SWE,30,15,53,15,113
2009,Zimbabwe,ZWE,Sweden,SWE,0,0,11,0,11
2009,Stateless,XXA,Sweden,SWE,87,289,519,143,1038
2009,Afghanistan,AFG,Switzerland,CHE,34,263,298,211,806
2009,Albania,ALB,Switzerland,CHE,0,0,0,20,20
2009,Algeria,DZA,Switzerland,CHE,10,20,32,254,316
2009,Angola,AGO,Switzerland,CHE,0,91,82,25,198
2009,Egypt,EGY,Switzerland,CHE,5,0,0,12,17
2009,Armenia,ARM,Switzerland,CHE,0,5,36,68,109
2009,Austria,AUT,Switzerland,CHE,0,0,0,5,5
2009,Azerbaijan,AZE,Switzerland,CHE,5,15,16,10,46
2009,Burundi,BDI,Switzerland,CHE,0,5,0,0,5
2009,Benin,BEN,Switzerland,CHE,0,5,5,25,35
2009,Bangladesh,BGD,Switzerland,CHE,0,5,16,22,43
2009,Bhutan,BTN,Switzerland,CHE,0,0,0,10,10
2009,Burkina Faso,BFA,Switzerland,CHE,0,5,5,11,21
2009,Belarus,BLR,Switzerland,CHE,0,0,16,77,93
2009,Bolivia (Plurinational State of),BOL,Switzerland,CHE,0,13,0,0,13
2009,Bosnia and Herzegovina,BIH,Switzerland,CHE,14,86,50,162,312
2009,Bulgaria,BGR,Switzerland,CHE,0,0,5,18,23
2009,Cambodia,KHM,Switzerland,CHE,5,0,5,0,10
2009,Chad,TCD,Switzerland,CHE,5,0,0,11,16
2009,China,CHN,Switzerland,CHE,40,238,252,53,583
2009,Chile,CHL,Switzerland,CHE,0,0,5,0,5
2009,Cameroon,CMR,Switzerland,CHE,5,10,37,42,94
2009,Congo,COG,Switzerland,CHE,0,0,0,11,11
2009,Dem. Rep. of the Congo,COD,Switzerland,CHE,5,175,167,52,399
2009,Colombia,COL,Switzerland,CHE,15,5,5,5,30
2009,Cuba,CUB,Switzerland,CHE,0,0,0,5,5
2009,Cabo Verde,CPV,Switzerland,CHE,0,0,0,5,5
2009,Czechia,CZE,Switzerland,CHE,0,0,0,5,5
2009,Ecuador,ECU,Switzerland,CHE,0,0,10,0,10
2009,Equatorial Guinea,GNQ,Switzerland,CHE,0,0,5,5,10
2009,Eritrea,ERI,Switzerland,CHE,1302,437,451,654,2844
2009,Ethiopia,ETH,Switzerland,CHE,45,105,122,71,343
2009,Gabon,GAB,Switzerland,CHE,0,0,0,5,5
2009,Gambia,GMB,Switzerland,CHE,0,5,55,175,235
2009,Georgia,GEO,Switzerland,CHE,0,14,57,652,723
2009,Germany,DEU,Switzerland,CHE,0,0,0,10,10
2009,Ghana,GHA,Switzerland,CHE,0,0,0,38,38
2009,Guinea-Bissau,GNB,Switzerland,CHE,0,0,25,141,166
2009,Guinea,GIN,Switzerland,CHE,0,10,57,268,335
2009,Cote d'Ivoire,CIV,Switzerland,CHE,0,21,64,102,187
2009,India,IND,Switzerland,CHE,0,0,5,20,25
2009,Iran (Islamic Rep. of),IRN,Switzerland,CHE,66,100,147,71,384
2009,Iraq,IRQ,Switzerland,CHE,161,360,624,514,1659
2009,Italy,ITA,Switzerland,CHE,0,0,0,13,13
2009,Jamaica,JAM,Switzerland,CHE,0,0,0,5,5
2009,Jordan,JOR,Switzerland,CHE,0,0,5,5,10
2009,Kazakhstan,KAZ,Switzerland,CHE,0,0,0,13,13
2009,Kenya,KEN,Switzerland,CHE,0,0,0,14,14
2009,Kyrgyzstan,KGZ,Switzerland,CHE,5,0,0,0,5
2009,Liberia,LBR,Switzerland,CHE,0,0,5,24,29
2009,Libya,LBY,Switzerland,CHE,10,12,13,19,54
2009,Lebanon,LBN,Switzerland,CHE,0,15,5,22,42
2009,Sri Lanka,LKA,Switzerland,CHE,170,478,539,235,1422
2009,Lithuania,LTU,Switzerland,CHE,0,0,0,5,5
2009,Madagascar,MDG,Switzerland,CHE,0,0,5,0,5
2009,Mauritania,MRT,Switzerland,CHE,0,0,5,38,43
2009,North Macedonia,MKD,Switzerland,CHE,0,22,23,40,85
2009,Rep. of Moldova,MDA,Switzerland,CHE,0,5,5,12,22
2009,Mali,MLI,Switzerland,CHE,0,0,5,24,29
2009,Mongolia,MNG,Switzerland,CHE,0,11,41,271,323
2009,Morocco,MAR,Switzerland,CHE,0,5,0,26,31
2009,Montenegro,MNE,Switzerland,CHE,0,5,5,14,24
2009,Myanmar,MMR,Switzerland,CHE,0,20,20,0,40
2009,Nepal,NPL,Switzerland,CHE,0,5,0,16,21
2009,Niger,NER,Switzerland,CHE,0,0,5,22,27
2009,Nigeria,NGA,Switzerland,CHE,0,12,70,1737,1819
2009,Pakistan,PAK,Switzerland,CHE,0,16,36,48,100
2009,Poland,POL,Switzerland,CHE,0,0,0,5,5
2009,Romania,ROU,Switzerland,CHE,0,5,0,25,30
2009,South Africa,ZAF,Switzerland,CHE,0,0,0,12,12
2009,Russian Federation,RUS,Switzerland,CHE,45,53,63,288,449
2009,Rwanda,RWA,Switzerland,CHE,0,0,0,11,11
2009,Saudi Arabia,SAU,Switzerland,CHE,0,0,0,5,5
2009,Serbia and Kosovo: S/RES/1244 (1999),SRB,Switzerland,CHE,41,343,754,820,1958
2009,Senegal,SEN,Switzerland,CHE,5,0,5,59,69
2009,Sierra Leone,SLE,Switzerland,CHE,0,5,10,43,58
2009,Somalia,SOM,Switzerland,CHE,50,696,696,428,1870
2009,Viet Nam,VNM,Switzerland,CHE,10,0,10,0,20
2009,Sudan,SDN,Switzerland,CHE,11,5,25,62,103
2009,Slovakia,SVK,Switzerland,CHE,0,0,0,5,5
2009,Switzerland,CHE,Switzerland,CHE,0,0,0,5,5
2009,Syrian Arab Rep.,SYR,Switzerland,CHE,67,51,265,125,508
2009,United Rep. of Tanzania,TZA,Switzerland,CHE,0,13,0,0,13
2009,Togo,TGO,Switzerland,CHE,56,24,35,39,154
2009,Tunisia,TUN,Switzerland,CHE,27,5,10,101,143
2009,Turkey,TUR,Switzerland,CHE,303,138,199,165,805
2009,Uganda,UGA,Switzerland,CHE,0,0,5,14,19
2009,Ukraine,UKR,Switzerland,CHE,0,5,10,16,31
2009,United States of America,USA,Switzerland,CHE,0,0,0,5,5
2009,Uzbekistan,UZB,Switzerland,CHE,0,0,0,5,5
2009,Western Sahara,ESH,Switzerland,CHE,0,0,0,10,10
2009,Yemen,YEM,Switzerland,CHE,34,16,36,18,104
2009,Zimbabwe,ZWE,Switzerland,CHE,0,5,0,28,33
2009,Stateless,XXA,Switzerland,CHE,5,0,0,5,10
2009,Central African Rep.,CAF,Togo,TGO,5,0,0,23,28
2009,Chad,TCD,Togo,TGO,10,0,0,5,15
2009,Cameroon,CMR,Togo,TGO,0,0,5,0,5
2009,Dem. Rep. of the Congo,COD,Togo,TGO,0,0,20,16,36
2009,Ghana,GHA,Togo,TGO,0,0,0,134,134
2009,Cote d'Ivoire,CIV,Togo,TGO,0,0,13,33,46
2009,Sri Lanka,LKA,Togo,TGO,0,0,64,62,126
2009,Rwanda,RWA,Togo,TGO,0,0,0,44,44
2009,Afghanistan,AFG,Ukraine,UKR,80,0,134,63,277
2009,Algeria,DZA,Ukraine,UKR,0,0,0,5,5
2009,Egypt,EGY,Ukraine,UKR,0,0,0,5,5
2009,Armenia,ARM,Ukraine,UKR,0,0,0,5,5
2009,Azerbaijan,AZE,Ukraine,UKR,0,0,0,13,13
2009,Bangladesh,BGD,Ukraine,UKR,0,0,12,13,25
2009,Belarus,BLR,Ukraine,UKR,12,0,0,0,12
2009,Cameroon,CMR,Ukraine,UKR,0,0,11,0,11
2009,Dem. Rep. of the Congo,COD,Ukraine,UKR,0,0,16,13,29
2009,Palestinian,PSE,Ukraine,UKR,0,0,5,12,17
2009,Georgia,GEO,Ukraine,UKR,5,0,34,30,69
2009,Guinea,GIN,Ukraine,UKR,0,0,10,5,15
2009,India,IND,Ukraine,UKR,0,0,0,10,10
2009,Iran (Islamic Rep. of),IRN,Ukraine,UKR,5,0,11,5,21
2009,Iraq,IRQ,Ukraine,UKR,5,0,23,10,38
2009,Sri Lanka,LKA,Ukraine,UKR,0,0,23,0,23
2009,Nigeria,NGA,Ukraine,UKR,0,0,0,5,5
2009,Pakistan,PAK,Ukraine,UKR,0,0,5,54,59
2009,Russian Federation,RUS,Ukraine,UKR,5,0,13,17,35
2009,Serbia and Kosovo: S/RES/1244 (1999),SRB,Ukraine,UKR,0,0,0,10,10
2009,Somalia,SOM,Ukraine,UKR,0,0,41,24,65
2009,Viet Nam,VNM,Ukraine,UKR,0,0,0,5,5
2009,Syrian Arab Rep.,SYR,Ukraine,UKR,5,0,16,10,31
2009,Turkey,TUR,Ukraine,UKR,0,0,10,0,10
2009,Uzbekistan,UZB,Ukraine,UKR,5,0,5,26,36
2009,Stateless,XXA,Ukraine,UKR,0,0,0,5,5
2009,Colombia,COL,Uruguay,URY,15,0,0,10,25
2009,Nigeria,NGA,Uruguay,URY,0,0,5,0,5
2009,Angola,AGO,Zimbabwe,ZWE,0,0,0,5,5
2009,Burundi,BDI,Zimbabwe,ZWE,55,0,0,16,71
2009,Dem. Rep. of the Congo,COD,Zimbabwe,ZWE,401,0,5,79,485
2009,Eritrea,ERI,Zimbabwe,ZWE,5,0,0,0,5
2009,Ethiopia,ETH,Zimbabwe,ZWE,0,0,0,10,10
2009,Rwanda,RWA,Zimbabwe,ZWE,48,0,5,15,68
2009,Somalia,SOM,Zimbabwe,ZWE,0,0,0,11,11
2009,Sudan,SDN,Zimbabwe,ZWE,5,0,0,0,5
2009,Uganda,UGA,Zimbabwe,ZWE,5,0,0,0,5
2010,Armenia,ARM,Argentina,ARG,11,0,16,0,27
2010,Bangladesh,BGD,Argentina,ARG,0,0,23,0,23
2010,China,CHN,Argentina,ARG,0,0,5,0,5
2010,Chile,CHL,Argentina,ARG,0,0,5,0,5
2010,Cameroon,CMR,Argentina,ARG,5,0,0,0,5
2010,Colombia,COL,Argentina,ARG,11,0,26,15,52
2010,Cuba,CUB,Argentina,ARG,0,0,15,10,25
2010,Dominican Rep.,DOM,Argentina,ARG,0,0,116,23,139
2010,Georgia,GEO,Argentina,ARG,0,0,5,0,5
2010,Ghana,GHA,Argentina,ARG,0,0,5,0,5
2010,Guinea,GIN,Argentina,ARG,0,0,5,0,5
2010,Haiti,HTI,Argentina,ARG,5,0,29,0,34
2010,India,IND,Argentina,ARG,0,0,26,10,36
2010,Lao People's Dem. Rep.,LAO,Argentina,ARG,0,0,0,5,5
2010,Liberia,LBR,Argentina,ARG,5,0,0,0,5
2010,Sri Lanka,LKA,Argentina,ARG,0,0,0,5,5
2010,Nigeria,NGA,Argentina,ARG,5,0,44,0,49
2010,Peru,PER,Argentina,ARG,0,0,13,17,30
2010,Russian Federation,RUS,Argentina,ARG,5,0,5,0,10
2010,Senegal,SEN,Argentina,ARG,5,0,67,23,95
2010,Sierra Leone,SLE,Argentina,ARG,0,0,14,0,14
2010,Ukraine,UKR,Argentina,ARG,0,0,5,0,5
2010,Georgia,GEO,Armenia,ARM,0,0,5,5,10
2010,Cote d'Ivoire,CIV,Armenia,ARM,0,0,5,0,5
2010,Iran (Islamic Rep. of),IRN,Armenia,ARM,0,0,13,0,13
2010,Iraq,IRQ,Armenia,ARM,18,0,0,19,37
2010,Afghanistan,AFG,Australia,AUS,1213,0,26,0,1239
2010,Albania,ALB,Australia,AUS,0,0,13,0,13
2010,Egypt,EGY,Australia,AUS,59,0,107,0,166
2010,Bahrain,BHR,Australia,AUS,5,0,0,0,5
2010,Bangladesh,BGD,Australia,AUS,17,0,49,0,66
2010,Brazil,BRA,Australia,AUS,0,0,5,0,5
2010,China,CHN,Australia,AUS,196,0,976,0,1172
2010,Cameroon,CMR,Australia,AUS,5,0,5,0,10
2010,Colombia,COL,Australia,AUS,0,0,33,0,33
2010,Eritrea,ERI,Australia,AUS,10,0,0,0,10
2010,Ethiopia,ETH,Australia,AUS,16,0,12,0,28
2010,Fiji,FJI,Australia,AUS,18,0,517,0,535
2010,France,FRA,Australia,AUS,0,0,5,0,5
2010,Palestinian,PSE,Australia,AUS,20,0,5,0,25
2010,Ghana,GHA,Australia,AUS,5,0,15,0,20
2010,Hungary,HUN,Australia,AUS,0,0,5,0,5
2010,India,IND,Australia,AUS,13,0,266,0,279
2010,Indonesia,IDN,Australia,AUS,5,0,168,0,173
2010,Iran (Islamic Rep. of),IRN,Australia,AUS,230,0,71,0,301
2010,Iraq,IRQ,Australia,AUS,251,0,26,0,277
2010,Italy,ITA,Australia,AUS,0,0,5,0,5
2010,Jordan,JOR,Australia,AUS,5,0,18,0,23
2010,Japan,JPN,Australia,AUS,0,0,5,0,5
2010,Kenya,KEN,Australia,AUS,5,0,15,0,20
2010,Rep. of Korea,KOR,Australia,AUS,5,0,59,0,64
2010,Dem. People's Rep. of Korea,PRK,Australia,AUS,0,0,16,0,16
2010,Lao People's Dem. Rep.,LAO,Australia,AUS,0,0,5,0,5
2010,Liberia,LBR,Australia,AUS,0,0,5,0,5
2010,Lebanon,LBN,Australia,AUS,10,0,105,0,115
2010,Sri Lanka,LKA,Australia,AUS,478,0,83,0,561
2010,Lithuania,LTU,Australia,AUS,0,0,5,0,5
2010,Latvia,LVA,Australia,AUS,0,0,5,0,5
2010,Malaysia,MYS,Australia,AUS,0,0,243,0,243
2010,Mongolia,MNG,Australia,AUS,0,0,12,0,12
2010,Mauritius,MUS,Australia,AUS,0,0,5,0,5
2010,Myanmar,MMR,Australia,AUS,47,0,21,0,68
2010,Nepal,NPL,Australia,AUS,15,0,94,0,109
2010,Nigeria,NGA,Australia,AUS,12,0,12,0,24
2010,Pakistan,PAK,Australia,AUS,162,0,91,0,253
2010,Peru,PER,Australia,AUS,0,0,5,0,5
2010,Philippines,PHL,Australia,AUS,0,0,61,0,61
2010,Papua New Guinea,PNG,Australia,AUS,15,0,10,0,25
2010,Poland,POL,Australia,AUS,0,0,5,0,5
2010,Portugal,PRT,Australia,AUS,0,0,5,0,5
2010,South Africa,ZAF,Australia,AUS,0,0,31,0,31
2010,Rwanda,RWA,Australia,AUS,5,0,0,0,5
2010,Saudi Arabia,SAU,Australia,AUS,10,0,0,0,10
2010,Somalia,SOM,Australia,AUS,0,0,5,0,5
2010,Viet Nam,VNM,Australia,AUS,5,0,34,0,39
2010,Sudan,SDN,Australia,AUS,5,0,5,0,10
2010,Syrian Arab Rep.,SYR,Australia,AUS,5,0,5,0,10
2010,United Rep. of Tanzania,TZA,Australia,AUS,0,0,5,0,5
2010,Thailand,THA,Australia,AUS,0,0,18,0,18
2010,Timor-Leste,TLS,Australia,AUS,0,0,5,0,5
2010,Tonga,TON,Australia,AUS,0,0,24,0,24
2010,Turkey,TUR,Australia,AUS,20,0,39,0,59
2010,United Arab Emirates,ARE,Australia,AUS,0,0,5,0,5
2010,Uganda,UGA,Australia,AUS,5,0,0,0,5
2010,United States of America,USA,Australia,AUS,0,0,5,0,5
2010,Uzbekistan,UZB,Australia,AUS,0,0,5,0,5
2010,Samoa,WSM,Australia,AUS,0,0,5,0,5
2010,Zambia,ZMB,Australia,AUS,0,0,5,0,5
2010,Zimbabwe,ZWE,Australia,AUS,175,0,110,0,285
2010,Stateless,XXA,Australia,AUS,241,0,10,0,251
2010,Afghanistan,AFG,Azerbaijan,AZE,0,0,20,0,20
2010,Iran (Islamic Rep. of),IRN,Azerbaijan,AZE,0,0,24,0,24
2010,Iraq,IRQ,Azerbaijan,AZE,0,0,14,0,14
2010,Pakistan,PAK,Azerbaijan,AZE,0,0,31,0,31
2010,Uzbekistan,UZB,Azerbaijan,AZE,0,0,5,0,5
2010,Afghanistan,AFG,Belgium,BEL,387,292,409,18,1106
2010,Albania,ALB,Belgium,BEL,11,0,55,10,76
2010,Algeria,DZA,Belgium,BEL,5,0,168,44,217
2010,Angola,AGO,Belgium,BEL,10,0,189,5,204
2010,Egypt,EGY,Belgium,BEL,0,0,19,0,19
2010,Armenia,ARM,Belgium,BEL,5,0,1751,103,1859
2010,Azerbaijan,AZE,Belgium,BEL,0,0,47,16,63
2010,Burundi,BDI,Belgium,BEL,38,0,122,10,170
2010,Benin,BEN,Belgium,BEL,5,0,38,0,43
2010,Bangladesh,BGD,Belgium,BEL,0,0,26,0,26
2010,Bhutan,BTN,Belgium,BEL,0,0,11,0,11
2010,Burkina Faso,BFA,Belgium,BEL,10,0,56,0,66
2010,Belarus,BLR,Belgium,BEL,5,0,28,19,52
2010,Brazil,BRA,Belgium,BEL,0,0,5,0,5
2010,Bosnia and Herzegovina,BIH,Belgium,BEL,0,0,54,11,65
2010,Bulgaria,BGR,Belgium,BEL,0,0,98,19,117
2010,Chad,TCD,Belgium,BEL,11,0,5,0,16
2010,China,CHN,Belgium,BEL,154,0,41,11,206
2010,Cameroon,CMR,Belgium,BEL,54,0,287,14,355
2010,Congo,COG,Belgium,BEL,5,0,14,0,19
2010,Dem. Rep. of the Congo,COD,Belgium,BEL,85,10,511,33,639
2010,Comoros,COM,Belgium,BEL,17,0,0,0,17
2010,Colombia,COL,Belgium,BEL,0,0,5,0,5
2010,Czechia,CZE,Belgium,BEL,0,0,12,0,12
2010,Djibouti,DJI,Belgium,BEL,23,0,35,0,58
2010,Eritrea,ERI,Belgium,BEL,28,5,11,0,44
2010,Ethiopia,ETH,Belgium,BEL,11,0,23,0,34
2010,Gabon,GAB,Belgium,BEL,0,0,5,0,5
2010,Gambia,GMB,Belgium,BEL,5,0,25,0,30
2010,Palestinian,PSE,Belgium,BEL,12,0,0,0,12
2010,Georgia,GEO,Belgium,BEL,5,0,200,38,243
2010,Ghana,GHA,Belgium,BEL,0,0,24,0,24
2010,Guinea-Bissau,GNB,Belgium,BEL,0,0,5,0,5
2010,Guinea,GIN,Belgium,BEL,362,12,578,45,997
2010,Croatia,HRV,Belgium,BEL,0,0,11,0,11
2010,Hungary,HUN,Belgium,BEL,0,0,24,0,24
2010,Cote d'Ivoire,CIV,Belgium,BEL,0,0,92,5,97
2010,India,IND,Belgium,BEL,0,0,58,5,63
2010,Iran (Islamic Rep. of),IRN,Belgium,BEL,58,0,107,41,206
2010,Iraq,IRQ,Belgium,BEL,303,424,199,55,981
2010,Israel,ISR,Belgium,BEL,0,0,0,5,5
2010,Jordan,JOR,Belgium,BEL,5,0,5,10,20
2010,Kazakhstan,KAZ,Belgium,BEL,5,0,36,0,41
2010,Kenya,KEN,Belgium,BEL,5,0,37,0,42
2010,Kyrgyzstan,KGZ,Belgium,BEL,5,0,12,10,27
2010,Dem. People's Rep. of Korea,PRK,Belgium,BEL,5,0,0,0,5
2010,Liberia,LBR,Belgium,BEL,5,0,18,0,23
2010,Libya,LBY,Belgium,BEL,0,0,5,0,5
2010,Lebanon,LBN,Belgium,BEL,11,0,75,10,96
2010,Sri Lanka,LKA,Belgium,BEL,48,0,76,10,134
2010,Madagascar,MDG,Belgium,BEL,0,0,5,0,5
2010,Mauritania,MRT,Belgium,BEL,24,0,146,0,170
2010,North Macedonia,MKD,Belgium,BEL,24,0,786,244,1054
2010,Rep. of Moldova,MDA,Belgium,BEL,0,0,12,0,12
2010,Mali,MLI,Belgium,BEL,0,0,10,0,10
2010,Mongolia,MNG,Belgium,BEL,0,0,20,5,25
2010,Morocco,MAR,Belgium,BEL,5,0,25,5,35
2010,Malta,MLT,Belgium,BEL,0,0,5,0,5
2010,Montenegro,MNE,Belgium,BEL,5,0,13,5,23
2010,Myanmar,MMR,Belgium,BEL,5,0,0,0,5
2010,Nepal,NPL,Belgium,BEL,0,0,25,5,30
2010,Niger,NER,Belgium,BEL,14,0,62,10,86
2010,Nigeria,NGA,Belgium,BEL,0,0,109,10,119
2010,Pakistan,PAK,Belgium,BEL,5,0,90,10,105
2010,Poland,POL,Belgium,BEL,0,0,0,5,5
2010,Romania,ROU,Belgium,BEL,0,0,70,0,70
2010,Russian Federation,RUS,Belgium,BEL,215,0,1574,117,1906
2010,Rwanda,RWA,Belgium,BEL,115,0,370,17,502
2010,Serbia and Kosovo: S/RES/1244 (1999),SRB,Belgium,BEL,259,0,2427,458,3144
2010,Senegal,SEN,Belgium,BEL,56,0,94,5,155
2010,Sierra Leone,SLE,Belgium,BEL,0,0,41,0,41
2010,Somalia,SOM,Belgium,BEL,45,43,87,5,180
2010,Viet Nam,VNM,Belgium,BEL,0,0,5,0,5
2010,Sudan,SDN,Belgium,BEL,13,5,31,5,54
2010,Suriname,SUR,Belgium,BEL,0,0,5,0,5
2010,Slovakia,SVK,Belgium,BEL,0,0,38,0,38
2010,Syrian Arab Rep.,SYR,Belgium,BEL,97,0,149,10,256
2010,United Rep. of Tanzania,TZA,Belgium,BEL,11,0,118,0,129
2010,Tajikistan,TJK,Belgium,BEL,0,0,5,0,5
2010,Togo,TGO,Belgium,BEL,18,0,208,5,231
2010,Tunisia,TUN,Belgium,BEL,0,0,11,5,16
2010,Turkey,TUR,Belgium,BEL,67,0,272,47,386
2010,Uganda,UGA,Belgium,BEL,0,0,14,0,14
2010,Ukraine,UKR,Belgium,BEL,0,0,30,10,40
2010,Uzbekistan,UZB,Belgium,BEL,0,0,20,5,25
2010,Yemen,YEM,Belgium,BEL,0,0,5,5,10
2010,Zimbabwe,ZWE,Belgium,BEL,0,0,5,0,5
2010,Stateless,XXA,Belgium,BEL,0,0,5,0,5
2010,Central African Rep.,CAF,Benin,BEN,0,0,5,0,5
2010,Chad,TCD,Benin,BEN,0,0,10,0,10
2010,Congo,COG,Benin,BEN,5,0,5,0,10
2010,Dem. Rep. of the Congo,COD,Benin,BEN,0,0,14,0,14
2010,Guinea,GIN,Benin,BEN,0,0,5,0,5
2010,Nigeria,NGA,Benin,BEN,0,0,15,0,15
2010,Togo,TGO,Benin,BEN,11,0,17,0,28
2010,Cuba,CUB,Bahamas,BHS,0,0,0,5,5
2010,Chad,TCD,Burkina Faso,BFA,5,0,0,5,10
2010,Cote d'Ivoire,CIV,Burkina Faso,BFA,0,0,0,5,5
2010,Togo,TGO,Burkina Faso,BFA,0,0,0,5,5
2010,Afghanistan,AFG,Belarus,BLR,5,0,84,10,99
2010,Azerbaijan,AZE,Belarus,BLR,0,5,0,0,5
2010,Georgia,GEO,Belarus,BLR,0,0,14,5,19
2010,Iran (Islamic Rep. of),IRN,Belarus,BLR,0,10,0,0,10
2010,Pakistan,PAK,Belarus,BLR,0,0,5,5,10
2010,Poland,POL,Belarus,BLR,0,0,0,5,5
2010,Russian Federation,RUS,Belarus,BLR,0,0,17,0,17
2010,Ukraine,UKR,Belarus,BLR,0,0,5,5,10
2010,Uzbekistan,UZB,Belarus,BLR,0,0,5,0,5
2010,Colombia,COL,Bolivia (Plurinational State of),BOL,14,5,0,20,39
2010,Afghanistan,AFG,Brazil,BRA,12,0,0,5,17
2010,Angola,AGO,Brazil,BRA,0,0,5,0,5
2010,Argentina,ARG,Brazil,BRA,0,0,5,0,5
2010,Bangladesh,BGD,Brazil,BRA,0,0,12,0,12
2010,Bhutan,BTN,Brazil,BRA,5,0,0,0,5
2010,Bolivia (Plurinational State of),BOL,Brazil,BRA,5,0,5,0,10
2010,Dem. Rep. of the Congo,COD,Brazil,BRA,43,0,23,5,71
2010,Colombia,COL,Brazil,BRA,21,0,49,11,81
2010,Cuba,CUB,Brazil,BRA,5,0,19,0,24
2010,Eritrea,ERI,Brazil,BRA,10,0,17,0,27
2010,Guinea-Bissau,GNB,Brazil,BRA,0,0,13,0,13
2010,Guinea,GIN,Brazil,BRA,0,0,5,5,10
2010,Haiti,HTI,Brazil,BRA,0,0,5,11,16
2010,Iran (Islamic Rep. of),IRN,Brazil,BRA,5,0,0,0,5
2010,Iraq,IRQ,Brazil,BRA,5,0,0,0,5
2010,Sri Lanka,LKA,Brazil,BRA,0,0,5,0,5
2010,Nigeria,NGA,Brazil,BRA,0,0,0,5,5
2010,Pakistan,PAK,Brazil,BRA,12,0,5,0,17
2010,Peru,PER,Brazil,BRA,5,0,0,0,5
2010,Senegal,SEN,Brazil,BRA,0,0,5,0,5
2010,Sierra Leone,SLE,Brazil,BRA,0,0,5,0,5
2010,Somalia,SOM,Brazil,BRA,5,0,5,0,10
2010,Sudan,SDN,Brazil,BRA,5,0,0,0,5
2010,Turkey,TUR,Brazil,BRA,0,0,5,0,5
2010,Uganda,UGA,Brazil,BRA,0,0,5,0,5
2010,Venezuela (Bolivarian Republic of),VEN,Brazil,BRA,0,0,5,0,5
2010,Viet Nam,VNM,Cambodia,KHM,5,0,0,0,5
2010,Afghanistan,AFG,Canada,CAN,412,0,26,49,487
2010,Albania,ALB,Canada,CAN,112,0,173,30,315
2010,Algeria,DZA,Canada,CAN,19,0,24,16,59
2010,Angola,AGO,Canada,CAN,10,0,0,0,10
2010,Antigua and Barbuda,ATG,Canada,CAN,10,0,14,0,24
2010,Egypt,EGY,Canada,CAN,29,0,10,5,44
2010,Argentina,ARG,Canada,CAN,5,0,5,11,21
2010,Armenia,ARM,Canada,CAN,18,0,12,5,35
2010,Australia,AUS,Canada,CAN,0,0,5,5,10
2010,Azerbaijan,AZE,Canada,CAN,14,0,0,5,19
2010,Barbados,BRB,Canada,CAN,13,0,20,5,38
2010,Burundi,BDI,Canada,CAN,130,0,16,5,151
2010,Belgium,BEL,Canada,CAN,0,0,0,5,5
2010,Benin,BEN,Canada,CAN,5,0,5,0,10
2010,Bangladesh,BGD,Canada,CAN,43,0,63,16,122
2010,Bahamas,BHS,Canada,CAN,0,0,10,0,10
2010,Burkina Faso,BFA,Canada,CAN,14,0,5,0,19
2010,Belarus,BLR,Canada,CAN,5,0,14,5,24
2010,Bolivia (Plurinational State of),BOL,Canada,CAN,11,0,5,5,21
2010,Botswana,BWA,Canada,CAN,36,0,23,14,73
2010,Brazil,BRA,Canada,CAN,10,0,47,49,106
2010,Bosnia and Herzegovina,BIH,Canada,CAN,5,0,19,5,29
2010,Bulgaria,BGR,Canada,CAN,17,0,5,10,32
2010,Belize,BLZ,Canada,CAN,0,0,5,0,5
2010,Cambodia,KHM,Canada,CAN,19,0,13,0,32
2010,Chad,TCD,Canada,CAN,29,0,18,0,47
2010,China,CHN,Canada,CAN,883,0,584,192,1659
2010,Chile,CHL,Canada,CAN,10,0,32,10,52
2010,Cameroon,CMR,Canada,CAN,104,0,52,10,166
2010,Congo,COG,Canada,CAN,25,0,11,5,41
2010,Dem. Rep. of the Congo,COD,Canada,CAN,207,0,73,17,297
2010,Colombia,COL,Canada,CAN,1266,0,1019,127,2412
2010,Costa Rica,CRI,Canada,CAN,0,0,5,14,19
2010,Cuba,CUB,Canada,CAN,116,0,103,47,266
2010,Czechia,CZE,Canada,CAN,24,0,274,671,969
2010,Djibouti,DJI,Canada,CAN,51,0,5,0,56
2010,Dominica,DMA,Canada,CAN,0,0,11,0,11
2010,Dominican Rep.,DOM,Canada,CAN,5,0,32,15,52
2010,Ecuador,ECU,Canada,CAN,10,0,30,10,50
2010,Equatorial Guinea,GNQ,Canada,CAN,0,0,5,0,5
2010,Eritrea,ERI,Canada,CAN,145,0,5,11,161
2010,Ethiopia,ETH,Canada,CAN,182,0,19,5,206
2010,Fiji,FJI,Canada,CAN,0,0,26,5,31
2010,France,FRA,Canada,CAN,0,0,26,23,49
2010,Gambia,GMB,Canada,CAN,13,0,0,0,13
2010,Palestinian,PSE,Canada,CAN,79,0,21,10,110
2010,United Kingdom of Great Britain and Northern Ireland,GBR,Canada,CAN,0,0,10,11,21
2010,Georgia,GEO,Canada,CAN,35,0,31,10,76
2010,Germany,DEU,Canada,CAN,0,0,41,19,60
2010,Ghana,GHA,Canada,CAN,26,0,30,13,69
2010,Greece,GRC,Canada,CAN,0,0,0,5,5
2010,Grenada,GRD,Canada,CAN,5,0,31,15,51
2010,Guatemala,GTM,Canada,CAN,69,0,142,42,253
2010,Guinea,GIN,Canada,CAN,43,0,23,5,71
2010,Guyana,GUY,Canada,CAN,33,0,112,33,178
2010,Haiti,HTI,Canada,CAN,2490,0,1778,295,4563
2010,"China, Hong Kong SAR",HKG,Canada,CAN,0,0,19,30,49
2010,Honduras,HND,Canada,CAN,49,0,207,53,309
2010,Croatia,HRV,Canada,CAN,5,0,12,5,22
2010,Hungary,HUN,Canada,CAN,22,0,72,1084,1178
2010,Cote d'Ivoire,CIV,Canada,CAN,25,0,12,5,42
2010,India,IND,Canada,CAN,124,0,206,88,418
2010,Indonesia,IDN,Canada,CAN,13,0,33,5,51
2010,Ireland,IRL,Canada,CAN,0,0,5,0,5
2010,Iran (Islamic Rep. of),IRN,Canada,CAN,270,0,62,34,366
2010,Iraq,IRQ,Canada,CAN,191,0,48,25,264
2010,Israel,ISR,Canada,CAN,56,0,324,104,484
2010,Italy,ITA,Canada,CAN,0,0,12,0,12
2010,Jamaica,JAM,Canada,CAN,75,0,125,60,260
2010,Jordan,JOR,Canada,CAN,37,0,54,14,105
2010,Japan,JPN,Canada,CAN,0,0,12,0,12
2010,Kazakhstan,KAZ,Canada,CAN,14,0,0,0,14
2010,Kenya,KEN,Canada,CAN,72,0,24,5,101
2010,Kyrgyzstan,KGZ,Canada,CAN,5,0,0,0,5
2010,Rep. of Korea,KOR,Canada,CAN,12,0,137,40,189
2010,Dem. People's Rep. of Korea,PRK,Canada,CAN,43,0,0,15,58
2010,Kuwait,KWT,Canada,CAN,16,0,0,0,16
2010,Lao People's Dem. Rep.,LAO,Canada,CAN,0,0,5,5,10
2010,Liberia,LBR,Canada,CAN,10,0,15,5,30
2010,Libya,LBY,Canada,CAN,14,0,10,5,29
2010,Saint Lucia,LCA,Canada,CAN,117,0,210,71,398
2010,Lebanon,LBN,Canada,CAN,59,0,93,32,184
2010,Sri Lanka,LKA,Canada,CAN,513,0,138,21,672
2010,Lithuania,LTU,Canada,CAN,0,0,0,14,14
2010,Latvia,LVA,Canada,CAN,0,0,5,14,19
2010,Madagascar,MDG,Canada,CAN,5,0,0,0,5
2010,Mauritania,MRT,Canada,CAN,12,0,5,5,22
2010,North Macedonia,MKD,Canada,CAN,5,0,13,0,18
2010,Rep. of Moldova,MDA,Canada,CAN,24,0,19,10,53
2010,Mexico,MEX,Canada,CAN,653,0,3437,1737,5827
2010,Mali,MLI,Canada,CAN,0,0,10,5,15
2010,Malaysia,MYS,Canada,CAN,5,0,22,0,27
2010,Mongolia,MNG,Canada,CAN,17,0,23,0,40
2010,Morocco,MAR,Canada,CAN,11,0,5,12,28
2010,Montenegro,MNE,Canada,CAN,0,0,5,0,5
2010,Mauritius,MUS,Canada,CAN,0,0,5,0,5
2010,Myanmar,MMR,Canada,CAN,5,0,0,0,5
2010,Namibia,NAM,Canada,CAN,13,0,0,0,13
2010,Nepal,NPL,Canada,CAN,87,0,33,5,125
2010,Netherlands,NLD,Canada,CAN,0,0,0,11,11
2010,Niger,NER,Canada,CAN,11,0,0,0,11
2010,Nicaragua,NIC,Canada,CAN,19,0,18,5,42
2010,Nigeria,NGA,Canada,CAN,593,0,251,87,931
2010,Norway,NOR,Canada,CAN,0,0,5,0,5
2010,Oman,OMN,Canada,CAN,5,0,0,0,5
2010,Pakistan,PAK,Canada,CAN,255,0,119,68,442
2010,Panama,PAN,Canada,CAN,0,0,5,5,10
2010,Paraguay,PRY,Canada,CAN,5,0,10,0,15
2010,Peru,PER,Canada,CAN,61,0,108,22,191
2010,Philippines,PHL,Canada,CAN,23,0,127,30,180
2010,Poland,POL,Canada,CAN,5,0,59,24,88
2010,Portugal,PRT,Canada,CAN,0,0,26,5,31
2010,Romania,ROU,Canada,CAN,29,0,18,39,86
2010,South Africa,ZAF,Canada,CAN,0,0,12,5,17
2010,Russian Federation,RUS,Canada,CAN,93,0,49,29,171
2010,Rwanda,RWA,Canada,CAN,159,0,40,5,204
2010,El Salvador,SLV,Canada,CAN,114,0,332,54,500
2010,Saudi Arabia,SAU,Canada,CAN,12,0,0,0,12
2010,Serbia and Kosovo: S/RES/1244 (1999),SRB,Canada,CAN,35,0,58,23,116
2010,Senegal,SEN,Canada,CAN,16,0,5,0,21
2010,Seychelles,SYC,Canada,CAN,0,0,5,0,5
2010,Singapore,SGP,Canada,CAN,5,0,0,0,5
2010,Sierra Leone,SLE,Canada,CAN,19,0,5,0,24
2010,San Marino,SMR,Canada,CAN,0,0,0,5,5
2010,Somalia,SOM,Canada,CAN,382,0,22,79,483
2010,Spain,ESP,Canada,CAN,0,0,12,11,23
2010,Viet Nam,VNM,Canada,CAN,10,0,19,0,29
2010,Saint Kitts and Nevis,KNA,Canada,CAN,0,0,0,5,5
2010,Sudan,SDN,Canada,CAN,34,0,5,5,44
2010,Suriname,SUR,Canada,CAN,0,0,5,0,5
2010,Slovakia,SVK,Canada,CAN,5,0,11,155,171
2010,Eswatini,SWZ,Canada,CAN,18,0,10,0,28
2010,Sweden,SWE,Canada,CAN,0,0,5,5,10
2010,Switzerland,CHE,Canada,CAN,0,0,0,5,5
2010,Syrian Arab Rep.,SYR,Canada,CAN,57,0,26,5,88
2010,United Rep. of Tanzania,TZA,Canada,CAN,27,0,5,10,42
2010,Thailand,THA,Canada,CAN,0,0,126,37,163
2010,Tajikistan,TJK,Canada,CAN,5,0,0,0,5
2010,Togo,TGO,Canada,CAN,5,0,12,0,17
2010,Trinidad and Tobago,TTO,Canada,CAN,21,0,102,28,151
2010,Tunisia,TUN,Canada,CAN,5,0,19,12,36
2010,Turkey,TUR,Canada,CAN,158,0,59,48,265
2010,United Arab Emirates,ARE,Canada,CAN,10,0,0,0,10
2010,Uganda,UGA,Canada,CAN,56,0,5,5,66
2010,Ukraine,UKR,Canada,CAN,66,0,55,38,159
2010,Uruguay,URY,Canada,CAN,5,0,17,5,27
2010,United States of America,USA,Canada,CAN,11,0,815,144,970
2010,Uzbekistan,UZB,Canada,CAN,18,0,5,0,23
2010,Saint Vincent and the Grenadines,VCT,Canada,CAN,236,0,409,90,735
2010,Venezuela (Bolivarian Republic of),VEN,Canada,CAN,110,0,52,29,191
2010,Yemen,YEM,Canada,CAN,14,0,5,0,19
2010,Zambia,ZMB,Canada,CAN,11,0,0,0,11
2010,Zimbabwe,ZWE,Canada,CAN,234,0,55,12,301
2010,Stateless,XXA,Canada,CAN,0,0,0,5,5
2010,Colombia,COL,Chile,CHL,66,0,394,0,460
2010,Cuba,CUB,Chile,CHL,0,0,5,0,5
2010,Ecuador,ECU,Chile,CHL,0,0,5,0,5
2010,Haiti,HTI,Chile,CHL,0,0,5,0,5
2010,Peru,PER,Chile,CHL,0,0,5,0,5
2010,Angola,AGO,Congo,COG,0,0,5,0,5
2010,Central African Rep.,CAF,Congo,COG,0,0,5,0,5
2010,Chad,TCD,Congo,COG,5,0,5,0,10
2010,Dem. Rep. of the Congo,COD,Congo,COG,130,0,272,0,402
2010,Cote d'Ivoire,CIV,Congo,COG,0,0,22,0,22
2010,Liberia,LBR,Congo,COG,0,0,0,5,5
2010,Rwanda,RWA,Congo,COG,0,0,14,0,14
2010,Sudan,SDN,Congo,COG,11,0,0,0,11
2010,Bangladesh,BGD,Colombia,COL,0,0,0,5,5
2010,Bolivia (Plurinational State of),BOL,Colombia,COL,0,0,5,0,5
2010,Dem. Rep. of the Congo,COD,Colombia,COL,0,0,5,0,5
2010,Cuba,CUB,Colombia,COL,0,0,11,11,22
2010,Eritrea,ERI,Colombia,COL,0,0,0,29,29
2010,Ethiopia,ETH,Colombia,COL,0,0,0,10,10
2010,El Salvador,SLV,Colombia,COL,5,0,0,0,5
2010,Somalia,SOM,Colombia,COL,0,0,0,29,29
2010,Bangladesh,BGD,Costa Rica,CRI,0,0,0,18,18
2010,China,CHN,Costa Rica,CRI,0,0,0,5,5
2010,Colombia,COL,Costa Rica,CRI,62,0,239,315,616
2010,Cuba,CUB,Costa Rica,CRI,29,0,15,14,58
2010,Dominican Rep.,DOM,Costa Rica,CRI,0,0,0,5,5
2010,Ecuador,ECU,Costa Rica,CRI,0,0,0,5,5
2010,Eritrea,ERI,Costa Rica,CRI,0,0,0,114,114
2010,Ethiopia,ETH,Costa Rica,CRI,0,0,0,15,15
2010,Ghana,GHA,Costa Rica,CRI,0,0,0,5,5
2010,Guatemala,GTM,Costa Rica,CRI,11,0,0,0,11
2010,Haiti,HTI,Costa Rica,CRI,0,0,5,0,5
2010,Honduras,HND,Costa Rica,CRI,5,0,30,5,40
2010,Mexico,MEX,Costa Rica,CRI,0,0,5,0,5
2010,Nepal,NPL,Costa Rica,CRI,0,0,0,17,17
2010,Nicaragua,NIC,Costa Rica,CRI,0,0,5,34,39
2010,Nigeria,NGA,Costa Rica,CRI,0,0,0,5,5
2010,Pakistan,PAK,Costa Rica,CRI,0,0,0,5,5
2010,Peru,PER,Costa Rica,CRI,0,0,0,5,5
2010,El Salvador,SLV,Costa Rica,CRI,20,0,22,5,47
2010,Somalia,SOM,Costa Rica,CRI,0,0,0,91,91
2010,Sudan,SDN,Costa Rica,CRI,0,0,0,5,5
2010,United States of America,USA,Costa Rica,CRI,0,0,0,10,10
2010,Venezuela (Bolivarian Republic of),VEN,Costa Rica,CRI,23,0,37,0,60
2010,Zimbabwe,ZWE,Costa Rica,CRI,0,0,0,10,10
2010,Afghanistan,AFG,Cyprus,CYP,0,0,32,0,32
2010,Egypt,EGY,Cyprus,CYP,10,0,170,10,190
2010,Armenia,ARM,Cyprus,CYP,0,0,12,0,12
2010,Bangladesh,BGD,Cyprus,CYP,0,0,125,0,125
2010,Belarus,BLR,Cyprus,CYP,0,0,5,0,5
2010,China,CHN,Cyprus,CYP,0,0,106,0,106
2010,Cameroon,CMR,Cyprus,CYP,0,0,104,0,104
2010,Dem. Rep. of the Congo,COD,Cyprus,CYP,0,0,5,0,5
2010,Palestinian,PSE,Cyprus,CYP,5,306,14,0,325
2010,Georgia,GEO,Cyprus,CYP,0,0,65,0,65
2010,Ghana,GHA,Cyprus,CYP,0,0,5,0,5
2010,Guinea,GIN,Cyprus,CYP,0,0,5,0,5
2010,India,IND,Cyprus,CYP,0,0,259,0,259
2010,Iran (Islamic Rep. of),IRN,Cyprus,CYP,5,0,68,5,78
2010,Iraq,IRQ,Cyprus,CYP,0,63,33,79,175
2010,Jordan,JOR,Cyprus,CYP,0,0,5,0,5
2010,Kazakhstan,KAZ,Cyprus,CYP,0,0,5,0,5
2010,Kenya,KEN,Cyprus,CYP,0,0,5,0,5
2010,Lebanon,LBN,Cyprus,CYP,0,5,19,0,24
2010,Sri Lanka,LKA,Cyprus,CYP,0,0,133,28,161
2010,Rep. of Moldova,MDA,Cyprus,CYP,0,0,5,11,16
2010,Mali,MLI,Cyprus,CYP,0,0,5,0,5
2010,Mongolia,MNG,Cyprus,CYP,0,0,5,0,5
2010,Morocco,MAR,Cyprus,CYP,0,0,10,0,10
2010,Nepal,NPL,Cyprus,CYP,0,0,89,10,99
2010,Nigeria,NGA,Cyprus,CYP,0,0,65,0,65
2010,Pakistan,PAK,Cyprus,CYP,0,0,101,10,111
2010,Philippines,PHL,Cyprus,CYP,0,0,94,5,99
2010,Russian Federation,RUS,Cyprus,CYP,0,0,5,0,5
2010,Serbia and Kosovo: S/RES/1244 (1999),SRB,Cyprus,CYP,0,5,0,0,5
2010,Viet Nam,VNM,Cyprus,CYP,0,0,187,5,192
2010,Syrian Arab Rep.,SYR,Cyprus,CYP,0,14,202,0,216
2010,Tunisia,TUN,Cyprus,CYP,0,0,5,0,5
2010,Turkey,TUR,Cyprus,CYP,12,0,61,0,73
2010,Ukraine,UKR,Cyprus,CYP,0,0,16,0,16
2010,Uzbekistan,UZB,Cyprus,CYP,0,0,5,0,5
2010,Afghanistan,AFG,Czechia,CZE,0,5,0,0,5
2010,Algeria,DZA,Czechia,CZE,0,0,10,5,15
2010,Egypt,EGY,Czechia,CZE,0,0,0,5,5
2010,Armenia,ARM,Czechia,CZE,5,0,10,14,29
2010,Belarus,BLR,Czechia,CZE,0,5,24,29,58
2010,Cambodia,KHM,Czechia,CZE,0,0,0,5,5
2010,China,CHN,Czechia,CZE,0,0,0,5,5
2010,Congo,COG,Czechia,CZE,0,5,0,5,10
2010,Dem. Rep. of the Congo,COD,Czechia,CZE,5,5,25,5,40
2010,Cuba,CUB,Czechia,CZE,5,13,0,0,18
2010,Georgia,GEO,Czechia,CZE,0,0,13,5,18
2010,Ghana,GHA,Czechia,CZE,0,0,0,5,5
2010,Guinea,GIN,Czechia,CZE,0,0,5,0,5
2010,India,IND,Czechia,CZE,0,0,0,5,5
2010,Iraq,IRQ,Czechia,CZE,5,12,0,5,22
2010,Kazakhstan,KAZ,Czechia,CZE,0,0,5,18,23
2010,Kyrgyzstan,KGZ,Czechia,CZE,5,5,5,15,30
2010,North Macedonia,MKD,Czechia,CZE,0,0,0,5,5
2010,Rep. of Moldova,MDA,Czechia,CZE,0,5,13,0,18
2010,Mongolia,MNG,Czechia,CZE,0,0,58,59,117
2010,Morocco,MAR,Czechia,CZE,0,0,0,5,5
2010,Myanmar,MMR,Czechia,CZE,43,0,0,0,43
2010,Niger,NER,Czechia,CZE,0,0,21,14,35
2010,Pakistan,PAK,Czechia,CZE,0,0,5,0,5
2010,Russian Federation,RUS,Czechia,CZE,18,17,10,28,73
2010,Serbia and Kosovo: S/RES/1244 (1999),SRB,Czechia,CZE,0,0,11,5,16
2010,Sierra Leone,SLE,Czechia,CZE,5,0,0,0,5
2010,Viet Nam,VNM,Czechia,CZE,0,0,23,19,42
2010,Slovakia,SVK,Czechia,CZE,0,0,0,5,5
2010,Syrian Arab Rep.,SYR,Czechia,CZE,5,0,25,18,48
2010,Turkey,TUR,Czechia,CZE,0,0,10,57,67
2010,Ukraine,UKR,Czechia,CZE,11,5,72,56,144
2010,Uzbekistan,UZB,Czechia,CZE,0,21,0,0,21
2010,Stateless,XXA,Czechia,CZE,5,5,14,21,45
2010,Afghanistan,AFG,Denmark,DNK,16,397,597,0,1010
2010,Albania,ALB,Denmark,DNK,0,0,5,0,5
2010,Algeria,DZA,Denmark,DNK,5,0,5,0,10
2010,Armenia,ARM,Denmark,DNK,0,0,17,0,17
2010,Azerbaijan,AZE,Denmark,DNK,5,0,14,0,19
2010,Bangladesh,BGD,Denmark,DNK,0,0,12,0,12
2010,Bosnia and Herzegovina,BIH,Denmark,DNK,0,0,14,0,14
2010,Bulgaria,BGR,Denmark,DNK,0,0,5,0,5
2010,China,CHN,Denmark,DNK,0,0,12,0,12
2010,Cameroon,CMR,Denmark,DNK,0,0,5,0,5
2010,Congo,COG,Denmark,DNK,0,0,5,0,5
2010,Dem. Rep. of the Congo,COD,Denmark,DNK,5,5,11,0,21
2010,Eritrea,ERI,Denmark,DNK,5,13,5,0,23
2010,Ethiopia,ETH,Denmark,DNK,0,0,5,0,5
2010,Gambia,GMB,Denmark,DNK,0,0,5,0,5
2010,Palestinian,PSE,Denmark,DNK,5,0,26,0,31
2010,Ghana,GHA,Denmark,DNK,0,0,5,0,5
2010,Guinea,GIN,Denmark,DNK,0,0,5,0,5
2010,Haiti,HTI,Denmark,DNK,0,0,5,0,5
2010,Hungary,HUN,Denmark,DNK,0,0,5,0,5
2010,India,IND,Denmark,DNK,0,0,20,0,20
2010,Iran (Islamic Rep. of),IRN,Denmark,DNK,190,17,121,0,328
2010,Iraq,IRQ,Denmark,DNK,5,17,71,0,93
2010,Israel,ISR,Denmark,DNK,0,0,5,0,5
2010,Jordan,JOR,Denmark,DNK,0,0,5,0,5
2010,Kenya,KEN,Denmark,DNK,0,0,5,0,5
2010,Libya,LBY,Denmark,DNK,0,0,11,0,11
2010,Lebanon,LBN,Denmark,DNK,0,0,5,0,5
2010,Sri Lanka,LKA,Denmark,DNK,5,0,54,0,59
2010,North Macedonia,MKD,Denmark,DNK,0,0,13,0,13
2010,Rep. of Moldova,MDA,Denmark,DNK,0,0,5,0,5
2010,Morocco,MAR,Denmark,DNK,0,0,10,0,10
2010,Montenegro,MNE,Denmark,DNK,0,0,5,0,5
2010,Myanmar,MMR,Denmark,DNK,5,0,12,0,17
2010,Nigeria,NGA,Denmark,DNK,0,0,19,0,19
2010,Pakistan,PAK,Denmark,DNK,0,0,13,0,13
2010,Poland,POL,Denmark,DNK,0,0,5,0,5
2010,Russian Federation,RUS,Denmark,DNK,73,26,54,0,153
2010,Rwanda,RWA,Denmark,DNK,0,0,5,0,5
2010,Serbia and Kosovo: S/RES/1244 (1999),SRB,Denmark,DNK,0,0,331,0,331
2010,Somalia,SOM,Denmark,DNK,5,19,46,0,70
2010,Viet Nam,VNM,Denmark,DNK,0,0,5,0,5
2010,Sudan,SDN,Denmark,DNK,5,0,18,0,23
2010,Syrian Arab Rep.,SYR,Denmark,DNK,327,11,250,0,588
2010,United Rep. of Tanzania,TZA,Denmark,DNK,0,0,5,0,5
2010,Tunisia,TUN,Denmark,DNK,0,0,5,0,5
2010,Turkey,TUR,Denmark,DNK,0,0,31,0,31
2010,Uganda,UGA,Denmark,DNK,0,0,16,0,16
2010,Uzbekistan,UZB,Denmark,DNK,0,0,10,0,10
2010,Zimbabwe,ZWE,Denmark,DNK,0,0,5,0,5
2010,Sudan,SDN,Dominican Rep.,DOM,5,0,0,0,5
2010,Afghanistan,AFG,Estonia,EST,5,0,11,0,16
2010,Georgia,GEO,Estonia,EST,0,0,5,0,5
2010,Sri Lanka,LKA,Estonia,EST,5,0,0,0,5
2010,Nigeria,NGA,Estonia,EST,0,0,5,0,5
2010,Russian Federation,RUS,Estonia,EST,0,5,0,0,5
2010,Afghanistan,AFG,Finland,FIN,28,168,154,112,462
2010,Albania,ALB,Finland,FIN,0,0,0,12,12
2010,Algeria,DZA,Finland,FIN,0,5,5,43,53
2010,Angola,AGO,Finland,FIN,0,21,24,5,50
2010,Egypt,EGY,Finland,FIN,0,0,0,5,5
2010,Armenia,ARM,Finland,FIN,0,0,0,15,15
2010,Azerbaijan,AZE,Finland,FIN,0,5,0,5,10
2010,Burundi,BDI,Finland,FIN,0,0,5,0,5
2010,Bangladesh,BGD,Finland,FIN,0,0,0,11,11
2010,Burkina Faso,BFA,Finland,FIN,0,0,0,5,5
2010,Belarus,BLR,Finland,FIN,0,0,13,76,89
2010,Bolivia (Plurinational State of),BOL,Finland,FIN,0,5,0,0,5
2010,Bosnia and Herzegovina,BIH,Finland,FIN,0,0,0,11,11
2010,Bulgaria,BGR,Finland,FIN,0,0,0,644,644
2010,China,CHN,Finland,FIN,5,10,0,0,15
2010,Cameroon,CMR,Finland,FIN,0,5,15,10,30
2010,Congo,COG,Finland,FIN,0,0,5,0,5
2010,Dem. Rep. of the Congo,COD,Finland,FIN,0,20,17,11,48
2010,Eritrea,ERI,Finland,FIN,0,0,5,11,16
2010,Estonia,EST,Finland,FIN,0,0,0,5,5
2010,Ethiopia,ETH,Finland,FIN,0,5,5,13,23
2010,Gambia,GMB,Finland,FIN,0,0,18,32,50
2010,Georgia,GEO,Finland,FIN,0,0,0,55,55
2010,Ghana,GHA,Finland,FIN,0,5,30,37,72
2010,Guinea,GIN,Finland,FIN,0,0,11,5,16
2010,Honduras,HND,Finland,FIN,0,0,0,5,5
2010,Croatia,HRV,Finland,FIN,0,0,0,5,5
2010,Cote d'Ivoire,CIV,Finland,FIN,0,0,0,5,5
2010,India,IND,Finland,FIN,0,0,5,18,23
2010,Iran (Islamic Rep. of),IRN,Finland,FIN,17,41,71,46,175
2010,Iraq,IRQ,Finland,FIN,71,536,266,336,1209
2010,Israel,ISR,Finland,FIN,0,0,0,5,5
2010,Kazakhstan,KAZ,Finland,FIN,0,0,0,5,5
2010,Kenya,KEN,Finland,FIN,0,0,5,0,5
2010,Kyrgyzstan,KGZ,Finland,FIN,0,0,0,5,5
2010,Liberia,LBR,Finland,FIN,0,0,0,5,5
2010,Libya,LBY,Finland,FIN,0,0,0,10,10
2010,Sri Lanka,LKA,Finland,FIN,0,20,42,15,77
2010,North Macedonia,MKD,Finland,FIN,0,0,0,19,19
2010,Rep. of Moldova,MDA,Finland,FIN,0,0,0,5,5
2010,Morocco,MAR,Finland,FIN,0,0,5,15,20
2010,Myanmar,MMR,Finland,FIN,0,0,5,0,5
2010,Nigeria,NGA,Finland,FIN,0,22,39,71,132
2010,Pakistan,PAK,Finland,FIN,0,5,5,0,10
2010,Romania,ROU,Finland,FIN,0,0,0,93,93
2010,Russian Federation,RUS,Finland,FIN,38,23,95,288,444
2010,Rwanda,RWA,Finland,FIN,0,5,5,0,10
2010,Serbia and Kosovo: S/RES/1244 (1999),SRB,Finland,FIN,0,19,48,281,348
2010,Senegal,SEN,Finland,FIN,0,0,0,5,5
2010,Sierra Leone,SLE,Finland,FIN,0,0,5,5,10
2010,Somalia,SOM,Finland,FIN,5,648,89,305,1047
2010,Sudan,SDN,Finland,FIN,0,0,0,14,14
2010,Slovakia,SVK,Finland,FIN,0,0,0,5,5
2010,Syrian Arab Rep.,SYR,Finland,FIN,0,5,13,17,35
2010,United Rep. of Tanzania,TZA,Finland,FIN,0,0,0,10,10
2010,Togo,TGO,Finland,FIN,0,0,0,5,5
2010,Tunisia,TUN,Finland,FIN,0,0,0,10,10
2010,Turkey,TUR,Finland,FIN,0,5,89,59,153
2010,Ukraine,UKR,Finland,FIN,0,0,5,5,10
2010,Uzbekistan,UZB,Finland,FIN,0,0,0,5,5
2010,Zimbabwe,ZWE,Finland,FIN,0,0,5,0,5
2010,Stateless,XXA,Finland,FIN,5,5,10,30,50
2010,Afghanistan,AFG,France,FRA,142,14,297,0,453
2010,Albania,ALB,France,FRA,11,5,417,0,433
2010,Algeria,DZA,France,FRA,19,15,878,0,912
2010,Angola,AGO,France,FRA,50,0,358,0,408
2010,Egypt,EGY,France,FRA,5,0,36,0,41
2010,Armenia,ARM,France,FRA,112,11,2329,0,2452
2010,Azerbaijan,AZE,France,FRA,74,0,489,0,563
2010,Burundi,BDI,France,FRA,14,0,16,0,30
2010,Bangladesh,BGD,France,FRA,26,0,2386,0,2412
2010,Bhutan,BTN,France,FRA,0,0,14,0,14
2010,Belarus,BLR,France,FRA,10,0,53,0,63
2010,Bolivia (Plurinational State of),BOL,France,FRA,0,0,5,0,5
2010,Bosnia and Herzegovina,BIH,France,FRA,24,0,345,0,369
2010,Bulgaria,BGR,France,FRA,0,0,10,0,10
2010,Cambodia,KHM,France,FRA,5,0,14,0,19
2010,Central African Rep.,CAF,France,FRA,10,0,104,0,114
2010,Chad,TCD,France,FRA,26,5,142,0,173
2010,China,CHN,France,FRA,139,0,1307,0,1446
2010,Cameroon,CMR,France,FRA,18,5,155,0,178
2010,Congo,COG,France,FRA,47,5,580,0,632
2010,Dem. Rep. of the Congo,COD,France,FRA,252,5,1828,0,2085
2010,Comoros,COM,France,FRA,84,0,455,0,539
2010,Colombia,COL,France,FRA,15,5,114,0,134
2010,Djibouti,DJI,France,FRA,11,0,5,0,16
2010,Eritrea,ERI,France,FRA,282,5,226,0,513
2010,Ethiopia,ETH,France,FRA,21,5,34,0,60
2010,Gambia,GMB,France,FRA,0,0,52,0,52
2010,Palestinian,PSE,France,FRA,38,0,71,0,109
2010,Georgia,GEO,France,FRA,16,0,511,0,527
2010,Guinea-Bissau,GNB,France,FRA,13,10,136,0,159
2010,Guinea,GIN,France,FRA,120,135,1308,0,1563
2010,Guyana,GUY,France,FRA,0,0,10,0,10
2010,Haiti,HTI,France,FRA,111,41,1411,0,1563
2010,Cote d'Ivoire,CIV,France,FRA,64,65,318,0,447
2010,Iran (Islamic Rep. of),IRN,France,FRA,184,0,79,0,263
2010,Iraq,IRQ,France,FRA,244,5,87,0,336
2010,Kazakhstan,KAZ,France,FRA,0,0,106,0,106
2010,Kenya,KEN,France,FRA,0,0,15,0,15
2010,Kyrgyzstan,KGZ,France,FRA,0,0,39,0,39
2010,Sri Lanka,LKA,France,FRA,580,5,2287,0,2872
2010,Madagascar,MDG,France,FRA,5,5,165,0,175
2010,Mauritania,MRT,France,FRA,55,23,938,0,1016
2010,North Macedonia,MKD,France,FRA,13,0,325,0,338
2010,Mali,MLI,France,FRA,12,415,145,0,572
2010,Mongolia,MNG,France,FRA,5,0,168,0,173
2010,Morocco,MAR,France,FRA,5,0,77,0,82
2010,Montenegro,MNE,France,FRA,0,0,48,0,48
2010,Myanmar,MMR,France,FRA,10,0,16,0,26
2010,Nepal,NPL,France,FRA,0,0,33,0,33
2010,Niger,NER,France,FRA,0,0,19,0,19
2010,Nigeria,NGA,France,FRA,10,16,548,0,574
2010,Pakistan,PAK,France,FRA,16,0,526,0,542
2010,Romania,ROU,France,FRA,0,0,25,0,25
2010,Russian Federation,RUS,France,FRA,368,5,2280,0,2653
2010,Rwanda,RWA,France,FRA,120,0,119,0,239
2010,Serbia and Kosovo: S/RES/1244 (1999),SRB,France,FRA,138,11,3961,0,4110
2010,Senegal,SEN,France,FRA,12,59,87,0,158
2010,Sierra Leone,SLE,France,FRA,5,10,97,0,112
2010,Somalia,SOM,France,FRA,103,86,84,0,273
2010,Sudan,SDN,France,FRA,137,13,736,0,886
2010,Syrian Arab Rep.,SYR,France,FRA,27,0,85,0,112
2010,Tajikistan,TJK,France,FRA,0,0,10,0,10
2010,Togo,TGO,France,FRA,24,0,108,0,132
2010,Tunisia,TUN,France,FRA,11,0,38,0,49
2010,Turkey,TUR,France,FRA,124,0,1895,0,2019
2010,Uganda,UGA,France,FRA,0,0,11,0,11
2010,Ukraine,UKR,France,FRA,10,0,73,0,83
2010,Zimbabwe,ZWE,France,FRA,14,0,0,0,14
2010,Stateless,XXA,France,FRA,61,0,119,0,180
2010,Afghanistan,AFG,United Kingdom of Great Britain and Northern Ireland,GBR,216,614,1441,571,2842
2010,Albania,ALB,United Kingdom of Great Britain and Northern Ireland,GBR,14,37,186,46,283
2010,Algeria,DZA,United Kingdom of Great Britain and Northern Ireland,GBR,5,15,228,123,371
2010,Angola,AGO,United Kingdom of Great Britain and Northern Ireland,GBR,12,15,61,10,98
2010,Egypt,EGY,United Kingdom of Great Britain and Northern Ireland,GBR,5,5,107,11,128
2010,Armenia,ARM,United Kingdom of Great Britain and Northern Ireland,GBR,0,5,22,5,32
2010,Australia,AUS,United Kingdom of Great Britain and Northern Ireland,GBR,0,0,0,5,5
2010,Azerbaijan,AZE,United Kingdom of Great Britain and Northern Ireland,GBR,21,0,11,5,37
2010,Barbados,BRB,United Kingdom of Great Britain and Northern Ireland,GBR,0,0,5,0,5
2010,Burundi,BDI,United Kingdom of Great Britain and Northern Ireland,GBR,0,5,12,0,17
2010,Benin,BEN,United Kingdom of Great Britain and Northern Ireland,GBR,0,0,14,0,14
2010,Bangladesh,BGD,United Kingdom of Great Britain and Northern Ireland,GBR,10,47,402,117,576
2010,Bahamas,BHS,United Kingdom of Great Britain and Northern Ireland,GBR,0,5,0,0,5
2010,Bhutan,BTN,United Kingdom of Great Britain and Northern Ireland,GBR,17,0,15,0,32
2010,Burkina Faso,BFA,United Kingdom of Great Britain and Northern Ireland,GBR,0,0,5,0,5
2010,Belarus,BLR,United Kingdom of Great Britain and Northern Ireland,GBR,5,0,30,5,40
2010,Bolivia (Plurinational State of),BOL,United Kingdom of Great Britain and Northern Ireland,GBR,0,0,27,5,32
2010,Botswana,BWA,United Kingdom of Great Britain and Northern Ireland,GBR,5,0,14,0,19
2010,Brazil,BRA,United Kingdom of Great Britain and Northern Ireland,GBR,0,5,46,11,62
2010,Bosnia and Herzegovina,BIH,United Kingdom of Great Britain and Northern Ireland,GBR,10,0,10,5,25
2010,Bulgaria,BGR,United Kingdom of Great Britain and Northern Ireland,GBR,0,0,0,5,5
2010,Belize,BLZ,United Kingdom of Great Britain and Northern Ireland,GBR,0,0,5,0,5
2010,Chad,TCD,United Kingdom of Great Britain and Northern Ireland,GBR,0,0,10,0,10
2010,China,CHN,United Kingdom of Great Britain and Northern Ireland,GBR,106,61,1422,317,1906
2010,Chile,CHL,United Kingdom of Great Britain and Northern Ireland,GBR,0,0,10,0,10
2010,Cameroon,CMR,United Kingdom of Great Britain and Northern Ireland,GBR,24,10,81,10,125
2010,Congo,COG,United Kingdom of Great Britain and Northern Ireland,GBR,5,5,25,5,40
2010,Dem. Rep. of the Congo,COD,United Kingdom of Great Britain and Northern Ireland,GBR,59,14,240,25,338
2010,Colombia,COL,United Kingdom of Great Britain and Northern Ireland,GBR,0,5,17,5,27
2010,Cuba,CUB,United Kingdom of Great Britain and Northern Ireland,GBR,0,0,16,0,16
2010,Cyprus,CYP,United Kingdom of Great Britain and Northern Ireland,GBR,0,0,0,5,5
2010,Czechia,CZE,United Kingdom of Great Britain and Northern Ireland,GBR,0,0,0,17,17
2010,Dominica,DMA,United Kingdom of Great Britain and Northern Ireland,GBR,0,0,5,0,5
2010,Dominican Rep.,DOM,United Kingdom of Great Britain and Northern Ireland,GBR,0,0,5,0,5
2010,Ecuador,ECU,United Kingdom of Great Britain and Northern Ireland,GBR,0,0,5,5,10
2010,Eritrea,ERI,United Kingdom of Great Britain and Northern Ireland,GBR,565,34,252,195,1046
2010,Estonia,EST,United Kingdom of Great Britain and Northern Ireland,GBR,0,0,0,5,5
2010,Ethiopia,ETH,United Kingdom of Great Britain and Northern Ireland,GBR,31,10,97,13,151
2010,France,FRA,United Kingdom of Great Britain and Northern Ireland,GBR,0,0,0,5,5
2010,Gambia,GMB,United Kingdom of Great Britain and Northern Ireland,GBR,125,58,324,21,528
2010,Palestinian,PSE,United Kingdom of Great Britain and Northern Ireland,GBR,25,23,188,65,301
2010,United Kingdom of Great Britain and Northern Ireland,GBR,United Kingdom of Great Britain and Northern Ireland,GBR,0,0,11,12,23
2010,Georgia,GEO,United Kingdom of Great Britain and Northern Ireland,GBR,5,0,73,5,83
2010,Ghana,GHA,United Kingdom of Great Britain and Northern Ireland,GBR,0,10,184,48,242
2010,Guinea-Bissau,GNB,United Kingdom of Great Britain and Northern Ireland,GBR,0,0,5,0,5
2010,Guatemala,GTM,United Kingdom of Great Britain and Northern Ireland,GBR,0,0,5,0,5
2010,Guinea,GIN,United Kingdom of Great Britain and Northern Ireland,GBR,25,11,90,17,143
2010,Guyana,GUY,United Kingdom of Great Britain and Northern Ireland,GBR,0,0,11,0,11
2010,Croatia,HRV,United Kingdom of Great Britain and Northern Ireland,GBR,0,0,5,0,5
2010,Cote d'Ivoire,CIV,United Kingdom of Great Britain and Northern Ireland,GBR,5,5,63,5,78
2010,India,IND,United Kingdom of Great Britain and Northern Ireland,GBR,0,14,420,286,720
2010,Indonesia,IDN,United Kingdom of Great Britain and Northern Ireland,GBR,0,0,5,0,5
2010,Ireland,IRL,United Kingdom of Great Britain and Northern Ireland,GBR,0,0,5,0,5
2010,Iran (Islamic Rep. of),IRN,United Kingdom of Great Britain and Northern Ireland,GBR,699,145,1774,178,2796
2010,Iraq,IRQ,United Kingdom of Great Britain and Northern Ireland,GBR,81,88,699,120,988
2010,Israel,ISR,United Kingdom of Great Britain and Northern Ireland,GBR,0,0,15,0,15
2010,Jamaica,JAM,United Kingdom of Great Britain and Northern Ireland,GBR,24,28,229,44,325
2010,Jordan,JOR,United Kingdom of Great Britain and Northern Ireland,GBR,5,0,17,5,27
2010,Kenya,KEN,United Kingdom of Great Britain and Northern Ireland,GBR,18,5,120,21,164
2010,Kyrgyzstan,KGZ,United Kingdom of Great Britain and Northern Ireland,GBR,0,0,21,5,26
2010,Rep. of Korea,KOR,United Kingdom of Great Britain and Northern Ireland,GBR,0,0,15,0,15
2010,Dem. People's Rep. of Korea,PRK,United Kingdom of Great Britain and Northern Ireland,GBR,0,5,142,29,176
2010,Kuwait,KWT,United Kingdom of Great Britain and Northern Ireland,GBR,29,5,59,10,103
2010,Liberia,LBR,United Kingdom of Great Britain and Northern Ireland,GBR,0,5,11,0,16
2010,Libya,LBY,United Kingdom of Great Britain and Northern Ireland,GBR,22,0,119,15,156
2010,Saint Lucia,LCA,United Kingdom of Great Britain and Northern Ireland,GBR,0,0,5,0,5
2010,Lebanon,LBN,United Kingdom of Great Britain and Northern Ireland,GBR,0,11,55,14,80
2010,Sri Lanka,LKA,United Kingdom of Great Britain and Northern Ireland,GBR,237,48,1695,137,2117
2010,Lithuania,LTU,United Kingdom of Great Britain and Northern Ireland,GBR,0,0,0,13,13
2010,Latvia,LVA,United Kingdom of Great Britain and Northern Ireland,GBR,0,0,0,5,5
2010,Mauritania,MRT,United Kingdom of Great Britain and Northern Ireland,GBR,0,0,10,0,10
2010,North Macedonia,MKD,United Kingdom of Great Britain and Northern Ireland,GBR,0,0,5,14,19
2010,Rep. of Moldova,MDA,United Kingdom of Great Britain and Northern Ireland,GBR,0,0,5,12,17
2010,Mexico,MEX,United Kingdom of Great Britain and Northern Ireland,GBR,0,0,12,0,12
2010,Mali,MLI,United Kingdom of Great Britain and Northern Ireland,GBR,0,0,14,0,14
2010,Malaysia,MYS,United Kingdom of Great Britain and Northern Ireland,GBR,5,0,42,16,63
2010,Malawi,MWI,United Kingdom of Great Britain and Northern Ireland,GBR,5,25,234,19,283
2010,Mongolia,MNG,United Kingdom of Great Britain and Northern Ireland,GBR,5,0,52,11,68
2010,Morocco,MAR,United Kingdom of Great Britain and Northern Ireland,GBR,5,12,24,19,60
2010,Mauritius,MUS,United Kingdom of Great Britain and Northern Ireland,GBR,0,0,68,5,73
2010,Myanmar,MMR,United Kingdom of Great Britain and Northern Ireland,GBR,106,5,201,0,312
2010,Namibia,NAM,United Kingdom of Great Britain and Northern Ireland,GBR,0,0,21,0,21
2010,Nepal,NPL,United Kingdom of Great Britain and Northern Ireland,GBR,0,0,20,10,30
2010,Netherlands,NLD,United Kingdom of Great Britain and Northern Ireland,GBR,0,0,5,0,5
2010,Niger,NER,United Kingdom of Great Britain and Northern Ireland,GBR,0,0,5,0,5
2010,Nigeria,NGA,United Kingdom of Great Britain and Northern Ireland,GBR,25,45,1052,188,1310
2010,Pakistan,PAK,United Kingdom of Great Britain and Northern Ireland,GBR,174,56,2095,235,2560
2010,Philippines,PHL,United Kingdom of Great Britain and Northern Ireland,GBR,0,0,16,5,21
2010,Poland,POL,United Kingdom of Great Britain and Northern Ireland,GBR,0,0,5,20,25
2010,Romania,ROU,United Kingdom of Great Britain and Northern Ireland,GBR,0,0,5,75,80
2010,South Africa,ZAF,United Kingdom of Great Britain and Northern Ireland,GBR,5,19,195,21,240
2010,Russian Federation,RUS,United Kingdom of Great Britain and Northern Ireland,GBR,35,5,80,10,130
2010,Rwanda,RWA,United Kingdom of Great Britain and Northern Ireland,GBR,5,5,26,0,36
2010,Saudi Arabia,SAU,United Kingdom of Great Britain and Northern Ireland,GBR,5,0,5,5,15
2010,Serbia and Kosovo: S/RES/1244 (1999),SRB,United Kingdom of Great Britain and Northern Ireland,GBR,0,5,25,38,68
2010,Senegal,SEN,United Kingdom of Great Britain and Northern Ireland,GBR,10,0,42,5,57
2010,Sierra Leone,SLE,United Kingdom of Great Britain and Northern Ireland,GBR,10,12,85,10,117
2010,Somalia,SOM,United Kingdom of Great Britain and Northern Ireland,GBR,437,96,441,116,1090
2010,Viet Nam,VNM,United Kingdom of Great Britain and Northern Ireland,GBR,10,42,155,314,521
2010,Saint Kitts and Nevis,KNA,United Kingdom of Great Britain and Northern Ireland,GBR,0,5,0,0,5
2010,Sudan,SDN,United Kingdom of Great Britain and Northern Ireland,GBR,397,17,142,117,673
2010,Slovakia,SVK,United Kingdom of Great Britain and Northern Ireland,GBR,0,0,0,5,5
2010,Eswatini,SWZ,United Kingdom of Great Britain and Northern Ireland,GBR,5,0,5,0,10
2010,Syrian Arab Rep.,SYR,United Kingdom of Great Britain and Northern Ireland,GBR,36,5,134,31,206
2010,United Rep. of Tanzania,TZA,United Kingdom of Great Britain and Northern Ireland,GBR,0,5,35,5,45
2010,Thailand,THA,United Kingdom of Great Britain and Northern Ireland,GBR,13,0,0,0,13
2010,Turkmenistan,TKM,United Kingdom of Great Britain and Northern Ireland,GBR,0,0,5,0,5
2010,Togo,TGO,United Kingdom of Great Britain and Northern Ireland,GBR,0,0,19,5,24
2010,Trinidad and Tobago,TTO,United Kingdom of Great Britain and Northern Ireland,GBR,0,0,26,5,31
2010,Tunisia,TUN,United Kingdom of Great Britain and Northern Ireland,GBR,0,0,21,0,21
2010,Turkey,TUR,United Kingdom of Great Britain and Northern Ireland,GBR,28,10,160,30,228
2010,Uganda,UGA,United Kingdom of Great Britain and Northern Ireland,GBR,37,22,247,13,319
2010,Ukraine,UKR,United Kingdom of Great Britain and Northern Ireland,GBR,0,5,44,15,64
2010,United States of America,USA,United Kingdom of Great Britain and Northern Ireland,GBR,0,0,29,12,41
2010,Uzbekistan,UZB,United Kingdom of Great Britain and Northern Ireland,GBR,0,0,16,0,16
2010,Saint Vincent and the Grenadines,VCT,United Kingdom of Great Britain and Northern Ireland,GBR,0,0,11,0,11
2010,Venezuela (Bolivarian Republic of),VEN,United Kingdom of Great Britain and Northern Ireland,GBR,5,0,12,0,17
2010,Western Sahara,ESH,United Kingdom of Great Britain and Northern Ireland,GBR,0,0,10,5,15
2010,Yemen,YEM,United Kingdom of Great Britain and Northern Ireland,GBR,10,0,46,5,61
2010,Zambia,ZMB,United Kingdom of Great Britain and Northern Ireland,GBR,0,5,28,0,33
2010,Zimbabwe,ZWE,United Kingdom of Great Britain and Northern Ireland,GBR,519,236,1749,55,2559
2010,Stateless,XXA,United Kingdom of Great Britain and Northern Ireland,GBR,151,5,108,16,280
2010,Sierra Leone,SLE,Ghana,GHA,16,0,0,0,16
2010,Sudan,SDN,Ghana,GHA,5,0,0,0,5
2010,Togo,TGO,Ghana,GHA,11,0,0,0,11
2010,Afghanistan,AFG,Greece,GRC,10,5,191,124,330
2010,Albania,ALB,Greece,GRC,0,0,251,162,413
2010,Algeria,DZA,Greece,GRC,0,0,24,10,34
2010,Egypt,EGY,Greece,GRC,0,0,25,14,39
2010,Armenia,ARM,Greece,GRC,0,0,24,17,41
2010,Bangladesh,BGD,Greece,GRC,0,0,208,29,237
2010,Burkina Faso,BFA,Greece,GRC,0,0,5,0,5
2010,Belarus,BLR,Greece,GRC,0,0,5,5,10
2010,China,CHN,Greece,GRC,0,0,292,13,305
2010,Cameroon,CMR,Greece,GRC,0,0,0,10,10
2010,Congo,COG,Greece,GRC,0,0,5,0,5
2010,Dominican Rep.,DOM,Greece,GRC,0,0,0,5,5
2010,Eritrea,ERI,Greece,GRC,0,0,11,0,11
2010,Ethiopia,ETH,Greece,GRC,0,0,5,14,19
2010,Gambia,GMB,Greece,GRC,0,0,0,5,5
2010,Palestinian,PSE,Greece,GRC,0,0,38,0,38
2010,Georgia,GEO,Greece,GRC,0,0,684,214,898
2010,Ghana,GHA,Greece,GRC,0,0,11,17,28
2010,Guinea,GIN,Greece,GRC,0,0,5,5,10
2010,Cote d'Ivoire,CIV,Greece,GRC,0,0,5,0,5
2010,India,IND,Greece,GRC,0,0,59,5,64
2010,Indonesia,IDN,Greece,GRC,0,0,5,0,5
2010,Iran (Islamic Rep. of),IRN,Greece,GRC,30,0,44,20,94
2010,Iraq,IRQ,Greece,GRC,13,0,131,83,227
2010,Kenya,KEN,Greece,GRC,0,0,5,5,10
2010,Kyrgyzstan,KGZ,Greece,GRC,0,5,0,0,5
2010,Lebanon,LBN,Greece,GRC,0,0,5,5,10
2010,Sri Lanka,LKA,Greece,GRC,0,0,12,5,17
2010,Rep. of Moldova,MDA,Greece,GRC,0,0,14,10,24
2010,Morocco,MAR,Greece,GRC,0,0,15,5,20
2010,Myanmar,MMR,Greece,GRC,0,0,0,5,5
2010,Niger,NER,Greece,GRC,0,0,5,0,5
2010,Nigeria,NGA,Greece,GRC,0,10,139,240,389
2010,Pakistan,PAK,Greece,GRC,0,0,845,147,992
2010,Philippines,PHL,Greece,GRC,0,0,5,0,5
2010,Russian Federation,RUS,Greece,GRC,5,0,36,30,71
2010,Serbia and Kosovo: S/RES/1244 (1999),SRB,Greece,GRC,0,0,5,0,5
2010,Senegal,SEN,Greece,GRC,0,0,23,10,33
2010,Sierra Leone,SLE,Greece,GRC,0,0,0,5,5
2010,Somalia,SOM,Greece,GRC,5,0,28,5,38
2010,Viet Nam,VNM,Greece,GRC,0,0,5,0,5
2010,Sudan,SDN,Greece,GRC,0,0,0,10,10
2010,Syrian Arab Rep.,SYR,Greece,GRC,0,0,100,29,129
2010,United Rep. of Tanzania,TZA,Greece,GRC,0,0,5,0,5
2010,Tunisia,TUN,Greece,GRC,0,0,5,5,10
2010,Turkey,TUR,Greece,GRC,0,5,28,18,51
2010,Ukraine,UKR,Greece,GRC,0,0,13,19,32
2010,Uzbekistan,UZB,Greece,GRC,0,0,5,0,5
2010,Colombia,COL,Guatemala,GTM,0,0,0,5,5
2010,Nepal,NPL,Guatemala,GTM,0,0,0,5,5
2010,El Salvador,SLV,Guatemala,GTM,5,0,0,0,5
2010,Colombia,COL,Honduras,HND,0,0,0,5,5
2010,Eritrea,ERI,Honduras,HND,0,0,0,38,38
2010,Somalia,SOM,Honduras,HND,0,0,0,15,15
2010,Zimbabwe,ZWE,Honduras,HND,0,0,0,5,5
2010,Afghanistan,AFG,Croatia,HRV,0,0,14,87,101
2010,Algeria,DZA,Croatia,HRV,0,0,5,5,10
2010,Palestinian,PSE,Croatia,HRV,0,0,0,34,34
2010,Iran (Islamic Rep. of),IRN,Croatia,HRV,0,0,5,12,17
2010,Pakistan,PAK,Croatia,HRV,0,0,5,0,5
2010,Serbia and Kosovo: S/RES/1244 (1999),SRB,Croatia,HRV,0,0,10,5,15
2010,Somalia,SOM,Croatia,HRV,0,0,0,10,10
2010,Turkey,TUR,Croatia,HRV,0,0,5,0,5
2010,Western Sahara,ESH,Croatia,HRV,0,0,0,5,5
2010,Afghanistan,AFG,Hungary,HUN,10,108,222,506,846
2010,Algeria,DZA,Hungary,HUN,0,0,11,24,35
2010,Egypt,EGY,Hungary,HUN,14,0,0,0,14
2010,Armenia,ARM,Hungary,HUN,0,0,0,10,10
2010,Bangladesh,BGD,Hungary,HUN,0,0,5,0,5
2010,China,CHN,Hungary,HUN,0,0,5,13,18
2010,Cameroon,CMR,Hungary,HUN,0,0,5,5,10
2010,Cuba,CUB,Hungary,HUN,0,0,0,5,5
2010,Ethiopia,ETH,Hungary,HUN,0,0,0,5,5
2010,Palestinian,PSE,Hungary,HUN,0,17,74,147,238
2010,Georgia,GEO,Hungary,HUN,0,0,25,48,73
2010,Guinea,GIN,Hungary,HUN,0,0,5,0,5
2010,Cote d'Ivoire,CIV,Hungary,HUN,0,0,0,5,5
2010,India,IND,Hungary,HUN,0,0,0,5,5
2010,Iran (Islamic Rep. of),IRN,Hungary,HUN,0,5,42,38,85
2010,Iraq,IRQ,Hungary,HUN,5,5,10,26,46
2010,Jordan,JOR,Hungary,HUN,0,0,5,5,10
2010,Kazakhstan,KAZ,Hungary,HUN,0,0,0,5,5
2010,Liberia,LBR,Hungary,HUN,0,0,0,5,5
2010,Lebanon,LBN,Hungary,HUN,0,5,0,16,21
2010,Sri Lanka,LKA,Hungary,HUN,13,0,0,0,13
2010,North Macedonia,MKD,Hungary,HUN,0,0,0,5,5
2010,Rep. of Moldova,MDA,Hungary,HUN,0,0,0,15,15
2010,Mongolia,MNG,Hungary,HUN,0,0,5,0,5
2010,Morocco,MAR,Hungary,HUN,0,0,5,10,15
2010,Nigeria,NGA,Hungary,HUN,0,0,22,28,50
2010,Pakistan,PAK,Hungary,HUN,0,0,16,34,50
2010,Romania,ROU,Hungary,HUN,0,0,0,5,5
2010,Russian Federation,RUS,Hungary,HUN,0,0,0,25,25
2010,Serbia and Kosovo: S/RES/1244 (1999),SRB,Hungary,HUN,0,0,90,413,503
2010,Somalia,SOM,Hungary,HUN,19,25,0,15,59
2010,Viet Nam,VNM,Hungary,HUN,0,0,16,22,38
2010,Sudan,SDN,Hungary,HUN,0,5,10,0,15
2010,Syrian Arab Rep.,SYR,Hungary,HUN,0,0,13,5,18
2010,Tunisia,TUN,Hungary,HUN,0,0,0,11,11
2010,Turkey,TUR,Hungary,HUN,0,0,14,41,55
2010,Ukraine,UKR,Hungary,HUN,0,0,5,5,10
2010,Western Sahara,ESH,Hungary,HUN,0,0,10,0,10
2010,Afghanistan,AFG,Iceland,ISL,0,5,0,5,10
2010,Iran (Islamic Rep. of),IRN,Iceland,ISL,5,0,0,0,5
2010,Iraq,IRQ,Iceland,ISL,0,0,0,5,5
2010,Kenya,KEN,Iceland,ISL,0,5,0,0,5
2010,Rep. of Moldova,MDA,Iceland,ISL,0,0,5,0,5
2010,Nigeria,NGA,Iceland,ISL,0,0,0,5,5
2010,Somalia,SOM,Iceland,ISL,0,0,5,0,5
2010,Spain,ESP,Iceland,ISL,0,0,5,0,5
2010,Afghanistan,AFG,Ireland,IRL,0,0,46,31,77
2010,Albania,ALB,Ireland,IRL,0,0,12,5,17
2010,Algeria,DZA,Ireland,IRL,0,0,24,18,42
2010,Angola,AGO,Ireland,IRL,0,0,13,0,13
2010,Egypt,EGY,Ireland,IRL,0,0,5,13,18
2010,Armenia,ARM,Ireland,IRL,0,0,5,5,10
2010,Burundi,BDI,Ireland,IRL,0,0,10,0,10
2010,Benin,BEN,Ireland,IRL,0,0,5,0,5
2010,Bangladesh,BGD,Ireland,IRL,0,0,33,13,46
2010,Bhutan,BTN,Ireland,IRL,0,0,17,5,22
2010,Bolivia (Plurinational State of),BOL,Ireland,IRL,0,0,12,0,12
2010,Brazil,BRA,Ireland,IRL,0,0,5,0,5
2010,China,CHN,Ireland,IRL,5,0,37,181,223
2010,Cameroon,CMR,Ireland,IRL,0,0,53,10,63
2010,Dem. Rep. of the Congo,COD,Ireland,IRL,0,0,44,13,57
2010,Eritrea,ERI,Ireland,IRL,0,0,10,20,30
2010,Ethiopia,ETH,Ireland,IRL,0,0,5,5,10
2010,Palestinian,PSE,Ireland,IRL,0,0,5,19,24
2010,Georgia,GEO,Ireland,IRL,0,0,43,25,68
2010,Ghana,GHA,Ireland,IRL,0,0,58,0,58
2010,Guinea,GIN,Ireland,IRL,0,0,5,0,5
2010,Croatia,HRV,Ireland,IRL,0,0,10,0,10
2010,Cote d'Ivoire,CIV,Ireland,IRL,0,0,5,0,5
2010,India,IND,Ireland,IRL,0,0,11,12,23
2010,Iran (Islamic Rep. of),IRN,Ireland,IRL,0,0,13,10,23
2010,Iraq,IRQ,Ireland,IRL,0,0,15,22,37
2010,Kenya,KEN,Ireland,IRL,0,0,10,0,10
2010,Kuwait,KWT,Ireland,IRL,0,0,0,5,5
2010,Liberia,LBR,Ireland,IRL,0,0,5,5,10
2010,Sri Lanka,LKA,Ireland,IRL,0,0,5,0,5
2010,Rep. of Moldova,MDA,Ireland,IRL,0,0,43,24,67
2010,Malawi,MWI,Ireland,IRL,0,0,15,0,15
2010,Mongolia,MNG,Ireland,IRL,0,0,5,0,5
2010,Mauritius,MUS,Ireland,IRL,0,0,15,5,20
2010,Nepal,NPL,Ireland,IRL,0,0,5,24,29
2010,Niger,NER,Ireland,IRL,0,0,0,5,5
2010,Nigeria,NGA,Ireland,IRL,0,0,301,93,394
2010,Pakistan,PAK,Ireland,IRL,0,0,148,54,202
2010,South Africa,ZAF,Ireland,IRL,0,0,44,0,44
2010,Russian Federation,RUS,Ireland,IRL,0,0,0,14,14
2010,Rwanda,RWA,Ireland,IRL,0,0,5,5,10
2010,Serbia and Kosovo: S/RES/1244 (1999),SRB,Ireland,IRL,0,0,17,5,22
2010,Sierra Leone,SLE,Ireland,IRL,0,0,17,5,22
2010,Somalia,SOM,Ireland,IRL,5,0,48,24,77
2010,Viet Nam,VNM,Ireland,IRL,0,0,0,5,5
2010,Sudan,SDN,Ireland,IRL,0,0,27,16,43
2010,Syrian Arab Rep.,SYR,Ireland,IRL,0,0,0,5,5
2010,Togo,TGO,Ireland,IRL,0,0,10,0,10
2010,Uganda,UGA,Ireland,IRL,0,0,15,0,15
2010,Ukraine,UKR,Ireland,IRL,0,0,10,0,10
2010,Zimbabwe,ZWE,Ireland,IRL,0,0,34,16,50
2010,Sudan,SDN,Israel,ISR,5,0,0,0,5
2010,Stateless,XXA,Israel,ISR,5,0,0,0,5
2010,Afghanistan,AFG,Italy,ITA,176,480,68,0,724
2010,Albania,ALB,Italy,ITA,0,10,23,0,33
2010,Algeria,DZA,Italy,ITA,0,0,77,0,77
2010,Egypt,EGY,Italy,ITA,5,0,26,0,31
2010,Armenia,ARM,Italy,ITA,5,0,20,0,25
2010,Azerbaijan,AZE,Italy,ITA,5,0,5,0,10
2010,Burundi,BDI,Italy,ITA,0,0,5,0,5
2010,Benin,BEN,Italy,ITA,0,0,5,0,5
2010,Bangladesh,BGD,Italy,ITA,5,5,178,0,188
2010,Burkina Faso,BFA,Italy,ITA,10,10,132,0,152
2010,Belarus,BLR,Italy,ITA,0,0,5,0,5
2010,Brazil,BRA,Italy,ITA,0,0,16,0,16
2010,Bosnia and Herzegovina,BIH,Italy,ITA,18,0,490,0,508
2010,Chad,TCD,Italy,ITA,0,0,5,0,5
2010,China,CHN,Italy,ITA,10,0,18,0,28
2010,Chile,CHL,Italy,ITA,0,0,5,0,5
2010,Cameroon,CMR,Italy,ITA,19,5,36,0,60
2010,Congo,COG,Italy,ITA,15,5,11,0,31
2010,Dem. Rep. of the Congo,COD,Italy,ITA,15,10,25,0,50
2010,Colombia,COL,Italy,ITA,27,0,24,0,51
2010,Cuba,CUB,Italy,ITA,5,5,24,0,34
2010,Dominican Rep.,DOM,Italy,ITA,0,0,5,0,5
2010,Ecuador,ECU,Italy,ITA,0,0,12,0,12
2010,Eritrea,ERI,Italy,ITA,347,145,78,0,570
2010,Ethiopia,ETH,Italy,ITA,13,5,13,0,31
2010,Gabon,GAB,Italy,ITA,0,0,5,0,5
2010,Gambia,GMB,Italy,ITA,5,5,82,0,92
2010,Palestinian,PSE,Italy,ITA,101,16,21,0,138
2010,Georgia,GEO,Italy,ITA,5,5,50,0,60
2010,Ghana,GHA,Italy,ITA,5,0,505,0,510
2010,Guinea-Bissau,GNB,Italy,ITA,0,0,13,0,13
2010,Guinea,GIN,Italy,ITA,26,17,129,0,172
2010,Honduras,HND,Italy,ITA,5,0,5,0,10
2010,Croatia,HRV,Italy,ITA,0,0,44,0,44
2010,Cote d'Ivoire,CIV,Italy,ITA,14,62,202,0,278
2010,India,IND,Italy,ITA,5,0,61,0,66
2010,Iran (Islamic Rep. of),IRN,Italy,ITA,157,23,27,0,207
2010,Iraq,IRQ,Italy,ITA,105,154,69,0,328
2010,Kenya,KEN,Italy,ITA,5,5,43,0,53
2010,Liberia,LBR,Italy,ITA,0,0,67,0,67
2010,Lebanon,LBN,Italy,ITA,20,0,24,0,44
2010,Sri Lanka,LKA,Italy,ITA,14,25,42,0,81
2010,Mauritania,MRT,Italy,ITA,11,5,20,0,36
2010,North Macedonia,MKD,Italy,ITA,0,0,102,0,102
2010,Rep. of Moldova,MDA,Italy,ITA,0,0,10,0,10
2010,Mali,MLI,Italy,ITA,5,0,66,0,71
2010,Mongolia,MNG,Italy,ITA,0,0,5,0,5
2010,Morocco,MAR,Italy,ITA,5,5,79,0,89
2010,Montenegro,MNE,Italy,ITA,0,0,182,0,182
2010,Myanmar,MMR,Italy,ITA,5,0,0,0,5
2010,Nepal,NPL,Italy,ITA,0,0,5,0,5
2010,Niger,NER,Italy,ITA,0,0,21,0,21
2010,Nigeria,NGA,Italy,ITA,20,27,1627,0,1674
2010,Pakistan,PAK,Italy,ITA,44,192,437,0,673
2010,Peru,PER,Italy,ITA,0,0,5,0,5
2010,Russian Federation,RUS,Italy,ITA,5,5,16,0,26
2010,El Salvador,SLV,Italy,ITA,0,5,24,0,29
2010,Serbia and Kosovo: S/RES/1244 (1999),SRB,Italy,ITA,12,23,731,0,766
2010,Senegal,SEN,Italy,ITA,12,10,99,0,121
2010,Sierra Leone,SLE,Italy,ITA,5,5,27,0,37
2010,Somalia,SOM,Italy,ITA,41,86,10,0,137
2010,Sudan,SDN,Italy,ITA,10,10,31,0,51
2010,Syrian Arab Rep.,SYR,Italy,ITA,24,0,29,0,53
2010,Togo,TGO,Italy,ITA,21,5,93,0,119
2010,Tunisia,TUN,Italy,ITA,0,0,117,0,117
2010,Turkey,TUR,Italy,ITA,147,60,351,0,558
2010,Uganda,UGA,Italy,ITA,5,0,12,0,17
2010,Ukraine,UKR,Italy,ITA,0,0,16,0,16
2010,Yemen,YEM,Italy,ITA,5,0,0,0,5
2010,Zimbabwe,ZWE,Italy,ITA,0,5,11,0,16
2010,Stateless,XXA,Italy,ITA,0,0,5,0,5
2010,Afghanistan,AFG,Japan,JPN,0,0,0,5,5
2010,Bangladesh,BGD,Japan,JPN,0,5,33,5,43
2010,China,CHN,Japan,JPN,0,11,10,5,26
2010,Cameroon,CMR,Japan,JPN,0,0,22,0,22
2010,Dem. Rep. of the Congo,COD,Japan,JPN,0,0,23,0,23
2010,Ethiopia,ETH,Japan,JPN,0,5,29,5,39
2010,Ghana,GHA,Japan,JPN,0,0,5,0,5
2010,Guinea,GIN,Japan,JPN,0,0,5,0,5
2010,India,IND,Japan,JPN,0,0,57,5,62
2010,Iran (Islamic Rep. of),IRN,Japan,JPN,0,5,22,5,32
2010,Iraq,IRQ,Japan,JPN,0,0,5,0,5
2010,Israel,ISR,Japan,JPN,0,0,0,5,5
2010,Kenya,KEN,Japan,JPN,0,0,5,0,5
2010,Sri Lanka,LKA,Japan,JPN,0,5,168,28,201
2010,Myanmar,MMR,Japan,JPN,24,287,385,10,706
2010,Nepal,NPL,Japan,JPN,0,0,31,0,31
2010,Nigeria,NGA,Japan,JPN,0,0,18,0,18
2010,Pakistan,PAK,Japan,JPN,0,0,48,10,58
2010,Peru,PER,Japan,JPN,0,5,0,0,5
2010,Philippines,PHL,Japan,JPN,0,0,5,0,5
2010,Russian Federation,RUS,Japan,JPN,0,0,5,0,5
2010,United Rep. of Tanzania,TZA,Japan,JPN,0,0,5,0,5
2010,Turkey,TUR,Japan,JPN,0,0,79,10,89
2010,Uganda,UGA,Japan,JPN,0,0,25,5,30
2010,Afghanistan,AFG,Kyrgyzstan,KGZ,0,0,5,0,5
2010,Iran (Islamic Rep. of),IRN,Kyrgyzstan,KGZ,0,0,0,5,5
2010,Kazakhstan,KAZ,Kyrgyzstan,KGZ,0,0,19,0,19
2010,Russian Federation,RUS,Kyrgyzstan,KGZ,0,0,0,26,26
2010,Uzbekistan,UZB,Kyrgyzstan,KGZ,0,0,0,143,143
2010,Afghanistan,AFG,Lithuania,LTU,0,10,5,13,28
2010,Armenia,ARM,Lithuania,LTU,0,0,5,16,21
2010,Azerbaijan,AZE,Lithuania,LTU,0,0,5,0,5
2010,Belarus,BLR,Lithuania,LTU,0,0,0,11,11
2010,Georgia,GEO,Lithuania,LTU,0,0,104,115,219
2010,Sri Lanka,LKA,Lithuania,LTU,0,0,5,11,16
2010,Pakistan,PAK,Lithuania,LTU,0,0,0,5,5
2010,Russian Federation,RUS,Lithuania,LTU,0,5,20,5,30
2010,Viet Nam,VNM,Lithuania,LTU,0,0,12,0,12
2010,Stateless,XXA,Lithuania,LTU,0,0,0,5,5
2010,Afghanistan,AFG,Luxembourg,LUX,0,0,5,5,10
2010,Albania,ALB,Luxembourg,LUX,0,0,5,0,5
2010,Algeria,DZA,Luxembourg,LUX,0,0,5,13,18
2010,Armenia,ARM,Luxembourg,LUX,0,0,0,5,5
2010,Azerbaijan,AZE,Luxembourg,LUX,0,0,10,0,10
2010,Benin,BEN,Luxembourg,LUX,0,0,5,0,5
2010,Belarus,BLR,Luxembourg,LUX,0,0,5,11,16
2010,Bosnia and Herzegovina,BIH,Luxembourg,LUX,0,0,12,11,23
2010,Dem. Rep. of the Congo,COD,Luxembourg,LUX,10,0,5,0,15
2010,Eritrea,ERI,Luxembourg,LUX,0,0,0,5,5
2010,Ethiopia,ETH,Luxembourg,LUX,5,0,0,0,5
2010,Gambia,GMB,Luxembourg,LUX,0,0,5,0,5
2010,Georgia,GEO,Luxembourg,LUX,0,0,0,5,5
2010,Guinea,GIN,Luxembourg,LUX,0,0,0,5,5
2010,Cote d'Ivoire,CIV,Luxembourg,LUX,5,0,0,0,5
2010,Iran (Islamic Rep. of),IRN,Luxembourg,LUX,14,0,18,11,43
2010,Iraq,IRQ,Luxembourg,LUX,11,0,5,32,48
2010,Rep. of Moldova,MDA,Luxembourg,LUX,0,0,0,5,5
2010,Morocco,MAR,Luxembourg,LUX,0,0,0,5,5
2010,Nigeria,NGA,Luxembourg,LUX,0,0,0,5,5
2010,Russian Federation,RUS,Luxembourg,LUX,5,0,0,15,20
2010,Serbia and Kosovo: S/RES/1244 (1999),SRB,Luxembourg,LUX,5,0,147,39,191
2010,Somalia,SOM,Luxembourg,LUX,0,13,0,5,18
2010,Sudan,SDN,Luxembourg,LUX,0,0,5,0,5
2010,Togo,TGO,Luxembourg,LUX,0,0,5,0,5
2010,Turkey,TUR,Luxembourg,LUX,0,0,0,5,5
2010,Ukraine,UKR,Luxembourg,LUX,0,0,0,5,5
2010,Afghanistan,AFG,Latvia,LVA,0,16,5,0,21
2010,Georgia,GEO,Latvia,LVA,0,0,11,0,11
2010,Russian Federation,RUS,Latvia,LVA,0,0,0,5,5
2010,Uzbekistan,UZB,Latvia,LVA,5,0,5,0,10
2010,India,IND,"China, Macao SAR",MAC,0,0,5,0,5
2010,Syrian Arab Rep.,SYR,"China, Macao SAR",MAC,0,0,5,0,5
2010,Bangladesh,BGD,Mexico,MEX,0,0,5,0,5
2010,Brazil,BRA,Mexico,MEX,0,0,0,5,5
2010,China,CHN,Mexico,MEX,0,0,5,14,19
2010,Colombia,COL,Mexico,MEX,39,0,25,15,79
2010,Cuba,CUB,Mexico,MEX,5,0,17,20,42
2010,Dominican Rep.,DOM,Mexico,MEX,5,0,0,11,16
2010,Ghana,GHA,Mexico,MEX,0,0,5,0,5
2010,Guatemala,GTM,Mexico,MEX,10,0,10,16,36
2010,Guinea,GIN,Mexico,MEX,5,0,0,0,5
2010,Haiti,HTI,Mexico,MEX,5,0,16,26,47
2010,Honduras,HND,Mexico,MEX,21,0,27,80,128
2010,India,IND,Mexico,MEX,5,0,61,204,270
2010,Iran (Islamic Rep. of),IRN,Mexico,MEX,10,0,0,0,10
2010,Iraq,IRQ,Mexico,MEX,5,0,0,0,5
2010,Jamaica,JAM,Mexico,MEX,0,0,5,0,5
2010,Sri Lanka,LKA,Mexico,MEX,28,0,10,10,48
2010,Nepal,NPL,Mexico,MEX,14,0,5,0,19
2010,Nicaragua,NIC,Mexico,MEX,0,0,14,0,14
2010,Nigeria,NGA,Mexico,MEX,14,0,5,0,19
2010,Pakistan,PAK,Mexico,MEX,0,0,0,10,10
2010,South Africa,ZAF,Mexico,MEX,0,0,5,0,5
2010,El Salvador,SLV,Mexico,MEX,58,0,23,65,146
2010,United States of America,USA,Mexico,MEX,0,0,5,0,5
2010,Venezuela (Bolivarian Republic of),VEN,Mexico,MEX,5,0,0,0,5
2010,Burundi,BDI,Mali,MLI,5,0,0,0,5
2010,Chad,TCD,Mali,MLI,5,0,0,0,5
2010,Dem. Rep. of the Congo,COD,Mali,MLI,5,0,0,0,5
2010,Guinea,GIN,Mali,MLI,5,0,0,0,5
2010,Cote d'Ivoire,CIV,Mali,MLI,0,0,0,12,12
2010,Rwanda,RWA,Mali,MLI,5,0,0,0,5
2010,Togo,TGO,Mali,MLI,5,0,0,0,5
2010,Burundi,BDI,Malawi,MWI,61,0,0,73,134
2010,Dem. Rep. of the Congo,COD,Malawi,MWI,408,0,0,113,521
2010,Ethiopia,ETH,Malawi,MWI,0,0,0,5,5
2010,Rwanda,RWA,Malawi,MWI,34,0,0,129,163
2010,Somalia,SOM,Malawi,MWI,20,0,0,0,20
2010,Burundi,BDI,Mozambique,MOZ,107,0,32,11,150
2010,Congo,COG,Mozambique,MOZ,0,0,5,0,5
2010,Dem. Rep. of the Congo,COD,Mozambique,MOZ,474,0,64,40,578
2010,Cote d'Ivoire,CIV,Mozambique,MOZ,0,0,5,0,5
2010,Rwanda,RWA,Mozambique,MOZ,75,0,20,52,147
2010,Somalia,SOM,Mozambique,MOZ,0,0,0,14,14
2010,Armenia,ARM,Malta,MLT,0,0,5,0,5
2010,Bangladesh,BGD,Malta,MLT,5,0,0,0,5
2010,China,CHN,Malta,MLT,5,0,0,0,5
2010,Eritrea,ERI,Malta,MLT,5,79,5,0,89
2010,Ethiopia,ETH,Malta,MLT,0,10,15,5,30
2010,Palestinian,PSE,Malta,MLT,0,0,5,0,5
2010,Cote d'Ivoire,CIV,Malta,MLT,0,0,5,0,5
2010,Iraq,IRQ,Malta,MLT,5,0,5,0,10
2010,Liberia,LBR,Malta,MLT,0,0,5,0,5
2010,Libya,LBY,Malta,MLT,10,0,0,0,10
2010,Morocco,MAR,Malta,MLT,0,0,5,0,5
2010,Nigeria,NGA,Malta,MLT,0,0,33,5,38
2010,Pakistan,PAK,Malta,MLT,5,0,11,0,16
2010,Somalia,SOM,Malta,MLT,5,74,0,0,79
2010,Sudan,SDN,Malta,MLT,0,0,5,0,5
2010,Syrian Arab Rep.,SYR,Malta,MLT,13,0,5,0,18
2010,Tunisia,TUN,Malta,MLT,0,5,0,0,5
2010,Turkey,TUR,Malta,MLT,0,0,5,0,5
2010,Burundi,BDI,Namibia,NAM,29,0,5,0,34
2010,Dem. Rep. of the Congo,COD,Namibia,NAM,88,0,74,0,162
2010,Rwanda,RWA,Namibia,NAM,5,0,0,0,5
2010,Sierra Leone,SLE,Namibia,NAM,0,0,0,19,19
2010,Zimbabwe,ZWE,Namibia,NAM,13,0,5,0,18
2010,Bhutan,BTN,Nepal,NPL,0,5,0,0,5
2010,Afghanistan,AFG,Netherlands,NLD,49,617,1241,0,1907
2010,Albania,ALB,Netherlands,NLD,0,0,16,0,16
2010,Algeria,DZA,Netherlands,NLD,0,0,31,0,31
2010,Angola,AGO,Netherlands,NLD,0,12,43,0,55
2010,Egypt,EGY,Netherlands,NLD,0,10,32,0,42
2010,Armenia,ARM,Netherlands,NLD,20,111,400,0,531
2010,Azerbaijan,AZE,Netherlands,NLD,10,46,95,0,151
2010,Burundi,BDI,Netherlands,NLD,5,27,34,0,66
2010,Benin,BEN,Netherlands,NLD,0,0,10,0,10
2010,Bangladesh,BGD,Netherlands,NLD,0,0,12,0,12
2010,Bhutan,BTN,Netherlands,NLD,5,43,0,0,48
2010,Burkina Faso,BFA,Netherlands,NLD,0,0,23,0,23
2010,Belarus,BLR,Netherlands,NLD,5,10,46,0,61
2010,Bosnia and Herzegovina,BIH,Netherlands,NLD,0,0,14,0,14
2010,Cambodia,KHM,Netherlands,NLD,0,12,0,0,12
2010,Chad,TCD,Netherlands,NLD,0,0,5,0,5
2010,China,CHN,Netherlands,NLD,61,134,163,0,358
2010,Cameroon,CMR,Netherlands,NLD,0,5,51,0,56
2010,Congo,COG,Netherlands,NLD,10,46,54,0,110
2010,Dem. Rep. of the Congo,COD,Netherlands,NLD,5,31,14,0,50
2010,Colombia,COL,Netherlands,NLD,0,5,10,0,15
2010,Cuba,CUB,Netherlands,NLD,5,0,5,0,10
2010,Ecuador,ECU,Netherlands,NLD,0,0,5,0,5
2010,Eritrea,ERI,Netherlands,NLD,36,268,276,0,580
2010,Ethiopia,ETH,Netherlands,NLD,15,15,84,0,114
2010,Gambia,GMB,Netherlands,NLD,0,5,15,0,20
2010,Palestinian,PSE,Netherlands,NLD,0,0,32,0,32
2010,Georgia,GEO,Netherlands,NLD,0,5,731,0,736
2010,Ghana,GHA,Netherlands,NLD,0,0,37,0,37
2010,Guinea,GIN,Netherlands,NLD,5,107,177,0,289
2010,Honduras,HND,Netherlands,NLD,5,0,0,0,5
2010,Croatia,HRV,Netherlands,NLD,0,0,5,0,5
2010,Cote d'Ivoire,CIV,Netherlands,NLD,5,64,78,0,147
2010,India,IND,Netherlands,NLD,0,0,13,0,13
2010,Indonesia,IDN,Netherlands,NLD,0,0,5,0,5
2010,Iran (Islamic Rep. of),IRN,Netherlands,NLD,179,247,406,0,832
2010,Iraq,IRQ,Netherlands,NLD,132,1091,1030,0,2253
2010,Israel,ISR,Netherlands,NLD,5,0,5,0,10
2010,Jamaica,JAM,Netherlands,NLD,0,0,14,0,14
2010,Jordan,JOR,Netherlands,NLD,5,0,0,0,5
2010,Kazakhstan,KAZ,Netherlands,NLD,0,12,20,0,32
2010,Kenya,KEN,Netherlands,NLD,0,0,14,0,14
2010,Kyrgyzstan,KGZ,Netherlands,NLD,0,0,5,0,5
2010,Dem. People's Rep. of Korea,PRK,Netherlands,NLD,0,5,5,0,10
2010,Lao People's Dem. Rep.,LAO,Netherlands,NLD,0,17,0,0,17
2010,Liberia,LBR,Netherlands,NLD,0,14,32,0,46
2010,Libya,LBY,Netherlands,NLD,5,50,113,0,168
2010,Lebanon,LBN,Netherlands,NLD,5,0,5,0,10
2010,Sri Lanka,LKA,Netherlands,NLD,22,90,125,0,237
2010,Mauritania,MRT,Netherlands,NLD,0,0,5,0,5
2010,North Macedonia,MKD,Netherlands,NLD,0,0,322,0,322
2010,Rep. of Moldova,MDA,Netherlands,NLD,0,0,5,0,5
2010,Mexico,MEX,Netherlands,NLD,0,0,5,0,5
2010,Mali,MLI,Netherlands,NLD,0,0,20,0,20
2010,Malawi,MWI,Netherlands,NLD,0,0,5,0,5
2010,Mongolia,MNG,Netherlands,NLD,0,5,254,0,259
2010,Morocco,MAR,Netherlands,NLD,0,0,18,0,18
2010,Myanmar,MMR,Netherlands,NLD,10,151,18,0,179
2010,Namibia,NAM,Netherlands,NLD,0,5,0,0,5
2010,Nepal,NPL,Netherlands,NLD,14,28,43,0,85
2010,Niger,NER,Netherlands,NLD,0,0,15,0,15
2010,Nigeria,NGA,Netherlands,NLD,0,11,144,0,155
2010,Pakistan,PAK,Netherlands,NLD,12,10,54,0,76
2010,Peru,PER,Netherlands,NLD,0,5,0,0,5
2010,South Africa,ZAF,Netherlands,NLD,0,0,5,0,5
2010,Russian Federation,RUS,Netherlands,NLD,0,10,185,0,195
2010,Rwanda,RWA,Netherlands,NLD,0,10,12,0,22
2010,Serbia and Kosovo: S/RES/1244 (1999),SRB,Netherlands,NLD,0,0,124,0,124
2010,Senegal,SEN,Netherlands,NLD,5,0,11,0,16
2010,Sierra Leone,SLE,Netherlands,NLD,0,63,73,0,136
2010,Somalia,SOM,Netherlands,NLD,97,3391,1841,0,5329
2010,Viet Nam,VNM,Netherlands,NLD,0,0,10,0,10
2010,Sudan,SDN,Netherlands,NLD,14,47,103,0,164
2010,Syrian Arab Rep.,SYR,Netherlands,NLD,10,36,93,0,139
2010,United Rep. of Tanzania,TZA,Netherlands,NLD,0,0,10,0,10
2010,Tajikistan,TJK,Netherlands,NLD,0,5,11,0,16
2010,Togo,TGO,Netherlands,NLD,0,5,26,0,31
2010,Tunisia,TUN,Netherlands,NLD,0,0,10,0,10
2010,Turkey,TUR,Netherlands,NLD,5,14,59,0,78
2010,Uganda,UGA,Netherlands,NLD,18,29,45,0,92
2010,Ukraine,UKR,Netherlands,NLD,0,5,27,0,32
2010,United States of America,USA,Netherlands,NLD,0,0,5,0,5
2010,Uzbekistan,UZB,Netherlands,NLD,5,11,10,0,26
2010,Venezuela (Bolivarian Republic of),VEN,Netherlands,NLD,0,0,5,0,5
2010,Yemen,YEM,Netherlands,NLD,0,0,18,0,18
2010,Zimbabwe,ZWE,Netherlands,NLD,0,0,14,0,14
2010,Stateless,XXA,Netherlands,NLD,10,31,68,0,109
2010,Chad,TCD,Niger,NER,0,0,0,18,18
2010,Dem. Rep. of the Congo,COD,Niger,NER,0,0,0,11,11
2010,Bangladesh,BGD,Nicaragua,NIC,5,0,0,5,10
2010,Eritrea,ERI,Nicaragua,NIC,10,0,0,35,45
2010,Honduras,HND,Nicaragua,NIC,5,0,0,0,5
2010,Nepal,NPL,Nicaragua,NIC,0,0,0,13,13
2010,El Salvador,SLV,Nicaragua,NIC,5,0,0,0,5
2010,Somalia,SOM,Nicaragua,NIC,14,0,0,12,26
2010,Dem. Rep. of the Congo,COD,Nigeria,NGA,55,0,91,51,197
2010,Guinea,GIN,Nigeria,NGA,10,0,0,0,10
2010,Sierra Leone,SLE,Nigeria,NGA,0,0,12,5,17
2010,Afghanistan,AFG,Norway,NOR,247,785,1483,352,2867
2010,Albania,ALB,Norway,NOR,0,0,16,10,26
2010,Algeria,DZA,Norway,NOR,0,0,85,92,177
2010,Angola,AGO,Norway,NOR,0,5,18,0,23
2010,Egypt,EGY,Norway,NOR,5,0,20,5,30
2010,Armenia,ARM,Norway,NOR,0,0,17,11,28
2010,Azerbaijan,AZE,Norway,NOR,5,0,36,13,54
2010,Burundi,BDI,Norway,NOR,5,0,17,17,39
2010,Bangladesh,BGD,Norway,NOR,0,0,12,5,17
2010,Bhutan,BTN,Norway,NOR,5,0,5,0,10
2010,Burkina Faso,BFA,Norway,NOR,0,0,5,5,10
2010,Belarus,BLR,Norway,NOR,0,0,5,27,32
2010,Brazil,BRA,Norway,NOR,0,0,5,0,5
2010,Bosnia and Herzegovina,BIH,Norway,NOR,0,0,12,10,22
2010,Bulgaria,BGR,Norway,NOR,0,0,5,0,5
2010,Chad,TCD,Norway,NOR,0,0,0,5,5
2010,China,CHN,Norway,NOR,99,0,13,10,122
2010,Cameroon,CMR,Norway,NOR,5,5,23,15,48
2010,Dem. Rep. of the Congo,COD,Norway,NOR,26,14,83,12,135
2010,Colombia,COL,Norway,NOR,0,0,10,5,15
2010,Cuba,CUB,Norway,NOR,0,0,0,5,5
2010,Equatorial Guinea,GNQ,Norway,NOR,0,0,5,0,5
2010,Eritrea,ERI,Norway,NOR,1100,503,470,351,2424
2010,Ethiopia,ETH,Norway,NOR,150,31,314,71,566
2010,Gambia,GMB,Norway,NOR,0,0,43,21,64
2010,Georgia,GEO,Norway,NOR,0,0,37,68,105
2010,Germany,DEU,Norway,NOR,0,0,0,5,5
2010,Ghana,GHA,Norway,NOR,0,0,51,33,84
2010,Guinea-Bissau,GNB,Norway,NOR,0,0,14,5,19
2010,Guinea,GIN,Norway,NOR,0,0,43,18,61
2010,Croatia,HRV,Norway,NOR,0,0,12,0,12
2010,Cote d'Ivoire,CIV,Norway,NOR,0,0,33,12,45
2010,India,IND,Norway,NOR,0,0,58,18,76
2010,Indonesia,IDN,Norway,NOR,5,0,0,0,5
2010,Iran (Islamic Rep. of),IRN,Norway,NOR,120,14,466,92,692
2010,Iraq,IRQ,Norway,NOR,137,245,744,291,1417
2010,Israel,ISR,Norway,NOR,0,0,15,5,20
2010,Italy,ITA,Norway,NOR,0,0,0,5,5
2010,Jordan,JOR,Norway,NOR,0,0,30,5,35
2010,Kazakhstan,KAZ,Norway,NOR,0,0,15,13,28
2010,Kenya,KEN,Norway,NOR,0,0,22,0,22
2010,Kyrgyzstan,KGZ,Norway,NOR,0,0,22,10,32
2010,Rep. of Korea,KOR,Norway,NOR,0,0,0,5,5
2010,Liberia,LBR,Norway,NOR,5,0,41,19,65
2010,Libya,LBY,Norway,NOR,0,5,29,36,70
2010,Lebanon,LBN,Norway,NOR,0,0,32,17,49
2010,Sri Lanka,LKA,Norway,NOR,5,26,155,14,200
2010,Mauritania,MRT,Norway,NOR,0,0,38,5,43
2010,North Macedonia,MKD,Norway,NOR,0,0,98,5,103
2010,Rep. of Moldova,MDA,Norway,NOR,0,0,5,0,5
2010,Mexico,MEX,Norway,NOR,0,0,12,0,12
2010,Mali,MLI,Norway,NOR,0,0,5,5,10
2010,Mongolia,MNG,Norway,NOR,0,0,11,0,11
2010,Morocco,MAR,Norway,NOR,5,5,48,51,109
2010,Montenegro,MNE,Norway,NOR,0,0,10,0,10
2010,Myanmar,MMR,Norway,NOR,42,15,10,5,72
2010,Nepal,NPL,Norway,NOR,0,0,26,5,31
2010,Niger,NER,Norway,NOR,0,0,20,5,25
2010,Nigeria,NGA,Norway,NOR,0,10,343,208,561
2010,Pakistan,PAK,Norway,NOR,0,5,91,56,152
2010,Philippines,PHL,Norway,NOR,0,0,5,0,5
2010,Romania,ROU,Norway,NOR,0,0,17,5,22
2010,South Africa,ZAF,Norway,NOR,0,0,0,5,5
2010,Russian Federation,RUS,Norway,NOR,22,14,533,231,800
2010,Rwanda,RWA,Norway,NOR,12,0,16,5,33
2010,Serbia and Kosovo: S/RES/1244 (1999),SRB,Norway,NOR,0,5,355,134,494
2010,Senegal,SEN,Norway,NOR,0,0,26,15,41
2010,Sierra Leone,SLE,Norway,NOR,0,0,15,15,30
2010,Somalia,SOM,Norway,NOR,705,541,260,496,2002
2010,Viet Nam,VNM,Norway,NOR,5,0,15,5,25
2010,Sudan,SDN,Norway,NOR,118,0,24,65,207
2010,Syrian Arab Rep.,SYR,Norway,NOR,23,14,156,51,244
2010,United Rep. of Tanzania,TZA,Norway,NOR,0,0,0,5,5
2010,Tajikistan,TJK,Norway,NOR,0,0,26,17,43
2010,Togo,TGO,Norway,NOR,0,0,0,13,13
2010,Tunisia,TUN,Norway,NOR,0,0,18,19,37
2010,Turkey,TUR,Norway,NOR,5,0,52,31,88
2010,Uganda,UGA,Norway,NOR,0,0,22,15,37
2010,Ukraine,UKR,Norway,NOR,0,0,0,14,14
2010,Uzbekistan,UZB,Norway,NOR,0,5,134,13,152
2010,Venezuela (Bolivarian Republic of),VEN,Norway,NOR,0,0,0,5,5
2010,Yemen,YEM,Norway,NOR,20,5,74,14,113
2010,Zambia,ZMB,Norway,NOR,0,0,5,0,5
2010,Zimbabwe,ZWE,Norway,NOR,0,0,44,5,49
2010,Stateless,XXA,Norway,NOR,94,100,600,226,1020
2010,Afghanistan,AFG,New Zealand,NZL,0,0,5,0,5
2010,Egypt,EGY,New Zealand,NZL,0,0,10,0,10
2010,Brazil,BRA,New Zealand,NZL,0,0,5,0,5
2010,China,CHN,New Zealand,NZL,10,0,12,0,22
2010,Colombia,COL,New Zealand,NZL,0,0,5,0,5
2010,Czechia,CZE,New Zealand,NZL,0,0,5,0,5
2010,Fiji,FJI,New Zealand,NZL,0,0,74,0,74
2010,Palestinian,PSE,New Zealand,NZL,5,0,0,0,5
2010,Indonesia,IDN,New Zealand,NZL,0,0,5,0,5
2010,Iran (Islamic Rep. of),IRN,New Zealand,NZL,5,0,20,0,25
2010,Iraq,IRQ,New Zealand,NZL,10,0,5,0,15
2010,Sri Lanka,LKA,New Zealand,NZL,5,0,26,0,31
2010,Madagascar,MDG,New Zealand,NZL,5,0,0,0,5
2010,Nepal,NPL,New Zealand,NZL,0,0,5,0,5
2010,Pakistan,PAK,New Zealand,NZL,5,0,12,0,17
2010,South Africa,ZAF,New Zealand,NZL,0,0,14,0,14
2010,Saudi Arabia,SAU,New Zealand,NZL,5,0,5,0,10
2010,Somalia,SOM,New Zealand,NZL,0,0,5,0,5
2010,Slovakia,SVK,New Zealand,NZL,0,0,12,0,12
2010,Turkey,TUR,New Zealand,NZL,0,0,5,0,5
2010,Zimbabwe,ZWE,New Zealand,NZL,5,0,0,0,5
2010,Belarus,BLR,Panama,PAN,5,0,0,0,5
2010,Colombia,COL,Panama,PAN,89,0,122,626,837
2010,Cuba,CUB,Panama,PAN,0,0,5,27,32
2010,Somalia,SOM,Panama,PAN,0,0,5,0,5
2010,Venezuela (Bolivarian Republic of),VEN,Panama,PAN,0,0,0,14,14
2010,Zimbabwe,ZWE,Panama,PAN,0,0,0,5,5
2010,Colombia,COL,Paraguay,PRY,0,0,0,5,5
2010,Cuba,CUB,Paraguay,PRY,5,0,0,0,5
2010,Colombia,COL,Peru,PER,33,0,0,214,247
2010,Cuba,CUB,Peru,PER,0,0,20,100,120
2010,Dominican Rep.,DOM,Peru,PER,0,0,5,0,5
2010,Ecuador,ECU,Peru,PER,0,0,5,0,5
2010,Haiti,HTI,Peru,PER,0,5,0,0,5
2010,Afghanistan,AFG,Poland,POL,0,14,0,0,14
2010,Armenia,ARM,Poland,POL,0,0,26,21,47
2010,Belarus,BLR,Poland,POL,20,0,5,5,30
2010,Congo,COG,Poland,POL,5,0,0,0,5
2010,Colombia,COL,Poland,POL,0,0,0,5,5
2010,Palestinian,PSE,Poland,POL,0,5,0,0,5
2010,Georgia,GEO,Poland,POL,0,0,327,368,695
2010,Iran (Islamic Rep. of),IRN,Poland,POL,5,0,0,0,5
2010,Iraq,IRQ,Poland,POL,12,0,0,0,12
2010,Kazakhstan,KAZ,Poland,POL,0,0,0,13,13
2010,Kyrgyzstan,KGZ,Poland,POL,0,0,0,18,18
2010,Mongolia,MNG,Poland,POL,0,0,5,5,10
2010,Nepal,NPL,Poland,POL,5,0,0,0,5
2010,Russian Federation,RUS,Poland,POL,42,172,1197,2428,3839
2010,Viet Nam,VNM,Poland,POL,5,0,19,0,24
2010,Turkey,TUR,Poland,POL,0,0,0,5,5
2010,Ukraine,UKR,Poland,POL,0,5,11,13,29
2010,Stateless,XXA,Poland,POL,0,0,0,5,5
2010,Angola,AGO,Portugal,PRT,0,0,0,11,11
2010,Cameroon,CMR,Portugal,PRT,0,5,0,0,5
2010,Dem. Rep. of the Congo,COD,Portugal,PRT,0,0,0,5,5
2010,Colombia,COL,Portugal,PRT,0,13,0,5,18
2010,Cuba,CUB,Portugal,PRT,0,5,0,0,5
2010,Eritrea,ERI,Portugal,PRT,0,5,0,0,5
2010,Georgia,GEO,Portugal,PRT,0,0,0,5,5
2010,Guinea-Bissau,GNB,Portugal,PRT,0,0,0,5,5
2010,Guinea,GIN,Portugal,PRT,0,13,0,31,44
2010,Iran (Islamic Rep. of),IRN,Portugal,PRT,5,0,0,0,5
2010,Sri Lanka,LKA,Portugal,PRT,0,5,0,0,5
2010,Mauritania,MRT,Portugal,PRT,0,0,0,5,5
2010,Nigeria,NGA,Portugal,PRT,0,5,0,5,10
2010,Senegal,SEN,Portugal,PRT,0,0,0,5,5
2010,Sierra Leone,SLE,Portugal,PRT,0,0,0,5,5
2010,Afghanistan,AFG,South Africa,ZAF,0,0,5,0,5
2010,Algeria,DZA,South Africa,ZAF,0,0,55,0,55
2010,Angola,AGO,South Africa,ZAF,50,0,27,0,77
2010,Egypt,EGY,South Africa,ZAF,0,0,151,0,151
2010,Burundi,BDI,South Africa,ZAF,144,0,351,0,495
2010,Benin,BEN,South Africa,ZAF,0,0,31,0,31
2010,Bangladesh,BGD,South Africa,ZAF,44,0,4433,0,4477
2010,Bahamas,BHS,South Africa,ZAF,0,0,10,0,10
2010,Burkina Faso,BFA,South Africa,ZAF,0,0,13,0,13
2010,China,CHN,South Africa,ZAF,0,0,2203,0,2203
2010,Cameroon,CMR,South Africa,ZAF,22,0,593,0,615
2010,Congo,COG,South Africa,ZAF,266,0,1560,0,1826
2010,Dem. Rep. of the Congo,COD,South Africa,ZAF,1317,0,2708,0,4025
2010,Comoros,COM,South Africa,ZAF,0,0,5,0,5
2010,Eritrea,ERI,South Africa,ZAF,169,0,53,0,222
2010,Ethiopia,ETH,South Africa,ZAF,1893,0,4435,0,6328
2010,Gabon,GAB,South Africa,ZAF,0,0,5,0,5
2010,Gambia,GMB,South Africa,ZAF,0,0,5,0,5
2010,Palestinian,PSE,South Africa,ZAF,5,0,0,0,5
2010,Ghana,GHA,South Africa,ZAF,0,0,1246,0,1246
2010,Guinea-Bissau,GNB,South Africa,ZAF,0,0,10,0,10
2010,Guinea,GIN,South Africa,ZAF,0,0,17,0,17
2010,Cote d'Ivoire,CIV,South Africa,ZAF,5,0,45,0,50
2010,India,IND,South Africa,ZAF,5,0,1325,0,1330
2010,Kenya,KEN,South Africa,ZAF,16,0,348,0,364
2010,Liberia,LBR,South Africa,ZAF,0,0,25,0,25
2010,Lesotho,LSO,South Africa,ZAF,0,0,337,0,337
2010,Sri Lanka,LKA,South Africa,ZAF,0,0,24,0,24
2010,Mauritania,MRT,South Africa,ZAF,0,0,5,0,5
2010,Mali,MLI,South Africa,ZAF,0,0,34,0,34
2010,Malawi,MWI,South Africa,ZAF,0,0,2272,0,2272
2010,Morocco,MAR,South Africa,ZAF,0,0,5,0,5
2010,Mozambique,MOZ,South Africa,ZAF,0,0,1165,0,1165
2010,Namibia,NAM,South Africa,ZAF,0,0,5,0,5
2010,Nepal,NPL,South Africa,ZAF,0,0,10,0,10
2010,Niger,NER,South Africa,ZAF,0,0,111,0,111
2010,Nigeria,NGA,South Africa,ZAF,0,0,2932,0,2932
2010,Pakistan,PAK,South Africa,ZAF,5,0,4362,0,4367
2010,South Africa,ZAF,South Africa,ZAF,0,0,5,0,5
2010,Rwanda,RWA,South Africa,ZAF,92,0,91,0,183
2010,Serbia and Kosovo: S/RES/1244 (1999),SRB,South Africa,ZAF,0,0,5,0,5
2010,Senegal,SEN,South Africa,ZAF,0,0,95,0,95
2010,Sierra Leone,SLE,South Africa,ZAF,0,0,10,0,10
2010,Solomon Islands,SLB,South Africa,ZAF,5,0,0,0,5
2010,Somalia,SOM,South Africa,ZAF,5563,0,1060,0,6623
2010,Sudan,SDN,South Africa,ZAF,0,0,13,0,13
2010,Eswatini,SWZ,South Africa,ZAF,0,0,38,0,38
2010,United Rep. of Tanzania,TZA,South Africa,ZAF,0,0,620,0,620
2010,Thailand,THA,South Africa,ZAF,0,0,36,0,36
2010,Togo,TGO,South Africa,ZAF,0,0,15,0,15
2010,Turkey,TUR,South Africa,ZAF,0,0,5,0,5
2010,Uganda,UGA,South Africa,ZAF,35,0,1147,0,1182
2010,United States of America,USA,South Africa,ZAF,0,0,5,0,5
2010,Yemen,YEM,South Africa,ZAF,5,0,0,0,5
2010,Zambia,ZMB,South Africa,ZAF,5,0,152,0,157
2010,Zimbabwe,ZWE,South Africa,ZAF,429,0,32750,0,33179
2010,Afghanistan,AFG,Russian Federation,RUS,74,0,796,0,870
2010,Angola,AGO,Russian Federation,RUS,0,0,5,0,5
2010,Egypt,EGY,Russian Federation,RUS,12,0,10,0,22
2010,Armenia,ARM,Russian Federation,RUS,0,0,5,0,5
2010,Azerbaijan,AZE,Russian Federation,RUS,0,0,16,0,16
2010,Belarus,BLR,Russian Federation,RUS,0,0,5,0,5
2010,Cambodia,KHM,Russian Federation,RUS,0,0,17,0,17
2010,China,CHN,Russian Federation,RUS,5,0,0,0,5
2010,Congo,COG,Russian Federation,RUS,0,0,10,0,10
2010,Dem. Rep. of the Congo,COD,Russian Federation,RUS,0,0,16,0,16
2010,Cuba,CUB,Russian Federation,RUS,0,0,10,0,10
2010,Eritrea,ERI,Russian Federation,RUS,0,0,5,0,5
2010,Ethiopia,ETH,Russian Federation,RUS,0,0,10,0,10
2010,Palestinian,PSE,Russian Federation,RUS,0,0,10,0,10
2010,Georgia,GEO,Russian Federation,RUS,11,0,711,0,722
2010,Guinea,GIN,Russian Federation,RUS,0,0,5,0,5
2010,Iran (Islamic Rep. of),IRN,Russian Federation,RUS,0,0,14,0,14
2010,Iraq,IRQ,Russian Federation,RUS,0,0,5,0,5
2010,Kazakhstan,KAZ,Russian Federation,RUS,0,0,11,0,11
2010,Kyrgyzstan,KGZ,Russian Federation,RUS,5,0,159,0,164
2010,Dem. People's Rep. of Korea,PRK,Russian Federation,RUS,0,0,15,0,15
2010,Rep. of Moldova,MDA,Russian Federation,RUS,0,0,5,0,5
2010,Pakistan,PAK,Russian Federation,RUS,0,0,5,0,5
2010,Rwanda,RWA,Russian Federation,RUS,0,0,5,0,5
2010,Serbia and Kosovo: S/RES/1244 (1999),SRB,Russian Federation,RUS,5,0,0,0,5
2010,Somalia,SOM,Russian Federation,RUS,0,0,19,0,19
2010,Sudan,SDN,Russian Federation,RUS,0,0,5,0,5
2010,Syrian Arab Rep.,SYR,Russian Federation,RUS,0,0,5,0,5
2010,Tajikistan,TJK,Russian Federation,RUS,0,0,21,0,21
2010,Turkmenistan,TKM,Russian Federation,RUS,0,0,5,0,5
2010,Ukraine,UKR,Russian Federation,RUS,0,0,14,0,14
2010,Uzbekistan,UZB,Russian Federation,RUS,5,0,63,0,68
2010,Bangladesh,BGD,El Salvador,SLV,0,0,0,27,27
2010,Eritrea,ERI,El Salvador,SLV,0,0,0,15,15
2010,Honduras,HND,El Salvador,SLV,10,0,0,0,10
2010,Nepal,NPL,El Salvador,SLV,0,0,5,24,29
2010,Somalia,SOM,El Salvador,SLV,0,0,0,5,5
2010,Afghanistan,AFG,Serbia and Kosovo: S/RES/1244 (1999),SRB,0,0,60,5,65
2010,Algeria,DZA,Serbia and Kosovo: S/RES/1244 (1999),SRB,0,0,5,0,5
2010,Congo,COG,Serbia and Kosovo: S/RES/1244 (1999),SRB,0,0,5,0,5
2010,Comoros,COM,Serbia and Kosovo: S/RES/1244 (1999),SRB,0,0,0,5,5
2010,Palestinian,PSE,Serbia and Kosovo: S/RES/1244 (1999),SRB,0,0,37,0,37
2010,Iran (Islamic Rep. of),IRN,Serbia and Kosovo: S/RES/1244 (1999),SRB,0,0,5,0,5
2010,Iraq,IRQ,Serbia and Kosovo: S/RES/1244 (1999),SRB,0,0,13,0,13
2010,Morocco,MAR,Serbia and Kosovo: S/RES/1244 (1999),SRB,0,0,5,0,5
2010,Nigeria,NGA,Serbia and Kosovo: S/RES/1244 (1999),SRB,0,0,5,0,5
2010,Pakistan,PAK,Serbia and Kosovo: S/RES/1244 (1999),SRB,0,0,5,5,10
2010,Somalia,SOM,Serbia and Kosovo: S/RES/1244 (1999),SRB,0,0,19,0,19
2010,Tunisia,TUN,Serbia and Kosovo: S/RES/1244 (1999),SRB,0,0,10,0,10
2010,Guinea,GIN,Sierra Leone,SLE,0,0,0,5,5
2010,Afghanistan,AFG,Spain,ESP,5,15,0,10,30
2010,Algeria,DZA,Spain,ESP,15,0,145,0,160
2010,Angola,AGO,Spain,ESP,0,0,10,0,10
2010,Egypt,EGY,Spain,ESP,0,0,0,5,5
2010,Armenia,ARM,Spain,ESP,0,0,15,13,28
2010,Azerbaijan,AZE,Spain,ESP,0,0,14,0,14
2010,Benin,BEN,Spain,ESP,0,0,5,0,5
2010,Bangladesh,BGD,Spain,ESP,0,0,11,0,11
2010,Burkina Faso,BFA,Spain,ESP,0,0,5,0,5
2010,Belarus,BLR,Spain,ESP,0,0,5,0,5
2010,Bolivia (Plurinational State of),BOL,Spain,ESP,0,0,5,0,5
2010,Brazil,BRA,Spain,ESP,0,0,14,0,14
2010,Bosnia and Herzegovina,BIH,Spain,ESP,0,0,5,0,5
2010,Chad,TCD,Spain,ESP,0,0,15,0,15
2010,China,CHN,Spain,ESP,5,0,0,0,5
2010,Cameroon,CMR,Spain,ESP,0,0,104,5,109
2010,Dem. Rep. of the Congo,COD,Spain,ESP,5,5,52,0,62
2010,Colombia,COL,Spain,ESP,27,5,311,10,353
2010,Costa Rica,CRI,Spain,ESP,0,0,5,0,5
2010,Cuba,CUB,Spain,ESP,0,216,26,5,247
2010,Ecuador,ECU,Spain,ESP,0,0,5,0,5
2010,Equatorial Guinea,GNQ,Spain,ESP,0,5,13,0,18
2010,Eritrea,ERI,Spain,ESP,0,0,11,0,11
2010,Ethiopia,ETH,Spain,ESP,0,0,5,0,5
2010,Gambia,GMB,Spain,ESP,0,0,36,0,36
2010,Palestinian,PSE,Spain,ESP,72,18,5,5,100
2010,Georgia,GEO,Spain,ESP,0,0,47,11,58
2010,Ghana,GHA,Spain,ESP,0,0,5,0,5
2010,Guinea-Bissau,GNB,Spain,ESP,0,0,5,0,5
2010,Guatemala,GTM,Spain,ESP,0,0,13,0,13
2010,Guinea,GIN,Spain,ESP,0,0,43,0,43
2010,Haiti,HTI,Spain,ESP,0,5,0,0,5
2010,Honduras,HND,Spain,ESP,10,0,14,0,24
2010,Cote d'Ivoire,CIV,Spain,ESP,0,29,153,5,187
2010,India,IND,Spain,ESP,5,0,0,0,5
2010,Iran (Islamic Rep. of),IRN,Spain,ESP,5,0,10,10,25
2010,Iraq,IRQ,Spain,ESP,5,5,0,0,10
2010,Kazakhstan,KAZ,Spain,ESP,0,0,5,0,5
2010,Liberia,LBR,Spain,ESP,0,0,5,0,5
2010,Sri Lanka,LKA,Spain,ESP,0,15,0,5,20
2010,Mauritania,MRT,Spain,ESP,0,0,15,0,15
2010,North Macedonia,MKD,Spain,ESP,0,0,18,0,18
2010,Rep. of Moldova,MDA,Spain,ESP,0,0,5,0,5
2010,Mexico,MEX,Spain,ESP,5,0,16,0,21
2010,Mali,MLI,Spain,ESP,0,0,14,0,14
2010,Mongolia,MNG,Spain,ESP,0,0,16,0,16
2010,Morocco,MAR,Spain,ESP,0,5,49,5,59
2010,Niger,NER,Spain,ESP,0,0,10,0,10
2010,Nigeria,NGA,Spain,ESP,0,0,162,10,172
2010,Pakistan,PAK,Spain,ESP,39,0,14,0,53
2010,Panama,PAN,Spain,ESP,0,0,5,0,5
2010,Paraguay,PRY,Spain,ESP,0,0,5,0,5
2010,Russian Federation,RUS,Spain,ESP,18,0,36,5,59
2010,Rwanda,RWA,Spain,ESP,0,0,5,0,5
2010,El Salvador,SLV,Spain,ESP,0,0,35,0,35
2010,Serbia and Kosovo: S/RES/1244 (1999),SRB,Spain,ESP,0,0,5,0,5
2010,Senegal,SEN,Spain,ESP,0,0,10,0,10
2010,Sierra Leone,SLE,Spain,ESP,0,0,5,0,5
2010,Somalia,SOM,Spain,ESP,0,38,23,5,66
2010,Sudan,SDN,Spain,ESP,0,0,20,0,20
2010,Syrian Arab Rep.,SYR,Spain,ESP,5,0,20,0,25
2010,Turkmenistan,TKM,Spain,ESP,0,0,10,0,10
2010,Togo,TGO,Spain,ESP,5,0,5,0,10
2010,Uganda,UGA,Spain,ESP,0,0,11,0,11
2010,Ukraine,UKR,Spain,ESP,0,0,0,5,5
2010,United States of America,USA,Spain,ESP,0,0,5,0,5
2010,Uzbekistan,UZB,Spain,ESP,5,0,0,0,5
2010,Venezuela (Bolivarian Republic of),VEN,Spain,ESP,0,0,14,0,14
2010,Zimbabwe,ZWE,Spain,ESP,0,0,5,0,5
2010,Afghanistan,AFG,Slovakia,SVK,0,38,12,23,73
2010,Algeria,DZA,Slovakia,SVK,0,0,5,5,10
2010,Armenia,ARM,Slovakia,SVK,0,0,13,5,18
2010,Bangladesh,BGD,Slovakia,SVK,0,0,0,5,5
2010,China,CHN,Slovakia,SVK,0,0,14,15,29
2010,Palestinian,PSE,Slovakia,SVK,0,0,5,5,10
2010,Georgia,GEO,Slovakia,SVK,0,0,14,56,70
2010,India,IND,Slovakia,SVK,0,0,5,37,42
2010,Iran (Islamic Rep. of),IRN,Slovakia,SVK,13,0,0,0,13
2010,Iraq,IRQ,Slovakia,SVK,5,0,5,0,10
2010,Sri Lanka,LKA,Slovakia,SVK,0,0,0,10,10
2010,Rep. of Moldova,MDA,Slovakia,SVK,0,0,10,34,44
2010,Nigeria,NGA,Slovakia,SVK,0,0,5,5,10
2010,Pakistan,PAK,Slovakia,SVK,0,0,20,47,67
2010,Russian Federation,RUS,Slovakia,SVK,0,0,12,57,69
2010,Serbia and Kosovo: S/RES/1244 (1999),SRB,Slovakia,SVK,0,0,5,14,19
2010,Somalia,SOM,Slovakia,SVK,0,16,0,5,21
2010,Viet Nam,VNM,Slovakia,SVK,0,0,19,17,36
2010,Syrian Arab Rep.,SYR,Slovakia,SVK,5,0,0,0,5
2010,Turkey,TUR,Slovakia,SVK,0,0,0,5,5
2010,Ukraine,UKR,Slovakia,SVK,0,0,0,20,20
2010,Stateless,XXA,Slovakia,SVK,0,0,0,5,5
2010,Afghanistan,AFG,Slovenia,SVN,0,0,0,29,29
2010,Algeria,DZA,Slovenia,SVN,0,0,0,5,5
2010,Bosnia and Herzegovina,BIH,Slovenia,SVN,0,0,5,12,17
2010,Eritrea,ERI,Slovenia,SVN,0,0,0,5,5
2010,Palestinian,PSE,Slovenia,SVN,0,0,0,10,10
2010,Croatia,HRV,Slovenia,SVN,0,0,0,5,5
2010,Iran (Islamic Rep. of),IRN,Slovenia,SVN,0,0,0,5,5
2010,Iraq,IRQ,Slovenia,SVN,0,0,0,10,10
2010,Kazakhstan,KAZ,Slovenia,SVN,10,0,0,0,10
2010,Sri Lanka,LKA,Slovenia,SVN,0,0,0,5,5
2010,Morocco,MAR,Slovenia,SVN,0,0,0,5,5
2010,Nigeria,NGA,Slovenia,SVN,0,0,5,0,5
2010,Russian Federation,RUS,Slovenia,SVN,0,0,0,5,5
2010,Serbia and Kosovo: S/RES/1244 (1999),SRB,Slovenia,SVN,0,0,0,38,38
2010,Senegal,SEN,Slovenia,SVN,0,0,0,5,5
2010,Somalia,SOM,Slovenia,SVN,5,0,0,0,5
2010,Sudan,SDN,Slovenia,SVN,5,0,0,0,5
2010,Syrian Arab Rep.,SYR,Slovenia,SVN,0,0,0,5,5
2010,Tunisia,TUN,Slovenia,SVN,0,0,0,5,5
2010,Turkey,TUR,Slovenia,SVN,0,0,0,22,22
2010,Afghanistan,AFG,Sweden,SWE,162,884,413,51,1510
2010,Albania,ALB,Sweden,SWE,0,5,42,12,59
2010,Algeria,DZA,Sweden,SWE,0,0,89,44,133
2010,Angola,AGO,Sweden,SWE,0,0,33,0,33
2010,Egypt,EGY,Sweden,SWE,0,0,149,10,159
2010,Armenia,ARM,Sweden,SWE,0,35,186,13,234
2010,Azerbaijan,AZE,Sweden,SWE,0,51,325,38,414
2010,Burundi,BDI,Sweden,SWE,0,13,5,5,23
2010,Benin,BEN,Sweden,SWE,0,0,10,0,10
2010,Bangladesh,BGD,Sweden,SWE,5,20,86,0,111
2010,Belarus,BLR,Sweden,SWE,10,5,245,78,338
2010,Bolivia (Plurinational State of),BOL,Sweden,SWE,0,0,37,0,37
2010,Bosnia and Herzegovina,BIH,Sweden,SWE,0,16,83,15,114
2010,Bulgaria,BGR,Sweden,SWE,0,0,16,5,21
2010,Canada,CAN,Sweden,SWE,0,0,5,0,5
2010,China,CHN,Sweden,SWE,11,0,53,23,87
2010,Chile,CHL,Sweden,SWE,0,0,27,0,27
2010,Cameroon,CMR,Sweden,SWE,5,5,22,0,32
2010,Congo,COG,Sweden,SWE,0,0,0,13,13
2010,Dem. Rep. of the Congo,COD,Sweden,SWE,17,17,49,0,83
2010,Colombia,COL,Sweden,SWE,5,5,13,0,23
2010,Cuba,CUB,Sweden,SWE,0,10,21,5,36
2010,Djibouti,DJI,Sweden,SWE,0,0,5,0,5
2010,Ecuador,ECU,Sweden,SWE,0,0,13,0,13
2010,Eritrea,ERI,Sweden,SWE,156,745,73,38,1012
2010,Estonia,EST,Sweden,SWE,0,0,0,5,5
2010,Ethiopia,ETH,Sweden,SWE,40,17,133,5,195
2010,Gambia,GMB,Sweden,SWE,5,5,25,0,35
2010,United Kingdom of Great Britain and Northern Ireland,GBR,Sweden,SWE,0,5,0,0,5
2010,Georgia,GEO,Sweden,SWE,0,5,140,27,172
2010,Ghana,GHA,Sweden,SWE,5,0,22,5,32
2010,Guinea,GIN,Sweden,SWE,0,5,17,5,27
2010,Haiti,HTI,Sweden,SWE,0,0,5,0,5
2010,Honduras,HND,Sweden,SWE,0,0,11,0,11
2010,Croatia,HRV,Sweden,SWE,0,0,5,11,16
2010,Cote d'Ivoire,CIV,Sweden,SWE,0,5,14,0,19
2010,India,IND,Sweden,SWE,0,0,39,13,52
2010,Indonesia,IDN,Sweden,SWE,0,0,5,0,5
2010,Iran (Islamic Rep. of),IRN,Sweden,SWE,214,42,821,78,1155
2010,Iraq,IRQ,Sweden,SWE,569,324,774,179,1846
2010,Israel,ISR,Sweden,SWE,0,0,15,5,20
2010,Italy,ITA,Sweden,SWE,0,5,5,0,10
2010,Jordan,JOR,Sweden,SWE,5,5,82,23,115
2010,Kazakhstan,KAZ,Sweden,SWE,5,18,263,27,313
2010,Kenya,KEN,Sweden,SWE,5,5,77,5,92
2010,Kyrgyzstan,KGZ,Sweden,SWE,5,0,190,25,220
2010,Rep. of Korea,KOR,Sweden,SWE,5,0,0,5,10
2010,Dem. People's Rep. of Korea,PRK,Sweden,SWE,0,0,0,5,5
2010,Kuwait,KWT,Sweden,SWE,0,0,5,0,5
2010,Liberia,LBR,Sweden,SWE,0,0,10,0,10
2010,Libya,LBY,Sweden,SWE,5,10,219,56,290
2010,Lebanon,LBN,Sweden,SWE,0,21,106,26,153
2010,Sri Lanka,LKA,Sweden,SWE,0,5,27,5,37
2010,Lithuania,LTU,Sweden,SWE,0,0,13,0,13
2010,Latvia,LVA,Sweden,SWE,0,0,5,5,10
2010,Mauritania,MRT,Sweden,SWE,0,0,5,0,5
2010,North Macedonia,MKD,Sweden,SWE,0,5,598,65,668
2010,Rep. of Moldova,MDA,Sweden,SWE,0,0,10,10,20
2010,Mexico,MEX,Sweden,SWE,0,0,5,5,10
2010,Mali,MLI,Sweden,SWE,0,0,5,0,5
2010,Malawi,MWI,Sweden,SWE,0,0,0,5,5
2010,Mongolia,MNG,Sweden,SWE,0,18,547,33,598
2010,Morocco,MAR,Sweden,SWE,0,5,24,17,46
2010,Montenegro,MNE,Sweden,SWE,0,5,23,5,33
2010,Nepal,NPL,Sweden,SWE,5,0,11,0,16
2010,Nicaragua,NIC,Sweden,SWE,0,0,18,0,18
2010,Nigeria,NGA,Sweden,SWE,10,11,144,32,197
2010,Pakistan,PAK,Sweden,SWE,5,5,70,5,85
2010,Paraguay,PRY,Sweden,SWE,0,0,5,0,5
2010,Peru,PER,Sweden,SWE,0,0,14,5,19
2010,Romania,ROU,Sweden,SWE,0,12,13,0,25
2010,South Africa,ZAF,Sweden,SWE,0,0,5,0,5
2010,Russian Federation,RUS,Sweden,SWE,56,58,510,116,740
2010,Rwanda,RWA,Sweden,SWE,0,0,5,0,5
2010,El Salvador,SLV,Sweden,SWE,0,0,40,5,45
2010,Serbia and Kosovo: S/RES/1244 (1999),SRB,Sweden,SWE,0,123,5343,830,6296
2010,Senegal,SEN,Sweden,SWE,0,0,12,0,12
2010,Sierra Leone,SLE,Sweden,SWE,0,0,11,0,11
2010,Somalia,SOM,Sweden,SWE,464,4141,359,393,5357
2010,Spain,ESP,Sweden,SWE,0,0,5,0,5
2010,Viet Nam,VNM,Sweden,SWE,0,5,142,30,177
2010,Sudan,SDN,Sweden,SWE,17,10,31,10,68
2010,Sweden,SWE,Sweden,SWE,0,0,0,5,5
2010,Syrian Arab Rep.,SYR,Sweden,SWE,50,61,241,28,380
2010,United Rep. of Tanzania,TZA,Sweden,SWE,0,0,14,0,14
2010,Thailand,THA,Sweden,SWE,0,0,5,0,5
2010,Tajikistan,TJK,Sweden,SWE,0,0,30,5,35
2010,Turkmenistan,TKM,Sweden,SWE,0,0,11,0,11
2010,Togo,TGO,Sweden,SWE,0,0,5,0,5
2010,Tunisia,TUN,Sweden,SWE,0,5,29,11,45
2010,Turkey,TUR,Sweden,SWE,5,17,158,31,211
2010,Uganda,UGA,Sweden,SWE,11,5,40,0,56
2010,Ukraine,UKR,Sweden,SWE,0,0,95,21,116
2010,United States of America,USA,Sweden,SWE,0,0,5,0,5
2010,Uzbekistan,UZB,Sweden,SWE,17,13,205,30,265
2010,Venezuela (Bolivarian Republic of),VEN,Sweden,SWE,0,0,5,0,5
2010,Yemen,YEM,Sweden,SWE,29,5,78,14,126
2010,Zimbabwe,ZWE,Sweden,SWE,0,0,5,0,5
2010,Stateless,XXA,Sweden,SWE,102,214,423,119,858
2010,Afghanistan,AFG,Switzerland,CHE,40,385,58,316,799
2010,Albania,ALB,Switzerland,CHE,0,5,0,17,22
2010,Algeria,DZA,Switzerland,CHE,5,0,31,418,454
2010,Angola,AGO,Switzerland,CHE,0,39,24,41,104
2010,Egypt,EGY,Switzerland,CHE,13,0,0,40,53
2010,Armenia,ARM,Switzerland,CHE,0,5,10,79,94
2010,Azerbaijan,AZE,Switzerland,CHE,0,0,10,27,37
2010,Burundi,BDI,Switzerland,CHE,0,5,0,0,5
2010,Benin,BEN,Switzerland,CHE,0,0,5,27,32
2010,Bangladesh,BGD,Switzerland,CHE,0,0,5,32,37
2010,Bhutan,BTN,Switzerland,CHE,0,0,0,5,5
2010,Burkina Faso,BFA,Switzerland,CHE,0,0,5,22,27
2010,Belarus,BLR,Switzerland,CHE,0,5,5,75,85
2010,Bosnia and Herzegovina,BIH,Switzerland,CHE,25,19,101,149,294
2010,Bulgaria,BGR,Switzerland,CHE,0,0,10,18,28
2010,Cambodia,KHM,Switzerland,CHE,5,0,0,0,5
2010,Chad,TCD,Switzerland,CHE,0,0,5,11,16
2010,China,CHN,Switzerland,CHE,35,237,65,30,367
2010,Chile,CHL,Switzerland,CHE,0,0,5,0,5
2010,Cameroon,CMR,Switzerland,CHE,5,12,37,35,89
2010,Congo,COG,Switzerland,CHE,0,0,10,5,15
2010,Dem. Rep. of the Congo,COD,Switzerland,CHE,10,65,90,48,213
2010,Colombia,COL,Switzerland,CHE,27,0,0,5,32
2010,Cuba,CUB,Switzerland,CHE,0,0,5,0,5
2010,Cabo Verde,CPV,Switzerland,CHE,0,0,0,5,5
2010,Equatorial Guinea,GNQ,Switzerland,CHE,0,0,0,10,10
2010,Eritrea,ERI,Switzerland,CHE,2160,736,100,470,3466
2010,Ethiopia,ETH,Switzerland,CHE,56,31,73,55,215
2010,France,FRA,Switzerland,CHE,0,5,0,0,5
2010,Gabon,GAB,Switzerland,CHE,0,0,0,18,18
2010,Gambia,GMB,Switzerland,CHE,0,5,18,182,205
2010,Palestinian,PSE,Switzerland,CHE,0,5,17,59,81
2010,Georgia,GEO,Switzerland,CHE,5,0,27,712,744
2010,Germany,DEU,Switzerland,CHE,0,0,0,11,11
2010,Ghana,GHA,Switzerland,CHE,0,0,0,126,126
2010,Guinea-Bissau,GNB,Switzerland,CHE,0,0,13,144,157
2010,Guinea,GIN,Switzerland,CHE,0,5,34,297,336
2010,Haiti,HTI,Switzerland,CHE,0,0,0,5,5
2010,Croatia,HRV,Switzerland,CHE,0,0,5,5,10
2010,Hungary,HUN,Switzerland,CHE,0,0,0,5,5
2010,Cote d'Ivoire,CIV,Switzerland,CHE,0,5,43,89,137
2010,India,IND,Switzerland,CHE,0,0,5,15,20
2010,Iran (Islamic Rep. of),IRN,Switzerland,CHE,89,53,115,117,374
2010,Iraq,IRQ,Switzerland,CHE,148,305,173,486,1112
2010,Italy,ITA,Switzerland,CHE,0,0,0,10,10
2010,Jamaica,JAM,Switzerland,CHE,0,0,0,5,5
2010,Jordan,JOR,Switzerland,CHE,12,0,0,0,12
2010,Kazakhstan,KAZ,Switzerland,CHE,0,0,0,13,13
2010,Kenya,KEN,Switzerland,CHE,0,5,0,14,19
2010,Dem. People's Rep. of Korea,PRK,Switzerland,CHE,0,5,0,0,5
2010,Kuwait,KWT,Switzerland,CHE,5,0,0,0,5
2010,Lao People's Dem. Rep.,LAO,Switzerland,CHE,5,0,0,0,5
2010,Liberia,LBR,Switzerland,CHE,0,0,5,53,58
2010,Libya,LBY,Switzerland,CHE,10,0,5,18,33
2010,Lebanon,LBN,Switzerland,CHE,0,0,5,20,25
2010,Sri Lanka,LKA,Switzerland,CHE,194,509,181,203,1087
2010,Lithuania,LTU,Switzerland,CHE,0,0,0,5,5
2010,Mauritania,MRT,Switzerland,CHE,0,0,5,26,31
2010,North Macedonia,MKD,Switzerland,CHE,0,5,58,324,387
2010,Rep. of Moldova,MDA,Switzerland,CHE,0,0,5,35,40
2010,Mexico,MEX,Switzerland,CHE,0,0,0,5,5
2010,Mali,MLI,Switzerland,CHE,0,0,5,55,60
2010,Malawi,MWI,Switzerland,CHE,0,0,0,5,5
2010,Mongolia,MNG,Switzerland,CHE,0,0,43,139,182
2010,Morocco,MAR,Switzerland,CHE,5,0,5,83,93
2010,Montenegro,MNE,Switzerland,CHE,0,0,0,11,11
2010,Myanmar,MMR,Switzerland,CHE,0,5,0,0,5
2010,Nepal,NPL,Switzerland,CHE,5,0,5,11,21
2010,Netherlands,NLD,Switzerland,CHE,0,0,0,5,5
2010,Niger,NER,Switzerland,CHE,0,0,5,38,43
2010,Nigeria,NGA,Switzerland,CHE,0,0,42,2201,2243
2010,Pakistan,PAK,Switzerland,CHE,5,0,25,68,98
2010,Poland,POL,Switzerland,CHE,0,0,0,5,5
2010,Romania,ROU,Switzerland,CHE,0,0,17,55,72
2010,Russian Federation,RUS,Switzerland,CHE,26,21,53,426,526
2010,Rwanda,RWA,Switzerland,CHE,0,0,0,5,5
2010,Saudi Arabia,SAU,Switzerland,CHE,0,5,0,0,5
2010,Serbia and Kosovo: S/RES/1244 (1999),SRB,Switzerland,CHE,31,97,459,1085,1672
2010,Senegal,SEN,Switzerland,CHE,0,0,5,76,81
2010,Sierra Leone,SLE,Switzerland,CHE,0,0,5,76,81
2010,Somalia,SOM,Switzerland,CHE,148,1141,38,245,1572
2010,Viet Nam,VNM,Switzerland,CHE,5,0,0,0,5
2010,Sudan,SDN,Switzerland,CHE,5,18,16,82,121
2010,Slovakia,SVK,Switzerland,CHE,0,0,5,5,10
2010,Syrian Arab Rep.,SYR,Switzerland,CHE,46,49,239,157,491
2010,United Rep. of Tanzania,TZA,Switzerland,CHE,0,0,0,5,5
2010,Tajikistan,TJK,Switzerland,CHE,0,0,0,5,5
2010,Turkmenistan,TKM,Switzerland,CHE,5,0,0,0,5
2010,Togo,TGO,Switzerland,CHE,30,5,36,84,155
2010,Tunisia,TUN,Switzerland,CHE,22,0,16,304,342
2010,Turkey,TUR,Switzerland,CHE,228,29,218,168,643
2010,Uganda,UGA,Switzerland,CHE,0,0,10,10,20
2010,Ukraine,UKR,Switzerland,CHE,0,0,10,24,34
2010,United States of America,USA,Switzerland,CHE,0,0,0,5,5
2010,Uzbekistan,UZB,Switzerland,CHE,0,0,0,18,18
2010,Western Sahara,ESH,Switzerland,CHE,0,0,0,10,10
2010,Yemen,YEM,Switzerland,CHE,22,25,14,15,76
2010,Zimbabwe,ZWE,Switzerland,CHE,0,0,0,19,19
2010,Stateless,XXA,Switzerland,CHE,0,0,5,5,10
2010,Chad,TCD,Togo,TGO,14,0,0,0,14
2010,Dem. Rep. of the Congo,COD,Togo,TGO,0,0,13,0,13
2010,Cote d'Ivoire,CIV,Togo,TGO,0,0,5,0,5
2010,Rwanda,RWA,Togo,TGO,5,0,0,0,5
2010,Afghanistan,AFG,Ukraine,UKR,101,0,183,156,440
2010,Algeria,DZA,Ukraine,UKR,0,0,0,5,5
2010,Armenia,ARM,Ukraine,UKR,0,0,14,0,14
2010,Azerbaijan,AZE,Ukraine,UKR,0,0,0,11,11
2010,Bangladesh,BGD,Ukraine,UKR,0,0,13,0,13
2010,Belarus,BLR,Ukraine,UKR,5,0,0,16,21
2010,China,CHN,Ukraine,UKR,0,0,0,5,5
2010,Cameroon,CMR,Ukraine,UKR,0,0,11,10,21
2010,Congo,COG,Ukraine,UKR,0,0,0,13,13
2010,Dem. Rep. of the Congo,COD,Ukraine,UKR,0,0,14,10,24
2010,Ethiopia,ETH,Ukraine,UKR,0,0,0,5,5
2010,Palestinian,PSE,Ukraine,UKR,0,0,12,28,40
2010,Georgia,GEO,Ukraine,UKR,0,0,18,12,30
2010,Guinea,GIN,Ukraine,UKR,0,0,21,5,26
2010,India,IND,Ukraine,UKR,0,0,0,5,5
2010,Iran (Islamic Rep. of),IRN,Ukraine,UKR,5,0,10,12,27
2010,Iraq,IRQ,Ukraine,UKR,5,0,18,13,36
2010,Jordan,JOR,Ukraine,UKR,0,0,5,0,5
2010,Kenya,KEN,Ukraine,UKR,0,0,0,5,5
2010,Kyrgyzstan,KGZ,Ukraine,UKR,0,0,24,63,87
2010,Rep. of Moldova,MDA,Ukraine,UKR,0,0,0,10,10
2010,Nepal,NPL,Ukraine,UKR,0,0,5,0,5
2010,Nigeria,NGA,Ukraine,UKR,0,0,5,5,10
2010,Pakistan,PAK,Ukraine,UKR,0,0,10,26,36
2010,Russian Federation,RUS,Ukraine,UKR,0,0,12,24,36
2010,Somalia,SOM,Ukraine,UKR,0,0,89,126,215
2010,Viet Nam,VNM,Ukraine,UKR,0,0,0,5,5
2010,Sudan,SDN,Ukraine,UKR,0,0,0,5,5
2010,Syrian Arab Rep.,SYR,Ukraine,UKR,0,0,23,10,33
2010,Turkmenistan,TKM,Ukraine,UKR,5,0,0,0,5
2010,Turkey,TUR,Ukraine,UKR,0,0,5,0,5
2010,Uzbekistan,UZB,Ukraine,UKR,0,0,25,70,95
2010,Stateless,XXA,Ukraine,UKR,0,0,0,13,13
2010,Colombia,COL,Uruguay,URY,0,0,13,0,13
2010,Afghanistan,AFG,Venezuela (Bolivarian Republic of),VEN,5,0,0,0,5
2010,Colombia,COL,Venezuela (Bolivarian Republic of),VEN,255,0,1700,0,1955
2010,Burundi,BDI,Zimbabwe,ZWE,36,0,5,14,55
2010,Dem. Rep. of the Congo,COD,Zimbabwe,ZWE,469,0,10,488,967
2010,Ethiopia,ETH,Zimbabwe,ZWE,5,0,0,0,5
2010,Rwanda,RWA,Zimbabwe,ZWE,30,0,0,126,156
2010,Somalia,SOM,Zimbabwe,ZWE,10,0,0,0,10
2011,Angola,AGO,Argentina,ARG,0,0,5,0,5
2011,Armenia,ARM,Argentina,ARG,0,0,12,5,17
2011,Bangladesh,BGD,Argentina,ARG,0,0,12,5,17
2011,Brazil,BRA,Argentina,ARG,0,0,5,0,5
2011,Chile,CHL,Argentina,ARG,0,0,0,5,5
2011,Cameroon,CMR,Argentina,ARG,0,0,0,12,12
2011,Dem. Rep. of the Congo,COD,Argentina,ARG,5,0,0,12,17
2011,Colombia,COL,Argentina,ARG,31,24,55,144,254
2011,Cuba,CUB,Argentina,ARG,5,0,19,18,42
2011,Dominican Rep.,DOM,Argentina,ARG,0,0,89,36,125
2011,Ecuador,ECU,Argentina,ARG,0,0,0,5,5
2011,Equatorial Guinea,GNQ,Argentina,ARG,0,0,0,5,5
2011,Ghana,GHA,Argentina,ARG,10,0,10,0,20
2011,Guinea-Bissau,GNB,Argentina,ARG,0,0,0,10,10
2011,Haiti,HTI,Argentina,ARG,12,0,30,28,70
2011,Cote d'Ivoire,CIV,Argentina,ARG,16,0,0,5,21
2011,India,IND,Argentina,ARG,0,0,18,5,23
2011,Kazakhstan,KAZ,Argentina,ARG,0,0,5,0,5
2011,Liberia,LBR,Argentina,ARG,0,0,0,10,10
2011,Sri Lanka,LKA,Argentina,ARG,0,0,0,5,5
2011,Nepal,NPL,Argentina,ARG,0,0,5,0,5
2011,Nigeria,NGA,Argentina,ARG,0,0,18,15,33
2011,Pakistan,PAK,Argentina,ARG,0,0,0,5,5
2011,Peru,PER,Argentina,ARG,0,0,10,24,34
2011,El Salvador,SLV,Argentina,ARG,0,5,0,0,5
2011,Senegal,SEN,Argentina,ARG,5,0,81,5,91
2011,Sierra Leone,SLE,Argentina,ARG,0,0,0,5,5
2011,Spain,ESP,Argentina,ARG,0,0,5,0,5
2011,Zimbabwe,ZWE,Argentina,ARG,0,0,5,0,5
2011,Cote d'Ivoire,CIV,Armenia,ARM,10,0,0,0,10
2011,Iran (Islamic Rep. of),IRN,Armenia,ARM,0,0,12,0,12
2011,Iraq,IRQ,Armenia,ARM,36,0,0,0,36
2011,Syrian Arab Rep.,SYR,Armenia,ARM,5,0,0,0,5
2011,Turkey,TUR,Armenia,ARM,0,0,10,0,10
2011,Afghanistan,AFG,Australia,AUS,1211,0,900,0,2111
2011,Albania,ALB,Australia,AUS,0,0,19,0,19
2011,Algeria,DZA,Australia,AUS,5,0,0,0,5
2011,Egypt,EGY,Australia,AUS,117,0,298,0,415
2011,Bahrain,BHR,Australia,AUS,38,0,10,0,48
2011,Burundi,BDI,Australia,AUS,0,0,5,0,5
2011,Bangladesh,BGD,Australia,AUS,19,0,83,0,102
2011,Brazil,BRA,Australia,AUS,0,0,12,0,12
2011,Cambodia,KHM,Australia,AUS,5,0,15,0,20
2011,China,CHN,Australia,AUS,132,0,934,0,1066
2011,Cameroon,CMR,Australia,AUS,0,0,5,0,5
2011,Dem. Rep. of the Congo,COD,Australia,AUS,0,0,5,0,5
2011,Colombia,COL,Australia,AUS,5,0,39,0,44
2011,Czechia,CZE,Australia,AUS,0,0,5,0,5
2011,Eritrea,ERI,Australia,AUS,27,0,0,0,27
2011,Ethiopia,ETH,Australia,AUS,13,0,19,0,32
2011,Fiji,FJI,Australia,AUS,27,0,260,0,287
2011,Palestinian,PSE,Australia,AUS,26,0,14,0,40
2011,United Kingdom of Great Britain and Northern Ireland,GBR,Australia,AUS,0,0,5,0,5
2011,Ghana,GHA,Australia,AUS,0,0,15,0,15
2011,"China, Hong Kong SAR",HKG,Australia,AUS,0,0,14,0,14
2011,India,IND,Australia,AUS,14,0,495,0,509
2011,Indonesia,IDN,Australia,AUS,11,0,156,0,167
2011,Iran (Islamic Rep. of),IRN,Australia,AUS,1181,0,859,0,2040
2011,Iraq,IRQ,Australia,AUS,434,0,235,0,669
2011,Israel,ISR,Australia,AUS,0,0,10,0,10
2011,Italy,ITA,Australia,AUS,0,0,5,0,5
2011,Jordan,JOR,Australia,AUS,0,0,28,0,28
2011,Japan,JPN,Australia,AUS,0,0,5,0,5
2011,Kazakhstan,KAZ,Australia,AUS,0,0,5,0,5
2011,Kenya,KEN,Australia,AUS,0,0,16,0,16
2011,Rep. of Korea,KOR,Australia,AUS,5,0,60,0,65
2011,Kuwait,KWT,Australia,AUS,15,0,10,0,25
2011,Libya,LBY,Australia,AUS,13,0,10,0,23
2011,Lebanon,LBN,Australia,AUS,36,0,149,0,185
2011,Sri Lanka,LKA,Australia,AUS,306,0,249,0,555
2011,North Macedonia,MKD,Australia,AUS,0,0,5,0,5
2011,Maldives,MDV,Australia,AUS,5,0,0,0,5
2011,Malaysia,MYS,Australia,AUS,5,0,160,0,165
2011,Mongolia,MNG,Australia,AUS,0,0,14,0,14
2011,Morocco,MAR,Australia,AUS,0,0,5,0,5
2011,Mozambique,MOZ,Australia,AUS,5,0,0,0,5
2011,Mauritius,MUS,Australia,AUS,0,0,30,0,30
2011,Myanmar,MMR,Australia,AUS,101,0,20,0,121
2011,Nepal,NPL,Australia,AUS,17,0,171,0,188
2011,Nigeria,NGA,Australia,AUS,5,0,26,0,31
2011,New Zealand,NZL,Australia,AUS,0,0,10,0,10
2011,Pakistan,PAK,Australia,AUS,291,0,302,0,593
2011,Peru,PER,Australia,AUS,0,0,12,0,12
2011,Philippines,PHL,Australia,AUS,0,0,61,0,61
2011,Papua New Guinea,PNG,Australia,AUS,38,0,44,0,82
2011,Romania,ROU,Australia,AUS,0,0,5,0,5
2011,South Africa,ZAF,Australia,AUS,0,0,12,0,12
2011,Russian Federation,RUS,Australia,AUS,0,0,5,0,5
2011,Rwanda,RWA,Australia,AUS,5,0,0,0,5
2011,El Salvador,SLV,Australia,AUS,0,0,10,0,10
2011,Saudi Arabia,SAU,Australia,AUS,5,0,0,0,5
2011,Singapore,SGP,Australia,AUS,0,0,5,0,5
2011,Somalia,SOM,Australia,AUS,11,0,0,0,11
2011,Viet Nam,VNM,Australia,AUS,0,0,153,0,153
2011,Sudan,SDN,Australia,AUS,5,0,0,0,5
2011,Syrian Arab Rep.,SYR,Australia,AUS,27,0,20,0,47
2011,Thailand,THA,Australia,AUS,0,0,16,0,16
2011,Tonga,TON,Australia,AUS,5,0,28,0,33
2011,Turkey,TUR,Australia,AUS,40,0,83,0,123
2011,Uganda,UGA,Australia,AUS,0,0,11,0,11
2011,Ukraine,UKR,Australia,AUS,0,0,13,0,13
2011,Uzbekistan,UZB,Australia,AUS,0,0,5,0,5
2011,Zambia,ZMB,Australia,AUS,0,0,5,0,5
2011,Zimbabwe,ZWE,Australia,AUS,75,0,109,0,184
2011,Stateless,XXA,Australia,AUS,519,0,356,0,875
2011,Afghanistan,AFG,Azerbaijan,AZE,0,0,28,0,28
2011,Iran (Islamic Rep. of),IRN,Azerbaijan,AZE,0,0,13,0,13
2011,Pakistan,PAK,Azerbaijan,AZE,0,0,16,0,16
2011,Afghanistan,AFG,Belgium,BEL,379,446,604,31,1460
2011,Albania,ALB,Belgium,BEL,30,0,395,70,495
2011,Algeria,DZA,Belgium,BEL,5,0,121,38,164
2011,Angola,AGO,Belgium,BEL,5,0,147,5,157
2011,Egypt,EGY,Belgium,BEL,5,0,17,5,27
2011,Argentina,ARG,Belgium,BEL,0,0,5,0,5
2011,Armenia,ARM,Belgium,BEL,5,5,896,54,960
2011,Azerbaijan,AZE,Belgium,BEL,5,0,32,5,42
2011,Burundi,BDI,Belgium,BEL,41,5,156,13,215
2011,Benin,BEN,Belgium,BEL,10,0,12,0,22
2011,Bangladesh,BGD,Belgium,BEL,0,0,109,17,126
2011,Bhutan,BTN,Belgium,BEL,0,0,5,0,5
2011,Burkina Faso,BFA,Belgium,BEL,5,0,62,0,67
2011,Belarus,BLR,Belgium,BEL,0,0,39,5,44
2011,Bosnia and Herzegovina,BIH,Belgium,BEL,0,0,268,85,353
2011,Bulgaria,BGR,Belgium,BEL,0,0,60,5,65
2011,Chad,TCD,Belgium,BEL,5,0,11,0,16
2011,China,CHN,Belgium,BEL,189,0,25,13,227
2011,Cameroon,CMR,Belgium,BEL,83,0,320,15,418
2011,Congo,COG,Belgium,BEL,0,0,13,5,18
2011,Dem. Rep. of the Congo,COD,Belgium,BEL,82,5,388,36,511
2011,Colombia,COL,Belgium,BEL,10,0,0,0,10
2011,Czechia,CZE,Belgium,BEL,0,0,12,0,12
2011,Djibouti,DJI,Belgium,BEL,27,0,29,5,61
2011,Equatorial Guinea,GNQ,Belgium,BEL,0,0,0,5,5
2011,Eritrea,ERI,Belgium,BEL,22,0,18,5,45
2011,Ethiopia,ETH,Belgium,BEL,5,0,21,0,26
2011,France,FRA,Belgium,BEL,0,0,5,0,5
2011,Gabon,GAB,Belgium,BEL,12,0,0,0,12
2011,Gambia,GMB,Belgium,BEL,10,0,38,5,53
2011,Palestinian,PSE,Belgium,BEL,5,13,5,0,23
2011,Georgia,GEO,Belgium,BEL,0,0,134,27,161
2011,Ghana,GHA,Belgium,BEL,5,0,41,0,46
2011,Guinea-Bissau,GNB,Belgium,BEL,0,0,10,0,10
2011,Guinea,GIN,Belgium,BEL,842,13,1143,58,2056
2011,Haiti,HTI,Belgium,BEL,0,0,0,5,5
2011,Croatia,HRV,Belgium,BEL,0,0,17,0,17
2011,Cote d'Ivoire,CIV,Belgium,BEL,18,0,135,20,173
2011,India,IND,Belgium,BEL,0,0,120,21,141
2011,Iran (Islamic Rep. of),IRN,Belgium,BEL,48,0,65,28,141
2011,Iraq,IRQ,Belgium,BEL,475,677,277,107,1536
2011,Israel,ISR,Belgium,BEL,0,0,5,0,5
2011,Jordan,JOR,Belgium,BEL,5,0,11,0,16
2011,Kazakhstan,KAZ,Belgium,BEL,0,0,21,16,37
2011,Kenya,KEN,Belgium,BEL,11,0,28,5,44
2011,Kyrgyzstan,KGZ,Belgium,BEL,0,0,0,12,12
2011,Dem. People's Rep. of Korea,PRK,Belgium,BEL,48,0,0,5,53
2011,Liberia,LBR,Belgium,BEL,5,0,19,0,24
2011,Libya,LBY,Belgium,BEL,0,0,0,10,10
2011,Lebanon,LBN,Belgium,BEL,14,0,32,10,56
2011,Sri Lanka,LKA,Belgium,BEL,71,0,148,5,224
2011,Madagascar,MDG,Belgium,BEL,0,0,5,0,5
2011,Mauritania,MRT,Belgium,BEL,18,0,114,10,142
2011,North Macedonia,MKD,Belgium,BEL,12,0,1250,200,1462
2011,Rep. of Moldova,MDA,Belgium,BEL,0,0,5,0,5
2011,Mali,MLI,Belgium,BEL,5,0,16,0,21
2011,Mongolia,MNG,Belgium,BEL,0,0,48,0,48
2011,Morocco,MAR,Belgium,BEL,5,0,26,5,36
2011,Montenegro,MNE,Belgium,BEL,0,0,5,5,10
2011,Mauritius,MUS,Belgium,BEL,0,0,10,0,10
2011,Myanmar,MMR,Belgium,BEL,11,0,0,0,11
2011,Nepal,NPL,Belgium,BEL,0,0,16,5,21
2011,Niger,NER,Belgium,BEL,16,0,71,10,97
2011,Nigeria,NGA,Belgium,BEL,10,0,104,5,119
2011,Pakistan,PAK,Belgium,BEL,5,0,189,25,219
2011,Romania,ROU,Belgium,BEL,0,0,86,5,91
2011,Russian Federation,RUS,Belgium,BEL,333,5,2257,156,2751
2011,Rwanda,RWA,Belgium,BEL,140,0,384,13,537
2011,El Salvador,SLV,Belgium,BEL,0,10,0,0,10
2011,Serbia and Kosovo: S/RES/1244 (1999),SRB,Belgium,BEL,352,0,4814,531,5697
2011,Senegal,SEN,Belgium,BEL,108,0,218,10,336
2011,Sierra Leone,SLE,Belgium,BEL,10,0,19,0,29
2011,Somalia,SOM,Belgium,BEL,95,36,212,10,353
2011,Sudan,SDN,Belgium,BEL,10,11,34,5,60
2011,Suriname,SUR,Belgium,BEL,0,0,0,5,5
2011,Slovakia,SVK,Belgium,BEL,0,0,44,0,44
2011,Syrian Arab Rep.,SYR,Belgium,BEL,63,0,19,14,96
2011,United Rep. of Tanzania,TZA,Belgium,BEL,14,5,116,5,140
2011,Togo,TGO,Belgium,BEL,27,5,116,5,153
2011,Tunisia,TUN,Belgium,BEL,0,0,30,5,35
2011,Turkey,TUR,Belgium,BEL,39,0,183,24,246
2011,Uganda,UGA,Belgium,BEL,0,0,14,0,14
2011,Ukraine,UKR,Belgium,BEL,0,0,33,0,33
2011,Uzbekistan,UZB,Belgium,BEL,0,0,18,5,23
2011,Venezuela (Bolivarian Republic of),VEN,Belgium,BEL,0,0,10,0,10
2011,Yemen,YEM,Belgium,BEL,0,0,0,5,5
2011,Zimbabwe,ZWE,Belgium,BEL,0,0,5,0,5
2011,Stateless,XXA,Belgium,BEL,0,0,0,5,5
2011,Cote d'Ivoire,CIV,Benin,BEN,140,0,10,0,150
2011,Rwanda,RWA,Benin,BEN,5,0,5,0,10
2011,Togo,TGO,Benin,BEN,0,0,10,0,10
2011,Cuba,CUB,Bahamas,BHS,0,0,0,5,5
2011,Chad,TCD,Burkina Faso,BFA,18,0,0,5,23
2011,Dem. Rep. of the Congo,COD,Burkina Faso,BFA,0,0,0,5,5
2011,Cote d'Ivoire,CIV,Burkina Faso,BFA,0,0,0,5,5
2011,Rwanda,RWA,Burkina Faso,BFA,10,0,0,0,10
2011,Afghanistan,AFG,Belarus,BLR,10,0,27,16,53
2011,Azerbaijan,AZE,Belarus,BLR,0,0,0,5,5
2011,Georgia,GEO,Belarus,BLR,0,0,13,11,24
2011,Pakistan,PAK,Belarus,BLR,5,0,0,5,10
2011,Ukraine,UKR,Belarus,BLR,0,0,5,0,5
2011,Colombia,COL,Bolivia (Plurinational State of),BOL,21,0,24,0,45
2011,Honduras,HND,Bolivia (Plurinational State of),BOL,0,0,5,0,5
2011,Peru,PER,Bolivia (Plurinational State of),BOL,0,0,5,0,5
2011,Afghanistan,AFG,Brazil,BRA,0,0,5,0,5
2011,Angola,AGO,Brazil,BRA,0,0,14,0,14
2011,Bangladesh,BGD,Brazil,BRA,0,0,44,10,54
2011,Dem. Rep. of the Congo,COD,Brazil,BRA,26,0,42,5,73
2011,Colombia,COL,Brazil,BRA,37,0,66,0,103
2011,Cuba,CUB,Brazil,BRA,0,0,12,5,17
2011,Ecuador,ECU,Brazil,BRA,0,0,0,5,5
2011,Ghana,GHA,Brazil,BRA,0,0,5,0,5
2011,Guinea-Bissau,GNB,Brazil,BRA,0,0,24,0,24
2011,Guinea,GIN,Brazil,BRA,0,0,5,0,5
2011,Haiti,HTI,Brazil,BRA,0,720,0,0,720
2011,Cote d'Ivoire,CIV,Brazil,BRA,5,0,0,0,5
2011,India,IND,Brazil,BRA,0,0,5,0,5
2011,Iraq,IRQ,Brazil,BRA,5,0,0,0,5
2011,Israel,ISR,Brazil,BRA,0,0,5,0,5
2011,Nigeria,NGA,Brazil,BRA,5,0,23,0,28
2011,Pakistan,PAK,Brazil,BRA,11,0,30,0,41
2011,Peru,PER,Brazil,BRA,0,0,5,0,5
2011,Senegal,SEN,Brazil,BRA,0,0,10,0,10
2011,Somalia,SOM,Brazil,BRA,5,0,0,0,5
2011,United States of America,USA,Brazil,BRA,0,0,5,0,5
2011,Venezuela (Bolivarian Republic of),VEN,Brazil,BRA,0,0,5,0,5
2011,Myanmar,MMR,Cambodia,KHM,0,0,0,11,11
2011,Pakistan,PAK,Cambodia,KHM,5,0,0,0,5
2011,Afghanistan,AFG,Canada,CAN,392,0,50,61,503
2011,Albania,ALB,Canada,CAN,92,0,173,29,294
2011,Algeria,DZA,Canada,CAN,60,0,55,23,138
2011,Angola,AGO,Canada,CAN,10,0,5,5,20
2011,Antigua and Barbuda,ATG,Canada,CAN,10,0,11,5,26
2011,Egypt,EGY,Canada,CAN,87,0,29,12,128
2011,Argentina,ARG,Canada,CAN,0,0,32,5,37
2011,Armenia,ARM,Canada,CAN,11,0,5,5,21
2011,Australia,AUS,Canada,CAN,0,0,5,0,5
2011,Azerbaijan,AZE,Canada,CAN,14,0,5,5,24
2011,Barbados,BRB,Canada,CAN,25,0,24,11,60
2011,Burundi,BDI,Canada,CAN,93,0,48,0,141
2011,Belgium,BEL,Canada,CAN,0,0,5,0,5
2011,Benin,BEN,Canada,CAN,5,0,0,0,5
2011,Bangladesh,BGD,Canada,CAN,48,0,81,16,145
2011,Bahamas,BHS,Canada,CAN,13,0,5,0,18
2011,Burkina Faso,BFA,Canada,CAN,10,0,5,0,15
2011,Belarus,BLR,Canada,CAN,10,0,5,5,20
2011,Bolivia (Plurinational State of),BOL,Canada,CAN,5,0,14,0,19
2011,Botswana,BWA,Canada,CAN,73,0,64,11,148
2011,Brazil,BRA,Canada,CAN,5,0,111,44,160
2011,Bosnia and Herzegovina,BIH,Canada,CAN,12,0,19,0,31
2011,Bulgaria,BGR,Canada,CAN,28,0,13,0,41
2011,Cambodia,KHM,Canada,CAN,5,0,5,0,10
2011,Chad,TCD,Canada,CAN,17,0,15,0,32
2011,China,CHN,Canada,CAN,958,0,672,179,1809
2011,Chile,CHL,Canada,CAN,5,0,52,18,75
2011,Cameroon,CMR,Canada,CAN,118,0,40,13,171
2011,Congo,COG,Canada,CAN,16,0,18,0,34
2011,Dem. Rep. of the Congo,COD,Canada,CAN,220,0,128,43,391
2011,Colombia,COL,Canada,CAN,639,0,972,121,1732
2011,Costa Rica,CRI,Canada,CAN,10,0,41,5,56
2011,Cuba,CUB,Canada,CAN,128,0,53,38,219
2011,Czechia,CZE,Canada,CAN,43,0,331,167,541
2011,Djibouti,DJI,Canada,CAN,68,0,11,0,79
2011,Dominica,DMA,Canada,CAN,0,0,13,0,13
2011,Dominican Rep.,DOM,Canada,CAN,13,0,46,22,81
2011,Ecuador,ECU,Canada,CAN,11,0,47,10,68
2011,Equatorial Guinea,GNQ,Canada,CAN,5,0,5,0,10
2011,Eritrea,ERI,Canada,CAN,243,0,10,12,265
2011,Estonia,EST,Canada,CAN,0,0,5,5,10
2011,Ethiopia,ETH,Canada,CAN,219,0,32,5,256
2011,Fiji,FJI,Canada,CAN,18,0,33,5,56
2011,France,FRA,Canada,CAN,5,0,12,15,32
2011,Gabon,GAB,Canada,CAN,0,0,5,0,5
2011,Gambia,GMB,Canada,CAN,12,0,11,0,23
2011,Palestinian,PSE,Canada,CAN,37,0,30,5,72
2011,United Kingdom of Great Britain and Northern Ireland,GBR,Canada,CAN,0,0,15,10,25
2011,Georgia,GEO,Canada,CAN,22,0,69,12,103
2011,Germany,DEU,Canada,CAN,0,0,17,5,22
2011,Ghana,GHA,Canada,CAN,41,0,49,5,95
2011,Guinea-Bissau,GNB,Canada,CAN,5,0,0,0,5
2011,Greece,GRC,Canada,CAN,5,0,12,5,22
2011,Grenada,GRD,Canada,CAN,16,0,33,5,54
2011,Guatemala,GTM,Canada,CAN,139,0,234,26,399
2011,Guinea,GIN,Canada,CAN,63,0,42,5,110
2011,Guyana,GUY,Canada,CAN,27,0,100,16,143
2011,Haiti,HTI,Canada,CAN,1440,0,1429,138,3007
2011,Honduras,HND,Canada,CAN,113,0,251,46,410
2011,Croatia,HRV,Canada,CAN,16,0,39,18,73
2011,Hungary,HUN,Canada,CAN,165,0,738,1087,1990
2011,Cote d'Ivoire,CIV,Canada,CAN,32,0,10,5,47
2011,India,IND,Canada,CAN,111,0,381,113,605
2011,Indonesia,IDN,Canada,CAN,12,0,18,5,35
2011,Iran (Islamic Rep. of),IRN,Canada,CAN,329,0,44,33,406
2011,Iraq,IRQ,Canada,CAN,210,0,40,20,270
2011,Israel,ISR,Canada,CAN,31,0,303,106,440
2011,Italy,ITA,Canada,CAN,0,0,26,10,36
2011,Jamaica,JAM,Canada,CAN,169,0,211,54,434
2011,Jordan,JOR,Canada,CAN,39,0,53,14,106
2011,Japan,JPN,Canada,CAN,0,0,0,10,10
2011,Kazakhstan,KAZ,Canada,CAN,15,0,5,0,20
2011,Kenya,KEN,Canada,CAN,108,0,23,0,131
2011,Kyrgyzstan,KGZ,Canada,CAN,0,0,12,0,12
2011,Rep. of Korea,KOR,Canada,CAN,20,0,76,74,170
2011,Dem. People's Rep. of Korea,PRK,Canada,CAN,117,0,12,41,170
2011,Lao People's Dem. Rep.,LAO,Canada,CAN,0,0,24,5,29
2011,Liberia,LBR,Canada,CAN,28,0,25,0,53
2011,Libya,LBY,Canada,CAN,32,0,21,24,77
2011,Saint Lucia,LCA,Canada,CAN,279,0,260,63,602
2011,Lebanon,LBN,Canada,CAN,76,0,89,14,179
2011,Sri Lanka,LKA,Canada,CAN,281,0,183,28,492
2011,Lithuania,LTU,Canada,CAN,5,0,18,19,42
2011,Latvia,LVA,Canada,CAN,27,0,22,30,79
2011,Madagascar,MDG,Canada,CAN,5,0,0,0,5
2011,Mauritania,MRT,Canada,CAN,5,0,10,5,20
2011,North Macedonia,MKD,Canada,CAN,10,0,16,5,31
2011,Rep. of Moldova,MDA,Canada,CAN,42,0,18,10,70
2011,Mexico,MEX,Canada,CAN,1042,0,4184,884,6110
2011,Mali,MLI,Canada,CAN,0,0,12,0,12
2011,Malaysia,MYS,Canada,CAN,0,0,12,5,17
2011,Malawi,MWI,Canada,CAN,11,0,0,0,11
2011,Mongolia,MNG,Canada,CAN,15,0,11,5,31
2011,Morocco,MAR,Canada,CAN,19,0,20,10,49
2011,Montenegro,MNE,Canada,CAN,13,0,20,0,33
2011,Myanmar,MMR,Canada,CAN,12,0,5,0,17
2011,Namibia,NAM,Canada,CAN,65,0,48,26,139
2011,Nepal,NPL,Canada,CAN,128,0,47,0,175
2011,Netherlands,NLD,Canada,CAN,0,0,10,5,15
2011,Niger,NER,Canada,CAN,12,0,0,5,17
2011,Nicaragua,NIC,Canada,CAN,12,0,41,5,58
2011,Nigeria,NGA,Canada,CAN,840,0,422,74,1336
2011,Oman,OMN,Canada,CAN,5,0,0,0,5
2011,Pakistan,PAK,Canada,CAN,433,0,138,73,644
2011,Panama,PAN,Canada,CAN,0,0,16,0,16
2011,Paraguay,PRY,Canada,CAN,10,0,0,0,10
2011,Peru,PER,Canada,CAN,16,0,86,20,122
2011,Philippines,PHL,Canada,CAN,18,0,175,28,221
2011,Poland,POL,Canada,CAN,10,0,39,37,86
2011,Portugal,PRT,Canada,CAN,0,0,48,21,69
2011,Puerto Rico,PRI,Canada,CAN,0,0,0,5,5
2011,Romania,ROU,Canada,CAN,34,0,35,29,98
2011,South Africa,ZAF,Canada,CAN,13,0,11,12,36
2011,Russian Federation,RUS,Canada,CAN,119,0,47,32,198
2011,Rwanda,RWA,Canada,CAN,118,0,43,5,166
2011,El Salvador,SLV,Canada,CAN,190,0,508,51,749
2011,Saudi Arabia,SAU,Canada,CAN,13,0,0,5,18
2011,Serbia and Kosovo: S/RES/1244 (1999),SRB,Canada,CAN,46,0,59,24,129
2011,Senegal,SEN,Canada,CAN,22,0,12,5,39
2011,Singapore,SGP,Canada,CAN,0,0,5,5,10
2011,Sierra Leone,SLE,Canada,CAN,10,0,5,0,15
2011,Somalia,SOM,Canada,CAN,646,0,31,165,842
2011,Spain,ESP,Canada,CAN,0,0,12,16,28
2011,Viet Nam,VNM,Canada,CAN,5,0,5,10,20
2011,Saint Kitts and Nevis,KNA,Canada,CAN,12,0,0,0,12
2011,Sudan,SDN,Canada,CAN,41,0,0,10,51
2011,Suriname,SUR,Canada,CAN,0,0,5,0,5
2011,Slovakia,SVK,Canada,CAN,5,0,57,163,225
2011,Slovenia,SVN,Canada,CAN,0,0,10,0,10
2011,Eswatini,SWZ,Canada,CAN,34,0,5,0,39
2011,Sweden,SWE,Canada,CAN,0,0,14,0,14
2011,Syrian Arab Rep.,SYR,Canada,CAN,83,0,56,14,153
2011,United Rep. of Tanzania,TZA,Canada,CAN,26,0,14,0,40
2011,Thailand,THA,Canada,CAN,5,0,53,21,79
2011,Tajikistan,TJK,Canada,CAN,5,0,5,0,10
2011,Togo,TGO,Canada,CAN,10,0,5,0,15
2011,Trinidad and Tobago,TTO,Canada,CAN,33,0,82,19,134
2011,Tunisia,TUN,Canada,CAN,19,0,24,5,48
2011,Turkey,TUR,Canada,CAN,189,0,104,48,341
2011,United Arab Emirates,ARE,Canada,CAN,12,0,0,5,17
2011,Uganda,UGA,Canada,CAN,68,0,18,0,86
2011,Ukraine,UKR,Canada,CAN,97,0,58,32,187
2011,Uruguay,URY,Canada,CAN,0,0,15,10,25
2011,United States of America,USA,Canada,CAN,5,0,560,103,668
2011,Uzbekistan,UZB,Canada,CAN,22,0,10,5,37
2011,Saint Vincent and the Grenadines,VCT,Canada,CAN,288,0,457,79,824
2011,Venezuela (Bolivarian Republic of),VEN,Canada,CAN,111,0,88,10,209
2011,Yemen,YEM,Canada,CAN,12,0,5,0,17
2011,Zambia,ZMB,Canada,CAN,0,0,13,0,13
2011,Zimbabwe,ZWE,Canada,CAN,224,0,57,13,294
2011,Burkina Faso,BFA,Central African Rep.,CAF,0,0,0,5,5
2011,Cameroon,CMR,Central African Rep.,CAF,0,0,0,5,5
2011,Congo,COG,Central African Rep.,CAF,0,0,0,23,23
2011,Cote d'Ivoire,CIV,Central African Rep.,CAF,0,0,0,5,5
2011,Liberia,LBR,Central African Rep.,CAF,0,0,0,5,5
2011,Nigeria,NGA,Central African Rep.,CAF,0,0,0,5,5
2011,Rwanda,RWA,Central African Rep.,CAF,0,0,0,5,5
2011,Zambia,ZMB,Central African Rep.,CAF,0,0,0,5,5
2011,Afghanistan,AFG,Cayman Islands,CYM,5,0,0,0,5
2011,Colombia,COL,Chile,CHL,5,53,137,0,195
2011,Costa Rica,CRI,Chile,CHL,0,5,0,0,5
2011,Cuba,CUB,Chile,CHL,0,0,5,0,5
2011,Ecuador,ECU,Chile,CHL,0,5,0,0,5
2011,El Salvador,SLV,Chile,CHL,0,5,0,0,5
2011,Cuba,CUB,Colombia,COL,0,0,30,48,78
2011,Eritrea,ERI,Colombia,COL,0,0,0,5,5
2011,Sri Lanka,LKA,Colombia,COL,0,0,5,0,5
2011,Russian Federation,RUS,Colombia,COL,5,0,0,0,5
2011,Somalia,SOM,Colombia,COL,0,0,0,24,24
2011,Dem. Rep. of the Congo,COD,Costa Rica,CRI,0,0,5,0,5
2011,Colombia,COL,Costa Rica,CRI,100,0,222,200,522
2011,Cuba,CUB,Costa Rica,CRI,58,0,70,25,153
2011,Guatemala,GTM,Costa Rica,CRI,5,0,16,0,21
2011,Honduras,HND,Costa Rica,CRI,31,0,5,14,50
2011,Iran (Islamic Rep. of),IRN,Costa Rica,CRI,5,0,0,0,5
2011,Mexico,MEX,Costa Rica,CRI,5,0,0,0,5
2011,Nicaragua,NIC,Costa Rica,CRI,0,0,12,0,12
2011,Nigeria,NGA,Costa Rica,CRI,5,0,11,5,21
2011,Peru,PER,Costa Rica,CRI,0,0,0,5,5
2011,El Salvador,SLV,Costa Rica,CRI,10,0,16,0,26
2011,Somalia,SOM,Costa Rica,CRI,13,0,0,0,13
2011,United States of America,USA,Costa Rica,CRI,0,0,5,0,5
2011,Venezuela (Bolivarian Republic of),VEN,Costa Rica,CRI,5,0,26,0,31
2011,Afghanistan,AFG,Cyprus,CYP,0,0,29,0,29
2011,Albania,ALB,Cyprus,CYP,0,0,5,0,5
2011,Algeria,DZA,Cyprus,CYP,0,0,5,5,10
2011,Egypt,EGY,Cyprus,CYP,0,0,147,10,157
2011,Armenia,ARM,Cyprus,CYP,0,0,16,0,16
2011,Benin,BEN,Cyprus,CYP,0,0,5,0,5
2011,Bangladesh,BGD,Cyprus,CYP,0,0,190,5,195
2011,Bosnia and Herzegovina,BIH,Cyprus,CYP,0,0,5,0,5
2011,China,CHN,Cyprus,CYP,0,0,48,0,48
2011,Cameroon,CMR,Cyprus,CYP,0,0,62,5,67
2011,Dem. Rep. of the Congo,COD,Cyprus,CYP,0,0,5,0,5
2011,Dominican Rep.,DOM,Cyprus,CYP,0,0,0,5,5
2011,Eritrea,ERI,Cyprus,CYP,5,0,0,0,5
2011,Ethiopia,ETH,Cyprus,CYP,0,0,20,0,20
2011,Palestinian,PSE,Cyprus,CYP,16,0,242,50,308
2011,Georgia,GEO,Cyprus,CYP,0,0,23,0,23
2011,Ghana,GHA,Cyprus,CYP,0,0,24,0,24
2011,Guinea,GIN,Cyprus,CYP,0,0,37,0,37
2011,India,IND,Cyprus,CYP,0,0,182,10,192
2011,Iran (Islamic Rep. of),IRN,Cyprus,CYP,0,5,186,19,210
2011,Iraq,IRQ,Cyprus,CYP,17,0,210,44,271
2011,Jordan,JOR,Cyprus,CYP,0,0,28,27,55
2011,Kenya,KEN,Cyprus,CYP,0,0,5,0,5
2011,Lebanon,LBN,Cyprus,CYP,0,0,23,0,23
2011,Sri Lanka,LKA,Cyprus,CYP,0,0,193,0,193
2011,Rep. of Moldova,MDA,Cyprus,CYP,0,0,5,5,10
2011,Mongolia,MNG,Cyprus,CYP,0,0,12,0,12
2011,Morocco,MAR,Cyprus,CYP,0,0,10,0,10
2011,Nepal,NPL,Cyprus,CYP,0,0,126,5,131
2011,Nigeria,NGA,Cyprus,CYP,0,0,91,5,96
2011,Pakistan,PAK,Cyprus,CYP,0,0,149,12,161
2011,Philippines,PHL,Cyprus,CYP,0,5,98,0,103
2011,Russian Federation,RUS,Cyprus,CYP,0,0,11,5,16
2011,Viet Nam,VNM,Cyprus,CYP,0,0,217,5,222
2011,Syrian Arab Rep.,SYR,Cyprus,CYP,0,0,57,16,73
2011,Tunisia,TUN,Cyprus,CYP,0,0,5,0,5
2011,Turkey,TUR,Cyprus,CYP,14,0,48,0,62
2011,Ukraine,UKR,Cyprus,CYP,0,0,5,0,5
2011,Uzbekistan,UZB,Cyprus,CYP,0,0,5,0,5
2011,Zimbabwe,ZWE,Cyprus,CYP,0,0,5,0,5
2011,Afghanistan,AFG,Czechia,CZE,11,5,0,0,16
2011,Belarus,BLR,Czechia,CZE,12,30,0,0,42
2011,Dem. Rep. of the Congo,COD,Czechia,CZE,0,5,0,0,5
2011,Cuba,CUB,Czechia,CZE,0,11,0,0,11
2011,Cote d'Ivoire,CIV,Czechia,CZE,0,5,0,0,5
2011,Iraq,IRQ,Czechia,CZE,12,0,0,0,12
2011,Kazakhstan,KAZ,Czechia,CZE,5,109,0,0,114
2011,Kyrgyzstan,KGZ,Czechia,CZE,5,0,0,0,5
2011,Myanmar,MMR,Czechia,CZE,23,0,0,0,23
2011,Russian Federation,RUS,Czechia,CZE,16,10,0,0,26
2011,Somalia,SOM,Czechia,CZE,0,5,0,0,5
2011,Syrian Arab Rep.,SYR,Czechia,CZE,0,10,0,0,10
2011,Togo,TGO,Czechia,CZE,0,5,0,0,5
2011,Ukraine,UKR,Czechia,CZE,12,0,0,0,12
2011,Uzbekistan,UZB,Czechia,CZE,14,5,0,0,19
2011,Stateless,XXA,Czechia,CZE,5,52,0,0,57
2011,Afghanistan,AFG,Denmark,DNK,16,281,846,0,1143
2011,Algeria,DZA,Denmark,DNK,0,0,5,0,5
2011,Armenia,ARM,Denmark,DNK,5,0,13,0,18
2011,Azerbaijan,AZE,Denmark,DNK,0,0,19,0,19
2011,Bangladesh,BGD,Denmark,DNK,0,0,38,0,38
2011,China,CHN,Denmark,DNK,0,0,10,0,10
2011,Cameroon,CMR,Denmark,DNK,0,0,10,0,10
2011,Dem. Rep. of the Congo,COD,Denmark,DNK,5,0,12,0,17
2011,Eritrea,ERI,Denmark,DNK,5,5,5,0,15
2011,Gambia,GMB,Denmark,DNK,0,0,5,0,5
2011,Palestinian,PSE,Denmark,DNK,5,0,13,0,18
2011,Ghana,GHA,Denmark,DNK,0,0,5,0,5
2011,Cote d'Ivoire,CIV,Denmark,DNK,0,0,5,0,5
2011,India,IND,Denmark,DNK,0,0,12,0,12
2011,Iran (Islamic Rep. of),IRN,Denmark,DNK,225,24,270,0,519
2011,Iraq,IRQ,Denmark,DNK,0,11,74,0,85
2011,Jordan,JOR,Denmark,DNK,0,0,15,0,15
2011,Kenya,KEN,Denmark,DNK,0,0,5,0,5
2011,Dem. People's Rep. of Korea,PRK,Denmark,DNK,5,0,0,0,5
2011,Libya,LBY,Denmark,DNK,0,0,5,0,5
2011,Sri Lanka,LKA,Denmark,DNK,5,0,17,0,22
2011,Myanmar,MMR,Denmark,DNK,5,0,14,0,19
2011,Nepal,NPL,Denmark,DNK,0,0,5,0,5
2011,Nigeria,NGA,Denmark,DNK,0,0,18,0,18
2011,Pakistan,PAK,Denmark,DNK,0,0,21,0,21
2011,Russian Federation,RUS,Denmark,DNK,55,42,116,0,213
2011,Serbia and Kosovo: S/RES/1244 (1999),SRB,Denmark,DNK,0,0,5,0,5
2011,Sierra Leone,SLE,Denmark,DNK,0,0,5,0,5
2011,Somalia,SOM,Denmark,DNK,0,5,20,0,25
2011,Viet Nam,VNM,Denmark,DNK,0,0,5,0,5
2011,Sudan,SDN,Denmark,DNK,10,0,10,0,20
2011,Syrian Arab Rep.,SYR,Denmark,DNK,343,10,195,0,548
2011,Uganda,UGA,Denmark,DNK,0,0,20,0,20
2011,Ukraine,UKR,Denmark,DNK,0,0,5,0,5
2011,Stateless,XXA,Denmark,DNK,58,0,36,0,94
2011,Haiti,HTI,Dominican Rep.,DOM,0,0,0,5,5
2011,Afghanistan,AFG,Estonia,EST,0,5,5,0,10
2011,Armenia,ARM,Estonia,EST,0,0,5,0,5
2011,Belarus,BLR,Estonia,EST,5,0,0,0,5
2011,Cameroon,CMR,Estonia,EST,0,0,5,0,5
2011,Dem. Rep. of the Congo,COD,Estonia,EST,0,0,11,0,11
2011,Georgia,GEO,Estonia,EST,0,0,5,0,5
2011,Libya,LBY,Estonia,EST,0,0,5,0,5
2011,Russian Federation,RUS,Estonia,EST,0,0,5,5,10
2011,Uzbekistan,UZB,Estonia,EST,0,0,5,0,5
2011,Stateless,XXA,Estonia,EST,0,0,0,5,5
2011,Afghanistan,AFG,Finland,FIN,10,169,117,81,377
2011,Albania,ALB,Finland,FIN,0,0,0,5,5
2011,Algeria,DZA,Finland,FIN,0,5,0,54,59
2011,Angola,AGO,Finland,FIN,5,30,0,0,35
2011,Egypt,EGY,Finland,FIN,0,0,0,5,5
2011,Armenia,ARM,Finland,FIN,0,0,0,10,10
2011,Azerbaijan,AZE,Finland,FIN,0,0,5,10,15
2011,Burundi,BDI,Finland,FIN,0,0,0,5,5
2011,Bangladesh,BGD,Finland,FIN,0,5,5,11,21
2011,Belarus,BLR,Finland,FIN,0,0,5,67,72
2011,Brazil,BRA,Finland,FIN,0,5,0,0,5
2011,Bosnia and Herzegovina,BIH,Finland,FIN,0,0,0,5,5
2011,Bulgaria,BGR,Finland,FIN,0,0,0,46,46
2011,China,CHN,Finland,FIN,0,11,0,0,11
2011,Chile,CHL,Finland,FIN,0,0,0,5,5
2011,Cameroon,CMR,Finland,FIN,0,0,11,5,16
2011,Congo,COG,Finland,FIN,5,0,0,0,5
2011,Dem. Rep. of the Congo,COD,Finland,FIN,5,17,13,0,35
2011,Cuba,CUB,Finland,FIN,0,0,0,5,5
2011,Eritrea,ERI,Finland,FIN,0,5,0,0,5
2011,Ethiopia,ETH,Finland,FIN,0,12,0,0,12
2011,Gambia,GMB,Finland,FIN,0,5,5,16,26
2011,Georgia,GEO,Finland,FIN,0,0,5,50,55
2011,Ghana,GHA,Finland,FIN,0,12,20,32,64
2011,Guatemala,GTM,Finland,FIN,0,0,5,0,5
2011,Guinea,GIN,Finland,FIN,0,5,0,13,18
2011,Cote d'Ivoire,CIV,Finland,FIN,0,5,0,0,5
2011,India,IND,Finland,FIN,0,0,0,11,11
2011,Iran (Islamic Rep. of),IRN,Finland,FIN,23,32,32,32,119
2011,Iraq,IRQ,Finland,FIN,40,356,58,283,737
2011,Kazakhstan,KAZ,Finland,FIN,0,5,0,10,15
2011,Kenya,KEN,Finland,FIN,0,0,5,0,5
2011,Kyrgyzstan,KGZ,Finland,FIN,0,0,0,5,5
2011,Libya,LBY,Finland,FIN,0,0,0,23,23
2011,Lebanon,LBN,Finland,FIN,0,0,0,5,5
2011,Sri Lanka,LKA,Finland,FIN,0,11,29,14,54
2011,North Macedonia,MKD,Finland,FIN,0,0,0,25,25
2011,Morocco,MAR,Finland,FIN,0,5,0,19,24
2011,Myanmar,MMR,Finland,FIN,0,0,0,5,5
2011,Niger,NER,Finland,FIN,0,0,0,5,5
2011,Nigeria,NGA,Finland,FIN,0,17,31,79,127
2011,Pakistan,PAK,Finland,FIN,5,0,5,19,29
2011,Romania,ROU,Finland,FIN,0,0,0,5,5
2011,Russian Federation,RUS,Finland,FIN,60,58,104,151,373
2011,Rwanda,RWA,Finland,FIN,5,0,0,5,10
2011,Serbia and Kosovo: S/RES/1244 (1999),SRB,Finland,FIN,0,11,42,149,202
2011,Sierra Leone,SLE,Finland,FIN,0,5,0,0,5
2011,Somalia,SOM,Finland,FIN,5,264,45,199,513
2011,Sudan,SDN,Finland,FIN,0,0,0,5,5
2011,Syrian Arab Rep.,SYR,Finland,FIN,5,28,5,10,48
2011,United Rep. of Tanzania,TZA,Finland,FIN,0,0,5,0,5
2011,Togo,TGO,Finland,FIN,0,0,5,0,5
2011,Tunisia,TUN,Finland,FIN,0,0,0,15,15
2011,Turkey,TUR,Finland,FIN,0,14,19,55,88
2011,Ukraine,UKR,Finland,FIN,0,0,0,12,12
2011,Uzbekistan,UZB,Finland,FIN,0,0,5,0,5
2011,Yemen,YEM,Finland,FIN,5,0,0,0,5
2011,Stateless,XXA,Finland,FIN,5,11,5,23,44
2011,Afghanistan,AFG,France,FRA,101,86,304,0,491
2011,Albania,ALB,France,FRA,10,29,424,0,463
2011,Algeria,DZA,France,FRA,31,11,1051,0,1093
2011,Angola,AGO,France,FRA,27,0,385,0,412
2011,Egypt,EGY,France,FRA,5,10,88,0,103
2011,Armenia,ARM,France,FRA,51,10,1764,0,1825
2011,Azerbaijan,AZE,France,FRA,89,0,414,0,503
2011,Burundi,BDI,France,FRA,11,0,5,0,16
2011,Benin,BEN,France,FRA,0,0,14,0,14
2011,Bangladesh,BGD,France,FRA,42,5,3721,0,3768
2011,Bhutan,BTN,France,FRA,0,0,12,0,12
2011,Burkina Faso,BFA,France,FRA,5,0,22,0,27
2011,Belarus,BLR,France,FRA,10,0,63,0,73
2011,Bolivia (Plurinational State of),BOL,France,FRA,0,0,14,0,14
2011,Bosnia and Herzegovina,BIH,France,FRA,13,0,95,0,108
2011,Bulgaria,BGR,France,FRA,0,0,5,0,5
2011,Cambodia,KHM,France,FRA,5,0,18,0,23
2011,Central African Rep.,CAF,France,FRA,10,5,49,0,64
2011,Chad,TCD,France,FRA,19,5,106,0,130
2011,China,CHN,France,FRA,156,0,2088,0,2244
2011,Cameroon,CMR,France,FRA,23,0,169,0,192
2011,Congo,COG,France,FRA,58,10,523,0,591
2011,Dem. Rep. of the Congo,COD,France,FRA,297,10,2327,0,2634
2011,Comoros,COM,France,FRA,49,5,997,0,1051
2011,Colombia,COL,France,FRA,11,0,94,0,105
2011,Cuba,CUB,France,FRA,5,0,5,0,10
2011,Cabo Verde,CPV,France,FRA,0,0,10,0,10
2011,Djibouti,DJI,France,FRA,5,0,5,0,10
2011,Dominican Rep.,DOM,France,FRA,0,0,184,0,184
2011,Equatorial Guinea,GNQ,France,FRA,0,0,5,0,5
2011,Eritrea,ERI,France,FRA,361,5,554,0,920
2011,Ethiopia,ETH,France,FRA,33,5,55,0,93
2011,Gabon,GAB,France,FRA,0,0,11,0,11
2011,Gambia,GMB,France,FRA,0,18,48,0,66
2011,Palestinian,PSE,France,FRA,17,0,40,0,57
2011,Georgia,GEO,France,FRA,34,0,647,0,681
2011,Ghana,GHA,France,FRA,0,0,15,0,15
2011,Guinea-Bissau,GNB,France,FRA,10,5,168,0,183
2011,Guinea,GIN,France,FRA,115,187,1243,0,1545
2011,Guyana,GUY,France,FRA,0,0,86,0,86
2011,Haiti,HTI,France,FRA,78,39,1729,0,1846
2011,Cote d'Ivoire,CIV,France,FRA,38,70,711,0,819
2011,India,IND,France,FRA,0,0,42,0,42
2011,Iran (Islamic Rep. of),IRN,France,FRA,122,0,61,0,183
2011,Iraq,IRQ,France,FRA,155,0,87,0,242
2011,Jamaica,JAM,France,FRA,0,0,5,0,5
2011,Kazakhstan,KAZ,France,FRA,10,0,85,0,95
2011,Kenya,KEN,France,FRA,0,5,18,0,23
2011,Kyrgyzstan,KGZ,France,FRA,5,0,84,0,89
2011,Lao People's Dem. Rep.,LAO,France,FRA,0,0,17,0,17
2011,Liberia,LBR,France,FRA,0,0,28,0,28
2011,Libya,LBY,France,FRA,0,0,24,0,24
2011,Lebanon,LBN,France,FRA,0,0,15,0,15
2011,Sri Lanka,LKA,France,FRA,332,15,2811,0,3158
2011,Madagascar,MDG,France,FRA,10,0,138,0,148
2011,Mauritania,MRT,France,FRA,38,17,1225,0,1280
2011,North Macedonia,MKD,France,FRA,5,0,491,0,496
2011,Rep. of Moldova,MDA,France,FRA,0,0,207,0,207
2011,Mali,MLI,France,FRA,10,378,134,0,522
2011,Mongolia,MNG,France,FRA,10,0,182,0,192
2011,Morocco,MAR,France,FRA,14,0,76,0,90
2011,Montenegro,MNE,France,FRA,0,0,76,0,76
2011,Myanmar,MMR,France,FRA,0,0,69,0,69
2011,Nepal,NPL,France,FRA,0,0,71,0,71
2011,Niger,NER,France,FRA,0,0,12,0,12
2011,Nigeria,NGA,France,FRA,5,23,655,0,683
2011,Pakistan,PAK,France,FRA,17,0,861,0,878
2011,Peru,PER,France,FRA,5,0,99,0,104
2011,Russian Federation,RUS,France,FRA,329,14,2403,0,2746
2011,Rwanda,RWA,France,FRA,88,0,89,0,177
2011,Serbia and Kosovo: S/RES/1244 (1999),SRB,France,FRA,100,10,3649,0,3759
2011,Senegal,SEN,France,FRA,11,53,90,0,154
2011,Sierra Leone,SLE,France,FRA,5,5,99,0,109
2011,Somalia,SOM,France,FRA,49,204,396,0,649
2011,Viet Nam,VNM,France,FRA,0,5,22,0,27
2011,Sudan,SDN,France,FRA,116,0,760,0,876
2011,Syrian Arab Rep.,SYR,France,FRA,33,5,18,0,56
2011,Thailand,THA,France,FRA,0,0,101,0,101
2011,Tajikistan,TJK,France,FRA,0,0,5,0,5
2011,Togo,TGO,France,FRA,23,0,83,0,106
2011,Tunisia,TUN,France,FRA,5,0,142,0,147
2011,Turkey,TUR,France,FRA,77,0,1683,0,1760
2011,Uganda,UGA,France,FRA,5,0,12,0,17
2011,Ukraine,UKR,France,FRA,0,0,74,0,74
2011,Uzbekistan,UZB,France,FRA,0,0,26,0,26
2011,Venezuela (Bolivarian Republic of),VEN,France,FRA,0,0,5,0,5
2011,Western Sahara,ESH,France,FRA,5,0,5,0,10
2011,Yemen,YEM,France,FRA,0,0,5,0,5
2011,Stateless,XXA,France,FRA,55,0,112,0,167
2011,Cote d'Ivoire,CIV,Gambia,GMB,0,0,0,154,154
2011,Afghanistan,AFG,United Kingdom of Great Britain and Northern Ireland,GBR,171,280,978,446,1875
2011,Albania,ALB,United Kingdom of Great Britain and Northern Ireland,GBR,21,52,163,101,337
2011,Algeria,DZA,United Kingdom of Great Britain and Northern Ireland,GBR,12,20,193,139,364
2011,Angola,AGO,United Kingdom of Great Britain and Northern Ireland,GBR,13,5,28,0,46
2011,Egypt,EGY,United Kingdom of Great Britain and Northern Ireland,GBR,45,10,129,23,207
2011,Argentina,ARG,United Kingdom of Great Britain and Northern Ireland,GBR,0,0,5,0,5
2011,Armenia,ARM,United Kingdom of Great Britain and Northern Ireland,GBR,0,0,15,0,15
2011,Australia,AUS,United Kingdom of Great Britain and Northern Ireland,GBR,0,0,5,0,5
2011,Azerbaijan,AZE,United Kingdom of Great Britain and Northern Ireland,GBR,5,0,15,0,20
2011,Bahrain,BHR,United Kingdom of Great Britain and Northern Ireland,GBR,61,0,34,14,109
2011,Burundi,BDI,United Kingdom of Great Britain and Northern Ireland,GBR,11,0,0,0,11
2011,Benin,BEN,United Kingdom of Great Britain and Northern Ireland,GBR,0,0,5,0,5
2011,Bangladesh,BGD,United Kingdom of Great Britain and Northern Ireland,GBR,10,30,431,122,593
2011,Bhutan,BTN,United Kingdom of Great Britain and Northern Ireland,GBR,18,5,5,0,28
2011,Belarus,BLR,United Kingdom of Great Britain and Northern Ireland,GBR,20,0,13,5,38
2011,Bolivia (Plurinational State of),BOL,United Kingdom of Great Britain and Northern Ireland,GBR,0,0,31,12,43
2011,Botswana,BWA,United Kingdom of Great Britain and Northern Ireland,GBR,0,0,13,0,13
2011,Brazil,BRA,United Kingdom of Great Britain and Northern Ireland,GBR,0,0,18,13,31
2011,Bosnia and Herzegovina,BIH,United Kingdom of Great Britain and Northern Ireland,GBR,0,0,0,5,5
2011,Bulgaria,BGR,United Kingdom of Great Britain and Northern Ireland,GBR,0,0,5,5,10
2011,Canada,CAN,United Kingdom of Great Britain and Northern Ireland,GBR,0,0,0,5,5
2011,Chad,TCD,United Kingdom of Great Britain and Northern Ireland,GBR,0,0,12,0,12
2011,China,CHN,United Kingdom of Great Britain and Northern Ireland,GBR,97,131,792,246,1266
2011,Chile,CHL,United Kingdom of Great Britain and Northern Ireland,GBR,0,0,5,0,5
2011,Cameroon,CMR,United Kingdom of Great Britain and Northern Ireland,GBR,22,10,51,10,93
2011,Congo,COG,United Kingdom of Great Britain and Northern Ireland,GBR,0,5,13,0,18
2011,Dem. Rep. of the Congo,COD,United Kingdom of Great Britain and Northern Ireland,GBR,43,28,114,22,207
2011,Colombia,COL,United Kingdom of Great Britain and Northern Ireland,GBR,0,5,18,10,33
2011,Dominica,DMA,United Kingdom of Great Britain and Northern Ireland,GBR,0,5,0,0,5
2011,Ecuador,ECU,United Kingdom of Great Britain and Northern Ireland,GBR,12,0,0,0,12
2011,Eritrea,ERI,United Kingdom of Great Britain and Northern Ireland,GBR,643,34,171,121,969
2011,Ethiopia,ETH,United Kingdom of Great Britain and Northern Ireland,GBR,37,5,67,12,121
2011,France,FRA,United Kingdom of Great Britain and Northern Ireland,GBR,0,0,0,5,5
2011,Gambia,GMB,United Kingdom of Great Britain and Northern Ireland,GBR,114,41,206,19,380
2011,Palestinian,PSE,United Kingdom of Great Britain and Northern Ireland,GBR,17,14,133,71,235
2011,Georgia,GEO,United Kingdom of Great Britain and Northern Ireland,GBR,5,0,40,12,57
2011,Ghana,GHA,United Kingdom of Great Britain and Northern Ireland,GBR,5,16,126,34,181
2011,Guinea,GIN,United Kingdom of Great Britain and Northern Ireland,GBR,25,5,37,5,72
2011,Guyana,GUY,United Kingdom of Great Britain and Northern Ireland,GBR,0,0,5,0,5
2011,"China, Hong Kong SAR",HKG,United Kingdom of Great Britain and Northern Ireland,GBR,0,5,0,0,5
2011,Honduras,HND,United Kingdom of Great Britain and Northern Ireland,GBR,0,0,11,0,11
2011,Croatia,HRV,United Kingdom of Great Britain and Northern Ireland,GBR,0,0,5,0,5
2011,Cote d'Ivoire,CIV,United Kingdom of Great Britain and Northern Ireland,GBR,16,10,119,14,159
2011,India,IND,United Kingdom of Great Britain and Northern Ireland,GBR,0,19,372,243,634
2011,Indonesia,IDN,United Kingdom of Great Britain and Northern Ireland,GBR,0,0,5,5,10
2011,Iran (Islamic Rep. of),IRN,United Kingdom of Great Britain and Northern Ireland,GBR,1147,126,1330,215,2818
2011,Iraq,IRQ,United Kingdom of Great Britain and Northern Ireland,GBR,62,51,299,78,490
2011,Israel,ISR,United Kingdom of Great Britain and Northern Ireland,GBR,0,5,0,5,10
2011,Jamaica,JAM,United Kingdom of Great Britain and Northern Ireland,GBR,24,26,103,22,175
2011,Jordan,JOR,United Kingdom of Great Britain and Northern Ireland,GBR,0,0,17,5,22
2011,Japan,JPN,United Kingdom of Great Britain and Northern Ireland,GBR,0,0,5,0,5
2011,Kazakhstan,KAZ,United Kingdom of Great Britain and Northern Ireland,GBR,0,0,5,0,5
2011,Kenya,KEN,United Kingdom of Great Britain and Northern Ireland,GBR,23,11,92,15,141
2011,Rep. of Korea,KOR,United Kingdom of Great Britain and Northern Ireland,GBR,0,0,5,0,5
2011,Dem. People's Rep. of Korea,PRK,United Kingdom of Great Britain and Northern Ireland,GBR,10,5,46,5,66
2011,Kuwait,KWT,United Kingdom of Great Britain and Northern Ireland,GBR,35,0,29,17,81
2011,Liberia,LBR,United Kingdom of Great Britain and Northern Ireland,GBR,0,0,12,5,17
2011,Libya,LBY,United Kingdom of Great Britain and Northern Ireland,GBR,121,66,721,116,1024
2011,Saint Lucia,LCA,United Kingdom of Great Britain and Northern Ireland,GBR,0,0,5,0,5
2011,Lebanon,LBN,United Kingdom of Great Britain and Northern Ireland,GBR,5,0,46,0,51
2011,Sri Lanka,LKA,United Kingdom of Great Britain and Northern Ireland,GBR,349,39,1522,138,2048
2011,Lithuania,LTU,United Kingdom of Great Britain and Northern Ireland,GBR,0,0,0,5,5
2011,North Macedonia,MKD,United Kingdom of Great Britain and Northern Ireland,GBR,0,5,0,5,10
2011,Rep. of Moldova,MDA,United Kingdom of Great Britain and Northern Ireland,GBR,0,5,0,5,10
2011,Mexico,MEX,United Kingdom of Great Britain and Northern Ireland,GBR,0,0,10,0,10
2011,Mali,MLI,United Kingdom of Great Britain and Northern Ireland,GBR,0,5,5,0,10
2011,Malaysia,MYS,United Kingdom of Great Britain and Northern Ireland,GBR,11,0,50,11,72
2011,Malawi,MWI,United Kingdom of Great Britain and Northern Ireland,GBR,5,24,138,10,177
2011,Mongolia,MNG,United Kingdom of Great Britain and Northern Ireland,GBR,11,10,47,5,73
2011,Morocco,MAR,United Kingdom of Great Britain and Northern Ireland,GBR,5,17,41,26,89
2011,Mauritius,MUS,United Kingdom of Great Britain and Northern Ireland,GBR,0,5,50,5,60
2011,Myanmar,MMR,United Kingdom of Great Britain and Northern Ireland,GBR,98,5,80,0,183
2011,Namibia,NAM,United Kingdom of Great Britain and Northern Ireland,GBR,0,0,13,5,18
2011,Nepal,NPL,United Kingdom of Great Britain and Northern Ireland,GBR,0,0,36,5,41
2011,Nigeria,NGA,United Kingdom of Great Britain and Northern Ireland,GBR,30,106,815,141,1092
2011,Nauru,NRU,United Kingdom of Great Britain and Northern Ireland,GBR,0,0,5,0,5
2011,Oman,OMN,United Kingdom of Great Britain and Northern Ireland,GBR,0,0,5,0,5
2011,Pakistan,PAK,United Kingdom of Great Britain and Northern Ireland,GBR,385,70,2669,286,3410
2011,Peru,PER,United Kingdom of Great Britain and Northern Ireland,GBR,0,0,0,5,5
2011,Philippines,PHL,United Kingdom of Great Britain and Northern Ireland,GBR,0,0,14,0,14
2011,Poland,POL,United Kingdom of Great Britain and Northern Ireland,GBR,0,0,10,0,10
2011,Romania,ROU,United Kingdom of Great Britain and Northern Ireland,GBR,0,0,0,10,10
2011,South Africa,ZAF,United Kingdom of Great Britain and Northern Ireland,GBR,5,12,97,10,124
2011,Russian Federation,RUS,United Kingdom of Great Britain and Northern Ireland,GBR,22,5,50,16,93
2011,Rwanda,RWA,United Kingdom of Great Britain and Northern Ireland,GBR,5,15,15,5,40
2011,Saudi Arabia,SAU,United Kingdom of Great Britain and Northern Ireland,GBR,13,0,5,0,18
2011,Serbia and Kosovo: S/RES/1244 (1999),SRB,United Kingdom of Great Britain and Northern Ireland,GBR,5,5,10,33,53
2011,Senegal,SEN,United Kingdom of Great Britain and Northern Ireland,GBR,10,0,36,0,46
2011,Sierra Leone,SLE,United Kingdom of Great Britain and Northern Ireland,GBR,22,10,59,11,102
2011,Somalia,SOM,United Kingdom of Great Britain and Northern Ireland,GBR,410,60,164,82,716
2011,Viet Nam,VNM,United Kingdom of Great Britain and Northern Ireland,GBR,11,48,89,183,331
2011,Sudan,SDN,United Kingdom of Great Britain and Northern Ireland,GBR,544,0,109,109,762
2011,Slovakia,SVK,United Kingdom of Great Britain and Northern Ireland,GBR,0,0,0,5,5
2011,Syrian Arab Rep.,SYR,United Kingdom of Great Britain and Northern Ireland,GBR,142,5,192,21,360
2011,United Rep. of Tanzania,TZA,United Kingdom of Great Britain and Northern Ireland,GBR,0,10,36,5,51
2011,Thailand,THA,United Kingdom of Great Britain and Northern Ireland,GBR,0,0,5,5,10
2011,Tajikistan,TJK,United Kingdom of Great Britain and Northern Ireland,GBR,0,0,5,0,5
2011,Togo,TGO,United Kingdom of Great Britain and Northern Ireland,GBR,0,0,0,5,5
2011,Trinidad and Tobago,TTO,United Kingdom of Great Britain and Northern Ireland,GBR,0,0,14,0,14
2011,Tunisia,TUN,United Kingdom of Great Britain and Northern Ireland,GBR,0,0,24,13,37
2011,Turkey,TUR,United Kingdom of Great Britain and Northern Ireland,GBR,28,15,126,26,195
2011,United Arab Emirates,ARE,United Kingdom of Great Britain and Northern Ireland,GBR,0,5,0,0,5
2011,Uganda,UGA,United Kingdom of Great Britain and Northern Ireland,GBR,91,13,165,24,293
2011,Ukraine,UKR,United Kingdom of Great Britain and Northern Ireland,GBR,0,0,30,10,40
2011,United States of America,USA,United Kingdom of Great Britain and Northern Ireland,GBR,0,0,17,18,35
2011,Uzbekistan,UZB,United Kingdom of Great Britain and Northern Ireland,GBR,13,0,11,0,24
2011,Venezuela (Bolivarian Republic of),VEN,United Kingdom of Great Britain and Northern Ireland,GBR,5,0,16,0,21
2011,Yemen,YEM,United Kingdom of Great Britain and Northern Ireland,GBR,10,13,31,5,59
2011,Zambia,ZMB,United Kingdom of Great Britain and Northern Ireland,GBR,5,5,11,0,21
2011,Zimbabwe,ZWE,United Kingdom of Great Britain and Northern Ireland,GBR,112,141,571,32,856
2011,Stateless,XXA,United Kingdom of Great Britain and Northern Ireland,GBR,68,5,80,29,182
2011,Burundi,BDI,Guinea-Bissau,GNB,0,0,0,5,5
2011,Guinea,GIN,Guinea-Bissau,GNB,0,0,0,5,5
2011,Cote d'Ivoire,CIV,Guinea-Bissau,GNB,13,0,0,33,46
2011,Liberia,LBR,Guinea-Bissau,GNB,0,0,0,59,59
2011,Nigeria,NGA,Guinea-Bissau,GNB,0,0,5,5,10
2011,Senegal,SEN,Guinea-Bissau,GNB,0,0,0,165,165
2011,Sudan,SDN,Guinea-Bissau,GNB,0,0,0,5,5
2011,Afghanistan,AFG,Greece,GRC,12,23,285,93,413
2011,Albania,ALB,Greece,GRC,5,0,419,53,477
2011,Algeria,DZA,Greece,GRC,0,0,125,12,137
2011,Egypt,EGY,Greece,GRC,0,0,206,37,243
2011,Argentina,ARG,Greece,GRC,0,0,0,5,5
2011,Armenia,ARM,Greece,GRC,0,0,54,35,89
2011,Burundi,BDI,Greece,GRC,0,0,5,0,5
2011,Bangladesh,BGD,Greece,GRC,0,5,1047,79,1131
2011,Burkina Faso,BFA,Greece,GRC,0,0,19,5,24
2011,Belarus,BLR,Greece,GRC,0,0,10,0,10
2011,Central African Rep.,CAF,Greece,GRC,0,0,17,0,17
2011,China,CHN,Greece,GRC,0,0,355,45,400
2011,Cameroon,CMR,Greece,GRC,0,0,0,5,5
2011,Congo,COG,Greece,GRC,5,0,0,0,5
2011,Dem. Rep. of the Congo,COD,Greece,GRC,0,0,5,0,5
2011,Cuba,CUB,Greece,GRC,0,0,0,5,5
2011,Dominica,DMA,Greece,GRC,0,0,20,0,20
2011,Dominican Rep.,DOM,Greece,GRC,0,0,69,16,85
2011,Eritrea,ERI,Greece,GRC,0,0,15,0,15
2011,Ethiopia,ETH,Greece,GRC,0,0,22,23,45
2011,Gambia,GMB,Greece,GRC,0,0,21,0,21
2011,Palestinian,PSE,Greece,GRC,0,0,20,10,30
2011,Georgia,GEO,Greece,GRC,0,10,1280,416,1706
2011,Ghana,GHA,Greece,GRC,0,0,119,10,129
2011,Guinea,GIN,Greece,GRC,0,10,26,5,41
2011,Cote d'Ivoire,CIV,Greece,GRC,0,0,14,0,14
2011,India,IND,Greece,GRC,0,0,148,37,185
2011,Indonesia,IDN,Greece,GRC,0,0,10,0,10
2011,Iran (Islamic Rep. of),IRN,Greece,GRC,5,5,102,25,137
2011,Iraq,IRQ,Greece,GRC,10,5,217,86,318
2011,Kazakhstan,KAZ,Greece,GRC,0,0,5,0,5
2011,Kenya,KEN,Greece,GRC,0,0,10,10,20
2011,Liberia,LBR,Greece,GRC,0,0,10,0,10
2011,Libya,LBY,Greece,GRC,0,0,5,0,5
2011,Lebanon,LBN,Greece,GRC,0,0,0,14,14
2011,Sri Lanka,LKA,Greece,GRC,0,0,26,0,26
2011,Mauritania,MRT,Greece,GRC,0,0,5,0,5
2011,Rep. of Moldova,MDA,Greece,GRC,0,0,24,20,44
2011,Mali,MLI,Greece,GRC,0,0,5,0,5
2011,Morocco,MAR,Greece,GRC,0,0,84,26,110
2011,Myanmar,MMR,Greece,GRC,0,0,11,0,11
2011,Nepal,NPL,Greece,GRC,0,0,0,5,5
2011,Niger,NER,Greece,GRC,0,0,53,0,53
2011,Nigeria,NGA,Greece,GRC,0,0,329,149,478
2011,Pakistan,PAK,Greece,GRC,0,5,2628,404,3037
2011,Philippines,PHL,Greece,GRC,0,0,15,0,15
2011,Russian Federation,RUS,Greece,GRC,0,0,78,31,109
2011,Rwanda,RWA,Greece,GRC,0,0,19,0,19
2011,Serbia and Kosovo: S/RES/1244 (1999),SRB,Greece,GRC,0,0,5,0,5
2011,Senegal,SEN,Greece,GRC,0,0,123,41,164
2011,Sierra Leone,SLE,Greece,GRC,0,0,20,5,25
2011,Somalia,SOM,Greece,GRC,0,5,41,5,51
2011,Sudan,SDN,Greece,GRC,0,5,27,0,32
2011,Syrian Arab Rep.,SYR,Greece,GRC,5,0,145,42,192
2011,United Rep. of Tanzania,TZA,Greece,GRC,0,0,10,0,10
2011,Turkmenistan,TKM,Greece,GRC,0,0,0,5,5
2011,Timor-Leste,TLS,Greece,GRC,0,0,5,0,5
2011,Togo,TGO,Greece,GRC,0,0,5,0,5
2011,Tunisia,TUN,Greece,GRC,0,0,27,5,32
2011,Turkey,TUR,Greece,GRC,0,5,5,13,23
2011,Uganda,UGA,Greece,GRC,0,5,0,5,10
2011,Ukraine,UKR,Greece,GRC,0,0,41,14,55
2011,Uzbekistan,UZB,Greece,GRC,0,5,5,0,10
2011,Cuba,CUB,Guatemala,GTM,0,0,0,5,5
2011,El Salvador,SLV,Guatemala,GTM,5,0,0,0,5
2011,Afghanistan,AFG,Croatia,HRV,0,0,13,357,370
2011,Algeria,DZA,Croatia,HRV,0,0,0,5,5
2011,Belgium,BEL,Croatia,HRV,0,0,5,0,5
2011,Bosnia and Herzegovina,BIH,Croatia,HRV,0,0,5,0,5
2011,Eritrea,ERI,Croatia,HRV,0,0,0,5,5
2011,Palestinian,PSE,Croatia,HRV,0,0,5,28,33
2011,Iran (Islamic Rep. of),IRN,Croatia,HRV,0,0,5,30,35
2011,Iraq,IRQ,Croatia,HRV,0,0,0,14,14
2011,Libya,LBY,Croatia,HRV,0,0,0,14,14
2011,Morocco,MAR,Croatia,HRV,0,0,0,5,5
2011,Pakistan,PAK,Croatia,HRV,0,0,5,66,71
2011,Serbia and Kosovo: S/RES/1244 (1999),SRB,Croatia,HRV,0,0,0,5,5
2011,Somalia,SOM,Croatia,HRV,0,0,0,15,15
2011,Sudan,SDN,Croatia,HRV,0,0,0,5,5
2011,Syrian Arab Rep.,SYR,Croatia,HRV,0,0,5,5,10
2011,Tunisia,TUN,Croatia,HRV,0,0,0,14,14
2011,Turkey,TUR,Croatia,HRV,0,0,0,5,5
2011,Western Sahara,ESH,Croatia,HRV,0,0,0,5,5
2011,Stateless,XXA,Croatia,HRV,0,0,5,0,5
2011,Afghanistan,AFG,Hungary,HUN,10,78,301,229,618
2011,Algeria,DZA,Hungary,HUN,0,0,18,14,32
2011,Egypt,EGY,Hungary,HUN,0,0,5,10,15
2011,Armenia,ARM,Hungary,HUN,0,0,11,0,11
2011,China,CHN,Hungary,HUN,0,0,5,5,10
2011,Cameroon,CMR,Hungary,HUN,5,0,0,0,5
2011,Dem. Rep. of the Congo,COD,Hungary,HUN,0,0,11,0,11
2011,Palestinian,PSE,Hungary,HUN,0,0,17,14,31
2011,Georgia,GEO,Hungary,HUN,0,0,11,13,24
2011,Guinea,GIN,Hungary,HUN,0,0,5,0,5
2011,Cote d'Ivoire,CIV,Hungary,HUN,0,0,0,5,5
2011,India,IND,Hungary,HUN,0,0,5,0,5
2011,Iran (Islamic Rep. of),IRN,Hungary,HUN,5,0,11,20,36
2011,Iraq,IRQ,Hungary,HUN,0,5,18,23,46
2011,Libya,LBY,Hungary,HUN,0,13,0,0,13
2011,Lebanon,LBN,Hungary,HUN,0,0,11,0,11
2011,Sri Lanka,LKA,Hungary,HUN,5,0,0,0,5
2011,North Macedonia,MKD,Hungary,HUN,0,0,5,0,5
2011,Rep. of Moldova,MDA,Hungary,HUN,0,0,5,5,10
2011,Mongolia,MNG,Hungary,HUN,0,0,5,0,5
2011,Morocco,MAR,Hungary,HUN,0,0,0,16,16
2011,Nigeria,NGA,Hungary,HUN,0,0,13,10,23
2011,Pakistan,PAK,Hungary,HUN,0,0,40,23,63
2011,Russian Federation,RUS,Hungary,HUN,0,0,5,5,10
2011,Serbia and Kosovo: S/RES/1244 (1999),SRB,Hungary,HUN,0,0,134,98,232
2011,Sierra Leone,SLE,Hungary,HUN,0,0,5,0,5
2011,Somalia,SOM,Hungary,HUN,0,0,11,5,16
2011,Viet Nam,VNM,Hungary,HUN,0,0,5,5,10
2011,Sudan,SDN,Hungary,HUN,5,0,0,0,5
2011,Syrian Arab Rep.,SYR,Hungary,HUN,0,5,16,50,71
2011,Tunisia,TUN,Hungary,HUN,0,0,15,10,25
2011,Turkey,TUR,Hungary,HUN,0,0,19,19,38
2011,Ukraine,UKR,Hungary,HUN,0,0,0,5,5
2011,Zimbabwe,ZWE,Hungary,HUN,0,0,5,0,5
2011,Ethiopia,ETH,Iceland,ISL,0,0,0,5,5
2011,India,IND,Iceland,ISL,0,0,0,5,5
2011,Iran (Islamic Rep. of),IRN,Iceland,ISL,5,0,0,0,5
2011,Iraq,IRQ,Iceland,ISL,0,0,0,5,5
2011,North Macedonia,MKD,Iceland,ISL,0,0,5,0,5
2011,Somalia,SOM,Iceland,ISL,0,5,0,0,5
2011,Syrian Arab Rep.,SYR,Iceland,ISL,0,0,0,5,5
2011,Afghanistan,AFG,Ireland,IRL,5,0,48,21,74
2011,Albania,ALB,Ireland,IRL,0,0,34,0,34
2011,Algeria,DZA,Ireland,IRL,0,0,46,5,51
2011,Angola,AGO,Ireland,IRL,0,0,5,0,5
2011,Egypt,EGY,Ireland,IRL,0,0,17,5,22
2011,Bangladesh,BGD,Ireland,IRL,0,0,20,11,31
2011,Bolivia (Plurinational State of),BOL,Ireland,IRL,0,0,10,0,10
2011,China,CHN,Ireland,IRL,0,0,179,11,190
2011,Chile,CHL,Ireland,IRL,0,0,5,0,5
2011,Cameroon,CMR,Ireland,IRL,0,0,37,0,37
2011,Congo,COG,Ireland,IRL,0,0,5,0,5
2011,Dem. Rep. of the Congo,COD,Ireland,IRL,0,0,76,18,94
2011,Eritrea,ERI,Ireland,IRL,0,0,5,5,10
2011,Ethiopia,ETH,Ireland,IRL,0,0,5,5,10
2011,Palestinian,PSE,Ireland,IRL,5,0,11,0,16
2011,Georgia,GEO,Ireland,IRL,0,0,26,0,26
2011,Ghana,GHA,Ireland,IRL,0,0,27,5,32
2011,Cote d'Ivoire,CIV,Ireland,IRL,0,0,11,0,11
2011,India,IND,Ireland,IRL,0,0,10,5,15
2011,Iran (Islamic Rep. of),IRN,Ireland,IRL,10,0,25,5,40
2011,Iraq,IRQ,Ireland,IRL,0,0,17,14,31
2011,Kyrgyzstan,KGZ,Ireland,IRL,5,0,0,5,10
2011,Libya,LBY,Ireland,IRL,0,0,5,0,5
2011,Sri Lanka,LKA,Ireland,IRL,0,0,0,13,13
2011,Rep. of Moldova,MDA,Ireland,IRL,0,0,29,0,29
2011,Malawi,MWI,Ireland,IRL,0,0,20,5,25
2011,Mongolia,MNG,Ireland,IRL,0,0,10,0,10
2011,Mauritius,MUS,Ireland,IRL,0,0,15,0,15
2011,Nepal,NPL,Ireland,IRL,0,0,5,5,10
2011,Nigeria,NGA,Ireland,IRL,0,0,228,43,271
2011,Pakistan,PAK,Ireland,IRL,12,0,161,54,227
2011,South Africa,ZAF,Ireland,IRL,0,0,51,5,56
2011,Russian Federation,RUS,Ireland,IRL,5,0,14,0,19
2011,Rwanda,RWA,Ireland,IRL,0,0,10,0,10
2011,Serbia and Kosovo: S/RES/1244 (1999),SRB,Ireland,IRL,0,0,13,0,13
2011,Somalia,SOM,Ireland,IRL,5,0,17,10,32
2011,Sudan,SDN,Ireland,IRL,0,0,10,5,15
2011,Eswatini,SWZ,Ireland,IRL,5,0,0,0,5
2011,Syrian Arab Rep.,SYR,Ireland,IRL,0,0,5,0,5
2011,United Rep. of Tanzania,TZA,Ireland,IRL,0,0,5,0,5
2011,Togo,TGO,Ireland,IRL,0,0,0,5,5
2011,Uganda,UGA,Ireland,IRL,0,0,17,0,17
2011,Ukraine,UKR,Ireland,IRL,0,0,5,0,5
2011,Yemen,YEM,Ireland,IRL,0,0,10,0,10
2011,Zimbabwe,ZWE,Ireland,IRL,0,0,69,5,74
2011,Stateless,XXA,Ireland,IRL,0,0,0,5,5
2011,Dem. Rep. of the Congo,COD,Israel,ISR,0,0,96,0,96
2011,Colombia,COL,Israel,ISR,0,0,29,0,29
2011,Eritrea,ERI,Israel,ISR,0,0,10,0,10
2011,Ethiopia,ETH,Israel,ISR,0,0,108,0,108
2011,Ghana,GHA,Israel,ISR,0,0,38,0,38
2011,Cote d'Ivoire,CIV,Israel,ISR,0,0,97,0,97
2011,Mongolia,MNG,Israel,ISR,0,0,5,0,5
2011,Myanmar,MMR,Israel,ISR,0,0,30,0,30
2011,Nigeria,NGA,Israel,ISR,0,0,61,0,61
2011,Sudan,SDN,Israel,ISR,0,0,5,0,5
2011,Afghanistan,AFG,Italy,ITA,165,544,370,0,1079
2011,Albania,ALB,Italy,ITA,0,10,21,0,31
2011,Algeria,DZA,Italy,ITA,5,0,94,0,99
2011,Angola,AGO,Italy,ITA,0,0,5,0,5
2011,Egypt,EGY,Italy,ITA,24,23,72,0,119
2011,Armenia,ARM,Italy,ITA,5,10,30,0,45
2011,Azerbaijan,AZE,Italy,ITA,15,5,0,0,20
2011,Benin,BEN,Italy,ITA,0,0,37,0,37
2011,Bangladesh,BGD,Italy,ITA,11,29,799,0,839
2011,Burkina Faso,BFA,Italy,ITA,5,20,421,0,446
2011,Brazil,BRA,Italy,ITA,0,0,10,0,10
2011,Bosnia and Herzegovina,BIH,Italy,ITA,0,0,510,0,510
2011,Central African Rep.,CAF,Italy,ITA,0,0,5,0,5
2011,Chad,TCD,Italy,ITA,13,23,94,0,130
2011,China,CHN,Italy,ITA,0,5,26,0,31
2011,Cameroon,CMR,Italy,ITA,13,12,85,0,110
2011,Congo,COG,Italy,ITA,24,10,61,0,95
2011,Dem. Rep. of the Congo,COD,Italy,ITA,21,14,40,0,75
2011,Colombia,COL,Italy,ITA,10,0,27,0,37
2011,Cuba,CUB,Italy,ITA,0,0,28,0,28
2011,Equatorial Guinea,GNQ,Italy,ITA,0,5,0,0,5
2011,Eritrea,ERI,Italy,ITA,257,117,64,0,438
2011,Ethiopia,ETH,Italy,ITA,81,26,80,0,187
2011,Gabon,GAB,Italy,ITA,0,0,10,0,10
2011,Gambia,GMB,Italy,ITA,5,11,154,0,170
2011,Palestinian,PSE,Italy,ITA,29,5,30,0,64
2011,Georgia,GEO,Italy,ITA,5,0,45,0,50
2011,Ghana,GHA,Italy,ITA,10,44,1449,0,1503
2011,Guinea-Bissau,GNB,Italy,ITA,0,0,70,0,70
2011,Guinea,GIN,Italy,ITA,33,22,246,0,301
2011,Haiti,HTI,Italy,ITA,10,0,0,0,10
2011,Honduras,HND,Italy,ITA,0,0,10,0,10
2011,Croatia,HRV,Italy,ITA,0,0,36,0,36
2011,Cote d'Ivoire,CIV,Italy,ITA,63,204,926,0,1193
2011,India,IND,Italy,ITA,0,5,20,0,25
2011,Iran (Islamic Rep. of),IRN,Italy,ITA,126,18,78,0,222
2011,Iraq,IRQ,Italy,ITA,42,129,113,0,284
2011,Kenya,KEN,Italy,ITA,5,0,23,0,28
2011,Kyrgyzstan,KGZ,Italy,ITA,0,0,5,0,5
2011,Liberia,LBR,Italy,ITA,0,0,73,0,73
2011,Libya,LBY,Italy,ITA,11,56,77,0,144
2011,Lebanon,LBN,Italy,ITA,0,5,12,0,17
2011,Sri Lanka,LKA,Italy,ITA,10,5,50,0,65
2011,Madagascar,MDG,Italy,ITA,0,0,5,0,5
2011,Mauritania,MRT,Italy,ITA,14,5,29,0,48
2011,North Macedonia,MKD,Italy,ITA,0,0,36,0,36
2011,Rep. of Moldova,MDA,Italy,ITA,0,5,11,0,16
2011,Mexico,MEX,Italy,ITA,0,0,5,0,5
2011,Mali,MLI,Italy,ITA,5,17,1233,0,1255
2011,Morocco,MAR,Italy,ITA,10,5,154,0,169
2011,Montenegro,MNE,Italy,ITA,0,0,21,0,21
2011,Nepal,NPL,Italy,ITA,0,0,5,0,5
2011,Niger,NER,Italy,ITA,0,11,182,0,193
2011,Nigeria,NGA,Italy,ITA,41,138,2958,0,3137
2011,Pakistan,PAK,Italy,ITA,89,311,1127,0,1527
2011,Russian Federation,RUS,Italy,ITA,10,5,13,0,28
2011,Rwanda,RWA,Italy,ITA,0,0,5,0,5
2011,El Salvador,SLV,Italy,ITA,0,0,14,0,14
2011,Serbia and Kosovo: S/RES/1244 (1999),SRB,Italy,ITA,10,34,263,0,307
2011,Senegal,SEN,Italy,ITA,35,28,321,0,384
2011,Sierra Leone,SLE,Italy,ITA,5,15,47,0,67
2011,Somalia,SOM,Italy,ITA,253,411,37,0,701
2011,Sudan,SDN,Italy,ITA,145,62,102,0,309
2011,Syrian Arab Rep.,SYR,Italy,ITA,31,20,57,0,108
2011,United Rep. of Tanzania,TZA,Italy,ITA,0,0,5,0,5
2011,Thailand,THA,Italy,ITA,0,0,5,0,5
2011,Togo,TGO,Italy,ITA,5,14,157,0,176
2011,Tunisia,TUN,Italy,ITA,11,38,3258,0,3307
2011,Turkey,TUR,Italy,ITA,120,39,555,0,714
2011,Uganda,UGA,Italy,ITA,0,0,10,0,10
2011,Ukraine,UKR,Italy,ITA,0,0,19,0,19
2011,Venezuela (Bolivarian Republic of),VEN,Italy,ITA,0,0,5,0,5
2011,Yemen,YEM,Italy,ITA,10,0,0,0,10
2011,Zimbabwe,ZWE,Italy,ITA,5,0,0,0,5
2011,Angola,AGO,Japan,JPN,0,0,10,0,10
2011,Bangladesh,BGD,Japan,JPN,0,0,71,0,71
2011,Brazil,BRA,Japan,JPN,0,0,0,5,5
2011,China,CHN,Japan,JPN,0,5,27,0,28
2011,Cameroon,CMR,Japan,JPN,0,5,32,0,33
2011,Congo,COG,Japan,JPN,0,0,10,0,10
2011,Dem. Rep. of the Congo,COD,Japan,JPN,0,5,15,0,15
2011,Ethiopia,ETH,Japan,JPN,0,0,34,0,35
2011,Palestinian,PSE,Japan,JPN,0,5,14,0,14
2011,Ghana,GHA,Japan,JPN,0,0,15,0,15
2011,Guinea,GIN,Japan,JPN,0,0,5,0,5
2011,Cote d'Ivoire,CIV,Japan,JPN,0,0,5,0,5
2011,India,IND,Japan,JPN,0,0,92,5,97
2011,Indonesia,IDN,Japan,JPN,0,0,5,0,5
2011,Iran (Islamic Rep. of),IRN,Japan,JPN,0,0,43,0,46
2011,Iraq,IRQ,Japan,JPN,0,0,0,5,5
2011,Liberia,LBR,Japan,JPN,0,0,5,0,5
2011,Sri Lanka,LKA,Japan,JPN,0,10,278,12,290
2011,Mali,MLI,Japan,JPN,0,0,5,0,5
2011,Malaysia,MYS,Japan,JPN,0,0,5,0,5
2011,Myanmar,MMR,Japan,JPN,5,136,583,15,604
2011,Nepal,NPL,Japan,JPN,0,0,208,16,224
2011,Nigeria,NGA,Japan,JPN,0,0,51,5,54
2011,Pakistan,PAK,Japan,JPN,0,0,154,10,163
2011,Peru,PER,Japan,JPN,0,0,5,0,5
2011,Philippines,PHL,Japan,JPN,0,0,18,0,18
2011,Senegal,SEN,Japan,JPN,0,0,5,0,5
2011,Viet Nam,VNM,Japan,JPN,0,0,5,0,5
2011,Sudan,SDN,Japan,JPN,0,0,5,0,5
2011,United Rep. of Tanzania,TZA,Japan,JPN,0,0,5,0,5
2011,Tunisia,TUN,Japan,JPN,0,0,5,0,5
2011,Turkey,TUR,Japan,JPN,0,5,221,23,244
2011,Uganda,UGA,Japan,JPN,0,5,45,0,46
2011,Afghanistan,AFG,Kazakhstan,KAZ,15,0,5,0,20
2011,China,CHN,Kazakhstan,KAZ,0,0,14,18,32
2011,Palestinian,PSE,Kazakhstan,KAZ,0,0,5,0,5
2011,Kyrgyzstan,KGZ,Kazakhstan,KAZ,0,0,10,0,10
2011,Russian Federation,RUS,Kazakhstan,KAZ,0,0,0,5,5
2011,Uzbekistan,UZB,Kazakhstan,KAZ,0,0,5,216,221
2011,Afghanistan,AFG,Kyrgyzstan,KGZ,0,0,57,5,62
2011,Iran (Islamic Rep. of),IRN,Kyrgyzstan,KGZ,0,0,10,0,10
2011,Iraq,IRQ,Kyrgyzstan,KGZ,0,0,0,5,5
2011,Kazakhstan,KAZ,Kyrgyzstan,KGZ,0,0,10,0,10
2011,Russian Federation,RUS,Kyrgyzstan,KGZ,0,0,0,15,15
2011,Uzbekistan,UZB,Kyrgyzstan,KGZ,0,0,0,32,32
2011,Afghanistan,AFG,Liechtenstein,LIE,0,0,0,5,5
2011,Eritrea,ERI,Liechtenstein,LIE,0,5,0,0,5
2011,Kyrgyzstan,KGZ,Liechtenstein,LIE,0,0,0,5,5
2011,Nigeria,NGA,Liechtenstein,LIE,0,0,0,5,5
2011,Russian Federation,RUS,Liechtenstein,LIE,0,0,0,10,10
2011,Serbia and Kosovo: S/RES/1244 (1999),SRB,Liechtenstein,LIE,0,0,16,15,31
2011,Somalia,SOM,Liechtenstein,LIE,0,5,0,0,5
2011,Afghanistan,AFG,Lithuania,LTU,0,5,5,19,29
2011,Armenia,ARM,Lithuania,LTU,0,0,5,19,24
2011,Belarus,BLR,Lithuania,LTU,5,0,0,5,10
2011,Georgia,GEO,Lithuania,LTU,0,0,189,52,241
2011,Kyrgyzstan,KGZ,Lithuania,LTU,0,0,14,5,19
2011,Russian Federation,RUS,Lithuania,LTU,0,5,17,26,48
2011,Tajikistan,TJK,Lithuania,LTU,0,0,0,5,5
2011,Uzbekistan,UZB,Lithuania,LTU,0,0,5,0,5
2011,Afghanistan,AFG,Luxembourg,LUX,0,0,10,0,10
2011,Albania,ALB,Luxembourg,LUX,0,0,11,0,11
2011,Algeria,DZA,Luxembourg,LUX,0,0,5,0,5
2011,Belarus,BLR,Luxembourg,LUX,0,0,5,0,5
2011,Bosnia and Herzegovina,BIH,Luxembourg,LUX,0,0,19,0,19
2011,Iran (Islamic Rep. of),IRN,Luxembourg,LUX,5,0,0,0,5
2011,Iraq,IRQ,Luxembourg,LUX,10,0,10,0,20
2011,Israel,ISR,Luxembourg,LUX,0,0,5,0,5
2011,North Macedonia,MKD,Luxembourg,LUX,0,0,148,0,148
2011,Mexico,MEX,Luxembourg,LUX,0,0,5,0,5
2011,Montenegro,MNE,Luxembourg,LUX,0,0,35,0,35
2011,Serbia and Kosovo: S/RES/1244 (1999),SRB,Luxembourg,LUX,5,0,467,0,472
2011,Syrian Arab Rep.,SYR,Luxembourg,LUX,0,0,5,0,5
2011,Afghanistan,AFG,Latvia,LVA,0,11,0,0,11
2011,Cameroon,CMR,Latvia,LVA,0,0,0,5,5
2011,Dem. Rep. of the Congo,COD,Latvia,LVA,0,0,0,13,13
2011,Georgia,GEO,Latvia,LVA,0,0,5,62,67
2011,Ghana,GHA,Latvia,LVA,5,0,0,0,5
2011,Iran (Islamic Rep. of),IRN,Latvia,LVA,0,5,0,0,5
2011,Kyrgyzstan,KGZ,Latvia,LVA,0,0,5,0,5
2011,Lebanon,LBN,Latvia,LVA,0,0,0,10,10
2011,Pakistan,PAK,Latvia,LVA,0,0,0,5,5
2011,Russian Federation,RUS,Latvia,LVA,5,0,0,5,10
2011,Syrian Arab Rep.,SYR,Latvia,LVA,0,5,0,0,5
2011,Uzbekistan,UZB,Latvia,LVA,0,5,0,0,5
2011,Dem. Rep. of the Congo,COD,Mali,MLI,16,0,5,0,21
2011,Cote d'Ivoire,CIV,Mali,MLI,21,0,27,0,48
2011,Rwanda,RWA,Mali,MLI,5,0,0,0,5
2011,Burundi,BDI,Malawi,MWI,92,0,161,10,263
2011,Dem. Rep. of the Congo,COD,Malawi,MWI,415,0,58,18,491
2011,Ethiopia,ETH,Malawi,MWI,0,0,5,0,5
2011,Rwanda,RWA,Malawi,MWI,80,0,92,16,188
2011,Uganda,UGA,Malawi,MWI,0,0,0,5,5
2011,Burundi,BDI,Mozambique,MOZ,12,0,0,0,12
2011,Dem. Rep. of the Congo,COD,Mozambique,MOZ,88,0,0,0,88
2011,Rwanda,RWA,Mozambique,MOZ,19,0,0,0,19
2011,Somalia,SOM,Mozambique,MOZ,5,0,0,0,5
2011,Egypt,EGY,Malta,MLT,0,0,12,0,12
2011,Bangladesh,BGD,Malta,MLT,0,0,32,0,32
2011,Burkina Faso,BFA,Malta,MLT,0,0,10,0,10
2011,Chad,TCD,Malta,MLT,0,5,11,0,16
2011,Cameroon,CMR,Malta,MLT,0,0,10,0,10
2011,Eritrea,ERI,Malta,MLT,15,245,43,5,308
2011,Ethiopia,ETH,Malta,MLT,10,14,78,0,102
2011,Gambia,GMB,Malta,MLT,0,0,10,0,10
2011,Palestinian,PSE,Malta,MLT,0,0,0,5,5
2011,Ghana,GHA,Malta,MLT,0,0,0,71,71
2011,Cote d'Ivoire,CIV,Malta,MLT,0,0,107,0,107
2011,India,IND,Malta,MLT,0,0,5,0,5
2011,Iran (Islamic Rep. of),IRN,Malta,MLT,5,0,0,0,5
2011,Libya,LBY,Malta,MLT,0,33,0,24,57
2011,Mali,MLI,Malta,MLT,0,0,83,5,88
2011,Morocco,MAR,Malta,MLT,5,0,0,0,5
2011,Niger,NER,Malta,MLT,0,0,13,0,13
2011,Nigeria,NGA,Malta,MLT,0,0,242,5,247
2011,Pakistan,PAK,Malta,MLT,15,16,15,0,46
2011,Senegal,SEN,Malta,MLT,0,0,0,5,5
2011,Sierra Leone,SLE,Malta,MLT,0,0,5,0,5
2011,Somalia,SOM,Malta,MLT,5,400,5,0,410
2011,Sudan,SDN,Malta,MLT,5,41,10,0,56
2011,Syrian Arab Rep.,SYR,Malta,MLT,0,46,0,5,51
2011,Togo,TGO,Malta,MLT,0,0,10,0,10
2011,Burundi,BDI,Namibia,NAM,22,0,13,41,76
2011,Cameroon,CMR,Namibia,NAM,0,0,0,11,11
2011,Congo,COG,Namibia,NAM,0,0,0,5,5
2011,Dem. Rep. of the Congo,COD,Namibia,NAM,79,0,94,352,525
2011,Eritrea,ERI,Namibia,NAM,0,0,0,5,5
2011,Ethiopia,ETH,Namibia,NAM,0,0,0,5,5
2011,Kenya,KEN,Namibia,NAM,0,0,0,5,5
2011,Liberia,LBR,Namibia,NAM,0,0,0,5,5
2011,Rwanda,RWA,Namibia,NAM,10,0,0,30,40
2011,Somalia,SOM,Namibia,NAM,5,0,0,0,5
2011,Sudan,SDN,Namibia,NAM,0,0,0,5,5
2011,United Rep. of Tanzania,TZA,Namibia,NAM,0,0,0,10,10
2011,Uganda,UGA,Namibia,NAM,0,0,0,5,5
2011,Zimbabwe,ZWE,Namibia,NAM,0,0,5,47,52
2011,Bhutan,BTN,Nepal,NPL,0,0,0,5,5
2011,Afghanistan,AFG,Netherlands,NLD,73,983,1453,0,2509
2011,Albania,ALB,Netherlands,NLD,0,0,25,0,25
2011,Algeria,DZA,Netherlands,NLD,0,0,17,0,17
2011,Angola,AGO,Netherlands,NLD,0,5,25,0,30
2011,Egypt,EGY,Netherlands,NLD,0,5,62,0,67
2011,Armenia,ARM,Netherlands,NLD,5,55,566,0,626
2011,Azerbaijan,AZE,Netherlands,NLD,10,30,101,0,141
2011,Burundi,BDI,Netherlands,NLD,0,10,25,0,35
2011,Benin,BEN,Netherlands,NLD,0,0,10,0,10
2011,Bangladesh,BGD,Netherlands,NLD,0,0,19,0,19
2011,Bhutan,BTN,Netherlands,NLD,0,54,0,0,54
2011,Burkina Faso,BFA,Netherlands,NLD,0,0,12,0,12
2011,Belarus,BLR,Netherlands,NLD,10,5,196,0,211
2011,Bolivia (Plurinational State of),BOL,Netherlands,NLD,0,0,5,0,5
2011,Brazil,BRA,Netherlands,NLD,0,0,5,0,5
2011,Bosnia and Herzegovina,BIH,Netherlands,NLD,0,0,26,0,26
2011,Chad,TCD,Netherlands,NLD,0,0,5,0,5
2011,China,CHN,Netherlands,NLD,36,148,177,0,361
2011,Cameroon,CMR,Netherlands,NLD,0,5,16,0,21
2011,Congo,COG,Netherlands,NLD,13,79,51,0,143
2011,Dem. Rep. of the Congo,COD,Netherlands,NLD,0,40,16,0,56
2011,Colombia,COL,Netherlands,NLD,0,5,12,0,17
2011,Cuba,CUB,Netherlands,NLD,0,5,0,0,5
2011,Ecuador,ECU,Netherlands,NLD,0,5,0,0,5
2011,Eritrea,ERI,Netherlands,NLD,27,404,181,0,612
2011,Ethiopia,ETH,Netherlands,NLD,24,97,61,0,182
2011,Gambia,GMB,Netherlands,NLD,0,0,24,0,24
2011,Palestinian,PSE,Netherlands,NLD,5,10,36,0,51
2011,Georgia,GEO,Netherlands,NLD,0,5,222,0,227
2011,Ghana,GHA,Netherlands,NLD,0,0,41,0,41
2011,Guinea,GIN,Netherlands,NLD,5,80,178,0,263
2011,Croatia,HRV,Netherlands,NLD,0,0,10,0,10
2011,Cote d'Ivoire,CIV,Netherlands,NLD,5,18,47,0,70
2011,India,IND,Netherlands,NLD,0,0,27,0,27
2011,Indonesia,IDN,Netherlands,NLD,0,0,5,0,5
2011,Iran (Islamic Rep. of),IRN,Netherlands,NLD,171,363,606,0,1140
2011,Iraq,IRQ,Netherlands,NLD,127,1117,1028,0,2272
2011,Israel,ISR,Netherlands,NLD,0,0,5,0,5
2011,Jamaica,JAM,Netherlands,NLD,12,0,0,0,12
2011,Jordan,JOR,Netherlands,NLD,5,0,0,0,5
2011,Kazakhstan,KAZ,Netherlands,NLD,0,0,15,0,15
2011,Kenya,KEN,Netherlands,NLD,0,0,10,0,10
2011,Kyrgyzstan,KGZ,Netherlands,NLD,5,5,16,0,26
2011,Dem. People's Rep. of Korea,PRK,Netherlands,NLD,0,10,0,0,10
2011,Kuwait,KWT,Netherlands,NLD,0,0,5,0,5
2011,Lao People's Dem. Rep.,LAO,Netherlands,NLD,0,16,0,0,16
2011,Liberia,LBR,Netherlands,NLD,0,10,14,0,24
2011,Libya,LBY,Netherlands,NLD,5,10,56,0,71
2011,Lebanon,LBN,Netherlands,NLD,0,0,18,0,18
2011,Sri Lanka,LKA,Netherlands,NLD,26,86,125,0,237
2011,Mauritania,MRT,Netherlands,NLD,0,0,5,0,5
2011,North Macedonia,MKD,Netherlands,NLD,0,0,275,0,275
2011,Rep. of Moldova,MDA,Netherlands,NLD,0,0,5,0,5
2011,Mali,MLI,Netherlands,NLD,0,0,18,0,18
2011,Malaysia,MYS,Netherlands,NLD,0,5,0,0,5
2011,Mongolia,MNG,Netherlands,NLD,0,5,146,0,151
2011,Morocco,MAR,Netherlands,NLD,0,0,24,0,24
2011,Myanmar,MMR,Netherlands,NLD,18,120,10,0,148
2011,Nepal,NPL,Netherlands,NLD,10,35,84,0,129
2011,Niger,NER,Netherlands,NLD,0,0,5,0,5
2011,Nigeria,NGA,Netherlands,NLD,0,20,153,0,173
2011,Pakistan,PAK,Netherlands,NLD,12,22,75,0,109
2011,South Africa,ZAF,Netherlands,NLD,0,0,5,0,5
2011,Russian Federation,RUS,Netherlands,NLD,5,16,445,0,466
2011,Rwanda,RWA,Netherlands,NLD,5,5,10,0,20
2011,El Salvador,SLV,Netherlands,NLD,0,0,5,0,5
2011,Saudi Arabia,SAU,Netherlands,NLD,0,0,5,0,5
2011,Serbia and Kosovo: S/RES/1244 (1999),SRB,Netherlands,NLD,0,0,142,0,142
2011,Senegal,SEN,Netherlands,NLD,0,0,10,0,10
2011,Sierra Leone,SLE,Netherlands,NLD,0,44,124,0,168
2011,Somalia,SOM,Netherlands,NLD,35,1638,950,0,2623
2011,Viet Nam,VNM,Netherlands,NLD,0,0,5,0,5
2011,Sudan,SDN,Netherlands,NLD,23,85,117,0,225
2011,Syrian Arab Rep.,SYR,Netherlands,NLD,5,17,64,0,86
2011,United Rep. of Tanzania,TZA,Netherlands,NLD,0,0,5,0,5
2011,Tajikistan,TJK,Netherlands,NLD,0,0,16,0,16
2011,Togo,TGO,Netherlands,NLD,0,0,26,0,26
2011,Trinidad and Tobago,TTO,Netherlands,NLD,0,5,0,0,5
2011,Tunisia,TUN,Netherlands,NLD,0,0,14,0,14
2011,Turkey,TUR,Netherlands,NLD,5,15,61,0,81
2011,Uganda,UGA,Netherlands,NLD,19,16,77,0,112
2011,Ukraine,UKR,Netherlands,NLD,0,0,35,0,35
2011,United States of America,USA,Netherlands,NLD,0,0,5,0,5
2011,Uzbekistan,UZB,Netherlands,NLD,0,10,13,0,23
2011,Yemen,YEM,Netherlands,NLD,5,5,12,0,22
2011,Zimbabwe,ZWE,Netherlands,NLD,0,0,12,0,12
2011,Stateless,XXA,Netherlands,NLD,0,24,71,0,95
2011,Chad,TCD,Niger,NER,5,0,0,0,5
2011,Cote d'Ivoire,CIV,Niger,NER,5,0,36,23,64
2011,Bangladesh,BGD,Nicaragua,NIC,0,0,0,5,5
2011,Congo,COG,Nicaragua,NIC,5,0,0,0,5
2011,Eritrea,ERI,Nicaragua,NIC,0,0,0,5,5
2011,Honduras,HND,Nicaragua,NIC,5,0,0,0,5
2011,Somalia,SOM,Nicaragua,NIC,0,0,0,13,13
2011,Afghanistan,AFG,Norway,NOR,204,337,615,153,1309
2011,Albania,ALB,Norway,NOR,0,0,36,5,41
2011,Algeria,DZA,Norway,NOR,0,0,47,70,117
2011,Angola,AGO,Norway,NOR,0,0,12,5,17
2011,Egypt,EGY,Norway,NOR,5,5,18,5,33
2011,Armenia,ARM,Norway,NOR,0,0,12,5,17
2011,Azerbaijan,AZE,Norway,NOR,0,0,35,17,52
2011,Burundi,BDI,Norway,NOR,5,0,5,5,15
2011,Benin,BEN,Norway,NOR,0,0,5,0,5
2011,Bangladesh,BGD,Norway,NOR,0,0,46,11,57
2011,Belarus,BLR,Norway,NOR,0,0,16,22,38
2011,Brazil,BRA,Norway,NOR,0,0,5,0,5
2011,Bosnia and Herzegovina,BIH,Norway,NOR,0,0,18,5,23
2011,Bulgaria,BGR,Norway,NOR,0,0,5,0,5
2011,Chad,TCD,Norway,NOR,0,0,0,5,5
2011,China,CHN,Norway,NOR,185,0,36,11,232
2011,Cameroon,CMR,Norway,NOR,0,0,11,5,16
2011,Congo,COG,Norway,NOR,0,0,0,5,5
2011,Dem. Rep. of the Congo,COD,Norway,NOR,12,10,72,15,109
2011,Colombia,COL,Norway,NOR,5,0,0,0,5
2011,Czechia,CZE,Norway,NOR,0,0,10,0,10
2011,Equatorial Guinea,GNQ,Norway,NOR,0,0,5,0,5
2011,Eritrea,ERI,Norway,NOR,1045,98,274,244,1661
2011,Ethiopia,ETH,Norway,NOR,152,43,219,58,472
2011,Gambia,GMB,Norway,NOR,0,0,56,27,83
2011,Georgia,GEO,Norway,NOR,0,0,10,32,42
2011,Ghana,GHA,Norway,NOR,0,0,22,15,37
2011,Guinea-Bissau,GNB,Norway,NOR,0,0,0,5,5
2011,Guinea,GIN,Norway,NOR,5,10,49,22,86
2011,Croatia,HRV,Norway,NOR,0,0,0,5,5
2011,Hungary,HUN,Norway,NOR,0,0,5,0,5
2011,Cote d'Ivoire,CIV,Norway,NOR,0,0,17,13,30
2011,India,IND,Norway,NOR,0,0,29,30,59
2011,Iran (Islamic Rep. of),IRN,Norway,NOR,120,14,285,88,507
2011,Iraq,IRQ,Norway,NOR,89,58,201,164,512
2011,Israel,ISR,Norway,NOR,0,0,10,0,10
2011,Jordan,JOR,Norway,NOR,0,0,10,18,28
2011,Kazakhstan,KAZ,Norway,NOR,5,0,0,11,16
2011,Kenya,KEN,Norway,NOR,0,0,5,0,5
2011,Kyrgyzstan,KGZ,Norway,NOR,0,0,49,22,71
2011,Rep. of Korea,KOR,Norway,NOR,0,0,5,0,5
2011,Kuwait,KWT,Norway,NOR,0,0,5,0,5
2011,Liberia,LBR,Norway,NOR,0,0,26,10,36
2011,Libya,LBY,Norway,NOR,0,0,16,66,82
2011,Lebanon,LBN,Norway,NOR,0,0,12,16,28
2011,Sri Lanka,LKA,Norway,NOR,0,10,66,10,86
2011,Lithuania,LTU,Norway,NOR,0,0,0,5,5
2011,Latvia,LVA,Norway,NOR,0,0,11,0,11
2011,Mauritania,MRT,Norway,NOR,0,0,14,0,14
2011,North Macedonia,MKD,Norway,NOR,0,0,21,0,21
2011,Rep. of Moldova,MDA,Norway,NOR,0,0,0,5,5
2011,Mexico,MEX,Norway,NOR,0,0,10,0,10
2011,Mongolia,MNG,Norway,NOR,0,0,5,0,5
2011,Morocco,MAR,Norway,NOR,0,0,53,43,96
2011,Montenegro,MNE,Norway,NOR,0,0,5,5,10
2011,Myanmar,MMR,Norway,NOR,10,18,5,18,51
2011,Nepal,NPL,Norway,NOR,0,0,11,10,21
2011,Niger,NER,Norway,NOR,0,0,13,0,13
2011,Nicaragua,NIC,Norway,NOR,0,0,0,5,5
2011,Nigeria,NGA,Norway,NOR,10,17,125,131,283
2011,Pakistan,PAK,Norway,NOR,5,5,81,30,121
2011,Philippines,PHL,Norway,NOR,0,5,0,0,5
2011,South Africa,ZAF,Norway,NOR,0,0,0,5,5
2011,Russian Federation,RUS,Norway,NOR,0,21,236,201,458
2011,Rwanda,RWA,Norway,NOR,5,0,11,0,16
2011,El Salvador,SLV,Norway,NOR,0,0,13,5,18
2011,Saudi Arabia,SAU,Norway,NOR,0,0,0,5,5
2011,Serbia and Kosovo: S/RES/1244 (1999),SRB,Norway,NOR,0,0,145,101,246
2011,Senegal,SEN,Norway,NOR,0,0,23,13,36
2011,Sierra Leone,SLE,Norway,NOR,0,0,26,5,31
2011,Somalia,SOM,Norway,NOR,759,446,106,454,1765
2011,Spain,ESP,Norway,NOR,0,0,5,0,5
2011,Viet Nam,VNM,Norway,NOR,0,0,10,10,20
2011,Sudan,SDN,Norway,NOR,137,11,11,56,215
2011,Syrian Arab Rep.,SYR,Norway,NOR,5,5,51,50,111
2011,United Rep. of Tanzania,TZA,Norway,NOR,0,0,0,5,5
2011,Tajikistan,TJK,Norway,NOR,0,0,5,10,15
2011,Togo,TGO,Norway,NOR,0,0,5,0,5
2011,Tunisia,TUN,Norway,NOR,0,0,20,55,75
2011,Turkey,TUR,Norway,NOR,5,5,48,13,71
2011,Uganda,UGA,Norway,NOR,5,0,30,5,40
2011,Ukraine,UKR,Norway,NOR,0,0,5,11,16
2011,United States of America,USA,Norway,NOR,0,0,5,0,5
2011,Uzbekistan,UZB,Norway,NOR,5,12,70,24,111
2011,Yemen,YEM,Norway,NOR,0,10,15,11,36
2011,Zimbabwe,ZWE,Norway,NOR,5,0,15,10,30
2011,Stateless,XXA,Norway,NOR,31,92,191,119,433
2011,Afghanistan,AFG,New Zealand,NZL,12,0,0,0,12
2011,Egypt,EGY,New Zealand,NZL,0,0,10,0,10
2011,Bahrain,BHR,New Zealand,NZL,15,0,5,0,20
2011,China,CHN,New Zealand,NZL,10,0,14,0,24
2011,Colombia,COL,New Zealand,NZL,0,0,5,0,5
2011,Czechia,CZE,New Zealand,NZL,5,0,12,0,17
2011,Ethiopia,ETH,New Zealand,NZL,0,0,5,0,5
2011,Fiji,FJI,New Zealand,NZL,5,0,22,0,27
2011,Germany,DEU,New Zealand,NZL,0,0,5,0,5
2011,Ghana,GHA,New Zealand,NZL,0,0,5,0,5
2011,Hungary,HUN,New Zealand,NZL,0,0,5,0,5
2011,Iran (Islamic Rep. of),IRN,New Zealand,NZL,10,0,35,0,45
2011,Iraq,IRQ,New Zealand,NZL,0,0,13,0,13
2011,Sri Lanka,LKA,New Zealand,NZL,5,0,15,0,20
2011,Nepal,NPL,New Zealand,NZL,0,0,5,0,5
2011,Pakistan,PAK,New Zealand,NZL,0,0,14,0,14
2011,South Africa,ZAF,New Zealand,NZL,0,0,21,0,21
2011,Russian Federation,RUS,New Zealand,NZL,0,0,5,0,5
2011,El Salvador,SLV,New Zealand,NZL,5,0,0,0,5
2011,Saudi Arabia,SAU,New Zealand,NZL,0,0,12,0,12
2011,Somalia,SOM,New Zealand,NZL,0,0,5,0,5
2011,Tunisia,TUN,New Zealand,NZL,0,0,5,0,5
2011,Turkey,TUR,New Zealand,NZL,0,0,5,0,5
2011,Uganda,UGA,New Zealand,NZL,0,0,5,0,5
2011,Zimbabwe,ZWE,New Zealand,NZL,0,0,5,0,5
2011,Bangladesh,BGD,Panama,PAN,0,0,0,10,10
2011,China,CHN,Panama,PAN,0,0,5,0,5
2011,Colombia,COL,Panama,PAN,135,0,57,758,950
2011,Cuba,CUB,Panama,PAN,5,0,0,44,49
2011,Ethiopia,ETH,Panama,PAN,0,0,0,5,5
2011,Honduras,HND,Panama,PAN,0,0,0,5,5
2011,Nicaragua,NIC,Panama,PAN,0,0,0,25,25
2011,El Salvador,SLV,Panama,PAN,0,0,0,5,5
2011,Venezuela (Bolivarian Republic of),VEN,Panama,PAN,12,0,0,0,12
2011,Bolivia (Plurinational State of),BOL,Paraguay,PRY,5,0,0,0,5
2011,Cuba,CUB,Paraguay,PRY,5,0,0,0,5
2011,Argentina,ARG,Peru,PER,0,0,0,10,10
2011,Bolivia (Plurinational State of),BOL,Peru,PER,5,0,0,0,5
2011,Colombia,COL,Peru,PER,5,0,0,23,28
2011,Cuba,CUB,Peru,PER,5,0,34,11,50
2011,Haiti,HTI,Peru,PER,5,0,0,102,107
2011,Niger,NER,Peru,PER,0,0,0,5,5
2011,Nigeria,NGA,Peru,PER,0,0,0,10,10
2011,South Africa,ZAF,Peru,PER,0,0,0,5,5
2011,Sierra Leone,SLE,Peru,PER,0,0,0,5,5
2011,Venezuela (Bolivarian Republic of),VEN,Peru,PER,5,0,0,5,10
2011,China,CHN,Philippines,PHL,0,0,0,5,5
2011,Iran (Islamic Rep. of),IRN,Philippines,PHL,0,0,0,14,14
2011,Afghanistan,AFG,Poland,POL,5,0,17,12,34
2011,Algeria,DZA,Poland,POL,0,0,5,5,10
2011,Egypt,EGY,Poland,POL,0,5,5,0,10
2011,Armenia,ARM,Poland,POL,0,32,82,108,222
2011,Azerbaijan,AZE,Poland,POL,0,5,0,5,10
2011,Bangladesh,BGD,Poland,POL,0,0,0,13,13
2011,Belarus,BLR,Poland,POL,19,5,18,11,53
2011,China,CHN,Poland,POL,0,0,5,5,10
2011,Cameroon,CMR,Poland,POL,0,0,10,5,15
2011,Congo,COG,Poland,POL,0,0,15,0,15
2011,Dem. Rep. of the Congo,COD,Poland,POL,0,0,5,0,5
2011,Cuba,CUB,Poland,POL,0,5,0,0,5
2011,Eritrea,ERI,Poland,POL,14,0,0,0,14
2011,Palestinian,PSE,Poland,POL,0,0,5,5,10
2011,Georgia,GEO,Poland,POL,0,5,551,1409,1965
2011,Ghana,GHA,Poland,POL,0,0,0,5,5
2011,Guinea,GIN,Poland,POL,0,0,0,5,5
2011,India,IND,Poland,POL,0,0,13,5,18
2011,Iran (Islamic Rep. of),IRN,Poland,POL,5,0,5,0,10
2011,Iraq,IRQ,Poland,POL,17,10,0,14,41
2011,Kazakhstan,KAZ,Poland,POL,0,0,5,25,30
2011,Kenya,KEN,Poland,POL,0,5,0,0,5
2011,Kyrgyzstan,KGZ,Poland,POL,0,10,0,22,32
2011,Libya,LBY,Poland,POL,0,5,0,5,10
2011,Sri Lanka,LKA,Poland,POL,0,5,0,0,5
2011,Rep. of Moldova,MDA,Poland,POL,0,0,5,0,5
2011,Mongolia,MNG,Poland,POL,0,15,10,5,30
2011,Morocco,MAR,Poland,POL,0,0,5,0,5
2011,Nepal,NPL,Poland,POL,0,0,32,22,54
2011,Nigeria,NGA,Poland,POL,5,0,14,5,24
2011,Pakistan,PAK,Poland,POL,0,0,10,14,24
2011,Russian Federation,RUS,Poland,POL,82,214,1798,4796,6890
2011,Sierra Leone,SLE,Poland,POL,0,0,0,5,5
2011,Somalia,SOM,Poland,POL,0,0,13,0,13
2011,Viet Nam,VNM,Poland,POL,0,5,21,10,36
2011,Syrian Arab Rep.,SYR,Poland,POL,0,0,0,11,11
2011,United Rep. of Tanzania,TZA,Poland,POL,0,0,5,0,5
2011,Tunisia,TUN,Poland,POL,0,0,0,5,5
2011,Turkey,TUR,Poland,POL,0,0,14,0,14
2011,Uganda,UGA,Poland,POL,0,0,5,0,5
2011,Ukraine,UKR,Poland,POL,0,5,39,31,75
2011,Uzbekistan,UZB,Poland,POL,0,5,5,14,24
2011,Stateless,XXA,Poland,POL,0,0,12,5,17
2011,Angola,AGO,Portugal,PRT,5,0,0,0,5
2011,Bosnia and Herzegovina,BIH,Portugal,PRT,0,5,0,0,5
2011,Dem. Rep. of the Congo,COD,Portugal,PRT,14,0,0,0,14
2011,Colombia,COL,Portugal,PRT,0,11,0,0,11
2011,Guinea-Bissau,GNB,Portugal,PRT,5,0,0,5,10
2011,Guinea,GIN,Portugal,PRT,0,0,0,20,20
2011,Cote d'Ivoire,CIV,Portugal,PRT,0,0,0,5,5
2011,North Macedonia,MKD,Portugal,PRT,0,5,0,0,5
2011,Nigeria,NGA,Portugal,PRT,0,0,0,5,5
2011,Pakistan,PAK,Portugal,PRT,5,0,0,0,5
2011,Russian Federation,RUS,Portugal,PRT,0,5,0,0,5
2011,Somalia,SOM,Portugal,PRT,0,10,0,0,10
2011,Turkey,TUR,Portugal,PRT,5,0,0,0,5
2011,Algeria,DZA,South Africa,ZAF,0,0,31,0,31
2011,Angola,AGO,South Africa,ZAF,18,0,0,0,18
2011,Egypt,EGY,South Africa,ZAF,0,0,97,0,97
2011,Burundi,BDI,South Africa,ZAF,49,0,543,0,592
2011,Benin,BEN,South Africa,ZAF,0,0,5,0,5
2011,Bangladesh,BGD,South Africa,ZAF,5,0,2048,0,2053
2011,Burkina Faso,BFA,South Africa,ZAF,0,0,5,0,5
2011,China,CHN,South Africa,ZAF,0,0,555,0,555
2011,Cameroon,CMR,South Africa,ZAF,5,0,205,0,210
2011,Congo,COG,South Africa,ZAF,107,0,696,0,803
2011,Dem. Rep. of the Congo,COD,South Africa,ZAF,802,0,2399,0,3201
2011,Comoros,COM,South Africa,ZAF,0,0,5,0,5
2011,Eritrea,ERI,South Africa,ZAF,292,0,48,0,340
2011,Ethiopia,ETH,South Africa,ZAF,1663,0,7387,0,9050
2011,Palestinian,PSE,South Africa,ZAF,14,0,0,0,14
2011,Ghana,GHA,South Africa,ZAF,0,0,554,0,554
2011,Cote d'Ivoire,CIV,South Africa,ZAF,0,0,12,0,12
2011,India,IND,South Africa,ZAF,0,0,644,0,644
2011,Kenya,KEN,South Africa,ZAF,5,0,147,0,152
2011,Lesotho,LSO,South Africa,ZAF,0,0,27,0,27
2011,Sri Lanka,LKA,South Africa,ZAF,0,0,5,0,5
2011,Mali,MLI,South Africa,ZAF,0,0,10,0,10
2011,Malawi,MWI,South Africa,ZAF,0,0,1020,0,1020
2011,Mozambique,MOZ,South Africa,ZAF,0,0,219,0,219
2011,Nepal,NPL,South Africa,ZAF,0,0,5,0,5
2011,Niger,NER,South Africa,ZAF,0,0,27,0,27
2011,Nigeria,NGA,South Africa,ZAF,0,0,957,0,957
2011,Pakistan,PAK,South Africa,ZAF,0,0,1581,0,1581
2011,Rwanda,RWA,South Africa,ZAF,35,0,86,0,121
2011,Senegal,SEN,South Africa,ZAF,0,0,48,0,48
2011,Somalia,SOM,South Africa,ZAF,3639,0,669,0,4308
2011,Sudan,SDN,South Africa,ZAF,0,0,12,0,12
2011,Eswatini,SWZ,South Africa,ZAF,0,0,22,0,22
2011,United Rep. of Tanzania,TZA,South Africa,ZAF,0,0,162,0,162
2011,Thailand,THA,South Africa,ZAF,0,0,5,0,5
2011,Togo,TGO,South Africa,ZAF,0,0,5,0,5
2011,Uganda,UGA,South Africa,ZAF,11,0,921,0,932
2011,Zambia,ZMB,South Africa,ZAF,5,0,56,0,61
2011,Zimbabwe,ZWE,South Africa,ZAF,83,0,15904,0,15987
2011,Afghanistan,AFG,Russian Federation,RUS,88,0,0,656,744
2011,Egypt,EGY,Russian Federation,RUS,0,0,0,10,10
2011,Armenia,ARM,Russian Federation,RUS,0,0,0,5,5
2011,Azerbaijan,AZE,Russian Federation,RUS,0,0,0,5,5
2011,Bangladesh,BGD,Russian Federation,RUS,5,0,0,0,5
2011,Belarus,BLR,Russian Federation,RUS,0,0,0,10,10
2011,Cambodia,KHM,Russian Federation,RUS,0,0,0,5,5
2011,China,CHN,Russian Federation,RUS,0,0,0,5,5
2011,Congo,COG,Russian Federation,RUS,0,0,0,5,5
2011,Dem. Rep. of the Congo,COD,Russian Federation,RUS,0,0,0,10,10
2011,Eritrea,ERI,Russian Federation,RUS,0,0,0,5,5
2011,Palestinian,PSE,Russian Federation,RUS,0,0,0,10,10
2011,Georgia,GEO,Russian Federation,RUS,11,0,0,506,517
2011,Guinea,GIN,Russian Federation,RUS,0,0,0,5,5
2011,Cote d'Ivoire,CIV,Russian Federation,RUS,0,0,0,5,5
2011,Iran (Islamic Rep. of),IRN,Russian Federation,RUS,0,0,0,5,5
2011,Iraq,IRQ,Russian Federation,RUS,0,0,0,10,10
2011,Kazakhstan,KAZ,Russian Federation,RUS,0,0,0,10,10
2011,Kyrgyzstan,KGZ,Russian Federation,RUS,0,0,0,82,82
2011,Dem. People's Rep. of Korea,PRK,Russian Federation,RUS,0,0,0,56,56
2011,Lebanon,LBN,Russian Federation,RUS,0,0,0,5,5
2011,Rep. of Moldova,MDA,Russian Federation,RUS,0,0,0,5,5
2011,Nigeria,NGA,Russian Federation,RUS,0,0,0,5,5
2011,Pakistan,PAK,Russian Federation,RUS,0,0,0,5,5
2011,Serbia and Kosovo: S/RES/1244 (1999),SRB,Russian Federation,RUS,0,0,0,5,5
2011,Somalia,SOM,Russian Federation,RUS,0,0,0,5,5
2011,Syrian Arab Rep.,SYR,Russian Federation,RUS,0,0,0,24,24
2011,Tajikistan,TJK,Russian Federation,RUS,0,0,0,14,14
2011,Turkmenistan,TKM,Russian Federation,RUS,0,0,0,5,5
2011,Turkey,TUR,Russian Federation,RUS,0,0,0,5,5
2011,Ukraine,UKR,Russian Federation,RUS,0,0,0,10,10
2011,Uzbekistan,UZB,Russian Federation,RUS,0,0,0,80,80
2011,Yemen,YEM,Russian Federation,RUS,0,0,0,5,5
2011,Cuba,CUB,El Salvador,SLV,0,0,0,5,5
2011,Eritrea,ERI,El Salvador,SLV,0,0,0,5,5
2011,Honduras,HND,El Salvador,SLV,0,0,0,16,16
2011,Afghanistan,AFG,Serbia and Kosovo: S/RES/1244 (1999),SRB,0,0,96,1587,1683
2011,Algeria,DZA,Serbia and Kosovo: S/RES/1244 (1999),SRB,0,0,12,47,59
2011,Bangladesh,BGD,Serbia and Kosovo: S/RES/1244 (1999),SRB,0,0,0,10,10
2011,Bosnia and Herzegovina,BIH,Serbia and Kosovo: S/RES/1244 (1999),SRB,0,0,5,0,5
2011,Dem. Rep. of the Congo,COD,Serbia and Kosovo: S/RES/1244 (1999),SRB,0,0,0,10,10
2011,Eritrea,ERI,Serbia and Kosovo: S/RES/1244 (1999),SRB,0,0,0,5,5
2011,Palestinian,PSE,Serbia and Kosovo: S/RES/1244 (1999),SRB,0,0,10,152,162
2011,India,IND,Serbia and Kosovo: S/RES/1244 (1999),SRB,0,0,0,27,27
2011,Iran (Islamic Rep. of),IRN,Serbia and Kosovo: S/RES/1244 (1999),SRB,0,0,0,39,39
2011,Iraq,IRQ,Serbia and Kosovo: S/RES/1244 (1999),SRB,0,0,5,31,36
2011,Libya,LBY,Serbia and Kosovo: S/RES/1244 (1999),SRB,0,0,0,142,142
2011,Sri Lanka,LKA,Serbia and Kosovo: S/RES/1244 (1999),SRB,0,0,0,5,5
2011,Morocco,MAR,Serbia and Kosovo: S/RES/1244 (1999),SRB,0,0,5,91,96
2011,Myanmar,MMR,Serbia and Kosovo: S/RES/1244 (1999),SRB,0,0,0,5,5
2011,Nepal,NPL,Serbia and Kosovo: S/RES/1244 (1999),SRB,0,0,0,10,10
2011,Pakistan,PAK,Serbia and Kosovo: S/RES/1244 (1999),SRB,0,0,0,356,356
2011,Somalia,SOM,Serbia and Kosovo: S/RES/1244 (1999),SRB,0,0,16,321,337
2011,Sudan,SDN,Serbia and Kosovo: S/RES/1244 (1999),SRB,0,0,0,16,16
2011,Syrian Arab Rep.,SYR,Serbia and Kosovo: S/RES/1244 (1999),SRB,0,0,0,33,33
2011,Tunisia,TUN,Serbia and Kosovo: S/RES/1244 (1999),SRB,0,0,5,69,74
2011,Turkey,TUR,Serbia and Kosovo: S/RES/1244 (1999),SRB,0,0,0,5,5
2011,Chad,TCD,Senegal,SEN,0,0,5,0,5
2011,Cameroon,CMR,Senegal,SEN,0,0,5,0,5
2011,Dem. Rep. of the Congo,COD,Senegal,SEN,0,0,5,0,5
2011,Gambia,GMB,Senegal,SEN,5,0,0,0,5
2011,Guinea,GIN,Senegal,SEN,0,0,15,0,15
2011,Cote d'Ivoire,CIV,Senegal,SEN,0,0,40,0,40
2011,Mauritania,MRT,Senegal,SEN,0,0,5,0,5
2011,Rwanda,RWA,Senegal,SEN,5,0,0,0,5
2011,Afghanistan,AFG,Spain,ESP,10,14,5,0,29
2011,Albania,ALB,Spain,ESP,5,0,0,0,5
2011,Algeria,DZA,Spain,ESP,0,5,79,5,89
2011,Angola,AGO,Spain,ESP,0,5,5,0,10
2011,Armenia,ARM,Spain,ESP,0,0,39,0,39
2011,Azerbaijan,AZE,Spain,ESP,5,0,0,0,5
2011,Benin,BEN,Spain,ESP,0,0,5,0,5
2011,Bangladesh,BGD,Spain,ESP,5,0,5,0,10
2011,Burkina Faso,BFA,Spain,ESP,0,0,27,0,27
2011,Belarus,BLR,Spain,ESP,5,0,5,0,10
2011,Bolivia (Plurinational State of),BOL,Spain,ESP,0,0,10,0,10
2011,Central African Rep.,CAF,Spain,ESP,0,0,15,0,15
2011,Chad,TCD,Spain,ESP,0,0,10,0,10
2011,China,CHN,Spain,ESP,0,0,5,0,5
2011,Cameroon,CMR,Spain,ESP,5,0,64,0,69
2011,Congo,COG,Spain,ESP,0,0,11,0,11
2011,Dem. Rep. of the Congo,COD,Spain,ESP,10,5,83,5,103
2011,Colombia,COL,Spain,ESP,37,13,334,5,389
2011,Cuba,CUB,Spain,ESP,80,467,22,10,579
2011,Ecuador,ECU,Spain,ESP,0,0,5,0,5
2011,Equatorial Guinea,GNQ,Spain,ESP,0,0,14,5,19
2011,Eritrea,ERI,Spain,ESP,0,0,11,0,11
2011,Ethiopia,ETH,Spain,ESP,0,0,5,0,5
2011,Gabon,GAB,Spain,ESP,0,0,5,0,5
2011,Gambia,GMB,Spain,ESP,0,0,52,5,57
2011,Palestinian,PSE,Spain,ESP,86,13,5,0,104
2011,Georgia,GEO,Spain,ESP,0,0,18,0,18
2011,Ghana,GHA,Spain,ESP,0,0,11,0,11
2011,Guinea-Bissau,GNB,Spain,ESP,0,0,17,0,17
2011,Guatemala,GTM,Spain,ESP,0,0,14,0,14
2011,Guinea,GIN,Spain,ESP,0,0,157,13,170
2011,Haiti,HTI,Spain,ESP,0,5,0,0,5
2011,Honduras,HND,Spain,ESP,0,0,39,0,39
2011,Cote d'Ivoire,CIV,Spain,ESP,0,28,22,5,55
2011,India,IND,Spain,ESP,0,0,12,0,12
2011,Iran (Islamic Rep. of),IRN,Spain,ESP,10,5,35,5,55
2011,Iraq,IRQ,Spain,ESP,5,5,0,5,15
2011,Jordan,JOR,Spain,ESP,5,0,0,0,5
2011,Kazakhstan,KAZ,Spain,ESP,5,0,0,0,5
2011,Kyrgyzstan,KGZ,Spain,ESP,0,0,10,5,15
2011,Liberia,LBR,Spain,ESP,0,0,12,0,12
2011,Sri Lanka,LKA,Spain,ESP,5,5,18,10,38
2011,Mauritania,MRT,Spain,ESP,0,0,5,0,5
2011,Mexico,MEX,Spain,ESP,0,0,23,0,23
2011,Mali,MLI,Spain,ESP,0,0,34,0,34
2011,Malawi,MWI,Spain,ESP,0,0,5,0,5
2011,Morocco,MAR,Spain,ESP,0,0,24,5,29
2011,Nepal,NPL,Spain,ESP,0,0,5,0,5
2011,Niger,NER,Spain,ESP,0,0,24,0,24
2011,Nicaragua,NIC,Spain,ESP,5,0,5,0,10
2011,Nigeria,NGA,Spain,ESP,0,0,209,15,224
2011,Pakistan,PAK,Spain,ESP,12,0,24,5,41
2011,Russian Federation,RUS,Spain,ESP,13,0,33,5,51
2011,Rwanda,RWA,Spain,ESP,0,0,5,0,5
2011,El Salvador,SLV,Spain,ESP,0,0,29,0,29
2011,Senegal,SEN,Spain,ESP,0,0,20,0,20
2011,Sierra Leone,SLE,Spain,ESP,0,5,29,5,39
2011,Somalia,SOM,Spain,ESP,10,67,10,33,120
2011,Sudan,SDN,Spain,ESP,0,0,11,0,11
2011,Syrian Arab Rep.,SYR,Spain,ESP,0,0,0,5,5
2011,Togo,TGO,Spain,ESP,5,0,21,0,26
2011,Turkey,TUR,Spain,ESP,0,0,5,0,5
2011,Ukraine,UKR,Spain,ESP,0,0,10,0,10
2011,United States of America,USA,Spain,ESP,0,0,5,0,5
2011,Venezuela (Bolivarian Republic of),VEN,Spain,ESP,14,0,59,0,73
2011,Western Sahara,ESH,Spain,ESP,5,0,42,0,47
2011,Zimbabwe,ZWE,Spain,ESP,5,0,12,0,17
2011,Afghanistan,AFG,Slovenia,SVN,0,0,26,24,50
2011,Algeria,DZA,Slovenia,SVN,0,0,0,13,13
2011,Egypt,EGY,Slovenia,SVN,0,0,0,5,5
2011,Belarus,BLR,Slovenia,SVN,0,0,0,5,5
2011,Bosnia and Herzegovina,BIH,Slovenia,SVN,0,5,12,5,22
2011,Dem. Rep. of the Congo,COD,Slovenia,SVN,0,5,0,0,5
2011,Palestinian,PSE,Slovenia,SVN,0,0,0,10,10
2011,Croatia,HRV,Slovenia,SVN,0,0,5,0,5
2011,India,IND,Slovenia,SVN,0,0,5,0,5
2011,Iran (Islamic Rep. of),IRN,Slovenia,SVN,0,0,0,13,13
2011,Iraq,IRQ,Slovenia,SVN,0,0,5,0,5
2011,Kazakhstan,KAZ,Slovenia,SVN,5,0,0,0,5
2011,Libya,LBY,Slovenia,SVN,0,0,0,5,5
2011,Rep. of Moldova,MDA,Slovenia,SVN,0,0,0,5,5
2011,Morocco,MAR,Slovenia,SVN,0,0,0,5,5
2011,Nigeria,NGA,Slovenia,SVN,0,0,14,0,14
2011,Pakistan,PAK,Slovenia,SVN,0,0,18,10,28
2011,Russian Federation,RUS,Slovenia,SVN,5,0,5,0,10
2011,Serbia and Kosovo: S/RES/1244 (1999),SRB,Slovenia,SVN,0,0,30,10,40
2011,Somalia,SOM,Slovenia,SVN,5,0,14,5,24
2011,Sudan,SDN,Slovenia,SVN,0,0,0,5,5
2011,Syrian Arab Rep.,SYR,Slovenia,SVN,0,0,0,5,5
2011,Tunisia,TUN,Slovenia,SVN,0,0,0,25,25
2011,Turkey,TUR,Slovenia,SVN,0,0,18,41,59
2011,Ukraine,UKR,Slovenia,SVN,0,0,0,5,5
2011,Western Sahara,ESH,Slovenia,SVN,0,0,0,10,10
2011,Afghanistan,AFG,Sweden,SWE,401,2188,957,102,3648
2011,Albania,ALB,Sweden,SWE,5,11,157,24,197
2011,Algeria,DZA,Sweden,SWE,0,5,105,82,192
2011,Angola,AGO,Sweden,SWE,0,0,13,0,13
2011,Egypt,EGY,Sweden,SWE,10,5,101,5,121
2011,Argentina,ARG,Sweden,SWE,0,0,5,0,5
2011,Armenia,ARM,Sweden,SWE,5,33,253,22,313
2011,Azerbaijan,AZE,Sweden,SWE,10,31,286,28,355
2011,Burundi,BDI,Sweden,SWE,5,5,0,0,10
2011,Benin,BEN,Sweden,SWE,0,0,5,0,5
2011,Bangladesh,BGD,Sweden,SWE,5,5,104,16,130
2011,Belarus,BLR,Sweden,SWE,5,5,212,102,324
2011,Bolivia (Plurinational State of),BOL,Sweden,SWE,0,5,30,0,35
2011,Botswana,BWA,Sweden,SWE,0,0,0,5,5
2011,Brazil,BRA,Sweden,SWE,0,5,0,0,5
2011,Bosnia and Herzegovina,BIH,Sweden,SWE,0,13,357,44,414
2011,Bulgaria,BGR,Sweden,SWE,0,13,5,0,18
2011,China,CHN,Sweden,SWE,27,5,50,26,108
2011,Chile,CHL,Sweden,SWE,0,5,19,0,24
2011,Cameroon,CMR,Sweden,SWE,5,5,20,0,30
2011,Congo,COG,Sweden,SWE,0,5,14,0,19
2011,Dem. Rep. of the Congo,COD,Sweden,SWE,16,33,53,5,107
2011,Colombia,COL,Sweden,SWE,0,0,12,5,17
2011,Cuba,CUB,Sweden,SWE,0,5,20,0,25
2011,Czechia,CZE,Sweden,SWE,0,0,10,0,10
2011,Denmark,DNK,Sweden,SWE,0,0,5,0,5
2011,Djibouti,DJI,Sweden,SWE,0,0,19,0,19
2011,Ecuador,ECU,Sweden,SWE,0,0,5,0,5
2011,Equatorial Guinea,GNQ,Sweden,SWE,0,0,5,0,5
2011,Eritrea,ERI,Sweden,SWE,174,1020,123,52,1369
2011,Estonia,EST,Sweden,SWE,0,0,14,0,14
2011,Ethiopia,ETH,Sweden,SWE,47,26,198,16,287
2011,Gambia,GMB,Sweden,SWE,0,5,33,5,43
2011,Georgia,GEO,Sweden,SWE,5,0,128,20,153
2011,Ghana,GHA,Sweden,SWE,0,5,36,5,46
2011,Guatemala,GTM,Sweden,SWE,0,0,0,5,5
2011,Guinea,GIN,Sweden,SWE,5,0,31,5,41
2011,Honduras,HND,Sweden,SWE,5,0,5,0,10
2011,Croatia,HRV,Sweden,SWE,0,0,19,5,24
2011,Cote d'Ivoire,CIV,Sweden,SWE,5,10,24,0,39
2011,India,IND,Sweden,SWE,0,0,44,5,49
2011,Indonesia,IDN,Sweden,SWE,0,0,5,0,5
2011,Iran (Islamic Rep. of),IRN,Sweden,SWE,378,67,759,70,1274
2011,Iraq,IRQ,Sweden,SWE,590,397,909,118,2014
2011,Israel,ISR,Sweden,SWE,0,0,10,5,15
2011,Jordan,JOR,Sweden,SWE,10,5,71,11,97
2011,Japan,JPN,Sweden,SWE,0,0,5,0,5
2011,Kazakhstan,KAZ,Sweden,SWE,5,17,250,37,309
2011,Kenya,KEN,Sweden,SWE,5,10,79,10,104
2011,Kyrgyzstan,KGZ,Sweden,SWE,0,17,387,34,438
2011,Kuwait,KWT,Sweden,SWE,0,0,21,0,21
2011,Liberia,LBR,Sweden,SWE,0,0,12,0,12
2011,Libya,LBY,Sweden,SWE,12,94,204,105,415
2011,Lebanon,LBN,Sweden,SWE,5,16,155,22,198
2011,Sri Lanka,LKA,Sweden,SWE,0,0,22,5,27
2011,Lithuania,LTU,Sweden,SWE,0,5,0,0,5
2011,Latvia,LVA,Sweden,SWE,0,0,5,0,5
2011,Mauritania,MRT,Sweden,SWE,0,0,10,0,10
2011,North Macedonia,MKD,Sweden,SWE,0,5,710,307,1022
2011,Malaysia,MYS,Sweden,SWE,0,0,5,0,5
2011,Mongolia,MNG,Sweden,SWE,0,17,747,49,813
2011,Morocco,MAR,Sweden,SWE,0,11,76,26,113
2011,Montenegro,MNE,Sweden,SWE,0,5,94,0,99
2011,Myanmar,MMR,Sweden,SWE,0,5,0,12,17
2011,Nepal,NPL,Sweden,SWE,0,5,13,0,18
2011,Netherlands,NLD,Sweden,SWE,0,0,0,5,5
2011,Niger,NER,Sweden,SWE,0,0,5,0,5
2011,Nicaragua,NIC,Sweden,SWE,0,0,10,0,10
2011,Nigeria,NGA,Sweden,SWE,10,17,221,23,271
2011,Pakistan,PAK,Sweden,SWE,18,14,117,14,163
2011,Peru,PER,Sweden,SWE,0,0,11,0,11
2011,Philippines,PHL,Sweden,SWE,0,0,5,0,5
2011,Romania,ROU,Sweden,SWE,0,12,0,5,17
2011,South Africa,ZAF,Sweden,SWE,0,0,5,0,5
2011,Russian Federation,RUS,Sweden,SWE,30,58,645,113,846
2011,Rwanda,RWA,Sweden,SWE,5,5,0,0,10
2011,El Salvador,SLV,Sweden,SWE,0,5,67,5,77
2011,Saudi Arabia,SAU,Sweden,SWE,0,0,14,0,14
2011,Serbia and Kosovo: S/RES/1244 (1999),SRB,Sweden,SWE,5,125,3118,533,3781
2011,Senegal,SEN,Sweden,SWE,0,5,11,0,16
2011,Sierra Leone,SLE,Sweden,SWE,5,5,20,0,30
2011,Somalia,SOM,Sweden,SWE,222,2168,229,348,2967
2011,Viet Nam,VNM,Sweden,SWE,0,14,106,21,141
2011,Sudan,SDN,Sweden,SWE,29,16,41,12,98
2011,Syrian Arab Rep.,SYR,Sweden,SWE,91,57,334,16,498
2011,United Rep. of Tanzania,TZA,Sweden,SWE,0,10,33,5,48
2011,Thailand,THA,Sweden,SWE,0,0,0,5,5
2011,Tajikistan,TJK,Sweden,SWE,0,0,36,5,41
2011,Togo,TGO,Sweden,SWE,0,5,5,0,10
2011,Tunisia,TUN,Sweden,SWE,5,0,63,22,90
2011,Turkey,TUR,Sweden,SWE,5,10,147,20,182
2011,Uganda,UGA,Sweden,SWE,45,5,48,5,103
2011,Ukraine,UKR,Sweden,SWE,0,5,127,17,149
2011,Uzbekistan,UZB,Sweden,SWE,16,24,284,16,340
2011,Venezuela (Bolivarian Republic of),VEN,Sweden,SWE,0,0,5,5,10
2011,Yemen,YEM,Sweden,SWE,81,65,60,15,221
2011,Zimbabwe,ZWE,Sweden,SWE,5,0,0,0,5
2011,Stateless,XXA,Sweden,SWE,125,378,519,86,1108
2011,Afghanistan,AFG,Switzerland,CHE,25,185,48,244,502
2011,Albania,ALB,Switzerland,CHE,0,0,5,26,31
2011,Algeria,DZA,Switzerland,CHE,0,0,39,516,555
2011,Angola,AGO,Switzerland,CHE,0,50,21,12,83
2011,Egypt,EGY,Switzerland,CHE,5,0,5,60,70
2011,Armenia,ARM,Switzerland,CHE,5,0,26,87,118
2011,Azerbaijan,AZE,Switzerland,CHE,5,0,10,17,32
2011,Burundi,BDI,Switzerland,CHE,0,5,0,0,5
2011,Benin,BEN,Switzerland,CHE,0,0,5,5,10
2011,Bangladesh,BGD,Switzerland,CHE,0,0,13,18,31
2011,Bhutan,BTN,Switzerland,CHE,0,0,5,0,5
2011,Burkina Faso,BFA,Switzerland,CHE,0,0,5,15,20
2011,Belarus,BLR,Switzerland,CHE,0,0,11,93,104
2011,Bosnia and Herzegovina,BIH,Switzerland,CHE,12,5,48,91,156
2011,Bulgaria,BGR,Switzerland,CHE,0,0,0,65,65
2011,Cambodia,KHM,Switzerland,CHE,5,0,0,0,5
2011,Chad,TCD,Switzerland,CHE,0,0,0,13,13
2011,China,CHN,Switzerland,CHE,51,337,40,35,463
2011,Cameroon,CMR,Switzerland,CHE,5,11,19,26,61
2011,Congo,COG,Switzerland,CHE,0,0,0,14,14
2011,Dem. Rep. of the Congo,COD,Switzerland,CHE,18,59,71,22,170
2011,Colombia,COL,Switzerland,CHE,40,0,0,5,45
2011,Cuba,CUB,Switzerland,CHE,0,0,0,5,5
2011,Czechia,CZE,Switzerland,CHE,0,0,0,15,15
2011,Djibouti,DJI,Switzerland,CHE,5,0,0,0,5
2011,Equatorial Guinea,GNQ,Switzerland,CHE,0,0,0,5,5
2011,Eritrea,ERI,Switzerland,CHE,2577,315,78,481,3451
2011,Ethiopia,ETH,Switzerland,CHE,50,34,40,46,170
2011,France,FRA,Switzerland,CHE,0,0,0,5,5
2011,Gabon,GAB,Switzerland,CHE,0,0,5,5,10
2011,Gambia,GMB,Switzerland,CHE,0,0,17,247,264
2011,Palestinian,PSE,Switzerland,CHE,10,12,0,53,75
2011,Georgia,GEO,Switzerland,CHE,5,0,10,396,411
2011,Germany,DEU,Switzerland,CHE,0,0,0,5,5
2011,Ghana,GHA,Switzerland,CHE,0,0,5,214,219
2011,Guinea-Bissau,GNB,Switzerland,CHE,0,0,15,107,122
2011,Guatemala,GTM,Switzerland,CHE,0,0,5,0,5
2011,Guinea,GIN,Switzerland,CHE,5,5,21,263,294
2011,Haiti,HTI,Switzerland,CHE,0,0,0,5,5
2011,Croatia,HRV,Switzerland,CHE,0,0,0,5,5
2011,Hungary,HUN,Switzerland,CHE,0,0,0,5,5
2011,Cote d'Ivoire,CIV,Switzerland,CHE,5,0,0,121,126
2011,India,IND,Switzerland,CHE,0,5,0,28,33
2011,Iran (Islamic Rep. of),IRN,Switzerland,CHE,84,68,36,118,306
2011,Iraq,IRQ,Switzerland,CHE,78,140,80,243,541
2011,Italy,ITA,Switzerland,CHE,0,0,0,10,10
2011,Jordan,JOR,Switzerland,CHE,0,0,0,5,5
2011,Kazakhstan,KAZ,Switzerland,CHE,0,0,0,10,10
2011,Kenya,KEN,Switzerland,CHE,5,5,0,13,23
2011,Kyrgyzstan,KGZ,Switzerland,CHE,0,0,14,5,19
2011,Liberia,LBR,Switzerland,CHE,5,0,0,79,84
2011,Libya,LBY,Switzerland,CHE,16,0,0,166,182
2011,Lebanon,LBN,Switzerland,CHE,0,0,0,18,18
2011,Sri Lanka,LKA,Switzerland,CHE,90,100,478,187,855
2011,Lithuania,LTU,Switzerland,CHE,0,0,0,10,10
2011,Mauritania,MRT,Switzerland,CHE,0,0,0,38,38
2011,North Macedonia,MKD,Switzerland,CHE,0,13,133,578,724
2011,Rep. of Moldova,MDA,Switzerland,CHE,0,0,0,27,27
2011,Mali,MLI,Switzerland,CHE,0,0,0,53,53
2011,Malawi,MWI,Switzerland,CHE,0,0,0,5,5
2011,Mongolia,MNG,Switzerland,CHE,0,0,25,55,80
2011,Morocco,MAR,Switzerland,CHE,0,0,23,350,373
2011,Montenegro,MNE,Switzerland,CHE,0,0,0,14,14
2011,Nepal,NPL,Switzerland,CHE,0,0,20,5,25
2011,Niger,NER,Switzerland,CHE,0,0,0,83,83
2011,Nigeria,NGA,Switzerland,CHE,0,5,20,1792,1817
2011,Pakistan,PAK,Switzerland,CHE,5,0,22,59,86
2011,Poland,POL,Switzerland,CHE,0,0,0,5,5
2011,Romania,ROU,Switzerland,CHE,0,0,0,37,37
2011,Russian Federation,RUS,Switzerland,CHE,49,33,73,174,329
2011,Rwanda,RWA,Switzerland,CHE,5,0,0,5,10
2011,Serbia and Kosovo: S/RES/1244 (1999),SRB,Switzerland,CHE,14,96,433,730,1273
2011,Senegal,SEN,Switzerland,CHE,0,0,10,113,123
2011,Sierra Leone,SLE,Switzerland,CHE,0,0,5,79,84
2011,Somalia,SOM,Switzerland,CHE,152,282,18,195,647
2011,Spain,ESP,Switzerland,CHE,0,0,0,5,5
2011,Viet Nam,VNM,Switzerland,CHE,5,0,0,5,10
2011,Sudan,SDN,Switzerland,CHE,13,5,0,73,91
2011,Slovakia,SVK,Switzerland,CHE,0,0,0,5,5
2011,Syrian Arab Rep.,SYR,Switzerland,CHE,115,215,42,203,575
2011,United Rep. of Tanzania,TZA,Switzerland,CHE,0,0,0,5,5
2011,Turkmenistan,TKM,Switzerland,CHE,0,0,0,5,5
2011,Togo,TGO,Switzerland,CHE,41,10,14,50,115
2011,Tunisia,TUN,Switzerland,CHE,5,0,50,2044,2099
2011,Turkey,TUR,Switzerland,CHE,139,23,115,137,414
2011,Uganda,UGA,Switzerland,CHE,5,0,0,10,15
2011,Ukraine,UKR,Switzerland,CHE,0,0,5,23,28
2011,United States of America,USA,Switzerland,CHE,0,0,0,5,5
2011,Uzbekistan,UZB,Switzerland,CHE,5,0,5,5,15
2011,Western Sahara,ESH,Switzerland,CHE,0,0,0,5,5
2011,Yemen,YEM,Switzerland,CHE,14,13,0,22,49
2011,Zimbabwe,ZWE,Switzerland,CHE,0,5,0,23,28
2011,Stateless,XXA,Switzerland,CHE,0,5,0,0,5
2011,Afghanistan,AFG,Turkmenistan,TKM,0,0,0,5,5
2011,Benin,BEN,Togo,TGO,5,0,0,0,5
2011,Central African Rep.,CAF,Togo,TGO,5,0,0,0,5
2011,Congo,COG,Togo,TGO,10,0,0,0,10
2011,Dem. Rep. of the Congo,COD,Togo,TGO,11,0,5,0,16
2011,Guinea,GIN,Togo,TGO,0,0,5,0,5
2011,Cote d'Ivoire,CIV,Togo,TGO,0,5023,0,0,5023
2011,Rwanda,RWA,Togo,TGO,5,0,0,0,5
2011,Colombia,COL,Uruguay,URY,0,0,0,5,5
2011,Colombia,COL,Venezuela (Bolivarian Republic of),VEN,491,0,1166,0,1657
2011,Burundi,BDI,Zambia,ZMB,5,0,10,0,15
2011,Dem. Rep. of the Congo,COD,Zambia,ZMB,127,0,18,0,145
2011,Eritrea,ERI,Zambia,ZMB,0,0,5,0,5
2011,Ethiopia,ETH,Zambia,ZMB,5,0,0,5,10
2011,Rwanda,RWA,Zambia,ZMB,0,0,10,0,10
2011,Somalia,SOM,Zambia,ZMB,64,0,0,0,64
2011,Burundi,BDI,Zimbabwe,ZWE,0,0,10,11,21
2011,Dem. Rep. of the Congo,COD,Zimbabwe,ZWE,0,146,132,339,617
2011,Rwanda,RWA,Zimbabwe,ZWE,0,10,11,0,21
2011,Somalia,SOM,Zimbabwe,ZWE,0,0,0,11,11
2011,Uganda,UGA,Zimbabwe,ZWE,0,0,5,0,5
2012,Armenia,ARM,Argentina,ARG,5,0,5,0,10
2012,Bangladesh,BGD,Argentina,ARG,0,0,36,0,36
2012,China,CHN,Argentina,ARG,0,0,17,0,17
2012,Chile,CHL,Argentina,ARG,0,0,5,0,5
2012,Cameroon,CMR,Argentina,ARG,0,0,12,5,17
2012,Dem. Rep. of the Congo,COD,Argentina,ARG,5,0,0,5,10
2012,Colombia,COL,Argentina,ARG,35,0,63,99,197
2012,Cuba,CUB,Argentina,ARG,0,0,24,10,34
2012,Dominican Rep.,DOM,Argentina,ARG,0,0,94,26,120
2012,Ecuador,ECU,Argentina,ARG,0,0,5,0,5
2012,Ghana,GHA,Argentina,ARG,13,0,5,0,18
2012,Guinea,GIN,Argentina,ARG,5,0,0,0,5
2012,Haiti,HTI,Argentina,ARG,0,0,13,5,18
2012,Cote d'Ivoire,CIV,Argentina,ARG,0,0,0,5,5
2012,India,IND,Argentina,ARG,0,0,10,10,20
2012,Liberia,LBR,Argentina,ARG,0,0,0,14,14
2012,Nepal,NPL,Argentina,ARG,0,0,0,5,5
2012,Nigeria,NGA,Argentina,ARG,5,0,28,23,56
2012,Peru,PER,Argentina,ARG,0,0,0,10,10
2012,South Africa,ZAF,Argentina,ARG,0,0,5,0,5
2012,Senegal,SEN,Argentina,ARG,0,0,66,5,71
2012,Syrian Arab Rep.,SYR,Argentina,ARG,41,0,0,0,41
2012,Venezuela (Bolivarian Republic of),VEN,Argentina,ARG,0,0,5,0,5
2012,Yemen,YEM,Argentina,ARG,15,0,0,0,15
2012,Stateless,XXA,Argentina,ARG,5,0,0,0,5
2012,Congo,COG,Armenia,ARM,0,0,5,0,5
2012,Dem. Rep. of the Congo,COD,Armenia,ARM,0,0,0,5,5
2012,Cote d'Ivoire,CIV,Armenia,ARM,0,0,5,0,5
2012,Iran (Islamic Rep. of),IRN,Armenia,ARM,5,0,11,0,16
2012,Iraq,IRQ,Armenia,ARM,20,0,0,0,20
2012,Liberia,LBR,Armenia,ARM,0,0,0,10,10
2012,Syrian Arab Rep.,SYR,Armenia,ARM,130,0,0,26,156
2012,Turkey,TUR,Armenia,ARM,0,0,0,5,5
2012,Afghanistan,AFG,Australia,AUS,1874,0,496,79,2449
2012,Albania,ALB,Australia,AUS,5,0,13,0,18
2012,Egypt,EGY,Australia,AUS,140,0,210,0,350
2012,Bahrain,BHR,Australia,AUS,0,0,11,0,11
2012,Burundi,BDI,Australia,AUS,0,0,5,0,5
2012,Bangladesh,BGD,Australia,AUS,45,0,105,0,150
2012,Brazil,BRA,Australia,AUS,0,0,14,0,14
2012,Cambodia,KHM,Australia,AUS,0,0,18,0,18
2012,China,CHN,Australia,AUS,70,0,1013,0,1083
2012,Dem. Rep. of the Congo,COD,Australia,AUS,5,0,0,0,5
2012,Colombia,COL,Australia,AUS,0,0,30,0,30
2012,Djibouti,DJI,Australia,AUS,0,0,5,0,5
2012,Estonia,EST,Australia,AUS,0,0,5,0,5
2012,Ethiopia,ETH,Australia,AUS,5,0,16,0,21
2012,Fiji,FJI,Australia,AUS,29,0,225,0,254
2012,Palestinian,PSE,Australia,AUS,49,0,5,0,54
2012,United Kingdom of Great Britain and Northern Ireland,GBR,Australia,AUS,0,0,20,0,20
2012,Georgia,GEO,Australia,AUS,0,0,14,0,14
2012,Germany,DEU,Australia,AUS,0,0,5,0,5
2012,Ghana,GHA,Australia,AUS,0,0,18,0,18
2012,Guinea,GIN,Australia,AUS,0,0,5,0,5
2012,"China, Hong Kong SAR",HKG,Australia,AUS,0,0,16,0,16
2012,Hungary,HUN,Australia,AUS,0,0,5,0,5
2012,India,IND,Australia,AUS,0,0,716,0,716
2012,Indonesia,IDN,Australia,AUS,10,0,86,0,96
2012,Iran (Islamic Rep. of),IRN,Australia,AUS,1023,0,488,73,1584
2012,Iraq,IRQ,Australia,AUS,342,0,118,27,487
2012,Israel,ISR,Australia,AUS,0,0,5,0,5
2012,Jordan,JOR,Australia,AUS,12,0,38,0,50
2012,Kenya,KEN,Australia,AUS,5,0,25,0,30
2012,Rep. of Korea,KOR,Australia,AUS,5,0,51,0,56
2012,Liberia,LBR,Australia,AUS,0,0,5,0,5
2012,Libya,LBY,Australia,AUS,81,0,80,0,161
2012,Lebanon,LBN,Australia,AUS,18,0,208,0,226
2012,Sri Lanka,LKA,Australia,AUS,166,0,490,296,952
2012,Malaysia,MYS,Australia,AUS,10,0,134,0,144
2012,Mongolia,MNG,Australia,AUS,0,0,5,0,5
2012,Mauritius,MUS,Australia,AUS,0,0,26,0,26
2012,Myanmar,MMR,Australia,AUS,49,0,12,0,61
2012,Nepal,NPL,Australia,AUS,5,0,274,0,279
2012,Nigeria,NGA,Australia,AUS,0,0,62,0,62
2012,Pakistan,PAK,Australia,AUS,669,0,444,59,1172
2012,Peru,PER,Australia,AUS,0,0,14,0,14
2012,Philippines,PHL,Australia,AUS,5,0,45,0,50
2012,Papua New Guinea,PNG,Australia,AUS,30,0,16,0,46
2012,Portugal,PRT,Australia,AUS,0,0,5,0,5
2012,Romania,ROU,Australia,AUS,0,0,5,0,5
2012,South Africa,ZAF,Australia,AUS,0,0,10,0,10
2012,Russian Federation,RUS,Australia,AUS,0,0,16,0,16
2012,Rwanda,RWA,Australia,AUS,5,0,5,0,10
2012,Saudi Arabia,SAU,Australia,AUS,15,0,0,0,15
2012,Senegal,SEN,Australia,AUS,0,0,5,0,5
2012,Singapore,SGP,Australia,AUS,0,0,10,0,10
2012,Sierra Leone,SLE,Australia,AUS,0,0,5,0,5
2012,Somalia,SOM,Australia,AUS,0,0,14,0,14
2012,Viet Nam,VNM,Australia,AUS,5,0,66,0,71
2012,Sudan,SDN,Australia,AUS,5,0,5,0,10
2012,Syrian Arab Rep.,SYR,Australia,AUS,117,0,11,0,128
2012,Thailand,THA,Australia,AUS,0,0,20,0,20
2012,Tonga,TON,Australia,AUS,5,0,40,0,45
2012,Turkey,TUR,Australia,AUS,36,0,56,0,92
2012,Uganda,UGA,Australia,AUS,0,0,14,0,14
2012,Ukraine,UKR,Australia,AUS,0,0,16,0,16
2012,United States of America,USA,Australia,AUS,0,0,10,0,10
2012,Yemen,YEM,Australia,AUS,5,0,0,0,5
2012,Zambia,ZMB,Australia,AUS,0,0,5,0,5
2012,Zimbabwe,ZWE,Australia,AUS,28,0,90,0,118
2012,Stateless,XXA,Australia,AUS,349,0,109,0,458
2012,Afghanistan,AFG,Azerbaijan,AZE,5,0,41,0,46
2012,Algeria,DZA,Azerbaijan,AZE,0,0,5,0,5
2012,Palestinian,PSE,Azerbaijan,AZE,0,0,5,0,5
2012,Iran (Islamic Rep. of),IRN,Azerbaijan,AZE,0,0,5,0,5
2012,Pakistan,PAK,Azerbaijan,AZE,0,0,27,0,27
2012,Syrian Arab Rep.,SYR,Azerbaijan,AZE,0,0,5,0,5
2012,Afghanistan,AFG,Belgium,BEL,567,937,1021,39,2564
2012,Albania,ALB,Belgium,BEL,219,5,1298,157,1679
2012,Algeria,DZA,Belgium,BEL,10,0,111,41,162
2012,Angola,AGO,Belgium,BEL,5,0,145,5,155
2012,Egypt,EGY,Belgium,BEL,5,0,37,0,42
2012,Argentina,ARG,Belgium,BEL,0,0,5,0,5
2012,Armenia,ARM,Belgium,BEL,17,10,449,19,495
2012,Azerbaijan,AZE,Belgium,BEL,12,0,148,11,171
2012,Burundi,BDI,Belgium,BEL,44,0,233,12,289
2012,Benin,BEN,Belgium,BEL,5,0,59,5,69
2012,Bangladesh,BGD,Belgium,BEL,0,0,343,26,369
2012,Bhutan,BTN,Belgium,BEL,0,0,11,0,11
2012,Burkina Faso,BFA,Belgium,BEL,23,0,102,0,125
2012,Belarus,BLR,Belgium,BEL,10,0,80,11,101
2012,Bosnia and Herzegovina,BIH,Belgium,BEL,5,0,319,35,359
2012,Bulgaria,BGR,Belgium,BEL,0,0,26,0,26
2012,Canada,CAN,Belgium,BEL,0,0,5,0,5
2012,Central African Rep.,CAF,Belgium,BEL,0,0,5,0,5
2012,Chad,TCD,Belgium,BEL,5,0,5,0,10
2012,China,CHN,Belgium,BEL,283,0,24,5,312
2012,Cameroon,CMR,Belgium,BEL,86,0,398,15,499
2012,Congo,COG,Belgium,BEL,5,0,14,0,19
2012,Dem. Rep. of the Congo,COD,Belgium,BEL,167,12,1411,78,1668
2012,Colombia,COL,Belgium,BEL,0,0,5,0,5
2012,Cuba,CUB,Belgium,BEL,0,0,5,0,5
2012,Djibouti,DJI,Belgium,BEL,21,0,54,0,75
2012,Equatorial Guinea,GNQ,Belgium,BEL,5,0,0,0,5
2012,Eritrea,ERI,Belgium,BEL,13,0,13,0,26
2012,Ethiopia,ETH,Belgium,BEL,5,0,11,0,16
2012,France,FRA,Belgium,BEL,0,0,0,5,5
2012,Gabon,GAB,Belgium,BEL,0,0,5,0,5
2012,Gambia,GMB,Belgium,BEL,5,0,43,5,53
2012,Palestinian,PSE,Belgium,BEL,0,11,0,0,11
2012,Georgia,GEO,Belgium,BEL,5,5,495,57,562
2012,Ghana,GHA,Belgium,BEL,5,0,88,5,98
2012,Guinea-Bissau,GNB,Belgium,BEL,0,0,10,0,10
2012,Guatemala,GTM,Belgium,BEL,0,5,0,0,5
2012,Guinea,GIN,Belgium,BEL,608,10,2201,97,2916
2012,Croatia,HRV,Belgium,BEL,0,0,23,0,23
2012,Hungary,HUN,Belgium,BEL,0,0,5,0,5
2012,Cote d'Ivoire,CIV,Belgium,BEL,42,0,287,19,348
2012,India,IND,Belgium,BEL,0,0,113,12,125
2012,Iran (Islamic Rep. of),IRN,Belgium,BEL,169,0,120,44,333
2012,Iraq,IRQ,Belgium,BEL,290,17,891,131,1329
2012,Israel,ISR,Belgium,BEL,0,0,5,0,5
2012,Jordan,JOR,Belgium,BEL,0,0,14,0,14
2012,Kazakhstan,KAZ,Belgium,BEL,5,0,266,45,316
2012,Kenya,KEN,Belgium,BEL,10,0,41,5,56
2012,Kyrgyzstan,KGZ,Belgium,BEL,35,0,187,21,243
2012,Dem. People's Rep. of Korea,PRK,Belgium,BEL,25,0,0,25,50
2012,Liberia,LBR,Belgium,BEL,0,0,26,0,26
2012,Lebanon,LBN,Belgium,BEL,0,0,37,18,55
2012,Sri Lanka,LKA,Belgium,BEL,44,0,32,5,81
2012,Madagascar,MDG,Belgium,BEL,0,0,5,0,5
2012,Mauritania,MRT,Belgium,BEL,52,0,189,19,260
2012,North Macedonia,MKD,Belgium,BEL,16,0,596,56,668
2012,Rep. of Moldova,MDA,Belgium,BEL,0,0,10,5,15
2012,Mali,MLI,Belgium,BEL,5,0,13,0,18
2012,Mongolia,MNG,Belgium,BEL,0,0,45,5,50
2012,Morocco,MAR,Belgium,BEL,5,0,52,15,72
2012,Montenegro,MNE,Belgium,BEL,0,0,120,5,125
2012,Mauritius,MUS,Belgium,BEL,0,0,5,0,5
2012,Myanmar,MMR,Belgium,BEL,0,0,5,0,5
2012,Nepal,NPL,Belgium,BEL,5,0,252,35,292
2012,Niger,NER,Belgium,BEL,5,0,82,0,87
2012,Nicaragua,NIC,Belgium,BEL,0,0,5,0,5
2012,Nigeria,NGA,Belgium,BEL,10,0,139,5,154
2012,Pakistan,PAK,Belgium,BEL,22,5,380,44,451
2012,Romania,ROU,Belgium,BEL,0,0,51,0,51
2012,Russian Federation,RUS,Belgium,BEL,375,0,1443,73,1891
2012,Rwanda,RWA,Belgium,BEL,141,0,412,13,566
2012,El Salvador,SLV,Belgium,BEL,0,0,10,0,10
2012,Serbia and Kosovo: S/RES/1244 (1999),SRB,Belgium,BEL,144,14,1979,142,2279
2012,Senegal,SEN,Belgium,BEL,49,0,278,10,337
2012,Sierra Leone,SLE,Belgium,BEL,5,0,41,0,46
2012,Somalia,SOM,Belgium,BEL,101,32,185,11,329
2012,Viet Nam,VNM,Belgium,BEL,0,0,0,5,5
2012,Sudan,SDN,Belgium,BEL,37,10,29,0,76
2012,Suriname,SUR,Belgium,BEL,0,0,5,5,10
2012,Slovakia,SVK,Belgium,BEL,0,0,23,0,23
2012,Syrian Arab Rep.,SYR,Belgium,BEL,129,469,0,32,630
2012,United Rep. of Tanzania,TZA,Belgium,BEL,5,0,74,5,84
2012,Tajikistan,TJK,Belgium,BEL,0,0,10,0,10
2012,Togo,TGO,Belgium,BEL,24,0,205,5,234
2012,Tunisia,TUN,Belgium,BEL,0,0,15,5,20
2012,Turkey,TUR,Belgium,BEL,75,0,193,27,295
2012,Uganda,UGA,Belgium,BEL,5,0,11,0,16
2012,Ukraine,UKR,Belgium,BEL,10,0,75,16,101
2012,United States of America,USA,Belgium,BEL,0,0,5,0,5
2012,Uzbekistan,UZB,Belgium,BEL,5,0,15,5,25
2012,Stateless,XXA,Belgium,BEL,0,0,10,0,10
2012,Cameroon,CMR,Benin,BEN,0,0,0,10,10
2012,Congo,COG,Benin,BEN,5,0,0,0,5
2012,Dem. Rep. of the Congo,COD,Benin,BEN,0,0,0,45,45
2012,Eritrea,ERI,Benin,BEN,0,0,13,0,13
2012,Cote d'Ivoire,CIV,Benin,BEN,149,0,0,109,258
2012,Mali,MLI,Benin,BEN,5,0,0,0,5
2012,Niger,NER,Benin,BEN,0,0,0,5,5
2012,Nigeria,NGA,Benin,BEN,0,0,28,0,28
2012,Sudan,SDN,Benin,BEN,0,0,0,5,5
2012,Togo,TGO,Benin,BEN,0,0,0,26,26
2012,Afghanistan,AFG,Belarus,BLR,10,0,24,5,39
2012,Egypt,EGY,Belarus,BLR,0,0,5,0,5
2012,Georgia,GEO,Belarus,BLR,0,0,11,0,11
2012,Iran (Islamic Rep. of),IRN,Belarus,BLR,5,0,0,0,5
2012,Russian Federation,RUS,Belarus,BLR,0,0,5,0,5
2012,Syrian Arab Rep.,SYR,Belarus,BLR,0,0,0,5,5
2012,Argentina,ARG,Bolivia (Plurinational State of),BOL,0,0,0,5,5
2012,Colombia,COL,Bolivia (Plurinational State of),BOL,12,5,18,5,40
2012,Afghanistan,AFG,Brazil,BRA,5,0,0,0,5
2012,Angola,AGO,Brazil,BRA,5,0,29,0,34
2012,Egypt,EGY,Brazil,BRA,0,0,5,0,5
2012,Bangladesh,BGD,Brazil,BRA,0,0,58,5,63
2012,Bhutan,BTN,Brazil,BRA,13,0,0,0,13
2012,Bolivia (Plurinational State of),BOL,Brazil,BRA,10,0,0,0,10
2012,Dem. Rep. of the Congo,COD,Brazil,BRA,40,0,35,0,75
2012,Colombia,COL,Brazil,BRA,52,0,84,0,136
2012,Cuba,CUB,Brazil,BRA,0,0,30,0,30
2012,Dominican Rep.,DOM,Brazil,BRA,0,0,5,0,5
2012,Ecuador,ECU,Brazil,BRA,0,0,5,0,5
2012,Ghana,GHA,Brazil,BRA,0,0,5,0,5
2012,Guinea-Bissau,GNB,Brazil,BRA,0,0,67,0,67
2012,Guinea,GIN,Brazil,BRA,0,0,5,0,5
2012,Cote d'Ivoire,CIV,Brazil,BRA,5,0,0,0,5
2012,India,IND,Brazil,BRA,0,0,5,0,5
2012,Iran (Islamic Rep. of),IRN,Brazil,BRA,5,0,0,0,5
2012,Iraq,IRQ,Brazil,BRA,5,0,0,0,5
2012,Morocco,MAR,Brazil,BRA,0,0,5,0,5
2012,Nigeria,NGA,Brazil,BRA,5,0,41,0,46
2012,Pakistan,PAK,Brazil,BRA,5,0,40,0,45
2012,Senegal,SEN,Brazil,BRA,5,0,25,0,30
2012,Sierra Leone,SLE,Brazil,BRA,0,0,5,0,5
2012,Somalia,SOM,Brazil,BRA,0,0,15,0,15
2012,Sudan,SDN,Brazil,BRA,5,0,5,0,10
2012,Syrian Arab Rep.,SYR,Brazil,BRA,36,0,0,0,36
2012,Venezuela (Bolivarian Republic of),VEN,Brazil,BRA,0,0,5,0,5
2012,Guatemala,GTM,Belize,BLZ,0,0,0,11,11
2012,El Salvador,SLV,Belize,BLZ,0,0,33,0,33
2012,Sri Lanka,LKA,Cambodia,KHM,0,0,0,5,5
2012,Myanmar,MMR,Cambodia,KHM,13,0,0,5,18
2012,Afghanistan,AFG,Canada,CAN,302,0,57,35,394
2012,Albania,ALB,Canada,CAN,63,0,118,23,204
2012,Algeria,DZA,Canada,CAN,57,0,89,17,163
2012,Angola,AGO,Canada,CAN,12,0,0,0,12
2012,Antigua and Barbuda,ATG,Canada,CAN,11,0,18,5,34
2012,Egypt,EGY,Canada,CAN,90,0,28,5,123
2012,Argentina,ARG,Canada,CAN,0,0,23,5,28
2012,Armenia,ARM,Canada,CAN,11,0,13,5,29
2012,Australia,AUS,Canada,CAN,0,0,5,0,5
2012,Azerbaijan,AZE,Canada,CAN,14,0,10,0,24
2012,Bahrain,BHR,Canada,CAN,0,0,5,0,5
2012,Barbados,BRB,Canada,CAN,22,0,32,5,59
2012,Burundi,BDI,Canada,CAN,156,0,37,5,198
2012,Belgium,BEL,Canada,CAN,0,0,0,5,5
2012,Benin,BEN,Canada,CAN,12,0,0,0,12
2012,Bangladesh,BGD,Canada,CAN,30,0,65,15,110
2012,Bahamas,BHS,Canada,CAN,10,0,10,0,20
2012,Burkina Faso,BFA,Canada,CAN,14,0,0,0,14
2012,Belarus,BLR,Canada,CAN,14,0,5,0,19
2012,Bolivia (Plurinational State of),BOL,Canada,CAN,12,0,0,0,12
2012,Botswana,BWA,Canada,CAN,88,0,51,14,153
2012,Brazil,BRA,Canada,CAN,0,0,58,18,76
2012,Bosnia and Herzegovina,BIH,Canada,CAN,5,0,58,5,68
2012,Bulgaria,BGR,Canada,CAN,21,0,12,5,38
2012,Belize,BLZ,Canada,CAN,5,0,5,0,10
2012,Cambodia,KHM,Canada,CAN,5,0,0,13,18
2012,Central African Rep.,CAF,Canada,CAN,5,0,0,0,5
2012,Chad,TCD,Canada,CAN,18,0,5,0,23
2012,China,CHN,Canada,CAN,626,0,880,210,1716
2012,Chile,CHL,Canada,CAN,5,0,36,15,56
2012,Cameroon,CMR,Canada,CAN,100,0,44,15,159
2012,Congo,COG,Canada,CAN,43,0,37,0,80
2012,Dem. Rep. of the Congo,COD,Canada,CAN,290,0,169,29,488
2012,Colombia,COL,Canada,CAN,482,0,731,113,1326
2012,Costa Rica,CRI,Canada,CAN,0,0,19,5,24
2012,Cuba,CUB,Canada,CAN,79,0,73,16,168
2012,Czechia,CZE,Canada,CAN,25,0,385,96,506
2012,Djibouti,DJI,Canada,CAN,116,0,25,5,146
2012,Dominica,DMA,Canada,CAN,0,0,5,0,5
2012,Dominican Rep.,DOM,Canada,CAN,21,0,70,30,121
2012,Ecuador,ECU,Canada,CAN,5,0,33,10,48
2012,Eritrea,ERI,Canada,CAN,154,0,16,5,175
2012,Estonia,EST,Canada,CAN,11,0,0,0,11
2012,Ethiopia,ETH,Canada,CAN,158,0,16,10,184
2012,Fiji,FJI,Canada,CAN,5,0,29,0,34
2012,France,FRA,Canada,CAN,0,0,18,18,36
2012,Gabon,GAB,Canada,CAN,13,0,0,0,13
2012,Gambia,GMB,Canada,CAN,0,0,13,0,13
2012,Palestinian,PSE,Canada,CAN,27,0,12,5,44
2012,United Kingdom of Great Britain and Northern Ireland,GBR,Canada,CAN,5,0,14,5,24
2012,Georgia,GEO,Canada,CAN,25,0,41,17,83
2012,Germany,DEU,Canada,CAN,0,0,14,0,14
2012,Ghana,GHA,Canada,CAN,37,0,53,5,95
2012,Greece,GRC,Canada,CAN,0,0,23,5,28
2012,Grenada,GRD,Canada,CAN,5,0,21,5,31
2012,Guatemala,GTM,Canada,CAN,74,0,205,28,307
2012,Guinea,GIN,Canada,CAN,69,0,39,5,113
2012,Guyana,GUY,Canada,CAN,17,0,39,10,66
2012,Haiti,HTI,Canada,CAN,571,0,605,46,1222
2012,"China, Hong Kong SAR",HKG,Canada,CAN,0,0,19,26,45
2012,Honduras,HND,Canada,CAN,131,0,193,40,364
2012,Croatia,HRV,Canada,CAN,23,0,246,77,346
2012,Hungary,HUN,Canada,CAN,448,0,2151,1553,4152
2012,Cote d'Ivoire,CIV,Canada,CAN,42,0,32,11,85
2012,India,IND,Canada,CAN,118,0,288,169,575
2012,Indonesia,IDN,Canada,CAN,15,0,21,0,36
2012,Ireland,IRL,Canada,CAN,0,0,5,0,5
2012,Iran (Islamic Rep. of),IRN,Canada,CAN,245,0,44,19,308
2012,Iraq,IRQ,Canada,CAN,90,0,34,13,137
2012,Israel,ISR,Canada,CAN,19,0,180,87,286
2012,Italy,ITA,Canada,CAN,0,0,15,11,26
2012,Jamaica,JAM,Canada,CAN,134,0,179,50,363
2012,Jordan,JOR,Canada,CAN,17,0,29,5,51
2012,Japan,JPN,Canada,CAN,0,0,20,5,25
2012,Kazakhstan,KAZ,Canada,CAN,10,0,5,10,25
2012,Kenya,KEN,Canada,CAN,52,0,22,0,74
2012,Kyrgyzstan,KGZ,Canada,CAN,5,0,5,0,10
2012,Rep. of Korea,KOR,Canada,CAN,10,0,58,27,95
2012,Dem. People's Rep. of Korea,PRK,Canada,CAN,230,0,18,42,290
2012,Kuwait,KWT,Canada,CAN,18,0,0,12,30
2012,Lao People's Dem. Rep.,LAO,Canada,CAN,0,0,11,0,11
2012,Liberia,LBR,Canada,CAN,16,0,13,0,29
2012,Libya,LBY,Canada,CAN,34,0,33,22,89
2012,Saint Lucia,LCA,Canada,CAN,300,0,236,62,598
2012,Lebanon,LBN,Canada,CAN,47,0,79,15,141
2012,Sri Lanka,LKA,Canada,CAN,371,0,269,20,660
2012,Lithuania,LTU,Canada,CAN,14,0,14,31,59
2012,Latvia,LVA,Canada,CAN,23,0,44,14,81
2012,Madagascar,MDG,Canada,CAN,0,0,5,0,5
2012,Mauritania,MRT,Canada,CAN,18,0,5,5,28
2012,North Macedonia,MKD,Canada,CAN,18,0,16,0,34
2012,Rep. of Moldova,MDA,Canada,CAN,15,0,20,10,45
2012,Mexico,MEX,Canada,CAN,568,0,2144,310,3022
2012,Mali,MLI,Canada,CAN,13,0,0,5,18
2012,Malaysia,MYS,Canada,CAN,5,0,12,0,17
2012,Malawi,MWI,Canada,CAN,5,0,0,0,5
2012,Mongolia,MNG,Canada,CAN,5,0,13,0,18
2012,Morocco,MAR,Canada,CAN,13,0,21,21,55
2012,Montenegro,MNE,Canada,CAN,0,0,5,5,10
2012,Mauritius,MUS,Canada,CAN,0,0,5,0,5
2012,Namibia,NAM,Canada,CAN,170,0,354,28,552
2012,Nepal,NPL,Canada,CAN,39,0,21,0,60
2012,Netherlands,NLD,Canada,CAN,0,0,11,10,21
2012,Niger,NER,Canada,CAN,15,0,5,0,20
2012,Nicaragua,NIC,Canada,CAN,15,0,19,10,44
2012,Nigeria,NGA,Canada,CAN,521,0,388,32,941
2012,Pakistan,PAK,Canada,CAN,500,0,182,54,736
2012,Panama,PAN,Canada,CAN,0,0,12,0,12
2012,Paraguay,PRY,Canada,CAN,0,0,5,0,5
2012,Peru,PER,Canada,CAN,31,0,101,15,147
2012,Philippines,PHL,Canada,CAN,11,0,121,15,147
2012,Poland,POL,Canada,CAN,24,0,128,90,242
2012,Portugal,PRT,Canada,CAN,0,0,73,5,78
2012,Qatar,QAT,Canada,CAN,5,0,0,0,5
2012,Romania,ROU,Canada,CAN,39,0,47,60,146
2012,South Africa,ZAF,Canada,CAN,5,0,16,0,21
2012,Russian Federation,RUS,Canada,CAN,104,0,56,23,183
2012,Rwanda,RWA,Canada,CAN,99,0,55,5,159
2012,El Salvador,SLV,Canada,CAN,188,0,358,30,576
2012,Saudi Arabia,SAU,Canada,CAN,5,0,13,5,23
2012,Serbia and Kosovo: S/RES/1244 (1999),SRB,Canada,CAN,40,0,68,20,128
2012,Senegal,SEN,Canada,CAN,29,0,20,10,59
2012,Singapore,SGP,Canada,CAN,0,0,0,11,11
2012,Sierra Leone,SLE,Canada,CAN,16,0,5,0,21
2012,Somalia,SOM,Canada,CAN,354,0,28,85,467
2012,Spain,ESP,Canada,CAN,0,0,49,10,59
2012,Viet Nam,VNM,Canada,CAN,10,0,12,5,27
2012,Saint Kitts and Nevis,KNA,Canada,CAN,5,0,0,0,5
2012,Sudan,SDN,Canada,CAN,45,0,10,5,60
2012,Slovakia,SVK,Canada,CAN,15,0,160,283,458
2012,Slovenia,SVN,Canada,CAN,5,0,0,0,5
2012,Eswatini,SWZ,Canada,CAN,58,0,14,0,72
2012,Sweden,SWE,Canada,CAN,0,0,0,5,5
2012,Syrian Arab Rep.,SYR,Canada,CAN,156,0,35,5,196
2012,United Rep. of Tanzania,TZA,Canada,CAN,14,0,5,0,19
2012,Thailand,THA,Canada,CAN,5,0,16,10,31
2012,Tajikistan,TJK,Canada,CAN,11,0,0,0,11
2012,Turkmenistan,TKM,Canada,CAN,5,0,0,0,5
2012,Togo,TGO,Canada,CAN,14,0,5,0,19
2012,Trinidad and Tobago,TTO,Canada,CAN,10,0,28,12,50
2012,Tunisia,TUN,Canada,CAN,22,0,30,13,65
2012,Turkey,TUR,Canada,CAN,162,0,138,44,344
2012,United Arab Emirates,ARE,Canada,CAN,5,0,0,0,5
2012,Uganda,UGA,Canada,CAN,45,0,10,5,60
2012,Ukraine,UKR,Canada,CAN,72,0,57,23,152
2012,Uruguay,URY,Canada,CAN,0,0,11,5,16
2012,United States of America,USA,Canada,CAN,5,0,317,81,403
2012,Uzbekistan,UZB,Canada,CAN,24,0,10,5,39
2012,Saint Vincent and the Grenadines,VCT,Canada,CAN,308,0,400,64,772
2012,Venezuela (Bolivarian Republic of),VEN,Canada,CAN,74,0,86,20,180
2012,Yemen,YEM,Canada,CAN,14,0,5,0,19
2012,Zambia,ZMB,Canada,CAN,5,0,5,0,10
2012,Zimbabwe,ZWE,Canada,CAN,33,0,23,5,61
2012,Colombia,COL,Chile,CHL,10,0,159,0,169
2012,Cuba,CUB,Chile,CHL,0,0,5,0,5
2012,Nepal,NPL,Chile,CHL,0,0,5,0,5
2012,Afghanistan,AFG,Colombia,COL,0,0,0,5,5
2012,Cuba,CUB,Colombia,COL,0,0,43,11,54
2012,Ecuador,ECU,Colombia,COL,5,0,0,0,5
2012,Eritrea,ERI,Colombia,COL,0,0,0,31,31
2012,Ethiopia,ETH,Colombia,COL,0,0,0,5,5
2012,Sri Lanka,LKA,Colombia,COL,0,0,0,5,5
2012,Nepal,NPL,Colombia,COL,0,0,0,5,5
2012,Somalia,SOM,Colombia,COL,0,0,0,13,13
2012,Venezuela (Bolivarian Republic of),VEN,Colombia,COL,0,0,5,0,5
2012,Bangladesh,BGD,Costa Rica,CRI,0,0,10,0,10
2012,Dem. Rep. of the Congo,COD,Costa Rica,CRI,0,0,0,5,5
2012,Colombia,COL,Costa Rica,CRI,62,0,187,215,464
2012,Cuba,CUB,Costa Rica,CRI,41,0,56,265,362
2012,Honduras,HND,Costa Rica,CRI,0,0,13,0,13
2012,Nepal,NPL,Costa Rica,CRI,0,0,13,0,13
2012,Nicaragua,NIC,Costa Rica,CRI,0,0,0,5,5
2012,Nigeria,NGA,Costa Rica,CRI,5,0,5,0,10
2012,El Salvador,SLV,Costa Rica,CRI,5,0,43,31,79
2012,Somalia,SOM,Costa Rica,CRI,0,0,0,5,5
2012,Venezuela (Bolivarian Republic of),VEN,Costa Rica,CRI,13,0,0,0,13
2012,Afghanistan,AFG,Cyprus,CYP,0,0,44,0,44
2012,Egypt,EGY,Cyprus,CYP,0,0,149,28,177
2012,Bangladesh,BGD,Cyprus,CYP,0,0,173,10,183
2012,China,CHN,Cyprus,CYP,0,0,14,0,14
2012,Cameroon,CMR,Cyprus,CYP,0,0,24,5,29
2012,Palestinian,PSE,Cyprus,CYP,50,15,83,64,212
2012,Georgia,GEO,Cyprus,CYP,0,0,5,0,5
2012,Cote d'Ivoire,CIV,Cyprus,CYP,0,0,5,0,5
2012,India,IND,Cyprus,CYP,0,0,62,14,76
2012,Iran (Islamic Rep. of),IRN,Cyprus,CYP,0,5,56,13,74
2012,Iraq,IRQ,Cyprus,CYP,19,0,76,5,100
2012,Jordan,JOR,Cyprus,CYP,0,0,11,5,16
2012,Lebanon,LBN,Cyprus,CYP,12,0,0,0,12
2012,Sri Lanka,LKA,Cyprus,CYP,0,5,54,5,64
2012,Rep. of Moldova,MDA,Cyprus,CYP,0,0,5,0,5
2012,Nepal,NPL,Cyprus,CYP,0,0,20,5,25
2012,Nigeria,NGA,Cyprus,CYP,0,0,16,0,16
2012,Pakistan,PAK,Cyprus,CYP,0,0,129,20,149
2012,Philippines,PHL,Cyprus,CYP,0,0,38,0,38
2012,Russian Federation,RUS,Cyprus,CYP,0,0,0,14,14
2012,Viet Nam,VNM,Cyprus,CYP,0,0,211,5,216
2012,Syrian Arab Rep.,SYR,Cyprus,CYP,0,0,10,56,66
2012,Turkey,TUR,Cyprus,CYP,0,0,19,0,19
2012,Ukraine,UKR,Cyprus,CYP,0,0,5,5,10
2012,Afghanistan,AFG,Czechia,CZE,0,10,0,5,15
2012,Algeria,DZA,Czechia,CZE,0,0,0,13,13
2012,Egypt,EGY,Czechia,CZE,0,0,0,5,5
2012,Armenia,ARM,Czechia,CZE,0,0,15,5,20
2012,Azerbaijan,AZE,Czechia,CZE,0,0,0,11,11
2012,Belarus,BLR,Czechia,CZE,10,25,0,15,50
2012,Bosnia and Herzegovina,BIH,Czechia,CZE,0,0,5,0,5
2012,China,CHN,Czechia,CZE,0,0,5,5,10
2012,Cameroon,CMR,Czechia,CZE,0,0,0,5,5
2012,Dem. Rep. of the Congo,COD,Czechia,CZE,0,0,0,5,5
2012,Cuba,CUB,Czechia,CZE,0,19,0,0,19
2012,Eritrea,ERI,Czechia,CZE,0,10,0,0,10
2012,Georgia,GEO,Czechia,CZE,0,0,13,0,13
2012,Ghana,GHA,Czechia,CZE,0,0,0,5,5
2012,India,IND,Czechia,CZE,0,0,5,0,5
2012,Iran (Islamic Rep. of),IRN,Czechia,CZE,0,0,5,5,10
2012,Iraq,IRQ,Czechia,CZE,0,5,0,5,10
2012,Kazakhstan,KAZ,Czechia,CZE,5,12,5,17,39
2012,Kyrgyzstan,KGZ,Czechia,CZE,0,5,5,12,22
2012,Libya,LBY,Czechia,CZE,0,0,0,5,5
2012,Sri Lanka,LKA,Czechia,CZE,0,5,0,0,5
2012,Rep. of Moldova,MDA,Czechia,CZE,0,0,10,0,10
2012,Mongolia,MNG,Czechia,CZE,0,0,17,14,31
2012,Myanmar,MMR,Czechia,CZE,5,0,0,0,5
2012,Nigeria,NGA,Czechia,CZE,0,0,11,12,23
2012,Pakistan,PAK,Czechia,CZE,12,0,0,0,12
2012,Poland,POL,Czechia,CZE,0,0,0,5,5
2012,Russian Federation,RUS,Czechia,CZE,5,0,23,17,45
2012,Saudi Arabia,SAU,Czechia,CZE,5,0,0,0,5
2012,Serbia and Kosovo: S/RES/1244 (1999),SRB,Czechia,CZE,0,0,0,13,13
2012,Senegal,SEN,Czechia,CZE,0,0,5,0,5
2012,Viet Nam,VNM,Czechia,CZE,0,0,33,24,57
2012,Slovakia,SVK,Czechia,CZE,0,0,0,5,5
2012,Syrian Arab Rep.,SYR,Czechia,CZE,0,20,0,10,30
2012,Tunisia,TUN,Czechia,CZE,0,0,5,0,5
2012,Turkey,TUR,Czechia,CZE,0,0,12,5,17
2012,Ukraine,UKR,Czechia,CZE,5,5,117,74,201
2012,Uzbekistan,UZB,Czechia,CZE,10,11,0,0,21
2012,Stateless,XXA,Czechia,CZE,0,18,0,10,28
2012,Afghanistan,AFG,Denmark,DNK,20,103,346,0,469
2012,Albania,ALB,Denmark,DNK,0,0,30,0,30
2012,Algeria,DZA,Denmark,DNK,0,0,10,0,10
2012,Egypt,EGY,Denmark,DNK,0,0,5,0,5
2012,Armenia,ARM,Denmark,DNK,0,0,46,0,46
2012,Azerbaijan,AZE,Denmark,DNK,0,0,18,0,18
2012,Bangladesh,BGD,Denmark,DNK,0,0,56,0,56
2012,Belarus,BLR,Denmark,DNK,0,0,19,0,19
2012,Bosnia and Herzegovina,BIH,Denmark,DNK,0,0,44,0,44
2012,China,CHN,Denmark,DNK,0,0,11,0,11
2012,Cameroon,CMR,Denmark,DNK,0,0,5,0,5
2012,Dem. Rep. of the Congo,COD,Denmark,DNK,5,5,13,0,23
2012,Eritrea,ERI,Denmark,DNK,0,5,5,0,10
2012,Ethiopia,ETH,Denmark,DNK,5,0,0,0,5
2012,Gambia,GMB,Denmark,DNK,0,0,10,0,10
2012,Ghana,GHA,Denmark,DNK,0,0,14,0,14
2012,Guinea-Bissau,GNB,Denmark,DNK,0,0,5,0,5
2012,Guinea,GIN,Denmark,DNK,0,0,5,0,5
2012,Hungary,HUN,Denmark,DNK,0,0,5,0,5
2012,Cote d'Ivoire,CIV,Denmark,DNK,5,0,5,0,10
2012,India,IND,Denmark,DNK,0,0,10,0,10
2012,Iran (Islamic Rep. of),IRN,Denmark,DNK,225,38,144,0,407
2012,Iraq,IRQ,Denmark,DNK,5,5,56,0,66
2012,Kazakhstan,KAZ,Denmark,DNK,0,0,5,0,5
2012,Libya,LBY,Denmark,DNK,0,0,15,0,15
2012,Lebanon,LBN,Denmark,DNK,0,0,12,0,12
2012,Sri Lanka,LKA,Denmark,DNK,0,0,20,0,20
2012,North Macedonia,MKD,Denmark,DNK,0,0,10,0,10
2012,Mali,MLI,Denmark,DNK,0,0,5,0,5
2012,Morocco,MAR,Denmark,DNK,0,0,11,0,11
2012,Nepal,NPL,Denmark,DNK,0,0,5,0,5
2012,Nigeria,NGA,Denmark,DNK,0,0,55,0,55
2012,Pakistan,PAK,Denmark,DNK,5,5,21,0,31
2012,Russian Federation,RUS,Denmark,DNK,78,50,103,0,231
2012,Rwanda,RWA,Denmark,DNK,5,0,0,0,5
2012,Serbia and Kosovo: S/RES/1244 (1999),SRB,Denmark,DNK,0,0,510,0,510
2012,Somalia,SOM,Denmark,DNK,5,262,20,0,287
2012,Sudan,SDN,Denmark,DNK,5,5,0,0,10
2012,Syrian Arab Rep.,SYR,Denmark,DNK,606,55,81,0,742
2012,Tajikistan,TJK,Denmark,DNK,5,0,0,0,5
2012,Tunisia,TUN,Denmark,DNK,0,0,5,0,5
2012,Turkey,TUR,Denmark,DNK,0,0,13,0,13
2012,Uganda,UGA,Denmark,DNK,0,0,21,0,21
2012,Uzbekistan,UZB,Denmark,DNK,5,0,5,0,10
2012,Stateless,XXA,Denmark,DNK,53,0,53,0,106
2012,Haiti,HTI,Dominican Rep.,DOM,25,0,28,964,1017
2012,Iran (Islamic Rep. of),IRN,Dominican Rep.,DOM,0,0,0,5,5
2012,Iraq,IRQ,Dominican Rep.,DOM,5,0,0,0,5
2012,Armenia,ARM,Estonia,EST,5,0,0,0,5
2012,Georgia,GEO,Estonia,EST,0,5,19,10,34
2012,Russian Federation,RUS,Estonia,EST,0,0,5,0,5
2012,Somalia,SOM,Estonia,EST,5,0,0,0,5
2012,Viet Nam,VNM,Estonia,EST,0,0,5,0,5
2012,Syrian Arab Rep.,SYR,Estonia,EST,0,0,5,0,5
2012,Afghanistan,AFG,Finland,FIN,74,135,74,45,328
2012,Albania,ALB,Finland,FIN,0,0,13,11,24
2012,Algeria,DZA,Finland,FIN,0,0,21,51,72
2012,Angola,AGO,Finland,FIN,15,0,15,5,35
2012,Egypt,EGY,Finland,FIN,0,0,14,5,19
2012,Armenia,ARM,Finland,FIN,0,0,5,5,10
2012,Azerbaijan,AZE,Finland,FIN,0,0,0,13,13
2012,Bangladesh,BGD,Finland,FIN,0,0,14,5,19
2012,Belarus,BLR,Finland,FIN,0,0,13,48,61
2012,Bosnia and Herzegovina,BIH,Finland,FIN,0,0,72,26,98
2012,Bulgaria,BGR,Finland,FIN,0,0,11,0,11
2012,China,CHN,Finland,FIN,16,5,0,5,26
2012,Cameroon,CMR,Finland,FIN,0,0,19,5,24
2012,Dem. Rep. of the Congo,COD,Finland,FIN,12,5,20,10,47
2012,Colombia,COL,Finland,FIN,0,0,5,0,5
2012,Cuba,CUB,Finland,FIN,0,0,0,5,5
2012,Ecuador,ECU,Finland,FIN,0,0,0,5,5
2012,Equatorial Guinea,GNQ,Finland,FIN,0,0,5,0,5
2012,Eritrea,ERI,Finland,FIN,5,0,0,0,5
2012,Ethiopia,ETH,Finland,FIN,5,0,13,5,23
2012,Gambia,GMB,Finland,FIN,0,0,13,14,27
2012,Georgia,GEO,Finland,FIN,0,0,5,43,48
2012,Ghana,GHA,Finland,FIN,5,0,24,5,34
2012,Guinea-Bissau,GNB,Finland,FIN,0,0,0,5,5
2012,Greece,GRC,Finland,FIN,0,0,5,0,5
2012,Guatemala,GTM,Finland,FIN,0,5,0,0,5
2012,Guinea,GIN,Finland,FIN,0,0,11,5,16
2012,Cote d'Ivoire,CIV,Finland,FIN,0,0,0,5,5
2012,India,IND,Finland,FIN,0,0,10,5,15
2012,Iran (Islamic Rep. of),IRN,Finland,FIN,84,13,44,29,170
2012,Iraq,IRQ,Finland,FIN,103,274,119,218,714
2012,Kazakhstan,KAZ,Finland,FIN,0,0,0,5,5
2012,Kenya,KEN,Finland,FIN,0,0,5,0,5
2012,Kyrgyzstan,KGZ,Finland,FIN,0,5,0,5,10
2012,Liberia,LBR,Finland,FIN,0,0,0,5,5
2012,Libya,LBY,Finland,FIN,0,0,5,15,20
2012,Lebanon,LBN,Finland,FIN,5,0,0,0,5
2012,Sri Lanka,LKA,Finland,FIN,0,5,16,10,31
2012,North Macedonia,MKD,Finland,FIN,0,0,15,11,26
2012,Rep. of Moldova,MDA,Finland,FIN,0,0,0,5,5
2012,Morocco,MAR,Finland,FIN,0,0,10,32,42
2012,Montenegro,MNE,Finland,FIN,0,0,19,5,24
2012,Myanmar,MMR,Finland,FIN,5,0,0,0,5
2012,Nigeria,NGA,Finland,FIN,5,0,26,33,64
2012,Pakistan,PAK,Finland,FIN,0,0,0,5,5
2012,Russian Federation,RUS,Finland,FIN,83,36,192,68,379
2012,Rwanda,RWA,Finland,FIN,12,0,0,0,12
2012,Serbia and Kosovo: S/RES/1244 (1999),SRB,Finland,FIN,0,0,131,49,180
2012,Senegal,SEN,Finland,FIN,0,0,5,5,10
2012,Sierra Leone,SLE,Finland,FIN,0,0,11,0,11
2012,Somalia,SOM,Finland,FIN,16,210,71,82,379
2012,Sudan,SDN,Finland,FIN,0,0,11,0,11
2012,Syrian Arab Rep.,SYR,Finland,FIN,71,71,0,28,170
2012,United Rep. of Tanzania,TZA,Finland,FIN,0,0,5,0,5
2012,Tunisia,TUN,Finland,FIN,0,0,0,23,23
2012,Turkey,TUR,Finland,FIN,0,0,39,28,67
2012,United Arab Emirates,ARE,Finland,FIN,0,0,0,5,5
2012,Uganda,UGA,Finland,FIN,5,0,0,0,5
2012,Ukraine,UKR,Finland,FIN,0,0,0,5,5
2012,Venezuela (Bolivarian Republic of),VEN,Finland,FIN,5,0,0,0,5
2012,Stateless,XXA,Finland,FIN,22,12,0,16,50
2012,Afghanistan,AFG,France,FRA,125,139,316,0,580
2012,Albania,ALB,France,FRA,10,10,428,0,448
2012,Algeria,DZA,France,FRA,20,17,1002,0,1039
2012,Angola,AGO,France,FRA,47,10,621,0,678
2012,Egypt,EGY,France,FRA,41,0,342,0,383
2012,Armenia,ARM,France,FRA,100,50,2687,0,2837
2012,Azerbaijan,AZE,France,FRA,59,0,336,0,395
2012,Burundi,BDI,France,FRA,16,0,21,0,37
2012,Benin,BEN,France,FRA,0,0,14,0,14
2012,Bangladesh,BGD,France,FRA,47,5,3550,0,3602
2012,Bhutan,BTN,France,FRA,5,0,38,0,43
2012,Burkina Faso,BFA,France,FRA,5,0,23,0,28
2012,Belarus,BLR,France,FRA,10,0,60,0,70
2012,Bolivia (Plurinational State of),BOL,France,FRA,0,0,10,0,10
2012,Brazil,BRA,France,FRA,0,0,12,0,12
2012,Bosnia and Herzegovina,BIH,France,FRA,12,0,349,0,361
2012,Bulgaria,BGR,France,FRA,0,0,5,0,5
2012,Cambodia,KHM,France,FRA,5,0,26,0,31
2012,Central African Rep.,CAF,France,FRA,10,0,51,0,61
2012,Chad,TCD,France,FRA,15,10,189,0,214
2012,China,CHN,France,FRA,376,0,2141,0,2517
2012,Chile,CHL,France,FRA,0,0,5,0,5
2012,Cameroon,CMR,France,FRA,18,5,225,0,248
2012,Congo,COG,France,FRA,46,13,600,0,659
2012,Dem. Rep. of the Congo,COD,France,FRA,331,21,3812,0,4164
2012,Comoros,COM,France,FRA,22,5,565,0,592
2012,Colombia,COL,France,FRA,14,0,85,0,99
2012,Cuba,CUB,France,FRA,5,0,10,0,15
2012,Cabo Verde,CPV,France,FRA,0,0,5,0,5
2012,Djibouti,DJI,France,FRA,0,13,10,0,23
2012,Dominica,DMA,France,FRA,0,0,5,0,5
2012,Dominican Rep.,DOM,France,FRA,0,0,109,0,109
2012,Eritrea,ERI,France,FRA,92,0,558,0,650
2012,Ethiopia,ETH,France,FRA,21,0,100,0,121
2012,Gabon,GAB,France,FRA,0,5,12,0,17
2012,Gambia,GMB,France,FRA,0,5,56,0,61
2012,Palestinian,PSE,France,FRA,23,0,43,0,66
2012,Georgia,GEO,France,FRA,31,5,1737,0,1773
2012,Ghana,GHA,France,FRA,0,0,25,0,25
2012,Guinea-Bissau,GNB,France,FRA,14,5,110,0,129
2012,Guinea,GIN,France,FRA,111,175,1394,0,1680
2012,Guyana,GUY,France,FRA,0,0,73,0,73
2012,Haiti,HTI,France,FRA,31,31,1705,0,1767
2012,Croatia,HRV,France,FRA,0,0,10,0,10
2012,Cote d'Ivoire,CIV,France,FRA,49,59,1043,0,1151
2012,India,IND,France,FRA,0,0,31,0,31
2012,Iran (Islamic Rep. of),IRN,France,FRA,101,5,89,0,195
2012,Iraq,IRQ,France,FRA,102,0,47,0,149
2012,Israel,ISR,France,FRA,0,0,5,0,5
2012,Jamaica,JAM,France,FRA,0,0,5,0,5
2012,Kazakhstan,KAZ,France,FRA,10,0,89,0,99
2012,Kenya,KEN,France,FRA,5,5,24,0,34
2012,Kyrgyzstan,KGZ,France,FRA,5,0,65,0,70
2012,Lao People's Dem. Rep.,LAO,France,FRA,0,0,10,0,10
2012,Liberia,LBR,France,FRA,0,0,13,0,13
2012,Libya,LBY,France,FRA,5,0,78,0,83
2012,Saint Lucia,LCA,France,FRA,0,0,5,0,5
2012,Lebanon,LBN,France,FRA,0,0,15,0,15
2012,Sri Lanka,LKA,France,FRA,187,10,2942,0,3139
2012,Madagascar,MDG,France,FRA,13,0,107,0,120
2012,Mauritania,MRT,France,FRA,49,24,1442,0,1515
2012,North Macedonia,MKD,France,FRA,5,0,432,0,437
2012,Rep. of Moldova,MDA,France,FRA,0,0,155,0,155
2012,Mexico,MEX,France,FRA,0,0,5,0,5
2012,Mali,MLI,France,FRA,17,267,313,0,597
2012,Mongolia,MNG,France,FRA,5,10,257,0,272
2012,Morocco,MAR,France,FRA,29,5,117,0,151
2012,Montenegro,MNE,France,FRA,0,0,210,0,210
2012,Mauritius,MUS,France,FRA,0,0,5,0,5
2012,Myanmar,MMR,France,FRA,5,0,166,0,171
2012,Nepal,NPL,France,FRA,5,0,130,0,135
2012,Niger,NER,France,FRA,0,0,10,0,10
2012,Nigeria,NGA,France,FRA,5,41,764,0,810
2012,Pakistan,PAK,France,FRA,25,0,1515,0,1540
2012,Peru,PER,France,FRA,0,5,120,0,125
2012,Philippines,PHL,France,FRA,0,0,5,0,5
2012,Romania,ROU,France,FRA,0,0,10,0,10
2012,South Africa,ZAF,France,FRA,0,0,5,0,5
2012,Russian Federation,RUS,France,FRA,257,5,2249,0,2511
2012,Rwanda,RWA,France,FRA,118,0,147,0,265
2012,El Salvador,SLV,France,FRA,0,0,5,0,5
2012,Serbia and Kosovo: S/RES/1244 (1999),SRB,France,FRA,56,10,1752,0,1818
2012,Senegal,SEN,France,FRA,15,38,112,0,165
2012,Sierra Leone,SLE,France,FRA,10,10,129,0,149
2012,Somalia,SOM,France,FRA,36,46,492,0,574
2012,Viet Nam,VNM,France,FRA,12,0,19,0,31
2012,Sudan,SDN,France,FRA,71,10,768,0,849
2012,Suriname,SUR,France,FRA,0,0,5,0,5
2012,Syrian Arab Rep.,SYR,France,FRA,126,117,21,0,264
2012,Thailand,THA,France,FRA,0,0,31,0,31
2012,Tajikistan,TJK,France,FRA,0,0,5,0,5
2012,Togo,TGO,France,FRA,11,0,93,0,104
2012,Tunisia,TUN,France,FRA,5,0,160,0,165
2012,Turkey,TUR,France,FRA,78,0,1693,0,1771
2012,Uganda,UGA,France,FRA,5,0,10,0,15
2012,Ukraine,UKR,France,FRA,5,0,87,0,92
2012,Uzbekistan,UZB,France,FRA,5,0,14,0,19
2012,Venezuela (Bolivarian Republic of),VEN,France,FRA,0,0,10,0,10
2012,Western Sahara,ESH,France,FRA,28,0,55,0,83
2012,Yemen,YEM,France,FRA,5,0,0,0,5
2012,Zimbabwe,ZWE,France,FRA,5,0,0,0,5
2012,Dem. Rep. of the Congo,COD,Gambia,GMB,5,0,0,0,5
2012,Cote d'Ivoire,CIV,Gambia,GMB,15,0,0,0,15
2012,Iraq,IRQ,Gambia,GMB,5,0,0,0,5
2012,Afghanistan,AFG,United Kingdom of Great Britain and Northern Ireland,GBR,204,149,578,234,1165
2012,Albania,ALB,United Kingdom of Great Britain and Northern Ireland,GBR,85,100,309,141,635
2012,Algeria,DZA,United Kingdom of Great Britain and Northern Ireland,GBR,17,5,148,98,268
2012,Angola,AGO,United Kingdom of Great Britain and Northern Ireland,GBR,5,10,25,0,40
2012,Egypt,EGY,United Kingdom of Great Britain and Northern Ireland,GBR,64,0,155,27,246
2012,Argentina,ARG,United Kingdom of Great Britain and Northern Ireland,GBR,0,0,5,0,5
2012,Armenia,ARM,United Kingdom of Great Britain and Northern Ireland,GBR,5,0,5,0,10
2012,Azerbaijan,AZE,United Kingdom of Great Britain and Northern Ireland,GBR,5,0,11,0,16
2012,Bahrain,BHR,United Kingdom of Great Britain and Northern Ireland,GBR,29,0,15,5,49
2012,Barbados,BRB,United Kingdom of Great Britain and Northern Ireland,GBR,0,0,5,0,5
2012,Bangladesh,BGD,United Kingdom of Great Britain and Northern Ireland,GBR,32,18,737,199,986
2012,Bhutan,BTN,United Kingdom of Great Britain and Northern Ireland,GBR,5,0,5,0,10
2012,Belarus,BLR,United Kingdom of Great Britain and Northern Ireland,GBR,15,0,10,0,25
2012,Bolivia (Plurinational State of),BOL,United Kingdom of Great Britain and Northern Ireland,GBR,0,0,0,13,13
2012,Botswana,BWA,United Kingdom of Great Britain and Northern Ireland,GBR,0,5,11,0,16
2012,Brazil,BRA,United Kingdom of Great Britain and Northern Ireland,GBR,0,0,14,15,29
2012,Bosnia and Herzegovina,BIH,United Kingdom of Great Britain and Northern Ireland,GBR,0,12,0,0,12
2012,Bulgaria,BGR,United Kingdom of Great Britain and Northern Ireland,GBR,0,0,10,0,10
2012,Canada,CAN,United Kingdom of Great Britain and Northern Ireland,GBR,0,0,11,0,11
2012,Chad,TCD,United Kingdom of Great Britain and Northern Ireland,GBR,0,0,0,10,10
2012,China,CHN,United Kingdom of Great Britain and Northern Ireland,GBR,51,90,613,155,909
2012,Cameroon,CMR,United Kingdom of Great Britain and Northern Ireland,GBR,30,5,63,5,103
2012,Congo,COG,United Kingdom of Great Britain and Northern Ireland,GBR,5,0,12,5,22
2012,Dem. Rep. of the Congo,COD,United Kingdom of Great Britain and Northern Ireland,GBR,65,18,125,15,223
2012,Colombia,COL,United Kingdom of Great Britain and Northern Ireland,GBR,0,0,13,5,18
2012,Cuba,CUB,United Kingdom of Great Britain and Northern Ireland,GBR,0,0,5,0,5
2012,Dominica,DMA,United Kingdom of Great Britain and Northern Ireland,GBR,0,0,5,0,5
2012,Eritrea,ERI,United Kingdom of Great Britain and Northern Ireland,GBR,618,5,81,65,769
2012,Ethiopia,ETH,United Kingdom of Great Britain and Northern Ireland,GBR,45,5,63,14,127
2012,Fiji,FJI,United Kingdom of Great Britain and Northern Ireland,GBR,5,0,0,0,5
2012,Gambia,GMB,United Kingdom of Great Britain and Northern Ireland,GBR,104,60,232,15,411
2012,Palestinian,PSE,United Kingdom of Great Britain and Northern Ireland,GBR,24,5,76,39,144
2012,United Kingdom of Great Britain and Northern Ireland,GBR,United Kingdom of Great Britain and Northern Ireland,GBR,0,0,14,0,14
2012,Georgia,GEO,United Kingdom of Great Britain and Northern Ireland,GBR,5,0,15,10,30
2012,Ghana,GHA,United Kingdom of Great Britain and Northern Ireland,GBR,5,32,132,33,202
2012,Guinea-Bissau,GNB,United Kingdom of Great Britain and Northern Ireland,GBR,0,0,0,5,5
2012,Greece,GRC,United Kingdom of Great Britain and Northern Ireland,GBR,0,0,5,0,5
2012,Guinea,GIN,United Kingdom of Great Britain and Northern Ireland,GBR,12,10,35,0,57
2012,Guyana,GUY,United Kingdom of Great Britain and Northern Ireland,GBR,5,0,0,0,5
2012,Honduras,HND,United Kingdom of Great Britain and Northern Ireland,GBR,0,15,5,0,20
2012,Croatia,HRV,United Kingdom of Great Britain and Northern Ireland,GBR,0,0,5,0,5
2012,Cote d'Ivoire,CIV,United Kingdom of Great Britain and Northern Ireland,GBR,17,5,41,5,68
2012,India,IND,United Kingdom of Great Britain and Northern Ireland,GBR,5,5,551,374,935
2012,Iran (Islamic Rep. of),IRN,United Kingdom of Great Britain and Northern Ireland,GBR,1338,85,1150,201,2774
2012,Iraq,IRQ,United Kingdom of Great Britain and Northern Ireland,GBR,63,32,188,52,335
2012,Israel,ISR,United Kingdom of Great Britain and Northern Ireland,GBR,0,0,5,0,5
2012,Jamaica,JAM,United Kingdom of Great Britain and Northern Ireland,GBR,12,11,81,25,129
2012,Jordan,JOR,United Kingdom of Great Britain and Northern Ireland,GBR,0,5,15,0,20
2012,Kenya,KEN,United Kingdom of Great Britain and Northern Ireland,GBR,10,10,77,5,102
2012,Kyrgyzstan,KGZ,United Kingdom of Great Britain and Northern Ireland,GBR,0,0,11,0,11
2012,Rep. of Korea,KOR,United Kingdom of Great Britain and Northern Ireland,GBR,0,0,11,0,11
2012,Dem. People's Rep. of Korea,PRK,United Kingdom of Great Britain and Northern Ireland,GBR,10,0,13,5,28
2012,Kuwait,KWT,United Kingdom of Great Britain and Northern Ireland,GBR,36,0,33,5,74
2012,Liberia,LBR,United Kingdom of Great Britain and Northern Ireland,GBR,0,0,0,5,5
2012,Libya,LBY,United Kingdom of Great Britain and Northern Ireland,GBR,83,24,218,40,365
2012,Saint Lucia,LCA,United Kingdom of Great Britain and Northern Ireland,GBR,0,0,5,0,5
2012,Lebanon,LBN,United Kingdom of Great Britain and Northern Ireland,GBR,5,0,40,5,50
2012,Sri Lanka,LKA,United Kingdom of Great Britain and Northern Ireland,GBR,371,25,1281,89,1766
2012,Lithuania,LTU,United Kingdom of Great Britain and Northern Ireland,GBR,0,0,5,0,5
2012,North Macedonia,MKD,United Kingdom of Great Britain and Northern Ireland,GBR,0,5,0,0,5
2012,Rep. of Moldova,MDA,United Kingdom of Great Britain and Northern Ireland,GBR,0,0,0,5,5
2012,Maldives,MDV,United Kingdom of Great Britain and Northern Ireland,GBR,5,0,0,0,5
2012,Mexico,MEX,United Kingdom of Great Britain and Northern Ireland,GBR,0,0,5,0,5
2012,Mali,MLI,United Kingdom of Great Britain and Northern Ireland,GBR,0,0,5,5,10
2012,Malaysia,MYS,United Kingdom of Great Britain and Northern Ireland,GBR,14,5,33,10,62
2012,Malawi,MWI,United Kingdom of Great Britain and Northern Ireland,GBR,5,31,109,18,163
2012,Mongolia,MNG,United Kingdom of Great Britain and Northern Ireland,GBR,0,10,23,5,38
2012,Morocco,MAR,United Kingdom of Great Britain and Northern Ireland,GBR,5,10,31,10,56
2012,Mozambique,MOZ,United Kingdom of Great Britain and Northern Ireland,GBR,0,5,0,0,5
2012,Mauritius,MUS,United Kingdom of Great Britain and Northern Ireland,GBR,0,10,49,5,64
2012,Myanmar,MMR,United Kingdom of Great Britain and Northern Ireland,GBR,59,0,35,0,94
2012,Namibia,NAM,United Kingdom of Great Britain and Northern Ireland,GBR,0,0,21,0,21
2012,Nepal,NPL,United Kingdom of Great Britain and Northern Ireland,GBR,0,5,50,5,60
2012,Nigeria,NGA,United Kingdom of Great Britain and Northern Ireland,GBR,78,95,925,118,1216
2012,Pakistan,PAK,United Kingdom of Great Britain and Northern Ireland,GBR,599,63,3165,384,4211
2012,Philippines,PHL,United Kingdom of Great Britain and Northern Ireland,GBR,0,0,18,5,23
2012,Poland,POL,United Kingdom of Great Britain and Northern Ireland,GBR,0,0,13,5,18
2012,Romania,ROU,United Kingdom of Great Britain and Northern Ireland,GBR,0,0,5,0,5
2012,South Africa,ZAF,United Kingdom of Great Britain and Northern Ireland,GBR,0,5,60,10,75
2012,Russian Federation,RUS,United Kingdom of Great Britain and Northern Ireland,GBR,53,0,67,18,138
2012,Rwanda,RWA,United Kingdom of Great Britain and Northern Ireland,GBR,0,0,13,0,13
2012,El Salvador,SLV,United Kingdom of Great Britain and Northern Ireland,GBR,0,0,5,0,5
2012,Saudi Arabia,SAU,United Kingdom of Great Britain and Northern Ireland,GBR,14,0,0,5,19
2012,Serbia and Kosovo: S/RES/1244 (1999),SRB,United Kingdom of Great Britain and Northern Ireland,GBR,0,5,11,10,26
2012,Senegal,SEN,United Kingdom of Great Britain and Northern Ireland,GBR,12,0,34,0,46
2012,Sierra Leone,SLE,United Kingdom of Great Britain and Northern Ireland,GBR,5,15,61,0,81
2012,Somalia,SOM,United Kingdom of Great Britain and Northern Ireland,GBR,359,36,136,46,577
2012,Viet Nam,VNM,United Kingdom of Great Britain and Northern Ireland,GBR,16,20,106,192,334
2012,Sudan,SDN,United Kingdom of Great Britain and Northern Ireland,GBR,497,0,94,106,697
2012,Slovakia,SVK,United Kingdom of Great Britain and Northern Ireland,GBR,0,0,5,0,5
2012,Eswatini,SWZ,United Kingdom of Great Britain and Northern Ireland,GBR,0,0,5,0,5
2012,Syrian Arab Rep.,SYR,United Kingdom of Great Britain and Northern Ireland,GBR,868,51,195,62,1176
2012,United Rep. of Tanzania,TZA,United Kingdom of Great Britain and Northern Ireland,GBR,0,5,24,5,34
2012,Thailand,THA,United Kingdom of Great Britain and Northern Ireland,GBR,0,11,0,0,11
2012,Togo,TGO,United Kingdom of Great Britain and Northern Ireland,GBR,0,0,10,0,10
2012,Trinidad and Tobago,TTO,United Kingdom of Great Britain and Northern Ireland,GBR,5,0,13,0,18
2012,Tunisia,TUN,United Kingdom of Great Britain and Northern Ireland,GBR,0,5,17,5,27
2012,Turkey,TUR,United Kingdom of Great Britain and Northern Ireland,GBR,31,5,93,23,152
2012,Uganda,UGA,United Kingdom of Great Britain and Northern Ireland,GBR,107,20,132,11,270
2012,Ukraine,UKR,United Kingdom of Great Britain and Northern Ireland,GBR,10,0,33,12,55
2012,United States of America,USA,United Kingdom of Great Britain and Northern Ireland,GBR,0,5,12,5,22
2012,Uzbekistan,UZB,United Kingdom of Great Britain and Northern Ireland,GBR,11,0,10,0,21
2012,Saint Vincent and the Grenadines,VCT,United Kingdom of Great Britain and Northern Ireland,GBR,5,0,0,0,5
2012,Venezuela (Bolivarian Republic of),VEN,United Kingdom of Great Britain and Northern Ireland,GBR,5,0,0,0,5
2012,Yemen,YEM,United Kingdom of Great Britain and Northern Ireland,GBR,11,5,32,5,53
2012,Zambia,ZMB,United Kingdom of Great Britain and Northern Ireland,GBR,5,0,18,5,28
2012,Zimbabwe,ZWE,United Kingdom of Great Britain and Northern Ireland,GBR,133,98,235,23,489
2012,Stateless,XXA,United Kingdom of Great Britain and Northern Ireland,GBR,230,0,64,14,308
2012,Dem. Rep. of the Congo,COD,Ghana,GHA,5,0,17,0,22
2012,Ethiopia,ETH,Ghana,GHA,0,0,5,0,5
2012,Cote d'Ivoire,CIV,Ghana,GHA,9142,0,0,891,10033
2012,Sri Lanka,LKA,Ghana,GHA,0,0,5,0,5
2012,Rwanda,RWA,Ghana,GHA,0,0,5,0,5
2012,Sudan,SDN,Ghana,GHA,47,0,0,0,47
2012,Togo,TGO,Ghana,GHA,0,0,15,0,15
2012,Afghanistan,AFG,Greece,GRC,5,23,344,324,696
2012,Albania,ALB,Greece,GRC,0,0,318,86,404
2012,Algeria,DZA,Greece,GRC,0,0,337,35,372
2012,Egypt,EGY,Greece,GRC,0,0,339,100,439
2012,Armenia,ARM,Greece,GRC,0,0,43,37,80
2012,Azerbaijan,AZE,Greece,GRC,0,0,5,0,5
2012,Bahrain,BHR,Greece,GRC,0,0,0,5,5
2012,Bangladesh,BGD,Greece,GRC,0,0,1851,522,2373
2012,Burkina Faso,BFA,Greece,GRC,0,0,17,10,27
2012,Belarus,BLR,Greece,GRC,0,0,0,5,5
2012,China,CHN,Greece,GRC,0,0,279,97,376
2012,Cameroon,CMR,Greece,GRC,0,5,21,5,31
2012,Congo,COG,Greece,GRC,0,5,30,0,35
2012,Dem. Rep. of the Congo,COD,Greece,GRC,0,0,33,0,33
2012,Comoros,COM,Greece,GRC,0,0,10,0,10
2012,Cuba,CUB,Greece,GRC,0,0,5,5,10
2012,Dominican Rep.,DOM,Greece,GRC,0,0,308,107,415
2012,Eritrea,ERI,Greece,GRC,0,0,61,5,66
2012,Ethiopia,ETH,Greece,GRC,0,0,47,58,105
2012,Gambia,GMB,Greece,GRC,0,0,14,5,19
2012,Palestinian,PSE,Greece,GRC,0,0,13,11,24
2012,Georgia,GEO,Greece,GRC,0,5,1115,501,1621
2012,Ghana,GHA,Greece,GRC,0,0,198,55,253
2012,Guinea,GIN,Greece,GRC,0,0,46,10,56
2012,Cote d'Ivoire,CIV,Greece,GRC,0,0,84,5,89
2012,India,IND,Greece,GRC,0,0,263,144,407
2012,Indonesia,IDN,Greece,GRC,0,0,15,5,20
2012,Iran (Islamic Rep. of),IRN,Greece,GRC,5,5,227,85,322
2012,Iraq,IRQ,Greece,GRC,5,0,165,237,407
2012,Israel,ISR,Greece,GRC,0,0,0,18,18
2012,Kazakhstan,KAZ,Greece,GRC,0,0,0,5,5
2012,Kenya,KEN,Greece,GRC,0,0,10,16,26
2012,Liberia,LBR,Greece,GRC,0,0,10,0,10
2012,Libya,LBY,Greece,GRC,0,0,5,0,5
2012,Lebanon,LBN,Greece,GRC,0,0,5,5,10
2012,Sri Lanka,LKA,Greece,GRC,0,0,14,21,35
2012,Mauritania,MRT,Greece,GRC,0,0,12,0,12
2012,North Macedonia,MKD,Greece,GRC,0,0,5,0,5
2012,Rep. of Moldova,MDA,Greece,GRC,0,0,22,16,38
2012,Mali,MLI,Greece,GRC,0,0,14,0,14
2012,Morocco,MAR,Greece,GRC,0,0,199,53,252
2012,Myanmar,MMR,Greece,GRC,0,0,0,5,5
2012,Nepal,NPL,Greece,GRC,0,0,5,0,5
2012,Niger,NER,Greece,GRC,0,0,12,0,12
2012,Nigeria,NGA,Greece,GRC,0,0,521,130,651
2012,Pakistan,PAK,Greece,GRC,0,0,3309,1565,4874
2012,Philippines,PHL,Greece,GRC,0,0,24,16,40
2012,Russian Federation,RUS,Greece,GRC,0,0,34,35,69
2012,Rwanda,RWA,Greece,GRC,0,0,5,5,10
2012,El Salvador,SLV,Greece,GRC,0,0,0,5,5
2012,Serbia and Kosovo: S/RES/1244 (1999),SRB,Greece,GRC,0,0,0,10,10
2012,Senegal,SEN,Greece,GRC,0,0,245,93,338
2012,Sierra Leone,SLE,Greece,GRC,0,0,20,5,25
2012,Somalia,SOM,Greece,GRC,0,0,40,0,40
2012,Sudan,SDN,Greece,GRC,0,10,82,10,102
2012,Syrian Arab Rep.,SYR,Greece,GRC,0,0,150,114,264
2012,United Rep. of Tanzania,TZA,Greece,GRC,0,0,5,13,18
2012,Timor-Leste,TLS,Greece,GRC,0,0,5,12,17
2012,Togo,TGO,Greece,GRC,0,0,0,5,5
2012,Tunisia,TUN,Greece,GRC,0,0,38,10,48
2012,Turkey,TUR,Greece,GRC,5,5,25,17,52
2012,Uganda,UGA,Greece,GRC,0,0,0,5,5
2012,Ukraine,UKR,Greece,GRC,0,0,32,30,62
2012,Uzbekistan,UZB,Greece,GRC,0,0,5,5,10
2012,Colombia,COL,Guatemala,GTM,5,0,0,0,5
2012,Honduras,HND,Guatemala,GTM,5,0,0,0,5
2012,El Salvador,SLV,Guatemala,GTM,5,0,0,5,10
2012,Colombia,COL,Honduras,HND,0,0,0,5,5
2012,Somalia,SOM,Honduras,HND,0,0,0,5,5
2012,Afghanistan,AFG,Croatia,HRV,0,0,33,336,369
2012,Algeria,DZA,Croatia,HRV,0,0,41,76,117
2012,Egypt,EGY,Croatia,HRV,0,0,0,5,5
2012,Bangladesh,BGD,Croatia,HRV,0,0,0,11,11
2012,Bosnia and Herzegovina,BIH,Croatia,HRV,0,0,5,0,5
2012,Eritrea,ERI,Croatia,HRV,0,0,5,12,17
2012,Palestinian,PSE,Croatia,HRV,0,0,0,10,10
2012,Iran (Islamic Rep. of),IRN,Croatia,HRV,0,0,0,17,17
2012,Iraq,IRQ,Croatia,HRV,0,0,0,14,14
2012,Libya,LBY,Croatia,HRV,0,0,5,5,10
2012,Morocco,MAR,Croatia,HRV,0,0,20,12,32
2012,Pakistan,PAK,Croatia,HRV,0,0,5,49,54
2012,Russian Federation,RUS,Croatia,HRV,0,0,5,14,19
2012,Serbia and Kosovo: S/RES/1244 (1999),SRB,Croatia,HRV,0,0,0,12,12
2012,Somalia,SOM,Croatia,HRV,0,0,20,245,265
2012,Sudan,SDN,Croatia,HRV,0,0,0,12,12
2012,Syrian Arab Rep.,SYR,Croatia,HRV,0,12,0,38,50
2012,Tunisia,TUN,Croatia,HRV,0,0,13,0,13
2012,Turkey,TUR,Croatia,HRV,5,0,0,15,20
2012,Ukraine,UKR,Croatia,HRV,5,0,5,0,10
2012,Afghanistan,AFG,Hungary,HUN,32,143,166,490,831
2012,Albania,ALB,Hungary,HUN,0,0,0,5,5
2012,Algeria,DZA,Hungary,HUN,0,0,5,63,68
2012,Egypt,EGY,Hungary,HUN,0,0,13,0,13
2012,Armenia,ARM,Hungary,HUN,0,0,0,5,5
2012,Bangladesh,BGD,Hungary,HUN,0,0,0,20,20
2012,Belarus,BLR,Hungary,HUN,0,0,5,0,5
2012,Bulgaria,BGR,Hungary,HUN,0,0,0,5,5
2012,China,CHN,Hungary,HUN,0,0,20,10,30
2012,Cuba,CUB,Hungary,HUN,0,0,0,5,5
2012,Eritrea,ERI,Hungary,HUN,0,0,0,5,5
2012,Ethiopia,ETH,Hungary,HUN,5,0,0,0,5
2012,Palestinian,PSE,Hungary,HUN,0,10,0,17,27
2012,Georgia,GEO,Hungary,HUN,0,0,5,0,5
2012,Cote d'Ivoire,CIV,Hungary,HUN,0,0,5,0,5
2012,India,IND,Hungary,HUN,0,0,5,13,18
2012,Iran (Islamic Rep. of),IRN,Hungary,HUN,0,0,12,36,48
2012,Iraq,IRQ,Hungary,HUN,0,11,21,5,37
2012,Kenya,KEN,Hungary,HUN,0,0,0,5,5
2012,Liberia,LBR,Hungary,HUN,0,0,0,5,5
2012,Libya,LBY,Hungary,HUN,0,0,5,5,10
2012,Sri Lanka,LKA,Hungary,HUN,0,0,0,5,5
2012,Morocco,MAR,Hungary,HUN,0,0,0,28,28
2012,Montenegro,MNE,Hungary,HUN,0,0,0,5,5
2012,Nigeria,NGA,Hungary,HUN,0,0,5,20,25
2012,Pakistan,PAK,Hungary,HUN,0,12,76,258,346
2012,Russian Federation,RUS,Hungary,HUN,0,0,0,5,5
2012,Serbia and Kosovo: S/RES/1244 (1999),SRB,Hungary,HUN,5,0,5,284,294
2012,Sierra Leone,SLE,Hungary,HUN,0,0,0,13,13
2012,Somalia,SOM,Hungary,HUN,12,47,0,47,106
2012,Syrian Arab Rep.,SYR,Hungary,HUN,0,45,15,75,135
2012,Tunisia,TUN,Hungary,HUN,0,0,5,19,24
2012,Turkey,TUR,Hungary,HUN,0,5,5,14,24
2012,Afghanistan,AFG,Iceland,ISL,0,0,0,5,5
2012,Algeria,DZA,Iceland,ISL,0,0,0,5,5
2012,Georgia,GEO,Iceland,ISL,0,0,0,5,5
2012,Iran (Islamic Rep. of),IRN,Iceland,ISL,0,0,0,5,5
2012,Nigeria,NGA,Iceland,ISL,0,0,0,12,12
2012,Afghanistan,AFG,Ireland,IRL,5,0,25,30,60
2012,Albania,ALB,Ireland,IRL,0,0,25,10,35
2012,Algeria,DZA,Ireland,IRL,0,0,32,14,46
2012,Egypt,EGY,Ireland,IRL,12,0,5,5,22
2012,Benin,BEN,Ireland,IRL,0,0,5,0,5
2012,Bangladesh,BGD,Ireland,IRL,0,0,16,20,36
2012,Bhutan,BTN,Ireland,IRL,0,0,0,5,5
2012,Brazil,BRA,Ireland,IRL,0,0,13,0,13
2012,China,CHN,Ireland,IRL,0,0,10,25,35
2012,Cameroon,CMR,Ireland,IRL,0,0,10,5,15
2012,Congo,COG,Ireland,IRL,0,0,5,0,5
2012,Dem. Rep. of the Congo,COD,Ireland,IRL,5,0,48,10,63
2012,Eritrea,ERI,Ireland,IRL,0,0,5,5,10
2012,Palestinian,PSE,Ireland,IRL,0,0,5,5,10
2012,Georgia,GEO,Ireland,IRL,0,0,13,5,18
2012,Ghana,GHA,Ireland,IRL,0,0,11,0,11
2012,India,IND,Ireland,IRL,0,0,5,5,10
2012,Iran (Islamic Rep. of),IRN,Ireland,IRL,5,0,12,5,22
2012,Iraq,IRQ,Ireland,IRL,12,0,0,0,12
2012,Israel,ISR,Ireland,IRL,0,0,5,0,5
2012,Kuwait,KWT,Ireland,IRL,0,0,0,5,5
2012,Sri Lanka,LKA,Ireland,IRL,0,0,0,5,5
2012,Rep. of Moldova,MDA,Ireland,IRL,0,0,13,5,18
2012,Malawi,MWI,Ireland,IRL,5,0,21,0,26
2012,Mongolia,MNG,Ireland,IRL,0,0,0,5,5
2012,Morocco,MAR,Ireland,IRL,0,0,5,0,5
2012,Mauritius,MUS,Ireland,IRL,5,0,13,0,18
2012,Myanmar,MMR,Ireland,IRL,0,0,5,0,5
2012,Nepal,NPL,Ireland,IRL,0,0,11,26,37
2012,Nigeria,NGA,Ireland,IRL,5,0,116,53,174
2012,Pakistan,PAK,Ireland,IRL,0,0,85,54,139
2012,South Africa,ZAF,Ireland,IRL,0,0,33,5,38
2012,Russian Federation,RUS,Ireland,IRL,5,0,0,5,10
2012,Rwanda,RWA,Ireland,IRL,0,0,10,0,10
2012,Serbia and Kosovo: S/RES/1244 (1999),SRB,Ireland,IRL,0,0,5,5,10
2012,Sierra Leone,SLE,Ireland,IRL,0,0,5,5,10
2012,Somalia,SOM,Ireland,IRL,0,0,11,0,11
2012,Sudan,SDN,Ireland,IRL,0,0,5,11,16
2012,Eswatini,SWZ,Ireland,IRL,0,0,5,0,5
2012,Syrian Arab Rep.,SYR,Ireland,IRL,15,0,5,0,20
2012,United Rep. of Tanzania,TZA,Ireland,IRL,0,0,5,0,5
2012,Togo,TGO,Ireland,IRL,0,0,5,0,5
2012,Ukraine,UKR,Ireland,IRL,0,0,16,0,16
2012,United States of America,USA,Ireland,IRL,0,0,0,5,5
2012,Zimbabwe,ZWE,Ireland,IRL,0,0,45,10,55
2012,Stateless,XXA,Ireland,IRL,0,0,5,0,5
2012,Afghanistan,AFG,Italy,ITA,182,625,253,0,1060
2012,Albania,ALB,Italy,ITA,11,18,34,0,63
2012,Algeria,DZA,Italy,ITA,5,5,63,0,73
2012,Angola,AGO,Italy,ITA,0,0,5,0,5
2012,Egypt,EGY,Italy,ITA,109,68,109,0,286
2012,Armenia,ARM,Italy,ITA,5,11,11,0,27
2012,Azerbaijan,AZE,Italy,ITA,11,0,0,0,11
2012,Bahrain,BHR,Italy,ITA,5,0,0,0,5
2012,Benin,BEN,Italy,ITA,0,5,26,0,31
2012,Bangladesh,BGD,Italy,ITA,14,75,839,0,928
2012,Burkina Faso,BFA,Italy,ITA,5,41,293,0,339
2012,Brazil,BRA,Italy,ITA,0,0,10,0,10
2012,Bosnia and Herzegovina,BIH,Italy,ITA,0,56,67,0,123
2012,Chad,TCD,Italy,ITA,57,103,219,0,379
2012,China,CHN,Italy,ITA,5,0,25,0,30
2012,Chile,CHL,Italy,ITA,0,0,5,0,5
2012,Cameroon,CMR,Italy,ITA,24,18,63,0,105
2012,Congo,COG,Italy,ITA,20,13,29,0,62
2012,Dem. Rep. of the Congo,COD,Italy,ITA,29,22,21,0,72
2012,Colombia,COL,Italy,ITA,10,10,15,0,35
2012,Cuba,CUB,Italy,ITA,5,0,17,0,22
2012,Ecuador,ECU,Italy,ITA,0,0,5,0,5
2012,Eritrea,ERI,Italy,ITA,116,77,22,0,215
2012,Ethiopia,ETH,Italy,ITA,20,20,16,0,56
2012,Gabon,GAB,Italy,ITA,0,5,5,0,10
2012,Gambia,GMB,Italy,ITA,15,62,164,0,241
2012,Palestinian,PSE,Italy,ITA,36,5,15,0,56
2012,Georgia,GEO,Italy,ITA,5,0,37,0,42
2012,Ghana,GHA,Italy,ITA,19,250,1546,0,1815
2012,Guinea-Bissau,GNB,Italy,ITA,0,24,69,0,93
2012,Guinea,GIN,Italy,ITA,13,68,283,0,364
2012,Croatia,HRV,Italy,ITA,0,5,0,0,5
2012,Cote d'Ivoire,CIV,Italy,ITA,74,452,672,0,1198
2012,India,IND,Italy,ITA,0,0,21,0,21
2012,Iran (Islamic Rep. of),IRN,Italy,ITA,105,27,27,0,159
2012,Iraq,IRQ,Italy,ITA,38,159,39,0,236
2012,Jordan,JOR,Italy,ITA,5,0,0,0,5
2012,Kenya,KEN,Italy,ITA,5,0,5,0,10
2012,Liberia,LBR,Italy,ITA,5,5,79,0,89
2012,Libya,LBY,Italy,ITA,27,40,71,0,138
2012,Lebanon,LBN,Italy,ITA,13,5,16,0,34
2012,Sri Lanka,LKA,Italy,ITA,10,15,46,0,71
2012,Mauritania,MRT,Italy,ITA,18,19,59,0,96
2012,North Macedonia,MKD,Italy,ITA,0,5,15,0,20
2012,Rep. of Moldova,MDA,Italy,ITA,0,0,10,0,10
2012,Mali,MLI,Italy,ITA,32,1920,786,0,2738
2012,Mongolia,MNG,Italy,ITA,0,0,5,0,5
2012,Morocco,MAR,Italy,ITA,17,5,247,0,269
2012,Montenegro,MNE,Italy,ITA,0,13,5,0,18
2012,Nepal,NPL,Italy,ITA,5,0,0,0,5
2012,Niger,NER,Italy,ITA,12,50,319,0,381
2012,Nicaragua,NIC,Italy,ITA,0,0,5,0,5
2012,Nigeria,NGA,Italy,ITA,74,550,3779,0,4403
2012,Pakistan,PAK,Italy,ITA,130,573,1145,0,1848
2012,Peru,PER,Italy,ITA,0,5,5,0,10
2012,Philippines,PHL,Italy,ITA,0,0,5,0,5
2012,Russian Federation,RUS,Italy,ITA,15,0,5,0,20
2012,Rwanda,RWA,Italy,ITA,0,0,5,0,5
2012,El Salvador,SLV,Italy,ITA,0,0,13,0,13
2012,Serbia and Kosovo: S/RES/1244 (1999),SRB,Italy,ITA,0,42,119,0,161
2012,Senegal,SEN,Italy,ITA,36,92,674,0,802
2012,Sierra Leone,SLE,Italy,ITA,5,21,39,0,65
2012,Somalia,SOM,Italy,ITA,238,568,29,0,835
2012,Sudan,SDN,Italy,ITA,125,152,122,0,399
2012,South Sudan,SSD,Italy,ITA,55,0,0,0,55
2012,Syrian Arab Rep.,SYR,Italy,ITA,98,103,28,0,229
2012,Togo,TGO,Italy,ITA,10,40,70,0,120
2012,Tunisia,TUN,Italy,ITA,5,82,822,0,909
2012,Turkey,TUR,Italy,ITA,56,73,275,0,404
2012,Uganda,UGA,Italy,ITA,5,0,0,0,5
2012,Ukraine,UKR,Italy,ITA,0,0,11,0,11
2012,Stateless,XXA,Italy,ITA,5,0,0,0,5
2012,Afghanistan,AFG,Japan,JPN,0,0,5,0,5
2012,Egypt,EGY,Japan,JPN,0,0,5,0,5
2012,Bangladesh,BGD,Japan,JPN,0,5,155,5,165
2012,Brazil,BRA,Japan,JPN,0,0,5,0,5
2012,China,CHN,Japan,JPN,0,5,18,0,23
2012,Cameroon,CMR,Japan,JPN,0,0,66,5,71
2012,Ethiopia,ETH,Japan,JPN,0,0,12,0,12
2012,Gambia,GMB,Japan,JPN,0,0,5,0,5
2012,Ghana,GHA,Japan,JPN,0,0,29,0,29
2012,Guinea,GIN,Japan,JPN,0,0,5,0,5
2012,India,IND,Japan,JPN,0,0,98,5,103
2012,Indonesia,IDN,Japan,JPN,0,0,5,0,5
2012,Iran (Islamic Rep. of),IRN,Japan,JPN,0,0,50,5,55
2012,Rep. of Korea,KOR,Japan,JPN,0,0,0,5,5
2012,Sri Lanka,LKA,Japan,JPN,0,0,211,10,221
2012,Mali,MLI,Japan,JPN,0,0,5,0,5
2012,Mongolia,MNG,Japan,JPN,0,0,5,0,5
2012,Myanmar,MMR,Japan,JPN,5,35,335,10,385
2012,Nepal,NPL,Japan,JPN,0,0,305,5,310
2012,Nigeria,NGA,Japan,JPN,0,0,77,0,77
2012,Pakistan,PAK,Japan,JPN,0,0,247,14,261
2012,Peru,PER,Japan,JPN,0,0,5,0,5
2012,Philippines,PHL,Japan,JPN,0,0,16,0,16
2012,Russian Federation,RUS,Japan,JPN,0,0,0,5,5
2012,Senegal,SEN,Japan,JPN,0,0,5,0,5
2012,Viet Nam,VNM,Japan,JPN,0,0,5,0,5
2012,Syrian Arab Rep.,SYR,Japan,JPN,0,10,0,0,10
2012,Thailand,THA,Japan,JPN,0,0,5,0,5
2012,Tunisia,TUN,Japan,JPN,0,0,12,0,12
2012,Turkey,TUR,Japan,JPN,0,0,334,26,360
2012,Uganda,UGA,Japan,JPN,0,5,23,0,28
2012,Uzbekistan,UZB,Japan,JPN,0,0,0,5,5
2012,Afghanistan,AFG,Kazakhstan,KAZ,14,0,10,0,24
2012,China,CHN,Kazakhstan,KAZ,0,0,5,5,10
2012,Kyrgyzstan,KGZ,Kazakhstan,KAZ,0,0,5,5,10
2012,Syrian Arab Rep.,SYR,Kazakhstan,KAZ,0,0,5,0,5
2012,Afghanistan,AFG,Kyrgyzstan,KGZ,0,0,20,15,35
2012,Uzbekistan,UZB,Kyrgyzstan,KGZ,0,0,0,126,126
2012,Zimbabwe,ZWE,Lesotho,LSO,5,0,0,0,5
2012,Afghanistan,AFG,Liechtenstein,LIE,0,0,0,5,5
2012,Armenia,ARM,Liechtenstein,LIE,0,0,5,0,5
2012,Bosnia and Herzegovina,BIH,Liechtenstein,LIE,0,0,10,0,10
2012,Eritrea,ERI,Liechtenstein,LIE,5,0,0,0,5
2012,Iraq,IRQ,Liechtenstein,LIE,5,0,0,0,5
2012,Russian Federation,RUS,Liechtenstein,LIE,0,0,10,0,10
2012,Serbia and Kosovo: S/RES/1244 (1999),SRB,Liechtenstein,LIE,0,0,14,0,14
2012,Somalia,SOM,Liechtenstein,LIE,10,0,0,0,10
2012,Ukraine,UKR,Liechtenstein,LIE,0,0,5,0,5
2012,Afghanistan,AFG,Lithuania,LTU,0,23,0,53,76
2012,Armenia,ARM,Lithuania,LTU,0,0,0,5,5
2012,Belarus,BLR,Lithuania,LTU,0,13,5,0,18
2012,Eritrea,ERI,Lithuania,LTU,5,0,0,0,5
2012,Georgia,GEO,Lithuania,LTU,0,0,223,60,283
2012,Iraq,IRQ,Lithuania,LTU,5,0,0,0,5
2012,Kyrgyzstan,KGZ,Lithuania,LTU,0,0,17,0,17
2012,Russian Federation,RUS,Lithuania,LTU,0,0,27,18,45
2012,Viet Nam,VNM,Lithuania,LTU,0,0,40,5,45
2012,Ukraine,UKR,Lithuania,LTU,5,0,0,0,5
2012,Uzbekistan,UZB,Lithuania,LTU,0,0,0,5,5
2012,Afghanistan,AFG,Luxembourg,LUX,0,0,5,0,5
2012,Albania,ALB,Luxembourg,LUX,0,0,162,0,162
2012,Algeria,DZA,Luxembourg,LUX,0,0,20,0,20
2012,Bosnia and Herzegovina,BIH,Luxembourg,LUX,0,0,232,0,232
2012,Cameroon,CMR,Luxembourg,LUX,0,0,5,0,5
2012,Greece,GRC,Luxembourg,LUX,0,0,10,0,10
2012,Iran (Islamic Rep. of),IRN,Luxembourg,LUX,14,0,0,0,14
2012,Iraq,IRQ,Luxembourg,LUX,18,0,16,0,34
2012,Israel,ISR,Luxembourg,LUX,0,0,5,0,5
2012,Kyrgyzstan,KGZ,Luxembourg,LUX,0,0,5,0,5
2012,North Macedonia,MKD,Luxembourg,LUX,0,0,249,0,249
2012,Montenegro,MNE,Luxembourg,LUX,0,0,59,0,59
2012,Serbia and Kosovo: S/RES/1244 (1999),SRB,Luxembourg,LUX,5,0,1093,0,1098
2012,Somalia,SOM,Luxembourg,LUX,0,0,12,0,12
2012,Syrian Arab Rep.,SYR,Luxembourg,LUX,5,0,0,0,5
2012,Tunisia,TUN,Luxembourg,LUX,0,0,5,0,5
2012,Zimbabwe,ZWE,Luxembourg,LUX,0,0,5,0,5
2012,Afghanistan,AFG,Latvia,LVA,0,0,5,11,16
2012,Algeria,DZA,Latvia,LVA,0,0,5,0,5
2012,Armenia,ARM,Latvia,LVA,0,0,5,0,5
2012,Azerbaijan,AZE,Latvia,LVA,0,0,5,0,5
2012,Cameroon,CMR,Latvia,LVA,0,0,0,5,5
2012,Dem. Rep. of the Congo,COD,Latvia,LVA,0,0,10,21,31
2012,Georgia,GEO,Latvia,LVA,0,0,39,77,116
2012,Iran (Islamic Rep. of),IRN,Latvia,LVA,13,0,0,0,13
2012,Pakistan,PAK,Latvia,LVA,0,0,5,0,5
2012,Russian Federation,RUS,Latvia,LVA,0,0,11,5,16
2012,Syrian Arab Rep.,SYR,Latvia,LVA,0,14,0,0,14
2012,Turkey,TUR,Latvia,LVA,0,0,5,0,5
2012,Uzbekistan,UZB,Latvia,LVA,0,0,5,0,5
2012,Afghanistan,AFG,Rep. of Moldova,MDA,0,5,0,10,15
2012,Egypt,EGY,Rep. of Moldova,MDA,0,0,0,5,5
2012,Armenia,ARM,Rep. of Moldova,MDA,0,11,0,0,11
2012,Azerbaijan,AZE,Rep. of Moldova,MDA,5,0,0,0,5
2012,Bangladesh,BGD,Rep. of Moldova,MDA,0,0,5,5,10
2012,Cameroon,CMR,Rep. of Moldova,MDA,0,0,5,0,5
2012,Georgia,GEO,Rep. of Moldova,MDA,0,0,5,0,5
2012,Cote d'Ivoire,CIV,Rep. of Moldova,MDA,0,0,5,0,5
2012,India,IND,Rep. of Moldova,MDA,0,0,5,0,5
2012,Iran (Islamic Rep. of),IRN,Rep. of Moldova,MDA,0,0,0,5,5
2012,Kazakhstan,KAZ,Rep. of Moldova,MDA,0,0,5,0,5
2012,Russian Federation,RUS,Rep. of Moldova,MDA,0,0,5,5,10
2012,Syrian Arab Rep.,SYR,Rep. of Moldova,MDA,12,33,0,5,50
2012,Turkey,TUR,Rep. of Moldova,MDA,0,0,5,0,5
2012,Bangladesh,BGD,Mexico,MEX,0,0,0,5,5
2012,Cameroon,CMR,Mexico,MEX,0,0,0,5,5
2012,Dem. Rep. of the Congo,COD,Mexico,MEX,5,0,0,0,5
2012,Colombia,COL,Mexico,MEX,13,0,11,10,34
2012,Cuba,CUB,Mexico,MEX,11,0,23,32,66
2012,Ecuador,ECU,Mexico,MEX,0,0,0,5,5
2012,Eritrea,ERI,Mexico,MEX,5,0,0,0,5
2012,Ghana,GHA,Mexico,MEX,5,0,0,0,5
2012,Guatemala,GTM,Mexico,MEX,22,0,17,10,49
2012,Haiti,HTI,Mexico,MEX,0,0,12,0,12
2012,Honduras,HND,Mexico,MEX,66,22,54,70,212
2012,Iran (Islamic Rep. of),IRN,Mexico,MEX,5,0,0,0,5
2012,Sri Lanka,LKA,Mexico,MEX,20,0,0,0,20
2012,Nicaragua,NIC,Mexico,MEX,0,0,0,5,5
2012,Nigeria,NGA,Mexico,MEX,5,0,5,0,10
2012,Pakistan,PAK,Mexico,MEX,0,0,0,5,5
2012,El Salvador,SLV,Mexico,MEX,80,5,43,34,162
2012,Burundi,BDI,Malawi,MWI,39,0,311,226,576
2012,Dem. Rep. of the Congo,COD,Malawi,MWI,81,0,119,2060,2260
2012,Ethiopia,ETH,Malawi,MWI,0,0,0,10,10
2012,Rwanda,RWA,Malawi,MWI,34,0,133,369,536
2012,Somalia,SOM,Malawi,MWI,5,0,0,27,32
2012,Uganda,UGA,Malawi,MWI,0,0,0,5,5
2012,Burundi,BDI,Mozambique,MOZ,80,0,0,386,466
2012,Congo,COG,Mozambique,MOZ,0,0,0,5,5
2012,Dem. Rep. of the Congo,COD,Mozambique,MOZ,405,0,0,1181,1586
2012,Ethiopia,ETH,Mozambique,MOZ,0,0,0,760,760
2012,Guinea,GIN,Mozambique,MOZ,0,0,0,5,5
2012,Liberia,LBR,Mozambique,MOZ,0,0,0,5,5
2012,Rwanda,RWA,Mozambique,MOZ,37,0,0,72,109
2012,Somalia,SOM,Mozambique,MOZ,54,0,0,1231,1285
2012,Sudan,SDN,Mozambique,MOZ,0,0,0,11,11
2012,Uganda,UGA,Mozambique,MOZ,0,0,0,5,5
2012,Egypt,EGY,Malta,MLT,5,0,0,0,5
2012,Cameroon,CMR,Malta,MLT,5,0,0,0,5
2012,Eritrea,ERI,Malta,MLT,153,5,36,5,199
2012,Ethiopia,ETH,Malta,MLT,11,5,10,0,26
2012,Ghana,GHA,Malta,MLT,0,0,0,5,5
2012,Cote d'Ivoire,CIV,Malta,MLT,0,5,0,0,5
2012,Libya,LBY,Malta,MLT,0,27,5,21,53
2012,Mali,MLI,Malta,MLT,0,0,5,0,5
2012,Nigeria,NGA,Malta,MLT,5,0,40,12,57
2012,Pakistan,PAK,Malta,MLT,0,5,15,0,20
2012,Serbia and Kosovo: S/RES/1244 (1999),SRB,Malta,MLT,0,0,0,5,5
2012,Somalia,SOM,Malta,MLT,1083,5,16,5,1109
2012,Sudan,SDN,Malta,MLT,5,0,0,0,5
2012,Syrian Arab Rep.,SYR,Malta,MLT,0,115,0,5,120
2012,Tunisia,TUN,Malta,MLT,0,5,0,0,5
2012,Burundi,BDI,Namibia,NAM,0,0,0,5,5
2012,Dem. Rep. of the Congo,COD,Namibia,NAM,0,0,0,31,31
2012,Rwanda,RWA,Namibia,NAM,0,0,0,10,10
2012,Bhutan,BTN,Nepal,NPL,0,1184,149,371,1704
2012,Afghanistan,AFG,Netherlands,NLD,45,606,1200,0,1851
2012,Albania,ALB,Netherlands,NLD,0,0,14,0,14
2012,Algeria,DZA,Netherlands,NLD,0,0,24,0,24
2012,Angola,AGO,Netherlands,NLD,0,0,17,0,17
2012,Egypt,EGY,Netherlands,NLD,11,26,111,0,148
2012,Armenia,ARM,Netherlands,NLD,0,25,379,0,404
2012,Azerbaijan,AZE,Netherlands,NLD,10,5,89,0,104
2012,Burundi,BDI,Netherlands,NLD,0,12,37,0,49
2012,Belgium,BEL,Netherlands,NLD,0,0,5,0,5
2012,Benin,BEN,Netherlands,NLD,0,0,5,0,5
2012,Bangladesh,BGD,Netherlands,NLD,5,0,34,0,39
2012,Bhutan,BTN,Netherlands,NLD,0,5,0,0,5
2012,Burkina Faso,BFA,Netherlands,NLD,0,0,13,0,13
2012,Belarus,BLR,Netherlands,NLD,0,5,75,0,80
2012,Bosnia and Herzegovina,BIH,Netherlands,NLD,0,0,65,0,65
2012,Canada,CAN,Netherlands,NLD,0,0,5,0,5
2012,Chad,TCD,Netherlands,NLD,0,0,5,0,5
2012,China,CHN,Netherlands,NLD,20,99,125,0,244
2012,Cameroon,CMR,Netherlands,NLD,5,5,30,0,40
2012,Congo,COG,Netherlands,NLD,10,52,76,0,138
2012,Dem. Rep. of the Congo,COD,Netherlands,NLD,0,11,12,0,23
2012,Colombia,COL,Netherlands,NLD,0,0,13,0,13
2012,Cuba,CUB,Netherlands,NLD,0,5,5,0,10
2012,Eritrea,ERI,Netherlands,NLD,12,259,197,0,468
2012,Ethiopia,ETH,Netherlands,NLD,0,24,63,0,87
2012,Gambia,GMB,Netherlands,NLD,0,0,21,0,21
2012,Palestinian,PSE,Netherlands,NLD,0,15,29,0,44
2012,Georgia,GEO,Netherlands,NLD,0,0,235,0,235
2012,Ghana,GHA,Netherlands,NLD,0,0,28,0,28
2012,Guinea-Bissau,GNB,Netherlands,NLD,0,0,5,0,5
2012,Guatemala,GTM,Netherlands,NLD,0,0,5,0,5
2012,Guinea,GIN,Netherlands,NLD,5,78,152,0,235
2012,Croatia,HRV,Netherlands,NLD,0,0,5,0,5
2012,Cote d'Ivoire,CIV,Netherlands,NLD,0,33,164,0,197
2012,India,IND,Netherlands,NLD,0,0,16,0,16
2012,Indonesia,IDN,Netherlands,NLD,0,0,5,0,5
2012,Iran (Islamic Rep. of),IRN,Netherlands,NLD,192,326,679,0,1197
2012,Iraq,IRQ,Netherlands,NLD,132,1073,658,0,1863
2012,Israel,ISR,Netherlands,NLD,0,0,5,0,5
2012,Jamaica,JAM,Netherlands,NLD,12,15,11,0,38
2012,Jordan,JOR,Netherlands,NLD,0,0,5,0,5
2012,Kazakhstan,KAZ,Netherlands,NLD,5,0,18,0,23
2012,Kenya,KEN,Netherlands,NLD,0,5,19,0,24
2012,Kyrgyzstan,KGZ,Netherlands,NLD,0,0,13,0,13
2012,Dem. People's Rep. of Korea,PRK,Netherlands,NLD,0,24,5,0,29
2012,Liberia,LBR,Netherlands,NLD,0,5,12,0,17
2012,Libya,LBY,Netherlands,NLD,0,10,153,0,163
2012,Lebanon,LBN,Netherlands,NLD,0,0,13,0,13
2012,Sri Lanka,LKA,Netherlands,NLD,5,78,111,0,194
2012,Mauritania,MRT,Netherlands,NLD,0,0,5,0,5
2012,North Macedonia,MKD,Netherlands,NLD,0,0,32,0,32
2012,Rep. of Moldova,MDA,Netherlands,NLD,0,0,11,0,11
2012,Mali,MLI,Netherlands,NLD,0,0,25,0,25
2012,Malaysia,MYS,Netherlands,NLD,0,0,5,0,5
2012,Malawi,MWI,Netherlands,NLD,0,0,5,0,5
2012,Mongolia,MNG,Netherlands,NLD,0,0,121,0,121
2012,Morocco,MAR,Netherlands,NLD,0,0,17,0,17
2012,Myanmar,MMR,Netherlands,NLD,0,36,5,0,41
2012,Nepal,NPL,Netherlands,NLD,5,31,83,0,119
2012,Niger,NER,Netherlands,NLD,0,0,5,0,5
2012,Nigeria,NGA,Netherlands,NLD,0,12,123,0,135
2012,Pakistan,PAK,Netherlands,NLD,25,42,74,0,141
2012,Romania,ROU,Netherlands,NLD,0,0,10,0,10
2012,Russian Federation,RUS,Netherlands,NLD,5,25,770,0,800
2012,Rwanda,RWA,Netherlands,NLD,0,0,11,0,11
2012,Serbia and Kosovo: S/RES/1244 (1999),SRB,Netherlands,NLD,0,5,117,0,122
2012,Senegal,SEN,Netherlands,NLD,0,0,20,0,20
2012,Sierra Leone,SLE,Netherlands,NLD,5,36,88,0,129
2012,Somalia,SOM,Netherlands,NLD,11,941,647,0,1599
2012,Viet Nam,VNM,Netherlands,NLD,0,0,5,0,5
2012,Sudan,SDN,Netherlands,NLD,15,53,95,0,163
2012,Suriname,SUR,Netherlands,NLD,0,0,5,0,5
2012,Syrian Arab Rep.,SYR,Netherlands,NLD,46,538,48,0,632
2012,United Rep. of Tanzania,TZA,Netherlands,NLD,0,0,5,0,5
2012,Tajikistan,TJK,Netherlands,NLD,5,5,14,0,24
2012,Togo,TGO,Netherlands,NLD,0,5,12,0,17
2012,Tunisia,TUN,Netherlands,NLD,0,5,12,0,17
2012,Turkey,TUR,Netherlands,NLD,16,15,92,0,123
2012,Uganda,UGA,Netherlands,NLD,20,23,62,0,105
2012,Ukraine,UKR,Netherlands,NLD,0,0,33,0,33
2012,United States of America,USA,Netherlands,NLD,0,0,10,0,10
2012,Uzbekistan,UZB,Netherlands,NLD,0,0,15,0,15
2012,Yemen,YEM,Netherlands,NLD,5,5,12,0,22
2012,Zambia,ZMB,Netherlands,NLD,0,0,5,0,5
2012,Zimbabwe,ZWE,Netherlands,NLD,0,0,10,0,10
2012,Stateless,XXA,Netherlands,NLD,0,61,65,0,126
2012,Bangladesh,BGD,Nicaragua,NIC,0,0,0,16,16
2012,El Salvador,SLV,Nicaragua,NIC,18,0,0,0,18
2012,Somalia,SOM,Nicaragua,NIC,0,0,0,18,18
2012,Afghanistan,AFG,Norway,NOR,256,215,443,176,1090
2012,Albania,ALB,Norway,NOR,0,0,132,37,169
2012,Algeria,DZA,Norway,NOR,0,0,31,95,126
2012,Angola,AGO,Norway,NOR,0,5,5,11,21
2012,Egypt,EGY,Norway,NOR,0,0,10,18,28
2012,Armenia,ARM,Norway,NOR,0,0,14,5,19
2012,Azerbaijan,AZE,Norway,NOR,0,0,41,12,53
2012,Burundi,BDI,Norway,NOR,0,0,5,0,5
2012,Bangladesh,BGD,Norway,NOR,0,0,209,20,229
2012,Bhutan,BTN,Norway,NOR,0,0,5,0,5
2012,Burkina Faso,BFA,Norway,NOR,0,0,0,5,5
2012,Belarus,BLR,Norway,NOR,0,0,83,62,145
2012,Bosnia and Herzegovina,BIH,Norway,NOR,0,0,40,14,54
2012,Bulgaria,BGR,Norway,NOR,0,0,31,0,31
2012,China,CHN,Norway,NOR,78,0,10,5,93
2012,Cameroon,CMR,Norway,NOR,0,0,11,0,11
2012,Dem. Rep. of the Congo,COD,Norway,NOR,10,0,44,5,59
2012,Cuba,CUB,Norway,NOR,0,0,5,0,5
2012,Eritrea,ERI,Norway,NOR,1224,5,149,111,1489
2012,Ethiopia,ETH,Norway,NOR,226,0,206,17,449
2012,Gambia,GMB,Norway,NOR,0,0,30,11,41
2012,Georgia,GEO,Norway,NOR,0,0,17,97,114
2012,Ghana,GHA,Norway,NOR,0,0,10,22,32
2012,Guinea-Bissau,GNB,Norway,NOR,0,0,0,12,12
2012,Greece,GRC,Norway,NOR,0,0,5,0,5
2012,Guinea,GIN,Norway,NOR,5,0,24,17,46
2012,Croatia,HRV,Norway,NOR,0,0,5,5,10
2012,Hungary,HUN,Norway,NOR,0,0,15,0,15
2012,Cote d'Ivoire,CIV,Norway,NOR,0,0,36,10,46
2012,India,IND,Norway,NOR,0,0,29,13,42
2012,Iran (Islamic Rep. of),IRN,Norway,NOR,120,0,229,66,415
2012,Iraq,IRQ,Norway,NOR,50,0,118,88,256
2012,Israel,ISR,Norway,NOR,0,0,0,5,5
2012,Italy,ITA,Norway,NOR,0,0,0,5,5
2012,Jordan,JOR,Norway,NOR,0,0,0,14,14
2012,Kazakhstan,KAZ,Norway,NOR,0,0,18,5,23
2012,Kenya,KEN,Norway,NOR,0,0,10,5,15
2012,Kyrgyzstan,KGZ,Norway,NOR,0,0,18,10,28
2012,Rep. of Korea,KOR,Norway,NOR,0,0,5,0,5
2012,Dem. People's Rep. of Korea,PRK,Norway,NOR,0,0,5,0,5
2012,Liberia,LBR,Norway,NOR,0,0,5,11,16
2012,Libya,LBY,Norway,NOR,0,0,51,68,119
2012,Lebanon,LBN,Norway,NOR,0,0,5,13,18
2012,Sri Lanka,LKA,Norway,NOR,0,0,19,5,24
2012,Latvia,LVA,Norway,NOR,0,0,5,0,5
2012,Mauritania,MRT,Norway,NOR,0,0,5,5,10
2012,North Macedonia,MKD,Norway,NOR,0,0,26,5,31
2012,Rep. of Moldova,MDA,Norway,NOR,0,0,0,5,5
2012,Maldives,MDV,Norway,NOR,0,0,0,12,12
2012,Mexico,MEX,Norway,NOR,0,0,5,0,5
2012,Mali,MLI,Norway,NOR,0,0,13,10,23
2012,Malawi,MWI,Norway,NOR,0,0,5,0,5
2012,Mongolia,MNG,Norway,NOR,0,0,14,10,24
2012,Morocco,MAR,Norway,NOR,0,0,45,79,124
2012,Montenegro,MNE,Norway,NOR,0,0,5,5,10
2012,Myanmar,MMR,Norway,NOR,5,0,11,0,16
2012,Nepal,NPL,Norway,NOR,0,0,16,10,26
2012,Niger,NER,Norway,NOR,0,0,0,13,13
2012,Nigeria,NGA,Norway,NOR,10,0,151,178,339
2012,Pakistan,PAK,Norway,NOR,12,0,88,36,136
2012,Poland,POL,Norway,NOR,0,0,5,0,5
2012,Romania,ROU,Norway,NOR,0,0,13,0,13
2012,Russian Federation,RUS,Norway,NOR,19,0,275,115,409
2012,Rwanda,RWA,Norway,NOR,0,0,11,0,11
2012,Serbia and Kosovo: S/RES/1244 (1999),SRB,Norway,NOR,0,0,154,107,261
2012,Senegal,SEN,Norway,NOR,0,0,10,5,15
2012,Sierra Leone,SLE,Norway,NOR,0,0,13,5,18
2012,Somalia,SOM,Norway,NOR,1124,726,303,380,2533
2012,Viet Nam,VNM,Norway,NOR,0,0,18,13,31
2012,Sudan,SDN,Norway,NOR,376,0,50,39,465
2012,South Sudan,SSD,Norway,NOR,5,0,0,0,5
2012,Syrian Arab Rep.,SYR,Norway,NOR,56,188,12,57,313
2012,United Rep. of Tanzania,TZA,Norway,NOR,0,0,5,0,5
2012,Tajikistan,TJK,Norway,NOR,0,0,13,0,13
2012,Tunisia,TUN,Norway,NOR,0,0,18,57,75
2012,Turkey,TUR,Norway,NOR,5,0,25,10,40
2012,Uganda,UGA,Norway,NOR,15,0,16,10,41
2012,Ukraine,UKR,Norway,NOR,0,0,16,10,26
2012,United States of America,USA,Norway,NOR,0,0,0,5,5
2012,Uzbekistan,UZB,Norway,NOR,10,0,129,17,156
2012,Yemen,YEM,Norway,NOR,10,5,42,5,62
2012,Zimbabwe,ZWE,Norway,NOR,0,0,5,0,5
2012,Stateless,XXA,Norway,NOR,50,39,117,76,282
2012,Iraq,IRQ,Nauru,NRU,0,0,0,5,5
2012,Sri Lanka,LKA,Nauru,NRU,0,0,0,29,29
2012,Egypt,EGY,New Zealand,NZL,13,0,5,0,18
2012,Bahrain,BHR,New Zealand,NZL,5,0,0,0,5
2012,Bangladesh,BGD,New Zealand,NZL,0,0,11,0,11
2012,China,CHN,New Zealand,NZL,10,0,22,0,32
2012,Czechia,CZE,New Zealand,NZL,0,0,10,0,10
2012,Fiji,FJI,New Zealand,NZL,0,0,32,0,32
2012,Palestinian,PSE,New Zealand,NZL,5,0,0,0,5
2012,Georgia,GEO,New Zealand,NZL,0,0,5,0,5
2012,Hungary,HUN,New Zealand,NZL,0,0,10,0,10
2012,India,IND,New Zealand,NZL,0,0,10,0,10
2012,Iran (Islamic Rep. of),IRN,New Zealand,NZL,16,0,22,0,38
2012,Iraq,IRQ,New Zealand,NZL,5,0,5,0,10
2012,Jordan,JOR,New Zealand,NZL,0,0,5,0,5
2012,Rep. of Korea,KOR,New Zealand,NZL,0,0,5,0,5
2012,Sri Lanka,LKA,New Zealand,NZL,5,0,14,0,19
2012,Nepal,NPL,New Zealand,NZL,0,0,5,0,5
2012,Pakistan,PAK,New Zealand,NZL,5,0,25,0,30
2012,South Africa,ZAF,New Zealand,NZL,0,0,5,0,5
2012,Saudi Arabia,SAU,New Zealand,NZL,0,0,5,0,5
2012,Viet Nam,VNM,New Zealand,NZL,0,0,5,0,5
2012,Switzerland,CHE,New Zealand,NZL,0,0,5,0,5
2012,Syrian Arab Rep.,SYR,New Zealand,NZL,12,0,0,0,12
2012,Turkey,TUR,New Zealand,NZL,0,0,5,0,5
2012,United Arab Emirates,ARE,New Zealand,NZL,0,0,5,0,5
2012,Afghanistan,AFG,Panama,PAN,0,0,5,0,5
2012,Bangladesh,BGD,Panama,PAN,0,0,0,5,5
2012,Colombia,COL,Panama,PAN,104,0,15,881,1000
2012,Cuba,CUB,Panama,PAN,14,0,0,55,69
2012,Dominican Rep.,DOM,Panama,PAN,5,0,0,0,5
2012,Eritrea,ERI,Panama,PAN,0,0,0,5,5
2012,Ethiopia,ETH,Panama,PAN,0,0,0,5,5
2012,Ghana,GHA,Panama,PAN,0,0,0,10,10
2012,Haiti,HTI,Panama,PAN,5,0,0,0,5
2012,Honduras,HND,Panama,PAN,0,0,0,5,5
2012,India,IND,Panama,PAN,0,0,0,14,14
2012,Libya,LBY,Panama,PAN,0,0,0,5,5
2012,Mexico,MEX,Panama,PAN,5,0,0,0,5
2012,Nicaragua,NIC,Panama,PAN,0,0,0,5,5
2012,Pakistan,PAK,Panama,PAN,0,0,0,5,5
2012,Peru,PER,Panama,PAN,0,0,0,5,5
2012,Venezuela (Bolivarian Republic of),VEN,Panama,PAN,5,0,0,14,19
2012,Bolivia (Plurinational State of),BOL,Paraguay,PRY,5,0,0,0,5
2012,Cuba,CUB,Paraguay,PRY,5,0,0,0,5
2012,Bangladesh,BGD,Peru,PER,12,0,0,0,12
2012,Colombia,COL,Peru,PER,120,0,0,81,201
2012,Cuba,CUB,Peru,PER,5,0,121,12,138
2012,Dominican Rep.,DOM,Peru,PER,5,0,0,0,5
2012,Haiti,HTI,Peru,PER,0,0,0,10,10
2012,Nigeria,NGA,Peru,PER,5,0,0,0,5
2012,Venezuela (Bolivarian Republic of),VEN,Peru,PER,5,0,5,0,10
2012,Afghanistan,AFG,Philippines,PHL,5,0,0,0,5
2012,Palestinian,PSE,Philippines,PHL,0,0,0,10,10
2012,Iran (Islamic Rep. of),IRN,Philippines,PHL,15,0,0,5,20
2012,Iraq,IRQ,Philippines,PHL,5,0,0,5,10
2012,Jordan,JOR,Philippines,PHL,0,0,0,5,5
2012,Myanmar,MMR,Philippines,PHL,5,0,0,0,5
2012,Pakistan,PAK,Philippines,PHL,0,0,0,5,5
2012,Afghanistan,AFG,Poland,POL,0,5,26,17,48
2012,Angola,AGO,Poland,POL,0,0,0,5,5
2012,Egypt,EGY,Poland,POL,0,0,13,68,81
2012,Armenia,ARM,Poland,POL,0,0,111,320,431
2012,Azerbaijan,AZE,Poland,POL,0,0,0,5,5
2012,Bangladesh,BGD,Poland,POL,0,0,0,14,14
2012,Belarus,BLR,Poland,POL,24,5,17,26,72
2012,China,CHN,Poland,POL,5,0,0,0,5
2012,Cameroon,CMR,Poland,POL,0,0,0,11,11
2012,Congo,COG,Poland,POL,0,0,0,12,12
2012,Dem. Rep. of the Congo,COD,Poland,POL,0,0,0,14,14
2012,Georgia,GEO,Poland,POL,0,0,468,2934,3402
2012,Guinea,GIN,Poland,POL,0,0,0,5,5
2012,India,IND,Poland,POL,0,0,5,5,10
2012,Iran (Islamic Rep. of),IRN,Poland,POL,0,0,10,13,23
2012,Iraq,IRQ,Poland,POL,0,0,5,11,16
2012,Kazakhstan,KAZ,Poland,POL,0,0,10,42,52
2012,Kyrgyzstan,KGZ,Poland,POL,0,0,14,21,35
2012,Lebanon,LBN,Poland,POL,0,0,0,5,5
2012,Rep. of Moldova,MDA,Poland,POL,0,0,0,5,5
2012,Mongolia,MNG,Poland,POL,0,0,5,11,16
2012,Morocco,MAR,Poland,POL,0,0,5,0,5
2012,Nepal,NPL,Poland,POL,0,0,0,13,13
2012,Nigeria,NGA,Poland,POL,0,0,10,10,20
2012,Pakistan,PAK,Poland,POL,0,0,17,28,45
2012,Russian Federation,RUS,Poland,POL,65,142,1098,5050,6355
2012,Rwanda,RWA,Poland,POL,0,0,0,5,5
2012,Viet Nam,VNM,Poland,POL,0,0,40,10,50
2012,Syrian Arab Rep.,SYR,Poland,POL,0,5,0,25,30
2012,United Rep. of Tanzania,TZA,Poland,POL,0,0,5,0,5
2012,Tajikistan,TJK,Poland,POL,0,0,0,10,10
2012,Turkmenistan,TKM,Poland,POL,0,0,0,5,5
2012,Tunisia,TUN,Poland,POL,0,0,0,5,5
2012,Turkey,TUR,Poland,POL,5,0,0,13,18
2012,Uganda,UGA,Poland,POL,5,0,0,0,5
2012,Ukraine,UKR,Poland,POL,0,0,48,32,80
2012,Uzbekistan,UZB,Poland,POL,0,0,13,5,18
2012,Stateless,XXA,Poland,POL,0,0,5,24,29
2012,Afghanistan,AFG,Portugal,PRT,0,0,0,5,5
2012,Angola,AGO,Portugal,PRT,0,0,0,5,5
2012,Belarus,BLR,Portugal,PRT,0,0,0,10,10
2012,Bosnia and Herzegovina,BIH,Portugal,PRT,0,5,0,0,5
2012,Cameroon,CMR,Portugal,PRT,0,0,0,11,11
2012,Congo,COG,Portugal,PRT,0,0,0,5,5
2012,Dem. Rep. of the Congo,COD,Portugal,PRT,0,5,0,5,10
2012,Colombia,COL,Portugal,PRT,0,5,0,11,16
2012,Georgia,GEO,Portugal,PRT,0,0,0,5,5
2012,Ghana,GHA,Portugal,PRT,0,0,0,5,5
2012,Guinea-Bissau,GNB,Portugal,PRT,0,0,0,13,13
2012,Guinea,GIN,Portugal,PRT,0,28,0,48,76
2012,Cote d'Ivoire,CIV,Portugal,PRT,0,14,0,5,19
2012,Iran (Islamic Rep. of),IRN,Portugal,PRT,0,0,0,5,5
2012,Kenya,KEN,Portugal,PRT,5,0,0,0,5
2012,Sri Lanka,LKA,Portugal,PRT,0,0,0,5,5
2012,Morocco,MAR,Portugal,PRT,0,0,0,5,5
2012,Nigeria,NGA,Portugal,PRT,0,5,0,27,32
2012,Pakistan,PAK,Portugal,PRT,0,0,0,5,5
2012,Russian Federation,RUS,Portugal,PRT,0,5,0,0,5
2012,Senegal,SEN,Portugal,PRT,0,5,0,5,10
2012,Sierra Leone,SLE,Portugal,PRT,0,5,0,0,5
2012,Somalia,SOM,Portugal,PRT,0,11,0,0,11
2012,Syrian Arab Rep.,SYR,Portugal,PRT,0,0,0,13,13
2012,Uganda,UGA,Portugal,PRT,5,0,0,0,5
2012,Ukraine,UKR,Portugal,PRT,0,0,0,5,5
2012,Afghanistan,AFG,South Africa,ZAF,5,0,0,0,5
2012,Algeria,DZA,South Africa,ZAF,0,0,149,0,149
2012,Angola,AGO,South Africa,ZAF,0,0,58,0,58
2012,Egypt,EGY,South Africa,ZAF,0,0,275,0,275
2012,Burundi,BDI,South Africa,ZAF,10,0,472,5,487
2012,Benin,BEN,South Africa,ZAF,0,0,43,0,43
2012,Bangladesh,BGD,South Africa,ZAF,64,0,3140,0,3204
2012,Burkina Faso,BFA,South Africa,ZAF,0,0,19,0,19
2012,China,CHN,South Africa,ZAF,0,0,1346,0,1346
2012,Chile,CHL,South Africa,ZAF,0,0,5,0,5
2012,Cameroon,CMR,South Africa,ZAF,0,0,721,0,721
2012,Congo,COG,South Africa,ZAF,164,0,941,0,1105
2012,Dem. Rep. of the Congo,COD,South Africa,ZAF,490,0,3237,0,3727
2012,Comoros,COM,South Africa,ZAF,0,0,5,0,5
2012,Eritrea,ERI,South Africa,ZAF,253,0,50,0,303
2012,Estonia,EST,South Africa,ZAF,5,0,5,0,10
2012,Ethiopia,ETH,South Africa,ZAF,2163,0,6622,0,8785
2012,Gabon,GAB,South Africa,ZAF,0,0,5,0,5
2012,Gambia,GMB,South Africa,ZAF,0,0,5,0,5
2012,Palestinian,PSE,South Africa,ZAF,0,0,5,0,5
2012,Ghana,GHA,South Africa,ZAF,0,0,2125,0,2125
2012,Guinea-Bissau,GNB,South Africa,ZAF,0,0,5,0,5
2012,Guinea,GIN,South Africa,ZAF,0,0,10,0,10
2012,Cote d'Ivoire,CIV,South Africa,ZAF,0,0,61,0,61
2012,India,IND,South Africa,ZAF,0,0,2701,0,2701
2012,Kenya,KEN,South Africa,ZAF,0,0,248,0,248
2012,Liberia,LBR,South Africa,ZAF,0,0,18,0,18
2012,Lesotho,LSO,South Africa,ZAF,0,0,371,0,371
2012,Sri Lanka,LKA,South Africa,ZAF,0,0,27,0,27
2012,Mali,MLI,South Africa,ZAF,0,0,34,0,34
2012,Malawi,MWI,South Africa,ZAF,0,0,3017,0,3017
2012,Morocco,MAR,South Africa,ZAF,0,0,5,0,5
2012,Mozambique,MOZ,South Africa,ZAF,0,0,1327,0,1327
2012,Nepal,NPL,South Africa,ZAF,0,0,60,0,60
2012,Niger,NER,South Africa,ZAF,0,0,94,0,94
2012,Nigeria,NGA,South Africa,ZAF,0,0,6403,0,6403
2012,Pakistan,PAK,South Africa,ZAF,0,0,3642,0,3642
2012,Philippines,PHL,South Africa,ZAF,0,0,5,0,5
2012,Rwanda,RWA,South Africa,ZAF,5,0,79,0,84
2012,Senegal,SEN,South Africa,ZAF,0,0,237,0,237
2012,Sierra Leone,SLE,South Africa,ZAF,0,0,5,0,5
2012,Somalia,SOM,South Africa,ZAF,3046,0,579,0,3625
2012,Sudan,SDN,South Africa,ZAF,5,0,5,0,10
2012,Eswatini,SWZ,South Africa,ZAF,0,0,24,0,24
2012,United Rep. of Tanzania,TZA,South Africa,ZAF,0,0,163,0,163
2012,Thailand,THA,South Africa,ZAF,0,0,5,0,5
2012,Togo,TGO,South Africa,ZAF,0,0,22,0,22
2012,Uganda,UGA,South Africa,ZAF,5,0,1679,0,1684
2012,Zambia,ZMB,South Africa,ZAF,0,0,160,0,160
2012,Zimbabwe,ZWE,South Africa,ZAF,10,0,16774,0,16784
2012,Afghanistan,AFG,Russian Federation,RUS,76,0,438,0,514
2012,Egypt,EGY,Russian Federation,RUS,0,0,10,0,10
2012,Armenia,ARM,Russian Federation,RUS,0,0,5,0,5
2012,Azerbaijan,AZE,Russian Federation,RUS,0,0,5,0,5
2012,Bangladesh,BGD,Russian Federation,RUS,0,0,5,0,5
2012,Belarus,BLR,Russian Federation,RUS,0,0,10,0,10
2012,China,CHN,Russian Federation,RUS,0,0,5,0,5
2012,Congo,COG,Russian Federation,RUS,0,0,5,0,5
2012,Dem. Rep. of the Congo,COD,Russian Federation,RUS,0,0,12,0,12
2012,Eritrea,ERI,Russian Federation,RUS,0,0,5,0,5
2012,Georgia,GEO,Russian Federation,RUS,5,0,317,0,322
2012,Guinea,GIN,Russian Federation,RUS,0,0,5,0,5
2012,Cote d'Ivoire,CIV,Russian Federation,RUS,0,0,5,0,5
2012,Iran (Islamic Rep. of),IRN,Russian Federation,RUS,0,0,5,0,5
2012,Iraq,IRQ,Russian Federation,RUS,0,0,13,0,13
2012,Kazakhstan,KAZ,Russian Federation,RUS,0,0,12,0,12
2012,Kyrgyzstan,KGZ,Russian Federation,RUS,0,0,46,0,46
2012,Dem. People's Rep. of Korea,PRK,Russian Federation,RUS,0,0,38,0,38
2012,Lebanon,LBN,Russian Federation,RUS,5,0,0,0,5
2012,Rep. of Moldova,MDA,Russian Federation,RUS,0,0,5,0,5
2012,Nigeria,NGA,Russian Federation,RUS,0,0,5,0,5
2012,Pakistan,PAK,Russian Federation,RUS,0,0,5,0,5
2012,Viet Nam,VNM,Russian Federation,RUS,0,0,5,0,5
2012,Sudan,SDN,Russian Federation,RUS,0,0,5,0,5
2012,Syrian Arab Rep.,SYR,Russian Federation,RUS,0,0,137,0,137
2012,Tajikistan,TJK,Russian Federation,RUS,5,0,15,0,20
2012,Turkmenistan,TKM,Russian Federation,RUS,0,0,10,0,10
2012,Ukraine,UKR,Russian Federation,RUS,0,0,13,0,13
2012,United States of America,USA,Russian Federation,RUS,0,0,5,0,5
2012,Uzbekistan,UZB,Russian Federation,RUS,5,0,67,0,72
2012,Yemen,YEM,Russian Federation,RUS,0,0,5,0,5
2012,Honduras,HND,El Salvador,SLV,5,0,0,0,5
2012,Afghanistan,AFG,Serbia and Kosovo: S/RES/1244 (1999),SRB,0,0,33,875,908
2012,Algeria,DZA,Serbia and Kosovo: S/RES/1244 (1999),SRB,0,0,14,170,184
2012,Egypt,EGY,Serbia and Kosovo: S/RES/1244 (1999),SRB,0,0,0,10,10
2012,Bangladesh,BGD,Serbia and Kosovo: S/RES/1244 (1999),SRB,0,0,0,104,104
2012,Burkina Faso,BFA,Serbia and Kosovo: S/RES/1244 (1999),SRB,0,0,0,5,5
2012,Congo,COG,Serbia and Kosovo: S/RES/1244 (1999),SRB,0,0,0,5,5
2012,Eritrea,ERI,Serbia and Kosovo: S/RES/1244 (1999),SRB,0,0,0,99,99
2012,Gambia,GMB,Serbia and Kosovo: S/RES/1244 (1999),SRB,0,0,0,14,14
2012,Palestinian,PSE,Serbia and Kosovo: S/RES/1244 (1999),SRB,0,0,5,53,58
2012,Guinea-Bissau,GNB,Serbia and Kosovo: S/RES/1244 (1999),SRB,0,0,0,5,5
2012,Guinea,GIN,Serbia and Kosovo: S/RES/1244 (1999),SRB,0,0,0,12,12
2012,India,IND,Serbia and Kosovo: S/RES/1244 (1999),SRB,0,0,0,10,10
2012,Iran (Islamic Rep. of),IRN,Serbia and Kosovo: S/RES/1244 (1999),SRB,0,0,0,25,25
2012,Iraq,IRQ,Serbia and Kosovo: S/RES/1244 (1999),SRB,0,0,0,14,14
2012,Libya,LBY,Serbia and Kosovo: S/RES/1244 (1999),SRB,0,0,0,44,44
2012,Mauritania,MRT,Serbia and Kosovo: S/RES/1244 (1999),SRB,0,0,0,5,5
2012,Mali,MLI,Serbia and Kosovo: S/RES/1244 (1999),SRB,0,0,0,19,19
2012,Morocco,MAR,Serbia and Kosovo: S/RES/1244 (1999),SRB,0,0,0,85,85
2012,Myanmar,MMR,Serbia and Kosovo: S/RES/1244 (1999),SRB,0,0,0,11,11
2012,Netherlands,NLD,Serbia and Kosovo: S/RES/1244 (1999),SRB,0,0,0,5,5
2012,Nigeria,NGA,Serbia and Kosovo: S/RES/1244 (1999),SRB,0,0,0,5,5
2012,Pakistan,PAK,Serbia and Kosovo: S/RES/1244 (1999),SRB,0,0,0,230,230
2012,Sierra Leone,SLE,Serbia and Kosovo: S/RES/1244 (1999),SRB,0,0,0,5,5
2012,Somalia,SOM,Serbia and Kosovo: S/RES/1244 (1999),SRB,0,0,26,615,641
2012,Sudan,SDN,Serbia and Kosovo: S/RES/1244 (1999),SRB,0,0,0,48,48
2012,Syrian Arab Rep.,SYR,Serbia and Kosovo: S/RES/1244 (1999),SRB,0,0,0,239,239
2012,Tunisia,TUN,Serbia and Kosovo: S/RES/1244 (1999),SRB,0,0,5,39,44
2012,Eritrea,ERI,Senegal,SEN,0,0,10,0,10
2012,Gambia,GMB,Senegal,SEN,0,0,10,0,10
2012,Guinea,GIN,Senegal,SEN,0,0,10,0,10
2012,Cote d'Ivoire,CIV,Senegal,SEN,0,0,27,0,27
2012,Liberia,LBR,Senegal,SEN,0,0,19,5,24
2012,Mauritania,MRT,Senegal,SEN,0,0,5,0,5
2012,Nigeria,NGA,Senegal,SEN,0,0,5,0,5
2012,Sierra Leone,SLE,Senegal,SEN,0,0,5,0,5
2012,Cote d'Ivoire,CIV,Sierra Leone,SLE,0,0,0,5,5
2012,Afghanistan,AFG,Spain,ESP,5,25,0,0,30
2012,Algeria,DZA,Spain,ESP,5,0,201,0,206
2012,Angola,AGO,Spain,ESP,0,0,16,0,16
2012,Egypt,EGY,Spain,ESP,0,0,20,0,20
2012,Armenia,ARM,Spain,ESP,5,0,5,0,10
2012,Azerbaijan,AZE,Spain,ESP,10,0,0,0,10
2012,Burundi,BDI,Spain,ESP,0,0,5,0,5
2012,Benin,BEN,Spain,ESP,0,0,10,0,10
2012,Bangladesh,BGD,Spain,ESP,0,0,10,0,10
2012,Burkina Faso,BFA,Spain,ESP,0,0,15,0,15
2012,Belarus,BLR,Spain,ESP,0,0,5,0,5
2012,Central African Rep.,CAF,Spain,ESP,0,0,5,0,5
2012,Chad,TCD,Spain,ESP,0,0,20,0,20
2012,Cameroon,CMR,Spain,ESP,5,0,220,0,225
2012,Congo,COG,Spain,ESP,5,0,41,0,46
2012,Dem. Rep. of the Congo,COD,Spain,ESP,5,0,80,15,100
2012,Colombia,COL,Spain,ESP,16,5,100,0,121
2012,Cuba,CUB,Spain,ESP,0,25,40,0,65
2012,Ecuador,ECU,Spain,ESP,0,0,5,0,5
2012,Equatorial Guinea,GNQ,Spain,ESP,0,0,5,0,5
2012,Eritrea,ERI,Spain,ESP,10,5,5,0,20
2012,Ethiopia,ETH,Spain,ESP,0,35,10,0,45
2012,Gambia,GMB,Spain,ESP,0,0,30,0,30
2012,Palestinian,PSE,Spain,ESP,76,16,5,0,97
2012,Georgia,GEO,Spain,ESP,0,0,10,0,10
2012,Ghana,GHA,Spain,ESP,0,0,25,0,25
2012,Guinea-Bissau,GNB,Spain,ESP,0,0,5,0,5
2012,Guatemala,GTM,Spain,ESP,0,0,10,0,10
2012,Guinea,GIN,Spain,ESP,0,0,130,0,130
2012,Haiti,HTI,Spain,ESP,5,0,0,0,5
2012,Honduras,HND,Spain,ESP,5,0,45,0,50
2012,Cote d'Ivoire,CIV,Spain,ESP,0,55,45,0,100
2012,India,IND,Spain,ESP,0,0,10,0,10
2012,Iran (Islamic Rep. of),IRN,Spain,ESP,0,0,41,0,41
2012,Iraq,IRQ,Spain,ESP,0,5,0,0,5
2012,Jordan,JOR,Spain,ESP,0,5,0,0,5
2012,Liberia,LBR,Spain,ESP,0,0,5,0,5
2012,Libya,LBY,Spain,ESP,0,0,10,0,10
2012,Sri Lanka,LKA,Spain,ESP,5,15,20,0,40
2012,Mauritania,MRT,Spain,ESP,0,0,5,0,5
2012,Mexico,MEX,Spain,ESP,0,0,10,0,10
2012,Mali,MLI,Spain,ESP,0,0,20,0,20
2012,Malawi,MWI,Spain,ESP,0,0,15,0,15
2012,Mongolia,MNG,Spain,ESP,0,0,5,0,5
2012,Morocco,MAR,Spain,ESP,0,5,51,0,56
2012,Niger,NER,Spain,ESP,0,0,10,0,10
2012,Nicaragua,NIC,Spain,ESP,5,0,15,0,20
2012,Nigeria,NGA,Spain,ESP,0,0,302,0,302
2012,Pakistan,PAK,Spain,ESP,31,5,36,0,72
2012,Romania,ROU,Spain,ESP,0,0,5,0,5
2012,Russian Federation,RUS,Spain,ESP,5,0,25,0,30
2012,Rwanda,RWA,Spain,ESP,0,0,5,0,5
2012,El Salvador,SLV,Spain,ESP,0,0,40,0,40
2012,Senegal,SEN,Spain,ESP,0,0,25,0,25
2012,Sierra Leone,SLE,Spain,ESP,0,0,20,0,20
2012,Somalia,SOM,Spain,ESP,5,44,5,10,64
2012,Sudan,SDN,Spain,ESP,0,35,5,0,40
2012,Syrian Arab Rep.,SYR,Spain,ESP,0,0,15,0,15
2012,Togo,TGO,Spain,ESP,0,0,5,0,5
2012,Turkey,TUR,Spain,ESP,0,0,30,0,30
2012,Uganda,UGA,Spain,ESP,0,0,5,0,5
2012,Ukraine,UKR,Spain,ESP,0,0,15,0,15
2012,Venezuela (Bolivarian Republic of),VEN,Spain,ESP,0,0,30,0,30
2012,Western Sahara,ESH,Spain,ESP,5,0,65,0,70
2012,Yemen,YEM,Spain,ESP,5,0,0,0,5
2012,Zimbabwe,ZWE,Spain,ESP,0,0,5,0,5
2012,Central African Rep.,CAF,Sudan,SDN,5,0,0,0,5
2012,Chad,TCD,Sudan,SDN,21,0,0,0,21
2012,Cameroon,CMR,Sudan,SDN,0,0,14,0,14
2012,Dem. Rep. of the Congo,COD,Sudan,SDN,0,0,5,0,5
2012,Eritrea,ERI,Sudan,SDN,13449,0,47,127,13623
2012,Ethiopia,ETH,Sudan,SDN,212,0,0,5,217
2012,Guinea,GIN,Sudan,SDN,0,0,5,0,5
2012,Cote d'Ivoire,CIV,Sudan,SDN,0,0,14,0,14
2012,Liberia,LBR,Sudan,SDN,0,0,15,12,27
2012,Mali,MLI,Sudan,SDN,0,0,13,0,13
2012,Nigeria,NGA,Sudan,SDN,0,0,18,0,18
2012,Sierra Leone,SLE,Sudan,SDN,0,0,0,11,11
2012,Somalia,SOM,Sudan,SDN,258,0,0,0,258
2012,Afghanistan,AFG,Slovakia,SVK,10,29,41,36,116
2012,Algeria,DZA,Slovakia,SVK,0,0,5,5,10
2012,Armenia,ARM,Slovakia,SVK,0,0,0,34,34
2012,Bangladesh,BGD,Slovakia,SVK,0,0,0,12,12
2012,Belarus,BLR,Slovakia,SVK,0,0,0,5,5
2012,China,CHN,Slovakia,SVK,0,0,5,13,18
2012,Cameroon,CMR,Slovakia,SVK,0,0,10,0,10
2012,Congo,COG,Slovakia,SVK,0,0,5,35,40
2012,Dem. Rep. of the Congo,COD,Slovakia,SVK,0,0,20,13,33
2012,Cuba,CUB,Slovakia,SVK,10,0,0,0,10
2012,Eritrea,ERI,Slovakia,SVK,0,0,0,13,13
2012,Gambia,GMB,Slovakia,SVK,0,0,0,5,5
2012,Palestinian,PSE,Slovakia,SVK,0,0,0,10,10
2012,Georgia,GEO,Slovakia,SVK,0,0,11,50,61
2012,Guinea,GIN,Slovakia,SVK,0,0,0,5,5
2012,India,IND,Slovakia,SVK,0,0,0,18,18
2012,Iran (Islamic Rep. of),IRN,Slovakia,SVK,0,0,12,0,12
2012,Iraq,IRQ,Slovakia,SVK,0,0,0,5,5
2012,Libya,LBY,Slovakia,SVK,0,0,5,0,5
2012,Rep. of Moldova,MDA,Slovakia,SVK,0,0,5,26,31
2012,Morocco,MAR,Slovakia,SVK,0,0,0,5,5
2012,Pakistan,PAK,Slovakia,SVK,0,0,0,13,13
2012,Russian Federation,RUS,Slovakia,SVK,0,0,0,12,12
2012,Serbia and Kosovo: S/RES/1244 (1999),SRB,Slovakia,SVK,0,0,5,0,5
2012,Somalia,SOM,Slovakia,SVK,10,72,37,95,214
2012,Viet Nam,VNM,Slovakia,SVK,0,0,5,10,15
2012,Syrian Arab Rep.,SYR,Slovakia,SVK,0,0,5,5,10
2012,Thailand,THA,Slovakia,SVK,0,0,0,5,5
2012,Tajikistan,TJK,Slovakia,SVK,0,0,0,5,5
2012,Turkey,TUR,Slovakia,SVK,0,0,11,0,11
2012,Ukraine,UKR,Slovakia,SVK,0,0,5,5,10
2012,Afghanistan,AFG,Slovenia,SVN,5,5,39,25,74
2012,Algeria,DZA,Slovenia,SVN,0,0,10,10,20
2012,Egypt,EGY,Slovenia,SVN,0,0,5,0,5
2012,Bosnia and Herzegovina,BIH,Slovenia,SVN,0,0,5,0,5
2012,China,CHN,Slovenia,SVN,0,0,5,0,5
2012,Cuba,CUB,Slovenia,SVN,0,0,5,0,5
2012,Palestinian,PSE,Slovenia,SVN,0,0,0,5,5
2012,Croatia,HRV,Slovenia,SVN,0,0,10,0,10
2012,Iran (Islamic Rep. of),IRN,Slovenia,SVN,5,0,5,0,10
2012,Iraq,IRQ,Slovenia,SVN,0,0,0,5,5
2012,Libya,LBY,Slovenia,SVN,0,0,0,5,5
2012,Lebanon,LBN,Slovenia,SVN,0,0,5,0,5
2012,Morocco,MAR,Slovenia,SVN,0,0,5,5,10
2012,Nigeria,NGA,Slovenia,SVN,0,0,5,5,10
2012,Pakistan,PAK,Slovenia,SVN,0,0,5,5,10
2012,Russian Federation,RUS,Slovenia,SVN,5,0,0,0,5
2012,Serbia and Kosovo: S/RES/1244 (1999),SRB,Slovenia,SVN,0,5,29,5,39
2012,Somalia,SOM,Slovenia,SVN,5,5,0,0,10
2012,Syrian Arab Rep.,SYR,Slovenia,SVN,0,0,14,17,31
2012,Tunisia,TUN,Slovenia,SVN,0,0,0,5,5
2012,Turkey,TUR,Slovenia,SVN,0,0,12,13,25
2012,Dem. Rep. of the Congo,COD,Eswatini,SWZ,5,0,0,0,5
2012,Rwanda,RWA,Eswatini,SWZ,5,0,0,0,5
2012,Afghanistan,AFG,Sweden,SWE,783,1188,912,292,3175
2012,Albania,ALB,Sweden,SWE,27,20,880,279,1206
2012,Algeria,DZA,Sweden,SWE,0,0,91,104,195
2012,Angola,AGO,Sweden,SWE,0,0,10,0,10
2012,Egypt,EGY,Sweden,SWE,27,0,88,13,128
2012,Armenia,ARM,Sweden,SWE,5,0,173,34,212
2012,Azerbaijan,AZE,Sweden,SWE,14,0,210,43,267
2012,Burundi,BDI,Sweden,SWE,0,0,5,5,10
2012,Benin,BEN,Sweden,SWE,0,0,0,5,5
2012,Bangladesh,BGD,Sweden,SWE,12,5,76,5,98
2012,Belarus,BLR,Sweden,SWE,5,0,190,124,319
2012,Bolivia (Plurinational State of),BOL,Sweden,SWE,0,0,28,5,33
2012,Brazil,BRA,Sweden,SWE,0,0,5,0,5
2012,Bosnia and Herzegovina,BIH,Sweden,SWE,0,0,1270,636,1906
2012,Canada,CAN,Sweden,SWE,0,0,0,5,5
2012,Chad,TCD,Sweden,SWE,0,0,0,5,5
2012,China,CHN,Sweden,SWE,53,0,29,14,96
2012,Chile,CHL,Sweden,SWE,0,0,5,5,10
2012,Cameroon,CMR,Sweden,SWE,10,0,18,5,33
2012,Congo,COG,Sweden,SWE,0,5,5,0,10
2012,Dem. Rep. of the Congo,COD,Sweden,SWE,16,10,42,5,73
2012,Colombia,COL,Sweden,SWE,0,0,10,0,10
2012,Cuba,CUB,Sweden,SWE,0,0,36,20,56
2012,Djibouti,DJI,Sweden,SWE,0,0,5,0,5
2012,Ecuador,ECU,Sweden,SWE,0,0,11,0,11
2012,Eritrea,ERI,Sweden,SWE,199,1080,89,209,1577
2012,Estonia,EST,Sweden,SWE,0,0,0,5,5
2012,Ethiopia,ETH,Sweden,SWE,55,5,156,32,248
2012,Gambia,GMB,Sweden,SWE,10,0,45,10,65
2012,Georgia,GEO,Sweden,SWE,0,0,158,195,353
2012,Ghana,GHA,Sweden,SWE,5,0,28,5,38
2012,Guinea-Bissau,GNB,Sweden,SWE,5,0,0,0,5
2012,Greece,GRC,Sweden,SWE,0,0,5,5,10
2012,Guatemala,GTM,Sweden,SWE,0,5,0,0,5
2012,Guinea,GIN,Sweden,SWE,0,0,23,10,33
2012,Croatia,HRV,Sweden,SWE,0,0,11,0,11
2012,Hungary,HUN,Sweden,SWE,0,0,14,0,14
2012,Cote d'Ivoire,CIV,Sweden,SWE,0,0,13,5,18
2012,India,IND,Sweden,SWE,0,0,30,5,35
2012,Iran (Islamic Rep. of),IRN,Sweden,SWE,416,22,537,88,1063
2012,Iraq,IRQ,Sweden,SWE,217,123,499,131,970
2012,Israel,ISR,Sweden,SWE,0,0,13,5,18
2012,Jordan,JOR,Sweden,SWE,5,0,60,24,89
2012,Japan,JPN,Sweden,SWE,0,0,5,0,5
2012,Kazakhstan,KAZ,Sweden,SWE,5,0,276,37,318
2012,Kenya,KEN,Sweden,SWE,0,0,53,5,58
2012,Kyrgyzstan,KGZ,Sweden,SWE,5,0,218,21,244
2012,Rep. of Korea,KOR,Sweden,SWE,0,0,10,0,10
2012,Dem. People's Rep. of Korea,PRK,Sweden,SWE,0,0,0,5,5
2012,Kuwait,KWT,Sweden,SWE,0,0,14,0,14
2012,Liberia,LBR,Sweden,SWE,0,0,5,0,5
2012,Libya,LBY,Sweden,SWE,11,12,64,64,151
2012,Lebanon,LBN,Sweden,SWE,5,5,151,35,196
2012,Sri Lanka,LKA,Sweden,SWE,0,0,5,5,10
2012,Latvia,LVA,Sweden,SWE,0,0,5,0,5
2012,North Macedonia,MKD,Sweden,SWE,0,0,348,99,447
2012,Rep. of Moldova,MDA,Sweden,SWE,0,0,5,5,10
2012,Mexico,MEX,Sweden,SWE,0,0,10,0,10
2012,Mali,MLI,Sweden,SWE,0,0,12,0,12
2012,Mongolia,MNG,Sweden,SWE,5,0,473,44,522
2012,Morocco,MAR,Sweden,SWE,0,0,111,77,188
2012,Montenegro,MNE,Sweden,SWE,0,0,85,13,98
2012,Nepal,NPL,Sweden,SWE,0,0,11,0,11
2012,Nicaragua,NIC,Sweden,SWE,0,0,18,0,18
2012,Nigeria,NGA,Sweden,SWE,27,0,199,48,274
2012,Pakistan,PAK,Sweden,SWE,32,5,117,19,173
2012,Peru,PER,Sweden,SWE,0,0,5,5,10
2012,Philippines,PHL,Sweden,SWE,0,0,5,0,5
2012,Romania,ROU,Sweden,SWE,0,0,10,5,15
2012,Russian Federation,RUS,Sweden,SWE,53,29,319,173,574
2012,Rwanda,RWA,Sweden,SWE,5,0,5,0,10
2012,El Salvador,SLV,Sweden,SWE,0,10,44,0,54
2012,Saudi Arabia,SAU,Sweden,SWE,5,0,0,0,5
2012,Serbia and Kosovo: S/RES/1244 (1999),SRB,Sweden,SWE,0,0,2672,704,3376
2012,Senegal,SEN,Sweden,SWE,0,0,16,5,21
2012,Sierra Leone,SLE,Sweden,SWE,5,0,18,5,28
2012,Somalia,SOM,Sweden,SWE,321,1708,220,981,3230
2012,Viet Nam,VNM,Sweden,SWE,0,0,17,10,27
2012,Sudan,SDN,Sweden,SWE,27,14,20,17,78
2012,Slovakia,SVK,Sweden,SWE,0,0,0,5,5
2012,Syrian Arab Rep.,SYR,Sweden,SWE,1133,3643,47,218,5041
2012,United Rep. of Tanzania,TZA,Sweden,SWE,0,0,13,0,13
2012,Thailand,THA,Sweden,SWE,0,0,5,0,5
2012,Tajikistan,TJK,Sweden,SWE,0,0,17,5,22
2012,Turkmenistan,TKM,Sweden,SWE,0,0,5,5,10
2012,Tunisia,TUN,Sweden,SWE,0,0,35,40,75
2012,Turkey,TUR,Sweden,SWE,16,5,63,20,104
2012,Uganda,UGA,Sweden,SWE,66,0,69,10,145
2012,Ukraine,UKR,Sweden,SWE,0,0,91,24,115
2012,United States of America,USA,Sweden,SWE,0,0,0,11,11
2012,Uzbekistan,UZB,Sweden,SWE,29,0,240,27,296
2012,Yemen,YEM,Sweden,SWE,38,25,67,10,140
2012,Stateless,XXA,Sweden,SWE,299,509,359,189,1356
2012,Afghanistan,AFG,Switzerland,CHE,38,135,26,389,588
2012,Albania,ALB,Switzerland,CHE,0,0,23,41,64
2012,Algeria,DZA,Switzerland,CHE,0,0,80,616,696
2012,Angola,AGO,Switzerland,CHE,0,40,28,18,86
2012,Egypt,EGY,Switzerland,CHE,0,0,10,125,135
2012,Armenia,ARM,Switzerland,CHE,0,0,22,91,113
2012,Azerbaijan,AZE,Switzerland,CHE,5,0,18,10,33
2012,Bahrain,BHR,Switzerland,CHE,0,0,0,5,5
2012,Burundi,BDI,Switzerland,CHE,5,0,0,0,5
2012,Benin,BEN,Switzerland,CHE,0,0,0,22,22
2012,Bangladesh,BGD,Switzerland,CHE,0,5,5,25,35
2012,Burkina Faso,BFA,Switzerland,CHE,0,0,5,20,25
2012,Belarus,BLR,Switzerland,CHE,0,0,12,136,148
2012,Bosnia and Herzegovina,BIH,Switzerland,CHE,5,11,202,315,533
2012,Bulgaria,BGR,Switzerland,CHE,0,0,16,128,144
2012,Cambodia,KHM,Switzerland,CHE,0,0,5,0,5
2012,Chad,TCD,Switzerland,CHE,0,0,0,204,204
2012,China,CHN,Switzerland,CHE,16,90,10,18,134
2012,Cameroon,CMR,Switzerland,CHE,5,5,10,29,49
2012,Congo,COG,Switzerland,CHE,0,0,0,12,12
2012,Dem. Rep. of the Congo,COD,Switzerland,CHE,0,55,53,41,149
2012,Colombia,COL,Switzerland,CHE,27,0,5,5,37
2012,Cuba,CUB,Switzerland,CHE,0,0,5,5,10
2012,Czechia,CZE,Switzerland,CHE,0,0,5,5,10
2012,Ecuador,ECU,Switzerland,CHE,0,0,5,0,5
2012,Equatorial Guinea,GNQ,Switzerland,CHE,0,0,5,5,10
2012,Eritrea,ERI,Switzerland,CHE,1332,214,24,540,2110
2012,Ethiopia,ETH,Switzerland,CHE,44,28,33,75,180
2012,France,FRA,Switzerland,CHE,0,0,0,5,5
2012,Gabon,GAB,Switzerland,CHE,0,0,5,5,10
2012,Gambia,GMB,Switzerland,CHE,0,5,30,410,445
2012,Palestinian,PSE,Switzerland,CHE,12,15,0,96,123
2012,Georgia,GEO,Switzerland,CHE,5,0,25,659,689
2012,Germany,DEU,Switzerland,CHE,0,5,0,0,5
2012,Ghana,GHA,Switzerland,CHE,0,5,10,395,410
2012,Guinea-Bissau,GNB,Switzerland,CHE,0,10,57,218,285
2012,Greece,GRC,Switzerland,CHE,0,0,0,5,5
2012,Guinea,GIN,Switzerland,CHE,0,13,46,282,341
2012,Croatia,HRV,Switzerland,CHE,0,0,5,35,40
2012,Hungary,HUN,Switzerland,CHE,0,0,0,21,21
2012,Cote d'Ivoire,CIV,Switzerland,CHE,0,5,5,116,126
2012,India,IND,Switzerland,CHE,0,0,0,12,12
2012,Iran (Islamic Rep. of),IRN,Switzerland,CHE,92,62,51,125,330
2012,Iraq,IRQ,Switzerland,CHE,136,157,76,207,576
2012,Israel,ISR,Switzerland,CHE,0,0,0,5,5
2012,Italy,ITA,Switzerland,CHE,0,0,0,5,5
2012,Jordan,JOR,Switzerland,CHE,5,0,0,5,10
2012,Kazakhstan,KAZ,Switzerland,CHE,0,0,0,5,5
2012,Kenya,KEN,Switzerland,CHE,10,0,0,10,20
2012,Kyrgyzstan,KGZ,Switzerland,CHE,5,0,0,16,21
2012,Liberia,LBR,Switzerland,CHE,0,5,0,73,78
2012,Libya,LBY,Switzerland,CHE,5,0,5,189,199
2012,Lebanon,LBN,Switzerland,CHE,0,5,0,20,25
2012,Sri Lanka,LKA,Switzerland,CHE,120,107,494,177,898
2012,Mauritania,MRT,Switzerland,CHE,0,0,5,49,54
2012,North Macedonia,MKD,Switzerland,CHE,0,13,392,1006,1411
2012,Rep. of Moldova,MDA,Switzerland,CHE,0,0,0,22,22
2012,Mexico,MEX,Switzerland,CHE,5,0,0,0,5
2012,Mali,MLI,Switzerland,CHE,0,0,0,130,130
2012,Mongolia,MNG,Switzerland,CHE,0,5,33,69,107
2012,Morocco,MAR,Switzerland,CHE,0,0,21,773,794
2012,Montenegro,MNE,Switzerland,CHE,0,5,10,34,49
2012,Myanmar,MMR,Switzerland,CHE,14,0,0,0,14
2012,Nepal,NPL,Switzerland,CHE,0,0,12,0,12
2012,Netherlands,NLD,Switzerland,CHE,0,0,0,5,5
2012,Niger,NER,Switzerland,CHE,0,0,0,148,148
2012,Nigeria,NGA,Switzerland,CHE,0,11,90,2817,2918
2012,Pakistan,PAK,Switzerland,CHE,5,0,25,88,118
2012,Poland,POL,Switzerland,CHE,0,0,0,5,5
2012,Romania,ROU,Switzerland,CHE,0,0,0,36,36
2012,South Africa,ZAF,Switzerland,CHE,0,0,5,5,10
2012,Russian Federation,RUS,Switzerland,CHE,37,18,63,233,351
2012,Rwanda,RWA,Switzerland,CHE,12,0,0,5,17
2012,Serbia and Kosovo: S/RES/1244 (1999),SRB,Switzerland,CHE,5,78,895,2267,3245
2012,Senegal,SEN,Switzerland,CHE,0,0,13,208,221
2012,Sierra Leone,SLE,Switzerland,CHE,0,0,5,82,87
2012,Somalia,SOM,Switzerland,CHE,97,174,5,185,461
2012,Spain,ESP,Switzerland,CHE,0,0,0,11,11
2012,Viet Nam,VNM,Switzerland,CHE,5,0,0,0,5
2012,Sudan,SDN,Switzerland,CHE,16,5,5,130,156
2012,South Sudan,SSD,Switzerland,CHE,0,0,0,5,5
2012,Slovakia,SVK,Switzerland,CHE,0,0,0,19,19
2012,Syrian Arab Rep.,SYR,Switzerland,CHE,184,205,10,211,610
2012,United Rep. of Tanzania,TZA,Switzerland,CHE,0,5,0,0,5
2012,Tajikistan,TJK,Switzerland,CHE,5,0,0,5,10
2012,Togo,TGO,Switzerland,CHE,39,5,16,53,113
2012,Tunisia,TUN,Switzerland,CHE,5,0,123,2453,2581
2012,Turkey,TUR,Switzerland,CHE,160,16,171,168,515
2012,Uganda,UGA,Switzerland,CHE,0,0,0,20,20
2012,Ukraine,UKR,Switzerland,CHE,0,0,5,18,23
2012,United States of America,USA,Switzerland,CHE,0,0,0,5,5
2012,Uzbekistan,UZB,Switzerland,CHE,5,0,10,10,25
2012,Venezuela (Bolivarian Republic of),VEN,Switzerland,CHE,0,0,0,5,5
2012,Samoa,WSM,Switzerland,CHE,0,0,0,10,10
2012,Yemen,YEM,Switzerland,CHE,10,16,5,10,41
2012,Zambia,ZMB,Switzerland,CHE,0,0,0,5,5
2012,Zimbabwe,ZWE,Switzerland,CHE,0,0,0,21,21
2012,Stateless,XXA,Switzerland,CHE,0,0,0,5,5
2012,Central African Rep.,CAF,Togo,TGO,5,0,5,0,10
2012,Chad,TCD,Togo,TGO,0,0,5,0,5
2012,Congo,COG,Togo,TGO,5,0,5,0,10
2012,Dem. Rep. of the Congo,COD,Togo,TGO,14,0,18,0,32
2012,Ghana,GHA,Togo,TGO,0,4982,0,0,4982
2012,Cote d'Ivoire,CIV,Togo,TGO,10,806,10,0,826
2012,Liberia,LBR,Togo,TGO,0,0,5,0,5
2012,Sri Lanka,LKA,Togo,TGO,0,0,34,0,34
2012,Mali,MLI,Togo,TGO,137,0,0,0,137
2012,Nigeria,NGA,Togo,TGO,0,0,5,0,5
2012,Afghanistan,AFG,Ukraine,UKR,36,17,153,45,251
2012,Angola,AGO,Ukraine,UKR,0,0,5,0,5
2012,Egypt,EGY,Ukraine,UKR,0,0,0,5,5
2012,Armenia,ARM,Ukraine,UKR,0,0,0,5,5
2012,Azerbaijan,AZE,Ukraine,UKR,5,0,13,5,23
2012,Bangladesh,BGD,Ukraine,UKR,0,0,0,13,13
2012,Belarus,BLR,Ukraine,UKR,0,0,5,5,10
2012,Cameroon,CMR,Ukraine,UKR,0,0,10,0,10
2012,Congo,COG,Ukraine,UKR,0,0,5,0,5
2012,Dem. Rep. of the Congo,COD,Ukraine,UKR,0,0,17,0,17
2012,Eritrea,ERI,Ukraine,UKR,0,5,11,5,21
2012,Ethiopia,ETH,Ukraine,UKR,0,0,5,5,10
2012,Palestinian,PSE,Ukraine,UKR,0,0,15,10,25
2012,Georgia,GEO,Ukraine,UKR,0,0,0,14,14
2012,Guinea,GIN,Ukraine,UKR,0,0,5,5,10
2012,Cote d'Ivoire,CIV,Ukraine,UKR,0,0,5,5,10
2012,India,IND,Ukraine,UKR,0,0,5,0,5
2012,Iran (Islamic Rep. of),IRN,Ukraine,UKR,0,0,25,11,36
2012,Iraq,IRQ,Ukraine,UKR,0,10,20,15,45
2012,Kazakhstan,KAZ,Ukraine,UKR,0,0,0,5,5
2012,Kyrgyzstan,KGZ,Ukraine,UKR,0,0,39,97,136
2012,Libya,LBY,Ukraine,UKR,0,0,5,0,5
2012,Lebanon,LBN,Ukraine,UKR,0,0,0,5,5
2012,Sri Lanka,LKA,Ukraine,UKR,0,0,12,0,12
2012,Pakistan,PAK,Ukraine,UKR,0,0,0,5,5
2012,Russian Federation,RUS,Ukraine,UKR,0,0,16,20,36
2012,Somalia,SOM,Ukraine,UKR,5,41,176,68,290
2012,Sudan,SDN,Ukraine,UKR,0,0,5,5,10
2012,Syrian Arab Rep.,SYR,Ukraine,UKR,0,17,38,37,92
2012,Turkey,TUR,Ukraine,UKR,5,0,0,0,5
2012,Uzbekistan,UZB,Ukraine,UKR,0,0,31,21,52
2012,Argentina,ARG,Uruguay,URY,0,0,0,5,5
2012,China,CHN,Uruguay,URY,0,0,0,5,5
2012,Colombia,COL,Uruguay,URY,5,0,5,14,24
2012,Cuba,CUB,Uruguay,URY,0,0,0,5,5
2012,Nigeria,NGA,Uruguay,URY,0,0,0,5,5
2012,Colombia,COL,Venezuela (Bolivarian Republic of),VEN,1182,0,9856,7406,18444
2012,Angola,AGO,Zambia,ZMB,0,0,0,20,20
2012,Burundi,BDI,Zambia,ZMB,5,0,0,0,5
2012,Dem. Rep. of the Congo,COD,Zambia,ZMB,321,0,10,30,361
2012,Somalia,SOM,Zambia,ZMB,5,0,0,122,127
2012,Burundi,BDI,Zimbabwe,ZWE,0,0,24,11,35
2012,Dem. Rep. of the Congo,COD,Zimbabwe,ZWE,205,0,299,505,1009
2012,Ethiopia,ETH,Zimbabwe,ZWE,0,0,0,5,5
2012,Cote d'Ivoire,CIV,Zimbabwe,ZWE,0,0,5,0,5
2012,Rwanda,RWA,Zimbabwe,ZWE,0,0,5,12,17
2012,Somalia,SOM,Zimbabwe,ZWE,0,0,0,10,10
2013,Dem. Rep. of the Congo,COD,Albania,ALB,5,0,0,0,5
2013,Iran (Islamic Rep. of),IRN,Albania,ALB,0,0,0,5,5
2013,Syrian Arab Rep.,SYR,Albania,ALB,0,0,0,12,12
2013,Chad,TCD,Angola,AGO,0,0,0,294,294
2013,Congo,COG,Angola,AGO,0,0,0,63,63
2013,Cote d'Ivoire,CIV,Angola,AGO,0,0,5,529,534
2013,Liberia,LBR,Angola,AGO,0,0,0,41,41
2013,Mauritania,MRT,Angola,AGO,0,0,0,233,233
2013,Senegal,SEN,Angola,AGO,0,0,0,10,10
2013,Sierra Leone,SLE,Angola,AGO,0,0,0,223,223
2013,Sudan,SDN,Angola,AGO,0,0,0,92,92
2013,Zimbabwe,ZWE,Angola,AGO,0,0,0,5,5
2013,Egypt,EGY,Argentina,ARG,5,0,0,0,5
2013,Armenia,ARM,Argentina,ARG,0,0,5,5,10
2013,Bangladesh,BGD,Argentina,ARG,0,0,28,5,33
2013,Cameroon,CMR,Argentina,ARG,5,0,0,5,10
2013,Dem. Rep. of the Congo,COD,Argentina,ARG,5,0,0,0,5
2013,Colombia,COL,Argentina,ARG,29,0,79,188,296
2013,Cuba,CUB,Argentina,ARG,5,0,78,30,113
2013,Dominican Rep.,DOM,Argentina,ARG,0,0,10,126,136
2013,Ecuador,ECU,Argentina,ARG,0,0,0,5,5
2013,Ghana,GHA,Argentina,ARG,15,0,10,0,25
2013,Guinea,GIN,Argentina,ARG,0,0,5,0,5
2013,Haiti,HTI,Argentina,ARG,5,0,17,5,27
2013,Honduras,HND,Argentina,ARG,5,0,0,0,5
2013,Hungary,HUN,Argentina,ARG,0,0,0,5,5
2013,India,IND,Argentina,ARG,0,0,34,20,54
2013,Kazakhstan,KAZ,Argentina,ARG,0,0,5,0,5
2013,Liberia,LBR,Argentina,ARG,0,0,0,5,5
2013,Mali,MLI,Argentina,ARG,5,0,0,0,5
2013,Nigeria,NGA,Argentina,ARG,0,0,20,13,33
2013,Pakistan,PAK,Argentina,ARG,5,0,0,0,5
2013,Peru,PER,Argentina,ARG,0,0,0,5,5
2013,South Africa,ZAF,Argentina,ARG,0,0,5,0,5
2013,Russian Federation,RUS,Argentina,ARG,0,0,5,5,10
2013,El Salvador,SLV,Argentina,ARG,5,0,5,0,10
2013,Senegal,SEN,Argentina,ARG,0,0,13,618,631
2013,Spain,ESP,Argentina,ARG,0,0,5,0,5
2013,Syrian Arab Rep.,SYR,Argentina,ARG,119,0,0,0,119
2013,Ukraine,UKR,Argentina,ARG,11,0,0,0,11
2013,Yemen,YEM,Argentina,ARG,0,0,0,5,5
2013,Stateless,XXA,Argentina,ARG,0,0,5,0,5
2013,Guinea,GIN,Armenia,ARM,0,0,5,0,5
2013,Cote d'Ivoire,CIV,Armenia,ARM,0,0,0,5,5
2013,Iran (Islamic Rep. of),IRN,Armenia,ARM,0,0,0,13,13
2013,Iraq,IRQ,Armenia,ARM,26,0,0,0,26
2013,Lebanon,LBN,Armenia,ARM,5,0,0,0,5
2013,Syrian Arab Rep.,SYR,Armenia,ARM,429,0,0,154,583
2013,Afghanistan,AFG,Australia,AUS,918,0,79,0,997
2013,Albania,ALB,Australia,AUS,5,0,10,0,15
2013,Egypt,EGY,Australia,AUS,289,0,86,0,375
2013,Bahrain,BHR,Australia,AUS,10,0,0,0,10
2013,Bangladesh,BGD,Australia,AUS,22,0,91,0,113
2013,China,CHN,Australia,AUS,131,0,639,0,770
2013,Dem. Rep. of the Congo,COD,Australia,AUS,0,0,5,0,5
2013,Colombia,COL,Australia,AUS,17,0,11,0,28
2013,Ethiopia,ETH,Australia,AUS,0,0,10,0,10
2013,Fiji,FJI,Australia,AUS,35,0,157,0,192
2013,Palestinian,PSE,Australia,AUS,67,0,5,0,72
2013,United Kingdom of Great Britain and Northern Ireland,GBR,Australia,AUS,0,0,16,0,16
2013,Ghana,GHA,Australia,AUS,5,0,11,0,16
2013,"China, Hong Kong SAR",HKG,Australia,AUS,0,0,20,0,20
2013,India,IND,Australia,AUS,44,0,576,0,620
2013,Indonesia,IDN,Australia,AUS,12,0,67,0,79
2013,Iran (Islamic Rep. of),IRN,Australia,AUS,593,0,139,0,732
2013,Iraq,IRQ,Australia,AUS,224,0,49,0,273
2013,Israel,ISR,Australia,AUS,0,0,11,0,11
2013,Italy,ITA,Australia,AUS,0,0,5,0,5
2013,Jordan,JOR,Australia,AUS,11,0,39,0,50
2013,Japan,JPN,Australia,AUS,0,0,5,0,5
2013,Kenya,KEN,Australia,AUS,0,0,15,0,15
2013,Rep. of Korea,KOR,Australia,AUS,5,0,30,0,35
2013,Liberia,LBR,Australia,AUS,10,0,0,0,10
2013,Libya,LBY,Australia,AUS,173,0,16,0,189
2013,Lebanon,LBN,Australia,AUS,10,0,167,0,177
2013,Sri Lanka,LKA,Australia,AUS,299,0,422,0,721
2013,Malaysia,MYS,Australia,AUS,12,0,91,0,103
2013,Mauritius,MUS,Australia,AUS,0,0,18,0,18
2013,Myanmar,MMR,Australia,AUS,11,0,0,0,11
2013,Nepal,NPL,Australia,AUS,5,0,132,0,137
2013,Nigeria,NGA,Australia,AUS,15,0,26,0,41
2013,New Zealand,NZL,Australia,AUS,0,0,13,0,13
2013,Pakistan,PAK,Australia,AUS,496,0,168,0,664
2013,Philippines,PHL,Australia,AUS,0,0,39,0,39
2013,Papua New Guinea,PNG,Australia,AUS,45,0,12,0,57
2013,Portugal,PRT,Australia,AUS,0,0,5,0,5
2013,South Africa,ZAF,Australia,AUS,0,0,5,0,5
2013,Russian Federation,RUS,Australia,AUS,5,0,5,0,10
2013,Rwanda,RWA,Australia,AUS,0,0,5,0,5
2013,Saudi Arabia,SAU,Australia,AUS,12,0,5,0,17
2013,Singapore,SGP,Australia,AUS,0,0,11,0,11
2013,Somalia,SOM,Australia,AUS,5,0,0,0,5
2013,Viet Nam,VNM,Australia,AUS,5,0,35,0,40
2013,Syrian Arab Rep.,SYR,Australia,AUS,61,0,0,0,61
2013,Thailand,THA,Australia,AUS,0,0,17,0,17
2013,Tonga,TON,Australia,AUS,5,0,31,0,36
2013,Turkey,TUR,Australia,AUS,36,0,22,0,58
2013,Ukraine,UKR,Australia,AUS,0,0,14,0,14
2013,United States of America,USA,Australia,AUS,0,0,5,0,5
2013,Zimbabwe,ZWE,Australia,AUS,51,0,40,0,91
2013,Stateless,XXA,Australia,AUS,240,0,23,0,263
2013,Afghanistan,AFG,Azerbaijan,AZE,5,0,105,0,110
2013,Iran (Islamic Rep. of),IRN,Azerbaijan,AZE,0,0,12,0,12
2013,Pakistan,PAK,Azerbaijan,AZE,0,0,31,0,31
2013,Afghanistan,AFG,Belgium,BEL,636,803,1042,39,2520
2013,Albania,ALB,Belgium,BEL,85,0,465,5,555
2013,Algeria,DZA,Belgium,BEL,11,0,59,22,92
2013,Angola,AGO,Belgium,BEL,5,0,128,5,138
2013,Egypt,EGY,Belgium,BEL,10,0,59,15,84
2013,Argentina,ARG,Belgium,BEL,0,0,5,0,5
2013,Armenia,ARM,Belgium,BEL,10,0,260,14,284
2013,Azerbaijan,AZE,Belgium,BEL,10,0,115,17,142
2013,Burundi,BDI,Belgium,BEL,68,5,114,5,192
2013,Benin,BEN,Belgium,BEL,10,0,84,5,99
2013,Bangladesh,BGD,Belgium,BEL,11,0,238,39,288
2013,Bhutan,BTN,Belgium,BEL,0,0,10,0,10
2013,Burkina Faso,BFA,Belgium,BEL,16,0,91,0,107
2013,Belarus,BLR,Belgium,BEL,5,0,36,11,52
2013,Bosnia and Herzegovina,BIH,Belgium,BEL,5,0,63,0,68
2013,Bulgaria,BGR,Belgium,BEL,0,0,19,0,19
2013,Central African Rep.,CAF,Belgium,BEL,5,5,0,0,10
2013,Chad,TCD,Belgium,BEL,5,0,15,0,20
2013,China,CHN,Belgium,BEL,205,0,46,10,261
2013,Cameroon,CMR,Belgium,BEL,68,0,278,19,365
2013,Congo,COG,Belgium,BEL,5,0,33,5,43
2013,Dem. Rep. of the Congo,COD,Belgium,BEL,342,22,1728,63,2155
2013,Colombia,COL,Belgium,BEL,5,0,5,0,10
2013,Cuba,CUB,Belgium,BEL,5,0,0,0,5
2013,Djibouti,DJI,Belgium,BEL,61,0,31,5,97
2013,Dominican Rep.,DOM,Belgium,BEL,0,0,5,0,5
2013,Equatorial Guinea,GNQ,Belgium,BEL,5,0,0,0,5
2013,Eritrea,ERI,Belgium,BEL,14,0,14,0,28
2013,Ethiopia,ETH,Belgium,BEL,5,0,12,0,17
2013,Gambia,GMB,Belgium,BEL,10,0,25,0,35
2013,Palestinian,PSE,Belgium,BEL,0,5,0,0,5
2013,Georgia,GEO,Belgium,BEL,0,0,185,19,204
2013,Ghana,GHA,Belgium,BEL,10,0,46,5,61
2013,Guinea-Bissau,GNB,Belgium,BEL,0,0,12,0,12
2013,Guatemala,GTM,Belgium,BEL,0,0,11,0,11
2013,Guinea,GIN,Belgium,BEL,555,5,1461,61,2082
2013,Croatia,HRV,Belgium,BEL,0,0,5,0,5
2013,Hungary,HUN,Belgium,BEL,0,0,10,0,10
2013,Cote d'Ivoire,CIV,Belgium,BEL,45,0,221,5,271
2013,India,IND,Belgium,BEL,0,0,34,0,34
2013,Iran (Islamic Rep. of),IRN,Belgium,BEL,204,0,218,69,491
2013,Iraq,IRQ,Belgium,BEL,161,65,222,73,521
2013,Israel,ISR,Belgium,BEL,0,0,5,0,5
2013,Italy,ITA,Belgium,BEL,0,0,5,0,5
2013,Jordan,JOR,Belgium,BEL,0,0,17,5,22
2013,Kazakhstan,KAZ,Belgium,BEL,14,0,116,12,142
2013,Kenya,KEN,Belgium,BEL,0,0,27,0,27
2013,Kyrgyzstan,KGZ,Belgium,BEL,17,0,82,10,109
2013,Dem. People's Rep. of Korea,PRK,Belgium,BEL,0,0,92,28,120
2013,Liberia,LBR,Belgium,BEL,0,0,14,0,14
2013,Libya,LBY,Belgium,BEL,0,0,0,5,5
2013,Lebanon,LBN,Belgium,BEL,5,0,26,12,43
2013,Sri Lanka,LKA,Belgium,BEL,50,0,37,5,92
2013,Mauritania,MRT,Belgium,BEL,25,0,230,10,265
2013,North Macedonia,MKD,Belgium,BEL,16,0,177,0,193
2013,Rep. of Moldova,MDA,Belgium,BEL,0,0,11,0,11
2013,Mali,MLI,Belgium,BEL,5,0,45,10,60
2013,Mongolia,MNG,Belgium,BEL,0,0,35,5,40
2013,Morocco,MAR,Belgium,BEL,11,0,105,19,135
2013,Montenegro,MNE,Belgium,BEL,0,0,5,0,5
2013,Mauritius,MUS,Belgium,BEL,0,0,5,0,5
2013,Myanmar,MMR,Belgium,BEL,5,0,0,0,5
2013,Nepal,NPL,Belgium,BEL,5,0,323,36,364
2013,Netherlands,NLD,Belgium,BEL,0,0,5,0,5
2013,Niger,NER,Belgium,BEL,18,0,114,0,132
2013,Nigeria,NGA,Belgium,BEL,5,0,109,5,119
2013,Pakistan,PAK,Belgium,BEL,51,0,727,108,886
2013,Romania,ROU,Belgium,BEL,0,0,54,0,54
2013,South Africa,ZAF,Belgium,BEL,0,0,5,0,5
2013,Russian Federation,RUS,Belgium,BEL,282,0,807,77,1166
2013,Rwanda,RWA,Belgium,BEL,85,0,307,15,407
2013,El Salvador,SLV,Belgium,BEL,0,0,12,0,12
2013,Serbia and Kosovo: S/RES/1244 (1999),SRB,Belgium,BEL,61,0,600,28,689
2013,Senegal,SEN,Belgium,BEL,81,0,450,25,556
2013,Sierra Leone,SLE,Belgium,BEL,10,0,62,0,72
2013,Somalia,SOM,Belgium,BEL,99,30,117,5,251
2013,Viet Nam,VNM,Belgium,BEL,0,0,10,0,10
2013,Sudan,SDN,Belgium,BEL,19,0,13,0,32
2013,Suriname,SUR,Belgium,BEL,0,0,5,5,10
2013,Slovakia,SVK,Belgium,BEL,0,0,10,0,10
2013,Syrian Arab Rep.,SYR,Belgium,BEL,213,1315,54,34,1616
2013,United Rep. of Tanzania,TZA,Belgium,BEL,13,0,40,0,53
2013,Tajikistan,TJK,Belgium,BEL,0,0,5,0,5
2013,Togo,TGO,Belgium,BEL,53,5,329,19,406
2013,Tunisia,TUN,Belgium,BEL,5,0,31,5,41
2013,Turkey,TUR,Belgium,BEL,95,0,293,49,437
2013,Uganda,UGA,Belgium,BEL,0,0,11,5,16
2013,Ukraine,UKR,Belgium,BEL,10,0,31,5,46
2013,Uzbekistan,UZB,Belgium,BEL,0,0,13,0,13
2013,Yemen,YEM,Belgium,BEL,0,0,5,0,5
2013,Stateless,XXA,Belgium,BEL,0,5,14,0,19
2013,Central African Rep.,CAF,Benin,BEN,12,0,0,5,17
2013,Chad,TCD,Benin,BEN,0,0,0,5,5
2013,Congo,COG,Benin,BEN,0,0,0,5,5
2013,Dem. Rep. of the Congo,COD,Benin,BEN,5,0,0,21,26
2013,Cote d'Ivoire,CIV,Benin,BEN,73,0,0,5,78
2013,Sri Lanka,LKA,Benin,BEN,5,0,0,0,5
2013,Mali,MLI,Benin,BEN,5,0,0,0,5
2013,Nigeria,NGA,Benin,BEN,0,0,5,0,5
2013,Pakistan,PAK,Benin,BEN,5,0,0,0,5
2013,Rwanda,RWA,Benin,BEN,0,0,0,5,5
2013,Central African Rep.,CAF,Burkina Faso,BFA,11,5,0,0,16
2013,Chad,TCD,Burkina Faso,BFA,0,5,0,0,5
2013,Afghanistan,AFG,Belarus,BLR,5,0,49,15,69
2013,Egypt,EGY,Belarus,BLR,0,5,0,5,10
2013,Armenia,ARM,Belarus,BLR,0,0,11,0,11
2013,Georgia,GEO,Belarus,BLR,0,0,16,5,21
2013,Iraq,IRQ,Belarus,BLR,0,0,0,5,5
2013,Pakistan,PAK,Belarus,BLR,0,0,5,0,5
2013,Russian Federation,RUS,Belarus,BLR,0,0,5,5,10
2013,Syrian Arab Rep.,SYR,Belarus,BLR,10,25,0,14,49
2013,Ukraine,UKR,Belarus,BLR,0,0,5,0,5
2013,Colombia,COL,Bolivia (Plurinational State of),BOL,5,0,5,5,15
2013,Syrian Arab Rep.,SYR,Bolivia (Plurinational State of),BOL,5,0,0,0,5
2013,Burundi,BDI,Botswana,BWA,0,0,5,0,5
2013,Dem. Rep. of the Congo,COD,Botswana,BWA,5,0,37,0,42
2013,Ethiopia,ETH,Botswana,BWA,0,0,5,0,5
2013,Somalia,SOM,Botswana,BWA,0,0,55,0,55
2013,Sudan,SDN,Botswana,BWA,0,0,5,0,5
2013,Uganda,UGA,Botswana,BWA,0,0,5,0,5
2013,Zimbabwe,ZWE,Botswana,BWA,5,0,20,0,25
2013,Afghanistan,AFG,Brazil,BRA,0,0,0,5,5
2013,Angola,AGO,Brazil,BRA,19,0,26,0,45
2013,Benin,BEN,Brazil,BRA,0,0,5,0,5
2013,Bangladesh,BGD,Brazil,BRA,0,0,100,10,110
2013,Bhutan,BTN,Brazil,BRA,10,0,0,0,10
2013,Burkina Faso,BFA,Brazil,BRA,0,0,11,0,11
2013,Bolivia (Plurinational State of),BOL,Brazil,BRA,17,0,0,0,17
2013,China,CHN,Brazil,BRA,0,0,0,5,5
2013,Cameroon,CMR,Brazil,BRA,0,0,11,0,11
2013,Dem. Rep. of the Congo,COD,Brazil,BRA,107,0,18,5,130
2013,Colombia,COL,Brazil,BRA,93,0,24,124,241
2013,Cuba,CUB,Brazil,BRA,0,0,5,14,19
2013,Dominican Rep.,DOM,Brazil,BRA,0,0,0,5,5
2013,Eritrea,ERI,Brazil,BRA,5,0,0,14,19
2013,Ghana,GHA,Brazil,BRA,5,0,18,5,28
2013,Guinea-Bissau,GNB,Brazil,BRA,0,0,94,5,99
2013,Guinea,GIN,Brazil,BRA,5,0,14,0,19
2013,Cote d'Ivoire,CIV,Brazil,BRA,0,0,11,0,11
2013,India,IND,Brazil,BRA,0,0,0,5,5
2013,Iran (Islamic Rep. of),IRN,Brazil,BRA,5,0,0,5,10
2013,Iraq,IRQ,Brazil,BRA,5,0,0,5,10
2013,Lebanon,LBN,Brazil,BRA,0,0,12,0,12
2013,Mali,MLI,Brazil,BRA,19,0,0,0,19
2013,Nepal,NPL,Brazil,BRA,0,0,13,0,13
2013,Nigeria,NGA,Brazil,BRA,18,0,37,11,66
2013,Pakistan,PAK,Brazil,BRA,32,0,10,10,52
2013,Paraguay,PRY,Brazil,BRA,0,0,0,5,5
2013,Peru,PER,Brazil,BRA,0,0,0,5,5
2013,Senegal,SEN,Brazil,BRA,5,0,151,10,166
2013,Sierra Leone,SLE,Brazil,BRA,5,0,0,0,5
2013,Somalia,SOM,Brazil,BRA,5,0,0,39,44
2013,Sudan,SDN,Brazil,BRA,5,0,0,0,5
2013,Syrian Arab Rep.,SYR,Brazil,BRA,289,0,0,5,294
2013,Togo,TGO,Brazil,BRA,0,0,5,0,5
2013,Turkey,TUR,Brazil,BRA,0,0,5,0,5
2013,Venezuela (Bolivarian Republic of),VEN,Brazil,BRA,5,0,0,0,5
2013,Algeria,DZA,Bosnia and Herzegovina,BIH,0,0,0,5,5
2013,Bangladesh,BGD,Bosnia and Herzegovina,BIH,0,0,0,5,5
2013,Palestinian,PSE,Bosnia and Herzegovina,BIH,0,0,5,0,5
2013,Serbia and Kosovo: S/RES/1244 (1999),SRB,Bosnia and Herzegovina,BIH,0,0,5,5,10
2013,Syrian Arab Rep.,SYR,Bosnia and Herzegovina,BIH,0,43,0,24,67
2013,Afghanistan,AFG,Bulgaria,BGR,0,5,38,54,97
2013,Algeria,DZA,Bulgaria,BGR,0,0,12,407,419
2013,Egypt,EGY,Bulgaria,BGR,0,5,0,11,16
2013,Armenia,ARM,Bulgaria,BGR,0,0,13,0,13
2013,Cameroon,CMR,Bulgaria,BGR,0,0,13,43,56
2013,Congo,COG,Bulgaria,BGR,0,0,0,11,11
2013,Dem. Rep. of the Congo,COD,Bulgaria,BGR,0,0,11,5,16
2013,Eritrea,ERI,Bulgaria,BGR,0,0,0,13,13
2013,Gambia,GMB,Bulgaria,BGR,0,0,5,5,10
2013,Georgia,GEO,Bulgaria,BGR,0,0,0,5,5
2013,Ghana,GHA,Bulgaria,BGR,0,0,5,15,20
2013,Guinea,GIN,Bulgaria,BGR,0,0,5,0,5
2013,Cote d'Ivoire,CIV,Bulgaria,BGR,0,0,23,25,48
2013,Iran (Islamic Rep. of),IRN,Bulgaria,BGR,0,0,14,17,31
2013,Iraq,IRQ,Bulgaria,BGR,21,53,95,179,348
2013,Jordan,JOR,Bulgaria,BGR,0,5,0,0,5
2013,Libya,LBY,Bulgaria,BGR,0,0,0,5,5
2013,Lebanon,LBN,Bulgaria,BGR,0,13,0,0,13
2013,Sri Lanka,LKA,Bulgaria,BGR,0,0,0,5,5
2013,Mali,MLI,Bulgaria,BGR,0,0,27,58,85
2013,Morocco,MAR,Bulgaria,BGR,0,0,0,86,86
2013,Myanmar,MMR,Bulgaria,BGR,0,0,5,0,5
2013,Nigeria,NGA,Bulgaria,BGR,0,0,5,5,10
2013,Pakistan,PAK,Bulgaria,BGR,0,0,10,10,20
2013,Russian Federation,RUS,Bulgaria,BGR,0,0,5,0,5
2013,Rwanda,RWA,Bulgaria,BGR,0,0,11,27,38
2013,Somalia,SOM,Bulgaria,BGR,11,5,5,16,37
2013,Sudan,SDN,Bulgaria,BGR,0,5,10,10,25
2013,Syrian Arab Rep.,SYR,Bulgaria,BGR,149,1862,10,365,2386
2013,United Rep. of Tanzania,TZA,Bulgaria,BGR,0,0,5,0,5
2013,Togo,TGO,Bulgaria,BGR,0,0,0,5,5
2013,Tunisia,TUN,Bulgaria,BGR,0,0,0,37,37
2013,Turkey,TUR,Bulgaria,BGR,0,0,0,5,5
2013,Ukraine,UKR,Bulgaria,BGR,0,0,5,0,5
2013,Yemen,YEM,Bulgaria,BGR,0,0,0,5,5
2013,Stateless,XXA,Bulgaria,BGR,0,325,18,76,419
2013,Syrian Arab Rep.,SYR,Belize,BLZ,0,0,0,5,5
2013,Sri Lanka,LKA,Cambodia,KHM,0,0,0,5,5
2013,Myanmar,MMR,Cambodia,KHM,13,0,0,0,13
2013,Afghanistan,AFG,Canada,CAN,275,0,67,43,385
2013,Albania,ALB,Canada,CAN,107,0,145,20,272
2013,Algeria,DZA,Canada,CAN,65,0,128,22,215
2013,Angola,AGO,Canada,CAN,5,0,16,5,26
2013,Antigua and Barbuda,ATG,Canada,CAN,11,0,10,0,21
2013,Egypt,EGY,Canada,CAN,248,0,23,5,276
2013,Argentina,ARG,Canada,CAN,0,0,13,0,13
2013,Armenia,ARM,Canada,CAN,10,0,10,0,20
2013,Austria,AUT,Canada,CAN,0,0,0,5,5
2013,Azerbaijan,AZE,Canada,CAN,19,0,5,5,29
2013,Bahrain,BHR,Canada,CAN,10,0,0,0,10
2013,Barbados,BRB,Canada,CAN,17,0,14,5,36
2013,Burundi,BDI,Canada,CAN,140,0,78,5,223
2013,Belgium,BEL,Canada,CAN,0,0,11,5,16
2013,Benin,BEN,Canada,CAN,5,0,24,0,29
2013,Bermuda,BMU,Canada,CAN,0,0,5,0,5
2013,Bangladesh,BGD,Canada,CAN,54,0,76,10,140
2013,Bahamas,BHS,Canada,CAN,12,0,13,0,25
2013,Burkina Faso,BFA,Canada,CAN,13,0,11,0,24
2013,Belarus,BLR,Canada,CAN,12,0,5,0,17
2013,Bolivia (Plurinational State of),BOL,Canada,CAN,0,0,10,0,10
2013,Botswana,BWA,Canada,CAN,11,0,24,5,40
2013,Brazil,BRA,Canada,CAN,13,0,23,22,58
2013,Bosnia and Herzegovina,BIH,Canada,CAN,0,0,31,10,41
2013,Bulgaria,BGR,Canada,CAN,22,0,13,0,35
2013,Cambodia,KHM,Canada,CAN,5,0,23,5,33
2013,Central African Rep.,CAF,Canada,CAN,12,0,0,0,12
2013,Chad,TCD,Canada,CAN,10,0,5,0,15
2013,China,CHN,Canada,CAN,536,0,791,257,1584
2013,Chile,CHL,Canada,CAN,0,0,15,5,20
2013,Cameroon,CMR,Canada,CAN,71,0,58,5,134
2013,Congo,COG,Canada,CAN,12,0,19,0,31
2013,Dem. Rep. of the Congo,COD,Canada,CAN,211,0,173,44,428
2013,Colombia,COL,Canada,CAN,386,0,579,64,1029
2013,Costa Rica,CRI,Canada,CAN,5,0,11,0,16
2013,Cuba,CUB,Canada,CAN,102,0,57,28,187
2013,Czechia,CZE,Canada,CAN,25,0,79,22,126
2013,Djibouti,DJI,Canada,CAN,53,0,31,10,94
2013,Dominica,DMA,Canada,CAN,0,0,0,5,5
2013,Dominican Rep.,DOM,Canada,CAN,11,0,32,16,59
2013,Ecuador,ECU,Canada,CAN,0,0,16,5,21
2013,Equatorial Guinea,GNQ,Canada,CAN,5,0,0,0,5
2013,Eritrea,ERI,Canada,CAN,158,0,32,11,201
2013,Estonia,EST,Canada,CAN,0,0,5,13,18
2013,Ethiopia,ETH,Canada,CAN,75,0,45,5,125
2013,Fiji,FJI,Canada,CAN,5,0,11,5,21
2013,Finland,FIN,Canada,CAN,0,0,0,5,5
2013,France,FRA,Canada,CAN,0,0,17,10,27
2013,Gabon,GAB,Canada,CAN,5,0,0,5,10
2013,Gambia,GMB,Canada,CAN,15,0,10,0,25
2013,Palestinian,PSE,Canada,CAN,17,0,10,5,32
2013,United Kingdom of Great Britain and Northern Ireland,GBR,Canada,CAN,0,0,0,11,11
2013,Georgia,GEO,Canada,CAN,22,0,31,5,58
2013,Germany,DEU,Canada,CAN,0,0,5,5,10
2013,Ghana,GHA,Canada,CAN,25,0,41,5,71
2013,Guinea-Bissau,GNB,Canada,CAN,0,0,5,0,5
2013,Greece,GRC,Canada,CAN,5,0,34,22,61
2013,Grenada,GRD,Canada,CAN,5,0,15,0,20
2013,Guatemala,GTM,Canada,CAN,40,0,149,23,212
2013,Guinea,GIN,Canada,CAN,32,0,54,5,91
2013,Guyana,GUY,Canada,CAN,5,0,21,0,26
2013,Haiti,HTI,Canada,CAN,216,0,301,22,539
2013,"China, Hong Kong SAR",HKG,Canada,CAN,0,0,12,17,29
2013,Honduras,HND,Canada,CAN,116,0,156,42,314
2013,Croatia,HRV,Canada,CAN,51,0,318,82,451
2013,Hungary,HUN,Canada,CAN,406,0,1101,477,1984
2013,Cote d'Ivoire,CIV,Canada,CAN,29,0,20,10,59
2013,India,IND,Canada,CAN,75,0,304,114,493
2013,Indonesia,IDN,Canada,CAN,15,0,14,0,29
2013,Iran (Islamic Rep. of),IRN,Canada,CAN,227,0,60,15,302
2013,Iraq,IRQ,Canada,CAN,113,0,40,26,179
2013,Israel,ISR,Canada,CAN,12,0,85,64,161
2013,Italy,ITA,Canada,CAN,0,0,29,10,39
2013,Jamaica,JAM,Canada,CAN,86,0,111,31,228
2013,Jordan,JOR,Canada,CAN,42,0,39,10,91
2013,Japan,JPN,Canada,CAN,0,0,14,0,14
2013,Kazakhstan,KAZ,Canada,CAN,16,0,15,5,36
2013,Kenya,KEN,Canada,CAN,23,0,20,0,43
2013,Kyrgyzstan,KGZ,Canada,CAN,0,0,12,0,12
2013,Rep. of Korea,KOR,Canada,CAN,5,0,37,22,64
2013,Dem. People's Rep. of Korea,PRK,Canada,CAN,21,0,86,150,257
2013,Kuwait,KWT,Canada,CAN,14,0,0,0,14
2013,Lao People's Dem. Rep.,LAO,Canada,CAN,5,0,0,0,5
2013,Liberia,LBR,Canada,CAN,0,0,13,0,13
2013,Libya,LBY,Canada,CAN,24,0,37,0,61
2013,Saint Lucia,LCA,Canada,CAN,148,0,164,19,331
2013,Lebanon,LBN,Canada,CAN,65,0,69,10,144
2013,Sri Lanka,LKA,Canada,CAN,286,0,253,21,560
2013,Lithuania,LTU,Canada,CAN,5,0,13,13,31
2013,Latvia,LVA,Canada,CAN,11,0,26,17,54
2013,Mauritania,MRT,Canada,CAN,15,0,10,5,30
2013,North Macedonia,MKD,Canada,CAN,0,0,16,5,21
2013,Rep. of Moldova,MDA,Canada,CAN,14,0,5,5,24
2013,Mexico,MEX,Canada,CAN,182,0,683,148,1013
2013,Mali,MLI,Canada,CAN,13,0,16,5,34
2013,Malaysia,MYS,Canada,CAN,0,0,12,5,17
2013,Mongolia,MNG,Canada,CAN,15,0,5,0,20
2013,Morocco,MAR,Canada,CAN,20,0,24,10,54
2013,Montenegro,MNE,Canada,CAN,5,0,0,0,5
2013,Myanmar,MMR,Canada,CAN,5,0,0,0,5
2013,Namibia,NAM,Canada,CAN,79,0,210,21,310
2013,Nepal,NPL,Canada,CAN,20,0,15,0,35
2013,Netherlands,NLD,Canada,CAN,0,0,16,5,21
2013,Niger,NER,Canada,CAN,0,0,5,5,10
2013,Nicaragua,NIC,Canada,CAN,15,0,27,5,47
2013,Nigeria,NGA,Canada,CAN,155,0,268,17,440
2013,Norway,NOR,Canada,CAN,0,0,0,5,5
2013,Pakistan,PAK,Canada,CAN,690,0,228,46,964
2013,Panama,PAN,Canada,CAN,5,0,11,0,16
2013,Paraguay,PRY,Canada,CAN,0,0,5,0,5
2013,Peru,PER,Canada,CAN,21,0,59,17,97
2013,Philippines,PHL,Canada,CAN,5,0,51,5,61
2013,Poland,POL,Canada,CAN,5,0,83,66,154
2013,Portugal,PRT,Canada,CAN,0,0,16,16,32
2013,Qatar,QAT,Canada,CAN,0,0,5,0,5
2013,Romania,ROU,Canada,CAN,40,0,53,118,211
2013,South Africa,ZAF,Canada,CAN,0,0,30,0,30
2013,Russian Federation,RUS,Canada,CAN,87,0,63,32,182
2013,Rwanda,RWA,Canada,CAN,40,0,47,5,92
2013,El Salvador,SLV,Canada,CAN,136,0,215,24,375
2013,Saudi Arabia,SAU,Canada,CAN,21,0,5,0,26
2013,Serbia and Kosovo: S/RES/1244 (1999),SRB,Canada,CAN,32,0,71,11,114
2013,Senegal,SEN,Canada,CAN,23,0,17,5,45
2013,Singapore,SGP,Canada,CAN,0,0,5,0,5
2013,Sierra Leone,SLE,Canada,CAN,0,0,5,0,5
2013,Somalia,SOM,Canada,CAN,198,0,56,84,338
2013,Spain,ESP,Canada,CAN,0,0,43,12,55
2013,Viet Nam,VNM,Canada,CAN,0,0,12,0,12
2013,Saint Kitts and Nevis,KNA,Canada,CAN,5,0,10,0,15
2013,Sudan,SDN,Canada,CAN,38,0,5,12,55
2013,Slovakia,SVK,Canada,CAN,16,0,135,52,203
2013,Eswatini,SWZ,Canada,CAN,14,0,13,5,32
2013,Sweden,SWE,Canada,CAN,0,0,5,11,16
2013,Switzerland,CHE,Canada,CAN,0,0,5,0,5
2013,Syrian Arab Rep.,SYR,Canada,CAN,440,0,35,14,489
2013,United Rep. of Tanzania,TZA,Canada,CAN,10,0,11,0,21
2013,Turks and Caicos Islands,TCA,Canada,CAN,0,0,5,0,5
2013,Thailand,THA,Canada,CAN,0,0,10,5,15
2013,Tajikistan,TJK,Canada,CAN,5,0,0,5,10
2013,Togo,TGO,Canada,CAN,10,0,5,0,15
2013,Trinidad and Tobago,TTO,Canada,CAN,10,0,16,5,31
2013,Tunisia,TUN,Canada,CAN,22,0,46,5,73
2013,Turkey,TUR,Canada,CAN,188,0,160,24,372
2013,Uganda,UGA,Canada,CAN,24,0,14,5,43
2013,Ukraine,UKR,Canada,CAN,55,0,57,22,134
2013,Uruguay,URY,Canada,CAN,0,0,14,5,19
2013,United States of America,USA,Canada,CAN,5,0,150,54,209
2013,Uzbekistan,UZB,Canada,CAN,14,0,14,0,28
2013,Saint Vincent and the Grenadines,VCT,Canada,CAN,105,0,202,26,333
2013,Venezuela (Bolivarian Republic of),VEN,Canada,CAN,36,0,55,12,103
2013,Yemen,YEM,Canada,CAN,22,0,5,0,27
2013,Zambia,ZMB,Canada,CAN,0,0,5,0,5
2013,Zimbabwe,ZWE,Canada,CAN,33,0,27,0,60
2013,Cuba,CUB,Cayman Islands,CYM,0,0,25,0,25
2013,Afghanistan,AFG,Chile,CHL,5,0,0,0,5
2013,Dem. Rep. of the Congo,COD,Chile,CHL,0,0,5,0,5
2013,Colombia,COL,Chile,CHL,26,10,115,5,156
2013,Palestinian,PSE,Chile,CHL,0,5,0,0,5
2013,Nepal,NPL,Chile,CHL,0,0,5,0,5
2013,Syrian Arab Rep.,SYR,Chile,CHL,5,0,0,0,5
2013,Angola,AGO,Dem. Rep. of the Congo,COD,558,0,0,0,558
2013,Burundi,BDI,Dem. Rep. of the Congo,COD,19,0,98,260,377
2013,Central African Rep.,CAF,Dem. Rep. of the Congo,COD,5,0,0,0,5
2013,Congo,COG,Dem. Rep. of the Congo,COD,11,0,21,82,114
2013,Gambia,GMB,Dem. Rep. of the Congo,COD,0,0,5,0,5
2013,Cote d'Ivoire,CIV,Dem. Rep. of the Congo,COD,0,0,5,0,5
2013,Liberia,LBR,Dem. Rep. of the Congo,COD,0,0,11,31,42
2013,Rwanda,RWA,Dem. Rep. of the Congo,COD,23,0,44,462,529
2013,Sierra Leone,SLE,Dem. Rep. of the Congo,COD,0,0,5,0,5
2013,Somalia,SOM,Dem. Rep. of the Congo,COD,5,0,5,0,10
2013,United Rep. of Tanzania,TZA,Dem. Rep. of the Congo,COD,0,0,0,5,5
2013,Bangladesh,BGD,Colombia,COL,0,0,0,42,42
2013,Cuba,CUB,Colombia,COL,0,0,60,30,90
2013,Ecuador,ECU,Colombia,COL,5,0,0,0,5
2013,Ghana,GHA,Colombia,COL,0,0,0,10,10
2013,Honduras,HND,Colombia,COL,0,0,5,0,5
2013,Cote d'Ivoire,CIV,Colombia,COL,0,0,0,5,5
2013,Nepal,NPL,Colombia,COL,0,0,5,0,5
2013,Nigeria,NGA,Colombia,COL,0,0,0,5,5
2013,Somalia,SOM,Colombia,COL,0,0,10,37,47
2013,Syrian Arab Rep.,SYR,Colombia,COL,0,0,5,5,10
2013,Venezuela (Bolivarian Republic of),VEN,Colombia,COL,0,0,14,0,14
2013,Bangladesh,BGD,Costa Rica,CRI,0,0,10,0,10
2013,Colombia,COL,Costa Rica,CRI,32,0,567,70,669
2013,Cuba,CUB,Costa Rica,CRI,24,0,153,10,187
2013,Ecuador,ECU,Costa Rica,CRI,0,0,5,0,5
2013,Ghana,GHA,Costa Rica,CRI,0,0,5,0,5
2013,Guatemala,GTM,Costa Rica,CRI,5,0,28,0,33
2013,Honduras,HND,Costa Rica,CRI,13,0,17,0,30
2013,Iran (Islamic Rep. of),IRN,Costa Rica,CRI,0,0,0,5,5
2013,Nicaragua,NIC,Costa Rica,CRI,0,0,5,0,5
2013,Nigeria,NGA,Costa Rica,CRI,11,0,0,0,11
2013,El Salvador,SLV,Costa Rica,CRI,31,0,131,0,162
2013,Venezuela (Bolivarian Republic of),VEN,Costa Rica,CRI,0,0,22,0,22
2013,Afghanistan,AFG,Cyprus,CYP,0,0,27,10,37
2013,Algeria,DZA,Cyprus,CYP,0,0,5,0,5
2013,Egypt,EGY,Cyprus,CYP,0,0,85,45,130
2013,Armenia,ARM,Cyprus,CYP,0,0,5,0,5
2013,Bangladesh,BGD,Cyprus,CYP,0,0,85,15,100
2013,Bosnia and Herzegovina,BIH,Cyprus,CYP,0,0,0,5,5
2013,China,CHN,Cyprus,CYP,0,0,5,0,5
2013,Cameroon,CMR,Cyprus,CYP,0,0,0,11,11
2013,Dem. Rep. of the Congo,COD,Cyprus,CYP,0,0,10,0,10
2013,Comoros,COM,Cyprus,CYP,0,5,0,0,5
2013,Palestinian,PSE,Cyprus,CYP,5,5,17,16,43
2013,Guinea,GIN,Cyprus,CYP,0,0,5,0,5
2013,India,IND,Cyprus,CYP,0,0,24,10,34
2013,Indonesia,IDN,Cyprus,CYP,0,0,0,5,5
2013,Iran (Islamic Rep. of),IRN,Cyprus,CYP,5,0,31,35,71
2013,Iraq,IRQ,Cyprus,CYP,5,0,11,0,16
2013,Jordan,JOR,Cyprus,CYP,0,0,14,0,14
2013,Kazakhstan,KAZ,Cyprus,CYP,0,0,5,0,5
2013,Lebanon,LBN,Cyprus,CYP,0,0,10,0,10
2013,Sri Lanka,LKA,Cyprus,CYP,0,0,59,5,64
2013,Rep. of Moldova,MDA,Cyprus,CYP,5,0,0,0,5
2013,Mali,MLI,Cyprus,CYP,0,0,5,0,5
2013,Morocco,MAR,Cyprus,CYP,0,0,5,0,5
2013,Nepal,NPL,Cyprus,CYP,0,0,0,5,5
2013,Pakistan,PAK,Cyprus,CYP,0,0,15,5,20
2013,Philippines,PHL,Cyprus,CYP,0,0,23,5,28
2013,Russian Federation,RUS,Cyprus,CYP,0,0,0,12,12
2013,Sierra Leone,SLE,Cyprus,CYP,5,0,0,0,5
2013,Somalia,SOM,Cyprus,CYP,0,0,5,0,5
2013,Viet Nam,VNM,Cyprus,CYP,0,0,78,5,83
2013,Syrian Arab Rep.,SYR,Cyprus,CYP,0,123,71,139,333
2013,Turkey,TUR,Cyprus,CYP,0,0,56,5,61
2013,Uzbekistan,UZB,Cyprus,CYP,0,0,5,0,5
2013,Afghanistan,AFG,Czechia,CZE,0,13,0,0,13
2013,Algeria,DZA,Czechia,CZE,0,0,0,12,12
2013,Armenia,ARM,Czechia,CZE,5,0,22,14,41
2013,Azerbaijan,AZE,Czechia,CZE,5,0,0,0,5
2013,Belarus,BLR,Czechia,CZE,10,67,0,21,98
2013,Bosnia and Herzegovina,BIH,Czechia,CZE,0,0,5,0,5
2013,China,CHN,Czechia,CZE,0,0,5,5,10
2013,Cameroon,CMR,Czechia,CZE,0,0,0,5,5
2013,Dem. Rep. of the Congo,COD,Czechia,CZE,0,0,0,5,5
2013,Cuba,CUB,Czechia,CZE,5,29,0,13,47
2013,Ecuador,ECU,Czechia,CZE,5,0,0,0,5
2013,Georgia,GEO,Czechia,CZE,5,0,10,5,20
2013,Guinea,GIN,Czechia,CZE,0,0,0,5,5
2013,Iran (Islamic Rep. of),IRN,Czechia,CZE,0,0,5,0,5
2013,Iraq,IRQ,Czechia,CZE,0,13,0,5,18
2013,Kazakhstan,KAZ,Czechia,CZE,0,5,10,11,26
2013,Kyrgyzstan,KGZ,Czechia,CZE,0,0,18,17,35
2013,Libya,LBY,Czechia,CZE,0,5,0,5,10
2013,Rep. of Moldova,MDA,Czechia,CZE,0,0,10,0,10
2013,Mongolia,MNG,Czechia,CZE,0,0,10,10,20
2013,Myanmar,MMR,Czechia,CZE,29,0,0,0,29
2013,Nigeria,NGA,Czechia,CZE,0,0,0,10,10
2013,Pakistan,PAK,Czechia,CZE,0,0,5,5,10
2013,Romania,ROU,Czechia,CZE,0,0,0,5,5
2013,Russian Federation,RUS,Czechia,CZE,12,5,35,26,78
2013,Serbia and Kosovo: S/RES/1244 (1999),SRB,Czechia,CZE,0,0,12,10,22
2013,Viet Nam,VNM,Czechia,CZE,0,0,49,15,64
2013,Slovakia,SVK,Czechia,CZE,0,0,0,10,10
2013,Syrian Arab Rep.,SYR,Czechia,CZE,5,98,0,10,113
2013,Tunisia,TUN,Czechia,CZE,0,0,0,5,5
2013,Turkey,TUR,Czechia,CZE,0,0,14,5,19
2013,Uganda,UGA,Czechia,CZE,5,0,0,0,5
2013,Ukraine,UKR,Czechia,CZE,10,0,92,69,171
2013,Uzbekistan,UZB,Czechia,CZE,5,5,0,0,10
2013,Stateless,XXA,Czechia,CZE,0,11,0,10,21
2013,Afghanistan,AFG,Denmark,DNK,18,164,254,0,436
2013,Albania,ALB,Denmark,DNK,0,0,43,0,43
2013,Algeria,DZA,Denmark,DNK,0,0,24,0,24
2013,Armenia,ARM,Denmark,DNK,0,0,56,0,56
2013,Azerbaijan,AZE,Denmark,DNK,11,0,5,0,16
2013,Bangladesh,BGD,Denmark,DNK,0,0,38,0,38
2013,Belarus,BLR,Denmark,DNK,0,0,15,0,15
2013,Bosnia and Herzegovina,BIH,Denmark,DNK,0,0,14,0,14
2013,Bulgaria,BGR,Denmark,DNK,0,0,15,0,15
2013,China,CHN,Denmark,DNK,0,0,28,0,28
2013,Cameroon,CMR,Denmark,DNK,5,0,0,0,5
2013,Dem. Rep. of the Congo,COD,Denmark,DNK,0,13,26,0,39
2013,Eritrea,ERI,Denmark,DNK,33,16,10,0,59
2013,Ethiopia,ETH,Denmark,DNK,0,0,5,0,5
2013,Georgia,GEO,Denmark,DNK,0,0,18,0,18
2013,Ghana,GHA,Denmark,DNK,0,0,15,0,15
2013,Greece,GRC,Denmark,DNK,0,0,5,0,5
2013,Croatia,HRV,Denmark,DNK,0,0,5,0,5
2013,India,IND,Denmark,DNK,0,0,20,0,20
2013,Iran (Islamic Rep. of),IRN,Denmark,DNK,269,30,108,0,407
2013,Iraq,IRQ,Denmark,DNK,5,5,50,0,60
2013,Jordan,JOR,Denmark,DNK,0,0,14,0,14
2013,Kenya,KEN,Denmark,DNK,0,0,5,0,5
2013,Kuwait,KWT,Denmark,DNK,0,0,5,0,5
2013,Libya,LBY,Denmark,DNK,0,0,11,0,11
2013,Lebanon,LBN,Denmark,DNK,0,0,10,0,10
2013,Sri Lanka,LKA,Denmark,DNK,5,0,11,0,16
2013,Mauritania,MRT,Denmark,DNK,0,0,5,0,5
2013,North Macedonia,MKD,Denmark,DNK,0,0,16,0,16
2013,Morocco,MAR,Denmark,DNK,0,0,26,0,26
2013,Montenegro,MNE,Denmark,DNK,0,0,10,0,10
2013,Myanmar,MMR,Denmark,DNK,0,0,21,0,21
2013,Nepal,NPL,Denmark,DNK,0,0,5,0,5
2013,Nigeria,NGA,Denmark,DNK,0,0,57,0,57
2013,Pakistan,PAK,Denmark,DNK,10,0,46,0,56
2013,Poland,POL,Denmark,DNK,0,0,5,0,5
2013,Romania,ROU,Denmark,DNK,0,0,5,0,5
2013,Russian Federation,RUS,Denmark,DNK,56,139,219,0,414
2013,Serbia and Kosovo: S/RES/1244 (1999),SRB,Denmark,DNK,0,0,488,0,488
2013,Somalia,SOM,Denmark,DNK,5,375,279,0,659
2013,Viet Nam,VNM,Denmark,DNK,0,0,5,0,5
2013,Sudan,SDN,Denmark,DNK,5,0,21,0,26
2013,Syrian Arab Rep.,SYR,Denmark,DNK,1005,291,56,0,1352
2013,Tunisia,TUN,Denmark,DNK,0,0,18,0,18
2013,Turkey,TUR,Denmark,DNK,0,0,10,0,10
2013,Uganda,UGA,Denmark,DNK,11,0,10,0,21
2013,Ukraine,UKR,Denmark,DNK,5,0,21,0,26
2013,United States of America,USA,Denmark,DNK,0,0,5,0,5
2013,Yemen,YEM,Denmark,DNK,0,0,5,0,5
2013,Zambia,ZMB,Denmark,DNK,0,0,5,0,5
2013,Stateless,XXA,Denmark,DNK,154,94,78,0,326
2013,Eritrea,ERI,Djibouti,DJI,81,0,0,0,81
2013,Colombia,COL,Dominican Rep.,DOM,0,0,5,0,5
2013,Cuba,CUB,Dominican Rep.,DOM,0,0,11,0,11
2013,Haiti,HTI,Dominican Rep.,DOM,5,0,263,0,268
2013,Sri Lanka,LKA,Dominican Rep.,DOM,0,0,22,0,22
2013,Albania,ALB,Estonia,EST,0,0,5,0,5
2013,Georgia,GEO,Estonia,EST,0,0,0,10,10
2013,Iran (Islamic Rep. of),IRN,Estonia,EST,0,0,0,5,5
2013,Pakistan,PAK,Estonia,EST,0,0,0,5,5
2013,Russian Federation,RUS,Estonia,EST,0,0,13,0,13
2013,Viet Nam,VNM,Estonia,EST,0,0,19,5,24
2013,Syrian Arab Rep.,SYR,Estonia,EST,0,0,5,0,5
2013,Afghanistan,AFG,Finland,FIN,53,184,60,53,350
2013,Albania,ALB,Finland,FIN,0,0,24,17,41
2013,Algeria,DZA,Finland,FIN,0,0,14,55,69
2013,Angola,AGO,Finland,FIN,0,15,14,11,40
2013,Egypt,EGY,Finland,FIN,0,0,5,0,5
2013,Armenia,ARM,Finland,FIN,0,0,5,0,5
2013,Azerbaijan,AZE,Finland,FIN,5,0,5,5,15
2013,Bangladesh,BGD,Finland,FIN,0,5,10,5,20
2013,Belarus,BLR,Finland,FIN,0,0,18,27,45
2013,Bosnia and Herzegovina,BIH,Finland,FIN,0,0,14,5,19
2013,Bulgaria,BGR,Finland,FIN,0,0,5,0,5
2013,China,CHN,Finland,FIN,13,0,5,0,18
2013,Cameroon,CMR,Finland,FIN,0,14,11,5,30
2013,Congo,COG,Finland,FIN,0,0,5,0,5
2013,Dem. Rep. of the Congo,COD,Finland,FIN,5,19,17,5,46
2013,Colombia,COL,Finland,FIN,0,0,0,5,5
2013,Cuba,CUB,Finland,FIN,0,0,5,5,10
2013,Eritrea,ERI,Finland,FIN,5,0,0,0,5
2013,Ethiopia,ETH,Finland,FIN,15,5,13,5,38
2013,Gambia,GMB,Finland,FIN,0,0,20,34,54
2013,Georgia,GEO,Finland,FIN,0,5,0,10,15
2013,Ghana,GHA,Finland,FIN,5,5,22,28,60
2013,Guinea,GIN,Finland,FIN,5,0,5,14,24
2013,Cote d'Ivoire,CIV,Finland,FIN,0,0,0,12,12
2013,India,IND,Finland,FIN,0,0,5,5,10
2013,Iran (Islamic Rep. of),IRN,Finland,FIN,71,46,42,72,231
2013,Iraq,IRQ,Finland,FIN,200,472,103,334,1109
2013,Jordan,JOR,Finland,FIN,0,0,0,5,5
2013,Kazakhstan,KAZ,Finland,FIN,0,0,0,5,5
2013,Kenya,KEN,Finland,FIN,0,5,14,0,19
2013,Kyrgyzstan,KGZ,Finland,FIN,0,14,0,0,14
2013,Libya,LBY,Finland,FIN,0,0,0,21,21
2013,Lebanon,LBN,Finland,FIN,0,0,0,5,5
2013,Sri Lanka,LKA,Finland,FIN,0,0,17,5,22
2013,Mauritania,MRT,Finland,FIN,0,0,0,5,5
2013,North Macedonia,MKD,Finland,FIN,0,0,18,5,23
2013,Rep. of Moldova,MDA,Finland,FIN,0,5,0,0,5
2013,Mexico,MEX,Finland,FIN,0,0,5,0,5
2013,Mali,MLI,Finland,FIN,0,0,14,5,19
2013,Morocco,MAR,Finland,FIN,0,0,16,70,86
2013,Montenegro,MNE,Finland,FIN,0,0,5,0,5
2013,Niger,NER,Finland,FIN,0,0,0,5,5
2013,Nigeria,NGA,Finland,FIN,5,22,60,105,192
2013,Pakistan,PAK,Finland,FIN,10,5,12,15,42
2013,Philippines,PHL,Finland,FIN,0,0,5,0,5
2013,Romania,ROU,Finland,FIN,0,0,5,0,5
2013,South Africa,ZAF,Finland,FIN,0,0,0,5,5
2013,Russian Federation,RUS,Finland,FIN,50,38,166,67,321
2013,Rwanda,RWA,Finland,FIN,5,0,5,0,10
2013,Serbia and Kosovo: S/RES/1244 (1999),SRB,Finland,FIN,0,18,95,21,134
2013,Senegal,SEN,Finland,FIN,0,0,5,12,17
2013,Singapore,SGP,Finland,FIN,0,0,0,5,5
2013,Sierra Leone,SLE,Finland,FIN,0,0,5,0,5
2013,Somalia,SOM,Finland,FIN,11,239,5,62,317
2013,Viet Nam,VNM,Finland,FIN,0,0,0,5,5
2013,Sudan,SDN,Finland,FIN,12,0,0,0,12
2013,Syrian Arab Rep.,SYR,Finland,FIN,67,78,0,37,182
2013,United Rep. of Tanzania,TZA,Finland,FIN,0,5,5,0,10
2013,Tajikistan,TJK,Finland,FIN,0,0,0,5,5
2013,Togo,TGO,Finland,FIN,0,5,0,5,10
2013,Tunisia,TUN,Finland,FIN,0,0,5,21,26
2013,Turkey,TUR,Finland,FIN,5,34,28,15,82
2013,Uganda,UGA,Finland,FIN,5,0,0,0,5
2013,Ukraine,UKR,Finland,FIN,0,0,13,5,18
2013,United States of America,USA,Finland,FIN,0,0,0,5,5
2013,Uzbekistan,UZB,Finland,FIN,0,0,5,0,5
2013,Yemen,YEM,Finland,FIN,0,0,0,5,5
2013,Zambia,ZMB,Finland,FIN,0,0,5,0,5
2013,Stateless,XXA,Finland,FIN,16,0,5,18,39
2013,Afghanistan,AFG,France,FRA,194,268,250,0,712
2013,Albania,ALB,France,FRA,20,67,2045,0,2132
2013,Algeria,DZA,France,FRA,41,14,1052,0,1107
2013,Angola,AGO,France,FRA,34,5,498,0,537
2013,Egypt,EGY,France,FRA,48,0,258,0,306
2013,Armenia,ARM,France,FRA,86,38,2186,0,2310
2013,Azerbaijan,AZE,France,FRA,120,0,445,0,565
2013,Burundi,BDI,France,FRA,13,0,18,0,31
2013,Bangladesh,BGD,France,FRA,106,5,3385,0,3496
2013,Bhutan,BTN,France,FRA,0,0,22,0,22
2013,Burkina Faso,BFA,France,FRA,5,5,18,0,28
2013,Belarus,BLR,France,FRA,13,0,77,0,90
2013,Brazil,BRA,France,FRA,0,0,10,0,10
2013,Bosnia and Herzegovina,BIH,France,FRA,31,0,554,0,585
2013,Central African Rep.,CAF,France,FRA,14,0,37,0,51
2013,Chad,TCD,France,FRA,19,0,260,0,279
2013,China,CHN,France,FRA,268,0,1839,0,2107
2013,Cameroon,CMR,France,FRA,23,5,136,0,164
2013,Congo,COG,France,FRA,25,5,426,0,456
2013,Dem. Rep. of the Congo,COD,France,FRA,433,28,2820,0,3281
2013,Comoros,COM,France,FRA,33,0,439,0,472
2013,Colombia,COL,France,FRA,5,0,59,0,64
2013,Cuba,CUB,France,FRA,14,0,5,0,19
2013,Cabo Verde,CPV,France,FRA,0,0,10,0,10
2013,Djibouti,DJI,France,FRA,13,0,5,0,18
2013,Dominica,DMA,France,FRA,0,0,5,0,5
2013,Dominican Rep.,DOM,France,FRA,0,5,158,0,163
2013,Eritrea,ERI,France,FRA,47,0,284,0,331
2013,Ethiopia,ETH,France,FRA,20,0,59,0,79
2013,Gabon,GAB,France,FRA,0,5,5,0,10
2013,Gambia,GMB,France,FRA,15,0,60,0,75
2013,Palestinian,PSE,France,FRA,46,5,30,0,81
2013,Georgia,GEO,France,FRA,39,11,1519,0,1569
2013,Ghana,GHA,France,FRA,0,0,16,0,16
2013,Guinea-Bissau,GNB,France,FRA,16,0,125,0,141
2013,Guinea,GIN,France,FRA,314,16,1407,0,1737
2013,Guyana,GUY,France,FRA,0,0,34,0,34
2013,Haiti,HTI,France,FRA,24,21,1630,0,1675
2013,Cote d'Ivoire,CIV,France,FRA,152,16,840,0,1008
2013,India,IND,France,FRA,5,0,26,0,31
2013,Iran (Islamic Rep. of),IRN,France,FRA,126,5,103,0,234
2013,Iraq,IRQ,France,FRA,62,0,30,0,92
2013,Kazakhstan,KAZ,France,FRA,11,5,110,0,126
2013,Kenya,KEN,France,FRA,5,0,17,0,22
2013,Kyrgyzstan,KGZ,France,FRA,10,0,45,0,55
2013,Libya,LBY,France,FRA,10,0,47,0,57
2013,Sri Lanka,LKA,France,FRA,385,22,2183,0,2590
2013,Mauritania,MRT,France,FRA,81,0,1140,0,1221
2013,North Macedonia,MKD,France,FRA,5,0,287,0,292
2013,Mali,MLI,France,FRA,275,10,893,0,1178
2013,Mongolia,MNG,France,FRA,5,5,163,0,173
2013,Morocco,MAR,France,FRA,18,5,82,0,105
2013,Montenegro,MNE,France,FRA,0,0,141,0,141
2013,Myanmar,MMR,France,FRA,21,0,376,0,397
2013,Nepal,NPL,France,FRA,10,0,106,0,116
2013,Nigeria,NGA,France,FRA,39,21,711,0,771
2013,Pakistan,PAK,France,FRA,55,5,1712,0,1772
2013,Peru,PER,France,FRA,0,0,80,0,80
2013,Philippines,PHL,France,FRA,0,0,5,0,5
2013,South Africa,ZAF,France,FRA,5,0,0,0,5
2013,Russian Federation,RUS,France,FRA,449,39,2208,0,2696
2013,Rwanda,RWA,France,FRA,58,0,101,0,159
2013,Serbia and Kosovo: S/RES/1244 (1999),SRB,France,FRA,67,28,3218,0,3313
2013,Senegal,SEN,France,FRA,60,10,207,0,277
2013,Sierra Leone,SLE,France,FRA,15,0,77,0,92
2013,Somalia,SOM,France,FRA,15,32,404,0,451
2013,Viet Nam,VNM,France,FRA,5,0,12,0,17
2013,Sudan,SDN,France,FRA,88,5,699,0,792
2013,Syrian Arab Rep.,SYR,France,FRA,474,361,46,0,881
2013,Thailand,THA,France,FRA,0,0,13,0,13
2013,Togo,TGO,France,FRA,12,0,61,0,73
2013,Tunisia,TUN,France,FRA,19,0,173,0,192
2013,Turkey,TUR,France,FRA,143,5,1612,0,1760
2013,Uganda,UGA,France,FRA,11,0,5,0,16
2013,Ukraine,UKR,France,FRA,12,0,97,0,109
2013,Uzbekistan,UZB,France,FRA,5,0,22,0,27
2013,Western Sahara,ESH,France,FRA,28,0,41,0,69
2013,Dem. Rep. of the Congo,COD,Gambia,GMB,10,0,0,0,10
2013,Cote d'Ivoire,CIV,Gambia,GMB,0,0,0,5,5
2013,Afghanistan,AFG,United Kingdom of Great Britain and Northern Ireland,GBR,298,142,557,325,1322
2013,Albania,ALB,United Kingdom of Great Britain and Northern Ireland,GBR,95,169,533,293,1090
2013,Algeria,DZA,United Kingdom of Great Britain and Northern Ireland,GBR,11,18,123,61,213
2013,Angola,AGO,United Kingdom of Great Britain and Northern Ireland,GBR,5,5,17,13,40
2013,Egypt,EGY,United Kingdom of Great Britain and Northern Ireland,GBR,66,5,180,25,276
2013,Armenia,ARM,United Kingdom of Great Britain and Northern Ireland,GBR,5,0,10,0,15
2013,Australia,AUS,United Kingdom of Great Britain and Northern Ireland,GBR,5,0,0,0,5
2013,Azerbaijan,AZE,United Kingdom of Great Britain and Northern Ireland,GBR,5,0,14,0,19
2013,Bahrain,BHR,United Kingdom of Great Britain and Northern Ireland,GBR,16,0,0,5,21
2013,Burundi,BDI,United Kingdom of Great Britain and Northern Ireland,GBR,0,5,5,0,10
2013,Benin,BEN,United Kingdom of Great Britain and Northern Ireland,GBR,0,0,10,0,10
2013,Bangladesh,BGD,United Kingdom of Great Britain and Northern Ireland,GBR,29,24,765,257,1075
2013,Bhutan,BTN,United Kingdom of Great Britain and Northern Ireland,GBR,5,0,0,0,5
2013,Burkina Faso,BFA,United Kingdom of Great Britain and Northern Ireland,GBR,5,0,0,0,5
2013,Belarus,BLR,United Kingdom of Great Britain and Northern Ireland,GBR,16,0,5,0,21
2013,Bolivia (Plurinational State of),BOL,United Kingdom of Great Britain and Northern Ireland,GBR,0,0,0,5,5
2013,Brazil,BRA,United Kingdom of Great Britain and Northern Ireland,GBR,0,5,12,5,22
2013,Bulgaria,BGR,United Kingdom of Great Britain and Northern Ireland,GBR,0,0,0,5,5
2013,Canada,CAN,United Kingdom of Great Britain and Northern Ireland,GBR,0,0,11,0,11
2013,Central African Rep.,CAF,United Kingdom of Great Britain and Northern Ireland,GBR,0,0,5,0,5
2013,Chad,TCD,United Kingdom of Great Britain and Northern Ireland,GBR,0,0,0,14,14
2013,China,CHN,United Kingdom of Great Britain and Northern Ireland,GBR,53,45,655,187,940
2013,Cameroon,CMR,United Kingdom of Great Britain and Northern Ireland,GBR,33,5,78,10,126
2013,Congo,COG,United Kingdom of Great Britain and Northern Ireland,GBR,5,0,20,0,25
2013,Dem. Rep. of the Congo,COD,United Kingdom of Great Britain and Northern Ireland,GBR,69,10,89,21,189
2013,Comoros,COM,United Kingdom of Great Britain and Northern Ireland,GBR,0,0,5,0,5
2013,Colombia,COL,United Kingdom of Great Britain and Northern Ireland,GBR,0,0,13,0,13
2013,Cabo Verde,CPV,United Kingdom of Great Britain and Northern Ireland,GBR,0,5,0,0,5
2013,Czechia,CZE,United Kingdom of Great Britain and Northern Ireland,GBR,0,0,5,0,5
2013,Ecuador,ECU,United Kingdom of Great Britain and Northern Ireland,GBR,0,0,5,0,5
2013,Eritrea,ERI,United Kingdom of Great Britain and Northern Ireland,GBR,823,10,93,106,1032
2013,Estonia,EST,United Kingdom of Great Britain and Northern Ireland,GBR,0,0,0,5,5
2013,Ethiopia,ETH,United Kingdom of Great Britain and Northern Ireland,GBR,53,5,66,20,144
2013,Gambia,GMB,United Kingdom of Great Britain and Northern Ireland,GBR,102,32,169,14,317
2013,Palestinian,PSE,United Kingdom of Great Britain and Northern Ireland,GBR,31,10,60,31,132
2013,United Kingdom of Great Britain and Northern Ireland,GBR,United Kingdom of Great Britain and Northern Ireland,GBR,0,12,0,0,12
2013,Georgia,GEO,United Kingdom of Great Britain and Northern Ireland,GBR,0,0,21,5,26
2013,Ghana,GHA,United Kingdom of Great Britain and Northern Ireland,GBR,12,5,138,29,184
2013,Greece,GRC,United Kingdom of Great Britain and Northern Ireland,GBR,0,0,5,0,5
2013,Grenada,GRD,United Kingdom of Great Britain and Northern Ireland,GBR,0,0,5,0,5
2013,Guinea,GIN,United Kingdom of Great Britain and Northern Ireland,GBR,23,5,43,10,81
2013,Guyana,GUY,United Kingdom of Great Britain and Northern Ireland,GBR,5,0,5,0,10
2013,Hungary,HUN,United Kingdom of Great Britain and Northern Ireland,GBR,0,0,5,0,5
2013,Cote d'Ivoire,CIV,United Kingdom of Great Britain and Northern Ireland,GBR,20,5,47,5,77
2013,India,IND,United Kingdom of Great Britain and Northern Ireland,GBR,5,10,637,365,1017
2013,Indonesia,IDN,United Kingdom of Great Britain and Northern Ireland,GBR,0,0,5,0,5
2013,Iran (Islamic Rep. of),IRN,United Kingdom of Great Britain and Northern Ireland,GBR,1255,52,931,183,2421
2013,Iraq,IRQ,United Kingdom of Great Britain and Northern Ireland,GBR,91,18,207,61,377
2013,Israel,ISR,United Kingdom of Great Britain and Northern Ireland,GBR,0,0,5,0,5
2013,Italy,ITA,United Kingdom of Great Britain and Northern Ireland,GBR,0,0,0,5,5
2013,Jamaica,JAM,United Kingdom of Great Britain and Northern Ireland,GBR,10,5,102,22,139
2013,Jordan,JOR,United Kingdom of Great Britain and Northern Ireland,GBR,0,0,17,5,22
2013,Kazakhstan,KAZ,United Kingdom of Great Britain and Northern Ireland,GBR,0,0,5,0,5
2013,Kenya,KEN,United Kingdom of Great Britain and Northern Ireland,GBR,5,5,76,5,91
2013,Kyrgyzstan,KGZ,United Kingdom of Great Britain and Northern Ireland,GBR,0,0,12,0,12
2013,Rep. of Korea,KOR,United Kingdom of Great Britain and Northern Ireland,GBR,0,0,5,5,10
2013,Dem. People's Rep. of Korea,PRK,United Kingdom of Great Britain and Northern Ireland,GBR,12,0,26,0,38
2013,Kuwait,KWT,United Kingdom of Great Britain and Northern Ireland,GBR,28,0,16,10,54
2013,Liberia,LBR,United Kingdom of Great Britain and Northern Ireland,GBR,0,5,0,5,10
2013,Libya,LBY,United Kingdom of Great Britain and Northern Ireland,GBR,171,0,173,29,373
2013,Lebanon,LBN,United Kingdom of Great Britain and Northern Ireland,GBR,10,0,47,5,62
2013,Sri Lanka,LKA,United Kingdom of Great Britain and Northern Ireland,GBR,315,26,1250,92,1683
2013,Lithuania,LTU,United Kingdom of Great Britain and Northern Ireland,GBR,0,0,11,5,16
2013,Latvia,LVA,United Kingdom of Great Britain and Northern Ireland,GBR,0,0,5,0,5
2013,Mauritania,MRT,United Kingdom of Great Britain and Northern Ireland,GBR,5,0,0,0,5
2013,Maldives,MDV,United Kingdom of Great Britain and Northern Ireland,GBR,5,0,0,0,5
2013,Mexico,MEX,United Kingdom of Great Britain and Northern Ireland,GBR,0,0,5,5,10
2013,Mali,MLI,United Kingdom of Great Britain and Northern Ireland,GBR,5,0,13,5,23
2013,Malaysia,MYS,United Kingdom of Great Britain and Northern Ireland,GBR,5,0,39,10,54
2013,Malawi,MWI,United Kingdom of Great Britain and Northern Ireland,GBR,15,25,115,15,170
2013,Mongolia,MNG,United Kingdom of Great Britain and Northern Ireland,GBR,5,5,13,5,28
2013,Morocco,MAR,United Kingdom of Great Britain and Northern Ireland,GBR,5,11,32,5,53
2013,Mauritius,MUS,United Kingdom of Great Britain and Northern Ireland,GBR,5,5,30,5,45
2013,Myanmar,MMR,United Kingdom of Great Britain and Northern Ireland,GBR,22,0,20,5,47
2013,Namibia,NAM,United Kingdom of Great Britain and Northern Ireland,GBR,0,0,12,5,17
2013,Nepal,NPL,United Kingdom of Great Britain and Northern Ireland,GBR,0,0,41,18,59
2013,Netherlands,NLD,United Kingdom of Great Britain and Northern Ireland,GBR,0,0,5,0,5
2013,Niger,NER,United Kingdom of Great Britain and Northern Ireland,GBR,0,0,0,5,5
2013,Nigeria,NGA,United Kingdom of Great Britain and Northern Ireland,GBR,82,82,961,124,1249
2013,Pakistan,PAK,United Kingdom of Great Britain and Northern Ireland,GBR,912,58,2606,463,4039
2013,Peru,PER,United Kingdom of Great Britain and Northern Ireland,GBR,0,0,0,5,5
2013,Philippines,PHL,United Kingdom of Great Britain and Northern Ireland,GBR,0,0,27,0,27
2013,Poland,POL,United Kingdom of Great Britain and Northern Ireland,GBR,0,0,76,24,100
2013,Romania,ROU,United Kingdom of Great Britain and Northern Ireland,GBR,0,0,0,13,13
2013,South Africa,ZAF,United Kingdom of Great Britain and Northern Ireland,GBR,0,5,39,12,56
2013,Russian Federation,RUS,United Kingdom of Great Britain and Northern Ireland,GBR,38,5,53,15,111
2013,Rwanda,RWA,United Kingdom of Great Britain and Northern Ireland,GBR,5,0,17,0,22
2013,El Salvador,SLV,United Kingdom of Great Britain and Northern Ireland,GBR,0,0,5,0,5
2013,Saudi Arabia,SAU,United Kingdom of Great Britain and Northern Ireland,GBR,14,0,5,0,19
2013,Serbia and Kosovo: S/RES/1244 (1999),SRB,United Kingdom of Great Britain and Northern Ireland,GBR,0,5,13,14,32
2013,Senegal,SEN,United Kingdom of Great Britain and Northern Ireland,GBR,10,0,19,0,29
2013,Seychelles,SYC,United Kingdom of Great Britain and Northern Ireland,GBR,0,0,5,0,5
2013,Sierra Leone,SLE,United Kingdom of Great Britain and Northern Ireland,GBR,32,13,49,10,104
2013,Somalia,SOM,United Kingdom of Great Britain and Northern Ireland,GBR,279,14,145,45,483
2013,Viet Nam,VNM,United Kingdom of Great Britain and Northern Ireland,GBR,23,34,171,191,419
2013,Saint Kitts and Nevis,KNA,United Kingdom of Great Britain and Northern Ireland,GBR,0,0,5,0,5
2013,Sudan,SDN,United Kingdom of Great Britain and Northern Ireland,GBR,481,0,105,94,680
2013,Eswatini,SWZ,United Kingdom of Great Britain and Northern Ireland,GBR,0,0,5,0,5
2013,Syrian Arab Rep.,SYR,United Kingdom of Great Britain and Northern Ireland,GBR,1444,11,110,175,1740
2013,United Rep. of Tanzania,TZA,United Kingdom of Great Britain and Northern Ireland,GBR,0,0,40,5,45
2013,Thailand,THA,United Kingdom of Great Britain and Northern Ireland,GBR,0,0,10,0,10
2013,Togo,TGO,United Kingdom of Great Britain and Northern Ireland,GBR,0,0,14,0,14
2013,Trinidad and Tobago,TTO,United Kingdom of Great Britain and Northern Ireland,GBR,0,0,16,5,21
2013,Tunisia,TUN,United Kingdom of Great Britain and Northern Ireland,GBR,0,0,22,12,34
2013,Turkey,TUR,United Kingdom of Great Britain and Northern Ireland,GBR,24,14,131,28,197
2013,Uganda,UGA,United Kingdom of Great Britain and Northern Ireland,GBR,76,10,106,5,197
2013,Ukraine,UKR,United Kingdom of Great Britain and Northern Ireland,GBR,10,0,21,14,45
2013,United States of America,USA,United Kingdom of Great Britain and Northern Ireland,GBR,0,0,17,16,33
2013,Uzbekistan,UZB,United Kingdom of Great Britain and Northern Ireland,GBR,5,0,19,0,24
2013,Saint Vincent and the Grenadines,VCT,United Kingdom of Great Britain and Northern Ireland,GBR,0,0,5,0,5
2013,Venezuela (Bolivarian Republic of),VEN,United Kingdom of Great Britain and Northern Ireland,GBR,0,0,5,0,5
2013,Western Sahara,ESH,United Kingdom of Great Britain and Northern Ireland,GBR,0,5,0,0,5
2013,Yemen,YEM,United Kingdom of Great Britain and Northern Ireland,GBR,26,0,37,5,68
2013,Zambia,ZMB,United Kingdom of Great Britain and Northern Ireland,GBR,5,5,12,0,22
2013,Zimbabwe,ZWE,United Kingdom of Great Britain and Northern Ireland,GBR,81,54,231,29,395
2013,Stateless,XXA,United Kingdom of Great Britain and Northern Ireland,GBR,218,0,36,22,276
2013,Central African Rep.,CAF,Ghana,GHA,5,0,0,0,5
2013,Chad,TCD,Ghana,GHA,0,0,0,5,5
2013,Guinea,GIN,Ghana,GHA,0,0,0,5,5
2013,Iraq,IRQ,Ghana,GHA,10,0,0,0,10
2013,Liberia,LBR,Ghana,GHA,0,0,0,5,5
2013,Lebanon,LBN,Ghana,GHA,5,0,0,0,5
2013,Nigeria,NGA,Ghana,GHA,0,0,0,35,35
2013,Sierra Leone,SLE,Ghana,GHA,0,0,0,5,5
2013,Sudan,SDN,Ghana,GHA,96,0,0,0,96
2013,Togo,TGO,Ghana,GHA,0,0,0,1893,1893
2013,Afghanistan,AFG,Greece,GRC,34,65,830,369,1298
2013,Albania,ALB,Greece,GRC,0,5,653,85,743
2013,Algeria,DZA,Greece,GRC,0,0,187,95,282
2013,Angola,AGO,Greece,GRC,0,0,10,0,10
2013,Egypt,EGY,Greece,GRC,5,0,252,59,316
2013,Armenia,ARM,Greece,GRC,0,0,73,18,91
2013,Azerbaijan,AZE,Greece,GRC,0,0,5,0,5
2013,Bahrain,BHR,Greece,GRC,0,0,50,0,50
2013,Bangladesh,BGD,Greece,GRC,0,0,1827,425,2252
2013,Burkina Faso,BFA,Greece,GRC,0,0,48,10,58
2013,Belarus,BLR,Greece,GRC,0,0,0,5,5
2013,Brazil,BRA,Greece,GRC,0,0,0,5,5
2013,Central African Rep.,CAF,Greece,GRC,0,5,0,0,5
2013,China,CHN,Greece,GRC,5,0,373,101,479
2013,Cameroon,CMR,Greece,GRC,0,0,73,10,83
2013,Congo,COG,Greece,GRC,0,0,93,15,108
2013,Dem. Rep. of the Congo,COD,Greece,GRC,0,0,72,19,91
2013,Comoros,COM,Greece,GRC,0,0,69,12,81
2013,Dominican Rep.,DOM,Greece,GRC,0,0,17,12,29
2013,Eritrea,ERI,Greece,GRC,35,5,68,57,165
2013,Ethiopia,ETH,Greece,GRC,10,11,120,21,162
2013,Gabon,GAB,Greece,GRC,0,0,5,0,5
2013,Gambia,GMB,Greece,GRC,0,0,37,10,47
2013,Palestinian,PSE,Greece,GRC,11,0,30,15,56
2013,Georgia,GEO,Greece,GRC,0,5,853,393,1251
2013,Ghana,GHA,Greece,GRC,0,0,141,19,160
2013,Guinea-Bissau,GNB,Greece,GRC,0,0,5,0,5
2013,Guinea,GIN,Greece,GRC,0,0,94,15,109
2013,Cote d'Ivoire,CIV,Greece,GRC,5,5,97,18,125
2013,India,IND,Greece,GRC,0,0,292,138,430
2013,Indonesia,IDN,Greece,GRC,0,0,16,10,26
2013,Iran (Islamic Rep. of),IRN,Greece,GRC,21,5,117,63,206
2013,Iraq,IRQ,Greece,GRC,5,17,220,198,440
2013,Kazakhstan,KAZ,Greece,GRC,0,0,5,5,10
2013,Kenya,KEN,Greece,GRC,0,0,26,12,38
2013,Liberia,LBR,Greece,GRC,0,0,5,0,5
2013,Libya,LBY,Greece,GRC,0,0,5,0,5
2013,Lebanon,LBN,Greece,GRC,0,0,5,5,10
2013,Sri Lanka,LKA,Greece,GRC,5,0,46,11,62
2013,Mauritania,MRT,Greece,GRC,0,0,33,5,38
2013,North Macedonia,MKD,Greece,GRC,0,0,5,0,5
2013,Rep. of Moldova,MDA,Greece,GRC,0,0,35,30,65
2013,Mali,MLI,Greece,GRC,0,0,32,5,37
2013,Morocco,MAR,Greece,GRC,0,0,142,46,188
2013,Mauritius,MUS,Greece,GRC,0,0,5,0,5
2013,Myanmar,MMR,Greece,GRC,0,0,5,0,5
2013,Nepal,NPL,Greece,GRC,0,0,17,5,22
2013,Niger,NER,Greece,GRC,0,0,18,5,23
2013,Nigeria,NGA,Greece,GRC,14,5,389,72,480
2013,Pakistan,PAK,Greece,GRC,10,5,4279,1287,5581
2013,Paraguay,PRY,Greece,GRC,0,0,5,0,5
2013,Philippines,PHL,Greece,GRC,0,0,30,10,40
2013,Russian Federation,RUS,Greece,GRC,0,0,34,19,53
2013,Rwanda,RWA,Greece,GRC,0,5,17,0,22
2013,El Salvador,SLV,Greece,GRC,0,0,5,0,5
2013,Serbia and Kosovo: S/RES/1244 (1999),SRB,Greece,GRC,0,0,5,13,18
2013,Senegal,SEN,Greece,GRC,0,0,238,64,302
2013,Singapore,SGP,Greece,GRC,0,0,0,5,5
2013,Sierra Leone,SLE,Greece,GRC,0,0,44,5,49
2013,Somalia,SOM,Greece,GRC,0,19,57,75,151
2013,Viet Nam,VNM,Greece,GRC,0,0,10,0,10
2013,Sudan,SDN,Greece,GRC,29,5,102,21,157
2013,Syrian Arab Rep.,SYR,Greece,GRC,44,61,70,126,301
2013,United Rep. of Tanzania,TZA,Greece,GRC,5,0,26,5,36
2013,Togo,TGO,Greece,GRC,0,0,5,0,5
2013,Tunisia,TUN,Greece,GRC,0,0,45,21,66
2013,Turkey,TUR,Greece,GRC,5,5,28,14,52
2013,Uganda,UGA,Greece,GRC,0,0,5,0,5
2013,Ukraine,UKR,Greece,GRC,0,0,27,16,43
2013,Uzbekistan,UZB,Greece,GRC,0,5,12,0,17
2013,Bangladesh,BGD,Guatemala,GTM,0,0,0,10,10
2013,Cuba,CUB,Guatemala,GTM,0,0,0,5,5
2013,Honduras,HND,Guatemala,GTM,0,0,0,5,5
2013,India,IND,Guatemala,GTM,0,0,0,10,10
2013,Mexico,MEX,Guatemala,GTM,0,0,0,5,5
2013,El Salvador,SLV,Guatemala,GTM,5,0,0,0,5
2013,Cote d'Ivoire,CIV,Guinea,GIN,0,0,0,50,50
2013,Iraq,IRQ,Guinea,GIN,0,0,0,5,5
2013,Liberia,LBR,Guinea,GIN,0,0,0,156,156
2013,Sierra Leone,SLE,Guinea,GIN,0,0,0,74,74
2013,Togo,TGO,Guinea,GIN,5,0,0,0,5
2013,Nicaragua,NIC,Honduras,HND,0,0,0,35,35
2013,Afghanistan,AFG,Croatia,HRV,0,0,10,292,302
2013,Algeria,DZA,Croatia,HRV,0,0,69,83,152
2013,Egypt,EGY,Croatia,HRV,0,0,0,5,5
2013,Bangladesh,BGD,Croatia,HRV,0,0,0,18,18
2013,Cuba,CUB,Croatia,HRV,0,0,0,10,10
2013,Eritrea,ERI,Croatia,HRV,0,0,0,27,27
2013,Palestinian,PSE,Croatia,HRV,0,0,0,11,11
2013,Ghana,GHA,Croatia,HRV,0,0,0,5,5
2013,Cote d'Ivoire,CIV,Croatia,HRV,0,0,0,5,5
2013,Iran (Islamic Rep. of),IRN,Croatia,HRV,0,0,5,13,18
2013,Iraq,IRQ,Croatia,HRV,0,0,0,5,5
2013,Kazakhstan,KAZ,Croatia,HRV,5,0,0,0,5
2013,Libya,LBY,Croatia,HRV,0,0,0,12,12
2013,North Macedonia,MKD,Croatia,HRV,0,0,0,5,5
2013,Mali,MLI,Croatia,HRV,0,0,0,15,15
2013,Morocco,MAR,Croatia,HRV,0,0,29,30,59
2013,Nigeria,NGA,Croatia,HRV,0,0,0,5,5
2013,Pakistan,PAK,Croatia,HRV,0,0,5,39,44
2013,Russian Federation,RUS,Croatia,HRV,0,0,5,13,18
2013,Serbia and Kosovo: S/RES/1244 (1999),SRB,Croatia,HRV,0,0,0,5,5
2013,Senegal,SEN,Croatia,HRV,0,0,0,5,5
2013,Somalia,SOM,Croatia,HRV,0,5,5,176,186
2013,Sudan,SDN,Croatia,HRV,0,0,0,44,44
2013,Syrian Arab Rep.,SYR,Croatia,HRV,0,10,0,188,198
2013,Tunisia,TUN,Croatia,HRV,0,0,21,25,46
2013,Turkey,TUR,Croatia,HRV,0,0,5,0,5
2013,Afghanistan,AFG,Hungary,HUN,33,52,193,1148,1426
2013,Albania,ALB,Hungary,HUN,0,0,0,42,42
2013,Algeria,DZA,Hungary,HUN,0,0,589,441,1030
2013,Egypt,EGY,Hungary,HUN,5,0,29,44,78
2013,Armenia,ARM,Hungary,HUN,0,0,0,5,5
2013,Benin,BEN,Hungary,HUN,0,0,5,0,5
2013,Bangladesh,BGD,Hungary,HUN,0,0,124,447,571
2013,Burkina Faso,BFA,Hungary,HUN,0,0,42,22,64
2013,Bosnia and Herzegovina,BIH,Hungary,HUN,0,0,0,5,5
2013,China,CHN,Hungary,HUN,0,0,0,5,5
2013,Cameroon,CMR,Hungary,HUN,0,0,10,26,36
2013,Congo,COG,Hungary,HUN,0,0,5,14,19
2013,Dem. Rep. of the Congo,COD,Hungary,HUN,0,0,5,37,42
2013,Comoros,COM,Hungary,HUN,0,0,39,55,94
2013,Cuba,CUB,Hungary,HUN,0,0,10,18,28
2013,Eritrea,ERI,Hungary,HUN,5,5,0,57,67
2013,Ethiopia,ETH,Hungary,HUN,5,0,0,0,5
2013,Gambia,GMB,Hungary,HUN,0,0,34,34,68
2013,Palestinian,PSE,Hungary,HUN,5,0,10,74,89
2013,Georgia,GEO,Hungary,HUN,16,0,0,23,39
2013,Ghana,GHA,Hungary,HUN,0,0,72,100,172
2013,Greece,GRC,Hungary,HUN,0,0,0,11,11
2013,Guinea,GIN,Hungary,HUN,0,0,57,67,124
2013,Cote d'Ivoire,CIV,Hungary,HUN,0,0,118,101,219
2013,India,IND,Hungary,HUN,0,0,5,66,71
2013,Iran (Islamic Rep. of),IRN,Hungary,HUN,0,0,10,42,52
2013,Iraq,IRQ,Hungary,HUN,0,10,5,37,52
2013,Liberia,LBR,Hungary,HUN,0,0,5,5,10
2013,Libya,LBY,Hungary,HUN,0,0,5,27,32
2013,Sri Lanka,LKA,Hungary,HUN,0,0,0,12,12
2013,Madagascar,MDG,Hungary,HUN,0,0,0,10,10
2013,Mauritania,MRT,Hungary,HUN,0,0,44,73,117
2013,North Macedonia,MKD,Hungary,HUN,0,0,0,10,10
2013,Rep. of Moldova,MDA,Hungary,HUN,0,0,0,5,5
2013,Mali,MLI,Hungary,HUN,0,0,141,118,259
2013,Mongolia,MNG,Hungary,HUN,0,0,5,0,5
2013,Morocco,MAR,Hungary,HUN,0,0,255,212,467
2013,Montenegro,MNE,Hungary,HUN,0,0,0,5,5
2013,Myanmar,MMR,Hungary,HUN,0,0,0,11,11
2013,Nepal,NPL,Hungary,HUN,0,0,5,5,10
2013,Nigeria,NGA,Hungary,HUN,0,0,116,262,378
2013,Pakistan,PAK,Hungary,HUN,0,5,898,1871,2774
2013,Russian Federation,RUS,Hungary,HUN,0,11,0,0,11
2013,Rwanda,RWA,Hungary,HUN,0,0,0,5,5
2013,Serbia and Kosovo: S/RES/1244 (1999),SRB,Hungary,HUN,0,0,1020,4718,5738
2013,Senegal,SEN,Hungary,HUN,0,0,116,72,188
2013,Sierra Leone,SLE,Hungary,HUN,0,0,15,42,57
2013,Somalia,SOM,Hungary,HUN,10,40,5,76,131
2013,Viet Nam,VNM,Hungary,HUN,0,0,0,5,5
2013,Sudan,SDN,Hungary,HUN,0,0,10,48,58
2013,Syrian Arab Rep.,SYR,Hungary,HUN,73,54,47,554,728
2013,Togo,TGO,Hungary,HUN,0,0,12,5,17
2013,Tunisia,TUN,Hungary,HUN,0,0,92,111,203
2013,Turkey,TUR,Hungary,HUN,0,0,13,81,94
2013,Uganda,UGA,Hungary,HUN,0,0,0,5,5
2013,Ukraine,UKR,Hungary,HUN,0,0,0,5,5
2013,Western Sahara,ESH,Hungary,HUN,0,0,0,5,5
2013,Zimbabwe,ZWE,Hungary,HUN,0,0,0,5,5
2013,Afghanistan,AFG,Iceland,ISL,0,0,5,5,10
2013,Albania,ALB,Iceland,ISL,0,0,38,5,43
2013,Algeria,DZA,Iceland,ISL,0,0,0,5,5
2013,Belarus,BLR,Iceland,ISL,0,0,5,0,5
2013,Georgia,GEO,Iceland,ISL,0,0,0,5,5
2013,Croatia,HRV,Iceland,ISL,0,0,46,0,46
2013,Iran (Islamic Rep. of),IRN,Iceland,ISL,0,0,0,5,5
2013,Iraq,IRQ,Iceland,ISL,0,0,0,5,5
2013,North Macedonia,MKD,Iceland,ISL,0,0,5,0,5
2013,Nigeria,NGA,Iceland,ISL,0,0,5,5,10
2013,Russian Federation,RUS,Iceland,ISL,0,0,5,5,10
2013,Serbia and Kosovo: S/RES/1244 (1999),SRB,Iceland,ISL,0,0,5,0,5
2013,Somalia,SOM,Iceland,ISL,0,0,0,5,5
2013,Afghanistan,AFG,Ireland,IRL,10,0,38,16,64
2013,Albania,ALB,Ireland,IRL,0,0,32,16,48
2013,Algeria,DZA,Ireland,IRL,0,0,28,19,47
2013,Egypt,EGY,Ireland,IRL,12,0,0,0,12
2013,Benin,BEN,Ireland,IRL,0,0,5,0,5
2013,Bangladesh,BGD,Ireland,IRL,0,0,11,14,25
2013,Brazil,BRA,Ireland,IRL,0,0,5,0,5
2013,China,CHN,Ireland,IRL,0,0,10,23,33
2013,Cameroon,CMR,Ireland,IRL,5,0,14,0,19
2013,Dem. Rep. of the Congo,COD,Ireland,IRL,10,0,50,12,72
2013,Ethiopia,ETH,Ireland,IRL,0,0,5,0,5
2013,Palestinian,PSE,Ireland,IRL,0,0,0,5,5
2013,Georgia,GEO,Ireland,IRL,0,0,10,10,20
2013,Ghana,GHA,Ireland,IRL,5,0,5,0,10
2013,Guinea,GIN,Ireland,IRL,0,0,0,5,5
2013,Cote d'Ivoire,CIV,Ireland,IRL,0,0,10,0,10
2013,India,IND,Ireland,IRL,0,0,0,10,10
2013,Iran (Islamic Rep. of),IRN,Ireland,IRL,14,0,0,5,19
2013,Iraq,IRQ,Ireland,IRL,10,0,5,5,20
2013,Kenya,KEN,Ireland,IRL,0,0,13,0,13
2013,Kuwait,KWT,Ireland,IRL,5,0,0,0,5
2013,Libya,LBY,Ireland,IRL,0,0,5,5,10
2013,Rep. of Moldova,MDA,Ireland,IRL,0,0,0,5,5
2013,Mali,MLI,Ireland,IRL,5,0,0,0,5
2013,Malawi,MWI,Ireland,IRL,5,0,21,5,31
2013,Mauritius,MUS,Ireland,IRL,0,0,11,5,16
2013,Nigeria,NGA,Ireland,IRL,0,0,95,61,156
2013,Pakistan,PAK,Ireland,IRL,5,0,63,45,113
2013,South Africa,ZAF,Ireland,IRL,0,0,18,5,23
2013,Russian Federation,RUS,Ireland,IRL,0,0,10,0,10
2013,Serbia and Kosovo: S/RES/1244 (1999),SRB,Ireland,IRL,0,0,0,5,5
2013,Sierra Leone,SLE,Ireland,IRL,0,0,0,5,5
2013,Somalia,SOM,Ireland,IRL,5,0,0,13,18
2013,Sudan,SDN,Ireland,IRL,5,0,0,5,10
2013,Syrian Arab Rep.,SYR,Ireland,IRL,34,0,0,0,34
2013,Togo,TGO,Ireland,IRL,0,0,0,5,5
2013,Turkey,TUR,Ireland,IRL,0,0,0,5,5
2013,Uganda,UGA,Ireland,IRL,5,0,0,0,5
2013,Ukraine,UKR,Ireland,IRL,0,0,0,11,11
2013,Uzbekistan,UZB,Ireland,IRL,0,0,0,5,5
2013,Zambia,ZMB,Ireland,IRL,5,0,0,0,5
2013,Zimbabwe,ZWE,Ireland,IRL,0,0,54,10,64
2013,Afghanistan,AFG,Italy,ITA,285,1317,162,0,1764
2013,Albania,ALB,Italy,ITA,17,39,38,0,94
2013,Algeria,DZA,Italy,ITA,5,21,127,0,153
2013,Egypt,EGY,Italy,ITA,102,232,134,0,468
2013,Armenia,ARM,Italy,ITA,14,44,24,0,82
2013,Azerbaijan,AZE,Italy,ITA,5,0,0,0,5
2013,Benin,BEN,Italy,ITA,0,13,5,0,18
2013,Bangladesh,BGD,Italy,ITA,22,276,293,0,591
2013,Burkina Faso,BFA,Italy,ITA,5,125,71,0,201
2013,Belarus,BLR,Italy,ITA,0,12,0,0,12
2013,Brazil,BRA,Italy,ITA,0,0,14,0,14
2013,Bosnia and Herzegovina,BIH,Italy,ITA,0,150,256,0,406
2013,Chad,TCD,Italy,ITA,5,39,33,0,77
2013,China,CHN,Italy,ITA,5,0,23,0,28
2013,Cameroon,CMR,Italy,ITA,26,33,29,0,88
2013,Congo,COG,Italy,ITA,19,21,5,0,45
2013,Dem. Rep. of the Congo,COD,Italy,ITA,18,26,18,0,62
2013,Colombia,COL,Italy,ITA,19,26,12,0,57
2013,Cuba,CUB,Italy,ITA,5,24,26,0,55
2013,Dominican Rep.,DOM,Italy,ITA,0,5,0,0,5
2013,Ecuador,ECU,Italy,ITA,0,5,0,0,5
2013,Equatorial Guinea,GNQ,Italy,ITA,5,0,0,0,5
2013,Eritrea,ERI,Italy,ITA,930,474,118,0,1522
2013,Ethiopia,ETH,Italy,ITA,67,93,35,0,195
2013,Gabon,GAB,Italy,ITA,0,0,10,0,10
2013,Gambia,GMB,Italy,ITA,18,325,280,0,623
2013,Palestinian,PSE,Italy,ITA,59,12,48,0,119
2013,Georgia,GEO,Italy,ITA,5,18,86,0,109
2013,Ghana,GHA,Italy,ITA,11,508,284,0,803
2013,Guinea-Bissau,GNB,Italy,ITA,0,40,19,0,59
2013,Guinea,GIN,Italy,ITA,10,116,75,0,201
2013,Cote d'Ivoire,CIV,Italy,ITA,49,349,145,0,543
2013,India,IND,Italy,ITA,0,10,39,0,49
2013,Iran (Islamic Rep. of),IRN,Italy,ITA,157,66,51,0,274
2013,Iraq,IRQ,Italy,ITA,71,382,173,0,626
2013,Jordan,JOR,Italy,ITA,0,0,5,0,5
2013,Kazakhstan,KAZ,Italy,ITA,0,5,0,0,5
2013,Kenya,KEN,Italy,ITA,5,10,12,0,27
2013,Kyrgyzstan,KGZ,Italy,ITA,0,0,5,0,5
2013,Kuwait,KWT,Italy,ITA,0,0,5,0,5
2013,Liberia,LBR,Italy,ITA,0,25,48,0,73
2013,Libya,LBY,Italy,ITA,18,31,63,0,112
2013,Lebanon,LBN,Italy,ITA,23,29,34,0,86
2013,Sri Lanka,LKA,Italy,ITA,5,28,43,0,76
2013,Mauritania,MRT,Italy,ITA,16,33,48,0,97
2013,North Macedonia,MKD,Italy,ITA,0,17,10,0,27
2013,Rep. of Moldova,MDA,Italy,ITA,0,0,11,0,11
2013,Mali,MLI,Italy,ITA,12,1469,202,0,1683
2013,Mongolia,MNG,Italy,ITA,0,0,5,0,5
2013,Morocco,MAR,Italy,ITA,10,78,246,0,334
2013,Montenegro,MNE,Italy,ITA,0,10,20,0,30
2013,Myanmar,MMR,Italy,ITA,5,0,0,0,5
2013,Nepal,NPL,Italy,ITA,0,0,5,0,5
2013,Niger,NER,Italy,ITA,0,78,24,0,102
2013,Nicaragua,NIC,Italy,ITA,0,0,5,0,5
2013,Nigeria,NGA,Italy,ITA,66,1180,1783,0,3029
2013,Pakistan,PAK,Italy,ITA,231,906,1299,0,2436
2013,Paraguay,PRY,Italy,ITA,0,0,5,0,5
2013,Peru,PER,Italy,ITA,5,13,0,0,18
2013,Russian Federation,RUS,Italy,ITA,0,5,15,0,20
2013,Rwanda,RWA,Italy,ITA,5,0,0,0,5
2013,El Salvador,SLV,Italy,ITA,5,28,15,0,48
2013,Serbia and Kosovo: S/RES/1244 (1999),SRB,Italy,ITA,5,182,181,0,368
2013,Senegal,SEN,Italy,ITA,40,246,495,0,781
2013,Sierra Leone,SLE,Italy,ITA,5,26,16,0,47
2013,Somalia,SOM,Italy,ITA,331,1254,62,0,1647
2013,Sudan,SDN,Italy,ITA,20,50,37,0,107
2013,Syrian Arab Rep.,SYR,Italy,ITA,246,149,383,0,778
2013,United Rep. of Tanzania,TZA,Italy,ITA,0,0,5,0,5
2013,Turkmenistan,TKM,Italy,ITA,5,0,0,0,5
2013,Togo,TGO,Italy,ITA,10,60,44,0,114
2013,Tunisia,TUN,Italy,ITA,5,97,964,0,1066
2013,Turkey,TUR,Italy,ITA,48,287,325,0,660
2013,Uganda,UGA,Italy,ITA,0,5,5,0,10
2013,Ukraine,UKR,Italy,ITA,5,15,18,0,38
2013,Venezuela (Bolivarian Republic of),VEN,Italy,ITA,0,5,0,0,5
2013,Yemen,YEM,Italy,ITA,5,0,0,0,5
2013,Zimbabwe,ZWE,Italy,ITA,0,0,5,0,5
2013,Stateless,XXA,Italy,ITA,5,0,0,0,5
2013,Bangladesh,BGD,Japan,JPN,0,0,125,0,125
2013,Cameroon,CMR,Japan,JPN,0,0,73,0,73
2013,Ghana,GHA,Japan,JPN,0,0,145,0,145
2013,India,IND,Japan,JPN,0,0,121,0,121
2013,Sri Lanka,LKA,Japan,JPN,0,0,204,0,204
2013,Myanmar,MMR,Japan,JPN,0,0,311,0,311
2013,Nepal,NPL,Japan,JPN,0,0,443,0,443
2013,Nigeria,NGA,Japan,JPN,0,0,95,0,95
2013,Pakistan,PAK,Japan,JPN,0,0,223,0,223
2013,Syrian Arab Rep.,SYR,Japan,JPN,0,26,0,0,26
2013,Turkey,TUR,Japan,JPN,0,0,459,0,459
2013,Afghanistan,AFG,Kazakhstan,KAZ,50,5,16,5,76
2013,Syrian Arab Rep.,SYR,Kazakhstan,KAZ,5,0,10,0,15
2013,Uzbekistan,UZB,Kazakhstan,KAZ,0,0,5,5,10
2013,Afghanistan,AFG,Kyrgyzstan,KGZ,0,0,63,5,68
2013,Pakistan,PAK,Kyrgyzstan,KGZ,0,0,5,0,5
2013,Syrian Arab Rep.,SYR,Kyrgyzstan,KGZ,11,0,10,14,35
2013,Uzbekistan,UZB,Kyrgyzstan,KGZ,0,0,0,34,34
2013,Albania,ALB,Liechtenstein,LIE,0,0,0,5,5
2013,Algeria,DZA,Liechtenstein,LIE,0,0,0,5,5
2013,Bosnia and Herzegovina,BIH,Liechtenstein,LIE,0,0,0,5,5
2013,China,CHN,Liechtenstein,LIE,0,5,0,0,5
2013,Kyrgyzstan,KGZ,Liechtenstein,LIE,0,0,0,5,5
2013,Morocco,MAR,Liechtenstein,LIE,0,0,0,5,5
2013,Romania,ROU,Liechtenstein,LIE,0,0,0,35,35
2013,Russian Federation,RUS,Liechtenstein,LIE,0,0,0,11,11
2013,Serbia and Kosovo: S/RES/1244 (1999),SRB,Liechtenstein,LIE,0,0,0,5,5
2013,Ukraine,UKR,Liechtenstein,LIE,0,0,0,5,5
2013,Afghanistan,AFG,Lithuania,LTU,0,18,0,19,37
2013,Armenia,ARM,Lithuania,LTU,0,0,0,5,5
2013,Azerbaijan,AZE,Lithuania,LTU,0,0,0,5,5
2013,Belarus,BLR,Lithuania,LTU,5,0,0,0,5
2013,Georgia,GEO,Lithuania,LTU,0,0,69,48,117
2013,India,IND,Lithuania,LTU,0,0,0,5,5
2013,Russian Federation,RUS,Lithuania,LTU,0,0,12,20,32
2013,Viet Nam,VNM,Lithuania,LTU,0,0,20,5,25
2013,Syrian Arab Rep.,SYR,Lithuania,LTU,0,13,0,0,13
2013,Ukraine,UKR,Lithuania,LTU,5,0,0,0,5
2013,Uzbekistan,UZB,Lithuania,LTU,0,5,0,0,5
2013,Stateless,XXA,Lithuania,LTU,0,0,0,10,10
2013,Afghanistan,AFG,Luxembourg,LUX,10,10,5,15,40
2013,Albania,ALB,Luxembourg,LUX,0,0,110,18,128
2013,Algeria,DZA,Luxembourg,LUX,0,0,13,15,28
2013,Egypt,EGY,Luxembourg,LUX,0,0,0,5,5
2013,Armenia,ARM,Luxembourg,LUX,0,0,0,5,5
2013,Azerbaijan,AZE,Luxembourg,LUX,0,0,0,11,11
2013,Benin,BEN,Luxembourg,LUX,0,0,14,0,14
2013,Belarus,BLR,Luxembourg,LUX,0,0,5,21,26
2013,Bosnia and Herzegovina,BIH,Luxembourg,LUX,0,0,157,29,186
2013,Cameroon,CMR,Luxembourg,LUX,0,0,5,0,5
2013,Dem. Rep. of the Congo,COD,Luxembourg,LUX,5,0,5,0,10
2013,Eritrea,ERI,Luxembourg,LUX,0,0,0,5,5
2013,Ethiopia,ETH,Luxembourg,LUX,5,0,0,0,5
2013,Gambia,GMB,Luxembourg,LUX,0,0,5,5,10
2013,Palestinian,PSE,Luxembourg,LUX,0,0,5,0,5
2013,Georgia,GEO,Luxembourg,LUX,0,0,0,10,10
2013,Guinea-Bissau,GNB,Luxembourg,LUX,0,0,0,5,5
2013,Guinea,GIN,Luxembourg,LUX,0,0,0,10,10
2013,Cote d'Ivoire,CIV,Luxembourg,LUX,0,0,5,0,5
2013,Iran (Islamic Rep. of),IRN,Luxembourg,LUX,30,0,5,14,49
2013,Iraq,IRQ,Luxembourg,LUX,10,0,18,18,46
2013,Italy,ITA,Luxembourg,LUX,0,0,0,5,5
2013,Dem. People's Rep. of Korea,PRK,Luxembourg,LUX,5,0,0,0,5
2013,Liberia,LBR,Luxembourg,LUX,0,0,0,12,12
2013,Libya,LBY,Luxembourg,LUX,5,0,0,5,10
2013,North Macedonia,MKD,Luxembourg,LUX,0,0,26,13,39
2013,Marshall Islands,MHL,Luxembourg,LUX,0,0,5,0,5
2013,Morocco,MAR,Luxembourg,LUX,0,0,5,10,15
2013,Montenegro,MNE,Luxembourg,LUX,10,0,126,11,147
2013,Nigeria,NGA,Luxembourg,LUX,0,0,16,26,42
2013,Russian Federation,RUS,Luxembourg,LUX,5,0,5,19,29
2013,Serbia and Kosovo: S/RES/1244 (1999),SRB,Luxembourg,LUX,0,5,260,56,321
2013,Senegal,SEN,Luxembourg,LUX,0,0,0,5,5
2013,Sierra Leone,SLE,Luxembourg,LUX,0,0,0,5,5
2013,Somalia,SOM,Luxembourg,LUX,5,0,5,17,27
2013,Sudan,SDN,Luxembourg,LUX,0,0,0,5,5
2013,Syrian Arab Rep.,SYR,Luxembourg,LUX,14,5,0,5,24
2013,Togo,TGO,Luxembourg,LUX,0,0,5,0,5
2013,Tunisia,TUN,Luxembourg,LUX,0,0,24,33,57
2013,Turkey,TUR,Luxembourg,LUX,0,0,12,5,17
2013,Egypt,EGY,Latvia,LVA,5,0,0,0,5
2013,Dem. Rep. of the Congo,COD,Latvia,LVA,0,0,5,0,5
2013,Georgia,GEO,Latvia,LVA,0,0,23,75,98
2013,Iran (Islamic Rep. of),IRN,Latvia,LVA,0,5,0,0,5
2013,Kyrgyzstan,KGZ,Latvia,LVA,5,0,0,0,5
2013,Russian Federation,RUS,Latvia,LVA,5,0,0,0,5
2013,Syrian Arab Rep.,SYR,Latvia,LVA,0,18,0,0,18
2013,Turkey,TUR,Latvia,LVA,0,0,0,5,5
2013,Uzbekistan,UZB,Latvia,LVA,0,0,5,0,5
2013,Afghanistan,AFG,Rep. of Moldova,MDA,0,0,0,5,5
2013,Egypt,EGY,Rep. of Moldova,MDA,0,0,5,0,5
2013,Armenia,ARM,Rep. of Moldova,MDA,0,5,0,0,5
2013,Iraq,IRQ,Rep. of Moldova,MDA,5,0,0,0,5
2013,Kyrgyzstan,KGZ,Rep. of Moldova,MDA,0,0,10,0,10
2013,Lebanon,LBN,Rep. of Moldova,MDA,0,0,0,5,5
2013,Nigeria,NGA,Rep. of Moldova,MDA,0,0,5,0,5
2013,Pakistan,PAK,Rep. of Moldova,MDA,0,0,0,5,5
2013,Russian Federation,RUS,Rep. of Moldova,MDA,0,0,5,0,5
2013,Syrian Arab Rep.,SYR,Rep. of Moldova,MDA,10,76,0,5,91
2013,Turkey,TUR,Rep. of Moldova,MDA,0,0,5,0,5
2013,Colombia,COL,Mexico,MEX,10,0,0,0,10
2013,Guatemala,GTM,Mexico,MEX,10,0,0,0,10
2013,Honduras,HND,Mexico,MEX,101,27,0,0,128
2013,Iran (Islamic Rep. of),IRN,Mexico,MEX,5,0,0,0,5
2013,Nigeria,NGA,Mexico,MEX,15,0,0,0,15
2013,El Salvador,SLV,Mexico,MEX,99,0,0,0,99
2013,Syrian Arab Rep.,SYR,Mexico,MEX,11,0,0,0,11
2013,Burundi,BDI,Malawi,MWI,0,0,0,424,424
2013,Dem. Rep. of the Congo,COD,Malawi,MWI,10,0,0,1649,1659
2013,Ethiopia,ETH,Malawi,MWI,0,0,0,10,10
2013,Rwanda,RWA,Malawi,MWI,0,0,0,311,311
2013,Sierra Leone,SLE,Malawi,MWI,0,0,0,5,5
2013,Somalia,SOM,Malawi,MWI,0,0,0,5,5
2013,Burundi,BDI,Mozambique,MOZ,5,0,0,0,5
2013,Dem. Rep. of the Congo,COD,Mozambique,MOZ,48,0,0,5,53
2013,Egypt,EGY,Malta,MLT,5,0,0,5,10
2013,Bangladesh,BGD,Malta,MLT,0,0,5,0,5
2013,Eritrea,ERI,Malta,MLT,548,5,29,10,592
2013,Ethiopia,ETH,Malta,MLT,12,5,12,0,29
2013,Ghana,GHA,Malta,MLT,0,0,0,30,30
2013,Cote d'Ivoire,CIV,Malta,MLT,0,0,5,0,5
2013,India,IND,Malta,MLT,0,0,0,5,5
2013,Iraq,IRQ,Malta,MLT,5,0,0,0,5
2013,Libya,LBY,Malta,MLT,66,47,0,13,126
2013,Mali,MLI,Malta,MLT,0,0,19,0,19
2013,Morocco,MAR,Malta,MLT,0,0,11,0,11
2013,Nigeria,NGA,Malta,MLT,5,5,43,11,64
2013,Pakistan,PAK,Malta,MLT,0,5,5,0,10
2013,Somalia,SOM,Malta,MLT,657,10,134,38,839
2013,Sudan,SDN,Malta,MLT,12,0,0,0,12
2013,Syrian Arab Rep.,SYR,Malta,MLT,413,171,0,21,605
2013,Tunisia,TUN,Malta,MLT,0,0,0,5,5
2013,Burundi,BDI,Namibia,NAM,12,0,11,0,23
2013,Dem. Rep. of the Congo,COD,Namibia,NAM,141,0,48,0,189
2013,Ethiopia,ETH,Namibia,NAM,5,0,0,0,5
2013,Rwanda,RWA,Namibia,NAM,13,0,0,0,13
2013,Zimbabwe,ZWE,Namibia,NAM,0,0,5,0,5
2013,Afghanistan,AFG,Netherlands,NLD,190,526,617,35,1368
2013,Albania,ALB,Netherlands,NLD,0,0,36,0,36
2013,Algeria,DZA,Netherlands,NLD,0,5,21,5,31
2013,Angola,AGO,Netherlands,NLD,0,0,19,0,19
2013,Egypt,EGY,Netherlands,NLD,16,32,184,10,242
2013,Armenia,ARM,Netherlands,NLD,0,17,281,15,313
2013,Azerbaijan,AZE,Netherlands,NLD,14,10,64,10,98
2013,Burundi,BDI,Netherlands,NLD,0,5,13,0,18
2013,Benin,BEN,Netherlands,NLD,0,0,5,0,5
2013,Bangladesh,BGD,Netherlands,NLD,0,11,29,0,40
2013,Burkina Faso,BFA,Netherlands,NLD,0,5,10,0,15
2013,Belarus,BLR,Netherlands,NLD,5,0,46,5,56
2013,Bosnia and Herzegovina,BIH,Netherlands,NLD,0,0,72,0,72
2013,Chad,TCD,Netherlands,NLD,0,0,5,0,5
2013,China,CHN,Netherlands,NLD,17,66,62,10,155
2013,Cameroon,CMR,Netherlands,NLD,0,0,21,0,21
2013,Congo,COG,Netherlands,NLD,0,87,65,5,157
2013,Dem. Rep. of the Congo,COD,Netherlands,NLD,10,34,11,0,55
2013,Colombia,COL,Netherlands,NLD,0,0,5,5,10
2013,Cuba,CUB,Netherlands,NLD,0,5,5,0,10
2013,Ecuador,ECU,Netherlands,NLD,0,0,5,0,5
2013,Eritrea,ERI,Netherlands,NLD,30,686,164,5,885
2013,Ethiopia,ETH,Netherlands,NLD,13,40,52,0,105
2013,Gambia,GMB,Netherlands,NLD,0,5,26,0,31
2013,Palestinian,PSE,Netherlands,NLD,10,50,18,0,78
2013,Georgia,GEO,Netherlands,NLD,0,10,140,23,173
2013,Ghana,GHA,Netherlands,NLD,0,0,26,5,31
2013,Guinea-Bissau,GNB,Netherlands,NLD,0,0,10,0,10
2013,Guinea,GIN,Netherlands,NLD,5,62,120,5,192
2013,Cote d'Ivoire,CIV,Netherlands,NLD,0,48,44,5,97
2013,India,IND,Netherlands,NLD,0,0,21,0,21
2013,Iran (Islamic Rep. of),IRN,Netherlands,NLD,444,290,489,26,1249
2013,Iraq,IRQ,Netherlands,NLD,114,774,447,42,1377
2013,Israel,ISR,Netherlands,NLD,0,0,5,0,5
2013,Jamaica,JAM,Netherlands,NLD,11,0,11,0,22
2013,Japan,JPN,Netherlands,NLD,0,0,5,0,5
2013,Kazakhstan,KAZ,Netherlands,NLD,0,10,17,5,32
2013,Kenya,KEN,Netherlands,NLD,0,0,11,0,11
2013,Kyrgyzstan,KGZ,Netherlands,NLD,0,0,11,0,11
2013,Dem. People's Rep. of Korea,PRK,Netherlands,NLD,0,5,127,0,132
2013,Kuwait,KWT,Netherlands,NLD,0,0,5,0,5
2013,Liberia,LBR,Netherlands,NLD,0,0,14,0,14
2013,Libya,LBY,Netherlands,NLD,5,20,138,10,173
2013,Lebanon,LBN,Netherlands,NLD,0,0,21,5,26
2013,Sri Lanka,LKA,Netherlands,NLD,12,95,86,5,198
2013,Mauritania,MRT,Netherlands,NLD,0,0,5,0,5
2013,North Macedonia,MKD,Netherlands,NLD,0,0,108,5,113
2013,Mali,MLI,Netherlands,NLD,0,0,53,5,58
2013,Mongolia,MNG,Netherlands,NLD,0,0,95,14,109
2013,Morocco,MAR,Netherlands,NLD,0,0,46,17,63
2013,Myanmar,MMR,Netherlands,NLD,0,53,10,0,63
2013,Nepal,NPL,Netherlands,NLD,14,28,44,5,91
2013,Niger,NER,Netherlands,NLD,0,0,10,0,10
2013,Nigeria,NGA,Netherlands,NLD,0,18,117,13,148
2013,Pakistan,PAK,Netherlands,NLD,17,46,97,5,165
2013,Russian Federation,RUS,Netherlands,NLD,5,29,271,18,323
2013,Rwanda,RWA,Netherlands,NLD,0,5,5,0,10
2013,El Salvador,SLV,Netherlands,NLD,0,0,5,0,5
2013,Serbia and Kosovo: S/RES/1244 (1999),SRB,Netherlands,NLD,0,5,324,11,340
2013,Senegal,SEN,Netherlands,NLD,0,5,29,0,34
2013,Sierra Leone,SLE,Netherlands,NLD,5,42,54,5,106
2013,Somalia,SOM,Netherlands,NLD,46,2683,291,18,3038
2013,Viet Nam,VNM,Netherlands,NLD,0,0,5,0,5
2013,Sudan,SDN,Netherlands,NLD,13,73,91,0,177
2013,Suriname,SUR,Netherlands,NLD,0,0,10,0,10
2013,Syrian Arab Rep.,SYR,Netherlands,NLD,63,2011,299,0,2373
2013,United Rep. of Tanzania,TZA,Netherlands,NLD,0,0,10,0,10
2013,Tajikistan,TJK,Netherlands,NLD,0,10,0,0,10
2013,Togo,TGO,Netherlands,NLD,0,5,17,0,22
2013,Trinidad and Tobago,TTO,Netherlands,NLD,0,0,5,0,5
2013,Tunisia,TUN,Netherlands,NLD,0,0,17,0,17
2013,Turkey,TUR,Netherlands,NLD,0,32,52,10,94
2013,Uganda,UGA,Netherlands,NLD,41,67,73,0,181
2013,Ukraine,UKR,Netherlands,NLD,0,5,38,0,43
2013,Uzbekistan,UZB,Netherlands,NLD,0,0,5,0,5
2013,Venezuela (Bolivarian Republic of),VEN,Netherlands,NLD,0,0,5,0,5
2013,Yemen,YEM,Netherlands,NLD,5,5,24,5,39
2013,Zambia,ZMB,Netherlands,NLD,5,0,0,0,5
2013,Zimbabwe,ZWE,Netherlands,NLD,0,14,0,0,14
2013,Stateless,XXA,Netherlands,NLD,96,80,38,0,214
2013,Central African Rep.,CAF,Niger,NER,10,0,0,0,10
2013,Chad,TCD,Niger,NER,0,0,5,0,5
2013,Cameroon,CMR,Niger,NER,0,0,0,5,5
2013,Cote d'Ivoire,CIV,Niger,NER,0,0,0,5,5
2013,Rwanda,RWA,Niger,NER,0,0,5,0,5
2013,Syrian Arab Rep.,SYR,Niger,NER,5,0,0,0,5
2013,Ghana,GHA,Nicaragua,NIC,5,0,0,0,5
2013,Honduras,HND,Nicaragua,NIC,21,0,0,0,21
2013,Iran (Islamic Rep. of),IRN,Nicaragua,NIC,0,0,0,5,5
2013,Nepal,NPL,Nicaragua,NIC,0,0,0,5,5
2013,Nigeria,NGA,Nicaragua,NIC,5,0,0,0,5
2013,Pakistan,PAK,Nicaragua,NIC,0,0,0,12,12
2013,El Salvador,SLV,Nicaragua,NIC,38,0,0,0,38
2013,Somalia,SOM,Nicaragua,NIC,5,0,0,0,5
2013,Afghanistan,AFG,Nigeria,NGA,5,0,0,0,5
2013,Burundi,BDI,Nigeria,NGA,0,0,0,5,5
2013,Central African Rep.,CAF,Nigeria,NGA,10,0,0,0,10
2013,Chad,TCD,Nigeria,NGA,10,0,13,226,249
2013,Cameroon,CMR,Nigeria,NGA,0,0,0,5,5
2013,Dem. Rep. of the Congo,COD,Nigeria,NGA,85,0,107,209,401
2013,Eritrea,ERI,Nigeria,NGA,0,0,0,5,5
2013,Guinea,GIN,Nigeria,NGA,0,0,0,14,14
2013,Cote d'Ivoire,CIV,Nigeria,NGA,13,0,17,16,46
2013,Liberia,LBR,Nigeria,NGA,0,0,0,5,5
2013,Mali,MLI,Nigeria,NGA,89,0,5,0,94
2013,Sudan,SDN,Nigeria,NGA,0,0,5,5,10
2013,Syrian Arab Rep.,SYR,Nigeria,NGA,10,0,0,0,10
2013,Togo,TGO,Nigeria,NGA,0,0,5,5,10
2013,Afghanistan,AFG,Norway,NOR,183,162,229,168,742
2013,Albania,ALB,Norway,NOR,0,0,167,14,181
2013,Algeria,DZA,Norway,NOR,0,5,25,79,109
2013,Angola,AGO,Norway,NOR,0,0,14,0,14
2013,Egypt,EGY,Norway,NOR,0,5,15,17,37
2013,Armenia,ARM,Norway,NOR,0,0,20,10,30
2013,Azerbaijan,AZE,Norway,NOR,0,0,23,31,54
2013,Burundi,BDI,Norway,NOR,5,0,0,0,5
2013,Bangladesh,BGD,Norway,NOR,0,0,109,32,141
2013,Burkina Faso,BFA,Norway,NOR,0,0,0,5,5
2013,Belarus,BLR,Norway,NOR,0,0,26,26,52
2013,Bosnia and Herzegovina,BIH,Norway,NOR,0,0,36,14,50
2013,Chad,TCD,Norway,NOR,0,0,0,14,14
2013,China,CHN,Norway,NOR,69,0,5,10,84
2013,Cameroon,CMR,Norway,NOR,0,0,0,12,12
2013,Dem. Rep. of the Congo,COD,Norway,NOR,5,13,11,10,39
2013,Colombia,COL,Norway,NOR,0,0,5,0,5
2013,Cuba,CUB,Norway,NOR,0,0,5,0,5
2013,Czechia,CZE,Norway,NOR,0,0,5,0,5
2013,Djibouti,DJI,Norway,NOR,0,0,0,15,15
2013,Eritrea,ERI,Norway,NOR,2141,13,153,434,2741
2013,Ethiopia,ETH,Norway,NOR,174,26,109,70,379
2013,Gambia,GMB,Norway,NOR,0,5,22,19,46
2013,Georgia,GEO,Norway,NOR,0,0,36,45,81
2013,Ghana,GHA,Norway,NOR,0,0,17,24,41
2013,Guinea-Bissau,GNB,Norway,NOR,0,0,10,11,21
2013,Guinea,GIN,Norway,NOR,10,10,26,25,71
2013,Croatia,HRV,Norway,NOR,0,0,0,5,5
2013,Cote d'Ivoire,CIV,Norway,NOR,5,5,10,17,37
2013,India,IND,Norway,NOR,0,0,17,0,17
2013,Iran (Islamic Rep. of),IRN,Norway,NOR,96,5,125,120,346
2013,Iraq,IRQ,Norway,NOR,28,17,60,108,213
2013,Israel,ISR,Norway,NOR,0,0,0,5,5
2013,Jordan,JOR,Norway,NOR,0,0,10,26,36
2013,Kazakhstan,KAZ,Norway,NOR,0,0,5,10,15
2013,Kenya,KEN,Norway,NOR,0,0,0,5,5
2013,Kyrgyzstan,KGZ,Norway,NOR,0,0,26,12,38
2013,Liberia,LBR,Norway,NOR,0,0,10,14,24
2013,Libya,LBY,Norway,NOR,0,0,15,69,84
2013,Lebanon,LBN,Norway,NOR,0,5,5,13,23
2013,Sri Lanka,LKA,Norway,NOR,5,5,17,5,32
2013,Lithuania,LTU,Norway,NOR,0,0,5,0,5
2013,Latvia,LVA,Norway,NOR,0,0,5,0,5
2013,Mauritania,MRT,Norway,NOR,0,0,0,10,10
2013,North Macedonia,MKD,Norway,NOR,0,0,30,5,35
2013,Rep. of Moldova,MDA,Norway,NOR,0,5,0,0,5
2013,Mali,MLI,Norway,NOR,5,0,19,40,64
2013,Morocco,MAR,Norway,NOR,5,0,35,100,140
2013,Montenegro,MNE,Norway,NOR,0,0,0,12,12
2013,Myanmar,MMR,Norway,NOR,5,0,5,0,10
2013,Netherlands,NLD,Norway,NOR,0,0,5,0,5
2013,Niger,NER,Norway,NOR,0,0,0,14,14
2013,Nigeria,NGA,Norway,NOR,32,17,139,426,614
2013,Pakistan,PAK,Norway,NOR,12,5,89,40,146
2013,Peru,PER,Norway,NOR,0,0,0,5,5
2013,Philippines,PHL,Norway,NOR,0,0,5,0,5
2013,Romania,ROU,Norway,NOR,0,0,12,5,17
2013,Russian Federation,RUS,Norway,NOR,27,18,200,181,426
2013,Rwanda,RWA,Norway,NOR,0,0,0,5,5
2013,El Salvador,SLV,Norway,NOR,0,0,5,0,5
2013,Serbia and Kosovo: S/RES/1244 (1999),SRB,Norway,NOR,0,12,234,96,342
2013,Senegal,SEN,Norway,NOR,0,0,5,14,19
2013,Sierra Leone,SLE,Norway,NOR,0,0,0,14,14
2013,Somalia,SOM,Norway,NOR,962,313,496,411,2182
2013,Spain,ESP,Norway,NOR,0,0,0,5,5
2013,Viet Nam,VNM,Norway,NOR,0,0,22,10,32
2013,Sudan,SDN,Norway,NOR,327,5,119,239,690
2013,South Sudan,SSD,Norway,NOR,0,0,14,0,14
2013,Syrian Arab Rep.,SYR,Norway,NOR,278,413,12,163,866
2013,United Rep. of Tanzania,TZA,Norway,NOR,0,0,0,5,5
2013,Tajikistan,TJK,Norway,NOR,0,0,15,0,15
2013,Turkmenistan,TKM,Norway,NOR,0,0,0,5,5
2013,Tunisia,TUN,Norway,NOR,0,0,14,62,76
2013,Turkey,TUR,Norway,NOR,0,0,19,34,53
2013,Uganda,UGA,Norway,NOR,23,0,15,10,48
2013,Ukraine,UKR,Norway,NOR,0,5,14,10,29
2013,Uzbekistan,UZB,Norway,NOR,5,0,86,19,110
2013,Yemen,YEM,Norway,NOR,0,0,20,29,49
2013,Zimbabwe,ZWE,Norway,NOR,0,0,0,5,5
2013,Stateless,XXA,Norway,NOR,102,218,72,131,523
2013,Iran (Islamic Rep. of),IRN,Nauru,NRU,0,0,0,5,5
2013,Iraq,IRQ,Nauru,NRU,0,0,0,5,5
2013,Sri Lanka,LKA,Nauru,NRU,0,0,0,21,21
2013,Afghanistan,AFG,New Zealand,NZL,5,0,5,0,10
2013,Bahrain,BHR,New Zealand,NZL,0,0,5,0,5
2013,Bangladesh,BGD,New Zealand,NZL,0,0,10,0,10
2013,China,CHN,New Zealand,NZL,5,0,14,0,19
2013,Czechia,CZE,New Zealand,NZL,0,0,12,0,12
2013,Ethiopia,ETH,New Zealand,NZL,0,0,5,0,5
2013,Fiji,FJI,New Zealand,NZL,0,0,34,0,34
2013,Hungary,HUN,New Zealand,NZL,0,0,5,0,5
2013,Indonesia,IDN,New Zealand,NZL,0,0,10,0,10
2013,Iran (Islamic Rep. of),IRN,New Zealand,NZL,11,0,20,0,31
2013,Iraq,IRQ,New Zealand,NZL,5,0,5,0,10
2013,Jordan,JOR,New Zealand,NZL,0,0,5,0,5
2013,Dem. People's Rep. of Korea,PRK,New Zealand,NZL,0,0,5,0,5
2013,Sri Lanka,LKA,New Zealand,NZL,5,0,32,0,37
2013,Malaysia,MYS,New Zealand,NZL,0,0,5,0,5
2013,Myanmar,MMR,New Zealand,NZL,0,0,5,0,5
2013,Pakistan,PAK,New Zealand,NZL,5,0,12,0,17
2013,South Africa,ZAF,New Zealand,NZL,0,0,10,0,10
2013,Saudi Arabia,SAU,New Zealand,NZL,18,0,0,0,18
2013,Somalia,SOM,New Zealand,NZL,5,0,5,0,10
2013,Syrian Arab Rep.,SYR,New Zealand,NZL,5,0,0,0,5
2013,Tunisia,TUN,New Zealand,NZL,0,0,5,0,5
2013,Turkey,TUR,New Zealand,NZL,5,0,0,0,5
2013,Tuvalu,TUV,New Zealand,NZL,0,0,5,0,5
2013,United States of America,USA,New Zealand,NZL,0,0,5,0,5
2013,Zimbabwe,ZWE,New Zealand,NZL,0,0,5,0,5
2013,Cameroon,CMR,Panama,PAN,0,0,0,5,5
2013,Colombia,COL,Panama,PAN,227,0,38,219,484
2013,Cuba,CUB,Panama,PAN,5,0,0,13,18
2013,Ghana,GHA,Panama,PAN,0,0,0,18,18
2013,Haiti,HTI,Panama,PAN,0,0,0,5,5
2013,Nicaragua,NIC,Panama,PAN,0,0,0,5,5
2013,Nigeria,NGA,Panama,PAN,0,0,0,5,5
2013,El Salvador,SLV,Panama,PAN,0,0,0,5,5
2013,Venezuela (Bolivarian Republic of),VEN,Panama,PAN,0,0,5,5,10
2013,Cuba,CUB,Paraguay,PRY,0,0,0,5,5
2013,Bangladesh,BGD,Peru,PER,0,0,5,0,5
2013,Colombia,COL,Peru,PER,36,0,31,83,150
2013,Cuba,CUB,Peru,PER,13,0,47,10,70
2013,Dominican Rep.,DOM,Peru,PER,0,0,10,0,10
2013,Haiti,HTI,Peru,PER,5,0,0,125,130
2013,India,IND,Peru,PER,0,0,5,0,5
2013,Nepal,NPL,Peru,PER,0,0,0,5,5
2013,Nigeria,NGA,Peru,PER,5,0,0,0,5
2013,Senegal,SEN,Peru,PER,0,0,0,5,5
2013,Syrian Arab Rep.,SYR,Peru,PER,5,0,0,0,5
2013,Ukraine,UKR,Peru,PER,5,0,0,0,5
2013,Afghanistan,AFG,Philippines,PHL,5,0,0,0,5
2013,Palestinian,PSE,Philippines,PHL,0,0,0,5,5
2013,Cote d'Ivoire,CIV,Philippines,PHL,5,0,0,0,5
2013,Iran (Islamic Rep. of),IRN,Philippines,PHL,5,0,0,0,5
2013,Iraq,IRQ,Philippines,PHL,0,0,0,5,5
2013,Somalia,SOM,Philippines,PHL,5,0,0,0,5
2013,Syrian Arab Rep.,SYR,Philippines,PHL,11,0,0,0,11
2013,Iraq,IRQ,Papua New Guinea,PNG,0,0,0,5,5
2013,Afghanistan,AFG,Poland,POL,21,0,26,55,102
2013,Algeria,DZA,Poland,POL,0,0,0,5,5
2013,Egypt,EGY,Poland,POL,16,0,5,26,47
2013,Armenia,ARM,Poland,POL,0,23,86,181,290
2013,Azerbaijan,AZE,Poland,POL,0,0,0,5,5
2013,Bangladesh,BGD,Poland,POL,0,0,5,14,19
2013,Belarus,BLR,Poland,POL,19,5,16,15,55
2013,China,CHN,Poland,POL,0,0,0,5,5
2013,Cameroon,CMR,Poland,POL,0,5,0,5,10
2013,Congo,COG,Poland,POL,0,0,0,5,5
2013,Dem. Rep. of the Congo,COD,Poland,POL,0,0,5,0,5
2013,Eritrea,ERI,Poland,POL,0,0,0,5,5
2013,Palestinian,PSE,Poland,POL,0,0,0,5,5
2013,Georgia,GEO,Poland,POL,0,62,375,1463,1900
2013,Guinea,GIN,Poland,POL,0,0,0,5,5
2013,India,IND,Poland,POL,0,0,0,11,11
2013,Iran (Islamic Rep. of),IRN,Poland,POL,0,0,5,5,10
2013,Iraq,IRQ,Poland,POL,0,0,5,10,15
2013,Kazakhstan,KAZ,Poland,POL,0,10,27,86,123
2013,Kyrgyzstan,KGZ,Poland,POL,11,5,10,36,62
2013,Lebanon,LBN,Poland,POL,0,0,0,12,12
2013,Sri Lanka,LKA,Poland,POL,0,0,0,5,5
2013,Rep. of Moldova,MDA,Poland,POL,0,0,5,0,5
2013,Mongolia,MNG,Poland,POL,0,0,12,0,12
2013,Morocco,MAR,Poland,POL,0,0,0,5,5
2013,Nepal,NPL,Poland,POL,0,0,0,10,10
2013,Nigeria,NGA,Poland,POL,0,0,0,12,12
2013,Pakistan,PAK,Poland,POL,5,0,10,22,37
2013,Romania,ROU,Poland,POL,0,0,0,5,5
2013,Russian Federation,RUS,Poland,POL,23,358,1457,13814,15652
2013,Rwanda,RWA,Poland,POL,0,0,5,0,5
2013,Somalia,SOM,Poland,POL,0,10,0,0,10
2013,Viet Nam,VNM,Poland,POL,0,0,29,21,50
2013,Syrian Arab Rep.,SYR,Poland,POL,70,20,0,149,239
2013,Tajikistan,TJK,Poland,POL,0,0,0,5,5
2013,Turkmenistan,TKM,Poland,POL,0,0,0,5,5
2013,Tunisia,TUN,Poland,POL,0,0,0,5,5
2013,Turkey,TUR,Poland,POL,0,0,0,13,13
2013,Ukraine,UKR,Poland,POL,0,13,38,27,78
2013,Uzbekistan,UZB,Poland,POL,0,5,0,16,21
2013,Stateless,XXA,Poland,POL,27,0,0,25,52
2013,Afghanistan,AFG,Portugal,PRT,0,5,0,0,5
2013,Bangladesh,BGD,Portugal,PRT,0,0,0,5,5
2013,Belarus,BLR,Portugal,PRT,0,5,0,0,5
2013,Dem. Rep. of the Congo,COD,Portugal,PRT,0,13,0,5,18
2013,Colombia,COL,Portugal,PRT,0,5,0,0,5
2013,Gambia,GMB,Portugal,PRT,0,0,0,5,5
2013,Guinea-Bissau,GNB,Portugal,PRT,0,0,0,13,13
2013,Guinea,GIN,Portugal,PRT,5,22,0,59,86
2013,Cote d'Ivoire,CIV,Portugal,PRT,0,5,0,10,15
2013,Iran (Islamic Rep. of),IRN,Portugal,PRT,5,0,0,0,5
2013,Iraq,IRQ,Portugal,PRT,0,0,0,5,5
2013,Libya,LBY,Portugal,PRT,0,5,0,0,5
2013,Sri Lanka,LKA,Portugal,PRT,0,10,0,0,10
2013,Mali,MLI,Portugal,PRT,0,0,0,20,20
2013,Morocco,MAR,Portugal,PRT,0,0,0,11,11
2013,Nigeria,NGA,Portugal,PRT,0,5,0,41,46
2013,Pakistan,PAK,Portugal,PRT,5,0,0,5,10
2013,Russian Federation,RUS,Portugal,PRT,5,0,0,0,5
2013,Senegal,SEN,Portugal,PRT,0,0,0,35,35
2013,Sierra Leone,SLE,Portugal,PRT,0,0,0,5,5
2013,Somalia,SOM,Portugal,PRT,0,5,0,5,10
2013,Syrian Arab Rep.,SYR,Portugal,PRT,0,14,0,133,147
2013,Togo,TGO,Portugal,PRT,0,0,0,5,5
2013,Afghanistan,AFG,Romania,ROU,5,5,38,5,53
2013,Albania,ALB,Romania,ROU,0,0,5,5,10
2013,Algeria,DZA,Romania,ROU,0,0,5,5,10
2013,Egypt,EGY,Romania,ROU,10,0,25,5,40
2013,Armenia,ARM,Romania,ROU,0,0,5,0,5
2013,Bangladesh,BGD,Romania,ROU,0,0,25,0,25
2013,China,CHN,Romania,ROU,0,0,21,10,31
2013,Cameroon,CMR,Romania,ROU,5,0,5,0,10
2013,Dem. Rep. of the Congo,COD,Romania,ROU,0,0,5,0,5
2013,Cuba,CUB,Romania,ROU,0,0,0,5,5
2013,Gambia,GMB,Romania,ROU,0,0,5,0,5
2013,Palestinian,PSE,Romania,ROU,14,0,15,0,29
2013,Georgia,GEO,Romania,ROU,0,0,18,5,23
2013,Guinea-Bissau,GNB,Romania,ROU,0,0,5,0,5
2013,Guinea,GIN,Romania,ROU,5,0,0,0,5
2013,Cote d'Ivoire,CIV,Romania,ROU,0,0,5,0,5
2013,Iran (Islamic Rep. of),IRN,Romania,ROU,12,5,19,0,36
2013,Iraq,IRQ,Romania,ROU,19,5,16,0,40
2013,Jordan,JOR,Romania,ROU,0,0,5,0,5
2013,Kazakhstan,KAZ,Romania,ROU,0,0,5,0,5
2013,Lebanon,LBN,Romania,ROU,0,0,5,0,5
2013,Rep. of Moldova,MDA,Romania,ROU,0,0,14,0,14
2013,Morocco,MAR,Romania,ROU,0,0,13,0,13
2013,Myanmar,MMR,Romania,ROU,5,0,0,0,5
2013,Nepal,NPL,Romania,ROU,0,0,5,0,5
2013,Nigeria,NGA,Romania,ROU,0,0,0,14,14
2013,Pakistan,PAK,Romania,ROU,5,5,93,5,108
2013,Philippines,PHL,Romania,ROU,0,0,12,0,12
2013,Russian Federation,RUS,Romania,ROU,0,0,0,13,13
2013,Rwanda,RWA,Romania,ROU,5,0,0,0,5
2013,Serbia and Kosovo: S/RES/1244 (1999),SRB,Romania,ROU,0,0,5,0,5
2013,Senegal,SEN,Romania,ROU,0,0,5,0,5
2013,Somalia,SOM,Romania,ROU,0,0,5,0,5
2013,Viet Nam,VNM,Romania,ROU,0,0,5,0,5
2013,Sudan,SDN,Romania,ROU,0,11,0,0,11
2013,Syrian Arab Rep.,SYR,Romania,ROU,311,507,127,33,978
2013,Tunisia,TUN,Romania,ROU,0,0,14,5,19
2013,Turkey,TUR,Romania,ROU,0,0,20,5,25
2013,Ukraine,UKR,Romania,ROU,0,0,10,0,10
2013,United States of America,USA,Romania,ROU,0,0,5,0,5
2013,Stateless,XXA,Romania,ROU,12,5,5,0,22
2013,Algeria,DZA,South Africa,ZAF,0,0,129,0,129
2013,Angola,AGO,South Africa,ZAF,0,0,43,0,43
2013,Egypt,EGY,South Africa,ZAF,0,0,365,0,365
2013,Burundi,BDI,South Africa,ZAF,10,0,676,0,686
2013,Benin,BEN,South Africa,ZAF,0,0,45,0,45
2013,Bangladesh,BGD,South Africa,ZAF,5,0,3772,0,3777
2013,Burkina Faso,BFA,South Africa,ZAF,0,0,22,0,22
2013,Botswana,BWA,South Africa,ZAF,0,0,11,0,11
2013,Central African Rep.,CAF,South Africa,ZAF,0,0,5,0,5
2013,China,CHN,South Africa,ZAF,0,0,1409,0,1409
2013,Cameroon,CMR,South Africa,ZAF,5,0,648,0,653
2013,Congo,COG,South Africa,ZAF,317,0,833,0,1150
2013,Dem. Rep. of the Congo,COD,South Africa,ZAF,1104,0,5703,0,6807
2013,Comoros,COM,South Africa,ZAF,0,0,10,0,10
2013,Eritrea,ERI,South Africa,ZAF,168,0,68,0,236
2013,Ethiopia,ETH,South Africa,ZAF,2055,0,5270,0,7325
2013,Gabon,GAB,South Africa,ZAF,0,0,5,0,5
2013,Gambia,GMB,South Africa,ZAF,0,0,10,0,10
2013,Palestinian,PSE,South Africa,ZAF,0,0,5,0,5
2013,Ghana,GHA,South Africa,ZAF,0,0,2341,0,2341
2013,Guinea-Bissau,GNB,South Africa,ZAF,0,0,5,0,5
2013,Guinea,GIN,South Africa,ZAF,0,0,14,0,14
2013,Cote d'Ivoire,CIV,South Africa,ZAF,0,0,40,0,40
2013,India,IND,South Africa,ZAF,0,0,2272,0,2272
2013,Iran (Islamic Rep. of),IRN,South Africa,ZAF,0,0,10,0,10
2013,Jordan,JOR,South Africa,ZAF,0,0,5,0,5
2013,Kenya,KEN,South Africa,ZAF,0,0,299,0,299
2013,Liberia,LBR,South Africa,ZAF,0,0,5,0,5
2013,Lesotho,LSO,South Africa,ZAF,0,0,3027,0,3027
2013,Sri Lanka,LKA,South Africa,ZAF,0,0,15,0,15
2013,Mali,MLI,South Africa,ZAF,5,0,42,0,47
2013,Malawi,MWI,South Africa,ZAF,0,0,2843,0,2843
2013,Morocco,MAR,South Africa,ZAF,0,0,12,0,12
2013,Mozambique,MOZ,South Africa,ZAF,0,0,3188,0,3188
2013,Nepal,NPL,South Africa,ZAF,0,0,12,0,12
2013,Niger,NER,South Africa,ZAF,0,0,60,0,60
2013,Nigeria,NGA,South Africa,ZAF,0,0,6816,0,6816
2013,Pakistan,PAK,South Africa,ZAF,0,0,3167,0,3167
2013,Rwanda,RWA,South Africa,ZAF,5,0,135,0,140
2013,Senegal,SEN,South Africa,ZAF,0,0,353,0,353
2013,Sierra Leone,SLE,South Africa,ZAF,0,0,11,0,11
2013,Somalia,SOM,South Africa,ZAF,3579,0,520,0,4099
2013,Sudan,SDN,South Africa,ZAF,0,0,19,0,19
2013,Eswatini,SWZ,South Africa,ZAF,0,0,48,0,48
2013,Syrian Arab Rep.,SYR,South Africa,ZAF,5,0,5,0,10
2013,United Rep. of Tanzania,TZA,South Africa,ZAF,0,0,400,0,400
2013,Thailand,THA,South Africa,ZAF,0,0,10,0,10
2013,Togo,TGO,South Africa,ZAF,0,0,12,0,12
2013,Uganda,UGA,South Africa,ZAF,5,0,1364,0,1369
2013,Yemen,YEM,South Africa,ZAF,0,0,5,0,5
2013,Zambia,ZMB,South Africa,ZAF,0,0,177,0,177
2013,Zimbabwe,ZWE,South Africa,ZAF,12,0,14676,0,14688
2013,Afghanistan,AFG,Russian Federation,RUS,20,0,351,111,482
2013,Egypt,EGY,Russian Federation,RUS,5,0,68,0,73
2013,Armenia,ARM,Russian Federation,RUS,0,0,5,0,5
2013,Azerbaijan,AZE,Russian Federation,RUS,0,0,5,0,5
2013,Belarus,BLR,Russian Federation,RUS,0,0,5,5,10
2013,China,CHN,Russian Federation,RUS,0,0,0,5,5
2013,Congo,COG,Russian Federation,RUS,0,0,5,0,5
2013,Dem. Rep. of the Congo,COD,Russian Federation,RUS,0,0,5,17,22
2013,Eritrea,ERI,Russian Federation,RUS,0,0,0,5,5
2013,Georgia,GEO,Russian Federation,RUS,0,0,176,96,272
2013,Guinea,GIN,Russian Federation,RUS,0,0,5,0,5
2013,Iran (Islamic Rep. of),IRN,Russian Federation,RUS,0,0,5,0,5
2013,Iraq,IRQ,Russian Federation,RUS,0,0,0,11,11
2013,Kazakhstan,KAZ,Russian Federation,RUS,0,0,12,0,12
2013,Kyrgyzstan,KGZ,Russian Federation,RUS,0,0,19,16,35
2013,Dem. People's Rep. of Korea,PRK,Russian Federation,RUS,0,0,30,12,42
2013,Lebanon,LBN,Russian Federation,RUS,0,0,5,0,5
2013,Latvia,LVA,Russian Federation,RUS,0,0,0,5,5
2013,Rep. of Moldova,MDA,Russian Federation,RUS,0,0,5,0,5
2013,Nigeria,NGA,Russian Federation,RUS,0,0,0,5,5
2013,Pakistan,PAK,Russian Federation,RUS,0,0,10,0,10
2013,Somalia,SOM,Russian Federation,RUS,0,0,5,0,5
2013,Sudan,SDN,Russian Federation,RUS,0,0,19,0,19
2013,Syrian Arab Rep.,SYR,Russian Federation,RUS,0,0,710,74,784
2013,Tajikistan,TJK,Russian Federation,RUS,0,0,0,14,14
2013,Turkmenistan,TKM,Russian Federation,RUS,0,0,0,5,5
2013,Turkey,TUR,Russian Federation,RUS,0,0,0,5,5
2013,Ukraine,UKR,Russian Federation,RUS,0,0,10,5,15
2013,Uzbekistan,UZB,Russian Federation,RUS,11,0,52,14,77
2013,Afghanistan,AFG,Serbia and Kosovo: S/RES/1244 (1999),SRB,0,0,0,552,552
2013,Algeria,DZA,Serbia and Kosovo: S/RES/1244 (1999),SRB,0,0,10,248,258
2013,Egypt,EGY,Serbia and Kosovo: S/RES/1244 (1999),SRB,0,0,0,21,21
2013,Bangladesh,BGD,Serbia and Kosovo: S/RES/1244 (1999),SRB,0,0,0,67,67
2013,Burkina Faso,BFA,Serbia and Kosovo: S/RES/1244 (1999),SRB,0,0,0,16,16
2013,Chad,TCD,Serbia and Kosovo: S/RES/1244 (1999),SRB,0,0,0,5,5
2013,Cameroon,CMR,Serbia and Kosovo: S/RES/1244 (1999),SRB,0,0,0,36,36
2013,Congo,COG,Serbia and Kosovo: S/RES/1244 (1999),SRB,0,0,0,30,30
2013,Comoros,COM,Serbia and Kosovo: S/RES/1244 (1999),SRB,0,0,0,57,57
2013,Cuba,CUB,Serbia and Kosovo: S/RES/1244 (1999),SRB,0,0,0,11,11
2013,Eritrea,ERI,Serbia and Kosovo: S/RES/1244 (1999),SRB,0,0,0,613,613
2013,Ethiopia,ETH,Serbia and Kosovo: S/RES/1244 (1999),SRB,0,0,0,5,5
2013,Gabon,GAB,Serbia and Kosovo: S/RES/1244 (1999),SRB,0,0,0,5,5
2013,Gambia,GMB,Serbia and Kosovo: S/RES/1244 (1999),SRB,0,0,0,28,28
2013,Palestinian,PSE,Serbia and Kosovo: S/RES/1244 (1999),SRB,0,0,0,81,81
2013,Ghana,GHA,Serbia and Kosovo: S/RES/1244 (1999),SRB,0,0,0,72,72
2013,Guinea,GIN,Serbia and Kosovo: S/RES/1244 (1999),SRB,0,0,0,38,38
2013,Cote d'Ivoire,CIV,Serbia and Kosovo: S/RES/1244 (1999),SRB,0,0,0,114,114
2013,India,IND,Serbia and Kosovo: S/RES/1244 (1999),SRB,0,0,0,10,10
2013,Iran (Islamic Rep. of),IRN,Serbia and Kosovo: S/RES/1244 (1999),SRB,0,0,0,39,39
2013,Iraq,IRQ,Serbia and Kosovo: S/RES/1244 (1999),SRB,0,5,0,53,58
2013,Libya,LBY,Serbia and Kosovo: S/RES/1244 (1999),SRB,0,0,0,21,21
2013,Madagascar,MDG,Serbia and Kosovo: S/RES/1244 (1999),SRB,0,0,0,15,15
2013,Mauritania,MRT,Serbia and Kosovo: S/RES/1244 (1999),SRB,0,0,0,32,32
2013,Mali,MLI,Serbia and Kosovo: S/RES/1244 (1999),SRB,0,0,0,224,224
2013,Morocco,MAR,Serbia and Kosovo: S/RES/1244 (1999),SRB,0,0,5,92,97
2013,Nigeria,NGA,Serbia and Kosovo: S/RES/1244 (1999),SRB,0,0,0,119,119
2013,Pakistan,PAK,Serbia and Kosovo: S/RES/1244 (1999),SRB,0,0,0,203,203
2013,Rwanda,RWA,Serbia and Kosovo: S/RES/1244 (1999),SRB,0,0,0,10,10
2013,Senegal,SEN,Serbia and Kosovo: S/RES/1244 (1999),SRB,0,0,0,49,49
2013,Sierra Leone,SLE,Serbia and Kosovo: S/RES/1244 (1999),SRB,0,0,0,41,41
2013,Somalia,SOM,Serbia and Kosovo: S/RES/1244 (1999),SRB,0,0,5,515,520
2013,Sudan,SDN,Serbia and Kosovo: S/RES/1244 (1999),SRB,0,0,0,149,149
2013,Syrian Arab Rep.,SYR,Serbia and Kosovo: S/RES/1244 (1999),SRB,0,5,0,1346,1351
2013,United Rep. of Tanzania,TZA,Serbia and Kosovo: S/RES/1244 (1999),SRB,0,0,0,5,5
2013,Togo,TGO,Serbia and Kosovo: S/RES/1244 (1999),SRB,0,0,0,10,10
2013,Tunisia,TUN,Serbia and Kosovo: S/RES/1244 (1999),SRB,0,0,0,82,82
2013,Western Sahara,ESH,Serbia and Kosovo: S/RES/1244 (1999),SRB,0,0,0,5,5
2013,Yemen,YEM,Serbia and Kosovo: S/RES/1244 (1999),SRB,0,0,0,5,5
2013,Central African Rep.,CAF,Senegal,SEN,0,0,5,0,5
2013,Congo,COG,Senegal,SEN,0,0,5,0,5
2013,Dem. Rep. of the Congo,COD,Senegal,SEN,0,0,5,0,5
2013,Eritrea,ERI,Senegal,SEN,0,0,5,0,5
2013,Gambia,GMB,Senegal,SEN,14,0,0,0,14
2013,Guinea,GIN,Senegal,SEN,0,0,5,0,5
2013,Cote d'Ivoire,CIV,Senegal,SEN,0,0,16,0,16
2013,Liberia,LBR,Senegal,SEN,0,0,5,0,5
2013,Mauritania,MRT,Senegal,SEN,0,0,10,0,10
2013,Mali,MLI,Senegal,SEN,0,0,5,0,5
2013,Sierra Leone,SLE,Senegal,SEN,0,0,5,0,5
2013,Sudan,SDN,Senegal,SEN,0,0,5,0,5
2013,Cote d'Ivoire,CIV,Sierra Leone,SLE,0,0,0,38,38
2013,Afghanistan,AFG,Spain,ESP,5,21,0,0,26
2013,Albania,ALB,Spain,ESP,0,0,10,0,10
2013,Algeria,DZA,Spain,ESP,0,0,183,0,183
2013,Angola,AGO,Spain,ESP,0,0,5,0,5
2013,Egypt,EGY,Spain,ESP,5,0,0,0,5
2013,Argentina,ARG,Spain,ESP,0,0,5,0,5
2013,Armenia,ARM,Spain,ESP,0,0,10,0,10
2013,Bangladesh,BGD,Spain,ESP,0,0,18,0,18
2013,Burkina Faso,BFA,Spain,ESP,0,0,5,0,5
2013,Belarus,BLR,Spain,ESP,0,0,5,0,5
2013,Bolivia (Plurinational State of),BOL,Spain,ESP,5,0,0,0,5
2013,Chad,TCD,Spain,ESP,0,0,10,0,10
2013,Chile,CHL,Spain,ESP,0,0,5,0,5
2013,Cameroon,CMR,Spain,ESP,0,0,82,0,82
2013,Congo,COG,Spain,ESP,0,0,5,0,5
2013,Dem. Rep. of the Congo,COD,Spain,ESP,0,0,66,0,66
2013,Colombia,COL,Spain,ESP,5,0,45,0,50
2013,Cuba,CUB,Spain,ESP,0,16,21,0,37
2013,Equatorial Guinea,GNQ,Spain,ESP,0,0,5,0,5
2013,Eritrea,ERI,Spain,ESP,5,5,10,0,20
2013,Ethiopia,ETH,Spain,ESP,0,0,13,0,13
2013,Gambia,GMB,Spain,ESP,0,0,16,0,16
2013,Palestinian,PSE,Spain,ESP,63,11,13,0,87
2013,Georgia,GEO,Spain,ESP,0,0,5,0,5
2013,Ghana,GHA,Spain,ESP,0,0,22,0,22
2013,Guinea-Bissau,GNB,Spain,ESP,0,0,10,0,10
2013,Guatemala,GTM,Spain,ESP,0,5,5,0,10
2013,Guinea,GIN,Spain,ESP,0,0,103,0,103
2013,Honduras,HND,Spain,ESP,5,0,24,0,29
2013,Cote d'Ivoire,CIV,Spain,ESP,5,12,219,0,236
2013,India,IND,Spain,ESP,0,0,5,0,5
2013,Iran (Islamic Rep. of),IRN,Spain,ESP,10,0,0,0,10
2013,Iraq,IRQ,Spain,ESP,0,5,0,0,5
2013,Jordan,JOR,Spain,ESP,0,5,0,0,5
2013,Kazakhstan,KAZ,Spain,ESP,0,0,5,0,5
2013,Liberia,LBR,Spain,ESP,0,0,5,0,5
2013,Libya,LBY,Spain,ESP,5,0,14,0,19
2013,Sri Lanka,LKA,Spain,ESP,0,17,0,0,17
2013,Mauritania,MRT,Spain,ESP,0,0,5,0,5
2013,Mexico,MEX,Spain,ESP,0,0,5,0,5
2013,Mongolia,MNG,Spain,ESP,0,0,5,0,5
2013,Morocco,MAR,Spain,ESP,5,0,15,0,20
2013,Niger,NER,Spain,ESP,0,0,5,0,5
2013,Nicaragua,NIC,Spain,ESP,0,0,5,0,5
2013,Nigeria,NGA,Spain,ESP,5,0,167,0,172
2013,Pakistan,PAK,Spain,ESP,60,5,26,0,91
2013,Paraguay,PRY,Spain,ESP,0,0,5,0,5
2013,Peru,PER,Spain,ESP,0,0,5,0,5
2013,Romania,ROU,Spain,ESP,0,0,5,0,5
2013,Russian Federation,RUS,Spain,ESP,5,0,18,0,23
2013,El Salvador,SLV,Spain,ESP,0,5,5,0,10
2013,Senegal,SEN,Spain,ESP,5,0,23,0,28
2013,Sierra Leone,SLE,Spain,ESP,0,0,13,0,13
2013,Somalia,SOM,Spain,ESP,5,83,10,0,98
2013,Sudan,SDN,Spain,ESP,0,0,10,0,10
2013,Syrian Arab Rep.,SYR,Spain,ESP,5,147,0,0,152
2013,Togo,TGO,Spain,ESP,5,0,5,0,10
2013,Turkey,TUR,Spain,ESP,0,0,5,0,5
2013,Uganda,UGA,Spain,ESP,0,0,5,0,5
2013,Ukraine,UKR,Spain,ESP,0,0,11,0,11
2013,Uzbekistan,UZB,Spain,ESP,5,0,5,0,10
2013,Venezuela (Bolivarian Republic of),VEN,Spain,ESP,0,0,27,0,27
2013,Western Sahara,ESH,Spain,ESP,0,0,5,0,5
2013,Central African Rep.,CAF,Sudan,SDN,10,0,0,0,10
2013,Chad,TCD,Sudan,SDN,5,0,0,0,5
2013,Eritrea,ERI,Sudan,SDN,6709,0,440,15,7164
2013,Ethiopia,ETH,Sudan,SDN,210,0,5,0,215
2013,Guinea,GIN,Sudan,SDN,0,0,0,5,5
2013,Liberia,LBR,Sudan,SDN,0,0,17,0,17
2013,Nigeria,NGA,Sudan,SDN,0,0,0,5,5
2013,Sierra Leone,SLE,Sudan,SDN,0,0,5,0,5
2013,Somalia,SOM,Sudan,SDN,600,0,0,0,600
2013,Afghanistan,AFG,Slovakia,SVK,5,11,21,69,106
2013,Algeria,DZA,Slovakia,SVK,0,0,5,5,10
2013,Armenia,ARM,Slovakia,SVK,0,0,0,17,17
2013,Bangladesh,BGD,Slovakia,SVK,0,0,5,0,5
2013,Belarus,BLR,Slovakia,SVK,0,5,0,0,5
2013,China,CHN,Slovakia,SVK,0,0,0,11,11
2013,Cameroon,CMR,Slovakia,SVK,0,0,5,5,10
2013,Congo,COG,Slovakia,SVK,0,0,5,0,5
2013,Dem. Rep. of the Congo,COD,Slovakia,SVK,0,0,0,14,14
2013,Eritrea,ERI,Slovakia,SVK,0,12,12,31,55
2013,Ethiopia,ETH,Slovakia,SVK,0,0,0,5,5
2013,Palestinian,PSE,Slovakia,SVK,0,0,5,0,5
2013,Georgia,GEO,Slovakia,SVK,0,0,5,28,33
2013,India,IND,Slovakia,SVK,0,0,0,14,14
2013,Iran (Islamic Rep. of),IRN,Slovakia,SVK,0,0,0,10,10
2013,Iraq,IRQ,Slovakia,SVK,0,0,13,0,13
2013,Libya,LBY,Slovakia,SVK,0,0,0,5,5
2013,Rep. of Moldova,MDA,Slovakia,SVK,0,0,5,5,10
2013,Mongolia,MNG,Slovakia,SVK,0,0,0,5,5
2013,Nigeria,NGA,Slovakia,SVK,0,0,0,5,5
2013,Pakistan,PAK,Slovakia,SVK,0,0,5,15,20
2013,Russian Federation,RUS,Slovakia,SVK,0,0,13,13,26
2013,Somalia,SOM,Slovakia,SVK,5,5,56,53,119
2013,Viet Nam,VNM,Slovakia,SVK,0,0,0,5,5
2013,Syrian Arab Rep.,SYR,Slovakia,SVK,0,5,5,17,27
2013,Tunisia,TUN,Slovakia,SVK,0,0,0,10,10
2013,Turkey,TUR,Slovakia,SVK,0,0,5,5,10
2013,Ukraine,UKR,Slovakia,SVK,0,0,0,5,5
2013,Afghanistan,AFG,Slovenia,SVN,5,0,10,14,29
2013,Albania,ALB,Slovenia,SVN,0,0,0,5,5
2013,Algeria,DZA,Slovenia,SVN,0,0,5,16,21
2013,Bangladesh,BGD,Slovenia,SVN,0,0,0,5,5
2013,Bosnia and Herzegovina,BIH,Slovenia,SVN,0,0,5,5,10
2013,Cuba,CUB,Slovenia,SVN,0,0,0,5,5
2013,Eritrea,ERI,Slovenia,SVN,5,0,0,0,5
2013,Gambia,GMB,Slovenia,SVN,0,0,0,5,5
2013,Palestinian,PSE,Slovenia,SVN,0,5,0,0,5
2013,Iran (Islamic Rep. of),IRN,Slovenia,SVN,5,0,0,0,5
2013,Morocco,MAR,Slovenia,SVN,0,0,0,14,14
2013,Nigeria,NGA,Slovenia,SVN,0,0,0,5,5
2013,Pakistan,PAK,Slovenia,SVN,0,0,22,0,22
2013,Russian Federation,RUS,Slovenia,SVN,5,0,13,0,18
2013,Serbia and Kosovo: S/RES/1244 (1999),SRB,Slovenia,SVN,0,0,21,30,51
2013,Somalia,SOM,Slovenia,SVN,5,0,12,0,17
2013,Syrian Arab Rep.,SYR,Slovenia,SVN,5,5,5,47,62
2013,Tunisia,TUN,Slovenia,SVN,0,0,5,0,5
2013,Turkey,TUR,Slovenia,SVN,0,0,13,0,13
2013,Ukraine,UKR,Slovenia,SVN,0,0,0,5,5
2013,Afghanistan,AFG,Sweden,SWE,858,1216,803,189,3066
2013,Albania,ALB,Sweden,SWE,5,30,808,136,979
2013,Algeria,DZA,Sweden,SWE,5,0,68,135,208
2013,Angola,AGO,Sweden,SWE,0,0,13,0,13
2013,Egypt,EGY,Sweden,SWE,32,10,84,20,146
2013,Armenia,ARM,Sweden,SWE,5,40,276,37,358
2013,Austria,AUT,Sweden,SWE,0,0,5,0,5
2013,Azerbaijan,AZE,Sweden,SWE,45,37,156,29,267
2013,Burundi,BDI,Sweden,SWE,5,16,12,0,33
2013,Bangladesh,BGD,Sweden,SWE,23,5,94,5,127
2013,Belarus,BLR,Sweden,SWE,5,5,174,165,349
2013,Bolivia (Plurinational State of),BOL,Sweden,SWE,0,17,48,10,75
2013,Brazil,BRA,Sweden,SWE,0,5,0,0,5
2013,Bosnia and Herzegovina,BIH,Sweden,SWE,0,22,403,97,522
2013,Bulgaria,BGR,Sweden,SWE,0,0,5,12,17
2013,Chad,TCD,Sweden,SWE,0,0,0,5,5
2013,China,CHN,Sweden,SWE,16,0,17,10,43
2013,Chile,CHL,Sweden,SWE,0,5,18,5,28
2013,Cameroon,CMR,Sweden,SWE,15,30,19,5,69
2013,Congo,COG,Sweden,SWE,5,0,5,5,15
2013,Dem. Rep. of the Congo,COD,Sweden,SWE,21,5,36,5,67
2013,Comoros,COM,Sweden,SWE,5,0,0,0,5
2013,Colombia,COL,Sweden,SWE,0,5,14,5,24
2013,Cuba,CUB,Sweden,SWE,0,0,28,14,42
2013,Djibouti,DJI,Sweden,SWE,0,5,22,0,27
2013,Ecuador,ECU,Sweden,SWE,0,0,5,0,5
2013,Eritrea,ERI,Sweden,SWE,700,1828,35,109,2672
2013,Ethiopia,ETH,Sweden,SWE,89,47,170,23,329
2013,France,FRA,Sweden,SWE,0,0,5,0,5
2013,Gambia,GMB,Sweden,SWE,21,0,55,10,86
2013,United Kingdom of Great Britain and Northern Ireland,GBR,Sweden,SWE,0,5,0,0,5
2013,Georgia,GEO,Sweden,SWE,10,5,209,119,343
2013,Ghana,GHA,Sweden,SWE,10,5,25,12,52
2013,Guinea-Bissau,GNB,Sweden,SWE,0,0,13,0,13
2013,Greece,GRC,Sweden,SWE,0,0,0,14,14
2013,Guatemala,GTM,Sweden,SWE,0,0,5,0,5
2013,Guinea,GIN,Sweden,SWE,10,0,24,5,39
2013,Croatia,HRV,Sweden,SWE,0,0,16,10,26
2013,Hungary,HUN,Sweden,SWE,0,0,10,5,15
2013,Cote d'Ivoire,CIV,Sweden,SWE,12,0,12,5,29
2013,India,IND,Sweden,SWE,0,5,29,5,39
2013,Iran (Islamic Rep. of),IRN,Sweden,SWE,640,89,508,100,1337
2013,Iraq,IRQ,Sweden,SWE,198,179,596,128,1101
2013,Israel,ISR,Sweden,SWE,0,5,16,5,26
2013,Italy,ITA,Sweden,SWE,0,0,0,5,5
2013,Jordan,JOR,Sweden,SWE,5,12,70,25,112
2013,Kazakhstan,KAZ,Sweden,SWE,12,48,215,50,325
2013,Kenya,KEN,Sweden,SWE,10,5,26,5,46
2013,Kyrgyzstan,KGZ,Sweden,SWE,5,46,173,27,251
2013,Rep. of Korea,KOR,Sweden,SWE,0,0,0,5,5
2013,Dem. People's Rep. of Korea,PRK,Sweden,SWE,0,0,5,0,5
2013,Kuwait,KWT,Sweden,SWE,5,0,15,0,20
2013,Liberia,LBR,Sweden,SWE,0,0,10,0,10
2013,Libya,LBY,Sweden,SWE,22,5,46,58,131
2013,Lebanon,LBN,Sweden,SWE,17,74,201,46,338
2013,Sri Lanka,LKA,Sweden,SWE,5,0,22,0,27
2013,Mauritania,MRT,Sweden,SWE,0,0,13,0,13
2013,North Macedonia,MKD,Sweden,SWE,0,5,321,121,447
2013,Rep. of Moldova,MDA,Sweden,SWE,0,0,12,10,22
2013,Mali,MLI,Sweden,SWE,5,0,19,5,29
2013,Malaysia,MYS,Sweden,SWE,0,0,5,0,5
2013,Mongolia,MNG,Sweden,SWE,0,39,322,53,414
2013,Morocco,MAR,Sweden,SWE,14,24,201,169,408
2013,Montenegro,MNE,Sweden,SWE,0,5,64,19,88
2013,Myanmar,MMR,Sweden,SWE,0,0,0,5,5
2013,Nepal,NPL,Sweden,SWE,0,5,10,0,15
2013,Netherlands,NLD,Sweden,SWE,0,0,5,0,5
2013,Nicaragua,NIC,Sweden,SWE,0,0,13,5,18
2013,Nigeria,NGA,Sweden,SWE,59,19,227,50,355
2013,Pakistan,PAK,Sweden,SWE,39,15,162,24,240
2013,Peru,PER,Sweden,SWE,0,0,0,5,5
2013,Philippines,PHL,Sweden,SWE,0,0,5,5,10
2013,Poland,POL,Sweden,SWE,0,0,12,0,12
2013,Romania,ROU,Sweden,SWE,0,10,19,5,34
2013,Russian Federation,RUS,Sweden,SWE,166,127,398,149,840
2013,Rwanda,RWA,Sweden,SWE,0,0,14,0,14
2013,El Salvador,SLV,Sweden,SWE,0,5,33,5,43
2013,Saudi Arabia,SAU,Sweden,SWE,5,0,0,0,5
2013,Serbia and Kosovo: S/RES/1244 (1999),SRB,Sweden,SWE,0,104,1924,542,2570
2013,Senegal,SEN,Sweden,SWE,5,0,15,5,25
2013,Sierra Leone,SLE,Sweden,SWE,5,5,13,0,23
2013,Somalia,SOM,Sweden,SWE,844,768,980,494,3086
2013,Spain,ESP,Sweden,SWE,0,0,5,0,5
2013,Viet Nam,VNM,Sweden,SWE,0,5,27,16,48
2013,Sudan,SDN,Sweden,SWE,67,18,48,35,168
2013,Slovakia,SVK,Sweden,SWE,0,0,5,0,5
2013,Syrian Arab Rep.,SYR,Sweden,SWE,1921,9608,32,671,12232
2013,United Rep. of Tanzania,TZA,Sweden,SWE,0,0,15,5,20
2013,Thailand,THA,Sweden,SWE,0,0,0,14,14
2013,Tajikistan,TJK,Sweden,SWE,10,0,32,10,52
2013,Togo,TGO,Sweden,SWE,0,0,5,0,5
2013,Tunisia,TUN,Sweden,SWE,5,0,42,40,87
2013,Turkey,TUR,Sweden,SWE,10,22,106,27,165
2013,Uganda,UGA,Sweden,SWE,184,21,36,11,252
2013,Ukraine,UKR,Sweden,SWE,0,12,72,43,127
2013,United States of America,USA,Sweden,SWE,0,0,14,5,19
2013,Uzbekistan,UZB,Sweden,SWE,37,16,227,39,319
2013,Venezuela (Bolivarian Republic of),VEN,Sweden,SWE,0,0,12,0,12
2013,Yemen,YEM,Sweden,SWE,68,30,81,18,197
2013,Zimbabwe,ZWE,Sweden,SWE,5,0,0,5,10
2013,Stateless,XXA,Sweden,SWE,720,3236,432,234,4622
2013,Afghanistan,AFG,Switzerland,CHE,92,627,30,312,1061
2013,Albania,ALB,Switzerland,CHE,0,0,67,51,118
2013,Algeria,DZA,Switzerland,CHE,0,10,105,930,1045
2013,Angola,AGO,Switzerland,CHE,0,38,5,15,58
2013,Egypt,EGY,Switzerland,CHE,17,0,31,166,214
2013,Armenia,ARM,Switzerland,CHE,0,23,26,85,134
2013,Azerbaijan,AZE,Switzerland,CHE,0,5,5,10,20
2013,Burundi,BDI,Switzerland,CHE,0,0,0,5,5
2013,Benin,BEN,Switzerland,CHE,0,0,11,34,45
2013,Bangladesh,BGD,Switzerland,CHE,5,0,17,60,82
2013,Burkina Faso,BFA,Switzerland,CHE,0,0,5,29,34
2013,Belarus,BLR,Switzerland,CHE,5,0,21,140,166
2013,Brazil,BRA,Switzerland,CHE,0,5,0,0,5
2013,Bosnia and Herzegovina,BIH,Switzerland,CHE,10,46,132,121,309
2013,Bulgaria,BGR,Switzerland,CHE,0,0,5,12,17
2013,Cambodia,KHM,Switzerland,CHE,0,0,5,0,5
2013,Chad,TCD,Switzerland,CHE,5,0,0,30,35
2013,China,CHN,Switzerland,CHE,36,162,70,41,309
2013,Cameroon,CMR,Switzerland,CHE,5,25,0,60,90
2013,Congo,COG,Switzerland,CHE,0,5,0,0,5
2013,Dem. Rep. of the Congo,COD,Switzerland,CHE,5,82,37,57,181
2013,Colombia,COL,Switzerland,CHE,5,0,0,11,16
2013,Cuba,CUB,Switzerland,CHE,0,5,0,0,5
2013,Cabo Verde,CPV,Switzerland,CHE,0,0,0,5,5
2013,Czechia,CZE,Switzerland,CHE,0,0,0,5,5
2013,Djibouti,DJI,Switzerland,CHE,0,0,0,5,5
2013,Ecuador,ECU,Switzerland,CHE,0,5,0,0,5
2013,Equatorial Guinea,GNQ,Switzerland,CHE,0,0,0,5,5
2013,Eritrea,ERI,Switzerland,CHE,1883,534,58,372,2847
2013,Ethiopia,ETH,Switzerland,CHE,57,43,34,76,210
2013,France,FRA,Switzerland,CHE,0,0,0,5,5
2013,Gabon,GAB,Switzerland,CHE,0,0,0,5,5
2013,Gambia,GMB,Switzerland,CHE,0,5,60,597,662
2013,Georgia,GEO,Switzerland,CHE,0,5,54,669,728
2013,Germany,DEU,Switzerland,CHE,0,0,0,5,5
2013,Ghana,GHA,Switzerland,CHE,0,0,10,220,230
2013,Guinea-Bissau,GNB,Switzerland,CHE,0,10,102,324,436
2013,Guinea,GIN,Switzerland,CHE,0,10,57,343,410
2013,Haiti,HTI,Switzerland,CHE,0,0,0,11,11
2013,Croatia,HRV,Switzerland,CHE,0,0,5,5,10
2013,Hungary,HUN,Switzerland,CHE,0,0,21,13,34
2013,Cote d'Ivoire,CIV,Switzerland,CHE,5,10,10,97,122
2013,India,IND,Switzerland,CHE,0,0,0,22,22
2013,Iran (Islamic Rep. of),IRN,Switzerland,CHE,78,65,51,138,332
2013,Iraq,IRQ,Switzerland,CHE,92,156,67,182,497
2013,Israel,ISR,Switzerland,CHE,0,0,0,5,5
2013,Italy,ITA,Switzerland,CHE,0,0,0,21,21
2013,Jordan,JOR,Switzerland,CHE,0,13,0,0,13
2013,Kazakhstan,KAZ,Switzerland,CHE,0,5,15,10,30
2013,Kenya,KEN,Switzerland,CHE,0,0,5,12,17
2013,Kyrgyzstan,KGZ,Switzerland,CHE,0,13,0,5,18
2013,Dem. People's Rep. of Korea,PRK,Switzerland,CHE,0,0,0,10,10
2013,Liberia,LBR,Switzerland,CHE,0,5,0,58,63
2013,Libya,LBY,Switzerland,CHE,0,12,0,142,154
2013,Lebanon,LBN,Switzerland,CHE,0,5,0,24,29
2013,Sri Lanka,LKA,Switzerland,CHE,150,139,311,172,772
2013,Latvia,LVA,Switzerland,CHE,0,0,0,5,5
2013,Mauritania,MRT,Switzerland,CHE,0,0,10,56,66
2013,North Macedonia,MKD,Switzerland,CHE,0,5,130,77,212
2013,Rep. of Moldova,MDA,Switzerland,CHE,0,0,0,22,22
2013,Mali,MLI,Switzerland,CHE,0,0,5,249,254
2013,Mongolia,MNG,Switzerland,CHE,0,17,25,36,78
2013,Morocco,MAR,Switzerland,CHE,5,5,63,1220,1293
2013,Mozambique,MOZ,Switzerland,CHE,0,0,0,5,5
2013,Montenegro,MNE,Switzerland,CHE,0,0,15,18,33
2013,Myanmar,MMR,Switzerland,CHE,0,0,0,5,5
2013,Namibia,NAM,Switzerland,CHE,0,0,0,5,5
2013,Nepal,NPL,Switzerland,CHE,0,0,10,21,31
2013,Niger,NER,Switzerland,CHE,0,0,0,69,69
2013,Nigeria,NGA,Switzerland,CHE,0,26,109,2043,2178
2013,Pakistan,PAK,Switzerland,CHE,5,5,58,157,225
2013,Poland,POL,Switzerland,CHE,0,0,13,0,13
2013,Portugal,PRT,Switzerland,CHE,0,0,0,5,5
2013,Romania,ROU,Switzerland,CHE,0,0,13,21,34
2013,South Africa,ZAF,Switzerland,CHE,0,0,0,5,5
2013,Russian Federation,RUS,Switzerland,CHE,33,18,126,265,442
2013,Rwanda,RWA,Switzerland,CHE,0,11,0,0,11
2013,Saudi Arabia,SAU,Switzerland,CHE,0,0,0,5,5
2013,Serbia and Kosovo: S/RES/1244 (1999),SRB,Switzerland,CHE,11,166,502,740,1419
2013,Senegal,SEN,Switzerland,CHE,5,0,70,357,432
2013,Sierra Leone,SLE,Switzerland,CHE,0,5,0,76,81
2013,Somalia,SOM,Switzerland,CHE,184,343,10,185,722
2013,Spain,ESP,Switzerland,CHE,0,0,0,5,5
2013,Viet Nam,VNM,Switzerland,CHE,13,0,0,0,13
2013,Sudan,SDN,Switzerland,CHE,5,28,0,78,111
2013,South Sudan,SSD,Switzerland,CHE,0,0,0,14,14
2013,Slovakia,SVK,Switzerland,CHE,0,0,0,5,5
2013,Syrian Arab Rep.,SYR,Switzerland,CHE,162,577,77,341,1157
2013,United Rep. of Tanzania,TZA,Switzerland,CHE,0,0,0,5,5
2013,Tajikistan,TJK,Switzerland,CHE,0,0,5,0,5
2013,Togo,TGO,Switzerland,CHE,23,11,25,59,118
2013,Tunisia,TUN,Switzerland,CHE,5,0,88,1972,2065
2013,Turkey,TUR,Switzerland,CHE,181,28,254,147,610
2013,Uganda,UGA,Switzerland,CHE,0,5,0,11,16
2013,Ukraine,UKR,Switzerland,CHE,0,14,0,33,47
2013,Uzbekistan,UZB,Switzerland,CHE,5,0,0,5,10
2013,Samoa,WSM,Switzerland,CHE,0,0,0,11,11
2013,Yemen,YEM,Switzerland,CHE,10,0,13,19,42
2013,Zimbabwe,ZWE,Switzerland,CHE,0,0,5,10,15
2013,Stateless,XXA,Switzerland,CHE,0,0,0,14,14
2013,Angola,AGO,United Rep. of Tanzania,TZA,0,0,0,5,5
2013,Burundi,BDI,United Rep. of Tanzania,TZA,12,0,0,0,12
2013,Dem. Rep. of the Congo,COD,United Rep. of Tanzania,TZA,469,0,41,0,510
2013,Kenya,KEN,United Rep. of Tanzania,TZA,0,0,10,0,10
2013,Rwanda,RWA,United Rep. of Tanzania,TZA,10,0,0,0,10
2013,Somalia,SOM,United Rep. of Tanzania,TZA,0,0,0,5,5
2013,Sudan,SDN,United Rep. of Tanzania,TZA,0,0,0,5,5
2013,Central African Rep.,CAF,Togo,TGO,29,0,0,0,29
2013,Congo,COG,Togo,TGO,0,0,5,0,5
2013,Dem. Rep. of the Congo,COD,Togo,TGO,5,0,27,0,32
2013,Ghana,GHA,Togo,TGO,0,0,0,5,5
2013,Cote d'Ivoire,CIV,Togo,TGO,0,0,5,111,116
2013,Liberia,LBR,Togo,TGO,0,0,0,10,10
2013,Libya,LBY,Togo,TGO,0,0,5,0,5
2013,Sri Lanka,LKA,Togo,TGO,0,0,0,5,5
2013,Nigeria,NGA,Togo,TGO,0,0,5,0,5
2013,Pakistan,PAK,Togo,TGO,0,0,0,5,5
2013,Rwanda,RWA,Togo,TGO,0,0,0,10,10
2013,Syrian Arab Rep.,SYR,Togo,TGO,0,0,0,5,5
2013,Afghanistan,AFG,Ukraine,UKR,40,10,137,41,228
2013,Algeria,DZA,Ukraine,UKR,0,0,0,10,10
2013,Angola,AGO,Ukraine,UKR,0,0,5,0,5
2013,Egypt,EGY,Ukraine,UKR,0,0,5,0,5
2013,Armenia,ARM,Ukraine,UKR,0,0,5,0,5
2013,Azerbaijan,AZE,Ukraine,UKR,0,0,14,0,14
2013,Bangladesh,BGD,Ukraine,UKR,0,0,14,0,14
2013,Belarus,BLR,Ukraine,UKR,0,0,5,0,5
2013,Cameroon,CMR,Ukraine,UKR,0,0,5,0,5
2013,Dem. Rep. of the Congo,COD,Ukraine,UKR,0,0,14,5,19
2013,Eritrea,ERI,Ukraine,UKR,0,5,14,5,24
2013,Palestinian,PSE,Ukraine,UKR,0,0,5,5,10
2013,Georgia,GEO,Ukraine,UKR,0,0,5,5,10
2013,Cote d'Ivoire,CIV,Ukraine,UKR,0,0,5,5,10
2013,India,IND,Ukraine,UKR,0,0,0,5,5
2013,Iran (Islamic Rep. of),IRN,Ukraine,UKR,10,0,17,5,32
2013,Iraq,IRQ,Ukraine,UKR,5,0,5,5,15
2013,Jordan,JOR,Ukraine,UKR,0,0,0,5,5
2013,Kyrgyzstan,KGZ,Ukraine,UKR,0,0,5,11,16
2013,Lebanon,LBN,Ukraine,UKR,0,0,10,0,10
2013,Sri Lanka,LKA,Ukraine,UKR,0,0,0,14,14
2013,Nigeria,NGA,Ukraine,UKR,0,0,5,0,5
2013,Pakistan,PAK,Ukraine,UKR,0,0,14,5,19
2013,Russian Federation,RUS,Ukraine,UKR,0,0,17,17,34
2013,Sierra Leone,SLE,Ukraine,UKR,0,0,5,0,5
2013,Somalia,SOM,Ukraine,UKR,0,5,20,5,30
2013,Sudan,SDN,Ukraine,UKR,0,0,11,0,11
2013,Syrian Arab Rep.,SYR,Ukraine,UKR,10,99,104,19,232
2013,Tajikistan,TJK,Ukraine,UKR,0,0,5,0,5
2013,Turkey,TUR,Ukraine,UKR,0,0,5,0,5
2013,Uzbekistan,UZB,Ukraine,UKR,0,0,15,5,20
2013,Stateless,XXA,Ukraine,UKR,0,11,5,0,16
2013,Colombia,COL,Uruguay,URY,5,0,5,11,21
2013,Colombia,COL,Venezuela (Bolivarian Republic of),VEN,725,0,2613,0,3338
2013,Burundi,BDI,Zambia,ZMB,0,0,32,5,37
2013,Congo,COG,Zambia,ZMB,0,0,0,5,5
2013,Dem. Rep. of the Congo,COD,Zambia,ZMB,759,0,230,238,1227
2013,Equatorial Guinea,GNQ,Zambia,ZMB,0,0,0,5,5
2013,Ethiopia,ETH,Zambia,ZMB,0,0,0,14,14
2013,Somalia,SOM,Zambia,ZMB,0,0,0,292,292
2013,Sudan,SDN,Zambia,ZMB,0,0,0,5,5
2014,Eritrea,ERI,Albania,ALB,0,0,0,26,26
2014,Iran (Islamic Rep. of),IRN,Albania,ALB,0,0,0,20,20
2014,Serbia and Kosovo: S/RES/1244 (1999),SRB,Albania,ALB,0,10,0,0,10
2014,Somalia,SOM,Albania,ALB,0,0,0,5,5
2014,Sudan,SDN,Albania,ALB,0,0,0,5,5
2014,Syrian Arab Rep.,SYR,Albania,ALB,0,5,0,94,99
2014,Congo,COG,Angola,AGO,0,0,0,17,17
2014,Dem. Rep. of the Congo,COD,Angola,AGO,0,0,0,1800,1800
2014,Ethiopia,ETH,Angola,AGO,0,0,0,19,19
2014,Guinea,GIN,Angola,AGO,0,0,10,0,10
2014,Cote d'Ivoire,CIV,Angola,AGO,0,0,18,0,18
2014,Mauritania,MRT,Angola,AGO,0,0,11,11,22
2014,Rwanda,RWA,Angola,AGO,0,0,0,205,205
2014,Afghanistan,AFG,Argentina,ARG,5,0,0,0,5
2014,Egypt,EGY,Argentina,ARG,0,0,5,0,5
2014,Bangladesh,BGD,Argentina,ARG,0,0,5,0,5
2014,China,CHN,Argentina,ARG,0,0,5,0,5
2014,Chile,CHL,Argentina,ARG,0,0,0,5,5
2014,Cameroon,CMR,Argentina,ARG,0,0,0,5,5
2014,Dem. Rep. of the Congo,COD,Argentina,ARG,10,0,0,0,10
2014,Colombia,COL,Argentina,ARG,5,0,36,178,219
2014,Cuba,CUB,Argentina,ARG,0,0,82,22,104
2014,Dominican Rep.,DOM,Argentina,ARG,0,0,17,35,52
2014,Germany,DEU,Argentina,ARG,0,0,5,0,5
2014,Ghana,GHA,Argentina,ARG,5,0,0,5,10
2014,Haiti,HTI,Argentina,ARG,5,0,31,27,63
2014,Honduras,HND,Argentina,ARG,0,0,0,5,5
2014,Hungary,HUN,Argentina,ARG,0,0,5,0,5
2014,India,IND,Argentina,ARG,0,0,25,15,40
2014,Morocco,MAR,Argentina,ARG,0,0,5,0,5
2014,Nigeria,NGA,Argentina,ARG,5,0,0,11,16
2014,Pakistan,PAK,Argentina,ARG,13,0,0,0,13
2014,Paraguay,PRY,Argentina,ARG,5,0,0,0,5
2014,Peru,PER,Argentina,ARG,0,0,0,5,5
2014,Russian Federation,RUS,Argentina,ARG,0,0,5,0,5
2014,Senegal,SEN,Argentina,ARG,0,0,97,65,162
2014,Spain,ESP,Argentina,ARG,0,0,0,5,5
2014,Syrian Arab Rep.,SYR,Argentina,ARG,76,0,0,5,81
2014,Turkey,TUR,Argentina,ARG,5,0,0,0,5
2014,Ukraine,UKR,Argentina,ARG,0,0,5,0,5
2014,Azerbaijan,AZE,Armenia,ARM,5,0,0,0,5
2014,Iran (Islamic Rep. of),IRN,Armenia,ARM,0,0,14,13,27
2014,Iraq,IRQ,Armenia,ARM,22,0,0,0,22
2014,Syrian Arab Rep.,SYR,Armenia,ARM,65,0,0,18,83
2014,Ukraine,UKR,Armenia,ARM,43,0,0,46,89
2014,Afghanistan,AFG,Australia,AUS,100,0,363,0,463
2014,Albania,ALB,Australia,AUS,0,0,5,0,5
2014,Algeria,DZA,Australia,AUS,0,0,5,0,5
2014,Egypt,EGY,Australia,AUS,218,0,396,0,614
2014,Burundi,BDI,Australia,AUS,0,0,5,0,5
2014,Belgium,BEL,Australia,AUS,0,0,5,0,5
2014,Bangladesh,BGD,Australia,AUS,18,0,327,0,345
2014,Brazil,BRA,Australia,AUS,0,0,10,0,10
2014,Cambodia,KHM,Australia,AUS,0,0,5,0,5
2014,Canada,CAN,Australia,AUS,0,0,5,0,5
2014,China,CHN,Australia,AUS,86,0,1218,0,1304
2014,Chile,CHL,Australia,AUS,0,0,5,0,5
2014,Cameroon,CMR,Australia,AUS,0,0,5,0,5
2014,Congo,COG,Australia,AUS,0,0,5,0,5
2014,Dem. Rep. of the Congo,COD,Australia,AUS,0,0,5,0,5
2014,Colombia,COL,Australia,AUS,5,0,25,0,30
2014,Eritrea,ERI,Australia,AUS,17,0,5,0,22
2014,Ethiopia,ETH,Australia,AUS,28,0,26,0,54
2014,Fiji,FJI,Australia,AUS,29,0,441,0,470
2014,Palestinian,PSE,Australia,AUS,10,0,47,0,57
2014,Germany,DEU,Australia,AUS,5,0,0,0,5
2014,Ghana,GHA,Australia,AUS,0,0,14,0,14
2014,"China, Hong Kong SAR",HKG,Australia,AUS,0,0,12,0,12
2014,India,IND,Australia,AUS,23,0,872,0,895
2014,Indonesia,IDN,Australia,AUS,5,0,157,0,162
2014,Ireland,IRL,Australia,AUS,0,0,44,0,44
2014,Iran (Islamic Rep. of),IRN,Australia,AUS,291,0,392,0,683
2014,Iraq,IRQ,Australia,AUS,175,0,145,0,320
2014,Israel,ISR,Australia,AUS,0,0,5,0,5
2014,Italy,ITA,Australia,AUS,0,0,5,0,5
2014,Jordan,JOR,Australia,AUS,14,0,76,0,90
2014,Japan,JPN,Australia,AUS,0,0,5,0,5
2014,Kenya,KEN,Australia,AUS,10,0,24,0,34
2014,Rep. of Korea,KOR,Australia,AUS,0,0,93,0,93
2014,Dem. People's Rep. of Korea,PRK,Australia,AUS,0,0,5,0,5
2014,Libya,LBY,Australia,AUS,145,0,85,0,230
2014,Lebanon,LBN,Australia,AUS,31,0,248,0,279
2014,Sri Lanka,LKA,Australia,AUS,32,0,871,0,903
2014,Latvia,LVA,Australia,AUS,0,0,5,0,5
2014,Maldives,MDV,Australia,AUS,0,0,5,0,5
2014,Malaysia,MYS,Australia,AUS,10,0,231,0,241
2014,Mongolia,MNG,Australia,AUS,0,0,28,0,28
2014,Mauritius,MUS,Australia,AUS,5,0,11,0,16
2014,Myanmar,MMR,Australia,AUS,11,0,31,0,42
2014,Nepal,NPL,Australia,AUS,5,0,243,0,248
2014,Nicaragua,NIC,Australia,AUS,0,0,5,0,5
2014,Nigeria,NGA,Australia,AUS,14,0,47,0,61
2014,New Zealand,NZL,Australia,AUS,0,0,5,0,5
2014,Pakistan,PAK,Australia,AUS,315,0,676,0,991
2014,Peru,PER,Australia,AUS,0,0,19,0,19
2014,Philippines,PHL,Australia,AUS,0,0,49,0,49
2014,Papua New Guinea,PNG,Australia,AUS,60,0,50,0,110
2014,Romania,ROU,Australia,AUS,0,0,5,0,5
2014,South Africa,ZAF,Australia,AUS,0,0,14,0,14
2014,Russian Federation,RUS,Australia,AUS,5,0,12,0,17
2014,Rwanda,RWA,Australia,AUS,0,0,16,0,16
2014,Saudi Arabia,SAU,Australia,AUS,11,0,5,0,16
2014,Sierra Leone,SLE,Australia,AUS,0,0,5,0,5
2014,Somalia,SOM,Australia,AUS,5,0,5,0,10
2014,Viet Nam,VNM,Australia,AUS,5,0,94,0,99
2014,Sudan,SDN,Australia,AUS,0,0,5,0,5
2014,Syrian Arab Rep.,SYR,Australia,AUS,48,0,5,0,53
2014,Thailand,THA,Australia,AUS,0,0,12,0,12
2014,Tonga,TON,Australia,AUS,0,0,75,0,75
2014,Tunisia,TUN,Australia,AUS,0,0,5,0,5
2014,Turkey,TUR,Australia,AUS,38,0,55,0,93
2014,Ukraine,UKR,Australia,AUS,0,0,13,0,13
2014,United States of America,USA,Australia,AUS,0,0,11,0,11
2014,Venezuela (Bolivarian Republic of),VEN,Australia,AUS,0,0,5,0,5
2014,Zambia,ZMB,Australia,AUS,0,0,5,0,5
2014,Zimbabwe,ZWE,Australia,AUS,10,0,47,0,57
2014,Stateless,XXA,Australia,AUS,12,0,123,0,135
2014,Tibetan,TIB,Australia,AUS,0,0,5,0,5
2014,Afghanistan,AFG,Azerbaijan,AZE,0,0,195,5,200
2014,Iran (Islamic Rep. of),IRN,Azerbaijan,AZE,0,0,5,5,10
2014,Iraq,IRQ,Azerbaijan,AZE,0,0,14,0,14
2014,Pakistan,PAK,Azerbaijan,AZE,0,0,101,0,101
2014,Syrian Arab Rep.,SYR,Azerbaijan,AZE,0,0,5,0,5
2014,Ukraine,UKR,Azerbaijan,AZE,0,0,59,10,69
2014,Dem. Rep. of the Congo,COD,Burundi,BDI,5228,0,0,1190,6418
2014,Rwanda,RWA,Burundi,BDI,12,0,0,0,12
2014,Afghanistan,AFG,Belgium,BEL,804,459,315,424,2002
2014,Albania,ALB,Belgium,BEL,70,5,369,148,592
2014,Algeria,DZA,Belgium,BEL,19,0,80,44,143
2014,Angola,AGO,Belgium,BEL,10,0,159,40,209
2014,Egypt,EGY,Belgium,BEL,26,0,76,43,145
2014,Armenia,ARM,Belgium,BEL,15,10,155,110,290
2014,Azerbaijan,AZE,Belgium,BEL,24,0,47,57,128
2014,Burundi,BDI,Belgium,BEL,29,0,95,41,165
2014,Benin,BEN,Belgium,BEL,26,0,61,21,108
2014,Bangladesh,BGD,Belgium,BEL,5,0,267,103,375
2014,Bhutan,BTN,Belgium,BEL,0,0,0,5,5
2014,Burkina Faso,BFA,Belgium,BEL,10,0,50,16,76
2014,Belarus,BLR,Belgium,BEL,5,0,13,19,37
2014,Brazil,BRA,Belgium,BEL,0,0,5,0,5
2014,Bosnia and Herzegovina,BIH,Belgium,BEL,16,5,52,36,109
2014,Bulgaria,BGR,Belgium,BEL,0,0,5,13,18
2014,Central African Rep.,CAF,Belgium,BEL,24,14,5,5,48
2014,Chad,TCD,Belgium,BEL,5,0,14,5,24
2014,China,CHN,Belgium,BEL,250,0,322,36,608
2014,Cameroon,CMR,Belgium,BEL,106,0,205,65,376
2014,Congo,COG,Belgium,BEL,10,0,16,5,31
2014,Dem. Rep. of the Congo,COD,Belgium,BEL,220,5,631,220,1076
2014,Colombia,COL,Belgium,BEL,5,0,0,0,5
2014,Djibouti,DJI,Belgium,BEL,76,0,67,19,162
2014,Dominican Rep.,DOM,Belgium,BEL,0,0,5,0,5
2014,Eritrea,ERI,Belgium,BEL,211,0,34,18,263
2014,Ethiopia,ETH,Belgium,BEL,5,0,19,10,34
2014,Gabon,GAB,Belgium,BEL,0,0,5,0,5
2014,Gambia,GMB,Belgium,BEL,12,0,40,19,71
2014,Palestinian,PSE,Belgium,BEL,10,5,0,5,20
2014,Georgia,GEO,Belgium,BEL,23,0,154,121,298
2014,Ghana,GHA,Belgium,BEL,10,0,25,5,40
2014,Guinea-Bissau,GNB,Belgium,BEL,5,0,16,5,26
2014,Guatemala,GTM,Belgium,BEL,0,5,0,0,5
2014,Guinea,GIN,Belgium,BEL,648,13,461,465,1587
2014,Haiti,HTI,Belgium,BEL,0,0,16,0,16
2014,Honduras,HND,Belgium,BEL,0,0,5,0,5
2014,Croatia,HRV,Belgium,BEL,0,0,0,17,17
2014,Cote d'Ivoire,CIV,Belgium,BEL,36,0,105,40,181
2014,India,IND,Belgium,BEL,5,0,23,14,42
2014,Iran (Islamic Rep. of),IRN,Belgium,BEL,310,5,201,134,650
2014,Iraq,IRQ,Belgium,BEL,337,476,189,190,1192
2014,Israel,ISR,Belgium,BEL,0,0,0,5,5
2014,Jamaica,JAM,Belgium,BEL,5,0,0,0,5
2014,Jordan,JOR,Belgium,BEL,10,0,22,10,42
2014,Kazakhstan,KAZ,Belgium,BEL,15,0,33,34,82
2014,Kenya,KEN,Belgium,BEL,5,0,19,16,40
2014,Kyrgyzstan,KGZ,Belgium,BEL,20,0,48,36,104
2014,Dem. People's Rep. of Korea,PRK,Belgium,BEL,13,0,5,5,23
2014,Liberia,LBR,Belgium,BEL,5,0,11,19,35
2014,Libya,LBY,Belgium,BEL,13,11,5,22,51
2014,Lebanon,LBN,Belgium,BEL,19,0,70,37,126
2014,Sri Lanka,LKA,Belgium,BEL,71,0,25,32,128
2014,Madagascar,MDG,Belgium,BEL,0,0,0,5,5
2014,Mauritania,MRT,Belgium,BEL,67,5,82,77,231
2014,North Macedonia,MKD,Belgium,BEL,5,0,141,150,296
2014,Rep. of Moldova,MDA,Belgium,BEL,0,0,5,22,27
2014,Mali,MLI,Belgium,BEL,57,0,101,24,182
2014,Mongolia,MNG,Belgium,BEL,5,0,11,5,21
2014,Morocco,MAR,Belgium,BEL,26,0,80,54,160
2014,Montenegro,MNE,Belgium,BEL,0,0,11,0,11
2014,Mauritius,MUS,Belgium,BEL,0,0,5,0,5
2014,Myanmar,MMR,Belgium,BEL,0,0,28,10,38
2014,Nepal,NPL,Belgium,BEL,0,0,72,20,92
2014,Netherlands,NLD,Belgium,BEL,0,0,5,0,5
2014,Niger,NER,Belgium,BEL,22,0,41,19,82
2014,Nigeria,NGA,Belgium,BEL,5,0,85,35,125
2014,Pakistan,PAK,Belgium,BEL,61,13,304,194,572
2014,Romania,ROU,Belgium,BEL,10,0,11,0,21
2014,Russian Federation,RUS,Belgium,BEL,424,5,442,726,1597
2014,Rwanda,RWA,Belgium,BEL,146,0,223,65,434
2014,El Salvador,SLV,Belgium,BEL,5,0,29,0,34
2014,Serbia and Kosovo: S/RES/1244 (1999),SRB,Belgium,BEL,93,0,333,451,877
2014,Senegal,SEN,Belgium,BEL,70,0,200,60,330
2014,Sierra Leone,SLE,Belgium,BEL,10,0,34,40,84
2014,Somalia,SOM,Belgium,BEL,135,44,54,69,302
2014,Sudan,SDN,Belgium,BEL,23,0,34,15,72
2014,South Sudan,SSD,Belgium,BEL,5,0,0,0,5
2014,Syrian Arab Rep.,SYR,Belgium,BEL,1261,444,30,37,1772
2014,United Rep. of Tanzania,TZA,Belgium,BEL,5,0,21,19,45
2014,Tajikistan,TJK,Belgium,BEL,0,0,5,0,5
2014,Turkmenistan,TKM,Belgium,BEL,5,0,0,0,5
2014,Togo,TGO,Belgium,BEL,45,0,139,57,241
2014,Tunisia,TUN,Belgium,BEL,10,5,30,17,62
2014,Turkey,TUR,Belgium,BEL,86,0,169,133,388
2014,United Arab Emirates,ARE,Belgium,BEL,0,0,5,0,5
2014,Uganda,UGA,Belgium,BEL,5,0,22,5,32
2014,Ukraine,UKR,Belgium,BEL,12,0,130,70,212
2014,Uzbekistan,UZB,Belgium,BEL,12,0,0,0,12
2014,Venezuela (Bolivarian Republic of),VEN,Belgium,BEL,0,0,11,0,11
2014,Yemen,YEM,Belgium,BEL,5,0,5,11,21
2014,Central African Rep.,CAF,Benin,BEN,223,0,0,5,228
2014,Cote d'Ivoire,CIV,Benin,BEN,5,0,32,0,37
2014,Mali,MLI,Benin,BEN,0,0,5,0,5
2014,Algeria,DZA,Burkina Faso,BFA,0,0,0,5,5
2014,Angola,AGO,Burkina Faso,BFA,0,0,0,5,5
2014,Burundi,BDI,Burkina Faso,BFA,0,0,0,47,47
2014,Central African Rep.,CAF,Burkina Faso,BFA,27,0,0,111,138
2014,Chad,TCD,Burkina Faso,BFA,0,0,0,73,73
2014,Cameroon,CMR,Burkina Faso,BFA,0,0,0,19,19
2014,Congo,COG,Burkina Faso,BFA,0,0,0,80,80
2014,Dem. Rep. of the Congo,COD,Burkina Faso,BFA,0,0,0,49,49
2014,Guinea,GIN,Burkina Faso,BFA,0,0,0,5,5
2014,Cote d'Ivoire,CIV,Burkina Faso,BFA,0,0,0,221,221
2014,Sri Lanka,LKA,Burkina Faso,BFA,0,0,0,5,5
2014,Niger,NER,Burkina Faso,BFA,0,0,0,10,10
2014,Nigeria,NGA,Burkina Faso,BFA,0,0,0,24,24
2014,Rwanda,RWA,Burkina Faso,BFA,0,0,0,26,26
2014,Togo,TGO,Burkina Faso,BFA,0,0,0,67,67
2014,Afghanistan,AFG,Belarus,BLR,12,0,36,10,58
2014,Bangladesh,BGD,Belarus,BLR,0,0,5,0,5
2014,Dem. Rep. of the Congo,COD,Belarus,BLR,0,0,5,0,5
2014,Georgia,GEO,Belarus,BLR,0,0,13,0,13
2014,Iran (Islamic Rep. of),IRN,Belarus,BLR,0,0,5,0,5
2014,Iraq,IRQ,Belarus,BLR,0,11,0,0,11
2014,Sri Lanka,LKA,Belarus,BLR,0,0,0,5,5
2014,Pakistan,PAK,Belarus,BLR,0,0,0,5,5
2014,Russian Federation,RUS,Belarus,BLR,0,0,5,5,10
2014,Syrian Arab Rep.,SYR,Belarus,BLR,10,28,0,34,72
2014,Ukraine,UKR,Belarus,BLR,0,284,31,181,496
2014,Colombia,COL,Bolivia (Plurinational State of),BOL,11,0,5,0,16
2014,Pakistan,PAK,Bolivia (Plurinational State of),BOL,5,0,0,0,5
2014,Dem. Rep. of the Congo,COD,Botswana,BWA,0,0,26,0,26
2014,Rwanda,RWA,Botswana,BWA,0,0,5,0,5
2014,Somalia,SOM,Botswana,BWA,0,0,11,0,11
2014,Zimbabwe,ZWE,Botswana,BWA,0,0,5,0,5
2014,Afghanistan,AFG,Brazil,BRA,11,0,0,0,11
2014,Angola,AGO,Brazil,BRA,11,0,5,0,16
2014,Egypt,EGY,Brazil,BRA,5,0,0,0,5
2014,Burkina Faso,BFA,Brazil,BRA,0,0,5,0,5
2014,Bolivia (Plurinational State of),BOL,Brazil,BRA,5,0,0,0,5
2014,Cameroon,CMR,Brazil,BRA,14,0,5,0,19
2014,Dem. Rep. of the Congo,COD,Brazil,BRA,176,0,0,0,176
2014,Colombia,COL,Brazil,BRA,29,0,5,0,34
2014,Gambia,GMB,Brazil,BRA,0,0,5,0,5
2014,Palestinian,PSE,Brazil,BRA,103,0,0,0,103
2014,Guinea-Bissau,GNB,Brazil,BRA,0,0,48,0,48
2014,Guinea,GIN,Brazil,BRA,26,0,5,0,31
2014,Cote d'Ivoire,CIV,Brazil,BRA,10,0,0,0,10
2014,Iran (Islamic Rep. of),IRN,Brazil,BRA,5,0,0,0,5
2014,Iraq,IRQ,Brazil,BRA,16,0,0,0,16
2014,Lebanon,LBN,Brazil,BRA,361,0,0,0,361
2014,Mali,MLI,Brazil,BRA,40,0,5,0,45
2014,Nigeria,NGA,Brazil,BRA,34,0,54,0,88
2014,Pakistan,PAK,Brazil,BRA,10,0,0,0,10
2014,Senegal,SEN,Brazil,BRA,0,0,5,0,5
2014,Sierra Leone,SLE,Brazil,BRA,0,0,5,0,5
2014,Syrian Arab Rep.,SYR,Brazil,BRA,1405,0,0,0,1405
2014,Togo,TGO,Brazil,BRA,10,0,0,0,10
2014,United States of America,USA,Brazil,BRA,0,0,5,0,5
2014,Afghanistan,AFG,Bosnia and Herzegovina,BIH,0,0,0,10,10
2014,Algeria,DZA,Bosnia and Herzegovina,BIH,0,0,0,10,10
2014,Armenia,ARM,Bosnia and Herzegovina,BIH,0,0,5,0,5
2014,Iran (Islamic Rep. of),IRN,Bosnia and Herzegovina,BIH,0,0,5,0,5
2014,Iraq,IRQ,Bosnia and Herzegovina,BIH,0,5,0,0,5
2014,Serbia and Kosovo: S/RES/1244 (1999),SRB,Bosnia and Herzegovina,BIH,0,0,0,5,5
2014,Somalia,SOM,Bosnia and Herzegovina,BIH,0,0,0,5,5
2014,Sudan,SDN,Bosnia and Herzegovina,BIH,0,0,0,5,5
2014,Syrian Arab Rep.,SYR,Bosnia and Herzegovina,BIH,5,5,0,10,20
2014,Afghanistan,AFG,Bulgaria,BGR,5,18,104,2147,2274
2014,Algeria,DZA,Bulgaria,BGR,0,0,5,438,443
2014,Egypt,EGY,Bulgaria,BGR,0,0,5,10,15
2014,Armenia,ARM,Bulgaria,BGR,0,0,10,0,10
2014,Bangladesh,BGD,Bulgaria,BGR,0,0,0,13,13
2014,Burkina Faso,BFA,Bulgaria,BGR,0,0,0,5,5
2014,Cameroon,CMR,Bulgaria,BGR,0,0,10,85,95
2014,Congo,COG,Bulgaria,BGR,0,0,5,13,18
2014,Dem. Rep. of the Congo,COD,Bulgaria,BGR,0,0,0,18,18
2014,Eritrea,ERI,Bulgaria,BGR,0,0,5,23,28
2014,Ethiopia,ETH,Bulgaria,BGR,5,0,0,0,5
2014,Gambia,GMB,Bulgaria,BGR,0,0,5,15,20
2014,Palestinian,PSE,Bulgaria,BGR,5,0,0,0,5
2014,Georgia,GEO,Bulgaria,BGR,0,0,0,5,5
2014,Ghana,GHA,Bulgaria,BGR,0,0,17,108,125
2014,Guinea,GIN,Bulgaria,BGR,0,0,5,5,10
2014,Cote d'Ivoire,CIV,Bulgaria,BGR,0,0,18,69,87
2014,India,IND,Bulgaria,BGR,0,0,0,5,5
2014,Iran (Islamic Rep. of),IRN,Bulgaria,BGR,0,14,47,103,164
2014,Iraq,IRQ,Bulgaria,BGR,48,44,121,214,427
2014,Jordan,JOR,Bulgaria,BGR,0,5,0,0,5
2014,Liberia,LBR,Bulgaria,BGR,0,0,0,5,5
2014,Libya,LBY,Bulgaria,BGR,0,0,0,5,5
2014,Lebanon,LBN,Bulgaria,BGR,5,0,5,26,36
2014,Sri Lanka,LKA,Bulgaria,BGR,0,0,0,5,5
2014,Mali,MLI,Bulgaria,BGR,0,0,19,146,165
2014,Morocco,MAR,Bulgaria,BGR,0,0,0,88,88
2014,Myanmar,MMR,Bulgaria,BGR,0,0,0,10,10
2014,Niger,NER,Bulgaria,BGR,0,0,0,5,5
2014,Nigeria,NGA,Bulgaria,BGR,0,0,12,0,12
2014,Pakistan,PAK,Bulgaria,BGR,0,0,15,99,114
2014,Russian Federation,RUS,Bulgaria,BGR,0,0,5,0,5
2014,Rwanda,RWA,Bulgaria,BGR,0,0,11,27,38
2014,Senegal,SEN,Bulgaria,BGR,0,0,0,10,10
2014,Sierra Leone,SLE,Bulgaria,BGR,0,0,0,12,12
2014,Somalia,SOM,Bulgaria,BGR,5,0,21,72,98
2014,Sudan,SDN,Bulgaria,BGR,0,0,5,34,39
2014,Syrian Arab Rep.,SYR,Bulgaria,BGR,4821,1585,15,1109,7530
2014,Togo,TGO,Bulgaria,BGR,0,0,0,5,5
2014,Tunisia,TUN,Bulgaria,BGR,0,0,0,31,31
2014,Turkey,TUR,Bulgaria,BGR,0,0,11,0,11
2014,Uganda,UGA,Bulgaria,BGR,0,0,0,5,5
2014,Ukraine,UKR,Bulgaria,BGR,0,0,0,11,11
2014,Yemen,YEM,Bulgaria,BGR,0,0,0,11,11
2014,Stateless,XXA,Bulgaria,BGR,264,163,23,63,513
2014,Eritrea,ERI,Cambodia,KHM,0,0,5,0,5
2014,Pakistan,PAK,Cambodia,KHM,0,0,0,5,5
2014,Afghanistan,AFG,Canada,CAN,396,0,73,59,528
2014,Albania,ALB,Canada,CAN,145,0,158,25,328
2014,Algeria,DZA,Canada,CAN,62,0,120,5,187
2014,Angola,AGO,Canada,CAN,5,0,20,0,25
2014,Antigua and Barbuda,ATG,Canada,CAN,21,0,5,5,31
2014,Egypt,EGY,Canada,CAN,289,0,37,5,331
2014,Argentina,ARG,Canada,CAN,5,0,5,0,10
2014,Armenia,ARM,Canada,CAN,13,0,10,0,23
2014,Azerbaijan,AZE,Canada,CAN,13,0,0,0,13
2014,Bahrain,BHR,Canada,CAN,5,0,0,0,5
2014,Barbados,BRB,Canada,CAN,12,0,12,5,29
2014,Burundi,BDI,Canada,CAN,71,0,69,5,145
2014,Belgium,BEL,Canada,CAN,0,0,5,0,5
2014,Benin,BEN,Canada,CAN,5,0,5,0,10
2014,Bangladesh,BGD,Canada,CAN,235,0,110,13,358
2014,Bahamas,BHS,Canada,CAN,12,0,13,0,25
2014,Burkina Faso,BFA,Canada,CAN,12,0,5,0,17
2014,Belarus,BLR,Canada,CAN,0,0,11,0,11
2014,Bolivia (Plurinational State of),BOL,Canada,CAN,5,0,0,0,5
2014,Botswana,BWA,Canada,CAN,13,0,5,0,18
2014,Brazil,BRA,Canada,CAN,5,0,12,5,22
2014,Bosnia and Herzegovina,BIH,Canada,CAN,0,0,15,0,15
2014,Bulgaria,BGR,Canada,CAN,0,0,14,0,14
2014,Belize,BLZ,Canada,CAN,5,0,5,0,10
2014,Cambodia,KHM,Canada,CAN,5,0,25,5,35
2014,Central African Rep.,CAF,Canada,CAN,21,0,0,0,21
2014,Chad,TCD,Canada,CAN,41,0,21,0,62
2014,China,CHN,Canada,CAN,917,0,1041,192,2150
2014,Chile,CHL,Canada,CAN,0,0,12,0,12
2014,Cameroon,CMR,Canada,CAN,145,0,85,5,235
2014,Congo,COG,Canada,CAN,46,0,61,15,122
2014,Dem. Rep. of the Congo,COD,Canada,CAN,142,0,166,19,327
2014,Colombia,COL,Canada,CAN,406,0,329,59,794
2014,Costa Rica,CRI,Canada,CAN,0,0,5,5,10
2014,Cuba,CUB,Canada,CAN,120,0,56,27,203
2014,Czechia,CZE,Canada,CAN,19,0,63,15,97
2014,Djibouti,DJI,Canada,CAN,122,0,44,0,166
2014,Dominican Rep.,DOM,Canada,CAN,10,0,20,15,45
2014,Ecuador,ECU,Canada,CAN,0,0,11,0,11
2014,Eritrea,ERI,Canada,CAN,204,0,27,5,236
2014,Ethiopia,ETH,Canada,CAN,91,0,54,0,145
2014,Fiji,FJI,Canada,CAN,0,0,12,0,12
2014,France,FRA,Canada,CAN,0,0,12,5,17
2014,Gabon,GAB,Canada,CAN,5,0,0,0,5
2014,Gambia,GMB,Canada,CAN,11,0,5,0,16
2014,Palestinian,PSE,Canada,CAN,49,0,14,5,68
2014,United Kingdom of Great Britain and Northern Ireland,GBR,Canada,CAN,5,0,10,0,15
2014,Georgia,GEO,Canada,CAN,36,0,33,5,74
2014,Germany,DEU,Canada,CAN,0,0,5,0,5
2014,Ghana,GHA,Canada,CAN,37,0,44,10,91
2014,Greece,GRC,Canada,CAN,0,0,30,10,40
2014,Grenada,GRD,Canada,CAN,5,0,12,0,17
2014,Guatemala,GTM,Canada,CAN,41,0,64,11,116
2014,Guinea,GIN,Canada,CAN,64,0,48,5,117
2014,Guyana,GUY,Canada,CAN,15,0,13,0,28
2014,Haiti,HTI,Canada,CAN,202,0,270,23,495
2014,"China, Hong Kong SAR",HKG,Canada,CAN,0,0,0,12,12
2014,Honduras,HND,Canada,CAN,146,0,116,22,284
2014,Croatia,HRV,Canada,CAN,40,0,240,90,370
2014,Hungary,HUN,Canada,CAN,340,0,330,305,975
2014,Cote d'Ivoire,CIV,Canada,CAN,33,0,17,5,55
2014,India,IND,Canada,CAN,114,0,393,126,633
2014,Indonesia,IDN,Canada,CAN,14,0,0,0,14
2014,Ireland,IRL,Canada,CAN,0,0,0,11,11
2014,Iran (Islamic Rep. of),IRN,Canada,CAN,258,0,96,12,366
2014,Iraq,IRQ,Canada,CAN,333,0,39,34,406
2014,Israel,ISR,Canada,CAN,5,0,76,42,123
2014,Italy,ITA,Canada,CAN,0,0,26,5,31
2014,Jamaica,JAM,Canada,CAN,135,0,113,15,263
2014,Jordan,JOR,Canada,CAN,39,0,25,5,69
2014,Japan,JPN,Canada,CAN,0,0,0,5,5
2014,Kazakhstan,KAZ,Canada,CAN,26,0,0,0,26
2014,Kenya,KEN,Canada,CAN,32,0,24,5,61
2014,Kyrgyzstan,KGZ,Canada,CAN,0,0,5,0,5
2014,Rep. of Korea,KOR,Canada,CAN,5,0,108,29,142
2014,Dem. People's Rep. of Korea,PRK,Canada,CAN,0,0,113,402,515
2014,Kuwait,KWT,Canada,CAN,26,0,0,10,36
2014,Liberia,LBR,Canada,CAN,0,0,0,5,5
2014,Libya,LBY,Canada,CAN,107,0,20,5,132
2014,Saint Lucia,LCA,Canada,CAN,20,0,38,10,68
2014,Lebanon,LBN,Canada,CAN,88,0,112,5,205
2014,Sri Lanka,LKA,Canada,CAN,229,0,152,14,395
2014,Lithuania,LTU,Canada,CAN,0,0,10,14,24
2014,Latvia,LVA,Canada,CAN,14,0,0,0,14
2014,Madagascar,MDG,Canada,CAN,11,0,0,0,11
2014,Mauritania,MRT,Canada,CAN,10,0,11,0,21
2014,Rep. of Moldova,MDA,Canada,CAN,0,0,12,0,12
2014,Mexico,MEX,Canada,CAN,93,0,186,44,323
2014,Mali,MLI,Canada,CAN,22,0,26,0,48
2014,Malaysia,MYS,Canada,CAN,0,0,0,10,10
2014,Mongolia,MNG,Canada,CAN,27,0,10,0,37
2014,Morocco,MAR,Canada,CAN,19,0,17,5,41
2014,Malta,MLT,Canada,CAN,0,0,5,0,5
2014,Myanmar,MMR,Canada,CAN,0,0,5,0,5
2014,Namibia,NAM,Canada,CAN,31,0,126,22,179
2014,Nepal,NPL,Canada,CAN,30,0,13,0,43
2014,Netherlands,NLD,Canada,CAN,0,0,17,0,17
2014,Niger,NER,Canada,CAN,13,0,0,0,13
2014,Nicaragua,NIC,Canada,CAN,13,0,0,0,13
2014,Nigeria,NGA,Canada,CAN,332,0,279,22,633
2014,Norway,NOR,Canada,CAN,0,0,5,0,5
2014,Oman,OMN,Canada,CAN,0,0,0,5,5
2014,Pakistan,PAK,Canada,CAN,854,0,201,42,1097
2014,Panama,PAN,Canada,CAN,0,0,5,0,5
2014,Peru,PER,Canada,CAN,18,0,46,5,69
2014,Philippines,PHL,Canada,CAN,10,0,44,11,65
2014,Poland,POL,Canada,CAN,12,0,47,31,90
2014,Portugal,PRT,Canada,CAN,0,0,17,0,17
2014,Romania,ROU,Canada,CAN,10,0,15,61,86
2014,South Africa,ZAF,Canada,CAN,0,0,14,0,14
2014,Russian Federation,RUS,Canada,CAN,117,0,44,17,178
2014,Rwanda,RWA,Canada,CAN,63,0,35,5,103
2014,El Salvador,SLV,Canada,CAN,126,0,136,12,274
2014,Saudi Arabia,SAU,Canada,CAN,30,0,0,5,35
2014,Serbia and Kosovo: S/RES/1244 (1999),SRB,Canada,CAN,22,0,55,10,87
2014,Senegal,SEN,Canada,CAN,41,0,31,5,77
2014,Singapore,SGP,Canada,CAN,0,0,5,0,5
2014,Sierra Leone,SLE,Canada,CAN,5,0,5,0,10
2014,Somalia,SOM,Canada,CAN,189,0,83,53,325
2014,Spain,ESP,Canada,CAN,0,0,23,10,33
2014,Viet Nam,VNM,Canada,CAN,5,0,13,0,18
2014,Saint Kitts and Nevis,KNA,Canada,CAN,14,0,0,0,14
2014,Sudan,SDN,Canada,CAN,62,0,24,5,91
2014,Slovakia,SVK,Canada,CAN,197,0,140,42,379
2014,Eswatini,SWZ,Canada,CAN,5,0,0,0,5
2014,Syrian Arab Rep.,SYR,Canada,CAN,685,0,27,18,730
2014,United Rep. of Tanzania,TZA,Canada,CAN,13,0,10,0,23
2014,Turks and Caicos Islands,TCA,Canada,CAN,0,0,10,0,10
2014,Thailand,THA,Canada,CAN,5,0,0,0,5
2014,Tajikistan,TJK,Canada,CAN,10,0,0,0,10
2014,Turkmenistan,TKM,Canada,CAN,0,0,5,0,5
2014,Togo,TGO,Canada,CAN,14,0,18,0,32
2014,Trinidad and Tobago,TTO,Canada,CAN,10,0,25,0,35
2014,Tunisia,TUN,Canada,CAN,40,0,32,5,77
2014,Turkey,TUR,Canada,CAN,167,0,121,10,298
2014,Uganda,UGA,Canada,CAN,28,0,22,0,50
2014,Ukraine,UKR,Canada,CAN,214,0,132,23,369
2014,United States of America,USA,Canada,CAN,0,0,98,40,138
2014,Uzbekistan,UZB,Canada,CAN,28,0,5,5,38
2014,Saint Vincent and the Grenadines,VCT,Canada,CAN,45,0,71,15,131
2014,Venezuela (Bolivarian Republic of),VEN,Canada,CAN,90,0,53,5,148
2014,Yemen,YEM,Canada,CAN,22,0,19,0,41
2014,Zimbabwe,ZWE,Canada,CAN,56,0,23,0,79
2014,Stateless,XXA,Canada,CAN,22,0,10,0,32
2014,Chad,TCD,Central African Rep.,CAF,0,0,699,0,699
2014,Dem. Rep. of the Congo,COD,Central African Rep.,CAF,0,0,1049,0,1049
2014,Sudan,SDN,Central African Rep.,CAF,0,0,475,0,475
2014,Togo,TGO,Central African Rep.,CAF,0,0,19,0,19
2014,Colombia,COL,Chile,CHL,19,0,105,0,124
2014,Bangladesh,BGD,Colombia,COL,0,0,0,30,30
2014,Bhutan,BTN,Colombia,COL,0,0,0,5,5
2014,Bolivia (Plurinational State of),BOL,Colombia,COL,5,0,0,0,5
2014,Cuba,CUB,Colombia,COL,0,0,30,355,385
2014,Ecuador,ECU,Colombia,COL,0,0,5,0,5
2014,Eritrea,ERI,Colombia,COL,0,0,0,5,5
2014,Ghana,GHA,Colombia,COL,0,0,0,5,5
2014,India,IND,Colombia,COL,0,0,0,5,5
2014,Nepal,NPL,Colombia,COL,0,0,0,84,84
2014,Pakistan,PAK,Colombia,COL,0,0,0,5,5
2014,Somalia,SOM,Colombia,COL,0,0,0,47,47
2014,Syrian Arab Rep.,SYR,Colombia,COL,0,0,0,5,5
2014,Venezuela (Bolivarian Republic of),VEN,Colombia,COL,10,0,10,5,25
2014,Stateless,XXA,Colombia,COL,0,0,5,0,5
2014,Bangladesh,BGD,Costa Rica,CRI,0,0,5,0,5
2014,Colombia,COL,Costa Rica,CRI,32,0,486,154,672
2014,Cuba,CUB,Costa Rica,CRI,13,0,77,0,90
2014,Dominican Rep.,DOM,Costa Rica,CRI,0,0,5,0,5
2014,Eritrea,ERI,Costa Rica,CRI,0,0,0,5,5
2014,Ghana,GHA,Costa Rica,CRI,0,0,5,0,5
2014,Guatemala,GTM,Costa Rica,CRI,5,0,5,0,10
2014,Haiti,HTI,Costa Rica,CRI,0,0,0,10,10
2014,Honduras,HND,Costa Rica,CRI,16,0,52,0,68
2014,Mexico,MEX,Costa Rica,CRI,0,0,10,0,10
2014,Nepal,NPL,Costa Rica,CRI,0,0,0,51,51
2014,Nicaragua,NIC,Costa Rica,CRI,0,0,13,0,13
2014,Nigeria,NGA,Costa Rica,CRI,0,0,10,0,10
2014,El Salvador,SLV,Costa Rica,CRI,62,0,146,0,208
2014,Syrian Arab Rep.,SYR,Costa Rica,CRI,5,0,0,0,5
2014,Ukraine,UKR,Costa Rica,CRI,5,0,0,0,5
2014,Venezuela (Bolivarian Republic of),VEN,Costa Rica,CRI,13,0,63,0,76
2014,Egypt,EGY,Cyprus,CYP,0,0,29,21,50
2014,Bangladesh,BGD,Cyprus,CYP,0,0,52,32,84
2014,Cameroon,CMR,Cyprus,CYP,0,0,5,0,5
2014,Dem. Rep. of the Congo,COD,Cyprus,CYP,0,0,5,5,10
2014,India,IND,Cyprus,CYP,0,0,39,30,69
2014,Iran (Islamic Rep. of),IRN,Cyprus,CYP,0,5,0,0,5
2014,Iraq,IRQ,Cyprus,CYP,28,0,0,20,48
2014,Kazakhstan,KAZ,Cyprus,CYP,5,0,0,0,5
2014,Lebanon,LBN,Cyprus,CYP,5,0,0,0,5
2014,Sri Lanka,LKA,Cyprus,CYP,0,0,44,5,49
2014,Mali,MLI,Cyprus,CYP,0,0,5,0,5
2014,Nigeria,NGA,Cyprus,CYP,0,0,11,0,11
2014,Pakistan,PAK,Cyprus,CYP,0,0,32,52,84
2014,Philippines,PHL,Cyprus,CYP,0,0,23,11,34
2014,Somalia,SOM,Cyprus,CYP,13,5,0,16,34
2014,Viet Nam,VNM,Cyprus,CYP,0,0,53,24,77
2014,Syrian Arab Rep.,SYR,Cyprus,CYP,5,924,0,0,929
2014,Ukraine,UKR,Cyprus,CYP,0,0,0,10,10
2014,Afghanistan,AFG,Czechia,CZE,5,0,0,11,16
2014,Algeria,DZA,Czechia,CZE,0,0,0,13,13
2014,Egypt,EGY,Czechia,CZE,0,0,5,0,5
2014,Armenia,ARM,Czechia,CZE,5,5,10,13,33
2014,Azerbaijan,AZE,Czechia,CZE,0,0,5,5,10
2014,Belarus,BLR,Czechia,CZE,5,21,0,10,36
2014,China,CHN,Czechia,CZE,5,0,5,5,15
2014,Dem. Rep. of the Congo,COD,Czechia,CZE,0,0,0,5,5
2014,Cuba,CUB,Czechia,CZE,5,27,0,0,32
2014,Georgia,GEO,Czechia,CZE,0,0,15,10,25
2014,India,IND,Czechia,CZE,0,0,0,5,5
2014,Iran (Islamic Rep. of),IRN,Czechia,CZE,0,0,5,5,10
2014,Iraq,IRQ,Czechia,CZE,0,13,0,0,13
2014,Kazakhstan,KAZ,Czechia,CZE,0,12,0,5,17
2014,Kyrgyzstan,KGZ,Czechia,CZE,0,0,17,10,27
2014,Libya,LBY,Czechia,CZE,0,0,0,5,5
2014,Lebanon,LBN,Czechia,CZE,0,0,0,5,5
2014,North Macedonia,MKD,Czechia,CZE,0,0,5,0,5
2014,Rep. of Moldova,MDA,Czechia,CZE,0,0,5,5,10
2014,Mongolia,MNG,Czechia,CZE,0,0,10,10,20
2014,Myanmar,MMR,Czechia,CZE,5,0,0,0,5
2014,Nigeria,NGA,Czechia,CZE,0,0,13,20,33
2014,Pakistan,PAK,Czechia,CZE,0,5,0,0,5
2014,Russian Federation,RUS,Czechia,CZE,5,5,23,16,49
2014,Serbia and Kosovo: S/RES/1244 (1999),SRB,Czechia,CZE,0,0,5,13,18
2014,Viet Nam,VNM,Czechia,CZE,0,0,26,16,42
2014,Slovakia,SVK,Czechia,CZE,0,0,0,5,5
2014,Syrian Arab Rep.,SYR,Czechia,CZE,0,74,0,5,79
2014,Tunisia,TUN,Czechia,CZE,0,0,0,5,5
2014,Turkey,TUR,Czechia,CZE,0,0,15,5,20
2014,Ukraine,UKR,Czechia,CZE,25,119,106,120,370
2014,Uzbekistan,UZB,Czechia,CZE,5,0,0,0,5
2014,Yemen,YEM,Czechia,CZE,0,0,10,0,10
2014,Stateless,XXA,Czechia,CZE,5,18,5,5,33
2014,Afghanistan,AFG,Denmark,DNK,10,66,127,0,203
2014,Albania,ALB,Denmark,DNK,0,0,39,0,39
2014,Algeria,DZA,Denmark,DNK,0,0,18,0,18
2014,Egypt,EGY,Denmark,DNK,0,0,17,0,17
2014,Armenia,ARM,Denmark,DNK,0,0,57,0,57
2014,Azerbaijan,AZE,Denmark,DNK,5,0,13,0,18
2014,Benin,BEN,Denmark,DNK,0,0,5,0,5
2014,Bangladesh,BGD,Denmark,DNK,0,0,69,0,69
2014,Burkina Faso,BFA,Denmark,DNK,0,0,5,0,5
2014,Belarus,BLR,Denmark,DNK,0,0,15,0,15
2014,Bosnia and Herzegovina,BIH,Denmark,DNK,0,0,23,0,23
2014,China,CHN,Denmark,DNK,0,0,23,0,23
2014,Dem. Rep. of the Congo,COD,Denmark,DNK,5,0,14,0,19
2014,Eritrea,ERI,Denmark,DNK,193,16,10,0,219
2014,Ethiopia,ETH,Denmark,DNK,11,5,36,0,52
2014,Georgia,GEO,Denmark,DNK,0,0,24,0,24
2014,Ghana,GHA,Denmark,DNK,0,0,23,0,23
2014,Croatia,HRV,Denmark,DNK,0,0,5,0,5
2014,India,IND,Denmark,DNK,0,0,14,0,14
2014,Iran (Islamic Rep. of),IRN,Denmark,DNK,61,5,93,0,159
2014,Iraq,IRQ,Denmark,DNK,5,5,72,0,82
2014,Liberia,LBR,Denmark,DNK,0,0,5,0,5
2014,Lebanon,LBN,Denmark,DNK,0,5,21,0,26
2014,Sri Lanka,LKA,Denmark,DNK,0,0,16,0,16
2014,Lithuania,LTU,Denmark,DNK,0,0,5,0,5
2014,North Macedonia,MKD,Denmark,DNK,0,0,18,0,18
2014,Morocco,MAR,Denmark,DNK,0,0,30,0,30
2014,Montenegro,MNE,Denmark,DNK,0,0,5,0,5
2014,Myanmar,MMR,Denmark,DNK,0,0,23,0,23
2014,Nepal,NPL,Denmark,DNK,0,0,5,0,5
2014,Nigeria,NGA,Denmark,DNK,0,0,38,0,38
2014,Pakistan,PAK,Denmark,DNK,0,0,35,0,35
2014,Poland,POL,Denmark,DNK,0,0,5,0,5
2014,Romania,ROU,Denmark,DNK,0,0,5,0,5
2014,Russian Federation,RUS,Denmark,DNK,25,66,245,0,336
2014,Serbia and Kosovo: S/RES/1244 (1999),SRB,Denmark,DNK,0,0,136,0,136
2014,Senegal,SEN,Denmark,DNK,0,0,5,0,5
2014,Sierra Leone,SLE,Denmark,DNK,0,0,5,0,5
2014,Somalia,SOM,Denmark,DNK,5,353,305,0,663
2014,Viet Nam,VNM,Denmark,DNK,0,0,5,0,5
2014,Sudan,SDN,Denmark,DNK,0,0,13,0,13
2014,Syrian Arab Rep.,SYR,Denmark,DNK,3122,864,137,0,4123
2014,Tunisia,TUN,Denmark,DNK,0,0,11,0,11
2014,Uganda,UGA,Denmark,DNK,10,0,12,0,22
2014,Ukraine,UKR,Denmark,DNK,0,0,10,0,10
2014,Uzbekistan,UZB,Denmark,DNK,0,0,5,0,5
2014,Stateless,XXA,Denmark,DNK,291,256,68,0,615
2014,Eritrea,ERI,Djibouti,DJI,17,0,0,48,65
2014,Ethiopia,ETH,Djibouti,DJI,42,0,0,18,60
2014,Iraq,IRQ,Djibouti,DJI,5,0,0,0,5
2014,Colombia,COL,Dominican Rep.,DOM,0,0,5,0,5
2014,Cuba,CUB,Dominican Rep.,DOM,0,0,0,5,5
2014,Haiti,HTI,Dominican Rep.,DOM,0,0,20,32,52
2014,Egypt,EGY,Estonia,EST,0,0,5,5,10
2014,Belarus,BLR,Estonia,EST,0,0,0,5,5
2014,Georgia,GEO,Estonia,EST,0,0,5,0,5
2014,Russian Federation,RUS,Estonia,EST,0,0,5,5,10
2014,Serbia and Kosovo: S/RES/1244 (1999),SRB,Estonia,EST,5,0,0,0,5
2014,Sudan,SDN,Estonia,EST,5,0,0,0,5
2014,Syrian Arab Rep.,SYR,Estonia,EST,0,0,13,0,13
2014,Ukraine,UKR,Estonia,EST,0,0,0,14,14
2014,Afghanistan,AFG,Finland,FIN,24,95,33,54,206
2014,Albania,ALB,Finland,FIN,0,0,78,20,98
2014,Algeria,DZA,Finland,FIN,0,0,16,66,82
2014,Angola,AGO,Finland,FIN,10,5,5,11,31
2014,Egypt,EGY,Finland,FIN,5,0,5,13,23
2014,Bangladesh,BGD,Finland,FIN,0,5,11,5,21
2014,Burkina Faso,BFA,Finland,FIN,0,5,0,5,10
2014,Belarus,BLR,Finland,FIN,5,0,5,25,35
2014,Bosnia and Herzegovina,BIH,Finland,FIN,0,0,10,0,10
2014,China,CHN,Finland,FIN,12,0,0,5,17
2014,Cameroon,CMR,Finland,FIN,13,10,11,12,46
2014,Dem. Rep. of the Congo,COD,Finland,FIN,5,18,13,5,41
2014,Cuba,CUB,Finland,FIN,0,5,5,0,10
2014,Eritrea,ERI,Finland,FIN,0,5,0,0,5
2014,Ethiopia,ETH,Finland,FIN,0,14,5,5,24
2014,Gambia,GMB,Finland,FIN,5,10,34,27,76
2014,Georgia,GEO,Finland,FIN,0,0,10,17,27
2014,Germany,DEU,Finland,FIN,0,0,5,0,5
2014,Ghana,GHA,Finland,FIN,5,10,19,20,54
2014,Guinea-Bissau,GNB,Finland,FIN,0,0,0,5,5
2014,Guinea,GIN,Finland,FIN,0,5,5,5,15
2014,Cote d'Ivoire,CIV,Finland,FIN,0,0,0,5,5
2014,India,IND,Finland,FIN,0,0,5,0,5
2014,Iran (Islamic Rep. of),IRN,Finland,FIN,77,32,31,31,171
2014,Iraq,IRQ,Finland,FIN,123,243,134,289,789
2014,Israel,ISR,Finland,FIN,0,0,0,5,5
2014,Jordan,JOR,Finland,FIN,0,0,0,14,14
2014,Kenya,KEN,Finland,FIN,0,0,5,12,17
2014,Kyrgyzstan,KGZ,Finland,FIN,0,5,0,0,5
2014,Liberia,LBR,Finland,FIN,0,5,0,0,5
2014,Libya,LBY,Finland,FIN,0,0,0,32,32
2014,Lebanon,LBN,Finland,FIN,0,0,0,5,5
2014,Sri Lanka,LKA,Finland,FIN,5,5,5,11,26
2014,Mauritania,MRT,Finland,FIN,0,0,0,5,5
2014,North Macedonia,MKD,Finland,FIN,0,0,0,5,5
2014,Mali,MLI,Finland,FIN,0,5,5,0,10
2014,Morocco,MAR,Finland,FIN,5,0,10,62,77
2014,Mozambique,MOZ,Finland,FIN,0,0,0,5,5
2014,Montenegro,MNE,Finland,FIN,0,0,5,0,5
2014,Niger,NER,Finland,FIN,0,0,0,5,5
2014,Nigeria,NGA,Finland,FIN,5,63,77,96,241
2014,Pakistan,PAK,Finland,FIN,5,0,5,25,35
2014,Russian Federation,RUS,Finland,FIN,75,43,156,21,295
2014,Rwanda,RWA,Finland,FIN,5,0,0,0,5
2014,El Salvador,SLV,Finland,FIN,0,5,0,0,5
2014,Saudi Arabia,SAU,Finland,FIN,0,0,0,5,5
2014,Serbia and Kosovo: S/RES/1244 (1999),SRB,Finland,FIN,0,18,84,28,130
2014,Senegal,SEN,Finland,FIN,0,0,5,5,10
2014,Sierra Leone,SLE,Finland,FIN,5,0,0,0,5
2014,Somalia,SOM,Finland,FIN,33,125,14,74,246
2014,Viet Nam,VNM,Finland,FIN,0,0,10,5,15
2014,Sudan,SDN,Finland,FIN,0,0,0,14,14
2014,Syrian Arab Rep.,SYR,Finland,FIN,35,60,10,44,149
2014,Togo,TGO,Finland,FIN,0,0,0,5,5
2014,Tunisia,TUN,Finland,FIN,0,0,5,26,31
2014,Turkey,TUR,Finland,FIN,5,25,33,13,76
2014,Uganda,UGA,Finland,FIN,0,0,0,5,5
2014,Ukraine,UKR,Finland,FIN,0,5,200,54,259
2014,United States of America,USA,Finland,FIN,0,0,0,11,11
2014,Stateless,XXA,Finland,FIN,28,5,5,10,48
2014,Afghanistan,AFG,France,FRA,255,230,110,0,595
2014,Albania,ALB,France,FRA,67,277,3479,0,3823
2014,Algeria,DZA,France,FRA,48,23,986,0,1057
2014,Angola,AGO,France,FRA,27,10,356,0,393
2014,Egypt,EGY,France,FRA,119,5,278,0,402
2014,Armenia,ARM,France,FRA,59,29,1429,0,1517
2014,Azerbaijan,AZE,France,FRA,116,5,660,0,781
2014,Bahrain,BHR,France,FRA,5,0,0,0,5
2014,Burundi,BDI,France,FRA,13,0,13,0,26
2014,Benin,BEN,France,FRA,0,0,23,0,23
2014,Bangladesh,BGD,France,FRA,193,10,3458,0,3661
2014,Bhutan,BTN,France,FRA,0,0,22,0,22
2014,Burkina Faso,BFA,France,FRA,5,0,30,0,35
2014,Belarus,BLR,France,FRA,10,0,46,0,56
2014,Bolivia (Plurinational State of),BOL,France,FRA,0,0,5,0,5
2014,Brazil,BRA,France,FRA,0,0,13,0,13
2014,Bosnia and Herzegovina,BIH,France,FRA,27,21,468,0,516
2014,Cambodia,KHM,France,FRA,0,0,33,0,33
2014,Central African Rep.,CAF,France,FRA,130,250,18,0,398
2014,Chad,TCD,France,FRA,25,0,209,0,234
2014,China,CHN,France,FRA,600,5,1954,0,2559
2014,Chile,CHL,France,FRA,0,0,5,0,5
2014,Cameroon,CMR,France,FRA,27,5,190,0,222
2014,Congo,COG,France,FRA,32,5,602,0,639
2014,Dem. Rep. of the Congo,COD,France,FRA,379,36,3706,0,4121
2014,Comoros,COM,France,FRA,32,5,532,0,569
2014,Colombia,COL,France,FRA,10,0,62,0,72
2014,Cuba,CUB,France,FRA,5,0,29,0,34
2014,Cabo Verde,CPV,France,FRA,0,0,10,0,10
2014,Djibouti,DJI,France,FRA,11,0,15,0,26
2014,Dominica,DMA,France,FRA,0,0,13,0,13
2014,Dominican Rep.,DOM,France,FRA,0,5,212,0,217
2014,Ecuador,ECU,France,FRA,5,0,0,0,5
2014,Eritrea,ERI,France,FRA,70,0,404,0,474
2014,Ethiopia,ETH,France,FRA,15,0,38,0,53
2014,Gabon,GAB,France,FRA,0,0,17,0,17
2014,Gambia,GMB,France,FRA,21,0,52,0,73
2014,Palestinian,PSE,France,FRA,102,5,14,0,121
2014,Georgia,GEO,France,FRA,80,27,1704,0,1811
2014,Ghana,GHA,France,FRA,0,0,18,0,18
2014,Guinea-Bissau,GNB,France,FRA,10,0,105,0,115
2014,Guinea,GIN,France,FRA,436,45,1544,0,2025
2014,Guyana,GUY,France,FRA,5,0,44,0,49
2014,Haiti,HTI,France,FRA,13,13,1572,0,1598
2014,Honduras,HND,France,FRA,0,0,5,0,5
2014,Cote d'Ivoire,CIV,France,FRA,151,12,678,0,841
2014,India,IND,France,FRA,0,5,39,0,44
2014,Iran (Islamic Rep. of),IRN,France,FRA,88,11,50,0,149
2014,Iraq,IRQ,France,FRA,384,0,27,0,411
2014,Jamaica,JAM,France,FRA,0,0,10,0,10
2014,Kazakhstan,KAZ,France,FRA,23,0,99,0,122
2014,Kenya,KEN,France,FRA,0,0,14,0,14
2014,Kyrgyzstan,KGZ,France,FRA,16,0,30,0,46
2014,Dem. People's Rep. of Korea,PRK,France,FRA,13,0,24,0,37
2014,Kuwait,KWT,France,FRA,0,0,5,0,5
2014,Liberia,LBR,France,FRA,0,0,10,0,10
2014,Libya,LBY,France,FRA,11,0,78,0,89
2014,Saint Lucia,LCA,France,FRA,0,0,10,0,10
2014,Lebanon,LBN,France,FRA,0,0,38,0,38
2014,Sri Lanka,LKA,France,FRA,407,39,1492,0,1938
2014,Madagascar,MDG,France,FRA,5,0,73,0,78
2014,Mauritania,MRT,France,FRA,77,5,732,0,814
2014,North Macedonia,MKD,France,FRA,5,0,142,0,147
2014,Rep. of Moldova,MDA,France,FRA,0,0,22,0,22
2014,Mali,MLI,France,FRA,264,19,1345,0,1628
2014,Mongolia,MNG,France,FRA,5,10,117,0,132
2014,Morocco,MAR,France,FRA,22,5,98,0,125
2014,Montenegro,MNE,France,FRA,5,0,145,0,150
2014,Mauritius,MUS,France,FRA,5,0,0,0,5
2014,Myanmar,MMR,France,FRA,10,0,189,0,199
2014,Nepal,NPL,France,FRA,0,0,49,0,49
2014,Niger,NER,France,FRA,0,0,10,0,10
2014,Nigeria,NGA,France,FRA,30,38,784,0,852
2014,Pakistan,PAK,France,FRA,97,20,1577,0,1694
2014,Peru,PER,France,FRA,5,5,48,0,58
2014,South Africa,ZAF,France,FRA,0,0,10,0,10
2014,Russian Federation,RUS,France,FRA,459,38,2502,0,2999
2014,Rwanda,RWA,France,FRA,82,0,93,0,175
2014,Serbia and Kosovo: S/RES/1244 (1999),SRB,France,FRA,179,106,3632,0,3917
2014,Senegal,SEN,France,FRA,75,0,175,0,250
2014,Sierra Leone,SLE,France,FRA,12,0,44,0,56
2014,Somalia,SOM,France,FRA,22,36,460,0,518
2014,Viet Nam,VNM,France,FRA,5,0,35,0,40
2014,Sudan,SDN,France,FRA,159,11,1110,0,1280
2014,Syrian Arab Rep.,SYR,France,FRA,884,520,63,0,1467
2014,United Rep. of Tanzania,TZA,France,FRA,0,0,11,0,11
2014,Thailand,THA,France,FRA,0,0,5,0,5
2014,Turkmenistan,TKM,France,FRA,5,0,0,0,5
2014,Togo,TGO,France,FRA,12,0,122,0,134
2014,Tunisia,TUN,France,FRA,16,5,138,0,159
2014,Turkey,TUR,France,FRA,171,12,1739,0,1922
2014,Uganda,UGA,France,FRA,10,0,5,0,15
2014,Ukraine,UKR,France,FRA,20,0,171,0,191
2014,Uzbekistan,UZB,France,FRA,11,0,15,0,26
2014,Venezuela (Bolivarian Republic of),VEN,France,FRA,5,0,15,0,20
2014,Western Sahara,ESH,France,FRA,85,0,156,0,241
2014,Yemen,YEM,France,FRA,5,0,13,0,18
2014,Zimbabwe,ZWE,France,FRA,0,0,5,0,5
2014,Afghanistan,AFG,United Kingdom of Great Britain and Northern Ireland,GBR,437,91,703,290,1521
2014,Albania,ALB,United Kingdom of Great Britain and Northern Ireland,GBR,5,231,953,361,1550
2014,Algeria,DZA,United Kingdom of Great Britain and Northern Ireland,GBR,10,12,157,54,233
2014,Angola,AGO,United Kingdom of Great Britain and Northern Ireland,GBR,5,10,42,5,62
2014,Egypt,EGY,United Kingdom of Great Britain and Northern Ireland,GBR,29,20,149,47,245
2014,Armenia,ARM,United Kingdom of Great Britain and Northern Ireland,GBR,12,0,0,0,12
2014,Australia,AUS,United Kingdom of Great Britain and Northern Ireland,GBR,0,0,0,5,5
2014,Azerbaijan,AZE,United Kingdom of Great Britain and Northern Ireland,GBR,11,0,5,0,16
2014,Bahrain,BHR,United Kingdom of Great Britain and Northern Ireland,GBR,12,0,5,0,17
2014,Barbados,BRB,United Kingdom of Great Britain and Northern Ireland,GBR,0,0,0,5,5
2014,Benin,BEN,United Kingdom of Great Britain and Northern Ireland,GBR,0,0,5,0,5
2014,Bangladesh,BGD,United Kingdom of Great Britain and Northern Ireland,GBR,52,18,625,160,855
2014,Bhutan,BTN,United Kingdom of Great Britain and Northern Ireland,GBR,5,0,0,0,5
2014,Burkina Faso,BFA,United Kingdom of Great Britain and Northern Ireland,GBR,0,0,5,0,5
2014,Belarus,BLR,United Kingdom of Great Britain and Northern Ireland,GBR,22,0,0,5,27
2014,Bolivia (Plurinational State of),BOL,United Kingdom of Great Britain and Northern Ireland,GBR,0,5,14,0,19
2014,Botswana,BWA,United Kingdom of Great Britain and Northern Ireland,GBR,0,0,10,5,15
2014,Brazil,BRA,United Kingdom of Great Britain and Northern Ireland,GBR,0,0,14,10,24
2014,Bosnia and Herzegovina,BIH,United Kingdom of Great Britain and Northern Ireland,GBR,0,0,12,10,22
2014,Canada,CAN,United Kingdom of Great Britain and Northern Ireland,GBR,0,0,5,5,10
2014,Central African Rep.,CAF,United Kingdom of Great Britain and Northern Ireland,GBR,5,0,0,0,5
2014,Chad,TCD,United Kingdom of Great Britain and Northern Ireland,GBR,5,0,5,0,10
2014,China,CHN,United Kingdom of Great Britain and Northern Ireland,GBR,40,37,921,133,1131
2014,Chile,CHL,United Kingdom of Great Britain and Northern Ireland,GBR,0,0,0,5,5
2014,Cameroon,CMR,United Kingdom of Great Britain and Northern Ireland,GBR,30,5,86,0,121
2014,Congo,COG,United Kingdom of Great Britain and Northern Ireland,GBR,5,0,13,5,23
2014,Dem. Rep. of the Congo,COD,United Kingdom of Great Britain and Northern Ireland,GBR,64,17,140,30,251
2014,Comoros,COM,United Kingdom of Great Britain and Northern Ireland,GBR,0,0,0,5,5
2014,Colombia,COL,United Kingdom of Great Britain and Northern Ireland,GBR,0,0,10,5,15
2014,Costa Rica,CRI,United Kingdom of Great Britain and Northern Ireland,GBR,0,0,5,0,5
2014,Cuba,CUB,United Kingdom of Great Britain and Northern Ireland,GBR,5,0,0,0,5
2014,Czechia,CZE,United Kingdom of Great Britain and Northern Ireland,GBR,0,0,0,16,16
2014,Ecuador,ECU,United Kingdom of Great Britain and Northern Ireland,GBR,0,0,5,0,5
2014,Eritrea,ERI,United Kingdom of Great Britain and Northern Ireland,GBR,2184,13,199,163,2559
2014,Ethiopia,ETH,United Kingdom of Great Britain and Northern Ireland,GBR,51,0,74,35,160
2014,France,FRA,United Kingdom of Great Britain and Northern Ireland,GBR,0,0,0,5,5
2014,Gambia,GMB,United Kingdom of Great Britain and Northern Ireland,GBR,149,5,151,5,310
2014,Palestinian,PSE,United Kingdom of Great Britain and Northern Ireland,GBR,58,10,64,26,158
2014,Georgia,GEO,United Kingdom of Great Britain and Northern Ireland,GBR,0,0,36,10,46
2014,Ghana,GHA,United Kingdom of Great Britain and Northern Ireland,GBR,14,10,125,28,177
2014,Greece,GRC,United Kingdom of Great Britain and Northern Ireland,GBR,0,0,5,0,5
2014,Grenada,GRD,United Kingdom of Great Britain and Northern Ireland,GBR,0,0,5,0,5
2014,Guinea,GIN,United Kingdom of Great Britain and Northern Ireland,GBR,13,0,36,0,49
2014,Guyana,GUY,United Kingdom of Great Britain and Northern Ireland,GBR,0,0,5,0,5
2014,Honduras,HND,United Kingdom of Great Britain and Northern Ireland,GBR,0,0,12,0,12
2014,Hungary,HUN,United Kingdom of Great Britain and Northern Ireland,GBR,0,0,5,0,5
2014,Cote d'Ivoire,CIV,United Kingdom of Great Britain and Northern Ireland,GBR,11,0,59,0,70
2014,India,IND,United Kingdom of Great Britain and Northern Ireland,GBR,5,18,709,253,985
2014,Indonesia,IDN,United Kingdom of Great Britain and Northern Ireland,GBR,0,0,14,0,14
2014,Iran (Islamic Rep. of),IRN,United Kingdom of Great Britain and Northern Ireland,GBR,1215,43,943,203,2404
2014,Iraq,IRQ,United Kingdom of Great Britain and Northern Ireland,GBR,178,29,347,75,629
2014,Israel,ISR,United Kingdom of Great Britain and Northern Ireland,GBR,0,0,5,0,5
2014,Jamaica,JAM,United Kingdom of Great Britain and Northern Ireland,GBR,14,5,97,17,133
2014,Jordan,JOR,United Kingdom of Great Britain and Northern Ireland,GBR,5,0,20,5,30
2014,Japan,JPN,United Kingdom of Great Britain and Northern Ireland,GBR,0,0,5,0,5
2014,Kazakhstan,KAZ,United Kingdom of Great Britain and Northern Ireland,GBR,0,0,5,0,5
2014,Kenya,KEN,United Kingdom of Great Britain and Northern Ireland,GBR,15,5,51,5,76
2014,Kyrgyzstan,KGZ,United Kingdom of Great Britain and Northern Ireland,GBR,5,0,0,0,5
2014,Rep. of Korea,KOR,United Kingdom of Great Britain and Northern Ireland,GBR,0,0,12,0,12
2014,Dem. People's Rep. of Korea,PRK,United Kingdom of Great Britain and Northern Ireland,GBR,5,5,23,0,33
2014,Kuwait,KWT,United Kingdom of Great Britain and Northern Ireland,GBR,29,0,14,5,48
2014,Liberia,LBR,United Kingdom of Great Britain and Northern Ireland,GBR,0,0,13,0,13
2014,Libya,LBY,United Kingdom of Great Britain and Northern Ireland,GBR,109,5,239,46,399
2014,Saint Lucia,LCA,United Kingdom of Great Britain and Northern Ireland,GBR,0,0,5,0,5
2014,Lebanon,LBN,United Kingdom of Great Britain and Northern Ireland,GBR,14,0,46,16,76
2014,Sri Lanka,LKA,United Kingdom of Great Britain and Northern Ireland,GBR,171,31,1373,102,1677
2014,Lithuania,LTU,United Kingdom of Great Britain and Northern Ireland,GBR,0,0,13,10,23
2014,Latvia,LVA,United Kingdom of Great Britain and Northern Ireland,GBR,0,0,13,0,13
2014,Mauritania,MRT,United Kingdom of Great Britain and Northern Ireland,GBR,0,0,0,5,5
2014,North Macedonia,MKD,United Kingdom of Great Britain and Northern Ireland,GBR,0,11,0,0,11
2014,Rep. of Moldova,MDA,United Kingdom of Great Britain and Northern Ireland,GBR,0,0,5,5,10
2014,Mexico,MEX,United Kingdom of Great Britain and Northern Ireland,GBR,0,0,0,5,5
2014,Mali,MLI,United Kingdom of Great Britain and Northern Ireland,GBR,0,0,5,11,16
2014,Malaysia,MYS,United Kingdom of Great Britain and Northern Ireland,GBR,10,5,24,12,51
2014,Malawi,MWI,United Kingdom of Great Britain and Northern Ireland,GBR,10,10,84,19,123
2014,Mongolia,MNG,United Kingdom of Great Britain and Northern Ireland,GBR,0,0,28,0,28
2014,Morocco,MAR,United Kingdom of Great Britain and Northern Ireland,GBR,5,13,37,12,67
2014,Mauritius,MUS,United Kingdom of Great Britain and Northern Ireland,GBR,0,0,50,12,62
2014,Myanmar,MMR,United Kingdom of Great Britain and Northern Ireland,GBR,41,5,45,0,91
2014,Namibia,NAM,United Kingdom of Great Britain and Northern Ireland,GBR,0,0,14,5,19
2014,Nepal,NPL,United Kingdom of Great Britain and Northern Ireland,GBR,0,0,37,10,47
2014,Niger,NER,United Kingdom of Great Britain and Northern Ireland,GBR,0,0,0,5,5
2014,Nigeria,NGA,United Kingdom of Great Britain and Northern Ireland,GBR,156,98,1040,117,1411
2014,Norway,NOR,United Kingdom of Great Britain and Northern Ireland,GBR,5,0,0,0,5
2014,Pakistan,PAK,United Kingdom of Great Britain and Northern Ireland,GBR,718,52,2610,435,3815
2014,Philippines,PHL,United Kingdom of Great Britain and Northern Ireland,GBR,0,0,33,5,38
2014,Poland,POL,United Kingdom of Great Britain and Northern Ireland,GBR,0,0,108,57,165
2014,Portugal,PRT,United Kingdom of Great Britain and Northern Ireland,GBR,0,0,5,0,5
2014,Romania,ROU,United Kingdom of Great Britain and Northern Ireland,GBR,0,0,30,5,35
2014,South Africa,ZAF,United Kingdom of Great Britain and Northern Ireland,GBR,5,5,55,10,75
2014,Russian Federation,RUS,United Kingdom of Great Britain and Northern Ireland,GBR,33,0,57,10,100
2014,Rwanda,RWA,United Kingdom of Great Britain and Northern Ireland,GBR,13,5,5,0,23
2014,El Salvador,SLV,United Kingdom of Great Britain and Northern Ireland,GBR,5,0,24,5,34
2014,Saudi Arabia,SAU,United Kingdom of Great Britain and Northern Ireland,GBR,5,0,17,15,37
2014,Serbia and Kosovo: S/RES/1244 (1999),SRB,United Kingdom of Great Britain and Northern Ireland,GBR,0,0,79,15,94
2014,Senegal,SEN,United Kingdom of Great Britain and Northern Ireland,GBR,0,0,19,5,24
2014,Singapore,SGP,United Kingdom of Great Britain and Northern Ireland,GBR,0,0,5,0,5
2014,Sierra Leone,SLE,United Kingdom of Great Britain and Northern Ireland,GBR,20,5,64,16,105
2014,Somalia,SOM,United Kingdom of Great Britain and Northern Ireland,GBR,173,19,173,62,427
2014,Viet Nam,VNM,United Kingdom of Great Britain and Northern Ireland,GBR,41,38,148,133,360
2014,Sudan,SDN,United Kingdom of Great Britain and Northern Ireland,GBR,881,5,153,120,1159
2014,South Sudan,SSD,United Kingdom of Great Britain and Northern Ireland,GBR,0,12,0,0,12
2014,Eswatini,SWZ,United Kingdom of Great Britain and Northern Ireland,GBR,10,0,5,0,15
2014,Syrian Arab Rep.,SYR,United Kingdom of Great Britain and Northern Ireland,GBR,1391,31,112,183,1717
2014,United Rep. of Tanzania,TZA,United Kingdom of Great Britain and Northern Ireland,GBR,5,5,16,5,31
2014,Thailand,THA,United Kingdom of Great Britain and Northern Ireland,GBR,0,0,5,5,10
2014,Turkmenistan,TKM,United Kingdom of Great Britain and Northern Ireland,GBR,0,0,5,0,5
2014,Togo,TGO,United Kingdom of Great Britain and Northern Ireland,GBR,0,0,5,0,5
2014,Trinidad and Tobago,TTO,United Kingdom of Great Britain and Northern Ireland,GBR,5,0,24,0,29
2014,Tunisia,TUN,United Kingdom of Great Britain and Northern Ireland,GBR,0,0,38,14,52
2014,Turkey,TUR,United Kingdom of Great Britain and Northern Ireland,GBR,38,37,187,29,291
2014,United Arab Emirates,ARE,United Kingdom of Great Britain and Northern Ireland,GBR,5,0,0,0,5
2014,Uganda,UGA,United Kingdom of Great Britain and Northern Ireland,GBR,125,10,121,11,267
2014,Ukraine,UKR,United Kingdom of Great Britain and Northern Ireland,GBR,0,5,153,56,214
2014,United States of America,USA,United Kingdom of Great Britain and Northern Ireland,GBR,5,0,31,15,51
2014,Uzbekistan,UZB,United Kingdom of Great Britain and Northern Ireland,GBR,0,0,12,5,17
2014,Saint Vincent and the Grenadines,VCT,United Kingdom of Great Britain and Northern Ireland,GBR,0,0,5,0,5
2014,Venezuela (Bolivarian Republic of),VEN,United Kingdom of Great Britain and Northern Ireland,GBR,5,0,22,5,32
2014,Western Sahara,ESH,United Kingdom of Great Britain and Northern Ireland,GBR,0,0,5,0,5
2014,Yemen,YEM,United Kingdom of Great Britain and Northern Ireland,GBR,12,5,60,10,87
2014,Zambia,ZMB,United Kingdom of Great Britain and Northern Ireland,GBR,5,5,17,5,32
2014,Zimbabwe,ZWE,United Kingdom of Great Britain and Northern Ireland,GBR,49,27,196,15,287
2014,Stateless,XXA,United Kingdom of Great Britain and Northern Ireland,GBR,209,5,95,19,328
2014,Afghanistan,AFG,Georgia,GEO,0,0,0,5,5
2014,Egypt,EGY,Georgia,GEO,0,5,25,23,53
2014,Azerbaijan,AZE,Georgia,GEO,0,0,0,11,11
2014,Bangladesh,BGD,Georgia,GEO,0,0,0,5,5
2014,Iran (Islamic Rep. of),IRN,Georgia,GEO,0,0,10,16,26
2014,Iraq,IRQ,Georgia,GEO,28,62,138,381,609
2014,Lebanon,LBN,Georgia,GEO,0,0,0,5,5
2014,Sri Lanka,LKA,Georgia,GEO,0,0,0,5,5
2014,Nigeria,NGA,Georgia,GEO,0,0,5,0,5
2014,Pakistan,PAK,Georgia,GEO,0,0,10,0,10
2014,Russian Federation,RUS,Georgia,GEO,0,0,0,11,11
2014,Sudan,SDN,Georgia,GEO,0,0,5,5,10
2014,Syrian Arab Rep.,SYR,Georgia,GEO,0,37,15,24,76
2014,Turkey,TUR,Georgia,GEO,0,0,5,0,5
2014,Ukraine,UKR,Georgia,GEO,0,0,5,62,67
2014,Central African Rep.,CAF,Ghana,GHA,26,0,0,0,26
2014,Chad,TCD,Ghana,GHA,0,0,0,18,18
2014,Cameroon,CMR,Ghana,GHA,0,0,0,5,5
2014,Dem. Rep. of the Congo,COD,Ghana,GHA,17,0,0,0,17
2014,Eritrea,ERI,Ghana,GHA,5,0,0,5,10
2014,Liberia,LBR,Ghana,GHA,0,0,5,0,5
2014,Nigeria,NGA,Ghana,GHA,5,0,0,0,5
2014,Pakistan,PAK,Ghana,GHA,10,0,0,0,10
2014,Rwanda,RWA,Ghana,GHA,0,0,0,14,14
2014,Somalia,SOM,Ghana,GHA,12,0,0,0,12
2014,Sudan,SDN,Ghana,GHA,50,0,0,0,50
2014,Syrian Arab Rep.,SYR,Ghana,GHA,5,0,0,0,5
2014,Togo,TGO,Ghana,GHA,5,0,0,54,59
2014,Uganda,UGA,Ghana,GHA,5,0,0,0,5
2014,Afghanistan,AFG,Greece,GRC,219,288,1418,1545,3470
2014,Albania,ALB,Greece,GRC,5,5,957,313,1280
2014,Algeria,DZA,Greece,GRC,5,0,136,98,239
2014,Angola,AGO,Greece,GRC,0,0,5,0,5
2014,Egypt,EGY,Greece,GRC,10,0,395,164,569
2014,Armenia,ARM,Greece,GRC,0,5,65,24,94
2014,Azerbaijan,AZE,Greece,GRC,0,0,5,0,5
2014,Bangladesh,BGD,Greece,GRC,14,5,625,450,1094
2014,Burkina Faso,BFA,Greece,GRC,0,0,16,42,58
2014,Belarus,BLR,Greece,GRC,0,0,5,0,5
2014,Bosnia and Herzegovina,BIH,Greece,GRC,0,0,5,0,5
2014,Central African Rep.,CAF,Greece,GRC,0,0,0,5,5
2014,Chad,TCD,Greece,GRC,0,0,0,5,5
2014,China,CHN,Greece,GRC,0,0,211,101,312
2014,Cameroon,CMR,Greece,GRC,5,0,74,158,237
2014,Congo,COG,Greece,GRC,0,5,47,91,143
2014,Dem. Rep. of the Congo,COD,Greece,GRC,19,0,89,56,164
2014,Comoros,COM,Greece,GRC,0,0,13,33,46
2014,Dominican Rep.,DOM,Greece,GRC,0,0,15,13,28
2014,Equatorial Guinea,GNQ,Greece,GRC,0,0,0,5,5
2014,Eritrea,ERI,Greece,GRC,129,5,140,141,415
2014,Ethiopia,ETH,Greece,GRC,37,5,132,45,219
2014,Gabon,GAB,Greece,GRC,0,0,5,0,5
2014,Gambia,GMB,Greece,GRC,0,0,23,37,60
2014,Palestinian,PSE,Greece,GRC,10,0,80,142,232
2014,Georgia,GEO,Greece,GRC,0,12,1093,625,1730
2014,Ghana,GHA,Greece,GRC,0,0,68,145,213
2014,Guinea,GIN,Greece,GRC,5,0,67,77,149
2014,Honduras,HND,Greece,GRC,0,0,5,0,5
2014,Cote d'Ivoire,CIV,Greece,GRC,5,0,92,198,295
2014,India,IND,Greece,GRC,0,0,91,78,169
2014,Indonesia,IDN,Greece,GRC,0,0,16,10,26
2014,Iran (Islamic Rep. of),IRN,Greece,GRC,110,11,231,213,565
2014,Iraq,IRQ,Greece,GRC,42,40,467,370,919
2014,Kazakhstan,KAZ,Greece,GRC,0,0,5,5,10
2014,Kenya,KEN,Greece,GRC,0,0,32,19,51
2014,Liberia,LBR,Greece,GRC,0,0,5,11,16
2014,Libya,LBY,Greece,GRC,0,0,16,5,21
2014,Lebanon,LBN,Greece,GRC,0,0,17,18,35
2014,Sri Lanka,LKA,Greece,GRC,5,0,42,41,88
2014,Madagascar,MDG,Greece,GRC,0,0,5,0,5
2014,Mauritania,MRT,Greece,GRC,10,0,27,18,55
2014,Rep. of Moldova,MDA,Greece,GRC,0,0,30,31,61
2014,Mali,MLI,Greece,GRC,0,0,28,82,110
2014,Morocco,MAR,Greece,GRC,11,0,105,71,187
2014,Myanmar,MMR,Greece,GRC,5,0,0,0,5
2014,Nepal,NPL,Greece,GRC,0,0,10,0,10
2014,Nigeria,NGA,Greece,GRC,23,0,341,281,645
2014,Pakistan,PAK,Greece,GRC,14,55,2130,1615,3814
2014,Philippines,PHL,Greece,GRC,0,0,39,24,63
2014,Russian Federation,RUS,Greece,GRC,5,0,35,37,77
2014,Rwanda,RWA,Greece,GRC,0,0,5,14,19
2014,Serbia and Kosovo: S/RES/1244 (1999),SRB,Greece,GRC,0,0,13,0,13
2014,Senegal,SEN,Greece,GRC,0,0,92,226,318
2014,Sierra Leone,SLE,Greece,GRC,0,0,30,41,71
2014,Somalia,SOM,Greece,GRC,11,38,172,165,386
2014,Viet Nam,VNM,Greece,GRC,5,0,0,5,10
2014,Sudan,SDN,Greece,GRC,96,24,170,153,443
2014,South Sudan,SSD,Greece,GRC,0,0,5,0,5
2014,Syrian Arab Rep.,SYR,Greece,GRC,430,165,394,503,1492
2014,United Rep. of Tanzania,TZA,Greece,GRC,0,0,21,23,44
2014,Tunisia,TUN,Greece,GRC,0,0,41,24,65
2014,Turkey,TUR,Greece,GRC,15,5,54,58,132
2014,Uganda,UGA,Greece,GRC,5,0,0,5,10
2014,Ukraine,UKR,Greece,GRC,0,5,79,40,124
2014,Uzbekistan,UZB,Greece,GRC,0,0,5,5,10
2014,Venezuela (Bolivarian Republic of),VEN,Greece,GRC,0,0,5,0,5
2014,Yemen,YEM,Greece,GRC,0,0,0,5,5
2014,Zimbabwe,ZWE,Greece,GRC,0,0,5,0,5
2014,Stateless,XXA,Greece,GRC,14,0,5,12,31
2014,Honduras,HND,Guatemala,GTM,10,0,0,0,10
2014,El Salvador,SLV,Guatemala,GTM,5,0,0,11,16
2014,Central African Rep.,CAF,Guinea,GIN,40,0,0,0,40
2014,Dem. Rep. of the Congo,COD,Guinea,GIN,13,0,0,0,13
2014,Cote d'Ivoire,CIV,Guinea,GIN,11,0,41,0,52
2014,Liberia,LBR,Guinea,GIN,24,0,44,5,73
2014,Sri Lanka,LKA,Guinea,GIN,12,0,10,0,22
2014,Niger,NER,Guinea,GIN,5,0,0,0,5
2014,Sierra Leone,SLE,Guinea,GIN,25,0,55,0,80
2014,Afghanistan,AFG,Croatia,HRV,0,0,5,18,23
2014,Algeria,DZA,Croatia,HRV,0,0,46,35,81
2014,Egypt,EGY,Croatia,HRV,0,0,21,5,26
2014,Bangladesh,BGD,Croatia,HRV,0,0,0,17,17
2014,Belarus,BLR,Croatia,HRV,5,0,0,0,5
2014,Bosnia and Herzegovina,BIH,Croatia,HRV,0,0,11,0,11
2014,Cameroon,CMR,Croatia,HRV,0,0,0,5,5
2014,Dem. Rep. of the Congo,COD,Croatia,HRV,0,0,0,5,5
2014,Comoros,COM,Croatia,HRV,0,0,0,5,5
2014,Eritrea,ERI,Croatia,HRV,0,0,0,5,5
2014,Gambia,GMB,Croatia,HRV,0,0,0,5,5
2014,Palestinian,PSE,Croatia,HRV,0,0,0,11,11
2014,Ghana,GHA,Croatia,HRV,0,0,5,5,10
2014,Cote d'Ivoire,CIV,Croatia,HRV,0,0,0,11,11
2014,Iran (Islamic Rep. of),IRN,Croatia,HRV,0,0,0,5,5
2014,Iraq,IRQ,Croatia,HRV,0,0,0,5,5
2014,Libya,LBY,Croatia,HRV,0,0,0,5,5
2014,Mali,MLI,Croatia,HRV,0,0,0,13,13
2014,Morocco,MAR,Croatia,HRV,0,0,17,11,28
2014,Nigeria,NGA,Croatia,HRV,5,0,11,24,40
2014,Pakistan,PAK,Croatia,HRV,0,0,5,28,33
2014,Russian Federation,RUS,Croatia,HRV,0,0,0,5,5
2014,Serbia and Kosovo: S/RES/1244 (1999),SRB,Croatia,HRV,0,0,5,5,10
2014,Senegal,SEN,Croatia,HRV,0,0,0,5,5
2014,Somalia,SOM,Croatia,HRV,0,5,0,14,19
2014,Syrian Arab Rep.,SYR,Croatia,HRV,0,0,0,84,84
2014,Tunisia,TUN,Croatia,HRV,0,0,14,36,50
2014,Turkey,TUR,Croatia,HRV,0,0,5,0,5
2014,Ukraine,UKR,Croatia,HRV,0,0,5,5,10
2014,Afghanistan,AFG,Hungary,HUN,17,58,236,6564,6875
2014,Albania,ALB,Hungary,HUN,0,0,10,32,42
2014,Algeria,DZA,Hungary,HUN,0,0,56,69,125
2014,Egypt,EGY,Hungary,HUN,0,0,16,18,34
2014,Armenia,ARM,Hungary,HUN,0,0,0,5,5
2014,Azerbaijan,AZE,Hungary,HUN,0,0,5,0,5
2014,Benin,BEN,Hungary,HUN,0,0,0,5,5
2014,Bangladesh,BGD,Hungary,HUN,0,0,41,183,224
2014,Burkina Faso,BFA,Hungary,HUN,0,0,0,14,14
2014,Bosnia and Herzegovina,BIH,Hungary,HUN,0,0,5,5,10
2014,Central African Rep.,CAF,Hungary,HUN,0,0,0,5,5
2014,China,CHN,Hungary,HUN,0,0,0,11,11
2014,Cameroon,CMR,Hungary,HUN,0,0,5,91,96
2014,Congo,COG,Hungary,HUN,0,0,13,77,90
2014,Dem. Rep. of the Congo,COD,Hungary,HUN,5,0,5,52,62
2014,Comoros,COM,Hungary,HUN,0,0,10,65,75
2014,Costa Rica,CRI,Hungary,HUN,0,0,0,43,43
2014,Cuba,CUB,Hungary,HUN,13,0,43,72,128
2014,Dominica,DMA,Hungary,HUN,0,0,0,5,5
2014,Eritrea,ERI,Hungary,HUN,10,21,0,103,134
2014,Ethiopia,ETH,Hungary,HUN,0,0,0,5,5
2014,Gambia,GMB,Hungary,HUN,0,0,14,71,85
2014,Palestinian,PSE,Hungary,HUN,14,11,25,819,869
2014,Georgia,GEO,Hungary,HUN,5,0,11,26,42
2014,Ghana,GHA,Hungary,HUN,0,0,44,173,217
2014,Guinea,GIN,Hungary,HUN,0,0,23,29,52
2014,Cote d'Ivoire,CIV,Hungary,HUN,5,0,25,82,112
2014,India,IND,Hungary,HUN,0,0,5,12,17
2014,Iran (Islamic Rep. of),IRN,Hungary,HUN,5,0,21,201,227
2014,Iraq,IRQ,Hungary,HUN,5,15,10,334,364
2014,Jordan,JOR,Hungary,HUN,0,0,0,5,5
2014,Kenya,KEN,Hungary,HUN,0,0,5,5,10
2014,Liberia,LBR,Hungary,HUN,0,0,0,5,5
2014,Libya,LBY,Hungary,HUN,0,0,12,14,26
2014,Lebanon,LBN,Hungary,HUN,0,0,0,5,5
2014,Sri Lanka,LKA,Hungary,HUN,0,0,5,12,17
2014,Mauritania,MRT,Hungary,HUN,0,0,15,18,33
2014,North Macedonia,MKD,Hungary,HUN,0,0,0,11,11
2014,Rep. of Moldova,MDA,Hungary,HUN,0,0,0,5,5
2014,Mali,MLI,Hungary,HUN,0,0,19,113,132
2014,Mongolia,MNG,Hungary,HUN,0,0,0,5,5
2014,Morocco,MAR,Hungary,HUN,0,0,24,31,55
2014,Montenegro,MNE,Hungary,HUN,0,0,0,5,5
2014,Myanmar,MMR,Hungary,HUN,0,0,5,0,5
2014,Nigeria,NGA,Hungary,HUN,5,0,97,192,294
2014,Pakistan,PAK,Hungary,HUN,0,0,129,290,419
2014,Russian Federation,RUS,Hungary,HUN,0,0,5,12,17
2014,Rwanda,RWA,Hungary,HUN,0,0,0,18,18
2014,Serbia and Kosovo: S/RES/1244 (1999),SRB,Hungary,HUN,0,0,3537,7613,11150
2014,Senegal,SEN,Hungary,HUN,0,0,54,38,92
2014,Sierra Leone,SLE,Hungary,HUN,0,0,10,39,49
2014,Somalia,SOM,Hungary,HUN,19,48,5,158,230
2014,Viet Nam,VNM,Hungary,HUN,0,0,13,11,24
2014,Sudan,SDN,Hungary,HUN,5,5,19,77,106
2014,Syrian Arab Rep.,SYR,Hungary,HUN,110,61,91,5991,6253
2014,United Rep. of Tanzania,TZA,Hungary,HUN,0,0,0,5,5
2014,Togo,TGO,Hungary,HUN,0,0,5,5,10
2014,Tunisia,TUN,Hungary,HUN,0,0,11,40,51
2014,Turkey,TUR,Hungary,HUN,0,0,12,93,105
2014,Uganda,UGA,Hungary,HUN,0,0,0,12,12
2014,Ukraine,UKR,Hungary,HUN,0,0,18,21,39
2014,Western Sahara,ESH,Hungary,HUN,0,0,0,5,5
2014,Yemen,YEM,Hungary,HUN,0,0,0,14,14
2014,Stateless,XXA,Hungary,HUN,0,5,0,5,10
2014,Afghanistan,AFG,Iceland,ISL,5,0,0,0,5
2014,Albania,ALB,Iceland,ISL,0,0,10,0,10
2014,Azerbaijan,AZE,Iceland,ISL,0,0,5,0,5
2014,Colombia,COL,Iceland,ISL,0,0,5,0,5
2014,Georgia,GEO,Iceland,ISL,0,0,5,0,5
2014,Iran (Islamic Rep. of),IRN,Iceland,ISL,5,0,5,0,10
2014,Iraq,IRQ,Iceland,ISL,0,0,5,0,5
2014,Nigeria,NGA,Iceland,ISL,0,0,5,0,5
2014,Syrian Arab Rep.,SYR,Iceland,ISL,0,0,5,0,5
2014,Ukraine,UKR,Iceland,ISL,0,5,5,0,10
2014,Stateless,XXA,Iceland,ISL,5,0,5,0,10
2014,Afghanistan,AFG,Ireland,IRL,5,0,13,5,23
2014,Albania,ALB,Ireland,IRL,5,0,42,5,52
2014,Algeria,DZA,Ireland,IRL,0,0,43,13,56
2014,Angola,AGO,Ireland,IRL,0,0,5,0,5
2014,Egypt,EGY,Ireland,IRL,0,0,0,13,13
2014,Bangladesh,BGD,Ireland,IRL,0,0,27,17,44
2014,Botswana,BWA,Ireland,IRL,0,0,5,0,5
2014,China,CHN,Ireland,IRL,0,0,5,18,23
2014,Cameroon,CMR,Ireland,IRL,5,0,13,0,18
2014,Dem. Rep. of the Congo,COD,Ireland,IRL,5,0,42,10,57
2014,Ethiopia,ETH,Ireland,IRL,5,0,0,0,5
2014,Palestinian,PSE,Ireland,IRL,10,0,0,0,10
2014,Georgia,GEO,Ireland,IRL,0,0,0,11,11
2014,Ghana,GHA,Ireland,IRL,0,0,5,0,5
2014,Honduras,HND,Ireland,IRL,5,0,0,0,5
2014,India,IND,Ireland,IRL,0,0,0,12,12
2014,Iran (Islamic Rep. of),IRN,Ireland,IRL,12,0,5,0,17
2014,Iraq,IRQ,Ireland,IRL,11,0,10,5,26
2014,Israel,ISR,Ireland,IRL,0,0,5,0,5
2014,Kenya,KEN,Ireland,IRL,5,0,0,0,5
2014,Kuwait,KWT,Ireland,IRL,0,0,5,0,5
2014,Lesotho,LSO,Ireland,IRL,0,0,5,0,5
2014,Malaysia,MYS,Ireland,IRL,0,0,0,5,5
2014,Malawi,MWI,Ireland,IRL,10,0,51,5,66
2014,Morocco,MAR,Ireland,IRL,0,0,5,0,5
2014,Mozambique,MOZ,Ireland,IRL,0,0,5,0,5
2014,Mauritius,MUS,Ireland,IRL,0,0,18,0,18
2014,Nepal,NPL,Ireland,IRL,0,0,0,5,5
2014,Nigeria,NGA,Ireland,IRL,0,0,92,37,129
2014,Pakistan,PAK,Ireland,IRL,10,0,61,70,141
2014,South Africa,ZAF,Ireland,IRL,0,0,55,0,55
2014,Rwanda,RWA,Ireland,IRL,5,0,0,0,5
2014,Saudi Arabia,SAU,Ireland,IRL,5,0,0,0,5
2014,Serbia and Kosovo: S/RES/1244 (1999),SRB,Ireland,IRL,0,0,5,0,5
2014,Somalia,SOM,Ireland,IRL,0,0,5,0,5
2014,Sudan,SDN,Ireland,IRL,5,0,5,0,10
2014,Eswatini,SWZ,Ireland,IRL,0,0,11,0,11
2014,Syrian Arab Rep.,SYR,Ireland,IRL,19,0,0,5,24
2014,Turkey,TUR,Ireland,IRL,0,0,0,5,5
2014,Uganda,UGA,Ireland,IRL,5,0,0,0,5
2014,Ukraine,UKR,Ireland,IRL,5,0,21,5,31
2014,Venezuela (Bolivarian Republic of),VEN,Ireland,IRL,0,0,17,5,22
2014,Zimbabwe,ZWE,Ireland,IRL,5,0,52,10,67
2014,Afghanistan,AFG,Italy,ITA,255,2142,118,5,2520
2014,Albania,ALB,Italy,ITA,13,56,73,0,142
2014,Algeria,DZA,Italy,ITA,0,25,57,0,82
2014,Angola,AGO,Italy,ITA,5,5,0,0,10
2014,Egypt,EGY,Italy,ITA,81,483,201,0,765
2014,Armenia,ARM,Italy,ITA,21,52,26,0,99
2014,Benin,BEN,Italy,ITA,0,16,21,0,37
2014,Bangladesh,BGD,Italy,ITA,30,283,423,0,736
2014,Burkina Faso,BFA,Italy,ITA,0,100,73,0,173
2014,Belarus,BLR,Italy,ITA,0,5,0,0,5
2014,Bolivia (Plurinational State of),BOL,Italy,ITA,0,5,0,0,5
2014,Brazil,BRA,Italy,ITA,0,14,5,0,19
2014,Bosnia and Herzegovina,BIH,Italy,ITA,0,106,55,0,161
2014,Central African Rep.,CAF,Italy,ITA,14,5,0,0,19
2014,Chad,TCD,Italy,ITA,10,32,5,0,47
2014,China,CHN,Italy,ITA,12,10,12,0,34
2014,Chile,CHL,Italy,ITA,0,0,5,0,5
2014,Cameroon,CMR,Italy,ITA,41,41,25,0,107
2014,Congo,COG,Italy,ITA,14,19,5,0,38
2014,Dem. Rep. of the Congo,COD,Italy,ITA,37,37,5,0,79
2014,Colombia,COL,Italy,ITA,32,42,10,0,84
2014,Cuba,CUB,Italy,ITA,0,24,19,0,43
2014,Dominican Rep.,DOM,Italy,ITA,0,0,5,0,5
2014,Ecuador,ECU,Italy,ITA,0,5,0,0,5
2014,Eritrea,ERI,Italy,ITA,851,448,156,0,1455
2014,Ethiopia,ETH,Italy,ITA,92,125,37,0,254
2014,Gabon,GAB,Italy,ITA,0,5,0,0,5
2014,Gambia,GMB,Italy,ITA,121,1163,2117,0,3401
2014,Palestinian,PSE,Italy,ITA,91,27,23,0,141
2014,Georgia,GEO,Italy,ITA,0,24,38,0,62
2014,Ghana,GHA,Italy,ITA,23,324,531,0,878
2014,Guinea-Bissau,GNB,Italy,ITA,0,89,103,0,192
2014,Guinea,GIN,Italy,ITA,13,238,182,0,433
2014,Cote d'Ivoire,CIV,Italy,ITA,51,492,163,0,706
2014,India,IND,Italy,ITA,5,16,17,0,38
2014,Iran (Islamic Rep. of),IRN,Italy,ITA,221,101,52,0,374
2014,Iraq,IRQ,Italy,ITA,97,605,67,5,774
2014,Jordan,JOR,Italy,ITA,5,0,0,0,5
2014,Kazakhstan,KAZ,Italy,ITA,5,0,0,0,5
2014,Kenya,KEN,Italy,ITA,5,10,0,0,15
2014,Liberia,LBR,Italy,ITA,0,51,39,5,95
2014,Libya,LBY,Italy,ITA,5,31,10,0,46
2014,Lebanon,LBN,Italy,ITA,5,27,20,0,52
2014,Sri Lanka,LKA,Italy,ITA,11,36,27,0,74
2014,Madagascar,MDG,Italy,ITA,0,5,0,0,5
2014,Mauritania,MRT,Italy,ITA,15,25,28,0,68
2014,North Macedonia,MKD,Italy,ITA,0,14,0,0,14
2014,Rep. of Moldova,MDA,Italy,ITA,0,5,0,0,5
2014,Mali,MLI,Italy,ITA,29,1954,1885,0,3868
2014,Morocco,MAR,Italy,ITA,13,35,166,0,214
2014,Montenegro,MNE,Italy,ITA,0,19,15,0,34
2014,Mauritius,MUS,Italy,ITA,0,0,5,0,5
2014,Myanmar,MMR,Italy,ITA,5,0,0,0,5
2014,Nepal,NPL,Italy,ITA,0,5,31,0,36
2014,Niger,NER,Italy,ITA,5,41,29,0,75
2014,Nicaragua,NIC,Italy,ITA,0,0,5,0,5
2014,Nigeria,NGA,Italy,ITA,138,2008,3014,0,5160
2014,Pakistan,PAK,Italy,ITA,386,2018,2258,0,4662
2014,Peru,PER,Italy,ITA,5,5,5,0,15
2014,Philippines,PHL,Italy,ITA,0,5,5,0,10
2014,Russian Federation,RUS,Italy,ITA,18,15,13,0,46
2014,Rwanda,RWA,Italy,ITA,0,0,5,0,5
2014,El Salvador,SLV,Italy,ITA,5,42,13,0,60
2014,Serbia and Kosovo: S/RES/1244 (1999),SRB,Italy,ITA,5,99,140,5,249
2014,Senegal,SEN,Italy,ITA,43,828,1129,0,2000
2014,Sierra Leone,SLE,Italy,ITA,0,63,41,0,104
2014,Somalia,SOM,Italy,ITA,374,1500,106,0,1980
2014,Sudan,SDN,Italy,ITA,63,113,45,0,221
2014,Syrian Arab Rep.,SYR,Italy,ITA,230,84,176,0,490
2014,United Rep. of Tanzania,TZA,Italy,ITA,0,5,0,0,5
2014,Togo,TGO,Italy,ITA,19,93,49,0,161
2014,Tunisia,TUN,Italy,ITA,11,101,318,0,430
2014,Turkey,TUR,Italy,ITA,67,260,173,0,500
2014,Uganda,UGA,Italy,ITA,5,0,0,0,5
2014,Ukraine,UKR,Italy,ITA,10,155,80,0,245
2014,Venezuela (Bolivarian Republic of),VEN,Italy,ITA,13,5,0,0,18
2014,Yemen,YEM,Italy,ITA,11,18,0,0,29
2014,Zimbabwe,ZWE,Italy,ITA,0,5,0,0,5
2014,Afghanistan,AFG,Japan,JPN,0,0,14,0,14
2014,Egypt,EGY,Japan,JPN,0,0,5,0,5
2014,Bangladesh,BGD,Japan,JPN,0,0,109,10,119
2014,Brazil,BRA,Japan,JPN,0,0,0,5,5
2014,China,CHN,Japan,JPN,0,0,38,12,50
2014,Cameroon,CMR,Japan,JPN,0,5,63,0,68
2014,Dem. Rep. of the Congo,COD,Japan,JPN,0,0,15,5,20
2014,Ethiopia,ETH,Japan,JPN,0,0,12,0,12
2014,Gambia,GMB,Japan,JPN,0,0,5,0,5
2014,Ghana,GHA,Japan,JPN,0,0,50,5,55
2014,Guatemala,GTM,Japan,JPN,0,0,0,5,5
2014,Guinea,GIN,Japan,JPN,0,0,10,0,10
2014,India,IND,Japan,JPN,0,0,107,19,126
2014,Indonesia,IDN,Japan,JPN,0,0,15,0,15
2014,Iran (Islamic Rep. of),IRN,Japan,JPN,0,0,42,0,42
2014,Liberia,LBR,Japan,JPN,0,0,5,0,5
2014,Sri Lanka,LKA,Japan,JPN,0,0,299,24,323
2014,Mali,MLI,Japan,JPN,0,0,10,0,10
2014,Malaysia,MYS,Japan,JPN,0,0,5,0,5
2014,Myanmar,MMR,Japan,JPN,0,19,255,21,295
2014,Nepal,NPL,Japan,JPN,0,0,689,22,711
2014,Nigeria,NGA,Japan,JPN,0,0,64,5,69
2014,Pakistan,PAK,Japan,JPN,0,0,164,21,185
2014,Peru,PER,Japan,JPN,0,0,10,0,10
2014,Philippines,PHL,Japan,JPN,0,0,62,5,67
2014,Viet Nam,VNM,Japan,JPN,0,0,187,17,204
2014,Syrian Arab Rep.,SYR,Japan,JPN,5,12,0,0,17
2014,United Rep. of Tanzania,TZA,Japan,JPN,0,0,5,0,5
2014,Thailand,THA,Japan,JPN,0,0,26,5,31
2014,Tunisia,TUN,Japan,JPN,0,0,23,11,34
2014,Turkey,TUR,Japan,JPN,0,0,505,60,565
2014,Uganda,UGA,Japan,JPN,0,0,21,0,21
2014,Afghanistan,AFG,Kazakhstan,KAZ,63,0,82,5,150
2014,China,CHN,Kazakhstan,KAZ,0,0,0,5,5
2014,Kyrgyzstan,KGZ,Kazakhstan,KAZ,0,0,0,10,10
2014,Syrian Arab Rep.,SYR,Kazakhstan,KAZ,5,0,43,0,48
2014,Ukraine,UKR,Kazakhstan,KAZ,0,0,82,10,92
2014,Uzbekistan,UZB,Kazakhstan,KAZ,11,0,0,0,11
2014,Afghanistan,AFG,Kyrgyzstan,KGZ,0,0,117,29,146
2014,Germany,DEU,Kyrgyzstan,KGZ,0,0,5,0,5
2014,Iran (Islamic Rep. of),IRN,Kyrgyzstan,KGZ,0,0,5,0,5
2014,Pakistan,PAK,Kyrgyzstan,KGZ,0,0,5,0,5
2014,Syrian Arab Rep.,SYR,Kyrgyzstan,KGZ,40,0,19,16,75
2014,Tajikistan,TJK,Kyrgyzstan,KGZ,0,0,5,0,5
2014,Uzbekistan,UZB,Kyrgyzstan,KGZ,0,0,0,93,93
2014,Albania,ALB,Liechtenstein,LIE,0,0,5,0,5
2014,Kyrgyzstan,KGZ,Liechtenstein,LIE,0,0,0,5,5
2014,Romania,ROU,Liechtenstein,LIE,0,0,5,0,5
2014,Russian Federation,RUS,Liechtenstein,LIE,0,0,5,0,5
2014,Serbia and Kosovo: S/RES/1244 (1999),SRB,Liechtenstein,LIE,0,0,0,13,13
2014,Somalia,SOM,Liechtenstein,LIE,0,0,5,0,5
2014,Syrian Arab Rep.,SYR,Liechtenstein,LIE,5,0,0,0,5
2014,Ukraine,UKR,Liechtenstein,LIE,0,0,0,5,5
2014,Afghanistan,AFG,Lithuania,LTU,11,23,0,18,52
2014,Azerbaijan,AZE,Lithuania,LTU,0,0,0,16,16
2014,Belarus,BLR,Lithuania,LTU,0,0,0,5,5
2014,Georgia,GEO,Lithuania,LTU,0,0,33,71,104
2014,Guinea,GIN,Lithuania,LTU,0,0,5,0,5
2014,India,IND,Lithuania,LTU,0,0,5,10,15
2014,Kazakhstan,KAZ,Lithuania,LTU,5,0,0,0,5
2014,Nigeria,NGA,Lithuania,LTU,0,0,5,0,5
2014,Pakistan,PAK,Lithuania,LTU,0,0,5,0,5
2014,Russian Federation,RUS,Lithuania,LTU,11,14,15,16,56
2014,Viet Nam,VNM,Lithuania,LTU,0,0,20,5,25
2014,Syrian Arab Rep.,SYR,Lithuania,LTU,0,0,0,5,5
2014,Tajikistan,TJK,Lithuania,LTU,0,0,0,5,5
2014,Ukraine,UKR,Lithuania,LTU,0,29,5,12,46
2014,Stateless,XXA,Lithuania,LTU,0,0,5,0,5
2014,Afghanistan,AFG,Luxembourg,LUX,0,0,0,5,5
2014,Albania,ALB,Luxembourg,LUX,0,0,83,10,93
2014,Algeria,DZA,Luxembourg,LUX,0,0,10,36,46
2014,Egypt,EGY,Luxembourg,LUX,5,0,0,5,10
2014,Armenia,ARM,Luxembourg,LUX,0,0,0,5,5
2014,Azerbaijan,AZE,Luxembourg,LUX,0,0,5,5,10
2014,Benin,BEN,Luxembourg,LUX,0,0,0,12,12
2014,Belarus,BLR,Luxembourg,LUX,0,0,5,13,18
2014,Bosnia and Herzegovina,BIH,Luxembourg,LUX,0,0,135,10,145
2014,China,CHN,Luxembourg,LUX,0,0,0,5,5
2014,Cameroon,CMR,Luxembourg,LUX,5,0,0,5,10
2014,Dem. Rep. of the Congo,COD,Luxembourg,LUX,5,0,13,5,23
2014,Eritrea,ERI,Luxembourg,LUX,12,0,5,0,17
2014,Ethiopia,ETH,Luxembourg,LUX,5,0,5,0,10
2014,Gambia,GMB,Luxembourg,LUX,0,0,0,5,5
2014,Palestinian,PSE,Luxembourg,LUX,0,0,0,5,5
2014,Georgia,GEO,Luxembourg,LUX,0,0,0,11,11
2014,Guinea,GIN,Luxembourg,LUX,0,0,5,0,5
2014,Cote d'Ivoire,CIV,Luxembourg,LUX,0,0,0,5,5
2014,Iran (Islamic Rep. of),IRN,Luxembourg,LUX,11,0,5,5,21
2014,Iraq,IRQ,Luxembourg,LUX,5,5,12,5,27
2014,Liberia,LBR,Luxembourg,LUX,0,0,5,0,5
2014,Libya,LBY,Luxembourg,LUX,0,0,11,5,16
2014,Mauritania,MRT,Luxembourg,LUX,0,0,0,5,5
2014,North Macedonia,MKD,Luxembourg,LUX,0,0,27,0,27
2014,Mali,MLI,Luxembourg,LUX,0,0,0,5,5
2014,Morocco,MAR,Luxembourg,LUX,0,0,5,12,17
2014,Montenegro,MNE,Luxembourg,LUX,0,5,131,0,136
2014,Nigeria,NGA,Luxembourg,LUX,0,0,23,52,75
2014,Russian Federation,RUS,Luxembourg,LUX,0,0,5,0,5
2014,Serbia and Kosovo: S/RES/1244 (1999),SRB,Luxembourg,LUX,5,0,140,55,200
2014,Senegal,SEN,Luxembourg,LUX,0,0,0,5,5
2014,Somalia,SOM,Luxembourg,LUX,5,0,13,0,18
2014,Syrian Arab Rep.,SYR,Luxembourg,LUX,37,5,5,14,61
2014,United Rep. of Tanzania,TZA,Luxembourg,LUX,5,0,0,0,5
2014,Togo,TGO,Luxembourg,LUX,0,0,0,5,5
2014,Tunisia,TUN,Luxembourg,LUX,0,0,26,19,45
2014,Turkey,TUR,Luxembourg,LUX,0,0,25,5,30
2014,Uganda,UGA,Luxembourg,LUX,0,0,5,0,5
2014,Ukraine,UKR,Luxembourg,LUX,0,0,0,5,5
2014,Algeria,DZA,Latvia,LVA,0,0,0,5,5
2014,Egypt,EGY,Latvia,LVA,0,0,5,0,5
2014,Armenia,ARM,Latvia,LVA,0,0,5,0,5
2014,Dem. Rep. of the Congo,COD,Latvia,LVA,0,0,0,5,5
2014,Cuba,CUB,Latvia,LVA,0,0,5,0,5
2014,Georgia,GEO,Latvia,LVA,0,0,31,137,168
2014,Iraq,IRQ,Latvia,LVA,0,0,0,5,5
2014,Russian Federation,RUS,Latvia,LVA,0,0,5,5,10
2014,Syrian Arab Rep.,SYR,Latvia,LVA,0,18,0,10,28
2014,Ukraine,UKR,Latvia,LVA,0,0,5,15,20
2014,Afghanistan,AFG,Rep. of Moldova,MDA,12,0,0,5,17
2014,Cuba,CUB,Rep. of Moldova,MDA,0,5,0,0,5
2014,Georgia,GEO,Rep. of Moldova,MDA,0,0,0,5,5
2014,Iran (Islamic Rep. of),IRN,Rep. of Moldova,MDA,0,5,0,0,5
2014,Iraq,IRQ,Rep. of Moldova,MDA,5,0,0,0,5
2014,Russian Federation,RUS,Rep. of Moldova,MDA,0,0,5,0,5
2014,Syrian Arab Rep.,SYR,Rep. of Moldova,MDA,22,39,0,5,66
2014,Tajikistan,TJK,Rep. of Moldova,MDA,5,0,0,0,5
2014,Ukraine,UKR,Rep. of Moldova,MDA,0,17,16,18,51
2014,Uzbekistan,UZB,Rep. of Moldova,MDA,5,0,5,0,10
2014,Burundi,BDI,Malawi,MWI,0,0,0,122,122
2014,Belgium,BEL,Malawi,MWI,0,0,0,5,5
2014,Dem. Rep. of the Congo,COD,Malawi,MWI,0,0,0,182,182
2014,Ethiopia,ETH,Malawi,MWI,0,0,0,5,5
2014,Rwanda,RWA,Malawi,MWI,25,0,0,122,147
2014,Dem. Rep. of the Congo,COD,Mozambique,MOZ,5,0,0,0,5
2014,Egypt,EGY,Malta,MLT,5,11,5,5,26
2014,Belarus,BLR,Malta,MLT,0,11,0,5,16
2014,Chad,TCD,Malta,MLT,0,0,0,12,12
2014,Cameroon,CMR,Malta,MLT,5,0,0,0,5
2014,Congo,COG,Malta,MLT,5,0,0,0,5
2014,Comoros,COM,Malta,MLT,0,0,10,0,10
2014,Eritrea,ERI,Malta,MLT,5,142,21,14,182
2014,Ethiopia,ETH,Malta,MLT,11,10,19,0,40
2014,Gambia,GMB,Malta,MLT,5,0,92,5,102
2014,Palestinian,PSE,Malta,MLT,10,14,5,10,39
2014,Guinea-Bissau,GNB,Malta,MLT,0,0,5,0,5
2014,Guinea,GIN,Malta,MLT,0,0,5,5,10
2014,Cote d'Ivoire,CIV,Malta,MLT,0,0,5,0,5
2014,Iran (Islamic Rep. of),IRN,Malta,MLT,12,0,0,0,12
2014,Iraq,IRQ,Malta,MLT,5,0,0,0,5
2014,Libya,LBY,Malta,MLT,145,242,0,64,451
2014,Mali,MLI,Malta,MLT,0,5,45,5,55
2014,Morocco,MAR,Malta,MLT,0,5,0,0,5
2014,Nigeria,NGA,Malta,MLT,0,15,64,17,96
2014,Pakistan,PAK,Malta,MLT,5,0,0,0,5
2014,Russian Federation,RUS,Malta,MLT,0,10,5,5,20
2014,Senegal,SEN,Malta,MLT,0,5,0,35,40
2014,Sierra Leone,SLE,Malta,MLT,0,0,5,0,5
2014,Somalia,SOM,Malta,MLT,5,296,75,150,526
2014,Sudan,SDN,Malta,MLT,5,60,10,36,111
2014,South Sudan,SSD,Malta,MLT,0,21,5,0,26
2014,Syrian Arab Rep.,SYR,Malta,MLT,5,360,5,26,396
2014,Togo,TGO,Malta,MLT,0,0,5,0,5
2014,Turkey,TUR,Malta,MLT,0,5,0,0,5
2014,Ukraine,UKR,Malta,MLT,0,27,0,18,45
2014,Burundi,BDI,Namibia,NAM,52,0,0,0,52
2014,Cameroon,CMR,Namibia,NAM,0,0,0,5,5
2014,Dem. Rep. of the Congo,COD,Namibia,NAM,337,0,0,53,390
2014,Rwanda,RWA,Namibia,NAM,21,0,0,0,21
2014,Somalia,SOM,Namibia,NAM,0,0,0,10,10
2014,South Sudan,SSD,Namibia,NAM,0,0,0,5,5
2014,Uganda,UGA,Namibia,NAM,0,0,0,5,5
2014,Zimbabwe,ZWE,Namibia,NAM,5,0,0,40,45
2014,Afghanistan,AFG,Netherlands,NLD,182,233,414,0,829
2014,Albania,ALB,Netherlands,NLD,0,0,59,0,59
2014,Algeria,DZA,Netherlands,NLD,5,0,11,0,16
2014,Angola,AGO,Netherlands,NLD,0,0,14,0,14
2014,Egypt,EGY,Netherlands,NLD,10,17,114,0,141
2014,Armenia,ARM,Netherlands,NLD,0,10,232,0,242
2014,Australia,AUS,Netherlands,NLD,0,0,5,0,5
2014,Azerbaijan,AZE,Netherlands,NLD,0,5,39,0,44
2014,Burundi,BDI,Netherlands,NLD,0,5,10,0,15
2014,Benin,BEN,Netherlands,NLD,0,0,5,0,5
2014,Bangladesh,BGD,Netherlands,NLD,0,0,10,0,10
2014,Burkina Faso,BFA,Netherlands,NLD,0,0,12,0,12
2014,Belarus,BLR,Netherlands,NLD,0,0,52,0,52
2014,Brazil,BRA,Netherlands,NLD,0,0,5,0,5
2014,Bosnia and Herzegovina,BIH,Netherlands,NLD,0,0,95,0,95
2014,Bulgaria,BGR,Netherlands,NLD,0,0,5,0,5
2014,Central African Rep.,CAF,Netherlands,NLD,5,0,0,0,5
2014,Chad,TCD,Netherlands,NLD,0,0,5,0,5
2014,China,CHN,Netherlands,NLD,14,43,64,0,121
2014,Cameroon,CMR,Netherlands,NLD,12,0,23,0,35
2014,Congo,COG,Netherlands,NLD,5,17,86,0,108
2014,Dem. Rep. of the Congo,COD,Netherlands,NLD,0,5,0,0,5
2014,Colombia,COL,Netherlands,NLD,0,0,11,0,11
2014,Cuba,CUB,Netherlands,NLD,0,0,10,0,10
2014,Eritrea,ERI,Netherlands,NLD,33,3455,357,0,3845
2014,Ethiopia,ETH,Netherlands,NLD,17,14,79,0,110
2014,Gambia,GMB,Netherlands,NLD,0,0,21,0,21
2014,Palestinian,PSE,Netherlands,NLD,19,12,5,0,36
2014,Georgia,GEO,Netherlands,NLD,0,5,282,0,287
2014,Ghana,GHA,Netherlands,NLD,0,0,30,0,30
2014,Guinea,GIN,Netherlands,NLD,5,52,75,0,132
2014,Cote d'Ivoire,CIV,Netherlands,NLD,0,5,24,0,29
2014,India,IND,Netherlands,NLD,0,0,12,0,12
2014,Iran (Islamic Rep. of),IRN,Netherlands,NLD,203,58,319,0,580
2014,Iraq,IRQ,Netherlands,NLD,86,241,450,0,777
2014,Israel,ISR,Netherlands,NLD,0,0,5,0,5
2014,Jamaica,JAM,Netherlands,NLD,21,5,16,0,42
2014,Jordan,JOR,Netherlands,NLD,0,5,5,0,10
2014,Kazakhstan,KAZ,Netherlands,NLD,0,0,29,0,29
2014,Kenya,KEN,Netherlands,NLD,0,10,5,0,15
2014,Kyrgyzstan,KGZ,Netherlands,NLD,0,0,12,0,12
2014,Dem. People's Rep. of Korea,PRK,Netherlands,NLD,0,0,35,0,35
2014,Liberia,LBR,Netherlands,NLD,0,0,12,0,12
2014,Libya,LBY,Netherlands,NLD,5,13,143,0,161
2014,Lebanon,LBN,Netherlands,NLD,0,0,14,0,14
2014,Sri Lanka,LKA,Netherlands,NLD,10,21,87,0,118
2014,Latvia,LVA,Netherlands,NLD,0,0,5,0,5
2014,Mauritania,MRT,Netherlands,NLD,0,0,5,0,5
2014,North Macedonia,MKD,Netherlands,NLD,0,0,101,0,101
2014,Mali,MLI,Netherlands,NLD,0,10,25,0,35
2014,Malawi,MWI,Netherlands,NLD,0,0,5,0,5
2014,Mongolia,MNG,Netherlands,NLD,0,10,295,0,305
2014,Morocco,MAR,Netherlands,NLD,0,0,37,0,37
2014,Montenegro,MNE,Netherlands,NLD,0,0,13,0,13
2014,Myanmar,MMR,Netherlands,NLD,0,19,0,0,19
2014,Nepal,NPL,Netherlands,NLD,5,5,45,0,55
2014,Niger,NER,Netherlands,NLD,0,0,5,0,5
2014,Nigeria,NGA,Netherlands,NLD,30,13,153,0,196
2014,Pakistan,PAK,Netherlands,NLD,25,14,117,0,156
2014,South Africa,ZAF,Netherlands,NLD,0,0,5,0,5
2014,Russian Federation,RUS,Netherlands,NLD,10,21,144,0,175
2014,Rwanda,RWA,Netherlands,NLD,0,0,15,0,15
2014,Saudi Arabia,SAU,Netherlands,NLD,5,0,0,0,5
2014,Serbia and Kosovo: S/RES/1244 (1999),SRB,Netherlands,NLD,0,0,177,0,177
2014,Senegal,SEN,Netherlands,NLD,0,0,11,0,11
2014,Sierra Leone,SLE,Netherlands,NLD,5,31,81,0,117
2014,Somalia,SOM,Netherlands,NLD,10,326,234,0,570
2014,Viet Nam,VNM,Netherlands,NLD,0,0,11,0,11
2014,Sudan,SDN,Netherlands,NLD,10,31,105,0,146
2014,Suriname,SUR,Netherlands,NLD,0,0,5,0,5
2014,Syrian Arab Rep.,SYR,Netherlands,NLD,349,5090,513,0,5952
2014,United Rep. of Tanzania,TZA,Netherlands,NLD,0,0,12,0,12
2014,Tajikistan,TJK,Netherlands,NLD,0,0,5,0,5
2014,Togo,TGO,Netherlands,NLD,0,0,5,0,5
2014,Trinidad and Tobago,TTO,Netherlands,NLD,5,0,0,0,5
2014,Tunisia,TUN,Netherlands,NLD,0,0,17,0,17
2014,Turkey,TUR,Netherlands,NLD,5,10,38,0,53
2014,Uganda,UGA,Netherlands,NLD,67,11,87,0,165
2014,Ukraine,UKR,Netherlands,NLD,5,0,153,0,158
2014,United States of America,USA,Netherlands,NLD,0,0,5,0,5
2014,Uzbekistan,UZB,Netherlands,NLD,0,5,10,0,15
2014,Yemen,YEM,Netherlands,NLD,0,11,20,0,31
2014,Zambia,ZMB,Netherlands,NLD,5,0,0,0,5
2014,Zimbabwe,ZWE,Netherlands,NLD,0,0,10,0,10
2014,Stateless,XXA,Netherlands,NLD,1285,82,238,0,1605
2014,Central African Rep.,CAF,Niger,NER,0,0,15,0,15
2014,Chad,TCD,Niger,NER,0,0,0,10,10
2014,Cameroon,CMR,Niger,NER,0,0,0,5,5
2014,Dem. Rep. of the Congo,COD,Niger,NER,0,0,0,5,5
2014,Cote d'Ivoire,CIV,Niger,NER,0,0,0,15,15
2014,Nigeria,NGA,Niger,NER,0,0,0,10,10
2014,Cuba,CUB,Nicaragua,NIC,5,0,0,0,5
2014,Guatemala,GTM,Nicaragua,NIC,5,0,0,0,5
2014,Honduras,HND,Nicaragua,NIC,5,0,0,0,5
2014,El Salvador,SLV,Nicaragua,NIC,74,0,0,0,74
2014,Central African Rep.,CAF,Nigeria,NGA,66,0,10,32,108
2014,Chad,TCD,Nigeria,NGA,5,0,0,48,53
2014,Cameroon,CMR,Nigeria,NGA,0,0,0,10,10
2014,Congo,COG,Nigeria,NGA,0,0,0,5,5
2014,Dem. Rep. of the Congo,COD,Nigeria,NGA,22,0,115,51,188
2014,Cote d'Ivoire,CIV,Nigeria,NGA,5,0,14,12,31
2014,Mali,MLI,Nigeria,NGA,26,0,23,5,54
2014,Sierra Leone,SLE,Nigeria,NGA,5,0,0,0,5
2014,Sudan,SDN,Nigeria,NGA,0,0,0,5,5
2014,Syrian Arab Rep.,SYR,Nigeria,NGA,5,0,0,0,5
2014,Togo,TGO,Nigeria,NGA,5,0,5,0,10
2014,Afghanistan,AFG,Norway,NOR,140,107,157,121,525
2014,Albania,ALB,Norway,NOR,0,0,203,10,213
2014,Algeria,DZA,Norway,NOR,0,0,25,101,126
2014,Angola,AGO,Norway,NOR,0,0,0,10,10
2014,Egypt,EGY,Norway,NOR,5,0,5,20,30
2014,Armenia,ARM,Norway,NOR,0,0,5,14,19
2014,Azerbaijan,AZE,Norway,NOR,0,0,15,0,15
2014,Burundi,BDI,Norway,NOR,0,0,5,0,5
2014,Benin,BEN,Norway,NOR,0,0,0,5,5
2014,Bangladesh,BGD,Norway,NOR,5,0,141,11,157
2014,Burkina Faso,BFA,Norway,NOR,0,0,0,5,5
2014,Belarus,BLR,Norway,NOR,0,0,26,28,54
2014,Bosnia and Herzegovina,BIH,Norway,NOR,0,0,32,50,82
2014,Bulgaria,BGR,Norway,NOR,0,0,5,0,5
2014,Central African Rep.,CAF,Norway,NOR,0,5,0,0,5
2014,Chad,TCD,Norway,NOR,0,0,0,10,10
2014,China,CHN,Norway,NOR,28,0,5,10,43
2014,Cameroon,CMR,Norway,NOR,0,0,13,5,18
2014,Dem. Rep. of the Congo,COD,Norway,NOR,0,0,12,5,17
2014,Colombia,COL,Norway,NOR,0,0,0,5,5
2014,Cuba,CUB,Norway,NOR,0,0,5,0,5
2014,Czechia,CZE,Norway,NOR,0,0,0,5,5
2014,Djibouti,DJI,Norway,NOR,0,0,0,5,5
2014,Eritrea,ERI,Norway,NOR,1890,0,85,374,2349
2014,Ethiopia,ETH,Norway,NOR,143,0,50,64,257
2014,Gambia,GMB,Norway,NOR,0,0,13,5,18
2014,Georgia,GEO,Norway,NOR,0,0,27,10,37
2014,Ghana,GHA,Norway,NOR,0,0,13,13,26
2014,Guinea,GIN,Norway,NOR,0,0,12,19,31
2014,Croatia,HRV,Norway,NOR,0,0,0,5,5
2014,Cote d'Ivoire,CIV,Norway,NOR,0,0,14,5,19
2014,India,IND,Norway,NOR,0,0,23,14,37
2014,Iran (Islamic Rep. of),IRN,Norway,NOR,46,0,55,59,160
2014,Iraq,IRQ,Norway,NOR,12,10,43,92,157
2014,Israel,ISR,Norway,NOR,0,0,0,5,5
2014,Italy,ITA,Norway,NOR,0,0,5,0,5
2014,Jordan,JOR,Norway,NOR,0,0,11,19,30
2014,Kazakhstan,KAZ,Norway,NOR,0,0,5,11,16
2014,Kenya,KEN,Norway,NOR,5,0,0,5,10
2014,Kyrgyzstan,KGZ,Norway,NOR,0,0,5,10,15
2014,Liberia,LBR,Norway,NOR,0,0,0,16,16
2014,Libya,LBY,Norway,NOR,0,0,5,61,66
2014,Lebanon,LBN,Norway,NOR,0,0,12,19,31
2014,Sri Lanka,LKA,Norway,NOR,0,0,5,11,16
2014,Mauritania,MRT,Norway,NOR,0,0,0,5,5
2014,North Macedonia,MKD,Norway,NOR,0,0,24,5,29
2014,Rep. of Moldova,MDA,Norway,NOR,0,0,5,0,5
2014,Mali,MLI,Norway,NOR,0,0,10,11,21
2014,Malaysia,MYS,Norway,NOR,0,0,5,0,5
2014,Mongolia,MNG,Norway,NOR,0,0,10,0,10
2014,Morocco,MAR,Norway,NOR,0,0,37,109,146
2014,Myanmar,MMR,Norway,NOR,5,0,5,14,24
2014,Nepal,NPL,Norway,NOR,0,0,0,5,5
2014,Niger,NER,Norway,NOR,0,0,0,5,5
2014,Nigeria,NGA,Norway,NOR,5,0,139,244,388
2014,Pakistan,PAK,Norway,NOR,14,0,67,63,144
2014,Philippines,PHL,Norway,NOR,0,0,10,0,10
2014,Poland,POL,Norway,NOR,0,0,5,0,5
2014,Romania,ROU,Norway,NOR,0,0,5,0,5
2014,Russian Federation,RUS,Norway,NOR,10,0,127,104,241
2014,Rwanda,RWA,Norway,NOR,0,0,0,10,10
2014,Serbia and Kosovo: S/RES/1244 (1999),SRB,Norway,NOR,0,0,166,69,235
2014,Senegal,SEN,Norway,NOR,0,0,5,11,16
2014,Sierra Leone,SLE,Norway,NOR,5,0,0,14,19
2014,Somalia,SOM,Norway,NOR,384,73,273,185,915
2014,Spain,ESP,Norway,NOR,0,0,0,5,5
2014,Viet Nam,VNM,Norway,NOR,0,0,12,17,29
2014,Sudan,SDN,Norway,NOR,137,0,60,166,363
2014,South Sudan,SSD,Norway,NOR,0,0,0,5,5
2014,Slovakia,SVK,Norway,NOR,0,0,5,0,5
2014,Syrian Arab Rep.,SYR,Norway,NOR,575,669,16,175,1435
2014,United Rep. of Tanzania,TZA,Norway,NOR,0,0,0,5,5
2014,Tajikistan,TJK,Norway,NOR,0,0,11,0,11
2014,Tunisia,TUN,Norway,NOR,0,0,16,71,87
2014,Turkey,TUR,Norway,NOR,0,10,20,23,53
2014,Uganda,UGA,Norway,NOR,16,0,14,23,53
2014,Ukraine,UKR,Norway,NOR,0,0,77,40,117
2014,Uzbekistan,UZB,Norway,NOR,5,5,95,24,129
2014,Venezuela (Bolivarian Republic of),VEN,Norway,NOR,0,0,5,0,5
2014,Yemen,YEM,Norway,NOR,0,0,12,18,30
2014,Zimbabwe,ZWE,Norway,NOR,0,0,0,5,5
2014,Stateless,XXA,Norway,NOR,145,260,51,101,557
2014,Afghanistan,AFG,Nauru,NRU,30,0,0,0,30
2014,Bangladesh,BGD,Nauru,NRU,0,0,12,0,12
2014,Iran (Islamic Rep. of),IRN,Nauru,NRU,158,0,39,0,197
2014,Iraq,IRQ,Nauru,NRU,13,0,0,0,13
2014,Lebanon,LBN,Nauru,NRU,10,0,0,0,10
2014,Sri Lanka,LKA,Nauru,NRU,0,0,5,0,5
2014,Myanmar,MMR,Nauru,NRU,5,0,0,0,5
2014,Nepal,NPL,Nauru,NRU,0,0,5,0,5
2014,Pakistan,PAK,Nauru,NRU,62,0,24,0,86
2014,Somalia,SOM,Nauru,NRU,42,0,5,0,47
2014,Sudan,SDN,Nauru,NRU,12,0,0,0,12
2014,Stateless,XXA,Nauru,NRU,49,0,0,0,49
2014,Congo,COG,Panama,PAN,0,0,0,5,5
2014,Colombia,COL,Panama,PAN,52,0,18,260,330
2014,Cuba,CUB,Panama,PAN,0,0,0,19,19
2014,Ghana,GHA,Panama,PAN,0,0,0,17,17
2014,Honduras,HND,Panama,PAN,0,0,0,5,5
2014,Mexico,MEX,Panama,PAN,0,0,0,5,5
2014,Nicaragua,NIC,Panama,PAN,0,0,0,5,5
2014,El Salvador,SLV,Panama,PAN,5,0,0,0,5
2014,Venezuela (Bolivarian Republic of),VEN,Panama,PAN,12,0,5,0,17
2014,Bolivia (Plurinational State of),BOL,Paraguay,PRY,5,0,0,0,5
2014,Cuba,CUB,Paraguay,PRY,5,0,5,0,10
2014,Syrian Arab Rep.,SYR,Paraguay,PRY,5,0,0,0,5
2014,Argentina,ARG,Peru,PER,0,0,10,0,10
2014,Bangladesh,BGD,Peru,PER,14,0,0,0,14
2014,Colombia,COL,Peru,PER,71,0,104,93,268
2014,Cuba,CUB,Peru,PER,22,0,43,5,70
2014,Dominican Rep.,DOM,Peru,PER,5,0,15,18,38
2014,Ecuador,ECU,Peru,PER,0,0,13,0,13
2014,Palestinian,PSE,Peru,PER,5,0,0,0,5
2014,Haiti,HTI,Peru,PER,5,0,0,0,5
2014,India,IND,Peru,PER,0,0,11,0,11
2014,Iraq,IRQ,Peru,PER,10,0,0,0,10
2014,Sri Lanka,LKA,Peru,PER,0,0,0,10,10
2014,Nigeria,NGA,Peru,PER,5,0,0,0,5
2014,El Salvador,SLV,Peru,PER,0,0,0,5,5
2014,Syrian Arab Rep.,SYR,Peru,PER,17,0,0,0,17
2014,Venezuela (Bolivarian Republic of),VEN,Peru,PER,5,0,14,0,19
2014,Palestinian,PSE,Philippines,PHL,12,0,0,0,12
2014,Iran (Islamic Rep. of),IRN,Philippines,PHL,10,0,0,0,10
2014,Iraq,IRQ,Philippines,PHL,11,0,0,0,11
2014,Pakistan,PAK,Philippines,PHL,5,0,0,0,5
2014,Syrian Arab Rep.,SYR,Philippines,PHL,13,0,0,0,13
2014,Afghanistan,AFG,Papua New Guinea,PNG,27,0,16,5,48
2014,Bangladesh,BGD,Papua New Guinea,PNG,5,0,12,0,17
2014,Iran (Islamic Rep. of),IRN,Papua New Guinea,PNG,35,0,55,196,286
2014,Iraq,IRQ,Papua New Guinea,PNG,10,0,5,55,70
2014,Lebanon,LBN,Papua New Guinea,PNG,0,0,5,11,16
2014,Myanmar,MMR,Papua New Guinea,PNG,0,0,0,5,5
2014,Nepal,NPL,Papua New Guinea,PNG,0,0,5,0,5
2014,Pakistan,PAK,Papua New Guinea,PNG,27,0,14,5,46
2014,Somalia,SOM,Papua New Guinea,PNG,0,0,0,5,5
2014,Viet Nam,VNM,Papua New Guinea,PNG,0,0,0,5,5
2014,Sudan,SDN,Papua New Guinea,PNG,20,0,0,0,20
2014,Syrian Arab Rep.,SYR,Papua New Guinea,PNG,0,0,0,5,5
2014,Stateless,XXA,Papua New Guinea,PNG,13,0,0,5,18
2014,Afghanistan,AFG,Poland,POL,28,0,15,24,67
2014,Algeria,DZA,Poland,POL,0,0,0,5,5
2014,Egypt,EGY,Poland,POL,14,0,0,5,19
2014,Armenia,ARM,Poland,POL,0,0,30,122,152
2014,Bangladesh,BGD,Poland,POL,0,0,5,29,34
2014,Belarus,BLR,Poland,POL,15,0,11,18,44
2014,China,CHN,Poland,POL,5,0,0,5,10
2014,Eritrea,ERI,Poland,POL,0,5,0,0,5
2014,Palestinian,PSE,Poland,POL,0,0,0,5,5
2014,Georgia,GEO,Poland,POL,0,0,133,674,807
2014,India,IND,Poland,POL,0,0,0,14,14
2014,Iran (Islamic Rep. of),IRN,Poland,POL,5,0,5,12,22
2014,Iraq,IRQ,Poland,POL,10,14,0,15,39
2014,Jordan,JOR,Poland,POL,0,0,0,5,5
2014,Kazakhstan,KAZ,Poland,POL,22,11,22,73,128
2014,Kyrgyzstan,KGZ,Poland,POL,0,0,19,71,90
2014,Liberia,LBR,Poland,POL,0,0,0,5,5
2014,Libya,LBY,Poland,POL,0,0,5,5,10
2014,Lebanon,LBN,Poland,POL,0,0,0,5,5
2014,Sri Lanka,LKA,Poland,POL,0,0,0,5,5
2014,Rep. of Moldova,MDA,Poland,POL,0,0,5,0,5
2014,Mongolia,MNG,Poland,POL,0,0,0,10,10
2014,Morocco,MAR,Poland,POL,0,0,0,5,5
2014,Nigeria,NGA,Poland,POL,0,0,0,5,5
2014,Pakistan,PAK,Poland,POL,0,0,14,32,46
2014,Russian Federation,RUS,Poland,POL,13,107,1002,3822,4944
2014,Somalia,SOM,Poland,POL,10,5,0,0,15
2014,Viet Nam,VNM,Poland,POL,0,0,42,16,58
2014,Syrian Arab Rep.,SYR,Poland,POL,115,17,0,62,194
2014,Tajikistan,TJK,Poland,POL,0,0,0,81,81
2014,Turkmenistan,TKM,Poland,POL,5,0,0,0,5
2014,Tunisia,TUN,Poland,POL,0,0,5,0,5
2014,Turkey,TUR,Poland,POL,0,0,5,5,10
2014,Uganda,UGA,Poland,POL,0,0,0,5,5
2014,Ukraine,UKR,Poland,POL,0,5,645,373,1023
2014,Uzbekistan,UZB,Poland,POL,0,0,12,13,25
2014,Stateless,XXA,Poland,POL,24,0,0,20,44
2014,Angola,AGO,Portugal,PRT,0,0,0,16,16
2014,Armenia,ARM,Portugal,PRT,5,0,0,0,5
2014,Bangladesh,BGD,Portugal,PRT,0,0,0,5,5
2014,Belarus,BLR,Portugal,PRT,0,5,0,0,5
2014,Brazil,BRA,Portugal,PRT,0,0,0,5,5
2014,China,CHN,Portugal,PRT,0,0,0,5,5
2014,Dem. Rep. of the Congo,COD,Portugal,PRT,0,0,0,13,13
2014,Eritrea,ERI,Portugal,PRT,0,10,0,0,10
2014,Palestinian,PSE,Portugal,PRT,0,0,0,5,5
2014,Ghana,GHA,Portugal,PRT,0,0,0,5,5
2014,Guinea-Bissau,GNB,Portugal,PRT,0,0,0,13,13
2014,Guinea,GIN,Portugal,PRT,0,13,5,20,38
2014,Cote d'Ivoire,CIV,Portugal,PRT,0,0,0,13,13
2014,Iran (Islamic Rep. of),IRN,Portugal,PRT,5,5,0,0,10
2014,Iraq,IRQ,Portugal,PRT,0,0,0,5,5
2014,Sri Lanka,LKA,Portugal,PRT,0,5,0,5,10
2014,Mali,MLI,Portugal,PRT,0,5,0,18,23
2014,Morocco,MAR,Portugal,PRT,5,0,0,19,24
2014,Nigeria,NGA,Portugal,PRT,0,5,0,5,10
2014,Pakistan,PAK,Portugal,PRT,0,14,0,10,24
2014,Russian Federation,RUS,Portugal,PRT,5,0,0,0,5
2014,Senegal,SEN,Portugal,PRT,0,0,0,10,10
2014,Sierra Leone,SLE,Portugal,PRT,0,5,0,0,5
2014,Somalia,SOM,Portugal,PRT,0,5,0,5,10
2014,Syrian Arab Rep.,SYR,Portugal,PRT,0,0,0,11,11
2014,Ukraine,UKR,Portugal,PRT,0,18,0,5,23
2014,Afghanistan,AFG,Romania,ROU,33,19,221,0,273
2014,Albania,ALB,Romania,ROU,0,0,12,5,17
2014,Algeria,DZA,Romania,ROU,0,0,5,0,5
2014,Egypt,EGY,Romania,ROU,0,0,12,0,12
2014,Armenia,ARM,Romania,ROU,0,0,5,0,5
2014,Bangladesh,BGD,Romania,ROU,0,0,5,0,5
2014,Central African Rep.,CAF,Romania,ROU,5,0,0,0,5
2014,China,CHN,Romania,ROU,0,0,12,0,12
2014,Cameroon,CMR,Romania,ROU,0,0,14,0,14
2014,Congo,COG,Romania,ROU,0,0,0,5,5
2014,Dem. Rep. of the Congo,COD,Romania,ROU,5,0,0,0,5
2014,Ethiopia,ETH,Romania,ROU,0,0,5,0,5
2014,Palestinian,PSE,Romania,ROU,0,0,11,0,11
2014,Georgia,GEO,Romania,ROU,0,0,5,5,10
2014,Ghana,GHA,Romania,ROU,0,0,5,0,5
2014,Guinea,GIN,Romania,ROU,0,0,5,0,5
2014,Cote d'Ivoire,CIV,Romania,ROU,0,0,5,0,5
2014,India,IND,Romania,ROU,0,0,5,0,5
2014,Iran (Islamic Rep. of),IRN,Romania,ROU,0,0,63,0,63
2014,Iraq,IRQ,Romania,ROU,111,10,88,0,209
2014,Jordan,JOR,Romania,ROU,0,0,5,0,5
2014,Libya,LBY,Romania,ROU,0,0,5,0,5
2014,Lebanon,LBN,Romania,ROU,0,0,5,5,10
2014,Rep. of Moldova,MDA,Romania,ROU,0,0,13,0,13
2014,Morocco,MAR,Romania,ROU,0,0,5,5,10
2014,Myanmar,MMR,Romania,ROU,5,0,0,0,5
2014,Nigeria,NGA,Romania,ROU,0,0,10,0,10
2014,Pakistan,PAK,Romania,ROU,5,0,22,5,32
2014,Philippines,PHL,Romania,ROU,0,0,11,0,11
2014,Russian Federation,RUS,Romania,ROU,0,0,10,0,10
2014,Serbia and Kosovo: S/RES/1244 (1999),SRB,Romania,ROU,0,0,5,5,10
2014,Senegal,SEN,Romania,ROU,0,0,5,0,5
2014,Somalia,SOM,Romania,ROU,5,0,5,0,10
2014,Viet Nam,VNM,Romania,ROU,0,0,5,0,5
2014,Sudan,SDN,Romania,ROU,5,0,0,0,5
2014,Syrian Arab Rep.,SYR,Romania,ROU,180,287,135,10,612
2014,Tunisia,TUN,Romania,ROU,0,0,5,0,5
2014,Turkey,TUR,Romania,ROU,5,0,21,5,31
2014,Ukraine,UKR,Romania,ROU,0,16,5,10,31
2014,Zimbabwe,ZWE,Romania,ROU,5,0,0,0,5
2014,Stateless,XXA,Romania,ROU,5,0,0,0,5
2014,Afghanistan,AFG,South Africa,ZAF,0,0,10,0,10
2014,Algeria,DZA,South Africa,ZAF,0,0,75,0,75
2014,Egypt,EGY,South Africa,ZAF,0,0,242,0,242
2014,Burundi,BDI,South Africa,ZAF,40,0,984,5,1029
2014,Benin,BEN,South Africa,ZAF,0,0,35,0,35
2014,Bangladesh,BGD,South Africa,ZAF,0,0,6656,11,6667
2014,Burkina Faso,BFA,South Africa,ZAF,0,0,21,0,21
2014,Bulgaria,BGR,South Africa,ZAF,5,0,0,0,5
2014,Central African Rep.,CAF,South Africa,ZAF,5,0,5,0,10
2014,China,CHN,South Africa,ZAF,0,0,621,0,621
2014,Cameroon,CMR,South Africa,ZAF,5,0,705,0,710
2014,Congo,COG,South Africa,ZAF,600,0,994,0,1594
2014,Dem. Rep. of the Congo,COD,South Africa,ZAF,2321,0,7245,12,9578
2014,Comoros,COM,South Africa,ZAF,0,0,16,0,16
2014,Eritrea,ERI,South Africa,ZAF,167,0,33,0,200
2014,Ethiopia,ETH,South Africa,ZAF,3042,0,5143,0,8185
2014,Gabon,GAB,South Africa,ZAF,0,0,10,0,10
2014,Palestinian,PSE,South Africa,ZAF,0,0,5,0,5
2014,Ghana,GHA,South Africa,ZAF,0,0,2401,0,2401
2014,Guinea,GIN,South Africa,ZAF,0,0,12,0,12
2014,Cote d'Ivoire,CIV,South Africa,ZAF,5,0,36,0,41
2014,India,IND,South Africa,ZAF,0,0,1808,0,1808
2014,Jordan,JOR,South Africa,ZAF,0,0,5,0,5
2014,Kenya,KEN,South Africa,ZAF,5,0,259,0,264
2014,Liberia,LBR,South Africa,ZAF,0,0,10,0,10
2014,Lesotho,LSO,South Africa,ZAF,0,0,1463,0,1463
2014,Sri Lanka,LKA,South Africa,ZAF,0,0,17,0,17
2014,Mali,MLI,South Africa,ZAF,0,0,14,0,14
2014,Malawi,MWI,South Africa,ZAF,0,0,2768,5,2773
2014,Morocco,MAR,South Africa,ZAF,0,0,10,0,10
2014,Mozambique,MOZ,South Africa,ZAF,0,0,1567,0,1567
2014,Nepal,NPL,South Africa,ZAF,0,0,14,0,14
2014,Niger,NER,South Africa,ZAF,0,0,116,0,116
2014,Nigeria,NGA,South Africa,ZAF,0,0,7710,5,7715
2014,Pakistan,PAK,South Africa,ZAF,0,0,2606,0,2606
2014,Rwanda,RWA,South Africa,ZAF,26,0,210,0,236
2014,Senegal,SEN,South Africa,ZAF,0,0,198,0,198
2014,Sierra Leone,SLE,South Africa,ZAF,0,0,15,0,15
2014,Somalia,SOM,South Africa,ZAF,2904,0,216,0,3120
2014,Sudan,SDN,South Africa,ZAF,14,0,10,0,24
2014,Eswatini,SWZ,South Africa,ZAF,0,0,58,0,58
2014,Syrian Arab Rep.,SYR,South Africa,ZAF,14,0,0,0,14
2014,United Rep. of Tanzania,TZA,South Africa,ZAF,0,0,590,0,590
2014,Thailand,THA,South Africa,ZAF,0,0,5,0,5
2014,Togo,TGO,South Africa,ZAF,0,0,18,0,18
2014,Uganda,UGA,South Africa,ZAF,63,0,1089,0,1152
2014,Ukraine,UKR,South Africa,ZAF,5,0,0,0,5
2014,Yemen,YEM,South Africa,ZAF,0,0,5,0,5
2014,Zambia,ZMB,South Africa,ZAF,0,0,148,0,148
2014,Zimbabwe,ZWE,South Africa,ZAF,15,0,20244,10,20269
2014,Afghanistan,AFG,Russian Federation,RUS,5,0,291,0,296
2014,Egypt,EGY,Russian Federation,RUS,0,0,25,0,25
2014,Armenia,ARM,Russian Federation,RUS,0,0,5,0,5
2014,Azerbaijan,AZE,Russian Federation,RUS,0,0,5,0,5
2014,Belarus,BLR,Russian Federation,RUS,0,0,5,0,5
2014,Eritrea,ERI,Russian Federation,RUS,0,0,5,0,5
2014,Palestinian,PSE,Russian Federation,RUS,0,0,10,0,10
2014,Georgia,GEO,Russian Federation,RUS,0,0,91,0,91
2014,India,IND,Russian Federation,RUS,0,0,5,0,5
2014,Iraq,IRQ,Russian Federation,RUS,0,0,10,0,10
2014,Kazakhstan,KAZ,Russian Federation,RUS,0,0,5,0,5
2014,Kyrgyzstan,KGZ,Russian Federation,RUS,0,0,23,0,23
2014,Dem. People's Rep. of Korea,PRK,Russian Federation,RUS,0,0,11,0,11
2014,Lebanon,LBN,Russian Federation,RUS,0,0,5,0,5
2014,Rep. of Moldova,MDA,Russian Federation,RUS,5,0,12,0,17
2014,Pakistan,PAK,Russian Federation,RUS,0,0,5,0,5
2014,Viet Nam,VNM,Russian Federation,RUS,0,0,5,0,5
2014,Sudan,SDN,Russian Federation,RUS,0,0,5,0,5
2014,Syrian Arab Rep.,SYR,Russian Federation,RUS,0,0,581,0,581
2014,Tajikistan,TJK,Russian Federation,RUS,0,0,18,0,18
2014,Turkmenistan,TKM,Russian Federation,RUS,0,0,5,0,5
2014,Ukraine,UKR,Russian Federation,RUS,241,0,3886,0,4127
2014,United States of America,USA,Russian Federation,RUS,0,0,5,0,5
2014,Uzbekistan,UZB,Russian Federation,RUS,0,0,57,0,57
2014,Afghanistan,AFG,Rwanda,RWA,5,0,0,0,5
2014,Burundi,BDI,Rwanda,RWA,21,0,0,0,21
2014,Dem. Rep. of the Congo,COD,Rwanda,RWA,5,0,0,0,5
2014,Cuba,CUB,El Salvador,SLV,0,0,5,0,5
2014,Honduras,HND,El Salvador,SLV,5,0,0,0,5
2014,Mexico,MEX,El Salvador,SLV,5,0,0,0,5
2014,Afghanistan,AFG,Serbia and Kosovo: S/RES/1244 (1999),SRB,0,0,0,2980,2980
2014,Albania,ALB,Serbia and Kosovo: S/RES/1244 (1999),SRB,0,0,5,0,5
2014,Algeria,DZA,Serbia and Kosovo: S/RES/1244 (1999),SRB,0,0,0,20,20
2014,Egypt,EGY,Serbia and Kosovo: S/RES/1244 (1999),SRB,0,0,0,5,5
2014,Bangladesh,BGD,Serbia and Kosovo: S/RES/1244 (1999),SRB,0,0,0,129,129
2014,Burkina Faso,BFA,Serbia and Kosovo: S/RES/1244 (1999),SRB,0,0,0,10,10
2014,Central African Rep.,CAF,Serbia and Kosovo: S/RES/1244 (1999),SRB,0,0,0,10,10
2014,Cameroon,CMR,Serbia and Kosovo: S/RES/1244 (1999),SRB,0,0,0,56,56
2014,Congo,COG,Serbia and Kosovo: S/RES/1244 (1999),SRB,0,0,0,65,65
2014,Dem. Rep. of the Congo,COD,Serbia and Kosovo: S/RES/1244 (1999),SRB,0,0,0,38,38
2014,Comoros,COM,Serbia and Kosovo: S/RES/1244 (1999),SRB,0,0,0,32,32
2014,Cuba,CUB,Serbia and Kosovo: S/RES/1244 (1999),SRB,0,0,0,15,15
2014,Eritrea,ERI,Serbia and Kosovo: S/RES/1244 (1999),SRB,0,0,0,794,794
2014,Ethiopia,ETH,Serbia and Kosovo: S/RES/1244 (1999),SRB,0,5,0,0,5
2014,Gambia,GMB,Serbia and Kosovo: S/RES/1244 (1999),SRB,0,0,0,61,61
2014,Palestinian,PSE,Serbia and Kosovo: S/RES/1244 (1999),SRB,0,0,0,189,189
2014,Ghana,GHA,Serbia and Kosovo: S/RES/1244 (1999),SRB,0,0,0,167,167
2014,Guinea,GIN,Serbia and Kosovo: S/RES/1244 (1999),SRB,0,0,0,26,26
2014,Cote d'Ivoire,CIV,Serbia and Kosovo: S/RES/1244 (1999),SRB,0,0,0,54,54
2014,India,IND,Serbia and Kosovo: S/RES/1244 (1999),SRB,0,0,0,21,21
2014,Iran (Islamic Rep. of),IRN,Serbia and Kosovo: S/RES/1244 (1999),SRB,0,0,0,90,90
2014,Iraq,IRQ,Serbia and Kosovo: S/RES/1244 (1999),SRB,0,0,0,275,275
2014,Liberia,LBR,Serbia and Kosovo: S/RES/1244 (1999),SRB,0,0,0,5,5
2014,Libya,LBY,Serbia and Kosovo: S/RES/1244 (1999),SRB,0,0,0,17,17
2014,Sri Lanka,LKA,Serbia and Kosovo: S/RES/1244 (1999),SRB,0,0,0,5,5
2014,Mauritania,MRT,Serbia and Kosovo: S/RES/1244 (1999),SRB,0,0,0,10,10
2014,North Macedonia,MKD,Serbia and Kosovo: S/RES/1244 (1999),SRB,0,0,0,5,5
2014,Mali,MLI,Serbia and Kosovo: S/RES/1244 (1999),SRB,0,0,0,183,183
2014,Morocco,MAR,Serbia and Kosovo: S/RES/1244 (1999),SRB,0,0,0,10,10
2014,Nigeria,NGA,Serbia and Kosovo: S/RES/1244 (1999),SRB,0,0,0,216,216
2014,Pakistan,PAK,Serbia and Kosovo: S/RES/1244 (1999),SRB,0,0,0,323,323
2014,Rwanda,RWA,Serbia and Kosovo: S/RES/1244 (1999),SRB,0,0,0,20,20
2014,Saudi Arabia,SAU,Serbia and Kosovo: S/RES/1244 (1999),SRB,0,0,0,5,5
2014,Senegal,SEN,Serbia and Kosovo: S/RES/1244 (1999),SRB,0,0,0,27,27
2014,Sierra Leone,SLE,Serbia and Kosovo: S/RES/1244 (1999),SRB,0,0,0,35,35
2014,Somalia,SOM,Serbia and Kosovo: S/RES/1244 (1999),SRB,0,0,0,708,708
2014,Sudan,SDN,Serbia and Kosovo: S/RES/1244 (1999),SRB,0,0,0,260,260
2014,Syrian Arab Rep.,SYR,Serbia and Kosovo: S/RES/1244 (1999),SRB,0,5,0,9601,9606
2014,Togo,TGO,Serbia and Kosovo: S/RES/1244 (1999),SRB,0,0,0,13,13
2014,Tunisia,TUN,Serbia and Kosovo: S/RES/1244 (1999),SRB,0,0,0,11,11
2014,Uganda,UGA,Serbia and Kosovo: S/RES/1244 (1999),SRB,0,0,0,13,13
2014,Ukraine,UKR,Serbia and Kosovo: S/RES/1244 (1999),SRB,0,0,0,5,5
2014,Yemen,YEM,Serbia and Kosovo: S/RES/1244 (1999),SRB,0,0,0,17,17
2014,Eritrea,ERI,Sierra Leone,SLE,0,0,0,5,5
2014,Guinea,GIN,Sierra Leone,SLE,0,0,0,10,10
2014,Cote d'Ivoire,CIV,Sierra Leone,SLE,5,0,0,5,10
2014,Afghanistan,AFG,Spain,ESP,21,10,10,0,41
2014,Albania,ALB,Spain,ESP,0,0,17,0,17
2014,Algeria,DZA,Spain,ESP,0,0,287,0,287
2014,Egypt,EGY,Spain,ESP,5,0,0,0,5
2014,Armenia,ARM,Spain,ESP,5,0,16,0,21
2014,Bangladesh,BGD,Spain,ESP,0,0,32,0,32
2014,Burkina Faso,BFA,Spain,ESP,0,0,5,0,5
2014,Belarus,BLR,Spain,ESP,0,0,11,0,11
2014,Bolivia (Plurinational State of),BOL,Spain,ESP,0,0,10,0,10
2014,Brazil,BRA,Spain,ESP,0,0,10,0,10
2014,Central African Rep.,CAF,Spain,ESP,0,0,5,0,5
2014,Chad,TCD,Spain,ESP,0,0,5,0,5
2014,China,CHN,Spain,ESP,12,0,0,0,12
2014,Cameroon,CMR,Spain,ESP,5,0,34,0,39
2014,Congo,COG,Spain,ESP,0,0,5,0,5
2014,Dem. Rep. of the Congo,COD,Spain,ESP,0,5,38,0,43
2014,Colombia,COL,Spain,ESP,14,0,71,0,85
2014,Cuba,CUB,Spain,ESP,0,5,13,0,18
2014,Dominican Rep.,DOM,Spain,ESP,0,0,14,0,14
2014,Ecuador,ECU,Spain,ESP,0,0,13,0,13
2014,Equatorial Guinea,GNQ,Spain,ESP,0,0,5,0,5
2014,Eritrea,ERI,Spain,ESP,0,5,0,0,5
2014,Ethiopia,ETH,Spain,ESP,0,5,5,0,10
2014,Gambia,GMB,Spain,ESP,0,0,35,0,35
2014,Palestinian,PSE,Spain,ESP,68,18,18,0,104
2014,Georgia,GEO,Spain,ESP,0,0,20,0,20
2014,Ghana,GHA,Spain,ESP,0,0,11,0,11
2014,Guinea-Bissau,GNB,Spain,ESP,0,0,10,0,10
2014,Guatemala,GTM,Spain,ESP,0,5,0,0,5
2014,Guinea,GIN,Spain,ESP,0,0,77,0,77
2014,Honduras,HND,Spain,ESP,5,0,22,0,27
2014,Cote d'Ivoire,CIV,Spain,ESP,0,10,327,0,337
2014,India,IND,Spain,ESP,0,0,5,0,5
2014,Iran (Islamic Rep. of),IRN,Spain,ESP,17,0,26,0,43
2014,Iraq,IRQ,Spain,ESP,5,0,0,0,5
2014,Kenya,KEN,Spain,ESP,0,0,5,0,5
2014,Liberia,LBR,Spain,ESP,0,0,18,0,18
2014,Libya,LBY,Spain,ESP,0,0,10,0,10
2014,Lebanon,LBN,Spain,ESP,0,0,5,0,5
2014,Sri Lanka,LKA,Spain,ESP,0,5,5,0,10
2014,Mexico,MEX,Spain,ESP,5,0,11,0,16
2014,Mali,MLI,Spain,ESP,0,0,131,0,131
2014,Morocco,MAR,Spain,ESP,5,0,76,0,81
2014,Mauritius,MUS,Spain,ESP,0,0,10,0,10
2014,Nigeria,NGA,Spain,ESP,0,0,200,0,200
2014,Pakistan,PAK,Spain,ESP,48,5,52,0,105
2014,Peru,PER,Spain,ESP,0,0,5,0,5
2014,Philippines,PHL,Spain,ESP,0,0,5,0,5
2014,Russian Federation,RUS,Spain,ESP,22,0,19,0,41
2014,Rwanda,RWA,Spain,ESP,0,0,14,0,14
2014,El Salvador,SLV,Spain,ESP,0,0,36,0,36
2014,Senegal,SEN,Spain,ESP,0,0,43,0,43
2014,Sierra Leone,SLE,Spain,ESP,0,0,11,0,11
2014,Somalia,SOM,Spain,ESP,5,86,27,0,118
2014,Sudan,SDN,Spain,ESP,5,0,14,0,19
2014,Syrian Arab Rep.,SYR,Spain,ESP,122,1039,10,0,1171
2014,Tunisia,TUN,Spain,ESP,0,0,5,0,5
2014,Uganda,UGA,Spain,ESP,0,0,10,0,10
2014,Ukraine,UKR,Spain,ESP,0,0,79,0,79
2014,Uzbekistan,UZB,Spain,ESP,0,0,5,0,5
2014,Venezuela (Bolivarian Republic of),VEN,Spain,ESP,0,0,20,0,20
2014,Western Sahara,ESH,Spain,ESP,0,0,25,0,25
2014,Central African Rep.,CAF,Sudan,SDN,53,0,0,0,53
2014,Dem. Rep. of the Congo,COD,Sudan,SDN,25,0,0,809,834
2014,Eritrea,ERI,Sudan,SDN,3533,0,14,2497,6044
2014,Ethiopia,ETH,Sudan,SDN,209,0,0,2646,2855
2014,Palestinian,PSE,Sudan,SDN,5,0,0,0,5
2014,Somalia,SOM,Sudan,SDN,20,0,0,92,112
2014,Syrian Arab Rep.,SYR,Sudan,SDN,59,0,0,0,59
2014,Afghanistan,AFG,Slovakia,SVK,10,46,5,52,113
2014,Algeria,DZA,Slovakia,SVK,0,0,0,10,10
2014,Armenia,ARM,Slovakia,SVK,0,0,5,5,10
2014,Cameroon,CMR,Slovakia,SVK,5,0,0,0,5
2014,Dem. Rep. of the Congo,COD,Slovakia,SVK,0,0,0,5,5
2014,Eritrea,ERI,Slovakia,SVK,0,10,0,0,10
2014,Palestinian,PSE,Slovakia,SVK,0,0,0,5,5
2014,Georgia,GEO,Slovakia,SVK,0,0,5,15,20
2014,India,IND,Slovakia,SVK,0,0,0,11,11
2014,Iran (Islamic Rep. of),IRN,Slovakia,SVK,0,5,5,0,10
2014,Iraq,IRQ,Slovakia,SVK,0,5,0,5,10
2014,Libya,LBY,Slovakia,SVK,0,5,0,0,5
2014,Rep. of Moldova,MDA,Slovakia,SVK,0,0,0,5,5
2014,Mongolia,MNG,Slovakia,SVK,0,0,5,0,5
2014,Morocco,MAR,Slovakia,SVK,0,0,0,5,5
2014,Pakistan,PAK,Slovakia,SVK,0,0,0,11,11
2014,Russian Federation,RUS,Slovakia,SVK,0,0,0,12,12
2014,Somalia,SOM,Slovakia,SVK,0,17,0,11,28
2014,Viet Nam,VNM,Slovakia,SVK,0,0,18,5,23
2014,Syrian Arab Rep.,SYR,Slovakia,SVK,0,14,17,11,42
2014,Turkey,TUR,Slovakia,SVK,0,0,0,5,5
2014,Ukraine,UKR,Slovakia,SVK,0,0,5,5,10
2014,Afghanistan,AFG,Slovenia,SVN,0,0,5,59,64
2014,Algeria,DZA,Slovenia,SVN,0,0,5,5,10
2014,Egypt,EGY,Slovenia,SVN,0,0,5,5,10
2014,Bangladesh,BGD,Slovenia,SVN,0,0,0,5,5
2014,Bosnia and Herzegovina,BIH,Slovenia,SVN,0,0,5,0,5
2014,China,CHN,Slovenia,SVN,0,0,0,5,5
2014,Cuba,CUB,Slovenia,SVN,0,0,5,5,10
2014,Palestinian,PSE,Slovenia,SVN,0,0,0,5,5
2014,Ghana,GHA,Slovenia,SVN,0,0,5,0,5
2014,Iran (Islamic Rep. of),IRN,Slovenia,SVN,10,0,5,5,20
2014,Iraq,IRQ,Slovenia,SVN,0,0,0,5,5
2014,Morocco,MAR,Slovenia,SVN,0,0,5,0,5
2014,Nigeria,NGA,Slovenia,SVN,0,0,11,5,16
2014,Pakistan,PAK,Slovenia,SVN,0,0,10,14,24
2014,Russian Federation,RUS,Slovenia,SVN,0,0,5,0,5
2014,Serbia and Kosovo: S/RES/1244 (1999),SRB,Slovenia,SVN,0,0,16,14,30
2014,Somalia,SOM,Slovenia,SVN,18,0,0,0,18
2014,Syrian Arab Rep.,SYR,Slovenia,SVN,5,10,0,70,85
2014,Turkey,TUR,Slovenia,SVN,0,0,0,10,10
2014,Ukraine,UKR,Slovenia,SVN,0,0,10,0,10
2014,Burundi,BDI,Eswatini,SWZ,45,0,0,10,55
2014,Dem. Rep. of the Congo,COD,Eswatini,SWZ,51,0,0,112,163
2014,Ethiopia,ETH,Eswatini,SWZ,0,0,0,10,10
2014,Rwanda,RWA,Eswatini,SWZ,48,0,0,29,77
2014,Somalia,SOM,Eswatini,SWZ,20,0,0,41,61
2014,Afghanistan,AFG,Sweden,SWE,621,877,511,494,2503
2014,Albania,ALB,Sweden,SWE,5,16,1061,317,1399
2014,Algeria,DZA,Sweden,SWE,0,11,81,331,423
2014,Angola,AGO,Sweden,SWE,0,5,0,15,20
2014,Egypt,EGY,Sweden,SWE,48,17,170,64,299
2014,Argentina,ARG,Sweden,SWE,0,0,5,0,5
2014,Armenia,ARM,Sweden,SWE,5,43,183,76,307
2014,Australia,AUS,Sweden,SWE,0,0,0,5,5
2014,Azerbaijan,AZE,Sweden,SWE,28,20,148,99,295
2014,Bahrain,BHR,Sweden,SWE,13,0,0,0,13
2014,Burundi,BDI,Sweden,SWE,0,0,5,11,16
2014,Bangladesh,BGD,Sweden,SWE,10,10,109,17,146
2014,Burkina Faso,BFA,Sweden,SWE,0,0,0,5,5
2014,Belarus,BLR,Sweden,SWE,10,10,91,148,259
2014,Bolivia (Plurinational State of),BOL,Sweden,SWE,0,10,26,10,46
2014,Brazil,BRA,Sweden,SWE,0,0,5,0,5
2014,Bosnia and Herzegovina,BIH,Sweden,SWE,0,14,285,139,438
2014,Bulgaria,BGR,Sweden,SWE,0,0,17,0,17
2014,Canada,CAN,Sweden,SWE,0,0,5,0,5
2014,Central African Rep.,CAF,Sweden,SWE,0,0,0,5,5
2014,Chad,TCD,Sweden,SWE,0,0,0,12,12
2014,China,CHN,Sweden,SWE,16,5,10,21,52
2014,Chile,CHL,Sweden,SWE,0,0,5,5,10
2014,Cameroon,CMR,Sweden,SWE,12,5,14,15,46
2014,Congo,COG,Sweden,SWE,0,0,0,14,14
2014,Dem. Rep. of the Congo,COD,Sweden,SWE,12,10,16,18,56
2014,Colombia,COL,Sweden,SWE,0,0,12,0,12
2014,Cuba,CUB,Sweden,SWE,0,0,26,10,36
2014,Denmark,DNK,Sweden,SWE,0,0,5,0,5
2014,Djibouti,DJI,Sweden,SWE,0,0,10,41,51
2014,Dominican Rep.,DOM,Sweden,SWE,0,0,5,0,5
2014,Ecuador,ECU,Sweden,SWE,0,5,0,0,5
2014,Eritrea,ERI,Sweden,SWE,5131,124,10,1314,6579
2014,Ethiopia,ETH,Sweden,SWE,120,28,145,160,453
2014,Gambia,GMB,Sweden,SWE,15,5,57,70,147
2014,Palestinian,PSE,Sweden,SWE,5,0,12,0,17
2014,Georgia,GEO,Sweden,SWE,5,12,341,302,660
2014,Germany,DEU,Sweden,SWE,0,0,0,5,5
2014,Ghana,GHA,Sweden,SWE,5,0,18,30,53
2014,Guinea-Bissau,GNB,Sweden,SWE,0,0,0,11,11
2014,Greece,GRC,Sweden,SWE,0,5,14,10,29
2014,Guinea,GIN,Sweden,SWE,5,0,13,22,40
2014,Honduras,HND,Sweden,SWE,5,0,5,0,10
2014,Croatia,HRV,Sweden,SWE,0,0,13,20,33
2014,Cote d'Ivoire,CIV,Sweden,SWE,0,5,11,22,38
2014,India,IND,Sweden,SWE,0,0,29,11,40
2014,Iran (Islamic Rep. of),IRN,Sweden,SWE,328,44,190,201,763
2014,Iraq,IRQ,Sweden,SWE,117,321,406,538,1382
2014,Israel,ISR,Sweden,SWE,0,0,14,0,14
2014,Jamaica,JAM,Sweden,SWE,5,0,0,0,5
2014,Jordan,JOR,Sweden,SWE,35,27,42,87,191
2014,Kazakhstan,KAZ,Sweden,SWE,5,25,117,74,221
2014,Kenya,KEN,Sweden,SWE,5,5,14,36,60
2014,Kyrgyzstan,KGZ,Sweden,SWE,5,5,103,71,184
2014,Liberia,LBR,Sweden,SWE,0,0,5,14,19
2014,Libya,LBY,Sweden,SWE,22,14,37,345,418
2014,Lebanon,LBN,Sweden,SWE,16,44,197,145,402
2014,Sri Lanka,LKA,Sweden,SWE,0,0,14,0,14
2014,Lithuania,LTU,Sweden,SWE,0,0,0,5,5
2014,Latvia,LVA,Sweden,SWE,0,0,0,5,5
2014,Mauritania,MRT,Sweden,SWE,0,0,0,11,11
2014,North Macedonia,MKD,Sweden,SWE,5,5,228,130,368
2014,Rep. of Moldova,MDA,Sweden,SWE,0,0,5,12,17
2014,Mexico,MEX,Sweden,SWE,0,0,12,5,17
2014,Mali,MLI,Sweden,SWE,5,0,11,21,37
2014,Mongolia,MNG,Sweden,SWE,5,41,284,101,431
2014,Morocco,MAR,Sweden,SWE,16,26,272,500,814
2014,Mozambique,MOZ,Sweden,SWE,0,0,0,5,5
2014,Montenegro,MNE,Sweden,SWE,0,5,62,24,91
2014,Myanmar,MMR,Sweden,SWE,0,0,0,5,5
2014,Nepal,NPL,Sweden,SWE,0,0,13,0,13
2014,Netherlands,NLD,Sweden,SWE,0,0,0,5,5
2014,Niger,NER,Sweden,SWE,0,0,0,10,10
2014,Nicaragua,NIC,Sweden,SWE,0,0,14,5,19
2014,Nigeria,NGA,Sweden,SWE,49,37,155,198,439
2014,Norway,NOR,Sweden,SWE,0,0,0,5,5
2014,Pakistan,PAK,Sweden,SWE,48,5,119,99,271
2014,Peru,PER,Sweden,SWE,0,0,10,5,15
2014,Philippines,PHL,Sweden,SWE,0,0,13,0,13
2014,Romania,ROU,Sweden,SWE,0,21,38,5,64
2014,South Africa,ZAF,Sweden,SWE,0,0,0,11,11
2014,Russian Federation,RUS,Sweden,SWE,175,51,334,281,841
2014,Rwanda,RWA,Sweden,SWE,0,0,0,13,13
2014,El Salvador,SLV,Sweden,SWE,0,5,31,5,41
2014,Saudi Arabia,SAU,Sweden,SWE,0,0,0,5,5
2014,Serbia and Kosovo: S/RES/1244 (1999),SRB,Sweden,SWE,5,98,1341,954,2398
2014,Senegal,SEN,Sweden,SWE,10,0,19,19,48
2014,Singapore,SGP,Sweden,SWE,0,0,0,5,5
2014,Sierra Leone,SLE,Sweden,SWE,12,5,10,19,46
2014,Somalia,SOM,Sweden,SWE,761,400,492,1493,3146
2014,Spain,ESP,Sweden,SWE,0,0,13,0,13
2014,Viet Nam,VNM,Sweden,SWE,0,0,21,12,33
2014,Sudan,SDN,Sweden,SWE,38,10,30,153,231
2014,Slovenia,SVN,Sweden,SWE,0,0,0,5,5
2014,Eswatini,SWZ,Sweden,SWE,0,0,0,10,10
2014,Syrian Arab Rep.,SYR,Sweden,SWE,1759,14627,27,1791,18204
2014,United Rep. of Tanzania,TZA,Sweden,SWE,0,0,15,20,35
2014,Thailand,THA,Sweden,SWE,5,0,0,0,5
2014,Tajikistan,TJK,Sweden,SWE,5,0,19,17,41
2014,Turkmenistan,TKM,Sweden,SWE,0,0,5,0,5
2014,Togo,TGO,Sweden,SWE,0,0,5,0,5
2014,Tunisia,TUN,Sweden,SWE,0,0,49,176,225
2014,Turkey,TUR,Sweden,SWE,0,11,114,28,153
2014,United Arab Emirates,ARE,Sweden,SWE,0,0,0,10,10
2014,Uganda,UGA,Sweden,SWE,103,10,32,71,216
2014,Ukraine,UKR,Sweden,SWE,10,23,162,234,429
2014,United States of America,USA,Sweden,SWE,0,5,15,10,30
2014,Uzbekistan,UZB,Sweden,SWE,32,20,152,71,275
2014,Venezuela (Bolivarian Republic of),VEN,Sweden,SWE,0,0,15,0,15
2014,Yemen,YEM,Sweden,SWE,20,15,37,54,126
2014,Zambia,ZMB,Sweden,SWE,5,0,0,0,5
2014,Zimbabwe,ZWE,Sweden,SWE,0,0,5,5,10
2014,Stateless,XXA,Sweden,SWE,566,3758,342,726,5392
2014,Afghanistan,AFG,Switzerland,CHE,289,1566,308,38,2201
2014,Albania,ALB,Switzerland,CHE,5,5,118,25,153
2014,Algeria,DZA,Switzerland,CHE,5,5,362,96,468
2014,Angola,AGO,Switzerland,CHE,0,46,34,0,80
2014,Egypt,EGY,Switzerland,CHE,5,5,115,55,180
2014,Armenia,ARM,Switzerland,CHE,0,16,100,10,126
2014,Azerbaijan,AZE,Switzerland,CHE,14,0,21,0,35
2014,Bahrain,BHR,Switzerland,CHE,0,5,0,0,5
2014,Burundi,BDI,Switzerland,CHE,0,0,5,0,5
2014,Belgium,BEL,Switzerland,CHE,0,0,0,5,5
2014,Benin,BEN,Switzerland,CHE,0,0,40,10,50
2014,Bangladesh,BGD,Switzerland,CHE,5,0,60,5,70
2014,Bhutan,BTN,Switzerland,CHE,0,0,5,0,5
2014,Burkina Faso,BFA,Switzerland,CHE,0,0,22,5,27
2014,Belarus,BLR,Switzerland,CHE,5,0,50,34,89
2014,Bosnia and Herzegovina,BIH,Switzerland,CHE,10,28,104,43,185
2014,Bulgaria,BGR,Switzerland,CHE,0,0,20,0,20
2014,Central African Rep.,CAF,Switzerland,CHE,0,0,5,0,5
2014,Chad,TCD,Switzerland,CHE,0,0,20,10,30
2014,China,CHN,Switzerland,CHE,181,965,248,11,1405
2014,Cameroon,CMR,Switzerland,CHE,0,10,49,5,64
2014,Congo,COG,Switzerland,CHE,0,0,5,0,5
2014,Dem. Rep. of the Congo,COD,Switzerland,CHE,23,100,138,12,273
2014,Colombia,COL,Switzerland,CHE,11,0,5,0,16
2014,Cuba,CUB,Switzerland,CHE,5,0,5,0,10
2014,Czechia,CZE,Switzerland,CHE,0,0,0,5,5
2014,Djibouti,DJI,Switzerland,CHE,0,0,5,0,5
2014,Equatorial Guinea,GNQ,Switzerland,CHE,0,0,10,0,10
2014,Eritrea,ERI,Switzerland,CHE,2272,1359,697,54,4382
2014,Ethiopia,ETH,Switzerland,CHE,85,136,293,14,528
2014,France,FRA,Switzerland,CHE,0,0,0,5,5
2014,Gabon,GAB,Switzerland,CHE,0,0,5,0,5
2014,Gambia,GMB,Switzerland,CHE,0,10,372,74,456
2014,Georgia,GEO,Switzerland,CHE,0,10,370,115,495
2014,Germany,DEU,Switzerland,CHE,0,0,13,0,13
2014,Ghana,GHA,Switzerland,CHE,0,0,92,38,130
2014,Guinea-Bissau,GNB,Switzerland,CHE,0,11,171,56,238
2014,Guinea,GIN,Switzerland,CHE,5,13,216,47,281
2014,Croatia,HRV,Switzerland,CHE,0,0,10,0,10
2014,Hungary,HUN,Switzerland,CHE,0,0,10,77,87
2014,Cote d'Ivoire,CIV,Switzerland,CHE,12,19,83,22,136
2014,India,IND,Switzerland,CHE,0,5,33,0,38
2014,Iran (Islamic Rep. of),IRN,Switzerland,CHE,127,109,221,26,483
2014,Iraq,IRQ,Switzerland,CHE,126,184,154,56,520
2014,Israel,ISR,Switzerland,CHE,0,0,0,5,5
2014,Italy,ITA,Switzerland,CHE,0,0,20,5,25
2014,Jamaica,JAM,Switzerland,CHE,0,0,5,0,5
2014,Jordan,JOR,Switzerland,CHE,0,0,13,0,13
2014,Kazakhstan,KAZ,Switzerland,CHE,0,0,12,19,31
2014,Kenya,KEN,Switzerland,CHE,5,0,19,0,24
2014,Kyrgyzstan,KGZ,Switzerland,CHE,5,0,13,0,18
2014,Liberia,LBR,Switzerland,CHE,0,5,42,5,52
2014,Libya,LBY,Switzerland,CHE,12,42,100,44,198
2014,Lebanon,LBN,Switzerland,CHE,0,5,20,5,30
2014,Sri Lanka,LKA,Switzerland,CHE,1228,247,245,62,1782
2014,Mauritania,MRT,Switzerland,CHE,0,0,44,11,55
2014,North Macedonia,MKD,Switzerland,CHE,0,19,61,18,98
2014,Rep. of Moldova,MDA,Switzerland,CHE,0,0,0,5,5
2014,Mali,MLI,Switzerland,CHE,0,5,211,54,270
2014,Malawi,MWI,Switzerland,CHE,0,0,5,0,5
2014,Mongolia,MNG,Switzerland,CHE,0,12,63,12,87
2014,Morocco,MAR,Switzerland,CHE,5,5,541,245,796
2014,Mozambique,MOZ,Switzerland,CHE,0,0,5,0,5
2014,Montenegro,MNE,Switzerland,CHE,0,5,14,5,24
2014,Myanmar,MMR,Switzerland,CHE,0,12,0,0,12
2014,Nepal,NPL,Switzerland,CHE,5,0,23,0,28
2014,Niger,NER,Switzerland,CHE,0,0,29,15,44
2014,Nigeria,NGA,Switzerland,CHE,0,21,880,107,1008
2014,Pakistan,PAK,Switzerland,CHE,5,5,128,28,166
2014,Poland,POL,Switzerland,CHE,0,0,5,5,10
2014,Romania,ROU,Switzerland,CHE,0,0,11,24,35
2014,South Africa,ZAF,Switzerland,CHE,0,0,0,5,5
2014,Russian Federation,RUS,Switzerland,CHE,63,32,173,31,299
2014,Rwanda,RWA,Switzerland,CHE,0,0,12,0,12
2014,Serbia and Kosovo: S/RES/1244 (1999),SRB,Switzerland,CHE,14,157,575,106,852
2014,Senegal,SEN,Switzerland,CHE,0,11,146,49,206
2014,Sierra Leone,SLE,Switzerland,CHE,0,0,57,14,71
2014,Somalia,SOM,Switzerland,CHE,205,537,197,49,988
2014,Spain,ESP,Switzerland,CHE,0,0,5,0,5
2014,Viet Nam,VNM,Switzerland,CHE,0,0,13,0,13
2014,Sudan,SDN,Switzerland,CHE,34,18,81,14,147
2014,South Sudan,SSD,Switzerland,CHE,0,0,44,0,44
2014,Slovakia,SVK,Switzerland,CHE,0,0,0,13,13
2014,Syrian Arab Rep.,SYR,Switzerland,CHE,916,1905,221,174,3216
2014,United Rep. of Tanzania,TZA,Switzerland,CHE,0,0,14,0,14
2014,Togo,TGO,Switzerland,CHE,36,5,61,5,107
2014,Tunisia,TUN,Switzerland,CHE,5,0,632,272,909
2014,Turkey,TUR,Switzerland,CHE,326,73,254,45,698
2014,Uganda,UGA,Switzerland,CHE,0,0,35,5,40
2014,Ukraine,UKR,Switzerland,CHE,0,0,92,25,117
2014,United States of America,USA,Switzerland,CHE,0,0,5,0,5
2014,Uzbekistan,UZB,Switzerland,CHE,5,0,5,0,10
2014,Western Sahara,ESH,Switzerland,CHE,5,0,5,0,10
2014,Yemen,YEM,Switzerland,CHE,37,21,29,5,92
2014,Zambia,ZMB,Switzerland,CHE,0,0,5,0,5
2014,Zimbabwe,ZWE,Switzerland,CHE,0,0,10,0,10
2014,Stateless,XXA,Switzerland,CHE,5,5,22,5,37
2014,Burundi,BDI,United Rep. of Tanzania,TZA,5,0,23,0,28
2014,Dem. Rep. of the Congo,COD,United Rep. of Tanzania,TZA,183,0,299,0,482
2014,Myanmar,MMR,Thailand,THA,740,0,0,310,1050
2014,Central African Rep.,CAF,Togo,TGO,310,0,0,0,310
2014,Dem. Rep. of the Congo,COD,Togo,TGO,15,0,0,0,15
2014,Afghanistan,AFG,Ukraine,UKR,61,16,112,37,226
2014,Algeria,DZA,Ukraine,UKR,0,0,0,5,5
2014,Egypt,EGY,Ukraine,UKR,0,0,5,0,5
2014,Armenia,ARM,Ukraine,UKR,0,0,5,0,5
2014,Azerbaijan,AZE,Ukraine,UKR,5,0,0,0,5
2014,Bangladesh,BGD,Ukraine,UKR,0,0,5,0,5
2014,Belarus,BLR,Ukraine,UKR,0,0,5,0,5
2014,Cameroon,CMR,Ukraine,UKR,0,0,5,5,10
2014,Dem. Rep. of the Congo,COD,Ukraine,UKR,0,5,14,0,19
2014,Eritrea,ERI,Ukraine,UKR,0,0,11,0,11
2014,Ethiopia,ETH,Ukraine,UKR,0,0,0,5,5
2014,Palestinian,PSE,Ukraine,UKR,0,0,0,5,5
2014,Georgia,GEO,Ukraine,UKR,0,5,5,0,10
2014,Guinea,GIN,Ukraine,UKR,0,0,5,12,17
2014,Cote d'Ivoire,CIV,Ukraine,UKR,0,0,10,0,10
2014,Iran (Islamic Rep. of),IRN,Ukraine,UKR,5,0,13,5,23
2014,Iraq,IRQ,Ukraine,UKR,0,5,16,5,26
2014,Jordan,JOR,Ukraine,UKR,0,5,0,0,5
2014,Kazakhstan,KAZ,Ukraine,UKR,5,0,0,0,5
2014,Kyrgyzstan,KGZ,Ukraine,UKR,0,0,0,5,5
2014,Sri Lanka,LKA,Ukraine,UKR,0,0,0,13,13
2014,Nigeria,NGA,Ukraine,UKR,0,0,5,0,5
2014,Pakistan,PAK,Ukraine,UKR,0,0,14,0,14
2014,Russian Federation,RUS,Ukraine,UKR,5,0,33,30,68
2014,Somalia,SOM,Ukraine,UKR,0,0,19,13,32
2014,Viet Nam,VNM,Ukraine,UKR,5,0,0,0,5
2014,Sudan,SDN,Ukraine,UKR,0,5,13,12,30
2014,Syrian Arab Rep.,SYR,Ukraine,UKR,12,166,42,14,234
2014,Tajikistan,TJK,Ukraine,UKR,0,0,0,5,5
2014,Uzbekistan,UZB,Ukraine,UKR,0,0,14,5,19
2014,Stateless,XXA,Ukraine,UKR,5,11,5,5,26
2014,Brazil,BRA,Uruguay,URY,0,0,0,5,5
2014,Colombia,COL,Uruguay,URY,5,0,0,14,19
2014,Mexico,MEX,Uruguay,URY,0,0,0,5,5
2014,Peru,PER,Uruguay,URY,0,0,0,5,5
2014,El Salvador,SLV,Uruguay,URY,5,0,0,0,5
2014,Syrian Arab Rep.,SYR,Uruguay,URY,5,0,0,0,5
2014,Colombia,COL,Venezuela (Bolivarian Republic of),VEN,724,0,2402,0,3126
2014,Burundi,BDI,Zambia,ZMB,0,0,0,24,24
2014,Dem. Rep. of the Congo,COD,Zambia,ZMB,783,0,308,0,1091
2014,Rwanda,RWA,Zambia,ZMB,5,0,149,0,154
2014,Somalia,SOM,Zambia,ZMB,12,0,11,0,23
2014,Burundi,BDI,Zimbabwe,ZWE,14,0,30,0,44
2014,Dem. Rep. of the Congo,COD,Zimbabwe,ZWE,893,0,277,0,1170
2014,Eritrea,ERI,Zimbabwe,ZWE,5,0,0,0,5
2014,Ethiopia,ETH,Zimbabwe,ZWE,13,0,0,0,13
2014,Cote d'Ivoire,CIV,Zimbabwe,ZWE,5,0,0,0,5
2014,Rwanda,RWA,Zimbabwe,ZWE,46,0,0,0,46
2015,Afghanistan,AFG,Albania,ALB,5,0,0,0,5
2015,Azerbaijan,AZE,Albania,ALB,0,0,0,5,5
2015,Central African Rep.,CAF,Albania,ALB,0,0,0,5,5
2015,Eritrea,ERI,Albania,ALB,0,0,0,10,10
2015,Gabon,GAB,Albania,ALB,0,0,0,5,5
2015,Iran (Islamic Rep. of),IRN,Albania,ALB,39,0,0,86,125
2015,Sudan,SDN,Albania,ALB,0,0,0,5,5
2015,Syrian Arab Rep.,SYR,Albania,ALB,0,0,0,79,79
2015,Chad,TCD,Angola,AGO,10,0,0,0,10
2015,Eritrea,ERI,Angola,AGO,17,0,0,0,17
2015,Guinea,GIN,Angola,AGO,5,0,10,0,15
2015,Cote d'Ivoire,CIV,Angola,AGO,12,0,15,0,27
2015,Liberia,LBR,Angola,AGO,5,0,0,0,5
2015,Mauritania,MRT,Angola,AGO,18,0,10,0,28
2015,Rwanda,RWA,Angola,AGO,18,0,0,0,18
2015,Somalia,SOM,Angola,AGO,16,0,0,5,21
2015,Sudan,SDN,Angola,AGO,13,0,0,0,13
2015,Western Sahara,ESH,Angola,AGO,5,0,0,0,5
2015,Angola,AGO,Argentina,ARG,5,0,0,0,5
2015,Armenia,ARM,Argentina,ARG,0,0,10,5,15
2015,Bangladesh,BGD,Argentina,ARG,0,0,5,0,5
2015,China,CHN,Argentina,ARG,0,0,5,0,5
2015,Chile,CHL,Argentina,ARG,0,0,0,5,5
2015,Cameroon,CMR,Argentina,ARG,0,0,11,0,11
2015,Dem. Rep. of the Congo,COD,Argentina,ARG,0,0,0,5,5
2015,Colombia,COL,Argentina,ARG,5,0,21,61,87
2015,Cuba,CUB,Argentina,ARG,5,0,152,27,184
2015,Dominican Rep.,DOM,Argentina,ARG,0,0,35,23,58
2015,Ghana,GHA,Argentina,ARG,0,0,25,0,25
2015,Guinea,GIN,Argentina,ARG,0,0,5,0,5
2015,Haiti,HTI,Argentina,ARG,0,0,57,17,74
2015,Hungary,HUN,Argentina,ARG,0,0,5,0,5
2015,India,IND,Argentina,ARG,0,0,24,21,45
2015,Mexico,MEX,Argentina,ARG,0,0,0,5,5
2015,Nigeria,NGA,Argentina,ARG,0,0,13,0,13
2015,Pakistan,PAK,Argentina,ARG,0,0,5,5,10
2015,Peru,PER,Argentina,ARG,0,0,0,13,13
2015,Russian Federation,RUS,Argentina,ARG,12,0,0,5,17
2015,El Salvador,SLV,Argentina,ARG,0,0,0,5,5
2015,Senegal,SEN,Argentina,ARG,0,0,280,16,296
2015,Syrian Arab Rep.,SYR,Argentina,ARG,55,0,18,10,83
2015,Ukraine,UKR,Argentina,ARG,23,0,10,16,49
2015,Venezuela (Bolivarian Republic of),VEN,Argentina,ARG,0,0,0,5,5
2015,Guinea,GIN,Armenia,ARM,0,0,5,0,5
2015,Iran (Islamic Rep. of),IRN,Armenia,ARM,0,0,14,5,19
2015,Iraq,IRQ,Armenia,ARM,41,0,5,16,62
2015,Lebanon,LBN,Armenia,ARM,0,0,0,5,5
2015,Syrian Arab Rep.,SYR,Armenia,ARM,87,0,0,14,101
2015,Ukraine,UKR,Armenia,ARM,68,0,14,36,118
2015,Yemen,YEM,Armenia,ARM,5,0,0,0,5
2015,Afghanistan,AFG,Australia,AUS,249,0,32,5,286
2015,Albania,ALB,Australia,AUS,5,0,0,0,5
2015,Egypt,EGY,Australia,AUS,123,0,10,11,144
2015,Bahrain,BHR,Australia,AUS,5,0,0,0,5
2015,Bangladesh,BGD,Australia,AUS,39,0,36,29,104
2015,Bhutan,BTN,Australia,AUS,5,0,0,0,5
2015,Brazil,BRA,Australia,AUS,0,0,0,5,5
2015,Cambodia,KHM,Australia,AUS,0,0,0,5,5
2015,China,CHN,Australia,AUS,147,0,111,149,407
2015,Cameroon,CMR,Australia,AUS,5,0,0,0,5
2015,Colombia,COL,Australia,AUS,5,0,13,0,18
2015,Eritrea,ERI,Australia,AUS,10,0,0,0,10
2015,Ethiopia,ETH,Australia,AUS,29,0,0,5,34
2015,Fiji,FJI,Australia,AUS,19,0,35,74,128
2015,France,FRA,Australia,AUS,0,0,0,5,5
2015,Palestinian,PSE,Australia,AUS,15,0,5,0,20
2015,United Kingdom of Great Britain and Northern Ireland,GBR,Australia,AUS,5,0,5,13,23
2015,Georgia,GEO,Australia,AUS,5,0,0,0,5
2015,Germany,DEU,Australia,AUS,0,0,0,5,5
2015,Greece,GRC,Australia,AUS,5,0,0,0,5
2015,Guinea,GIN,Australia,AUS,5,0,0,0,5
2015,"China, Hong Kong SAR",HKG,Australia,AUS,0,0,10,10,20
2015,Hungary,HUN,Australia,AUS,0,0,0,5,5
2015,India,IND,Australia,AUS,25,0,54,141,220
2015,Indonesia,IDN,Australia,AUS,18,0,23,29,70
2015,Ireland,IRL,Australia,AUS,0,0,5,31,36
2015,Iran (Islamic Rep. of),IRN,Australia,AUS,303,0,130,27,460
2015,Iraq,IRQ,Australia,AUS,387,0,29,19,435
2015,Israel,ISR,Australia,AUS,0,0,0,5,5
2015,Italy,ITA,Australia,AUS,5,0,0,13,18
2015,Jordan,JOR,Australia,AUS,11,0,0,10,21
2015,Japan,JPN,Australia,AUS,0,0,5,0,5
2015,Kenya,KEN,Australia,AUS,13,0,0,0,13
2015,Rep. of Korea,KOR,Australia,AUS,5,0,11,30,46
2015,Dem. People's Rep. of Korea,PRK,Australia,AUS,0,0,5,0,5
2015,Kuwait,KWT,Australia,AUS,5,0,0,0,5
2015,Lao People's Dem. Rep.,LAO,Australia,AUS,5,0,0,0,5
2015,Liberia,LBR,Australia,AUS,5,0,0,0,5
2015,Libya,LBY,Australia,AUS,142,0,5,5,152
2015,Lebanon,LBN,Australia,AUS,90,0,10,10,110
2015,Sri Lanka,LKA,Australia,AUS,171,0,753,22,946
2015,North Macedonia,MKD,Australia,AUS,5,0,0,5,10
2015,Maldives,MDV,Australia,AUS,5,0,0,0,5
2015,Mexico,MEX,Australia,AUS,0,0,5,0,5
2015,Malaysia,MYS,Australia,AUS,18,0,303,216,537
2015,Morocco,MAR,Australia,AUS,5,0,0,0,5
2015,Mauritius,MUS,Australia,AUS,5,0,0,0,5
2015,Myanmar,MMR,Australia,AUS,11,0,0,0,11
2015,Nepal,NPL,Australia,AUS,10,0,18,22,50
2015,Netherlands,NLD,Australia,AUS,0,0,5,0,5
2015,Nigeria,NGA,Australia,AUS,5,0,5,12,22
2015,New Zealand,NZL,Australia,AUS,5,0,0,0,5
2015,Oman,OMN,Australia,AUS,5,0,0,0,5
2015,Pakistan,PAK,Australia,AUS,270,0,45,69,384
2015,Philippines,PHL,Australia,AUS,5,0,0,19,24
2015,Papua New Guinea,PNG,Australia,AUS,52,0,5,19,76
2015,Poland,POL,Australia,AUS,0,0,5,0,5
2015,Romania,ROU,Australia,AUS,0,0,0,5,5
2015,South Africa,ZAF,Australia,AUS,0,0,0,5,5
2015,Russian Federation,RUS,Australia,AUS,5,0,5,0,10
2015,Rwanda,RWA,Australia,AUS,5,0,5,0,10
2015,Saudi Arabia,SAU,Australia,AUS,18,0,0,5,23
2015,Sierra Leone,SLE,Australia,AUS,5,0,0,0,5
2015,Solomon Islands,SLB,Australia,AUS,0,0,0,12,12
2015,Somalia,SOM,Australia,AUS,10,0,0,0,10
2015,Viet Nam,VNM,Australia,AUS,11,0,35,23,69
2015,Sudan,SDN,Australia,AUS,5,0,10,0,15
2015,Syrian Arab Rep.,SYR,Australia,AUS,5,0,113,5,123
2015,United Rep. of Tanzania,TZA,Australia,AUS,5,0,0,0,5
2015,Thailand,THA,Australia,AUS,0,0,5,14,19
2015,Timor-Leste,TLS,Australia,AUS,5,0,0,0,5
2015,Tonga,TON,Australia,AUS,5,0,0,12,17
2015,Turkey,TUR,Australia,AUS,32,0,10,10,52
2015,Uganda,UGA,Australia,AUS,5,0,0,0,5
2015,Ukraine,UKR,Australia,AUS,5,0,0,5,10
2015,United States of America,USA,Australia,AUS,5,0,0,5,10
2015,Yemen,YEM,Australia,AUS,5,0,0,0,5
2015,Zambia,ZMB,Australia,AUS,5,0,0,0,5
2015,Zimbabwe,ZWE,Australia,AUS,12,0,0,5,17
2015,Stateless,XXA,Australia,AUS,14,0,52,5,71
2015,Tibetan,TIB,Australia,AUS,5,0,0,0,5
2015,Afghanistan,AFG,Azerbaijan,AZE,0,0,114,5,119
2015,Iran (Islamic Rep. of),IRN,Azerbaijan,AZE,0,0,18,0,18
2015,Nepal,NPL,Azerbaijan,AZE,0,0,0,5,5
2015,Pakistan,PAK,Azerbaijan,AZE,0,0,68,10,78
2015,Syrian Arab Rep.,SYR,Azerbaijan,AZE,0,0,5,0,5
2015,Ukraine,UKR,Azerbaijan,AZE,0,0,23,10,33
2015,Yemen,YEM,Azerbaijan,AZE,0,0,5,0,5
2015,Dem. Rep. of the Congo,COD,Burundi,BDI,2826,0,0,472,3298
2015,Comoros,COM,Burundi,BDI,0,0,0,5,5
2015,Mali,MLI,Burundi,BDI,5,0,0,0,5
2015,Rwanda,RWA,Burundi,BDI,13,0,0,14,27
2015,Somalia,SOM,Burundi,BDI,0,0,0,5,5
2015,Afghanistan,AFG,Belgium,BEL,583,407,249,10,1249
2015,Albania,ALB,Belgium,BEL,50,5,453,56,564
2015,Algeria,DZA,Belgium,BEL,18,0,45,14,77
2015,Angola,AGO,Belgium,BEL,5,0,46,0,51
2015,Egypt,EGY,Belgium,BEL,22,0,42,10,74
2015,Armenia,ARM,Belgium,BEL,14,10,133,12,169
2015,Azerbaijan,AZE,Belgium,BEL,31,0,20,5,56
2015,Burundi,BDI,Belgium,BEL,112,5,23,0,140
2015,Benin,BEN,Belgium,BEL,5,0,18,0,23
2015,Bangladesh,BGD,Belgium,BEL,5,0,32,0,37
2015,Burkina Faso,BFA,Belgium,BEL,32,0,36,0,68
2015,Belarus,BLR,Belgium,BEL,14,0,5,0,19
2015,Bosnia and Herzegovina,BIH,Belgium,BEL,5,0,50,5,60
2015,Bulgaria,BGR,Belgium,BEL,0,0,5,0,5
2015,Central African Rep.,CAF,Belgium,BEL,13,11,0,0,24
2015,Chad,TCD,Belgium,BEL,5,0,0,0,5
2015,China,CHN,Belgium,BEL,141,0,50,5,196
2015,Cameroon,CMR,Belgium,BEL,65,5,152,13,235
2015,Congo,COG,Belgium,BEL,5,0,5,0,10
2015,Dem. Rep. of the Congo,COD,Belgium,BEL,199,5,407,10,621
2015,Colombia,COL,Belgium,BEL,5,0,0,0,5
2015,Cuba,CUB,Belgium,BEL,0,0,0,5,5
2015,Djibouti,DJI,Belgium,BEL,89,0,54,0,143
2015,Eritrea,ERI,Belgium,BEL,649,0,38,5,692
2015,Ethiopia,ETH,Belgium,BEL,18,0,40,5,63
2015,Gabon,GAB,Belgium,BEL,10,0,0,0,10
2015,Gambia,GMB,Belgium,BEL,5,0,23,5,33
2015,Palestinian,PSE,Belgium,BEL,5,0,11,0,16
2015,Georgia,GEO,Belgium,BEL,5,0,167,25,197
2015,Ghana,GHA,Belgium,BEL,5,0,15,0,20
2015,Guinea-Bissau,GNB,Belgium,BEL,0,0,5,0,5
2015,Guinea,GIN,Belgium,BEL,562,5,264,34,865
2015,Haiti,HTI,Belgium,BEL,0,0,5,0,5
2015,Croatia,HRV,Belgium,BEL,0,0,5,0,5
2015,Cote d'Ivoire,CIV,Belgium,BEL,27,0,54,0,81
2015,India,IND,Belgium,BEL,0,0,23,5,28
2015,Iran (Islamic Rep. of),IRN,Belgium,BEL,226,5,56,28,315
2015,Iraq,IRQ,Belgium,BEL,627,336,307,66,1336
2015,Jamaica,JAM,Belgium,BEL,5,0,0,0,5
2015,Jordan,JOR,Belgium,BEL,0,0,15,5,20
2015,Kazakhstan,KAZ,Belgium,BEL,5,0,23,0,28
2015,Kenya,KEN,Belgium,BEL,5,0,14,0,19
2015,Kyrgyzstan,KGZ,Belgium,BEL,5,0,15,0,20
2015,Dem. People's Rep. of Korea,PRK,Belgium,BEL,0,0,5,0,5
2015,Libya,LBY,Belgium,BEL,26,31,0,5,62
2015,Lebanon,LBN,Belgium,BEL,28,5,45,10,88
2015,Sri Lanka,LKA,Belgium,BEL,100,0,15,0,115
2015,Lithuania,LTU,Belgium,BEL,0,0,5,0,5
2015,Mauritania,MRT,Belgium,BEL,22,0,59,0,81
2015,North Macedonia,MKD,Belgium,BEL,22,0,221,22,265
2015,Rep. of Moldova,MDA,Belgium,BEL,0,0,5,0,5
2015,Mexico,MEX,Belgium,BEL,0,0,10,0,10
2015,Mali,MLI,Belgium,BEL,11,0,27,0,38
2015,Mongolia,MNG,Belgium,BEL,0,0,10,0,10
2015,Morocco,MAR,Belgium,BEL,20,0,99,14,133
2015,Montenegro,MNE,Belgium,BEL,0,0,10,0,10
2015,Myanmar,MMR,Belgium,BEL,0,0,5,0,5
2015,Nepal,NPL,Belgium,BEL,0,0,18,0,18
2015,Niger,NER,Belgium,BEL,13,0,59,0,72
2015,Nigeria,NGA,Belgium,BEL,5,0,53,5,63
2015,Pakistan,PAK,Belgium,BEL,79,0,174,13,266
2015,Philippines,PHL,Belgium,BEL,0,0,5,0,5
2015,Romania,ROU,Belgium,BEL,0,0,5,0,5
2015,Russian Federation,RUS,Belgium,BEL,326,5,475,40,846
2015,Rwanda,RWA,Belgium,BEL,79,0,179,10,268
2015,El Salvador,SLV,Belgium,BEL,0,51,5,5,61
2015,Serbia and Kosovo: S/RES/1244 (1999),SRB,Belgium,BEL,101,0,576,29,706
2015,Senegal,SEN,Belgium,BEL,68,0,109,16,193
2015,Sierra Leone,SLE,Belgium,BEL,0,0,12,0,12
2015,Somalia,SOM,Belgium,BEL,265,274,105,10,654
2015,Sudan,SDN,Belgium,BEL,53,0,31,5,89
2015,Syrian Arab Rep.,SYR,Belgium,BEL,3443,430,57,27,3957
2015,United Rep. of Tanzania,TZA,Belgium,BEL,14,0,5,0,19
2015,Tajikistan,TJK,Belgium,BEL,11,0,10,0,21
2015,Togo,TGO,Belgium,BEL,28,0,83,5,116
2015,Tunisia,TUN,Belgium,BEL,19,0,28,5,52
2015,Turkey,TUR,Belgium,BEL,38,0,104,10,152
2015,Uganda,UGA,Belgium,BEL,5,0,14,0,19
2015,Ukraine,UKR,Belgium,BEL,73,42,303,26,444
2015,United States of America,USA,Belgium,BEL,0,0,5,0,5
2015,Venezuela (Bolivarian Republic of),VEN,Belgium,BEL,10,0,0,0,10
2015,Yemen,YEM,Belgium,BEL,19,16,0,0,35
2015,Stateless,XXA,Belgium,BEL,5,0,12,0,17
2015,Central African Rep.,CAF,Benin,BEN,114,0,0,0,114
2015,Cote d'Ivoire,CIV,Benin,BEN,10,0,0,0,10
2015,Afghanistan,AFG,Belarus,BLR,5,0,13,27,45
2015,Armenia,ARM,Belarus,BLR,0,0,5,0,5
2015,Georgia,GEO,Belarus,BLR,0,0,5,5,10
2015,Iraq,IRQ,Belarus,BLR,0,0,5,15,20
2015,Libya,LBY,Belarus,BLR,0,10,0,0,10
2015,Lebanon,LBN,Belarus,BLR,0,0,5,0,5
2015,Pakistan,PAK,Belarus,BLR,0,0,0,5,5
2015,Russian Federation,RUS,Belarus,BLR,0,0,10,0,10
2015,Syrian Arab Rep.,SYR,Belarus,BLR,16,50,22,56,144
2015,Ukraine,UKR,Belarus,BLR,0,805,31,100,936
2015,Yemen,YEM,Belarus,BLR,0,14,0,5,19
2015,Brazil,BRA,Bolivia (Plurinational State of),BOL,0,0,5,0,5
2015,Colombia,COL,Bolivia (Plurinational State of),BOL,0,0,14,0,14
2015,Ghana,GHA,Bolivia (Plurinational State of),BOL,0,0,5,0,5
2015,Nigeria,NGA,Bolivia (Plurinational State of),BOL,0,0,18,0,18
2015,Burundi,BDI,Botswana,BWA,0,0,23,0,23
2015,Dem. Rep. of the Congo,COD,Botswana,BWA,5,0,413,12,430
2015,Eritrea,ERI,Botswana,BWA,10,0,0,0,10
2015,Somalia,SOM,Botswana,BWA,0,0,25,11,36
2015,Zimbabwe,ZWE,Botswana,BWA,0,0,16,15,31
2015,Afghanistan,AFG,Brazil,BRA,24,0,0,0,24
2015,Angola,AGO,Brazil,BRA,13,0,36,0,49
2015,Egypt,EGY,Brazil,BRA,5,0,5,0,10
2015,Burundi,BDI,Brazil,BRA,5,0,0,0,5
2015,Benin,BEN,Brazil,BRA,0,0,5,0,5
2015,Bangladesh,BGD,Brazil,BRA,0,0,0,1967,1967
2015,Burkina Faso,BFA,Brazil,BRA,0,0,35,0,35
2015,Bolivia (Plurinational State of),BOL,Brazil,BRA,5,0,0,0,5
2015,China,CHN,Brazil,BRA,0,0,5,0,5
2015,Cameroon,CMR,Brazil,BRA,10,0,5,0,15
2015,Congo,COG,Brazil,BRA,5,0,0,0,5
2015,Dem. Rep. of the Congo,COD,Brazil,BRA,254,0,14,0,268
2015,Colombia,COL,Brazil,BRA,80,0,11,0,91
2015,Cuba,CUB,Brazil,BRA,10,0,11,0,21
2015,Cabo Verde,CPV,Brazil,BRA,0,0,5,0,5
2015,Dominican Rep.,DOM,Brazil,BRA,0,0,10,0,10
2015,Gambia,GMB,Brazil,BRA,0,0,15,0,15
2015,Palestinian,PSE,Brazil,BRA,70,0,0,0,70
2015,Ghana,GHA,Brazil,BRA,5,0,14,1164,1183
2015,Guinea-Bissau,GNB,Brazil,BRA,0,0,58,376,434
2015,Guinea,GIN,Brazil,BRA,19,0,10,0,29
2015,Cote d'Ivoire,CIV,Brazil,BRA,10,0,15,0,25
2015,Iran (Islamic Rep. of),IRN,Brazil,BRA,10,0,0,0,10
2015,Iraq,IRQ,Brazil,BRA,28,0,0,0,28
2015,Lebanon,LBN,Brazil,BRA,0,0,12,0,12
2015,Mexico,MEX,Brazil,BRA,5,0,0,0,5
2015,Nepal,NPL,Brazil,BRA,0,0,5,0,5
2015,Nigeria,NGA,Brazil,BRA,11,0,79,0,90
2015,Pakistan,PAK,Brazil,BRA,65,0,24,0,89
2015,Peru,PER,Brazil,BRA,0,0,10,0,10
2015,Philippines,PHL,Brazil,BRA,0,0,5,0,5
2015,Senegal,SEN,Brazil,BRA,0,0,17,0,17
2015,Sierra Leone,SLE,Brazil,BRA,0,0,5,0,5
2015,Sudan,SDN,Brazil,BRA,10,0,0,0,10
2015,Syrian Arab Rep.,SYR,Brazil,BRA,532,0,0,0,532
2015,Togo,TGO,Brazil,BRA,10,0,14,0,24
2015,Ukraine,UKR,Brazil,BRA,5,0,0,0,5
2015,Venezuela (Bolivarian Republic of),VEN,Brazil,BRA,5,0,24,0,29
2015,Afghanistan,AFG,Bosnia and Herzegovina,BIH,0,0,0,13,13
2015,Cameroon,CMR,Bosnia and Herzegovina,BIH,0,0,0,5,5
2015,Palestinian,PSE,Bosnia and Herzegovina,BIH,0,0,0,5,5
2015,Iraq,IRQ,Bosnia and Herzegovina,BIH,0,0,0,5,5
2015,Syrian Arab Rep.,SYR,Bosnia and Herzegovina,BIH,0,5,0,0,5
2015,Afghanistan,AFG,Bulgaria,BGR,0,5,93,7352,7450
2015,Algeria,DZA,Bulgaria,BGR,0,0,0,49,49
2015,Armenia,ARM,Bulgaria,BGR,0,0,5,5,10
2015,Azerbaijan,AZE,Bulgaria,BGR,0,0,5,0,5
2015,Bangladesh,BGD,Bulgaria,BGR,0,0,0,59,59
2015,Central African Rep.,CAF,Bulgaria,BGR,0,0,0,5,5
2015,Cameroon,CMR,Bulgaria,BGR,0,0,12,16,28
2015,Congo,COG,Bulgaria,BGR,0,0,0,10,10
2015,Dem. Rep. of the Congo,COD,Bulgaria,BGR,0,0,0,5,5
2015,Dominican Rep.,DOM,Bulgaria,BGR,0,0,0,5,5
2015,Eritrea,ERI,Bulgaria,BGR,0,0,0,16,16
2015,Gambia,GMB,Bulgaria,BGR,0,0,0,12,12
2015,Georgia,GEO,Bulgaria,BGR,0,0,0,5,5
2015,Ghana,GHA,Bulgaria,BGR,0,0,15,13,28
2015,Guinea,GIN,Bulgaria,BGR,0,0,0,5,5
2015,Cote d'Ivoire,CIV,Bulgaria,BGR,0,0,14,5,19
2015,India,IND,Bulgaria,BGR,5,0,0,47,52
2015,Iran (Islamic Rep. of),IRN,Bulgaria,BGR,0,0,16,207,223
2015,Iraq,IRQ,Bulgaria,BGR,107,49,180,6240,6576
2015,Liberia,LBR,Bulgaria,BGR,0,0,0,5,5
2015,Libya,LBY,Bulgaria,BGR,0,0,0,5,5
2015,Lebanon,LBN,Bulgaria,BGR,0,0,11,13,24
2015,Sri Lanka,LKA,Bulgaria,BGR,0,0,0,17,17
2015,Mali,MLI,Bulgaria,BGR,0,0,10,31,41
2015,Morocco,MAR,Bulgaria,BGR,0,0,0,12,12
2015,Myanmar,MMR,Bulgaria,BGR,0,0,0,25,25
2015,Nigeria,NGA,Bulgaria,BGR,0,0,11,0,11
2015,Pakistan,PAK,Bulgaria,BGR,0,0,19,687,706
2015,Rwanda,RWA,Bulgaria,BGR,0,0,0,11,11
2015,Senegal,SEN,Bulgaria,BGR,0,0,0,10,10
2015,Sierra Leone,SLE,Bulgaria,BGR,0,0,0,5,5
2015,Somalia,SOM,Bulgaria,BGR,0,0,0,16,16
2015,Sudan,SDN,Bulgaria,BGR,0,0,10,0,10
2015,Syrian Arab Rep.,SYR,Bulgaria,BGR,4520,802,66,2042,7430
2015,Tunisia,TUN,Bulgaria,BGR,0,0,0,5,5
2015,Turkey,TUR,Bulgaria,BGR,0,0,0,5,5
2015,Uganda,UGA,Bulgaria,BGR,0,0,0,5,5
2015,Ukraine,UKR,Bulgaria,BGR,0,0,40,17,57
2015,Stateless,XXA,Bulgaria,BGR,68,26,15,63,172
2015,Viet Nam,VNM,Cambodia,KHM,13,0,0,0,13
2015,Thailand,THA,Cambodia,KHM,0,0,0,5,5
2015,Afghanistan,AFG,Canada,CAN,292,0,38,26,356
2015,Albania,ALB,Canada,CAN,32,0,42,5,79
2015,Algeria,DZA,Canada,CAN,33,0,35,0,68
2015,Angola,AGO,Canada,CAN,5,0,17,0,22
2015,Antigua and Barbuda,ATG,Canada,CAN,13,0,0,0,13
2015,Egypt,EGY,Canada,CAN,164,0,15,5,184
2015,Argentina,ARG,Canada,CAN,0,0,5,5,10
2015,Azerbaijan,AZE,Canada,CAN,5,0,0,0,5
2015,Bahrain,BHR,Canada,CAN,5,0,0,0,5
2015,Barbados,BRB,Canada,CAN,18,0,5,0,23
2015,Burundi,BDI,Canada,CAN,113,0,38,0,151
2015,Benin,BEN,Canada,CAN,15,0,5,0,20
2015,Bangladesh,BGD,Canada,CAN,127,0,61,12,200
2015,Bahamas,BHS,Canada,CAN,18,0,10,5,33
2015,Burkina Faso,BFA,Canada,CAN,16,0,0,0,16
2015,Belarus,BLR,Canada,CAN,0,0,5,0,5
2015,Brazil,BRA,Canada,CAN,5,0,10,5,20
2015,Bosnia and Herzegovina,BIH,Canada,CAN,5,0,0,0,5
2015,Bulgaria,BGR,Canada,CAN,5,0,5,0,10
2015,Cambodia,KHM,Canada,CAN,5,0,5,0,10
2015,Central African Rep.,CAF,Canada,CAN,16,0,0,0,16
2015,Chad,TCD,Canada,CAN,60,0,25,0,85
2015,China,CHN,Canada,CAN,652,0,567,53,1272
2015,Chile,CHL,Canada,CAN,0,0,13,0,13
2015,Cameroon,CMR,Canada,CAN,145,0,48,0,193
2015,Congo,COG,Canada,CAN,21,0,14,0,35
2015,Dem. Rep. of the Congo,COD,Canada,CAN,103,0,161,5,269
2015,Colombia,COL,Canada,CAN,293,0,234,37,564
2015,Cuba,CUB,Canada,CAN,77,0,33,13,123
2015,Czechia,CZE,Canada,CAN,34,0,16,25,75
2015,Djibouti,DJI,Canada,CAN,40,0,12,0,52
2015,Dominican Rep.,DOM,Canada,CAN,5,0,14,5,24
2015,Ecuador,ECU,Canada,CAN,0,0,12,0,12
2015,Equatorial Guinea,GNQ,Canada,CAN,5,0,0,0,5
2015,Eritrea,ERI,Canada,CAN,228,0,15,5,248
2015,Ethiopia,ETH,Canada,CAN,152,0,71,5,228
2015,Fiji,FJI,Canada,CAN,0,0,5,0,5
2015,France,FRA,Canada,CAN,0,0,0,5,5
2015,Gabon,GAB,Canada,CAN,0,0,5,0,5
2015,Gambia,GMB,Canada,CAN,10,0,5,0,15
2015,Palestinian,PSE,Canada,CAN,78,0,29,10,117
2015,Georgia,GEO,Canada,CAN,15,0,27,5,47
2015,Germany,DEU,Canada,CAN,0,0,5,0,5
2015,Ghana,GHA,Canada,CAN,31,0,49,0,80
2015,Greece,GRC,Canada,CAN,0,0,15,0,15
2015,Grenada,GRD,Canada,CAN,0,0,5,0,5
2015,Guatemala,GTM,Canada,CAN,16,0,17,5,38
2015,Guinea,GIN,Canada,CAN,23,0,23,0,46
2015,Guyana,GUY,Canada,CAN,0,0,12,0,12
2015,Haiti,HTI,Canada,CAN,134,0,178,13,325
2015,"China, Hong Kong SAR",HKG,Canada,CAN,5,0,0,0,5
2015,Honduras,HND,Canada,CAN,65,0,43,10,118
2015,Croatia,HRV,Canada,CAN,10,0,10,5,25
2015,Hungary,HUN,Canada,CAN,493,0,117,78,688
2015,Cote d'Ivoire,CIV,Canada,CAN,13,0,13,0,26
2015,India,IND,Canada,CAN,86,0,146,45,277
2015,Indonesia,IDN,Canada,CAN,11,0,5,0,16
2015,Iran (Islamic Rep. of),IRN,Canada,CAN,119,0,16,5,140
2015,Iraq,IRQ,Canada,CAN,524,0,41,24,589
2015,Israel,ISR,Canada,CAN,5,0,28,5,38
2015,Italy,ITA,Canada,CAN,0,0,30,0,30
2015,Jamaica,JAM,Canada,CAN,82,0,75,0,157
2015,Jordan,JOR,Canada,CAN,34,0,37,5,76
2015,Japan,JPN,Canada,CAN,0,0,0,5,5
2015,Kazakhstan,KAZ,Canada,CAN,12,0,0,0,12
2015,Kenya,KEN,Canada,CAN,25,0,16,0,41
2015,Kyrgyzstan,KGZ,Canada,CAN,14,0,10,0,24
2015,Rep. of Korea,KOR,Canada,CAN,0,0,5,0,5
2015,Kuwait,KWT,Canada,CAN,0,0,5,0,5
2015,Liberia,LBR,Canada,CAN,0,0,10,0,10
2015,Libya,LBY,Canada,CAN,362,0,52,0,414
2015,Saint Lucia,LCA,Canada,CAN,14,0,15,0,29
2015,Lebanon,LBN,Canada,CAN,59,0,73,0,132
2015,Sri Lanka,LKA,Canada,CAN,163,0,43,5,211
2015,Mauritania,MRT,Canada,CAN,17,0,10,0,27
2015,Mexico,MEX,Canada,CAN,35,0,33,11,79
2015,Mali,MLI,Canada,CAN,26,0,37,5,68
2015,Malaysia,MYS,Canada,CAN,5,0,0,0,5
2015,Mongolia,MNG,Canada,CAN,18,0,12,0,30
2015,Morocco,MAR,Canada,CAN,10,0,17,0,27
2015,Myanmar,MMR,Canada,CAN,0,0,5,0,5
2015,Nepal,NPL,Canada,CAN,48,0,5,5,58
2015,Netherlands,NLD,Canada,CAN,0,0,10,0,10
2015,Niger,NER,Canada,CAN,5,0,0,0,5
2015,Nigeria,NGA,Canada,CAN,392,0,238,12,642
2015,Pakistan,PAK,Canada,CAN,657,0,142,12,811
2015,Panama,PAN,Canada,CAN,0,0,5,0,5
2015,Peru,PER,Canada,CAN,10,0,14,0,24
2015,Philippines,PHL,Canada,CAN,0,0,17,5,22
2015,Poland,POL,Canada,CAN,5,0,10,5,20
2015,Romania,ROU,Canada,CAN,0,0,0,10,10
2015,South Africa,ZAF,Canada,CAN,16,0,5,0,21
2015,Russian Federation,RUS,Canada,CAN,56,0,12,0,68
2015,Rwanda,RWA,Canada,CAN,31,0,18,5,54
2015,El Salvador,SLV,Canada,CAN,96,0,42,5,143
2015,Saudi Arabia,SAU,Canada,CAN,27,0,10,0,37
2015,Serbia and Kosovo: S/RES/1244 (1999),SRB,Canada,CAN,20,0,20,5,45
2015,Senegal,SEN,Canada,CAN,40,0,16,0,56
2015,Sierra Leone,SLE,Canada,CAN,5,0,0,0,5
2015,Somalia,SOM,Canada,CAN,210,0,135,26,371
2015,Spain,ESP,Canada,CAN,0,0,0,10,10
2015,Viet Nam,VNM,Canada,CAN,11,0,0,0,11
2015,Saint Kitts and Nevis,KNA,Canada,CAN,5,0,5,0,10
2015,Sudan,SDN,Canada,CAN,71,0,18,10,99
2015,Slovakia,SVK,Canada,CAN,136,0,42,91,269
2015,Eswatini,SWZ,Canada,CAN,5,0,0,0,5
2015,Switzerland,CHE,Canada,CAN,0,0,0,5,5
2015,Syrian Arab Rep.,SYR,Canada,CAN,552,0,13,5,570
2015,United Rep. of Tanzania,TZA,Canada,CAN,5,0,12,0,17
2015,Thailand,THA,Canada,CAN,0,0,5,0,5
2015,Togo,TGO,Canada,CAN,11,0,5,0,16
2015,Trinidad and Tobago,TTO,Canada,CAN,12,0,0,0,12
2015,Tunisia,TUN,Canada,CAN,19,0,14,0,33
2015,Turkey,TUR,Canada,CAN,101,0,50,10,161
2015,Uganda,UGA,Canada,CAN,45,0,14,0,59
2015,Ukraine,UKR,Canada,CAN,188,0,127,10,325
2015,United States of America,USA,Canada,CAN,5,0,108,23,136
2015,Uzbekistan,UZB,Canada,CAN,16,0,5,0,21
2015,Saint Vincent and the Grenadines,VCT,Canada,CAN,17,0,22,0,39
2015,Venezuela (Bolivarian Republic of),VEN,Canada,CAN,158,0,40,5,203
2015,Yemen,YEM,Canada,CAN,130,0,5,0,135
2015,Zambia,ZMB,Canada,CAN,5,0,0,0,5
2015,Zimbabwe,ZWE,Canada,CAN,31,0,11,0,42
2015,Stateless,XXA,Canada,CAN,132,0,27,0,159
2015,Chad,TCD,Central African Rep.,CAF,0,0,0,10,10
2015,Dem. Rep. of the Congo,COD,Central African Rep.,CAF,0,49,0,25,74
2015,Rwanda,RWA,Central African Rep.,CAF,0,0,0,10,10
2015,Cuba,CUB,Cayman Islands,CYM,5,0,68,0,73
2015,Colombia,COL,Chile,CHL,58,0,51,10,119
2015,Dem. People's Rep. of Korea,PRK,Chile,CHL,5,0,0,0,5
2015,El Salvador,SLV,Chile,CHL,5,0,0,0,5
2015,Syrian Arab Rep.,SYR,Chile,CHL,5,0,0,0,5
2015,Angola,AGO,Dem. Rep. of the Congo,COD,5,0,0,0,5
2015,Burundi,BDI,Dem. Rep. of the Congo,COD,276,0,5,0,281
2015,Central African Rep.,CAF,Dem. Rep. of the Congo,COD,25,0,24,16,65
2015,Congo,COG,Dem. Rep. of the Congo,COD,5,0,0,5,10
2015,Cote d'Ivoire,CIV,Dem. Rep. of the Congo,COD,0,0,0,5,5
2015,Kenya,KEN,Dem. Rep. of the Congo,COD,5,0,0,0,5
2015,Liberia,LBR,Dem. Rep. of the Congo,COD,0,0,0,5,5
2015,Rwanda,RWA,Dem. Rep. of the Congo,COD,5,0,0,0,5
2015,Somalia,SOM,Dem. Rep. of the Congo,COD,5,0,0,0,5
2015,South Sudan,SSD,Dem. Rep. of the Congo,COD,5,0,0,0,5
2015,Syrian Arab Rep.,SYR,Dem. Rep. of the Congo,COD,5,0,0,0,5
2015,United Rep. of Tanzania,TZA,Dem. Rep. of the Congo,COD,0,0,5,0,5
2015,Bangladesh,BGD,Colombia,COL,0,0,0,10,10
2015,Cuba,CUB,Colombia,COL,0,0,58,233,291
2015,Eritrea,ERI,Colombia,COL,0,0,0,5,5
2015,Ethiopia,ETH,Colombia,COL,0,0,0,5,5
2015,Haiti,HTI,Colombia,COL,0,0,0,5,5
2015,India,IND,Colombia,COL,0,0,0,5,5
2015,Nepal,NPL,Colombia,COL,0,0,0,10,10
2015,Nigeria,NGA,Colombia,COL,0,0,0,5,5
2015,Pakistan,PAK,Colombia,COL,0,0,0,10,10
2015,Somalia,SOM,Colombia,COL,0,0,0,5,5
2015,Syrian Arab Rep.,SYR,Colombia,COL,5,0,0,5,10
2015,United States of America,USA,Colombia,COL,0,0,0,5,5
2015,Venezuela (Bolivarian Republic of),VEN,Colombia,COL,5,0,16,68,89
2015,Colombia,COL,Costa Rica,CRI,111,0,204,0,315
2015,Cuba,CUB,Costa Rica,CRI,10,0,56,0,66
2015,Dominican Rep.,DOM,Costa Rica,CRI,0,0,5,0,5
2015,Ghana,GHA,Costa Rica,CRI,0,0,5,0,5
2015,Guatemala,GTM,Costa Rica,CRI,0,0,5,0,5
2015,Honduras,HND,Costa Rica,CRI,11,0,34,0,45
2015,Mexico,MEX,Costa Rica,CRI,0,0,5,0,5
2015,Nicaragua,NIC,Costa Rica,CRI,13,0,0,0,13
2015,Nigeria,NGA,Costa Rica,CRI,5,0,0,0,5
2015,El Salvador,SLV,Costa Rica,CRI,74,0,149,0,223
2015,Syrian Arab Rep.,SYR,Costa Rica,CRI,5,0,0,0,5
2015,Ukraine,UKR,Costa Rica,CRI,10,0,0,0,10
2015,Venezuela (Bolivarian Republic of),VEN,Costa Rica,CRI,15,0,91,0,106
2015,Afghanistan,AFG,Cyprus,CYP,0,0,0,5,5
2015,Egypt,EGY,Cyprus,CYP,5,0,59,57,121
2015,Armenia,ARM,Cyprus,CYP,5,0,0,0,5
2015,Bangladesh,BGD,Cyprus,CYP,0,0,45,10,55
2015,China,CHN,Cyprus,CYP,0,0,5,0,5
2015,Cameroon,CMR,Cyprus,CYP,12,0,0,5,17
2015,Dem. Rep. of the Congo,COD,Cyprus,CYP,5,0,0,5,10
2015,Comoros,COM,Cyprus,CYP,0,0,5,0,5
2015,Palestinian,PSE,Cyprus,CYP,31,12,0,11,54
2015,Georgia,GEO,Cyprus,CYP,0,0,0,5,5
2015,Ghana,GHA,Cyprus,CYP,0,0,5,0,5
2015,Guinea,GIN,Cyprus,CYP,0,0,0,5,5
2015,India,IND,Cyprus,CYP,5,0,54,30,89
2015,Iran (Islamic Rep. of),IRN,Cyprus,CYP,12,0,10,10,32
2015,Iraq,IRQ,Cyprus,CYP,26,10,0,24,60
2015,Jordan,JOR,Cyprus,CYP,0,5,10,10,25
2015,Sri Lanka,LKA,Cyprus,CYP,0,0,46,5,51
2015,Mali,MLI,Cyprus,CYP,0,0,0,5,5
2015,Nepal,NPL,Cyprus,CYP,0,0,5,0,5
2015,Nigeria,NGA,Cyprus,CYP,0,0,14,0,14
2015,Pakistan,PAK,Cyprus,CYP,0,0,63,34,97
2015,Philippines,PHL,Cyprus,CYP,0,0,44,5,49
2015,Russian Federation,RUS,Cyprus,CYP,5,0,0,5,10
2015,Rwanda,RWA,Cyprus,CYP,5,0,0,0,5
2015,Sierra Leone,SLE,Cyprus,CYP,5,0,0,0,5
2015,Somalia,SOM,Cyprus,CYP,5,0,0,32,37
2015,Viet Nam,VNM,Cyprus,CYP,0,0,82,14,96
2015,Syrian Arab Rep.,SYR,Cyprus,CYP,33,1356,0,100,1489
2015,Turkey,TUR,Cyprus,CYP,5,0,16,5,26
2015,Ukraine,UKR,Cyprus,CYP,0,0,0,35,35
2015,Stateless,XXA,Cyprus,CYP,52,0,0,5,57
2015,Afghanistan,AFG,Czechia,CZE,0,5,0,20,25
2015,Algeria,DZA,Czechia,CZE,0,0,0,10,10
2015,Armenia,ARM,Czechia,CZE,5,0,16,25,46
2015,Azerbaijan,AZE,Czechia,CZE,5,0,0,0,5
2015,Belarus,BLR,Czechia,CZE,5,11,0,5,21
2015,China,CHN,Czechia,CZE,0,0,0,5,5
2015,Dem. Rep. of the Congo,COD,Czechia,CZE,0,0,0,5,5
2015,Cuba,CUB,Czechia,CZE,0,54,0,59,113
2015,Georgia,GEO,Czechia,CZE,0,0,5,14,19
2015,Ghana,GHA,Czechia,CZE,0,0,0,5,5
2015,India,IND,Czechia,CZE,0,0,0,10,10
2015,Iran (Islamic Rep. of),IRN,Czechia,CZE,0,0,0,5,5
2015,Iraq,IRQ,Czechia,CZE,5,14,0,0,19
2015,Kazakhstan,KAZ,Czechia,CZE,0,0,0,11,11
2015,Kyrgyzstan,KGZ,Czechia,CZE,0,0,0,5,5
2015,Libya,LBY,Czechia,CZE,0,0,0,5,5
2015,Lebanon,LBN,Czechia,CZE,0,0,0,5,5
2015,Rep. of Moldova,MDA,Czechia,CZE,5,0,12,5,22
2015,Mongolia,MNG,Czechia,CZE,0,0,5,11,16
2015,Nigeria,NGA,Czechia,CZE,5,0,11,16,32
2015,Pakistan,PAK,Czechia,CZE,0,0,0,5,5
2015,Russian Federation,RUS,Czechia,CZE,0,5,16,16,37
2015,Serbia and Kosovo: S/RES/1244 (1999),SRB,Czechia,CZE,0,0,13,14,27
2015,Viet Nam,VNM,Czechia,CZE,0,0,48,25,73
2015,Slovakia,SVK,Czechia,CZE,0,0,0,5,5
2015,Syrian Arab Rep.,SYR,Czechia,CZE,29,101,0,20,150
2015,Turkey,TUR,Czechia,CZE,0,0,13,0,13
2015,Ukraine,UKR,Czechia,CZE,5,175,277,172,629
2015,Uzbekistan,UZB,Czechia,CZE,0,5,0,0,5
2015,Stateless,XXA,Czechia,CZE,5,26,5,0,36
2015,Afghanistan,AFG,Denmark,DNK,19,48,110,0,177
2015,Albania,ALB,Denmark,DNK,0,0,69,0,69
2015,Algeria,DZA,Denmark,DNK,0,0,15,0,15
2015,Egypt,EGY,Denmark,DNK,0,0,13,0,13
2015,Armenia,ARM,Denmark,DNK,5,0,61,0,66
2015,Azerbaijan,AZE,Denmark,DNK,0,0,11,0,11
2015,Bangladesh,BGD,Denmark,DNK,0,0,15,0,15
2015,Bosnia and Herzegovina,BIH,Denmark,DNK,0,0,24,0,24
2015,Bulgaria,BGR,Denmark,DNK,0,0,10,0,10
2015,China,CHN,Denmark,DNK,0,0,12,0,12
2015,Dem. Rep. of the Congo,COD,Denmark,DNK,0,0,10,0,10
2015,Eritrea,ERI,Denmark,DNK,2700,182,65,0,2947
2015,Ethiopia,ETH,Denmark,DNK,24,5,45,0,74
2015,Gambia,GMB,Denmark,DNK,0,0,5,0,5
2015,Georgia,GEO,Denmark,DNK,0,0,15,0,15
2015,Ghana,GHA,Denmark,DNK,0,0,10,0,10
2015,Haiti,HTI,Denmark,DNK,0,0,5,0,5
2015,India,IND,Denmark,DNK,0,0,13,0,13
2015,Iran (Islamic Rep. of),IRN,Denmark,DNK,96,10,40,0,146
2015,Iraq,IRQ,Denmark,DNK,5,21,42,0,68
2015,Jordan,JOR,Denmark,DNK,0,0,5,0,5
2015,Kenya,KEN,Denmark,DNK,0,0,12,0,12
2015,Lebanon,LBN,Denmark,DNK,0,0,18,0,18
2015,Lithuania,LTU,Denmark,DNK,0,0,5,0,5
2015,North Macedonia,MKD,Denmark,DNK,0,0,31,0,31
2015,Rep. of Moldova,MDA,Denmark,DNK,0,0,5,0,5
2015,Morocco,MAR,Denmark,DNK,0,0,30,0,30
2015,Myanmar,MMR,Denmark,DNK,0,0,37,0,37
2015,Nigeria,NGA,Denmark,DNK,0,0,24,0,24
2015,Pakistan,PAK,Denmark,DNK,0,5,21,0,26
2015,Romania,ROU,Denmark,DNK,0,0,10,0,10
2015,Russian Federation,RUS,Denmark,DNK,10,10,197,0,217
2015,Rwanda,RWA,Denmark,DNK,0,0,5,0,5
2015,Serbia and Kosovo: S/RES/1244 (1999),SRB,Denmark,DNK,0,0,165,0,165
2015,Somalia,SOM,Denmark,DNK,5,118,159,0,282
2015,Sudan,SDN,Denmark,DNK,10,0,35,0,45
2015,Syrian Arab Rep.,SYR,Denmark,DNK,4167,1550,111,0,5828
2015,United Rep. of Tanzania,TZA,Denmark,DNK,0,0,5,0,5
2015,Thailand,THA,Denmark,DNK,5,0,0,0,5
2015,Tunisia,TUN,Denmark,DNK,0,0,11,0,11
2015,Turkey,TUR,Denmark,DNK,0,0,5,0,5
2015,Uganda,UGA,Denmark,DNK,15,0,5,0,20
2015,Ukraine,UKR,Denmark,DNK,0,0,66,0,66
2015,Stateless,XXA,Denmark,DNK,539,368,106,0,1013
2015,Dem. Rep. of the Congo,COD,Djibouti,DJI,0,0,0,5,5
2015,Eritrea,ERI,Djibouti,DJI,82,0,0,411,493
2015,Ethiopia,ETH,Djibouti,DJI,55,0,0,795,850
2015,Palestinian,PSE,Djibouti,DJI,5,0,0,0,5
2015,Pakistan,PAK,Djibouti,DJI,5,0,0,0,5
2015,Somalia,SOM,Djibouti,DJI,177,0,0,22,199
2015,Syrian Arab Rep.,SYR,Djibouti,DJI,0,0,0,5,5
2015,Yemen,YEM,Djibouti,DJI,6157,0,0,30,6187
2015,Afghanistan,AFG,Dominican Rep.,DOM,5,0,0,0,5
2015,Cuba,CUB,Dominican Rep.,DOM,0,0,0,5,5
2015,Iran (Islamic Rep. of),IRN,Dominican Rep.,DOM,0,0,5,0,5
2015,Iraq,IRQ,Dominican Rep.,DOM,0,0,0,5,5
2015,Syrian Arab Rep.,SYR,Dominican Rep.,DOM,0,0,0,5,5
2015,Afghanistan,AFG,Estonia,EST,0,0,10,0,10
2015,Algeria,DZA,Estonia,EST,0,0,5,0,5
2015,Egypt,EGY,Estonia,EST,0,0,5,0,5
2015,Armenia,ARM,Estonia,EST,0,0,5,0,5
2015,Cameroon,CMR,Estonia,EST,0,0,5,0,5
2015,Georgia,GEO,Estonia,EST,0,0,0,5,5
2015,Sri Lanka,LKA,Estonia,EST,0,5,0,0,5
2015,Mali,MLI,Estonia,EST,0,0,5,0,5
2015,Nigeria,NGA,Estonia,EST,0,0,5,0,5
2015,Russian Federation,RUS,Estonia,EST,0,0,5,5,10
2015,Sudan,SDN,Estonia,EST,14,0,0,0,14
2015,Syrian Arab Rep.,SYR,Estonia,EST,0,0,14,0,14
2015,Ukraine,UKR,Estonia,EST,5,54,18,23,100
2015,Afghanistan,AFG,Finland,FIN,36,19,43,136,234
2015,Albania,ALB,Finland,FIN,0,0,372,287,659
2015,Algeria,DZA,Finland,FIN,0,0,19,50,69
2015,Angola,AGO,Finland,FIN,0,0,0,10,10
2015,Egypt,EGY,Finland,FIN,0,0,0,13,13
2015,Azerbaijan,AZE,Finland,FIN,5,5,5,14,29
2015,Burundi,BDI,Finland,FIN,0,0,0,5,5
2015,Bangladesh,BGD,Finland,FIN,0,0,13,0,13
2015,Belarus,BLR,Finland,FIN,0,0,5,14,19
2015,Bosnia and Herzegovina,BIH,Finland,FIN,0,0,19,5,24
2015,Bulgaria,BGR,Finland,FIN,0,0,5,0,5
2015,China,CHN,Finland,FIN,11,0,0,0,11
2015,Cameroon,CMR,Finland,FIN,10,0,10,5,25
2015,Dem. Rep. of the Congo,COD,Finland,FIN,11,0,5,5,21
2015,Dominican Rep.,DOM,Finland,FIN,5,0,0,5,10
2015,Eritrea,ERI,Finland,FIN,0,0,0,12,12
2015,Estonia,EST,Finland,FIN,0,0,0,5,5
2015,Ethiopia,ETH,Finland,FIN,5,0,5,11,21
2015,Gambia,GMB,Finland,FIN,0,0,16,17,33
2015,Georgia,GEO,Finland,FIN,0,0,17,5,22
2015,Ghana,GHA,Finland,FIN,0,0,10,10,20
2015,Guinea-Bissau,GNB,Finland,FIN,0,0,5,0,5
2015,Guinea,GIN,Finland,FIN,0,0,12,0,12
2015,Cote d'Ivoire,CIV,Finland,FIN,5,0,0,0,5
2015,India,IND,Finland,FIN,0,0,10,0,10
2015,Iran (Islamic Rep. of),IRN,Finland,FIN,42,0,5,45,92
2015,Iraq,IRQ,Finland,FIN,426,182,110,2890,3608
2015,Jordan,JOR,Finland,FIN,0,0,0,5,5
2015,Kazakhstan,KAZ,Finland,FIN,5,0,0,0,5
2015,Kenya,KEN,Finland,FIN,0,0,0,5,5
2015,Rep. of Korea,KOR,Finland,FIN,0,0,5,0,5
2015,Libya,LBY,Finland,FIN,0,10,0,13,23
2015,Lebanon,LBN,Finland,FIN,0,0,13,5,18
2015,Sri Lanka,LKA,Finland,FIN,0,0,5,0,5
2015,Mauritania,MRT,Finland,FIN,0,0,0,5,5
2015,North Macedonia,MKD,Finland,FIN,0,0,19,0,19
2015,Mali,MLI,Finland,FIN,0,0,0,13,13
2015,Morocco,MAR,Finland,FIN,5,0,22,54,81
2015,Montenegro,MNE,Finland,FIN,0,0,5,5,10
2015,Myanmar,MMR,Finland,FIN,15,0,0,0,15
2015,Nepal,NPL,Finland,FIN,0,0,53,0,53
2015,Nigeria,NGA,Finland,FIN,0,0,55,60,115
2015,Pakistan,PAK,Finland,FIN,5,0,14,5,24
2015,Romania,ROU,Finland,FIN,0,0,5,0,5
2015,Russian Federation,RUS,Finland,FIN,56,20,63,33,172
2015,Serbia and Kosovo: S/RES/1244 (1999),SRB,Finland,FIN,0,0,139,38,177
2015,Senegal,SEN,Finland,FIN,0,0,0,10,10
2015,Sierra Leone,SLE,Finland,FIN,0,0,0,5,5
2015,Somalia,SOM,Finland,FIN,231,171,14,148,564
2015,Spain,ESP,Finland,FIN,0,0,0,5,5
2015,Viet Nam,VNM,Finland,FIN,0,0,0,5,5
2015,Sudan,SDN,Finland,FIN,0,0,0,5,5
2015,Syrian Arab Rep.,SYR,Finland,FIN,107,22,0,55,184
2015,United Rep. of Tanzania,TZA,Finland,FIN,0,0,0,10,10
2015,Tajikistan,TJK,Finland,FIN,0,0,0,5,5
2015,Togo,TGO,Finland,FIN,0,0,0,5,5
2015,Tunisia,TUN,Finland,FIN,0,0,5,20,25
2015,Turkey,TUR,Finland,FIN,0,0,30,18,48
2015,United Arab Emirates,ARE,Finland,FIN,0,0,0,5,5
2015,Uganda,UGA,Finland,FIN,5,0,0,0,5
2015,Ukraine,UKR,Finland,FIN,0,0,58,15,73
2015,United States of America,USA,Finland,FIN,0,0,0,5,5
2015,Uzbekistan,UZB,Finland,FIN,0,0,5,0,5
2015,Yemen,YEM,Finland,FIN,0,5,0,0,5
2015,Stateless,XXA,Finland,FIN,42,0,5,18,65
2015,Afghanistan,AFG,France,FRA,207,346,136,0,689
2015,Albania,ALB,France,FRA,45,207,2057,0,2309
2015,Algeria,DZA,France,FRA,66,19,1523,0,1608
2015,Angola,AGO,France,FRA,31,10,372,0,413
2015,Egypt,EGY,France,FRA,75,0,222,0,297
2015,Armenia,ARM,France,FRA,38,20,1087,0,1145
2015,Azerbaijan,AZE,France,FRA,76,5,625,0,706
2015,Burundi,BDI,France,FRA,11,0,10,0,21
2015,Benin,BEN,France,FRA,5,0,15,0,20
2015,Bangladesh,BGD,France,FRA,217,24,3045,0,3286
2015,Bhutan,BTN,France,FRA,5,0,42,0,47
2015,Burkina Faso,BFA,France,FRA,0,10,26,0,36
2015,Belarus,BLR,France,FRA,19,0,53,0,72
2015,Brazil,BRA,France,FRA,0,0,10,0,10
2015,Bosnia and Herzegovina,BIH,France,FRA,13,5,246,0,264
2015,Cambodia,KHM,France,FRA,5,0,40,0,45
2015,Central African Rep.,CAF,France,FRA,190,420,78,0,688
2015,Chad,TCD,France,FRA,43,5,266,0,314
2015,China,CHN,France,FRA,828,0,1833,0,2661
2015,Cameroon,CMR,France,FRA,31,10,156,0,197
2015,Congo,COG,France,FRA,44,5,758,0,807
2015,Dem. Rep. of the Congo,COD,France,FRA,465,68,4241,0,4774
2015,Comoros,COM,France,FRA,29,5,278,0,312
2015,Colombia,COL,France,FRA,10,5,40,0,55
2015,Cuba,CUB,France,FRA,12,0,15,0,27
2015,Cabo Verde,CPV,France,FRA,0,0,5,0,5
2015,Djibouti,DJI,France,FRA,17,0,15,0,32
2015,Dominica,DMA,France,FRA,0,0,10,0,10
2015,Dominican Rep.,DOM,France,FRA,0,10,300,0,310
2015,Eritrea,ERI,France,FRA,492,0,568,0,1060
2015,Ethiopia,ETH,France,FRA,62,0,201,0,263
2015,Gabon,GAB,France,FRA,0,0,13,0,13
2015,Gambia,GMB,France,FRA,19,0,90,0,109
2015,Palestinian,PSE,France,FRA,138,16,48,0,202
2015,Georgia,GEO,France,FRA,84,36,1402,0,1522
2015,Ghana,GHA,France,FRA,0,0,23,0,23
2015,Guinea-Bissau,GNB,France,FRA,10,0,100,0,110
2015,Guinea,GIN,France,FRA,675,96,2243,0,3014
2015,Guyana,GUY,France,FRA,5,0,19,0,24
2015,Haiti,HTI,France,FRA,33,24,2428,0,2485
2015,Cote d'Ivoire,CIV,France,FRA,150,38,846,0,1034
2015,India,IND,France,FRA,5,5,60,0,70
2015,Iran (Islamic Rep. of),IRN,France,FRA,107,0,77,0,184
2015,Iraq,IRQ,France,FRA,1822,52,41,0,1915
2015,Israel,ISR,France,FRA,0,0,5,0,5
2015,Jamaica,JAM,France,FRA,5,0,10,0,15
2015,Jordan,JOR,France,FRA,5,0,5,0,10
2015,Kazakhstan,KAZ,France,FRA,12,5,105,0,122
2015,Kenya,KEN,France,FRA,5,0,10,0,15
2015,Kyrgyzstan,KGZ,France,FRA,5,0,47,0,52
2015,Lao People's Dem. Rep.,LAO,France,FRA,5,0,0,0,5
2015,Libya,LBY,France,FRA,58,5,133,0,196
2015,Saint Lucia,LCA,France,FRA,0,0,5,0,5
2015,Lebanon,LBN,France,FRA,5,0,35,0,40
2015,Sri Lanka,LKA,France,FRA,543,45,2136,0,2724
2015,Madagascar,MDG,France,FRA,5,5,96,0,106
2015,Mauritania,MRT,France,FRA,77,0,787,0,864
2015,North Macedonia,MKD,France,FRA,5,0,188,0,193
2015,Rep. of Moldova,MDA,France,FRA,0,0,27,0,27
2015,Mexico,MEX,France,FRA,0,0,11,0,11
2015,Mali,MLI,France,FRA,184,12,974,0,1170
2015,Mongolia,MNG,France,FRA,21,10,137,0,168
2015,Morocco,MAR,France,FRA,20,0,146,0,166
2015,Montenegro,MNE,France,FRA,0,0,98,0,98
2015,Mauritius,MUS,France,FRA,0,0,5,0,5
2015,Myanmar,MMR,France,FRA,5,0,63,0,68
2015,Nepal,NPL,France,FRA,5,5,115,0,125
2015,Niger,NER,France,FRA,0,0,16,0,16
2015,Nigeria,NGA,France,FRA,75,27,1385,0,1487
2015,Pakistan,PAK,France,FRA,108,23,2458,0,2589
2015,Peru,PER,France,FRA,5,5,37,0,47
2015,South Africa,ZAF,France,FRA,0,0,13,0,13
2015,Russian Federation,RUS,France,FRA,437,66,3075,0,3578
2015,Rwanda,RWA,France,FRA,40,0,55,0,95
2015,El Salvador,SLV,France,FRA,0,0,11,0,11
2015,Serbia and Kosovo: S/RES/1244 (1999),SRB,France,FRA,195,101,3126,0,3422
2015,Senegal,SEN,France,FRA,90,5,242,0,337
2015,Sierra Leone,SLE,France,FRA,10,0,53,0,63
2015,Somalia,SOM,France,FRA,39,45,700,0,784
2015,Viet Nam,VNM,France,FRA,11,0,23,0,34
2015,Sudan,SDN,France,FRA,1163,36,2371,0,3570
2015,Suriname,SUR,France,FRA,0,0,10,0,10
2015,South Sudan,SSD,France,FRA,5,0,0,0,5
2015,Slovakia,SVK,France,FRA,5,0,0,0,5
2015,Syrian Arab Rep.,SYR,France,FRA,1587,735,74,0,2396
2015,Thailand,THA,France,FRA,5,0,10,0,15
2015,Tajikistan,TJK,France,FRA,0,0,11,0,11
2015,Turkmenistan,TKM,France,FRA,0,0,5,0,5
2015,Togo,TGO,France,FRA,18,0,147,0,165
2015,Tunisia,TUN,France,FRA,25,5,186,0,216
2015,Turkey,TUR,France,FRA,119,10,1151,0,1280
2015,Uganda,UGA,France,FRA,21,0,10,0,31
2015,Ukraine,UKR,France,FRA,100,206,953,0,1259
2015,Uzbekistan,UZB,France,FRA,0,0,15,0,15
2015,Venezuela (Bolivarian Republic of),VEN,France,FRA,19,0,10,0,29
2015,Western Sahara,ESH,France,FRA,104,5,393,0,502
2015,Yemen,YEM,France,FRA,18,15,5,0,38
2015,Afghanistan,AFG,United Kingdom of Great Britain and Northern Ireland,GBR,592,193,1040,485,2310
2015,Albania,ALB,United Kingdom of Great Britain and Northern Ireland,GBR,10,356,1539,418,2323
2015,Algeria,DZA,United Kingdom of Great Britain and Northern Ireland,GBR,14,5,166,46,231
2015,Angola,AGO,United Kingdom of Great Britain and Northern Ireland,GBR,10,5,31,5,51
2015,Egypt,EGY,United Kingdom of Great Britain and Northern Ireland,GBR,27,61,286,86,460
2015,Argentina,ARG,United Kingdom of Great Britain and Northern Ireland,GBR,0,0,5,0,5
2015,Armenia,ARM,United Kingdom of Great Britain and Northern Ireland,GBR,5,0,42,5,52
2015,Australia,AUS,United Kingdom of Great Britain and Northern Ireland,GBR,0,0,0,5,5
2015,Azerbaijan,AZE,United Kingdom of Great Britain and Northern Ireland,GBR,5,0,19,0,24
2015,Bahrain,BHR,United Kingdom of Great Britain and Northern Ireland,GBR,19,0,5,0,24
2015,Barbados,BRB,United Kingdom of Great Britain and Northern Ireland,GBR,0,0,5,0,5
2015,Burundi,BDI,United Kingdom of Great Britain and Northern Ireland,GBR,0,0,12,0,12
2015,Belgium,BEL,United Kingdom of Great Britain and Northern Ireland,GBR,0,0,0,5,5
2015,Bangladesh,BGD,United Kingdom of Great Britain and Northern Ireland,GBR,86,31,887,192,1196
2015,Bhutan,BTN,United Kingdom of Great Britain and Northern Ireland,GBR,5,0,0,0,5
2015,Belarus,BLR,United Kingdom of Great Britain and Northern Ireland,GBR,14,0,0,0,14
2015,Bolivia (Plurinational State of),BOL,United Kingdom of Great Britain and Northern Ireland,GBR,0,0,17,5,22
2015,Botswana,BWA,United Kingdom of Great Britain and Northern Ireland,GBR,0,5,17,0,22
2015,Brazil,BRA,United Kingdom of Great Britain and Northern Ireland,GBR,0,0,16,10,26
2015,Bosnia and Herzegovina,BIH,United Kingdom of Great Britain and Northern Ireland,GBR,0,0,0,5,5
2015,Bulgaria,BGR,United Kingdom of Great Britain and Northern Ireland,GBR,0,0,5,0,5
2015,Canada,CAN,United Kingdom of Great Britain and Northern Ireland,GBR,5,0,10,0,15
2015,Central African Rep.,CAF,United Kingdom of Great Britain and Northern Ireland,GBR,0,0,5,0,5
2015,Chad,TCD,United Kingdom of Great Britain and Northern Ireland,GBR,10,0,18,5,33
2015,China,CHN,United Kingdom of Great Britain and Northern Ireland,GBR,78,32,1089,116,1315
2015,Cameroon,CMR,United Kingdom of Great Britain and Northern Ireland,GBR,49,5,112,5,171
2015,Congo,COG,United Kingdom of Great Britain and Northern Ireland,GBR,5,5,24,0,34
2015,Dem. Rep. of the Congo,COD,United Kingdom of Great Britain and Northern Ireland,GBR,80,23,204,31,338
2015,Colombia,COL,United Kingdom of Great Britain and Northern Ireland,GBR,0,0,10,5,15
2015,Cyprus,CYP,United Kingdom of Great Britain and Northern Ireland,GBR,0,0,5,0,5
2015,Czechia,CZE,United Kingdom of Great Britain and Northern Ireland,GBR,0,0,5,0,5
2015,Dominica,DMA,United Kingdom of Great Britain and Northern Ireland,GBR,0,5,0,0,5
2015,Equatorial Guinea,GNQ,United Kingdom of Great Britain and Northern Ireland,GBR,0,0,5,0,5
2015,Eritrea,ERI,United Kingdom of Great Britain and Northern Ireland,GBR,1354,211,1600,177,3342
2015,Ethiopia,ETH,United Kingdom of Great Britain and Northern Ireland,GBR,350,14,271,39,674
2015,Gambia,GMB,United Kingdom of Great Britain and Northern Ireland,GBR,107,10,199,19,335
2015,Palestinian,PSE,United Kingdom of Great Britain and Northern Ireland,GBR,82,17,108,37,244
2015,Georgia,GEO,United Kingdom of Great Britain and Northern Ireland,GBR,0,0,73,5,78
2015,Germany,DEU,United Kingdom of Great Britain and Northern Ireland,GBR,0,0,0,5,5
2015,Ghana,GHA,United Kingdom of Great Britain and Northern Ireland,GBR,18,0,152,32,202
2015,Guinea-Bissau,GNB,United Kingdom of Great Britain and Northern Ireland,GBR,0,5,0,0,5
2015,Greece,GRC,United Kingdom of Great Britain and Northern Ireland,GBR,0,0,5,0,5
2015,Grenada,GRD,United Kingdom of Great Britain and Northern Ireland,GBR,0,0,5,0,5
2015,Guatemala,GTM,United Kingdom of Great Britain and Northern Ireland,GBR,0,0,5,0,5
2015,Guinea,GIN,United Kingdom of Great Britain and Northern Ireland,GBR,11,0,29,5,45
2015,Guyana,GUY,United Kingdom of Great Britain and Northern Ireland,GBR,5,0,5,0,10
2015,Honduras,HND,United Kingdom of Great Britain and Northern Ireland,GBR,0,0,12,0,12
2015,Hungary,HUN,United Kingdom of Great Britain and Northern Ireland,GBR,0,0,5,0,5
2015,Cote d'Ivoire,CIV,United Kingdom of Great Britain and Northern Ireland,GBR,10,0,43,5,58
2015,India,IND,United Kingdom of Great Britain and Northern Ireland,GBR,15,10,954,379,1358
2015,Ireland,IRL,United Kingdom of Great Britain and Northern Ireland,GBR,0,0,5,0,5
2015,Iran (Islamic Rep. of),IRN,United Kingdom of Great Britain and Northern Ireland,GBR,1946,52,1272,368,3638
2015,Iraq,IRQ,United Kingdom of Great Britain and Northern Ireland,GBR,215,92,896,337,1540
2015,Israel,ISR,United Kingdom of Great Britain and Northern Ireland,GBR,0,0,11,0,11
2015,Jamaica,JAM,United Kingdom of Great Britain and Northern Ireland,GBR,18,5,146,12,181
2015,Jordan,JOR,United Kingdom of Great Britain and Northern Ireland,GBR,11,0,32,5,48
2015,Kazakhstan,KAZ,United Kingdom of Great Britain and Northern Ireland,GBR,0,0,12,0,12
2015,Kenya,KEN,United Kingdom of Great Britain and Northern Ireland,GBR,10,5,99,5,119
2015,Kyrgyzstan,KGZ,United Kingdom of Great Britain and Northern Ireland,GBR,0,0,11,0,11
2015,Rep. of Korea,KOR,United Kingdom of Great Britain and Northern Ireland,GBR,0,0,18,5,23
2015,Dem. People's Rep. of Korea,PRK,United Kingdom of Great Britain and Northern Ireland,GBR,0,0,42,10,52
2015,Kuwait,KWT,United Kingdom of Great Britain and Northern Ireland,GBR,103,0,32,10,145
2015,Liberia,LBR,United Kingdom of Great Britain and Northern Ireland,GBR,0,0,12,0,12
2015,Libya,LBY,United Kingdom of Great Britain and Northern Ireland,GBR,150,45,835,60,1090
2015,Saint Lucia,LCA,United Kingdom of Great Britain and Northern Ireland,GBR,0,0,12,0,12
2015,Lebanon,LBN,United Kingdom of Great Britain and Northern Ireland,GBR,20,0,84,5,109
2015,Sri Lanka,LKA,United Kingdom of Great Britain and Northern Ireland,GBR,198,28,1908,117,2251
2015,Lithuania,LTU,United Kingdom of Great Britain and Northern Ireland,GBR,0,0,33,11,44
2015,Latvia,LVA,United Kingdom of Great Britain and Northern Ireland,GBR,0,0,20,11,31
2015,Maldives,MDV,United Kingdom of Great Britain and Northern Ireland,GBR,10,0,0,0,10
2015,Mexico,MEX,United Kingdom of Great Britain and Northern Ireland,GBR,0,0,13,5,18
2015,Mali,MLI,United Kingdom of Great Britain and Northern Ireland,GBR,0,0,13,5,18
2015,Malaysia,MYS,United Kingdom of Great Britain and Northern Ireland,GBR,15,0,41,10,66
2015,Malawi,MWI,United Kingdom of Great Britain and Northern Ireland,GBR,10,38,138,10,196
2015,Mongolia,MNG,United Kingdom of Great Britain and Northern Ireland,GBR,5,0,18,5,28
2015,Morocco,MAR,United Kingdom of Great Britain and Northern Ireland,GBR,12,5,56,22,95
2015,Mauritius,MUS,United Kingdom of Great Britain and Northern Ireland,GBR,0,0,63,12,75
2015,Myanmar,MMR,United Kingdom of Great Britain and Northern Ireland,GBR,56,0,136,13,205
2015,Namibia,NAM,United Kingdom of Great Britain and Northern Ireland,GBR,5,0,32,0,37
2015,Nepal,NPL,United Kingdom of Great Britain and Northern Ireland,GBR,0,0,66,5,71
2015,Niger,NER,United Kingdom of Great Britain and Northern Ireland,GBR,0,0,5,0,5
2015,Nigeria,NGA,United Kingdom of Great Britain and Northern Ireland,GBR,132,122,1486,112,1852
2015,Oman,OMN,United Kingdom of Great Britain and Northern Ireland,GBR,0,0,14,0,14
2015,Pakistan,PAK,United Kingdom of Great Britain and Northern Ireland,GBR,718,45,3002,474,4239
2015,Philippines,PHL,United Kingdom of Great Britain and Northern Ireland,GBR,0,0,35,10,45
2015,Poland,POL,United Kingdom of Great Britain and Northern Ireland,GBR,0,0,75,34,109
2015,Portugal,PRT,United Kingdom of Great Britain and Northern Ireland,GBR,0,0,5,5,10
2015,Romania,ROU,United Kingdom of Great Britain and Northern Ireland,GBR,0,0,15,5,20
2015,South Africa,ZAF,United Kingdom of Great Britain and Northern Ireland,GBR,5,10,79,5,99
2015,Russian Federation,RUS,United Kingdom of Great Britain and Northern Ireland,GBR,50,5,87,21,163
2015,Rwanda,RWA,United Kingdom of Great Britain and Northern Ireland,GBR,5,5,13,0,23
2015,El Salvador,SLV,United Kingdom of Great Britain and Northern Ireland,GBR,5,0,22,0,27
2015,Saudi Arabia,SAU,United Kingdom of Great Britain and Northern Ireland,GBR,11,5,11,10,37
2015,Serbia and Kosovo: S/RES/1244 (1999),SRB,United Kingdom of Great Britain and Northern Ireland,GBR,0,0,36,26,62
2015,Senegal,SEN,United Kingdom of Great Britain and Northern Ireland,GBR,10,0,23,5,38
2015,Singapore,SGP,United Kingdom of Great Britain and Northern Ireland,GBR,0,0,5,0,5
2015,Sierra Leone,SLE,United Kingdom of Great Britain and Northern Ireland,GBR,12,14,72,5,103
2015,Somalia,SOM,United Kingdom of Great Britain and Northern Ireland,GBR,214,25,298,65,602
2015,Viet Nam,VNM,United Kingdom of Great Britain and Northern Ireland,GBR,42,60,234,203,539
2015,Sudan,SDN,United Kingdom of Great Britain and Northern Ireland,GBR,2393,5,348,134,2880
2015,South Sudan,SSD,United Kingdom of Great Britain and Northern Ireland,GBR,11,5,0,0,16
2015,Slovakia,SVK,United Kingdom of Great Britain and Northern Ireland,GBR,0,0,5,12,17
2015,Eswatini,SWZ,United Kingdom of Great Britain and Northern Ireland,GBR,24,0,5,0,29
2015,Syrian Arab Rep.,SYR,United Kingdom of Great Britain and Northern Ireland,GBR,2011,42,213,250,2516
2015,United Rep. of Tanzania,TZA,United Kingdom of Great Britain and Northern Ireland,GBR,5,10,35,0,50
2015,Thailand,THA,United Kingdom of Great Britain and Northern Ireland,GBR,0,0,14,5,19
2015,Tajikistan,TJK,United Kingdom of Great Britain and Northern Ireland,GBR,0,0,5,0,5
2015,Turkmenistan,TKM,United Kingdom of Great Britain and Northern Ireland,GBR,0,0,5,5,10
2015,Togo,TGO,United Kingdom of Great Britain and Northern Ireland,GBR,0,0,5,5,10
2015,Trinidad and Tobago,TTO,United Kingdom of Great Britain and Northern Ireland,GBR,5,0,21,5,31
2015,Tunisia,TUN,United Kingdom of Great Britain and Northern Ireland,GBR,0,5,14,10,29
2015,Turkey,TUR,United Kingdom of Great Britain and Northern Ireland,GBR,35,33,216,31,315
2015,United Arab Emirates,ARE,United Kingdom of Great Britain and Northern Ireland,GBR,0,0,20,0,20
2015,Uganda,UGA,United Kingdom of Great Britain and Northern Ireland,GBR,145,5,134,12,296
2015,Ukraine,UKR,United Kingdom of Great Britain and Northern Ireland,GBR,0,0,243,73,316
2015,United States of America,USA,United Kingdom of Great Britain and Northern Ireland,GBR,13,0,36,21,70
2015,Uzbekistan,UZB,United Kingdom of Great Britain and Northern Ireland,GBR,0,5,12,5,22
2015,Saint Vincent and the Grenadines,VCT,United Kingdom of Great Britain and Northern Ireland,GBR,0,0,13,0,13
2015,Venezuela (Bolivarian Republic of),VEN,United Kingdom of Great Britain and Northern Ireland,GBR,5,0,19,0,24
2015,Western Sahara,ESH,United Kingdom of Great Britain and Northern Ireland,GBR,0,0,0,5,5
2015,Yemen,YEM,United Kingdom of Great Britain and Northern Ireland,GBR,55,15,58,5,133
2015,Zambia,ZMB,United Kingdom of Great Britain and Northern Ireland,GBR,0,5,26,0,31
2015,Zimbabwe,ZWE,United Kingdom of Great Britain and Northern Ireland,GBR,56,56,449,21,582
2015,Stateless,XXA,United Kingdom of Great Britain and Northern Ireland,GBR,401,0,123,29,553
2015,Afghanistan,AFG,Georgia,GEO,0,0,0,13,13
2015,Egypt,EGY,Georgia,GEO,0,5,13,10,28
2015,Armenia,ARM,Georgia,GEO,0,0,12,0,12
2015,Azerbaijan,AZE,Georgia,GEO,0,0,0,11,11
2015,Bangladesh,BGD,Georgia,GEO,0,0,14,14,28
2015,Palestinian,PSE,Georgia,GEO,0,5,0,0,5
2015,Cote d'Ivoire,CIV,Georgia,GEO,0,0,0,5,5
2015,India,IND,Georgia,GEO,0,0,5,0,5
2015,Iran (Islamic Rep. of),IRN,Georgia,GEO,5,0,36,5,46
2015,Iraq,IRQ,Georgia,GEO,60,397,59,473,989
2015,Kazakhstan,KAZ,Georgia,GEO,0,0,0,5,5
2015,Kuwait,KWT,Georgia,GEO,0,0,5,0,5
2015,Lebanon,LBN,Georgia,GEO,0,5,5,0,10
2015,Morocco,MAR,Georgia,GEO,0,0,5,0,5
2015,Nigeria,NGA,Georgia,GEO,0,0,5,0,5
2015,Pakistan,PAK,Georgia,GEO,0,0,0,5,5
2015,Russian Federation,RUS,Georgia,GEO,0,5,38,5,48
2015,Syrian Arab Rep.,SYR,Georgia,GEO,5,20,10,10,45
2015,Turkey,TUR,Georgia,GEO,0,0,26,5,31
2015,Ukraine,UKR,Georgia,GEO,0,444,66,215,725
2015,Central African Rep.,CAF,Ghana,GHA,74,0,0,0,74
2015,Cameroon,CMR,Ghana,GHA,0,0,5,0,5
2015,Dem. Rep. of the Congo,COD,Ghana,GHA,14,0,0,0,14
2015,Eritrea,ERI,Ghana,GHA,5,0,0,0,5
2015,Cote d'Ivoire,CIV,Ghana,GHA,5,920,0,760,1685
2015,Pakistan,PAK,Ghana,GHA,12,0,0,0,12
2015,Somalia,SOM,Ghana,GHA,15,0,0,0,15
2015,Sudan,SDN,Ghana,GHA,48,0,0,0,48
2015,Syrian Arab Rep.,SYR,Ghana,GHA,44,0,0,0,44
2015,Togo,TGO,Ghana,GHA,10,0,15,0,25
2015,Afghanistan,AFG,Greece,GRC,177,171,261,699,1308
2015,Albania,ALB,Greece,GRC,0,0,638,81,719
2015,Algeria,DZA,Greece,GRC,0,0,123,47,170
2015,Egypt,EGY,Greece,GRC,25,0,197,33,255
2015,Armenia,ARM,Greece,GRC,0,0,26,5,31
2015,Azerbaijan,AZE,Greece,GRC,0,0,5,0,5
2015,Bangladesh,BGD,Greece,GRC,19,0,642,102,763
2015,Burkina Faso,BFA,Greece,GRC,0,0,10,5,15
2015,China,CHN,Greece,GRC,5,0,60,10,75
2015,Cameroon,CMR,Greece,GRC,16,5,178,100,299
2015,Congo,COG,Greece,GRC,0,0,14,12,26
2015,Dem. Rep. of the Congo,COD,Greece,GRC,19,5,69,65,158
2015,Comoros,COM,Greece,GRC,0,0,11,0,11
2015,Dominican Rep.,DOM,Greece,GRC,0,0,17,28,45
2015,Eritrea,ERI,Greece,GRC,68,5,22,38,133
2015,Ethiopia,ETH,Greece,GRC,20,0,29,10,59
2015,Gabon,GAB,Greece,GRC,0,0,5,0,5
2015,Gambia,GMB,Greece,GRC,0,0,13,0,13
2015,Palestinian,PSE,Greece,GRC,59,0,5,14,78
2015,Georgia,GEO,Greece,GRC,0,0,315,28,343
2015,Ghana,GHA,Greece,GRC,0,0,58,10,68
2015,Guinea,GIN,Greece,GRC,0,0,17,5,22
2015,Cote d'Ivoire,CIV,Greece,GRC,5,0,40,28,73
2015,India,IND,Greece,GRC,5,0,58,5,68
2015,Indonesia,IDN,Greece,GRC,0,0,10,0,10
2015,Iran (Islamic Rep. of),IRN,Greece,GRC,52,0,84,133,269
2015,Iraq,IRQ,Greece,GRC,56,51,52,139,298
2015,Kenya,KEN,Greece,GRC,5,0,17,0,22
2015,Liberia,LBR,Greece,GRC,0,0,5,0,5
2015,Libya,LBY,Greece,GRC,5,5,0,10,20
2015,Lebanon,LBN,Greece,GRC,0,0,5,0,5
2015,Sri Lanka,LKA,Greece,GRC,0,0,10,11,21
2015,Madagascar,MDG,Greece,GRC,0,0,5,0,5
2015,Mauritania,MRT,Greece,GRC,5,0,13,0,18
2015,Rep. of Moldova,MDA,Greece,GRC,0,0,20,5,25
2015,Mali,MLI,Greece,GRC,0,0,10,18,28
2015,Morocco,MAR,Greece,GRC,0,0,63,31,94
2015,Myanmar,MMR,Greece,GRC,5,0,11,0,16
2015,Nepal,NPL,Greece,GRC,0,0,10,0,10
2015,Nigeria,NGA,Greece,GRC,22,0,313,60,395
2015,Pakistan,PAK,Greece,GRC,29,5,1488,344,1866
2015,Peru,PER,Greece,GRC,0,0,5,0,5
2015,Russian Federation,RUS,Greece,GRC,0,0,39,11,50
2015,Rwanda,RWA,Greece,GRC,0,0,12,0,12
2015,El Salvador,SLV,Greece,GRC,0,0,5,0,5
2015,Senegal,SEN,Greece,GRC,0,0,81,15,96
2015,Sierra Leone,SLE,Greece,GRC,5,0,20,14,39
2015,Somalia,SOM,Greece,GRC,16,28,26,52,122
2015,Sudan,SDN,Greece,GRC,59,13,82,66,220
2015,Syrian Arab Rep.,SYR,Greece,GRC,2781,5,5,278,3069
2015,United Rep. of Tanzania,TZA,Greece,GRC,5,0,12,0,17
2015,Togo,TGO,Greece,GRC,0,0,13,5,18
2015,Tunisia,TUN,Greece,GRC,0,0,22,10,32
2015,Turkey,TUR,Greece,GRC,14,0,5,10,29
2015,Uganda,UGA,Greece,GRC,5,0,11,5,21
2015,Ukraine,UKR,Greece,GRC,0,42,130,33,205
2015,Western Sahara,ESH,Greece,GRC,0,0,5,0,5
2015,Yemen,YEM,Greece,GRC,0,5,0,5,10
2015,Stateless,XXA,Greece,GRC,157,0,13,31,201
2015,Cuba,CUB,Guatemala,GTM,0,0,0,31,31
2015,Honduras,HND,Guatemala,GTM,12,0,0,10,22
2015,Nepal,NPL,Guatemala,GTM,0,0,0,19,19
2015,El Salvador,SLV,Guatemala,GTM,50,0,0,5,55
2015,United States of America,USA,Guatemala,GTM,0,0,0,5,5
2015,Central African Rep.,CAF,Guinea,GIN,12,0,0,0,12
2015,Cote d'Ivoire,CIV,Guinea,GIN,58,0,14,0,72
2015,Liberia,LBR,Guinea,GIN,17,0,5,0,22
2015,Nigeria,NGA,Guinea,GIN,5,0,0,0,5
2015,Sierra Leone,SLE,Guinea,GIN,19,0,0,0,19
2015,Afghanistan,AFG,Croatia,HRV,0,0,0,14,14
2015,Algeria,DZA,Croatia,HRV,0,0,20,10,30
2015,Egypt,EGY,Croatia,HRV,0,0,0,5,5
2015,Azerbaijan,AZE,Croatia,HRV,5,0,0,0,5
2015,Bangladesh,BGD,Croatia,HRV,0,0,5,0,5
2015,Bosnia and Herzegovina,BIH,Croatia,HRV,0,0,5,5,10
2015,Bulgaria,BGR,Croatia,HRV,0,0,5,0,5
2015,Cameroon,CMR,Croatia,HRV,0,0,5,0,5
2015,Gambia,GMB,Croatia,HRV,0,0,5,0,5
2015,India,IND,Croatia,HRV,0,0,0,5,5
2015,Iran (Islamic Rep. of),IRN,Croatia,HRV,0,0,0,10,10
2015,Iraq,IRQ,Croatia,HRV,5,0,0,0,5
2015,Morocco,MAR,Croatia,HRV,0,0,14,0,14
2015,Montenegro,MNE,Croatia,HRV,0,0,0,5,5
2015,Nigeria,NGA,Croatia,HRV,5,0,18,0,23
2015,Pakistan,PAK,Croatia,HRV,0,0,5,0,5
2015,Russian Federation,RUS,Croatia,HRV,0,0,12,0,12
2015,Serbia and Kosovo: S/RES/1244 (1999),SRB,Croatia,HRV,0,0,13,11,24
2015,Senegal,SEN,Croatia,HRV,0,0,5,0,5
2015,Somalia,SOM,Croatia,HRV,0,5,0,0,5
2015,Syrian Arab Rep.,SYR,Croatia,HRV,0,0,5,21,26
2015,Tunisia,TUN,Croatia,HRV,0,0,5,0,5
2015,Turkey,TUR,Croatia,HRV,12,0,0,0,12
2015,Ukraine,UKR,Croatia,HRV,0,0,13,0,13
2015,Albania,ALB,Iceland,ISL,0,0,54,24,78
2015,Algeria,DZA,Iceland,ISL,0,0,0,5,5
2015,Azerbaijan,AZE,Iceland,ISL,0,0,5,0,5
2015,Belarus,BLR,Iceland,ISL,0,0,0,10,10
2015,Eritrea,ERI,Iceland,ISL,5,0,0,0,5
2015,Georgia,GEO,Iceland,ISL,0,0,5,0,5
2015,Guinea,GIN,Iceland,ISL,0,0,5,0,5
2015,Iran (Islamic Rep. of),IRN,Iceland,ISL,5,0,0,0,5
2015,Iraq,IRQ,Iceland,ISL,0,0,0,12,12
2015,Libya,LBY,Iceland,ISL,5,0,0,0,5
2015,North Macedonia,MKD,Iceland,ISL,0,0,21,0,21
2015,Morocco,MAR,Iceland,ISL,0,0,0,5,5
2015,Nigeria,NGA,Iceland,ISL,0,0,5,5,10
2015,Pakistan,PAK,Iceland,ISL,0,0,0,5,5
2015,Russian Federation,RUS,Iceland,ISL,0,0,0,14,14
2015,Serbia and Kosovo: S/RES/1244 (1999),SRB,Iceland,ISL,0,0,0,12,12
2015,Somalia,SOM,Iceland,ISL,5,0,0,0,5
2015,Syrian Arab Rep.,SYR,Iceland,ISL,5,12,0,12,29
2015,Ukraine,UKR,Iceland,ISL,5,5,0,0,10
2015,United States of America,USA,Iceland,ISL,0,0,5,0,5
2015,Uzbekistan,UZB,Iceland,ISL,0,0,0,5,5
2015,Stateless,XXA,Iceland,ISL,5,0,0,5,10
2015,Afghanistan,AFG,Ireland,IRL,5,0,10,30,45
2015,Albania,ALB,Ireland,IRL,0,0,79,52,131
2015,Algeria,DZA,Ireland,IRL,0,0,37,23,60
2015,Egypt,EGY,Ireland,IRL,0,0,0,10,10
2015,Bangladesh,BGD,Ireland,IRL,0,0,43,70,113
2015,Botswana,BWA,Ireland,IRL,0,0,5,0,5
2015,China,CHN,Ireland,IRL,0,0,14,5,19
2015,Cameroon,CMR,Ireland,IRL,0,0,13,0,13
2015,Dem. Rep. of the Congo,COD,Ireland,IRL,10,0,31,5,46
2015,Eritrea,ERI,Ireland,IRL,5,0,0,0,5
2015,Palestinian,PSE,Ireland,IRL,5,0,5,0,10
2015,Georgia,GEO,Ireland,IRL,0,0,14,5,19
2015,Ghana,GHA,Ireland,IRL,5,0,5,0,10
2015,Guyana,GUY,Ireland,IRL,0,0,0,5,5
2015,India,IND,Ireland,IRL,0,0,10,19,29
2015,Iran (Islamic Rep. of),IRN,Ireland,IRL,10,0,0,5,15
2015,Iraq,IRQ,Ireland,IRL,18,0,0,10,28
2015,Kenya,KEN,Ireland,IRL,0,0,0,5,5
2015,Kuwait,KWT,Ireland,IRL,13,0,0,0,13
2015,Libya,LBY,Ireland,IRL,13,0,0,0,13
2015,Rep. of Moldova,MDA,Ireland,IRL,0,0,5,0,5
2015,Mexico,MEX,Ireland,IRL,0,0,5,0,5
2015,Malawi,MWI,Ireland,IRL,5,0,29,10,44
2015,Morocco,MAR,Ireland,IRL,0,0,0,5,5
2015,Mauritius,MUS,Ireland,IRL,0,0,12,0,12
2015,Nigeria,NGA,Ireland,IRL,0,0,87,37,124
2015,Pakistan,PAK,Ireland,IRL,5,0,140,370,515
2015,South Africa,ZAF,Ireland,IRL,5,0,29,5,39
2015,Somalia,SOM,Ireland,IRL,12,0,0,5,17
2015,Viet Nam,VNM,Ireland,IRL,0,0,5,0,5
2015,Sudan,SDN,Ireland,IRL,12,0,0,0,12
2015,Eswatini,SWZ,Ireland,IRL,0,0,0,5,5
2015,Syrian Arab Rep.,SYR,Ireland,IRL,23,0,0,10,33
2015,Ukraine,UKR,Ireland,IRL,0,0,25,13,38
2015,United States of America,USA,Ireland,IRL,0,0,0,5,5
2015,Venezuela (Bolivarian Republic of),VEN,Ireland,IRL,5,0,0,0,5
2015,Zimbabwe,ZWE,Ireland,IRL,5,0,38,11,54
2015,Afghanistan,AFG,Italy,ITA,305,2973,152,14,3444
2015,Albania,ALB,Italy,ITA,31,78,128,0,237
2015,Algeria,DZA,Italy,ITA,5,27,86,0,118
2015,Angola,AGO,Italy,ITA,0,5,0,0,5
2015,Egypt,EGY,Italy,ITA,27,225,441,0,693
2015,Argentina,ARG,Italy,ITA,0,0,5,0,5
2015,Armenia,ARM,Italy,ITA,13,36,24,0,73
2015,Azerbaijan,AZE,Italy,ITA,0,0,5,0,5
2015,Burundi,BDI,Italy,ITA,0,5,0,0,5
2015,Benin,BEN,Italy,ITA,5,45,63,0,113
2015,Bangladesh,BGD,Italy,ITA,102,1124,3785,0,5011
2015,Burkina Faso,BFA,Italy,ITA,10,155,227,0,392
2015,Belarus,BLR,Italy,ITA,0,5,0,0,5
2015,Brazil,BRA,Italy,ITA,0,11,5,0,16
2015,Bosnia and Herzegovina,BIH,Italy,ITA,0,103,48,0,151
2015,Central African Rep.,CAF,Italy,ITA,17,12,10,0,39
2015,Chad,TCD,Italy,ITA,0,50,25,0,75
2015,China,CHN,Italy,ITA,21,10,68,0,99
2015,Chile,CHL,Italy,ITA,0,5,0,0,5
2015,Cameroon,CMR,Italy,ITA,45,86,98,0,229
2015,Congo,COG,Italy,ITA,16,51,40,0,107
2015,Dem. Rep. of the Congo,COD,Italy,ITA,42,47,22,0,111
2015,Colombia,COL,Italy,ITA,16,43,10,0,69
2015,Cuba,CUB,Italy,ITA,5,18,13,0,36
2015,Dominican Rep.,DOM,Italy,ITA,0,5,5,0,10
2015,Ecuador,ECU,Italy,ITA,0,0,10,0,10
2015,Equatorial Guinea,GNQ,Italy,ITA,0,11,0,0,11
2015,Eritrea,ERI,Italy,ITA,260,267,132,0,659
2015,Ethiopia,ETH,Italy,ITA,49,82,21,0,152
2015,Gabon,GAB,Italy,ITA,0,11,0,0,11
2015,Gambia,GMB,Italy,ITA,247,2749,5730,0,8726
2015,Palestinian,PSE,Italy,ITA,81,32,79,0,192
2015,Georgia,GEO,Italy,ITA,5,52,57,0,114
2015,Ghana,GHA,Italy,ITA,43,758,1868,5,2674
2015,Guinea-Bissau,GNB,Italy,ITA,0,154,345,0,499
2015,Guinea,GIN,Italy,ITA,37,564,572,0,1173
2015,Honduras,HND,Italy,ITA,0,5,0,0,5
2015,Cote d'Ivoire,CIV,Italy,ITA,62,867,1337,10,2276
2015,India,IND,Italy,ITA,5,13,67,0,85
2015,Iran (Islamic Rep. of),IRN,Italy,ITA,130,97,120,0,347
2015,Iraq,IRQ,Italy,ITA,130,455,66,5,656
2015,Israel,ISR,Italy,ITA,5,0,0,0,5
2015,Jordan,JOR,Italy,ITA,5,5,16,0,26
2015,Kenya,KEN,Italy,ITA,5,12,14,0,31
2015,Kuwait,KWT,Italy,ITA,0,0,5,0,5
2015,Liberia,LBR,Italy,ITA,0,65,38,12,115
2015,Libya,LBY,Italy,ITA,34,131,43,0,208
2015,Lebanon,LBN,Italy,ITA,12,26,44,0,82
2015,Sri Lanka,LKA,Italy,ITA,18,50,44,0,112
2015,Madagascar,MDG,Italy,ITA,0,5,5,0,10
2015,Mauritania,MRT,Italy,ITA,15,37,69,0,121
2015,North Macedonia,MKD,Italy,ITA,0,5,5,0,10
2015,Rep. of Moldova,MDA,Italy,ITA,0,13,5,0,18
2015,Mali,MLI,Italy,ITA,61,2723,5814,0,8598
2015,Morocco,MAR,Italy,ITA,10,84,233,0,327
2015,Montenegro,MNE,Italy,ITA,0,10,0,0,10
2015,Mauritius,MUS,Italy,ITA,0,0,5,0,5
2015,Myanmar,MMR,Italy,ITA,5,5,0,0,10
2015,Namibia,NAM,Italy,ITA,0,5,0,0,5
2015,Nepal,NPL,Italy,ITA,0,27,18,0,45
2015,Niger,NER,Italy,ITA,5,59,78,0,142
2015,Nicaragua,NIC,Italy,ITA,0,5,5,0,10
2015,Nigeria,NGA,Italy,ITA,343,3400,8852,0,12595
2015,Pakistan,PAK,Italy,ITA,433,3063,4423,0,7919
2015,Peru,PER,Italy,ITA,0,12,5,0,17
2015,Philippines,PHL,Italy,ITA,0,0,10,0,10
2015,Russian Federation,RUS,Italy,ITA,10,29,22,0,61
2015,Rwanda,RWA,Italy,ITA,5,0,0,0,5
2015,El Salvador,SLV,Italy,ITA,5,40,30,0,75
2015,Serbia and Kosovo: S/RES/1244 (1999),SRB,Italy,ITA,16,98,105,0,219
2015,Senegal,SEN,Italy,ITA,89,1474,3867,0,5430
2015,Sierra Leone,SLE,Italy,ITA,5,112,71,0,188
2015,Somalia,SOM,Italy,ITA,198,876,73,0,1147
2015,Sudan,SDN,Italy,ITA,61,111,96,0,268
2015,South Sudan,SSD,Italy,ITA,0,5,0,0,5
2015,Eswatini,SWZ,Italy,ITA,5,0,0,0,5
2015,Syrian Arab Rep.,SYR,Italy,ITA,256,74,253,0,583
2015,United Rep. of Tanzania,TZA,Italy,ITA,13,0,0,0,13
2015,Thailand,THA,Italy,ITA,0,5,0,0,5
2015,Tajikistan,TJK,Italy,ITA,5,0,0,0,5
2015,Togo,TGO,Italy,ITA,17,133,139,0,289
2015,Tunisia,TUN,Italy,ITA,5,74,302,0,381
2015,Turkey,TUR,Italy,ITA,87,187,119,5,398
2015,Uganda,UGA,Italy,ITA,12,5,5,0,22
2015,Ukraine,UKR,Italy,ITA,79,1555,848,0,2482
2015,Venezuela (Bolivarian Republic of),VEN,Italy,ITA,0,16,14,0,30
2015,Yemen,YEM,Italy,ITA,10,5,0,0,15
2015,Zimbabwe,ZWE,Italy,ITA,0,5,0,0,5
2015,Afghanistan,AFG,Japan,JPN,5,0,5,0,10
2015,Egypt,EGY,Japan,JPN,0,0,5,0,5
2015,Bangladesh,BGD,Japan,JPN,0,0,124,0,124
2015,China,CHN,Japan,JPN,0,0,11,0,11
2015,Cameroon,CMR,Japan,JPN,0,0,43,0,43
2015,Dem. Rep. of the Congo,COD,Japan,JPN,0,0,5,0,5
2015,Ethiopia,ETH,Japan,JPN,0,0,16,0,16
2015,Gambia,GMB,Japan,JPN,0,0,5,0,5
2015,Ghana,GHA,Japan,JPN,0,0,66,0,66
2015,Guinea,GIN,Japan,JPN,0,0,13,0,13
2015,India,IND,Japan,JPN,0,0,84,0,84
2015,Indonesia,IDN,Japan,JPN,0,0,178,0,178
2015,Iran (Islamic Rep. of),IRN,Japan,JPN,0,0,49,0,49
2015,Kenya,KEN,Japan,JPN,0,0,5,0,5
2015,Liberia,LBR,Japan,JPN,0,0,5,0,5
2015,Sri Lanka,LKA,Japan,JPN,0,0,312,0,312
2015,Mali,MLI,Japan,JPN,0,0,5,0,5
2015,Myanmar,MMR,Japan,JPN,0,5,225,0,230
2015,Nepal,NPL,Japan,JPN,0,0,1007,0,1007
2015,Nigeria,NGA,Japan,JPN,0,0,69,0,69
2015,Pakistan,PAK,Japan,JPN,0,0,147,0,147
2015,Peru,PER,Japan,JPN,0,0,5,0,5
2015,Philippines,PHL,Japan,JPN,0,0,65,0,65
2015,Senegal,SEN,Japan,JPN,0,0,26,0,26
2015,Viet Nam,VNM,Japan,JPN,0,0,251,0,251
2015,Syrian Arab Rep.,SYR,Japan,JPN,5,5,0,0,10
2015,United Rep. of Tanzania,TZA,Japan,JPN,0,0,5,0,5
2015,Thailand,THA,Japan,JPN,0,0,140,0,140
2015,Tunisia,TUN,Japan,JPN,0,0,19,0,19
2015,Turkey,TUR,Japan,JPN,0,0,468,0,468
2015,Uganda,UGA,Japan,JPN,0,0,25,0,25
2015,Ukraine,UKR,Japan,JPN,0,5,0,0,5
2015,Afghanistan,AFG,Kazakhstan,KAZ,122,0,154,35,311
2015,Kyrgyzstan,KGZ,Kazakhstan,KAZ,0,0,0,5,5
2015,Syrian Arab Rep.,SYR,Kazakhstan,KAZ,5,0,10,0,15
2015,Ukraine,UKR,Kazakhstan,KAZ,0,0,16,0,16
2015,Afghanistan,AFG,Kyrgyzstan,KGZ,5,0,109,40,154
2015,Pakistan,PAK,Kyrgyzstan,KGZ,0,0,0,5,5
2015,Syrian Arab Rep.,SYR,Kyrgyzstan,KGZ,5,0,5,13,23
2015,Tajikistan,TJK,Kyrgyzstan,KGZ,0,0,5,0,5
2015,Turkmenistan,TKM,Kyrgyzstan,KGZ,0,0,0,5,5
2015,Ukraine,UKR,Kyrgyzstan,KGZ,11,0,0,16,27
2015,Albania,ALB,Liechtenstein,LIE,0,0,5,5,10
2015,Armenia,ARM,Liechtenstein,LIE,0,0,5,5,10
2015,Belarus,BLR,Liechtenstein,LIE,0,0,0,5,5
2015,Croatia,HRV,Liechtenstein,LIE,0,0,5,0,5
2015,Kyrgyzstan,KGZ,Liechtenstein,LIE,0,0,5,0,5
2015,North Macedonia,MKD,Liechtenstein,LIE,0,0,0,10,10
2015,Russian Federation,RUS,Liechtenstein,LIE,0,0,5,5,10
2015,Serbia and Kosovo: S/RES/1244 (1999),SRB,Liechtenstein,LIE,0,0,0,13,13
2015,Somalia,SOM,Liechtenstein,LIE,0,0,13,0,13
2015,Ukraine,UKR,Liechtenstein,LIE,0,0,0,10,10
2015,Afghanistan,AFG,Lithuania,LTU,0,14,0,48,62
2015,Armenia,ARM,Lithuania,LTU,0,0,0,5,5
2015,Azerbaijan,AZE,Lithuania,LTU,0,0,5,5,10
2015,Belarus,BLR,Lithuania,LTU,0,0,5,11,16
2015,Georgia,GEO,Lithuania,LTU,0,0,33,42,75
2015,India,IND,Lithuania,LTU,0,0,10,0,10
2015,Iraq,IRQ,Lithuania,LTU,0,22,0,5,27
2015,Kyrgyzstan,KGZ,Lithuania,LTU,0,0,5,0,5
2015,Russian Federation,RUS,Lithuania,LTU,10,5,5,21,41
2015,Viet Nam,VNM,Lithuania,LTU,0,0,5,5,10
2015,Syrian Arab Rep.,SYR,Lithuania,LTU,0,5,0,0,5
2015,Tajikistan,TJK,Lithuania,LTU,5,0,0,0,5
2015,Ukraine,UKR,Lithuania,LTU,0,26,26,21,73
2015,Afghanistan,AFG,Luxembourg,LUX,5,0,0,5,10
2015,Albania,ALB,Luxembourg,LUX,0,14,57,23,94
2015,Algeria,DZA,Luxembourg,LUX,0,0,5,32,37
2015,Egypt,EGY,Luxembourg,LUX,0,0,0,5,5
2015,Azerbaijan,AZE,Luxembourg,LUX,0,0,10,0,10
2015,Benin,BEN,Luxembourg,LUX,0,0,0,5,5
2015,Belarus,BLR,Luxembourg,LUX,0,0,0,5,5
2015,Bosnia and Herzegovina,BIH,Luxembourg,LUX,0,0,105,5,110
2015,Cameroon,CMR,Luxembourg,LUX,0,0,0,13,13
2015,Dem. Rep. of the Congo,COD,Luxembourg,LUX,5,0,5,5,15
2015,Eritrea,ERI,Luxembourg,LUX,29,0,0,12,41
2015,Ethiopia,ETH,Luxembourg,LUX,12,0,0,5,17
2015,Gambia,GMB,Luxembourg,LUX,0,0,5,5,10
2015,Palestinian,PSE,Luxembourg,LUX,11,0,0,0,11
2015,Georgia,GEO,Luxembourg,LUX,0,0,5,21,26
2015,Ghana,GHA,Luxembourg,LUX,0,0,0,5,5
2015,Guinea,GIN,Luxembourg,LUX,0,0,5,5,10
2015,Cote d'Ivoire,CIV,Luxembourg,LUX,0,0,5,0,5
2015,Iran (Islamic Rep. of),IRN,Luxembourg,LUX,11,0,0,5,16
2015,Iraq,IRQ,Luxembourg,LUX,16,5,0,49,70
2015,Liberia,LBR,Luxembourg,LUX,0,0,0,5,5
2015,Libya,LBY,Luxembourg,LUX,0,0,0,11,11
2015,Sri Lanka,LKA,Luxembourg,LUX,5,0,0,0,5
2015,North Macedonia,MKD,Luxembourg,LUX,0,0,24,0,24
2015,Mali,MLI,Luxembourg,LUX,0,0,0,5,5
2015,Morocco,MAR,Luxembourg,LUX,0,0,0,10,10
2015,Montenegro,MNE,Luxembourg,LUX,0,0,75,5,80
2015,Nigeria,NGA,Luxembourg,LUX,0,0,18,24,42
2015,Pakistan,PAK,Luxembourg,LUX,0,0,0,5,5
2015,Russian Federation,RUS,Luxembourg,LUX,0,0,0,16,16
2015,Serbia and Kosovo: S/RES/1244 (1999),SRB,Luxembourg,LUX,5,5,141,113,264
2015,Somalia,SOM,Luxembourg,LUX,5,0,0,10,15
2015,South Sudan,SSD,Luxembourg,LUX,0,0,0,5,5
2015,Syrian Arab Rep.,SYR,Luxembourg,LUX,80,0,0,20,100
2015,Togo,TGO,Luxembourg,LUX,0,0,5,0,5
2015,Tunisia,TUN,Luxembourg,LUX,0,0,14,19,33
2015,Turkey,TUR,Luxembourg,LUX,15,0,0,5,20
2015,Uganda,UGA,Luxembourg,LUX,0,0,0,5,5
2015,Ukraine,UKR,Luxembourg,LUX,0,0,5,26,31
2015,Stateless,XXA,Luxembourg,LUX,11,0,0,0,11
2015,Afghanistan,AFG,Latvia,LVA,13,0,0,0,13
2015,Armenia,ARM,Latvia,LVA,0,0,5,0,5
2015,Azerbaijan,AZE,Latvia,LVA,0,0,0,5,5
2015,Georgia,GEO,Latvia,LVA,0,0,18,87,105
2015,Iraq,IRQ,Latvia,LVA,0,0,5,21,26
2015,Sri Lanka,LKA,Latvia,LVA,0,0,5,0,5
2015,Russian Federation,RUS,Latvia,LVA,0,0,0,5,5
2015,Viet Nam,VNM,Latvia,LVA,0,0,64,24,88
2015,Syrian Arab Rep.,SYR,Latvia,LVA,0,15,0,5,20
2015,Ukraine,UKR,Latvia,LVA,0,0,37,55,92
2015,Afghanistan,AFG,Rep. of Moldova,MDA,5,0,0,11,16
2015,Armenia,ARM,Rep. of Moldova,MDA,0,0,5,0,5
2015,Iraq,IRQ,Rep. of Moldova,MDA,0,14,0,5,19
2015,Kyrgyzstan,KGZ,Rep. of Moldova,MDA,0,0,5,0,5
2015,Lebanon,LBN,Rep. of Moldova,MDA,0,0,5,0,5
2015,Sri Lanka,LKA,Rep. of Moldova,MDA,0,0,5,0,5
2015,Nigeria,NGA,Rep. of Moldova,MDA,0,0,5,0,5
2015,Russian Federation,RUS,Rep. of Moldova,MDA,0,0,5,0,5
2015,Syrian Arab Rep.,SYR,Rep. of Moldova,MDA,21,38,0,10,69
2015,Turkey,TUR,Rep. of Moldova,MDA,0,0,5,5,10
2015,Ukraine,UKR,Rep. of Moldova,MDA,0,93,29,50,172
2015,Yemen,YEM,Rep. of Moldova,MDA,0,5,0,0,5
2015,Cameroon,CMR,Mexico,MEX,5,0,0,0,5
2015,Colombia,COL,Mexico,MEX,10,0,11,5,26
2015,Cuba,CUB,Mexico,MEX,0,0,5,32,37
2015,Ecuador,ECU,Mexico,MEX,0,0,0,5,5
2015,Germany,DEU,Mexico,MEX,0,0,5,0,5
2015,Ghana,GHA,Mexico,MEX,0,0,0,5,5
2015,Guatemala,GTM,Mexico,MEX,28,5,35,34,102
2015,Haiti,HTI,Mexico,MEX,0,0,11,5,16
2015,Honduras,HND,Mexico,MEX,376,63,612,507,1558
2015,India,IND,Mexico,MEX,0,0,5,15,20
2015,Iraq,IRQ,Mexico,MEX,5,0,0,0,5
2015,Nepal,NPL,Mexico,MEX,0,0,0,5,5
2015,Nicaragua,NIC,Mexico,MEX,0,0,15,13,28
2015,Nigeria,NGA,Mexico,MEX,5,0,5,0,10
2015,Panama,PAN,Mexico,MEX,5,0,0,0,5
2015,Peru,PER,Mexico,MEX,0,0,5,0,5
2015,Russian Federation,RUS,Mexico,MEX,5,0,0,0,5
2015,El Salvador,SLV,Mexico,MEX,462,66,555,392,1475
2015,Syrian Arab Rep.,SYR,Mexico,MEX,5,0,0,0,5
2015,Turkey,TUR,Mexico,MEX,0,5,0,0,5
2015,Ukraine,UKR,Mexico,MEX,5,0,0,0,5
2015,United States of America,USA,Mexico,MEX,0,0,5,5,10
2015,Venezuela (Bolivarian Republic of),VEN,Mexico,MEX,18,10,24,5,57
2015,Burundi,BDI,Malawi,MWI,172,0,26,0,198
2015,Dem. Rep. of the Congo,COD,Malawi,MWI,3078,0,0,0,3078
2015,Rwanda,RWA,Malawi,MWI,89,0,77,10,176
2015,Somalia,SOM,Malawi,MWI,13,0,0,0,13
2015,Burundi,BDI,Mozambique,MOZ,0,0,0,473,473
2015,Congo,COG,Mozambique,MOZ,0,0,0,10,10
2015,Dem. Rep. of the Congo,COD,Mozambique,MOZ,0,0,0,1920,1920
2015,Ethiopia,ETH,Mozambique,MOZ,0,0,0,5,5
2015,Rwanda,RWA,Mozambique,MOZ,0,0,0,142,142
2015,Somalia,SOM,Mozambique,MOZ,0,0,0,266,266
2015,Algeria,DZA,Malta,MLT,0,0,5,5,10
2015,Egypt,EGY,Malta,MLT,0,13,10,5,28
2015,Bangladesh,BGD,Malta,MLT,5,0,0,0,5
2015,China,CHN,Malta,MLT,0,0,5,0,5
2015,Cameroon,CMR,Malta,MLT,0,0,5,0,5
2015,Comoros,COM,Malta,MLT,0,0,5,0,5
2015,Eritrea,ERI,Malta,MLT,0,51,0,0,51
2015,Ethiopia,ETH,Malta,MLT,5,16,0,0,21
2015,Gambia,GMB,Malta,MLT,5,5,13,5,28
2015,Palestinian,PSE,Malta,MLT,0,0,0,12,12
2015,Ghana,GHA,Malta,MLT,0,5,0,0,5
2015,Guinea-Bissau,GNB,Malta,MLT,0,0,12,0,12
2015,Guinea,GIN,Malta,MLT,0,0,5,0,5
2015,Cote d'Ivoire,CIV,Malta,MLT,0,5,13,0,18
2015,Iran (Islamic Rep. of),IRN,Malta,MLT,5,0,0,0,5
2015,Iraq,IRQ,Malta,MLT,5,0,0,0,5
2015,Libya,LBY,Malta,MLT,244,761,0,32,1037
2015,North Macedonia,MKD,Malta,MLT,0,0,12,0,12
2015,Mali,MLI,Malta,MLT,0,5,24,0,29
2015,Morocco,MAR,Malta,MLT,0,11,0,0,11
2015,Nepal,NPL,Malta,MLT,0,0,5,5,10
2015,Nigeria,NGA,Malta,MLT,5,5,11,5,26
2015,Serbia and Kosovo: S/RES/1244 (1999),SRB,Malta,MLT,0,0,5,0,5
2015,Senegal,SEN,Malta,MLT,0,0,0,28,28
2015,Somalia,SOM,Malta,MLT,5,53,0,5,63
2015,Sudan,SDN,Malta,MLT,0,0,5,0,5
2015,Syrian Arab Rep.,SYR,Malta,MLT,18,265,0,16,299
2015,Tunisia,TUN,Malta,MLT,0,0,11,0,11
2015,Ukraine,UKR,Malta,MLT,0,51,0,5,56
2015,Venezuela (Bolivarian Republic of),VEN,Malta,MLT,0,0,10,0,10
2015,Burundi,BDI,Namibia,NAM,18,0,0,0,18
2015,Cameroon,CMR,Namibia,NAM,0,0,0,5,5
2015,Dem. Rep. of the Congo,COD,Namibia,NAM,143,0,0,0,143
2015,Rwanda,RWA,Namibia,NAM,14,0,0,0,14
2015,Zimbabwe,ZWE,Namibia,NAM,5,0,0,0,5
2015,Afghanistan,AFG,Netherlands,NLD,211,0,183,41,435
2015,Albania,ALB,Netherlands,NLD,0,0,300,102,402
2015,Algeria,DZA,Netherlands,NLD,0,0,14,5,19
2015,Angola,AGO,Netherlands,NLD,0,0,5,0,5
2015,Egypt,EGY,Netherlands,NLD,16,0,39,10,65
2015,Armenia,ARM,Netherlands,NLD,5,0,74,16,95
2015,Azerbaijan,AZE,Netherlands,NLD,16,0,30,0,46
2015,Burundi,BDI,Netherlands,NLD,0,0,12,0,12
2015,Bangladesh,BGD,Netherlands,NLD,5,0,11,0,16
2015,Belarus,BLR,Netherlands,NLD,5,0,18,5,28
2015,Brazil,BRA,Netherlands,NLD,0,0,5,0,5
2015,Bosnia and Herzegovina,BIH,Netherlands,NLD,0,0,75,5,80
2015,Chad,TCD,Netherlands,NLD,0,0,5,0,5
2015,China,CHN,Netherlands,NLD,34,5,97,18,154
2015,Cameroon,CMR,Netherlands,NLD,0,0,15,5,20
2015,Congo,COG,Netherlands,NLD,10,0,24,5,39
2015,Colombia,COL,Netherlands,NLD,0,0,5,0,5
2015,Cuba,CUB,Netherlands,NLD,0,0,11,0,11
2015,Eritrea,ERI,Netherlands,NLD,4462,264,243,58,5027
2015,Ethiopia,ETH,Netherlands,NLD,26,0,51,5,82
2015,Gambia,GMB,Netherlands,NLD,5,0,22,0,27
2015,Palestinian,PSE,Netherlands,NLD,11,0,5,0,16
2015,Georgia,GEO,Netherlands,NLD,0,0,142,34,176
2015,Ghana,GHA,Netherlands,NLD,0,0,13,5,18
2015,Guinea,GIN,Netherlands,NLD,17,0,25,12,54
2015,Honduras,HND,Netherlands,NLD,0,0,5,0,5
2015,Cote d'Ivoire,CIV,Netherlands,NLD,0,0,14,0,14
2015,India,IND,Netherlands,NLD,0,0,5,5,10
2015,Indonesia,IDN,Netherlands,NLD,0,0,5,0,5
2015,Iran (Islamic Rep. of),IRN,Netherlands,NLD,205,5,147,66,423
2015,Iraq,IRQ,Netherlands,NLD,172,0,159,149,480
2015,Israel,ISR,Netherlands,NLD,0,0,0,5,5
2015,Jamaica,JAM,Netherlands,NLD,48,0,5,0,53
2015,Jordan,JOR,Netherlands,NLD,0,0,13,0,13
2015,Kazakhstan,KAZ,Netherlands,NLD,0,0,5,0,5
2015,Kenya,KEN,Netherlands,NLD,0,0,5,0,5
2015,Kyrgyzstan,KGZ,Netherlands,NLD,0,0,5,0,5
2015,Dem. People's Rep. of Korea,PRK,Netherlands,NLD,0,0,5,0,5
2015,Liberia,LBR,Netherlands,NLD,0,0,10,0,10
2015,Libya,LBY,Netherlands,NLD,17,0,30,15,62
2015,Lebanon,LBN,Netherlands,NLD,5,0,21,0,26
2015,Sri Lanka,LKA,Netherlands,NLD,16,0,26,5,47
2015,North Macedonia,MKD,Netherlands,NLD,0,0,59,12,71
2015,Rep. of Moldova,MDA,Netherlands,NLD,0,0,5,0,5
2015,Mexico,MEX,Netherlands,NLD,0,0,0,5,5
2015,Mali,MLI,Netherlands,NLD,0,0,13,0,13
2015,Mongolia,MNG,Netherlands,NLD,5,0,314,50,369
2015,Morocco,MAR,Netherlands,NLD,5,0,40,5,50
2015,Myanmar,MMR,Netherlands,NLD,20,0,10,0,30
2015,Nepal,NPL,Netherlands,NLD,0,0,25,5,30
2015,Niger,NER,Netherlands,NLD,0,0,5,0,5
2015,Nigeria,NGA,Netherlands,NLD,59,0,121,17,197
2015,Pakistan,PAK,Netherlands,NLD,52,0,86,18,156
2015,Philippines,PHL,Netherlands,NLD,0,0,5,0,5
2015,South Africa,ZAF,Netherlands,NLD,0,0,10,0,10
2015,Russian Federation,RUS,Netherlands,NLD,13,0,77,12,102
2015,Rwanda,RWA,Netherlands,NLD,0,0,10,0,10
2015,El Salvador,SLV,Netherlands,NLD,0,0,5,0,5
2015,Serbia and Kosovo: S/RES/1244 (1999),SRB,Netherlands,NLD,0,0,210,219,429
2015,Senegal,SEN,Netherlands,NLD,0,0,10,0,10
2015,Sierra Leone,SLE,Netherlands,NLD,12,0,12,10,34
2015,Somalia,SOM,Netherlands,NLD,55,5,71,19,150
2015,Viet Nam,VNM,Netherlands,NLD,0,0,31,10,41
2015,Sudan,SDN,Netherlands,NLD,108,10,43,12,173
2015,Syrian Arab Rep.,SYR,Netherlands,NLD,7601,114,577,231,8523
2015,United Rep. of Tanzania,TZA,Netherlands,NLD,0,0,10,0,10
2015,Tajikistan,TJK,Netherlands,NLD,0,0,0,12,12
2015,Togo,TGO,Netherlands,NLD,0,0,5,0,5
2015,Trinidad and Tobago,TTO,Netherlands,NLD,5,0,0,0,5
2015,Tunisia,TUN,Netherlands,NLD,0,0,10,5,15
2015,Turkey,TUR,Netherlands,NLD,5,0,23,5,33
2015,Uganda,UGA,Netherlands,NLD,42,0,34,0,76
2015,Ukraine,UKR,Netherlands,NLD,5,0,387,60,452
2015,United States of America,USA,Netherlands,NLD,0,0,18,0,18
2015,Uzbekistan,UZB,Netherlands,NLD,0,0,5,0,5
2015,Yemen,YEM,Netherlands,NLD,14,0,13,0,27
2015,Zimbabwe,ZWE,Netherlands,NLD,0,0,5,5,10
2015,Stateless,XXA,Netherlands,NLD,1725,5,284,43,2057
2015,Central African Rep.,CAF,Niger,NER,18,0,13,0,31
2015,Honduras,HND,Nicaragua,NIC,16,0,0,0,16
2015,El Salvador,SLV,Nicaragua,NIC,45,0,0,0,45
2015,Burundi,BDI,Nigeria,NGA,10,0,0,0,10
2015,Central African Rep.,CAF,Nigeria,NGA,67,0,35,39,141
2015,Chad,TCD,Nigeria,NGA,0,0,5,5,10
2015,Cameroon,CMR,Nigeria,NGA,5,0,0,5,10
2015,Dem. Rep. of the Congo,COD,Nigeria,NGA,18,0,45,195,258
2015,Eritrea,ERI,Nigeria,NGA,10,0,0,5,15
2015,Ghana,GHA,Nigeria,NGA,5,0,0,0,5
2015,Cote d'Ivoire,CIV,Nigeria,NGA,5,0,13,35,53
2015,Liberia,LBR,Nigeria,NGA,5,0,0,0,5
2015,Mali,MLI,Nigeria,NGA,20,0,5,193,218
2015,Sierra Leone,SLE,Nigeria,NGA,5,0,0,0,5
2015,Syrian Arab Rep.,SYR,Nigeria,NGA,21,0,0,0,21
2015,Togo,TGO,Nigeria,NGA,0,0,218,5,223
2015,Afghanistan,AFG,Norway,NOR,236,316,111,597,1260
2015,Albania,ALB,Norway,NOR,0,0,307,111,418
2015,Algeria,DZA,Norway,NOR,0,0,34,58,92
2015,Angola,AGO,Norway,NOR,0,0,5,0,5
2015,Egypt,EGY,Norway,NOR,0,0,46,60,106
2015,Armenia,ARM,Norway,NOR,0,0,16,5,21
2015,Azerbaijan,AZE,Norway,NOR,5,0,5,22,32
2015,Burundi,BDI,Norway,NOR,5,0,0,0,5
2015,Bangladesh,BGD,Norway,NOR,0,0,89,44,133
2015,Belarus,BLR,Norway,NOR,0,0,0,14,14
2015,Bosnia and Herzegovina,BIH,Norway,NOR,0,0,41,57,98
2015,Chad,TCD,Norway,NOR,0,0,0,5,5
2015,China,CHN,Norway,NOR,39,0,0,0,39
2015,Cameroon,CMR,Norway,NOR,0,0,0,14,14
2015,Congo,COG,Norway,NOR,5,0,0,0,5
2015,Dem. Rep. of the Congo,COD,Norway,NOR,0,5,0,0,5
2015,Djibouti,DJI,Norway,NOR,0,0,0,10,10
2015,Eritrea,ERI,Norway,NOR,2550,0,39,165,2754
2015,Ethiopia,ETH,Norway,NOR,202,0,62,48,312
2015,Gambia,GMB,Norway,NOR,0,0,10,11,21
2015,Georgia,GEO,Norway,NOR,0,0,16,5,21
2015,Ghana,GHA,Norway,NOR,0,0,0,12,12
2015,Greece,GRC,Norway,NOR,0,0,5,0,5
2015,Guinea,GIN,Norway,NOR,5,0,5,12,22
2015,Honduras,HND,Norway,NOR,5,0,0,0,5
2015,Croatia,HRV,Norway,NOR,0,0,0,5,5
2015,Cote d'Ivoire,CIV,Norway,NOR,0,0,0,5,5
2015,India,IND,Norway,NOR,0,0,10,13,23
2015,Iran (Islamic Rep. of),IRN,Norway,NOR,42,0,32,97,171
2015,Iraq,IRQ,Norway,NOR,20,5,50,281,356
2015,Jordan,JOR,Norway,NOR,0,0,5,10,15
2015,Kenya,KEN,Norway,NOR,0,0,0,5,5
2015,Liberia,LBR,Norway,NOR,0,0,0,5,5
2015,Libya,LBY,Norway,NOR,0,10,5,47,62
2015,Lebanon,LBN,Norway,NOR,0,0,13,44,57
2015,Sri Lanka,LKA,Norway,NOR,0,0,0,11,11
2015,Mauritania,MRT,Norway,NOR,0,0,0,5,5
2015,North Macedonia,MKD,Norway,NOR,0,0,33,10,43
2015,Mexico,MEX,Norway,NOR,0,0,5,0,5
2015,Mali,MLI,Norway,NOR,0,0,0,5,5
2015,Mongolia,MNG,Norway,NOR,0,0,15,5,20
2015,Morocco,MAR,Norway,NOR,5,0,50,71,126
2015,Montenegro,MNE,Norway,NOR,0,0,11,0,11
2015,Myanmar,MMR,Norway,NOR,5,0,0,0,5
2015,Nepal,NPL,Norway,NOR,0,0,5,26,31
2015,Niger,NER,Norway,NOR,0,0,0,5,5
2015,Nigeria,NGA,Norway,NOR,5,0,57,74,136
2015,Pakistan,PAK,Norway,NOR,5,0,59,133,197
2015,Romania,ROU,Norway,NOR,0,0,12,0,12
2015,Russian Federation,RUS,Norway,NOR,5,0,59,44,108
2015,Rwanda,RWA,Norway,NOR,0,0,0,5,5
2015,El Salvador,SLV,Norway,NOR,0,0,11,0,11
2015,Saudi Arabia,SAU,Norway,NOR,0,0,0,5,5
2015,Serbia and Kosovo: S/RES/1244 (1999),SRB,Norway,NOR,0,5,172,38,215
2015,Senegal,SEN,Norway,NOR,0,0,0,22,22
2015,Sierra Leone,SLE,Norway,NOR,0,0,0,5,5
2015,Somalia,SOM,Norway,NOR,139,15,185,97,436
2015,Viet Nam,VNM,Norway,NOR,0,0,5,14,19
2015,Sudan,SDN,Norway,NOR,375,5,58,49,487
2015,Sweden,SWE,Norway,NOR,0,0,0,5,5
2015,Syrian Arab Rep.,SYR,Norway,NOR,1355,189,5,659,2208
2015,Tajikistan,TJK,Norway,NOR,0,0,5,5,10
2015,Tunisia,TUN,Norway,NOR,0,0,13,34,47
2015,Turkey,TUR,Norway,NOR,10,5,41,25,81
2015,Uganda,UGA,Norway,NOR,10,0,30,5,45
2015,Ukraine,UKR,Norway,NOR,0,0,53,35,88
2015,United States of America,USA,Norway,NOR,0,0,0,5,5
2015,Uzbekistan,UZB,Norway,NOR,12,0,5,12,29
2015,Yemen,YEM,Norway,NOR,0,5,5,11,21
2015,Stateless,XXA,Norway,NOR,313,110,58,97,578
2015,Afghanistan,AFG,Nauru,NRU,38,0,12,0,50
2015,Bangladesh,BGD,Nauru,NRU,5,0,29,0,34
2015,India,IND,Nauru,NRU,5,0,12,0,17
2015,Indonesia,IDN,Nauru,NRU,5,0,0,0,5
2015,Iran (Islamic Rep. of),IRN,Nauru,NRU,85,0,57,0,142
2015,Iraq,IRQ,Nauru,NRU,29,0,0,0,29
2015,Sri Lanka,LKA,Nauru,NRU,31,0,85,0,116
2015,Myanmar,MMR,Nauru,NRU,14,0,0,0,14
2015,Nepal,NPL,Nauru,NRU,0,0,10,0,10
2015,Pakistan,PAK,Nauru,NRU,34,0,25,0,59
2015,Somalia,SOM,Nauru,NRU,26,0,0,0,26
2015,Syrian Arab Rep.,SYR,Nauru,NRU,5,0,0,0,5
2015,Stateless,XXA,Nauru,NRU,118,0,5,0,123
2015,Colombia,COL,Panama,PAN,42,0,14,158,214
2015,Cuba,CUB,Panama,PAN,0,0,0,15,15
2015,Dominican Rep.,DOM,Panama,PAN,0,0,0,10,10
2015,Nicaragua,NIC,Panama,PAN,0,0,0,14,14
2015,El Salvador,SLV,Panama,PAN,0,0,0,5,5
2015,Venezuela (Bolivarian Republic of),VEN,Panama,PAN,0,0,0,27,27
2015,Liberia,LBR,Paraguay,PRY,0,0,5,0,5
2015,Syrian Arab Rep.,SYR,Paraguay,PRY,27,0,10,0,37
2015,Bangladesh,BGD,Peru,PER,5,0,14,0,19
2015,Colombia,COL,Peru,PER,59,0,89,0,148
2015,Cuba,CUB,Peru,PER,24,0,70,0,94
2015,Dominican Rep.,DOM,Peru,PER,5,0,25,0,30
2015,Ecuador,ECU,Peru,PER,0,0,5,0,5
2015,Palestinian,PSE,Peru,PER,5,0,0,0,5
2015,Haiti,HTI,Peru,PER,5,0,0,0,5
2015,India,IND,Peru,PER,0,0,5,0,5
2015,Nigeria,NGA,Peru,PER,5,0,5,0,10
2015,Senegal,SEN,Peru,PER,0,0,5,0,5
2015,Syrian Arab Rep.,SYR,Peru,PER,10,0,0,0,10
2015,Ukraine,UKR,Peru,PER,11,0,0,0,11
2015,Venezuela (Bolivarian Republic of),VEN,Peru,PER,71,0,51,0,122
2015,Palestinian,PSE,Philippines,PHL,0,0,0,5,5
2015,Iran (Islamic Rep. of),IRN,Philippines,PHL,5,0,0,0,5
2015,Iraq,IRQ,Philippines,PHL,5,0,0,0,5
2015,Pakistan,PAK,Philippines,PHL,10,0,0,5,15
2015,Rwanda,RWA,Philippines,PHL,5,0,0,0,5
2015,Somalia,SOM,Philippines,PHL,5,0,0,0,5
2015,Viet Nam,VNM,Philippines,PHL,5,0,0,0,5
2015,Syrian Arab Rep.,SYR,Philippines,PHL,17,0,0,0,17
2015,Afghanistan,AFG,Papua New Guinea,PNG,49,0,0,0,49
2015,Bangladesh,BGD,Papua New Guinea,PNG,5,0,5,0,10
2015,Iran (Islamic Rep. of),IRN,Papua New Guinea,PNG,33,0,10,0,43
2015,Iraq,IRQ,Papua New Guinea,PNG,26,0,0,0,26
2015,Sri Lanka,LKA,Papua New Guinea,PNG,5,0,0,0,5
2015,Pakistan,PAK,Papua New Guinea,PNG,34,0,0,0,34
2015,Somalia,SOM,Papua New Guinea,PNG,25,0,0,0,25
2015,Sudan,SDN,Papua New Guinea,PNG,67,0,0,0,67
2015,Stateless,XXA,Papua New Guinea,PNG,62,0,0,0,62
2015,Afghanistan,AFG,Poland,POL,10,5,5,11,31
2015,Algeria,DZA,Poland,POL,0,0,0,5,5
2015,Egypt,EGY,Poland,POL,16,0,0,5,21
2015,Armenia,ARM,Poland,POL,0,0,43,147,190
2015,Azerbaijan,AZE,Poland,POL,0,0,5,10,15
2015,Bangladesh,BGD,Poland,POL,0,0,0,11,11
2015,Belarus,BLR,Poland,POL,15,0,18,13,46
2015,China,CHN,Poland,POL,0,0,0,11,11
2015,Cuba,CUB,Poland,POL,10,0,0,0,10
2015,Eritrea,ERI,Poland,POL,0,11,0,0,11
2015,Palestinian,PSE,Poland,POL,0,0,0,5,5
2015,Georgia,GEO,Poland,POL,0,0,121,348,469
2015,Ghana,GHA,Poland,POL,0,0,0,5,5
2015,India,IND,Poland,POL,0,0,5,0,5
2015,Iran (Islamic Rep. of),IRN,Poland,POL,5,0,0,14,19
2015,Iraq,IRQ,Poland,POL,25,24,0,19,68
2015,Jordan,JOR,Poland,POL,0,0,5,0,5
2015,Kazakhstan,KAZ,Poland,POL,0,0,25,17,42
2015,Kyrgyzstan,KGZ,Poland,POL,5,0,90,87,182
2015,Libya,LBY,Poland,POL,0,5,0,5,10
2015,Lebanon,LBN,Poland,POL,0,0,5,0,5
2015,Mongolia,MNG,Poland,POL,0,0,5,0,5
2015,Nepal,NPL,Poland,POL,0,0,0,5,5
2015,Nigeria,NGA,Poland,POL,0,0,5,0,5
2015,Pakistan,PAK,Poland,POL,0,0,10,18,28
2015,Russian Federation,RUS,Poland,POL,21,104,670,6566,7361
2015,Rwanda,RWA,Poland,POL,0,0,0,5,5
2015,Somalia,SOM,Poland,POL,0,5,0,0,5
2015,Viet Nam,VNM,Poland,POL,0,0,28,14,42
2015,Syrian Arab Rep.,SYR,Poland,POL,203,5,0,89,297
2015,Tajikistan,TJK,Poland,POL,0,0,18,499,517
2015,Turkmenistan,TKM,Poland,POL,10,0,5,0,15
2015,Tunisia,TUN,Poland,POL,0,0,5,0,5
2015,Turkey,TUR,Poland,POL,0,0,5,0,5
2015,Ukraine,UKR,Poland,POL,0,5,1776,766,2547
2015,Uzbekistan,UZB,Poland,POL,0,0,16,13,29
2015,Yemen,YEM,Poland,POL,0,5,0,5,10
2015,Stateless,XXA,Poland,POL,21,0,5,34,60
2015,Afghanistan,AFG,Portugal,PRT,0,0,0,5,5
2015,Algeria,DZA,Portugal,PRT,0,0,0,5,5
2015,Angola,AGO,Portugal,PRT,0,0,0,5,5
2015,Bangladesh,BGD,Portugal,PRT,0,0,0,5,5
2015,Brazil,BRA,Portugal,PRT,0,0,0,5,5
2015,Cameroon,CMR,Portugal,PRT,5,0,0,5,10
2015,Congo,COG,Portugal,PRT,0,0,0,10,10
2015,Dem. Rep. of the Congo,COD,Portugal,PRT,0,5,0,10,15
2015,Gambia,GMB,Portugal,PRT,0,0,0,5,5
2015,Ghana,GHA,Portugal,PRT,0,0,0,5,5
2015,Guinea-Bissau,GNB,Portugal,PRT,0,0,0,5,5
2015,Guinea,GIN,Portugal,PRT,0,5,14,19,38
2015,Cote d'Ivoire,CIV,Portugal,PRT,0,5,0,14,19
2015,Iran (Islamic Rep. of),IRN,Portugal,PRT,5,0,0,5,10
2015,Libya,LBY,Portugal,PRT,5,0,0,0,5
2015,Sri Lanka,LKA,Portugal,PRT,0,5,0,0,5
2015,North Macedonia,MKD,Portugal,PRT,0,0,0,5,5
2015,Mali,MLI,Portugal,PRT,0,0,5,79,84
2015,Morocco,MAR,Portugal,PRT,5,0,0,21,26
2015,Nigeria,NGA,Portugal,PRT,0,5,0,0,5
2015,Pakistan,PAK,Portugal,PRT,0,5,0,24,29
2015,Russian Federation,RUS,Portugal,PRT,0,0,0,5,5
2015,Senegal,SEN,Portugal,PRT,0,0,0,10,10
2015,Sierra Leone,SLE,Portugal,PRT,10,0,0,10,20
2015,Somalia,SOM,Portugal,PRT,0,5,0,0,5
2015,Syrian Arab Rep.,SYR,Portugal,PRT,0,5,0,5,10
2015,Togo,TGO,Portugal,PRT,0,0,0,5,5
2015,Ukraine,UKR,Portugal,PRT,0,118,0,166,284
2015,Afghanistan,AFG,Romania,ROU,11,5,86,0,102
2015,Egypt,EGY,Romania,ROU,0,0,12,0,12
2015,Bangladesh,BGD,Romania,ROU,0,0,5,5,10
2015,Brazil,BRA,Romania,ROU,0,0,5,0,5
2015,Central African Rep.,CAF,Romania,ROU,5,0,0,0,5
2015,China,CHN,Romania,ROU,0,0,12,10,22
2015,Cameroon,CMR,Romania,ROU,0,0,5,5,10
2015,Congo,COG,Romania,ROU,0,5,0,0,5
2015,Dem. Rep. of the Congo,COD,Romania,ROU,0,0,5,0,5
2015,Cuba,CUB,Romania,ROU,0,0,0,5,5
2015,Ethiopia,ETH,Romania,ROU,0,0,5,0,5
2015,France,FRA,Romania,ROU,0,0,5,0,5
2015,Palestinian,PSE,Romania,ROU,0,0,13,0,13
2015,Georgia,GEO,Romania,ROU,0,0,16,0,16
2015,Guinea,GIN,Romania,ROU,0,0,5,0,5
2015,India,IND,Romania,ROU,0,0,5,0,5
2015,Iran (Islamic Rep. of),IRN,Romania,ROU,5,0,29,0,34
2015,Iraq,IRQ,Romania,ROU,39,22,141,11,213
2015,Israel,ISR,Romania,ROU,0,0,5,0,5
2015,Libya,LBY,Romania,ROU,0,5,0,0,5
2015,Lebanon,LBN,Romania,ROU,0,0,0,5,5
2015,Sri Lanka,LKA,Romania,ROU,0,0,13,0,13
2015,Rep. of Moldova,MDA,Romania,ROU,0,0,13,5,18
2015,Morocco,MAR,Romania,ROU,0,0,5,0,5
2015,Nigeria,NGA,Romania,ROU,0,0,11,5,16
2015,Pakistan,PAK,Romania,ROU,0,0,33,5,38
2015,Philippines,PHL,Romania,ROU,0,0,23,10,33
2015,Serbia and Kosovo: S/RES/1244 (1999),SRB,Romania,ROU,0,0,0,5,5
2015,Somalia,SOM,Romania,ROU,5,0,0,0,5
2015,Viet Nam,VNM,Romania,ROU,0,0,12,0,12
2015,Sudan,SDN,Romania,ROU,0,0,5,0,5
2015,Syrian Arab Rep.,SYR,Romania,ROU,144,194,228,10,576
2015,Tunisia,TUN,Romania,ROU,0,0,0,12,12
2015,Turkey,TUR,Romania,ROU,0,0,39,10,49
2015,Ukraine,UKR,Romania,ROU,18,5,17,5,45
2015,Yemen,YEM,Romania,ROU,0,0,5,0,5
2015,Stateless,XXA,Romania,ROU,11,5,0,0,16
2015,Algeria,DZA,South Africa,ZAF,0,0,82,0,82
2015,Egypt,EGY,South Africa,ZAF,0,0,168,0,168
2015,Burundi,BDI,South Africa,ZAF,5,0,964,0,969
2015,Benin,BEN,South Africa,ZAF,0,0,46,0,46
2015,Bangladesh,BGD,South Africa,ZAF,0,0,4084,0,4084
2015,Burkina Faso,BFA,South Africa,ZAF,0,0,42,0,42
2015,Botswana,BWA,South Africa,ZAF,0,0,10,0,10
2015,Bulgaria,BGR,South Africa,ZAF,0,0,5,0,5
2015,Chad,TCD,South Africa,ZAF,0,0,13,0,13
2015,China,CHN,South Africa,ZAF,0,0,677,0,677
2015,Cameroon,CMR,South Africa,ZAF,0,0,530,0,530
2015,Congo,COG,South Africa,ZAF,191,0,424,0,615
2015,Dem. Rep. of the Congo,COD,South Africa,ZAF,614,0,4417,0,5031
2015,Comoros,COM,South Africa,ZAF,0,0,5,0,5
2015,Eritrea,ERI,South Africa,ZAF,44,0,268,0,312
2015,Ethiopia,ETH,South Africa,ZAF,1001,0,8306,0,9307
2015,Gabon,GAB,South Africa,ZAF,0,0,11,0,11
2015,Gambia,GMB,South Africa,ZAF,0,0,10,0,10
2015,Palestinian,PSE,South Africa,ZAF,0,0,15,0,15
2015,Ghana,GHA,South Africa,ZAF,0,0,1810,0,1810
2015,Guinea-Bissau,GNB,South Africa,ZAF,0,0,5,0,5
2015,Guinea,GIN,South Africa,ZAF,0,0,21,0,21
2015,Cote d'Ivoire,CIV,South Africa,ZAF,0,0,54,0,54
2015,India,IND,South Africa,ZAF,0,0,2166,0,2166
2015,Jamaica,JAM,South Africa,ZAF,0,0,5,0,5
2015,Jordan,JOR,South Africa,ZAF,0,0,5,0,5
2015,Kenya,KEN,South Africa,ZAF,0,0,234,0,234
2015,Liberia,LBR,South Africa,ZAF,0,0,5,0,5
2015,Lesotho,LSO,South Africa,ZAF,0,0,478,0,478
2015,Sri Lanka,LKA,South Africa,ZAF,0,0,12,0,12
2015,Mali,MLI,South Africa,ZAF,0,0,21,0,21
2015,Malawi,MWI,South Africa,ZAF,0,0,2378,0,2378
2015,Morocco,MAR,South Africa,ZAF,0,0,10,0,10
2015,Mozambique,MOZ,South Africa,ZAF,0,0,931,0,931
2015,Mauritius,MUS,South Africa,ZAF,0,0,5,0,5
2015,Nepal,NPL,South Africa,ZAF,0,0,53,0,53
2015,Niger,NER,South Africa,ZAF,0,0,51,0,51
2015,Nigeria,NGA,South Africa,ZAF,0,0,6592,0,6592
2015,Pakistan,PAK,South Africa,ZAF,0,0,2768,0,2768
2015,Rwanda,RWA,South Africa,ZAF,5,0,110,0,115
2015,Senegal,SEN,South Africa,ZAF,0,0,252,0,252
2015,Sierra Leone,SLE,South Africa,ZAF,0,0,5,0,5
2015,Somalia,SOM,South Africa,ZAF,618,0,1112,0,1730
2015,Sudan,SDN,South Africa,ZAF,0,0,19,0,19
2015,Eswatini,SWZ,South Africa,ZAF,0,0,28,0,28
2015,Syrian Arab Rep.,SYR,South Africa,ZAF,5,0,5,0,10
2015,United Rep. of Tanzania,TZA,South Africa,ZAF,0,0,527,0,527
2015,Thailand,THA,South Africa,ZAF,0,0,29,0,29
2015,Togo,TGO,South Africa,ZAF,0,0,14,0,14
2015,Turkey,TUR,South Africa,ZAF,5,0,0,0,5
2015,Uganda,UGA,South Africa,ZAF,5,0,997,0,1002
2015,Ukraine,UKR,South Africa,ZAF,0,0,5,0,5
2015,Zambia,ZMB,South Africa,ZAF,0,0,134,0,134
2015,Zimbabwe,ZWE,South Africa,ZAF,5,0,17201,0,17206
2015,Afghanistan,AFG,Russian Federation,RUS,15,0,313,0,328
2015,Egypt,EGY,Russian Federation,RUS,0,0,14,0,14
2015,Armenia,ARM,Russian Federation,RUS,0,0,5,0,5
2015,Azerbaijan,AZE,Russian Federation,RUS,0,0,5,0,5
2015,Belarus,BLR,Russian Federation,RUS,0,0,11,0,11
2015,Dem. Rep. of the Congo,COD,Russian Federation,RUS,0,0,5,0,5
2015,Estonia,EST,Russian Federation,RUS,0,0,5,0,5
2015,Palestinian,PSE,Russian Federation,RUS,0,0,10,0,10
2015,Georgia,GEO,Russian Federation,RUS,0,0,66,0,66
2015,Cote d'Ivoire,CIV,Russian Federation,RUS,0,0,5,0,5
2015,Iran (Islamic Rep. of),IRN,Russian Federation,RUS,0,0,5,0,5
2015,Iraq,IRQ,Russian Federation,RUS,0,0,14,0,14
2015,Kazakhstan,KAZ,Russian Federation,RUS,0,0,5,0,5
2015,Kyrgyzstan,KGZ,Russian Federation,RUS,0,0,21,0,21
2015,Dem. People's Rep. of Korea,PRK,Russian Federation,RUS,0,0,19,0,19
2015,Lebanon,LBN,Russian Federation,RUS,0,0,5,0,5
2015,Lithuania,LTU,Russian Federation,RUS,0,0,5,0,5
2015,Rep. of Moldova,MDA,Russian Federation,RUS,5,0,12,0,17
2015,Nigeria,NGA,Russian Federation,RUS,0,0,5,0,5
2015,Pakistan,PAK,Russian Federation,RUS,0,0,5,0,5
2015,Sudan,SDN,Russian Federation,RUS,0,0,5,0,5
2015,Syrian Arab Rep.,SYR,Russian Federation,RUS,0,0,391,0,391
2015,Tajikistan,TJK,Russian Federation,RUS,0,0,26,0,26
2015,Turkmenistan,TKM,Russian Federation,RUS,0,0,5,0,5
2015,Ukraine,UKR,Russian Federation,RUS,84,0,1790,0,1874
2015,United States of America,USA,Russian Federation,RUS,0,0,5,0,5
2015,Uzbekistan,UZB,Russian Federation,RUS,0,0,38,0,38
2015,Yemen,YEM,Russian Federation,RUS,0,0,14,0,14
2015,Stateless,XXA,Russian Federation,RUS,0,0,5,0,5
2015,Burundi,BDI,Rwanda,RWA,5,0,0,0,5
2015,Dem. Rep. of the Congo,COD,Rwanda,RWA,44,0,0,0,44
2015,Honduras,HND,El Salvador,SLV,5,0,0,0,5
2015,Iraq,IRQ,El Salvador,SLV,5,0,0,0,5
2015,Syrian Arab Rep.,SYR,El Salvador,SLV,5,0,0,5,10
2015,Afghanistan,AFG,Serbia and Kosovo: S/RES/1244 (1999),SRB,0,0,0,63,63
2015,Algeria,DZA,Serbia and Kosovo: S/RES/1244 (1999),SRB,0,0,0,5,5
2015,Cameroon,CMR,Serbia and Kosovo: S/RES/1244 (1999),SRB,0,0,0,5,5
2015,Congo,COG,Serbia and Kosovo: S/RES/1244 (1999),SRB,0,0,0,5,5
2015,Eritrea,ERI,Serbia and Kosovo: S/RES/1244 (1999),SRB,0,0,0,74,74
2015,Palestinian,PSE,Serbia and Kosovo: S/RES/1244 (1999),SRB,0,0,0,21,21
2015,Ghana,GHA,Serbia and Kosovo: S/RES/1244 (1999),SRB,0,0,0,10,10
2015,Cote d'Ivoire,CIV,Serbia and Kosovo: S/RES/1244 (1999),SRB,0,0,0,5,5
2015,Iran (Islamic Rep. of),IRN,Serbia and Kosovo: S/RES/1244 (1999),SRB,0,0,0,5,5
2015,Iraq,IRQ,Serbia and Kosovo: S/RES/1244 (1999),SRB,5,0,0,12,17
2015,Libya,LBY,Serbia and Kosovo: S/RES/1244 (1999),SRB,0,10,0,19,29
2015,North Macedonia,MKD,Serbia and Kosovo: S/RES/1244 (1999),SRB,0,0,0,5,5
2015,Mali,MLI,Serbia and Kosovo: S/RES/1244 (1999),SRB,0,0,0,10,10
2015,Nigeria,NGA,Serbia and Kosovo: S/RES/1244 (1999),SRB,0,0,0,5,5
2015,Russian Federation,RUS,Serbia and Kosovo: S/RES/1244 (1999),SRB,0,0,0,10,10
2015,Senegal,SEN,Serbia and Kosovo: S/RES/1244 (1999),SRB,0,0,0,5,5
2015,Somalia,SOM,Serbia and Kosovo: S/RES/1244 (1999),SRB,0,0,0,127,127
2015,Sudan,SDN,Serbia and Kosovo: S/RES/1244 (1999),SRB,0,0,0,52,52
2015,Syrian Arab Rep.,SYR,Serbia and Kosovo: S/RES/1244 (1999),SRB,5,5,0,473,483
2015,Uganda,UGA,Serbia and Kosovo: S/RES/1244 (1999),SRB,0,0,0,5,5
2015,Ukraine,UKR,Serbia and Kosovo: S/RES/1244 (1999),SRB,12,0,0,0,12
2015,Yemen,YEM,Serbia and Kosovo: S/RES/1244 (1999),SRB,0,0,0,16,16
2015,Afghanistan,AFG,Spain,ESP,32,16,5,0,53
2015,Albania,ALB,Spain,ESP,0,0,10,0,10
2015,Algeria,DZA,Spain,ESP,0,0,170,0,170
2015,Angola,AGO,Spain,ESP,0,0,5,0,5
2015,Egypt,EGY,Spain,ESP,0,0,35,0,35
2015,Armenia,ARM,Spain,ESP,0,0,11,0,11
2015,Benin,BEN,Spain,ESP,0,0,5,0,5
2015,Bangladesh,BGD,Spain,ESP,0,0,5,0,5
2015,Burkina Faso,BFA,Spain,ESP,0,0,5,0,5
2015,Belarus,BLR,Spain,ESP,0,0,5,0,5
2015,Bolivia (Plurinational State of),BOL,Spain,ESP,0,0,5,0,5
2015,Chad,TCD,Spain,ESP,0,0,5,0,5
2015,China,CHN,Spain,ESP,0,0,5,0,5
2015,Cameroon,CMR,Spain,ESP,0,0,50,0,50
2015,Dem. Rep. of the Congo,COD,Spain,ESP,0,0,28,0,28
2015,Colombia,COL,Spain,ESP,0,0,29,0,29
2015,Cuba,CUB,Spain,ESP,0,5,24,0,29
2015,Eritrea,ERI,Spain,ESP,5,0,0,0,5
2015,Ethiopia,ETH,Spain,ESP,0,5,0,0,5
2015,Gambia,GMB,Spain,ESP,0,0,12,0,12
2015,Palestinian,PSE,Spain,ESP,30,15,5,0,50
2015,Georgia,GEO,Spain,ESP,0,0,10,0,10
2015,Ghana,GHA,Spain,ESP,0,0,5,0,5
2015,Guinea-Bissau,GNB,Spain,ESP,0,0,11,0,11
2015,Guinea,GIN,Spain,ESP,0,0,31,0,31
2015,Honduras,HND,Spain,ESP,5,0,20,0,25
2015,Cote d'Ivoire,CIV,Spain,ESP,5,12,66,0,83
2015,Iran (Islamic Rep. of),IRN,Spain,ESP,5,0,11,0,16
2015,Iraq,IRQ,Spain,ESP,5,0,0,0,5
2015,Kazakhstan,KAZ,Spain,ESP,0,0,5,0,5
2015,Liberia,LBR,Spain,ESP,0,0,5,0,5
2015,Sri Lanka,LKA,Spain,ESP,5,0,23,0,28
2015,Mexico,MEX,Spain,ESP,0,0,5,0,5
2015,Mali,MLI,Spain,ESP,0,0,207,0,207
2015,Morocco,MAR,Spain,ESP,15,0,47,0,62
2015,Nigeria,NGA,Spain,ESP,0,0,43,0,43
2015,Pakistan,PAK,Spain,ESP,56,5,37,0,98
2015,Peru,PER,Spain,ESP,0,0,5,0,5
2015,Russian Federation,RUS,Spain,ESP,12,0,22,0,34
2015,El Salvador,SLV,Spain,ESP,0,0,16,0,16
2015,Serbia and Kosovo: S/RES/1244 (1999),SRB,Spain,ESP,0,0,5,0,5
2015,Senegal,SEN,Spain,ESP,0,0,16,0,16
2015,Singapore,SGP,Spain,ESP,0,0,5,0,5
2015,Sierra Leone,SLE,Spain,ESP,0,0,5,0,5
2015,Somalia,SOM,Spain,ESP,10,101,53,0,164
2015,Sudan,SDN,Spain,ESP,5,0,5,0,10
2015,Syrian Arab Rep.,SYR,Spain,ESP,17,639,5,0,661
2015,Ukraine,UKR,Spain,ESP,0,0,5,0,5
2015,Western Sahara,ESH,Spain,ESP,5,0,24,0,29
2015,Dem. Rep. of the Congo,COD,Sudan,SDN,0,0,0,5,5
2015,Eritrea,ERI,Sudan,SDN,4164,10,19,36,4229
2015,Ethiopia,ETH,Sudan,SDN,73,10,39,20,142
2015,Somalia,SOM,Sudan,SDN,13,0,0,0,13
2015,Syrian Arab Rep.,SYR,Sudan,SDN,0,5,0,0,5
2015,Afghanistan,AFG,Slovakia,SVK,0,5,10,50,65
2015,Cameroon,CMR,Slovakia,SVK,0,0,5,0,5
2015,Dem. Rep. of the Congo,COD,Slovakia,SVK,0,0,5,0,5
2015,Cuba,CUB,Slovakia,SVK,5,0,0,0,5
2015,India,IND,Slovakia,SVK,0,0,5,5,10
2015,Iraq,IRQ,Slovakia,SVK,0,10,0,10,20
2015,Rep. of Moldova,MDA,Slovakia,SVK,0,0,0,5,5
2015,Mongolia,MNG,Slovakia,SVK,0,0,5,0,5
2015,Russian Federation,RUS,Slovakia,SVK,0,0,5,5,10
2015,Somalia,SOM,Slovakia,SVK,0,5,0,0,5
2015,Viet Nam,VNM,Slovakia,SVK,0,0,0,5,5
2015,Sudan,SDN,Slovakia,SVK,0,5,0,0,5
2015,Syrian Arab Rep.,SYR,Slovakia,SVK,0,12,0,5,17
2015,Ukraine,UKR,Slovakia,SVK,0,12,10,21,43
2015,Afghanistan,AFG,Slovenia,SVN,0,0,24,20,44
2015,Albania,ALB,Slovenia,SVN,0,0,5,5,10
2015,Algeria,DZA,Slovenia,SVN,0,0,5,0,5
2015,Bosnia and Herzegovina,BIH,Slovenia,SVN,0,0,10,0,10
2015,Iran (Islamic Rep. of),IRN,Slovenia,SVN,20,0,0,5,25
2015,Iraq,IRQ,Slovenia,SVN,0,0,16,22,38
2015,Kazakhstan,KAZ,Slovenia,SVN,5,0,0,0,5
2015,Morocco,MAR,Slovenia,SVN,0,0,5,0,5
2015,Nigeria,NGA,Slovenia,SVN,0,0,0,5,5
2015,Pakistan,PAK,Slovenia,SVN,0,0,5,5,10
2015,Russian Federation,RUS,Slovenia,SVN,0,0,5,0,5
2015,Serbia and Kosovo: S/RES/1244 (1999),SRB,Slovenia,SVN,0,0,37,5,42
2015,Somalia,SOM,Slovenia,SVN,5,0,0,0,5
2015,Syrian Arab Rep.,SYR,Slovenia,SVN,0,11,0,5,16
2015,Ukraine,UKR,Slovenia,SVN,0,0,17,11,28
2015,Burundi,BDI,Eswatini,SWZ,15,0,0,12,27
2015,Dem. Rep. of the Congo,COD,Eswatini,SWZ,32,0,0,32,64
2015,Rwanda,RWA,Eswatini,SWZ,14,0,0,0,14
2015,Somalia,SOM,Eswatini,SWZ,22,0,0,0,22
2015,Afghanistan,AFG,Sweden,SWE,333,689,349,1567,2938
2015,Albania,ALB,Sweden,SWE,10,19,1650,900,2579
2015,Algeria,DZA,Sweden,SWE,0,0,30,263,293
2015,Angola,AGO,Sweden,SWE,0,0,0,10,10
2015,Egypt,EGY,Sweden,SWE,40,10,120,96,266
2015,Argentina,ARG,Sweden,SWE,0,0,0,5,5
2015,Armenia,ARM,Sweden,SWE,0,25,106,51,182
2015,Azerbaijan,AZE,Sweden,SWE,17,16,66,71,170
2015,Burundi,BDI,Sweden,SWE,5,0,0,10,15
2015,Benin,BEN,Sweden,SWE,0,0,0,5,5
2015,Bangladesh,BGD,Sweden,SWE,5,0,67,26,98
2015,Burkina Faso,BFA,Sweden,SWE,0,0,0,5,5
2015,Belarus,BLR,Sweden,SWE,5,0,32,113,150
2015,Bolivia (Plurinational State of),BOL,Sweden,SWE,0,0,12,0,12
2015,Brazil,BRA,Sweden,SWE,0,0,0,5,5
2015,Bosnia and Herzegovina,BIH,Sweden,SWE,0,0,302,216,518
2015,Bulgaria,BGR,Sweden,SWE,0,0,10,0,10
2015,Chad,TCD,Sweden,SWE,0,0,0,13,13
2015,China,CHN,Sweden,SWE,5,0,10,13,28
2015,Chile,CHL,Sweden,SWE,0,0,11,5,16
2015,Cameroon,CMR,Sweden,SWE,5,0,10,19,34
2015,Congo,COG,Sweden,SWE,0,0,0,13,13
2015,Dem. Rep. of the Congo,COD,Sweden,SWE,5,0,13,19,37
2015,Colombia,COL,Sweden,SWE,0,0,5,14,19
2015,Cuba,CUB,Sweden,SWE,0,0,13,14,27
2015,Cabo Verde,CPV,Sweden,SWE,0,0,5,0,5
2015,Djibouti,DJI,Sweden,SWE,0,0,10,12,22
2015,Dominican Rep.,DOM,Sweden,SWE,0,0,0,5,5
2015,Eritrea,ERI,Sweden,SWE,6159,194,5,660,7018
2015,Ethiopia,ETH,Sweden,SWE,144,16,118,150,428
2015,France,FRA,Sweden,SWE,0,0,5,0,5
2015,Gambia,GMB,Sweden,SWE,5,5,25,61,96
2015,Palestinian,PSE,Sweden,SWE,121,175,129,41,466
2015,Georgia,GEO,Sweden,SWE,5,5,147,323,480
2015,Ghana,GHA,Sweden,SWE,0,0,10,26,36
2015,Guinea-Bissau,GNB,Sweden,SWE,0,0,0,5,5
2015,Greece,GRC,Sweden,SWE,0,0,11,0,11
2015,Guinea,GIN,Sweden,SWE,5,0,5,25,35
2015,Croatia,HRV,Sweden,SWE,0,0,5,0,5
2015,Hungary,HUN,Sweden,SWE,0,0,0,5,5
2015,Cote d'Ivoire,CIV,Sweden,SWE,0,0,5,11,16
2015,India,IND,Sweden,SWE,5,0,10,14,29
2015,Iran (Islamic Rep. of),IRN,Sweden,SWE,122,10,91,341,564
2015,Iraq,IRQ,Sweden,SWE,176,124,200,1746,2246
2015,Israel,ISR,Sweden,SWE,0,0,11,0,11
2015,Italy,ITA,Sweden,SWE,0,0,0,5,5
2015,Jordan,JOR,Sweden,SWE,15,14,51,65,145
2015,Kazakhstan,KAZ,Sweden,SWE,0,0,52,78,130
2015,Kenya,KEN,Sweden,SWE,0,0,5,14,19
2015,Kyrgyzstan,KGZ,Sweden,SWE,5,5,23,50,83
2015,Rep. of Korea,KOR,Sweden,SWE,0,0,0,5,5
2015,Liberia,LBR,Sweden,SWE,0,0,0,5,5
2015,Libya,LBY,Sweden,SWE,12,5,30,255,302
2015,Lebanon,LBN,Sweden,SWE,19,10,115,185,329
2015,Sri Lanka,LKA,Sweden,SWE,0,0,5,11,16
2015,Lithuania,LTU,Sweden,SWE,0,0,5,0,5
2015,Mauritania,MRT,Sweden,SWE,0,0,0,10,10
2015,North Macedonia,MKD,Sweden,SWE,0,5,274,194,473
2015,Rep. of Moldova,MDA,Sweden,SWE,0,0,13,18,31
2015,Mexico,MEX,Sweden,SWE,0,0,5,5,10
2015,Mali,MLI,Sweden,SWE,0,0,5,15,20
2015,Mongolia,MNG,Sweden,SWE,0,15,294,84,393
2015,Morocco,MAR,Sweden,SWE,13,12,155,408,588
2015,Montenegro,MNE,Sweden,SWE,0,0,76,58,134
2015,Nicaragua,NIC,Sweden,SWE,0,0,11,0,11
2015,Nigeria,NGA,Sweden,SWE,35,5,47,164,251
2015,Pakistan,PAK,Sweden,SWE,23,5,56,74,158
2015,Philippines,PHL,Sweden,SWE,0,0,0,12,12
2015,Poland,POL,Sweden,SWE,0,0,5,5,10
2015,Romania,ROU,Sweden,SWE,0,0,33,10,43
2015,Russian Federation,RUS,Sweden,SWE,77,17,137,153,384
2015,Rwanda,RWA,Sweden,SWE,0,0,0,11,11
2015,El Salvador,SLV,Sweden,SWE,5,0,34,11,50
2015,Saudi Arabia,SAU,Sweden,SWE,12,5,0,0,17
2015,Serbia and Kosovo: S/RES/1244 (1999),SRB,Sweden,SWE,0,20,1808,1230,3058
2015,Senegal,SEN,Sweden,SWE,5,0,10,23,38
2015,Sierra Leone,SLE,Sweden,SWE,0,0,5,14,19
2015,Somalia,SOM,Sweden,SWE,682,192,299,942,2115
2015,Spain,ESP,Sweden,SWE,0,0,0,5,5
2015,Viet Nam,VNM,Sweden,SWE,0,0,0,11,11
2015,Sudan,SDN,Sweden,SWE,49,10,47,76,182
2015,Slovakia,SVK,Sweden,SWE,0,0,5,0,5
2015,Syrian Arab Rep.,SYR,Sweden,SWE,1903,16383,37,2046,20369
2015,United Rep. of Tanzania,TZA,Sweden,SWE,0,5,0,13,18
2015,Thailand,THA,Sweden,SWE,0,0,0,5,5
2015,Tajikistan,TJK,Sweden,SWE,5,0,5,14,24
2015,Togo,TGO,Sweden,SWE,0,0,0,5,5
2015,Tunisia,TUN,Sweden,SWE,0,5,30,143,178
2015,Turkey,TUR,Sweden,SWE,0,0,63,48,111
2015,Uganda,UGA,Sweden,SWE,56,0,25,37,118
2015,Ukraine,UKR,Sweden,SWE,0,25,438,389,852
2015,United States of America,USA,Sweden,SWE,0,5,13,12,30
2015,Uzbekistan,UZB,Sweden,SWE,20,5,34,66,125
2015,Venezuela (Bolivarian Republic of),VEN,Sweden,SWE,0,0,22,5,27
2015,Yemen,YEM,Sweden,SWE,28,22,21,70,141
2015,Zambia,ZMB,Sweden,SWE,0,0,0,5,5
2015,Stateless,XXA,Sweden,SWE,2063,997,148,597,3805
2015,Afghanistan,AFG,Switzerland,CHE,177,622,1021,82,1902
2015,Albania,ALB,Switzerland,CHE,0,12,321,79,412
2015,Algeria,DZA,Switzerland,CHE,5,0,236,73,314
2015,Angola,AGO,Switzerland,CHE,5,39,21,0,65
2015,Egypt,EGY,Switzerland,CHE,19,0,59,42,120
2015,Armenia,ARM,Switzerland,CHE,0,22,58,5,85
2015,Azerbaijan,AZE,Switzerland,CHE,14,5,5,0,24
2015,Burundi,BDI,Switzerland,CHE,0,0,11,0,11
2015,Benin,BEN,Switzerland,CHE,0,0,20,10,30
2015,Bangladesh,BGD,Switzerland,CHE,0,5,51,5,61
2015,Burkina Faso,BFA,Switzerland,CHE,0,0,15,5,20
2015,Belarus,BLR,Switzerland,CHE,0,5,31,16,52
2015,Bosnia and Herzegovina,BIH,Switzerland,CHE,0,10,97,20,127
2015,Bulgaria,BGR,Switzerland,CHE,0,0,5,0,5
2015,Central African Rep.,CAF,Switzerland,CHE,0,0,0,5,5
2015,Chad,TCD,Switzerland,CHE,5,0,31,5,41
2015,China,CHN,Switzerland,CHE,130,406,231,5,772
2015,Cameroon,CMR,Switzerland,CHE,5,20,55,5,85
2015,Congo,COG,Switzerland,CHE,0,0,5,0,5
2015,Dem. Rep. of the Congo,COD,Switzerland,CHE,25,80,115,10,230
2015,Colombia,COL,Switzerland,CHE,0,0,5,0,5
2015,Cuba,CUB,Switzerland,CHE,0,0,5,0,5
2015,Djibouti,DJI,Switzerland,CHE,5,0,5,0,10
2015,Equatorial Guinea,GNQ,Switzerland,CHE,0,0,5,5,10
2015,Eritrea,ERI,Switzerland,CHE,2633,2325,2094,79,7131
2015,Ethiopia,ETH,Switzerland,CHE,84,124,333,18,559
2015,France,FRA,Switzerland,CHE,0,0,0,5,5
2015,Gabon,GAB,Switzerland,CHE,0,0,5,0,5
2015,Gambia,GMB,Switzerland,CHE,5,0,536,352,893
2015,Georgia,GEO,Switzerland,CHE,5,21,310,110,446
2015,Ghana,GHA,Switzerland,CHE,0,0,56,37,93
2015,Guinea-Bissau,GNB,Switzerland,CHE,0,10,65,54,129
2015,Guinea,GIN,Switzerland,CHE,12,16,214,56,298
2015,Haiti,HTI,Switzerland,CHE,0,0,5,0,5
2015,Croatia,HRV,Switzerland,CHE,0,0,5,0,5
2015,Hungary,HUN,Switzerland,CHE,0,0,0,5,5
2015,Cote d'Ivoire,CIV,Switzerland,CHE,21,11,71,16,119
2015,India,IND,Switzerland,CHE,0,0,12,0,12
2015,Iran (Islamic Rep. of),IRN,Switzerland,CHE,117,79,199,20,415
2015,Iraq,IRQ,Switzerland,CHE,62,137,377,112,688
2015,Israel,ISR,Switzerland,CHE,0,0,5,0,5
2015,Italy,ITA,Switzerland,CHE,0,0,14,0,14
2015,Jordan,JOR,Switzerland,CHE,12,5,0,5,22
2015,Kazakhstan,KAZ,Switzerland,CHE,0,0,11,0,11
2015,Kenya,KEN,Switzerland,CHE,5,0,10,0,15
2015,Kyrgyzstan,KGZ,Switzerland,CHE,0,0,5,0,5
2015,Rep. of Korea,KOR,Switzerland,CHE,0,0,5,0,5
2015,Liberia,LBR,Switzerland,CHE,0,0,33,5,38
2015,Libya,LBY,Switzerland,CHE,16,38,79,46,179
2015,Lebanon,LBN,Switzerland,CHE,5,5,20,5,35
2015,Sri Lanka,LKA,Switzerland,CHE,1008,233,488,47,1776
2015,Latvia,LVA,Switzerland,CHE,0,0,0,5,5
2015,Mauritania,MRT,Switzerland,CHE,0,0,18,10,28
2015,North Macedonia,MKD,Switzerland,CHE,0,5,108,35,148
2015,Rep. of Moldova,MDA,Switzerland,CHE,0,0,10,11,21
2015,Mali,MLI,Switzerland,CHE,0,5,121,43,169
2015,Mongolia,MNG,Switzerland,CHE,0,12,83,11,106
2015,Morocco,MAR,Switzerland,CHE,5,0,288,171,464
2015,Montenegro,MNE,Switzerland,CHE,0,5,13,0,18
2015,Mauritius,MUS,Switzerland,CHE,0,0,5,0,5
2015,Myanmar,MMR,Switzerland,CHE,0,0,5,0,5
2015,Nepal,NPL,Switzerland,CHE,0,5,0,5,10
2015,Netherlands,NLD,Switzerland,CHE,0,0,0,5,5
2015,Niger,NER,Switzerland,CHE,0,0,22,5,27
2015,Nicaragua,NIC,Switzerland,CHE,0,0,5,0,5
2015,Nigeria,NGA,Switzerland,CHE,0,25,782,158,965
2015,Pakistan,PAK,Switzerland,CHE,5,5,134,37,181
2015,Poland,POL,Switzerland,CHE,0,0,5,0,5
2015,Romania,ROU,Switzerland,CHE,0,0,5,15,20
2015,South Africa,ZAF,Switzerland,CHE,0,5,0,0,5
2015,Russian Federation,RUS,Switzerland,CHE,55,13,164,16,248
2015,Rwanda,RWA,Switzerland,CHE,5,0,13,0,18
2015,Serbia and Kosovo: S/RES/1244 (1999),SRB,Switzerland,CHE,13,105,668,154,940
2015,Senegal,SEN,Switzerland,CHE,0,5,226,170,401
2015,Sierra Leone,SLE,Switzerland,CHE,0,5,53,10,68
2015,Somalia,SOM,Switzerland,CHE,146,364,274,84,868
2015,Viet Nam,VNM,Switzerland,CHE,5,0,0,0,5
2015,Sudan,SDN,Switzerland,CHE,11,10,140,22,183
2015,South Sudan,SSD,Switzerland,CHE,0,5,16,0,21
2015,Slovakia,SVK,Switzerland,CHE,0,0,5,0,5
2015,Syrian Arab Rep.,SYR,Switzerland,CHE,1309,1972,421,122,3824
2015,United Rep. of Tanzania,TZA,Switzerland,CHE,0,0,12,0,12
2015,Tajikistan,TJK,Switzerland,CHE,0,0,5,0,5
2015,Togo,TGO,Switzerland,CHE,16,12,39,5,72
2015,Tunisia,TUN,Switzerland,CHE,5,5,234,147,391
2015,Turkey,TUR,Switzerland,CHE,213,59,210,31,513
2015,Uganda,UGA,Switzerland,CHE,5,0,39,0,44
2015,Ukraine,UKR,Switzerland,CHE,0,0,196,42,238
2015,United States of America,USA,Switzerland,CHE,0,0,0,5,5
2015,Uzbekistan,UZB,Switzerland,CHE,0,0,10,0,10
2015,Western Sahara,ESH,Switzerland,CHE,0,0,5,0,5
2015,Yemen,YEM,Switzerland,CHE,43,0,13,5,61
2015,Zimbabwe,ZWE,Switzerland,CHE,5,0,5,0,10
2015,Stateless,XXA,Switzerland,CHE,11,23,0,0,34
2015,Burundi,BDI,United Rep. of Tanzania,TZA,0,0,37,0,37
2015,Dem. Rep. of the Congo,COD,United Rep. of Tanzania,TZA,164,0,180,0,344
2015,Myanmar,MMR,Thailand,THA,152,0,15,0,167
2015,Central African Rep.,CAF,Togo,TGO,143,0,0,0,143
2015,Dem. Rep. of the Congo,COD,Togo,TGO,5,0,0,0,5
2015,Mali,MLI,Togo,TGO,46,0,0,0,46
2015,Rwanda,RWA,Togo,TGO,5,0,0,0,5
2015,Syrian Arab Rep.,SYR,Togo,TGO,5,0,0,0,5
2015,Afghanistan,AFG,Ukraine,UKR,18,18,141,117,294
2015,Algeria,DZA,Ukraine,UKR,0,0,5,5,10
2015,Angola,AGO,Ukraine,UKR,0,0,0,5,5
2015,Egypt,EGY,Ukraine,UKR,0,0,5,0,5
2015,Armenia,ARM,Ukraine,UKR,0,0,0,5,5
2015,Azerbaijan,AZE,Ukraine,UKR,0,0,5,0,5
2015,Bangladesh,BGD,Ukraine,UKR,0,0,13,5,18
2015,Belarus,BLR,Ukraine,UKR,0,0,13,0,13
2015,Cameroon,CMR,Ukraine,UKR,0,0,0,12,12
2015,Congo,COG,Ukraine,UKR,0,0,0,5,5
2015,Dem. Rep. of the Congo,COD,Ukraine,UKR,0,5,14,5,24
2015,Eritrea,ERI,Ukraine,UKR,0,0,5,0,5
2015,Ethiopia,ETH,Ukraine,UKR,0,0,0,5,5
2015,Gambia,GMB,Ukraine,UKR,0,0,5,0,5
2015,Georgia,GEO,Ukraine,UKR,0,0,0,14,14
2015,Guinea,GIN,Ukraine,UKR,0,0,11,12,23
2015,Cote d'Ivoire,CIV,Ukraine,UKR,0,0,5,0,5
2015,Iran (Islamic Rep. of),IRN,Ukraine,UKR,0,5,11,5,21
2015,Iraq,IRQ,Ukraine,UKR,0,11,32,5,48
2015,Kyrgyzstan,KGZ,Ukraine,UKR,0,0,11,5,16
2015,Lebanon,LBN,Ukraine,UKR,0,0,5,0,5
2015,Sri Lanka,LKA,Ukraine,UKR,0,0,5,16,21
2015,Mali,MLI,Ukraine,UKR,0,0,5,0,5
2015,Morocco,MAR,Ukraine,UKR,0,0,5,0,5
2015,Nigeria,NGA,Ukraine,UKR,0,0,10,5,15
2015,Pakistan,PAK,Ukraine,UKR,0,0,12,0,12
2015,Russian Federation,RUS,Ukraine,UKR,5,5,42,21,73
2015,Sierra Leone,SLE,Ukraine,UKR,0,0,5,0,5
2015,Somalia,SOM,Ukraine,UKR,0,0,52,32,84
2015,Sudan,SDN,Ukraine,UKR,0,5,13,5,23
2015,Syrian Arab Rep.,SYR,Ukraine,UKR,5,58,134,10,207
2015,Tajikistan,TJK,Ukraine,UKR,0,5,0,5,10
2015,Tunisia,TUN,Ukraine,UKR,0,0,5,0,5
2015,Turkey,TUR,Ukraine,UKR,0,5,0,0,5
2015,Uzbekistan,UZB,Ukraine,UKR,0,0,12,12,24
2015,Stateless,XXA,Ukraine,UKR,0,10,25,5,40
2015,Bolivia (Plurinational State of),BOL,Uruguay,URY,5,0,0,0,5
2015,Colombia,COL,Uruguay,URY,10,0,0,5,15
2015,Cuba,CUB,Uruguay,URY,5,0,0,0,5
2015,Mexico,MEX,Uruguay,URY,5,0,0,0,5
2015,Nigeria,NGA,Uruguay,URY,0,0,0,5,5
2015,El Salvador,SLV,Uruguay,URY,0,0,0,5,5
2015,Sierra Leone,SLE,Uruguay,URY,0,0,10,0,10
2015,Syrian Arab Rep.,SYR,Uruguay,URY,11,0,0,0,11
2015,Colombia,COL,Venezuela (Bolivarian Republic of),VEN,1211,0,469,0,1680
2015,Egypt,EGY,Zambia,ZMB,0,0,0,5,5
2015,Burundi,BDI,Zambia,ZMB,492,0,0,0,492
2015,Dem. Rep. of the Congo,COD,Zambia,ZMB,1458,0,617,0,2075
2015,Ethiopia,ETH,Zambia,ZMB,0,0,5,0,5
2015,Rwanda,RWA,Zambia,ZMB,0,0,5,0,5
2015,Somalia,SOM,Zambia,ZMB,89,0,5,33,127
2015,Sudan,SDN,Zambia,ZMB,5,0,0,0,5
2015,Syrian Arab Rep.,SYR,Zambia,ZMB,5,0,0,0,5
2015,United Rep. of Tanzania,TZA,Zambia,ZMB,0,0,0,10,10
2015,Uganda,UGA,Zambia,ZMB,0,0,0,5,5
2015,Egypt,EGY,Zimbabwe,ZWE,0,0,5,0,5
2015,Burundi,BDI,Zimbabwe,ZWE,0,23,10,15,48
2015,Dem. Rep. of the Congo,COD,Zimbabwe,ZWE,41,479,98,276,894
2015,Eritrea,ERI,Zimbabwe,ZWE,0,0,0,5,5
2015,Ethiopia,ETH,Zimbabwe,ZWE,0,0,0,5,5
2015,Cote d'Ivoire,CIV,Zimbabwe,ZWE,0,0,0,5,5
2015,Mali,MLI,Zimbabwe,ZWE,0,0,0,11,11
2015,Rwanda,RWA,Zimbabwe,ZWE,0,18,5,10,33
2015,Somalia,SOM,Zimbabwe,ZWE,5,0,0,0,5
2016,Afghanistan,AFG,Albania,ALB,0,0,0,64,64
2016,Dem. Rep. of the Congo,COD,Albania,ALB,0,0,0,5,5
2016,Iran (Islamic Rep. of),IRN,Albania,ALB,10,0,0,0,10
2016,Iraq,IRQ,Albania,ALB,0,18,0,10,28
2016,Pakistan,PAK,Albania,ALB,0,0,0,5,5
2016,Serbia and Kosovo: S/RES/1244 (1999),SRB,Albania,ALB,0,0,10,0,10
2016,Syrian Arab Rep.,SYR,Albania,ALB,0,0,0,127,127
2016,Tunisia,TUN,Albania,ALB,0,0,5,0,5
2016,Angola,AGO,Argentina,ARG,0,0,5,0,5
2016,Armenia,ARM,Argentina,ARG,0,0,5,0,5
2016,Brazil,BRA,Argentina,ARG,0,0,0,5,5
2016,China,CHN,Argentina,ARG,0,0,11,5,16
2016,Chile,CHL,Argentina,ARG,0,0,0,5,5
2016,Cameroon,CMR,Argentina,ARG,0,0,5,0,5
2016,Colombia,COL,Argentina,ARG,0,0,10,18,28
2016,Cuba,CUB,Argentina,ARG,5,0,62,28,95
2016,Dominican Rep.,DOM,Argentina,ARG,0,0,21,10,31
2016,Ghana,GHA,Argentina,ARG,5,0,30,0,35
2016,Guinea,GIN,Argentina,ARG,0,0,5,0,5
2016,Haiti,HTI,Argentina,ARG,0,0,99,13,112
2016,Cote d'Ivoire,CIV,Argentina,ARG,0,0,0,5,5
2016,India,IND,Argentina,ARG,0,0,14,0,14
2016,Iraq,IRQ,Argentina,ARG,5,0,0,0,5
2016,Mexico,MEX,Argentina,ARG,0,0,0,5,5
2016,Nigeria,NGA,Argentina,ARG,0,0,0,11,11
2016,Pakistan,PAK,Argentina,ARG,5,0,0,0,5
2016,Peru,PER,Argentina,ARG,5,0,0,0,5
2016,Russian Federation,RUS,Argentina,ARG,0,0,14,0,14
2016,El Salvador,SLV,Argentina,ARG,5,0,0,0,5
2016,Senegal,SEN,Argentina,ARG,0,0,528,0,528
2016,Syrian Arab Rep.,SYR,Argentina,ARG,92,0,5,13,110
2016,Ukraine,UKR,Argentina,ARG,41,0,5,5,51
2016,Venezuela (Bolivarian Republic of),VEN,Argentina,ARG,0,0,0,5,5
2016,Iran (Islamic Rep. of),IRN,Armenia,ARM,0,0,14,5,19
2016,Iraq,IRQ,Armenia,ARM,0,0,16,5,21
2016,Syrian Arab Rep.,SYR,Armenia,ARM,29,0,5,16,50
2016,Ukraine,UKR,Armenia,ARM,5,0,0,0,5
2016,Afghanistan,AFG,Australia,AUS,1415,0,76,0,1491
2016,Albania,ALB,Australia,AUS,0,0,15,0,15
2016,Algeria,DZA,Australia,AUS,0,0,5,0,5
2016,Egypt,EGY,Australia,AUS,55,0,84,0,139
2016,Azerbaijan,AZE,Australia,AUS,5,0,5,0,10
2016,Bahrain,BHR,Australia,AUS,10,0,5,0,15
2016,Burundi,BDI,Australia,AUS,23,0,0,0,23
2016,Bangladesh,BGD,Australia,AUS,45,0,256,0,301
2016,Bhutan,BTN,Australia,AUS,0,0,5,0,5
2016,Belarus,BLR,Australia,AUS,5,0,0,0,5
2016,Brazil,BRA,Australia,AUS,0,0,20,0,20
2016,Cambodia,KHM,Australia,AUS,10,0,11,0,21
2016,Chad,TCD,Australia,AUS,0,0,5,0,5
2016,China,CHN,Australia,AUS,112,0,635,0,747
2016,Congo,COG,Australia,AUS,5,0,0,0,5
2016,Dem. Rep. of the Congo,COD,Australia,AUS,13,0,5,0,18
2016,Colombia,COL,Australia,AUS,0,0,18,0,18
2016,Cuba,CUB,Australia,AUS,0,0,5,0,5
2016,Cyprus,CYP,Australia,AUS,0,0,5,0,5
2016,Czechia,CZE,Australia,AUS,0,0,5,0,5
2016,Denmark,DNK,Australia,AUS,0,0,5,0,5
2016,Ecuador,ECU,Australia,AUS,0,0,5,0,5
2016,Eritrea,ERI,Australia,AUS,21,0,0,0,21
2016,Estonia,EST,Australia,AUS,0,0,5,0,5
2016,Ethiopia,ETH,Australia,AUS,41,0,15,0,56
2016,Fiji,FJI,Australia,AUS,30,0,237,0,267
2016,France,FRA,Australia,AUS,0,0,5,0,5
2016,Gambia,GMB,Australia,AUS,5,0,0,0,5
2016,Palestinian,PSE,Australia,AUS,63,0,5,0,68
2016,United Kingdom of Great Britain and Northern Ireland,GBR,Australia,AUS,0,0,23,0,23
2016,Georgia,GEO,Australia,AUS,0,0,10,0,10
2016,Ghana,GHA,Australia,AUS,5,0,13,0,18
2016,Greece,GRC,Australia,AUS,5,0,0,0,5
2016,Guinea,GIN,Australia,AUS,5,0,0,0,5
2016,"China, Hong Kong SAR",HKG,Australia,AUS,5,0,28,0,33
2016,Honduras,HND,Australia,AUS,5,0,0,0,5
2016,Croatia,HRV,Australia,AUS,0,0,5,0,5
2016,India,IND,Australia,AUS,54,0,422,0,476
2016,Indonesia,IDN,Australia,AUS,26,0,101,0,127
2016,Ireland,IRL,Australia,AUS,0,0,17,0,17
2016,Iran (Islamic Rep. of),IRN,Australia,AUS,886,0,187,0,1073
2016,Iraq,IRQ,Australia,AUS,631,0,91,0,722
2016,Israel,ISR,Australia,AUS,0,0,12,0,12
2016,Italy,ITA,Australia,AUS,0,0,5,0,5
2016,Jamaica,JAM,Australia,AUS,5,0,0,0,5
2016,Jordan,JOR,Australia,AUS,21,0,35,0,56
2016,Japan,JPN,Australia,AUS,5,0,5,0,10
2016,Kenya,KEN,Australia,AUS,22,0,27,0,49
2016,Kyrgyzstan,KGZ,Australia,AUS,5,0,10,0,15
2016,Kiribati,KIR,Australia,AUS,0,0,5,0,5
2016,Rep. of Korea,KOR,Australia,AUS,5,0,39,0,44
2016,Kuwait,KWT,Australia,AUS,12,0,0,0,12
2016,Liberia,LBR,Australia,AUS,10,0,0,0,10
2016,Libya,LBY,Australia,AUS,246,0,12,0,258
2016,Lebanon,LBN,Australia,AUS,42,0,108,0,150
2016,Sri Lanka,LKA,Australia,AUS,804,0,616,0,1420
2016,Latvia,LVA,Australia,AUS,0,0,5,0,5
2016,"China, Macao SAR",MAC,Australia,AUS,0,0,5,0,5
2016,North Macedonia,MKD,Australia,AUS,0,0,5,0,5
2016,Rep. of Moldova,MDA,Australia,AUS,0,0,5,0,5
2016,Mexico,MEX,Australia,AUS,5,0,0,0,5
2016,Malaysia,MYS,Australia,AUS,32,0,2244,0,2276
2016,Mongolia,MNG,Australia,AUS,0,0,33,0,33
2016,Malta,MLT,Australia,AUS,0,0,5,0,5
2016,Mauritius,MUS,Australia,AUS,0,0,10,0,10
2016,Myanmar,MMR,Australia,AUS,32,0,19,0,51
2016,Nepal,NPL,Australia,AUS,17,0,156,0,173
2016,Nicaragua,NIC,Australia,AUS,0,0,5,0,5
2016,Nigeria,NGA,Australia,AUS,41,0,39,0,80
2016,Norway,NOR,Australia,AUS,0,0,5,0,5
2016,New Zealand,NZL,Australia,AUS,10,0,14,0,24
2016,Pakistan,PAK,Australia,AUS,481,0,308,0,789
2016,Peru,PER,Australia,AUS,0,0,14,0,14
2016,Philippines,PHL,Australia,AUS,10,0,37,0,47
2016,Papua New Guinea,PNG,Australia,AUS,52,0,39,0,91
2016,Poland,POL,Australia,AUS,0,0,5,0,5
2016,South Africa,ZAF,Australia,AUS,5,0,13,0,18
2016,Russian Federation,RUS,Australia,AUS,10,0,19,0,29
2016,Rwanda,RWA,Australia,AUS,20,0,5,0,25
2016,El Salvador,SLV,Australia,AUS,12,0,0,0,12
2016,Saudi Arabia,SAU,Australia,AUS,12,0,11,0,23
2016,Serbia and Kosovo: S/RES/1244 (1999),SRB,Australia,AUS,0,0,5,0,5
2016,Singapore,SGP,Australia,AUS,5,0,10,0,15
2016,Sierra Leone,SLE,Australia,AUS,5,0,0,0,5
2016,Solomon Islands,SLB,Australia,AUS,13,0,5,0,18
2016,Somalia,SOM,Australia,AUS,21,0,5,0,26
2016,Viet Nam,VNM,Australia,AUS,26,0,131,0,157
2016,Sudan,SDN,Australia,AUS,26,0,5,0,31
2016,South Sudan,SSD,Australia,AUS,5,0,0,0,5
2016,Slovenia,SVN,Australia,AUS,0,0,5,0,5
2016,Syrian Arab Rep.,SYR,Australia,AUS,78,0,5,0,83
2016,United Rep. of Tanzania,TZA,Australia,AUS,0,0,12,0,12
2016,Thailand,THA,Australia,AUS,0,0,38,0,38
2016,Tonga,TON,Australia,AUS,5,0,41,0,46
2016,Tunisia,TUN,Australia,AUS,0,0,5,0,5
2016,Turkey,TUR,Australia,AUS,33,0,24,0,57
2016,Uganda,UGA,Australia,AUS,12,0,5,0,17
2016,Ukraine,UKR,Australia,AUS,5,0,13,0,18
2016,United States of America,USA,Australia,AUS,5,0,15,0,20
2016,Uzbekistan,UZB,Australia,AUS,10,0,5,0,15
2016,Saint Vincent and the Grenadines,VCT,Australia,AUS,0,0,5,0,5
2016,Venezuela (Bolivarian Republic of),VEN,Australia,AUS,5,0,5,0,10
2016,Samoa,WSM,Australia,AUS,0,0,10,0,10
2016,Yemen,YEM,Australia,AUS,5,0,0,0,5
2016,Zambia,ZMB,Australia,AUS,0,0,18,0,18
2016,Zimbabwe,ZWE,Australia,AUS,37,0,27,0,64
2016,Stateless,XXA,Australia,AUS,301,0,27,0,328
2016,Tibetan,TIB,Australia,AUS,5,0,0,0,5
2016,Afghanistan,AFG,Azerbaijan,AZE,5,0,94,12,111
2016,Georgia,GEO,Azerbaijan,AZE,0,0,5,0,5
2016,Iran (Islamic Rep. of),IRN,Azerbaijan,AZE,0,0,5,0,5
2016,Iraq,IRQ,Azerbaijan,AZE,0,0,5,13,18
2016,Pakistan,PAK,Azerbaijan,AZE,0,0,20,5,25
2016,Russian Federation,RUS,Azerbaijan,AZE,0,0,5,0,5
2016,Angola,AGO,Burundi,BDI,0,0,0,5,5
2016,Central African Rep.,CAF,Burundi,BDI,0,0,0,5,5
2016,Dem. Rep. of the Congo,COD,Burundi,BDI,4943,0,0,775,5718
2016,Mali,MLI,Burundi,BDI,0,0,0,5,5
2016,Rwanda,RWA,Burundi,BDI,51,0,0,194,245
2016,Somalia,SOM,Burundi,BDI,5,0,0,0,5
2016,Uganda,UGA,Burundi,BDI,5,0,0,0,5
2016,Afghanistan,AFG,Belgium,BEL,656,830,583,88,2157
2016,Albania,ALB,Belgium,BEL,67,0,492,95,654
2016,Algeria,DZA,Belgium,BEL,5,0,33,5,43
2016,Angola,AGO,Belgium,BEL,0,0,30,5,35
2016,Egypt,EGY,Belgium,BEL,5,0,21,5,31
2016,Armenia,ARM,Belgium,BEL,21,0,116,11,148
2016,Azerbaijan,AZE,Belgium,BEL,15,0,13,0,28
2016,Burundi,BDI,Belgium,BEL,167,0,39,5,211
2016,Benin,BEN,Belgium,BEL,5,0,24,0,29
2016,Bangladesh,BGD,Belgium,BEL,5,0,34,0,39
2016,Burkina Faso,BFA,Belgium,BEL,14,0,19,0,33
2016,Belarus,BLR,Belgium,BEL,5,0,5,0,10
2016,Bosnia and Herzegovina,BIH,Belgium,BEL,5,0,11,10,26
2016,Bulgaria,BGR,Belgium,BEL,0,0,0,5,5
2016,Central African Rep.,CAF,Belgium,BEL,15,5,10,0,30
2016,China,CHN,Belgium,BEL,125,0,37,0,162
2016,Cameroon,CMR,Belgium,BEL,52,0,127,10,189
2016,Congo,COG,Belgium,BEL,0,0,12,0,12
2016,Dem. Rep. of the Congo,COD,Belgium,BEL,88,0,403,14,505
2016,Colombia,COL,Belgium,BEL,0,0,5,0,5
2016,Cuba,CUB,Belgium,BEL,5,0,0,0,5
2016,Djibouti,DJI,Belgium,BEL,53,0,42,0,95
2016,Dominican Rep.,DOM,Belgium,BEL,0,0,10,0,10
2016,Eritrea,ERI,Belgium,BEL,275,0,34,5,314
2016,Ethiopia,ETH,Belgium,BEL,29,0,41,0,70
2016,Gabon,GAB,Belgium,BEL,5,0,0,0,5
2016,Gambia,GMB,Belgium,BEL,5,0,22,0,27
2016,Palestinian,PSE,Belgium,BEL,24,0,10,0,34
2016,Georgia,GEO,Belgium,BEL,0,0,43,38,81
2016,Germany,DEU,Belgium,BEL,0,0,0,5,5
2016,Ghana,GHA,Belgium,BEL,0,0,21,0,21
2016,Greece,GRC,Belgium,BEL,0,0,0,5,5
2016,Guinea,GIN,Belgium,BEL,285,0,325,20,630
2016,Haiti,HTI,Belgium,BEL,0,0,12,0,12
2016,Hungary,HUN,Belgium,BEL,0,0,0,5,5
2016,Cote d'Ivoire,CIV,Belgium,BEL,18,0,51,5,74
2016,India,IND,Belgium,BEL,0,0,23,5,28
2016,Iran (Islamic Rep. of),IRN,Belgium,BEL,67,0,26,22,115
2016,Iraq,IRQ,Belgium,BEL,2745,556,2090,567,5958
2016,Jordan,JOR,Belgium,BEL,5,0,5,0,10
2016,Kazakhstan,KAZ,Belgium,BEL,0,0,5,0,5
2016,Kenya,KEN,Belgium,BEL,5,0,5,0,10
2016,Kyrgyzstan,KGZ,Belgium,BEL,13,0,0,0,13
2016,Kuwait,KWT,Belgium,BEL,0,0,0,5,5
2016,Liberia,LBR,Belgium,BEL,0,0,10,0,10
2016,Libya,LBY,Belgium,BEL,13,26,0,0,39
2016,Lebanon,LBN,Belgium,BEL,10,0,27,21,58
2016,Sri Lanka,LKA,Belgium,BEL,46,0,13,0,59
2016,Mauritania,MRT,Belgium,BEL,32,0,41,0,73
2016,North Macedonia,MKD,Belgium,BEL,16,0,24,58,98
2016,Rep. of Moldova,MDA,Belgium,BEL,0,0,10,0,10
2016,Mali,MLI,Belgium,BEL,5,0,12,5,22
2016,Mongolia,MNG,Belgium,BEL,0,0,5,0,5
2016,Morocco,MAR,Belgium,BEL,16,0,87,15,118
2016,Montenegro,MNE,Belgium,BEL,0,0,5,0,5
2016,Myanmar,MMR,Belgium,BEL,5,0,5,0,10
2016,Nepal,NPL,Belgium,BEL,0,0,10,0,10
2016,Niger,NER,Belgium,BEL,19,0,40,5,64
2016,Nigeria,NGA,Belgium,BEL,11,0,61,10,82
2016,Pakistan,PAK,Belgium,BEL,54,0,184,18,256
2016,Romania,ROU,Belgium,BEL,0,0,0,5,5
2016,Russian Federation,RUS,Belgium,BEL,197,5,246,24,472
2016,Rwanda,RWA,Belgium,BEL,77,0,97,10,184
2016,El Salvador,SLV,Belgium,BEL,5,0,0,0,5
2016,Serbia and Kosovo: S/RES/1244 (1999),SRB,Belgium,BEL,39,0,111,155,305
2016,Senegal,SEN,Belgium,BEL,60,0,97,5,162
2016,Sierra Leone,SLE,Belgium,BEL,0,0,11,0,11
2016,Somalia,SOM,Belgium,BEL,767,209,341,21,1338
2016,Sudan,SDN,Belgium,BEL,79,0,22,5,106
2016,Suriname,SUR,Belgium,BEL,0,0,5,0,5
2016,Slovakia,SVK,Belgium,BEL,0,0,0,23,23
2016,Syrian Arab Rep.,SYR,Belgium,BEL,5429,1619,76,207,7331
2016,United Rep. of Tanzania,TZA,Belgium,BEL,5,0,0,0,5
2016,Togo,TGO,Belgium,BEL,18,0,91,5,114
2016,Tunisia,TUN,Belgium,BEL,10,0,39,0,49
2016,Turkey,TUR,Belgium,BEL,13,0,40,5,58
2016,Uganda,UGA,Belgium,BEL,0,0,5,0,5
2016,Ukraine,UKR,Belgium,BEL,56,5,109,11,181
2016,Uzbekistan,UZB,Belgium,BEL,12,0,10,0,22
2016,Venezuela (Bolivarian Republic of),VEN,Belgium,BEL,5,0,11,0,16
2016,Yemen,YEM,Belgium,BEL,0,13,0,0,13
2016,Zimbabwe,ZWE,Belgium,BEL,0,0,5,0,5
2016,Stateless,XXA,Belgium,BEL,14,0,0,0,14
2016,Central African Rep.,CAF,Benin,BEN,257,0,5,5,267
2016,Cote d'Ivoire,CIV,Benin,BEN,11,0,0,0,11
2016,Mali,MLI,Benin,BEN,0,0,0,5,5
2016,Afghanistan,AFG,Belarus,BLR,0,0,5,14,19
2016,Azerbaijan,AZE,Belarus,BLR,0,0,0,5,5
2016,Georgia,GEO,Belarus,BLR,0,0,5,0,5
2016,Iran (Islamic Rep. of),IRN,Belarus,BLR,0,0,10,0,10
2016,Iraq,IRQ,Belarus,BLR,0,5,10,19,34
2016,Kazakhstan,KAZ,Belarus,BLR,0,5,0,0,5
2016,Lebanon,LBN,Belarus,BLR,0,0,0,5,5
2016,Sri Lanka,LKA,Belarus,BLR,0,0,0,5,5
2016,Pakistan,PAK,Belarus,BLR,0,0,5,0,5
2016,Russian Federation,RUS,Belarus,BLR,0,0,0,5,5
2016,Syrian Arab Rep.,SYR,Belarus,BLR,0,14,0,5,19
2016,Tajikistan,TJK,Belarus,BLR,0,0,0,12,12
2016,Ukraine,UKR,Belarus,BLR,0,560,18,84,662
2016,Yemen,YEM,Belarus,BLR,0,18,0,5,23
2016,Colombia,COL,Bolivia (Plurinational State of),BOL,0,0,5,0,5
2016,Syrian Arab Rep.,SYR,Bolivia (Plurinational State of),BOL,5,0,0,0,5
2016,Burundi,BDI,Botswana,BWA,0,0,41,10,51
2016,Dem. Rep. of the Congo,COD,Botswana,BWA,5,0,136,28,169
2016,Somalia,SOM,Botswana,BWA,0,0,5,0,5
2016,Zimbabwe,ZWE,Botswana,BWA,0,0,10,0,10
2016,Afghanistan,AFG,Brazil,BRA,17,5,0,0,22
2016,Angola,AGO,Brazil,BRA,26,5,61,0,92
2016,Egypt,EGY,Brazil,BRA,0,0,13,0,13
2016,Benin,BEN,Brazil,BRA,0,0,14,0,14
2016,Bangladesh,BGD,Brazil,BRA,5,0,33,0,38
2016,Burkina Faso,BFA,Brazil,BRA,0,0,10,0,10
2016,China,CHN,Brazil,BRA,0,0,5,0,5
2016,Cameroon,CMR,Brazil,BRA,20,0,5,0,25
2016,Congo,COG,Brazil,BRA,5,0,0,0,5
2016,Dem. Rep. of the Congo,COD,Brazil,BRA,189,30,19,0,238
2016,Colombia,COL,Brazil,BRA,13,0,5,0,18
2016,Cuba,CUB,Brazil,BRA,5,0,37,0,42
2016,Cabo Verde,CPV,Brazil,BRA,0,0,15,0,15
2016,Dominican Rep.,DOM,Brazil,BRA,0,0,26,0,26
2016,Gambia,GMB,Brazil,BRA,0,0,21,0,21
2016,Palestinian,PSE,Brazil,BRA,54,10,0,0,64
2016,Ghana,GHA,Brazil,BRA,14,0,131,0,145
2016,Guinea-Bissau,GNB,Brazil,BRA,5,0,98,0,103
2016,Guinea,GIN,Brazil,BRA,21,5,5,0,31
2016,Cote d'Ivoire,CIV,Brazil,BRA,5,0,0,0,5
2016,India,IND,Brazil,BRA,0,0,13,0,13
2016,Iran (Islamic Rep. of),IRN,Brazil,BRA,5,0,0,0,5
2016,Iraq,IRQ,Brazil,BRA,18,0,0,0,18
2016,Jordan,JOR,Brazil,BRA,0,0,5,0,5
2016,Lebanon,LBN,Brazil,BRA,10,0,11,0,21
2016,Mali,MLI,Brazil,BRA,0,0,19,0,19
2016,Morocco,MAR,Brazil,BRA,5,0,0,0,5
2016,Mozambique,MOZ,Brazil,BRA,0,0,5,0,5
2016,Nigeria,NGA,Brazil,BRA,16,0,33,0,49
2016,Pakistan,PAK,Brazil,BRA,100,5,12,0,117
2016,Philippines,PHL,Brazil,BRA,0,0,16,0,16
2016,Portugal,PRT,Brazil,BRA,0,0,5,0,5
2016,South Africa,ZAF,Brazil,BRA,0,0,5,0,5
2016,Russian Federation,RUS,Brazil,BRA,5,0,0,0,5
2016,El Salvador,SLV,Brazil,BRA,5,0,0,0,5
2016,Senegal,SEN,Brazil,BRA,5,0,175,0,180
2016,Sierra Leone,SLE,Brazil,BRA,10,0,12,0,22
2016,Sao Tome and Principe,STP,Brazil,BRA,0,0,5,0,5
2016,Sudan,SDN,Brazil,BRA,10,0,0,0,10
2016,Syrian Arab Rep.,SYR,Brazil,BRA,322,14,0,0,336
2016,United Rep. of Tanzania,TZA,Brazil,BRA,5,0,0,0,5
2016,Togo,TGO,Brazil,BRA,12,0,16,0,28
2016,Tunisia,TUN,Brazil,BRA,0,0,5,0,5
2016,Turkey,TUR,Brazil,BRA,5,0,0,0,5
2016,Uganda,UGA,Brazil,BRA,5,0,0,0,5
2016,Ukraine,UKR,Brazil,BRA,5,0,0,0,5
2016,Venezuela (Bolivarian Republic of),VEN,Brazil,BRA,14,0,28,0,42
2016,Stateless,XXA,Brazil,BRA,5,0,0,0,5
2016,Armenia,ARM,Bosnia and Herzegovina,BIH,0,0,0,5,5
2016,Iraq,IRQ,Bosnia and Herzegovina,BIH,0,5,0,0,5
2016,Pakistan,PAK,Bosnia and Herzegovina,BIH,0,0,0,10,10
2016,Serbia and Kosovo: S/RES/1244 (1999),SRB,Bosnia and Herzegovina,BIH,0,0,0,5,5
2016,Sierra Leone,SLE,Bosnia and Herzegovina,BIH,0,0,0,5,5
2016,Syrian Arab Rep.,SYR,Bosnia and Herzegovina,BIH,0,5,0,5,10
2016,Afghanistan,AFG,Bulgaria,BGR,0,10,431,0,441
2016,Algeria,DZA,Bulgaria,BGR,0,0,5,0,5
2016,Egypt,EGY,Bulgaria,BGR,0,0,5,0,5
2016,Armenia,ARM,Bulgaria,BGR,0,0,13,0,13
2016,Bangladesh,BGD,Bulgaria,BGR,0,0,5,0,5
2016,China,CHN,Bulgaria,BGR,0,0,5,0,5
2016,Cameroon,CMR,Bulgaria,BGR,0,0,5,0,5
2016,Iran (Islamic Rep. of),IRN,Bulgaria,BGR,5,0,38,0,43
2016,Iraq,IRQ,Bulgaria,BGR,36,38,278,0,352
2016,Kyrgyzstan,KGZ,Bulgaria,BGR,0,0,5,0,5
2016,Lebanon,LBN,Bulgaria,BGR,0,11,0,0,11
2016,Sri Lanka,LKA,Bulgaria,BGR,0,0,5,0,5
2016,Mali,MLI,Bulgaria,BGR,0,0,5,0,5
2016,Morocco,MAR,Bulgaria,BGR,0,0,10,0,10
2016,Nigeria,NGA,Bulgaria,BGR,0,0,5,0,5
2016,Pakistan,PAK,Bulgaria,BGR,0,0,63,0,63
2016,Russian Federation,RUS,Bulgaria,BGR,0,0,17,0,17
2016,Somalia,SOM,Bulgaria,BGR,5,0,5,0,10
2016,Syrian Arab Rep.,SYR,Bulgaria,BGR,689,520,67,0,1276
2016,Tunisia,TUN,Bulgaria,BGR,0,0,5,0,5
2016,Turkey,TUR,Bulgaria,BGR,0,0,5,0,5
2016,Ukraine,UKR,Bulgaria,BGR,0,0,34,0,34
2016,Yemen,YEM,Bulgaria,BGR,10,0,0,0,10
2016,Stateless,XXA,Bulgaria,BGR,12,10,5,0,27
2016,Pakistan,PAK,Cambodia,KHM,5,0,0,0,5
2016,Viet Nam,VNM,Cambodia,KHM,0,0,34,18,52
2016,Afghanistan,AFG,Canada,CAN,469,0,84,22,575
2016,Albania,ALB,Canada,CAN,77,0,79,10,166
2016,Algeria,DZA,Canada,CAN,25,0,33,5,63
2016,Angola,AGO,Canada,CAN,13,0,10,0,23
2016,Antigua and Barbuda,ATG,Canada,CAN,10,0,14,0,24
2016,Egypt,EGY,Canada,CAN,185,0,29,5,219
2016,Argentina,ARG,Canada,CAN,0,0,5,0,5
2016,Armenia,ARM,Canada,CAN,5,0,0,0,5
2016,Azerbaijan,AZE,Canada,CAN,59,0,10,0,69
2016,Bahrain,BHR,Canada,CAN,10,0,0,0,10
2016,Barbados,BRB,Canada,CAN,29,0,5,0,34
2016,Burundi,BDI,Canada,CAN,379,0,21,5,405
2016,Belgium,BEL,Canada,CAN,0,0,11,0,11
2016,Benin,BEN,Canada,CAN,12,0,5,0,17
2016,Bangladesh,BGD,Canada,CAN,134,0,67,15,216
2016,Bahamas,BHS,Canada,CAN,44,0,37,5,86
2016,Burkina Faso,BFA,Canada,CAN,21,0,15,0,36
2016,Belarus,BLR,Canada,CAN,5,0,0,0,5
2016,Bolivia (Plurinational State of),BOL,Canada,CAN,5,0,0,0,5
2016,Botswana,BWA,Canada,CAN,5,0,0,0,5
2016,Brazil,BRA,Canada,CAN,5,0,10,5,20
2016,Bosnia and Herzegovina,BIH,Canada,CAN,0,0,5,0,5
2016,Bulgaria,BGR,Canada,CAN,5,0,0,0,5
2016,Cambodia,KHM,Canada,CAN,12,0,0,0,12
2016,Central African Rep.,CAF,Canada,CAN,12,0,0,0,12
2016,Chad,TCD,Canada,CAN,76,0,28,5,109
2016,China,CHN,Canada,CAN,360,0,615,110,1085
2016,Chile,CHL,Canada,CAN,5,0,31,0,36
2016,Cameroon,CMR,Canada,CAN,120,0,54,5,179
2016,Congo,COG,Canada,CAN,50,0,14,0,64
2016,Dem. Rep. of the Congo,COD,Canada,CAN,162,0,126,10,298
2016,Colombia,COL,Canada,CAN,352,0,190,27,569
2016,Costa Rica,CRI,Canada,CAN,0,0,12,0,12
2016,Cuba,CUB,Canada,CAN,29,0,24,5,58
2016,Czechia,CZE,Canada,CAN,38,0,21,26,85
2016,Djibouti,DJI,Canada,CAN,105,0,10,0,115
2016,Dominican Rep.,DOM,Canada,CAN,18,0,11,5,34
2016,Ecuador,ECU,Canada,CAN,5,0,5,0,10
2016,Eritrea,ERI,Canada,CAN,269,0,47,15,331
2016,Ethiopia,ETH,Canada,CAN,225,0,79,10,314
2016,France,FRA,Canada,CAN,0,0,5,5,10
2016,Gambia,GMB,Canada,CAN,13,0,5,0,18
2016,Palestinian,PSE,Canada,CAN,132,0,24,5,161
2016,Georgia,GEO,Canada,CAN,32,0,28,5,65
2016,Germany,DEU,Canada,CAN,0,0,5,0,5
2016,Ghana,GHA,Canada,CAN,37,0,35,5,77
2016,Greece,GRC,Canada,CAN,0,0,5,0,5
2016,Guatemala,GTM,Canada,CAN,21,0,36,5,62
2016,Guinea,GIN,Canada,CAN,27,0,21,0,48
2016,Guyana,GUY,Canada,CAN,5,0,17,5,27
2016,Haiti,HTI,Canada,CAN,207,0,193,10,410
2016,"China, Hong Kong SAR",HKG,Canada,CAN,0,0,5,0,5
2016,Honduras,HND,Canada,CAN,86,0,49,5,140
2016,Croatia,HRV,Canada,CAN,15,0,17,29,61
2016,Hungary,HUN,Canada,CAN,567,0,223,133,923
2016,Cote d'Ivoire,CIV,Canada,CAN,24,0,10,0,34
2016,India,IND,Canada,CAN,169,0,239,128,536
2016,Indonesia,IDN,Canada,CAN,14,0,5,0,19
2016,Ireland,IRL,Canada,CAN,0,0,10,0,10
2016,Iran (Islamic Rep. of),IRN,Canada,CAN,131,0,27,16,174
2016,Iraq,IRQ,Canada,CAN,577,0,133,30,740
2016,Israel,ISR,Canada,CAN,15,0,21,10,46
2016,Italy,ITA,Canada,CAN,0,0,32,0,32
2016,Jamaica,JAM,Canada,CAN,72,0,72,5,149
2016,Jordan,JOR,Canada,CAN,37,0,41,0,78
2016,Japan,JPN,Canada,CAN,0,0,5,0,5
2016,Kazakhstan,KAZ,Canada,CAN,13,0,0,5,18
2016,Kenya,KEN,Canada,CAN,21,0,16,0,37
2016,Kyrgyzstan,KGZ,Canada,CAN,15,0,5,0,20
2016,Rep. of Korea,KOR,Canada,CAN,14,0,0,0,14
2016,Dem. People's Rep. of Korea,PRK,Canada,CAN,0,0,0,5,5
2016,Kuwait,KWT,Canada,CAN,0,0,14,0,14
2016,Liberia,LBR,Canada,CAN,5,0,0,0,5
2016,Libya,LBY,Canada,CAN,252,0,40,5,297
2016,Saint Lucia,LCA,Canada,CAN,5,0,11,5,21
2016,Lebanon,LBN,Canada,CAN,142,0,101,14,257
2016,Sri Lanka,LKA,Canada,CAN,131,0,32,13,176
2016,Mauritania,MRT,Canada,CAN,26,0,13,0,39
2016,North Macedonia,MKD,Canada,CAN,5,0,0,0,5
2016,Rep. of Moldova,MDA,Canada,CAN,5,0,5,0,10
2016,Mexico,MEX,Canada,CAN,29,0,60,48,137
2016,Mali,MLI,Canada,CAN,32,0,52,5,89
2016,Malaysia,MYS,Canada,CAN,0,0,5,0,5
2016,Mongolia,MNG,Canada,CAN,20,0,14,0,34
2016,Morocco,MAR,Canada,CAN,16,0,10,0,26
2016,Montenegro,MNE,Canada,CAN,0,0,0,5,5
2016,Mauritius,MUS,Canada,CAN,0,0,5,0,5
2016,Myanmar,MMR,Canada,CAN,5,0,0,0,5
2016,Namibia,NAM,Canada,CAN,0,0,0,5,5
2016,Nepal,NPL,Canada,CAN,79,0,36,5,120
2016,Niger,NER,Canada,CAN,0,0,5,0,5
2016,Nicaragua,NIC,Canada,CAN,5,0,0,0,5
2016,Nigeria,NGA,Canada,CAN,389,0,475,17,881
2016,Norway,NOR,Canada,CAN,0,0,0,5,5
2016,Pakistan,PAK,Canada,CAN,542,0,166,22,730
2016,Peru,PER,Canada,CAN,10,0,20,5,35
2016,Philippines,PHL,Canada,CAN,0,0,11,0,11
2016,Poland,POL,Canada,CAN,12,0,10,10,32
2016,Portugal,PRT,Canada,CAN,0,0,0,5,5
2016,Romania,ROU,Canada,CAN,5,0,0,13,18
2016,South Africa,ZAF,Canada,CAN,11,0,15,5,31
2016,Russian Federation,RUS,Canada,CAN,58,0,13,10,81
2016,Rwanda,RWA,Canada,CAN,42,0,22,5,69
2016,El Salvador,SLV,Canada,CAN,152,0,58,5,215
2016,Saudi Arabia,SAU,Canada,CAN,73,0,18,5,96
2016,Serbia and Kosovo: S/RES/1244 (1999),SRB,Canada,CAN,12,0,23,5,40
2016,Senegal,SEN,Canada,CAN,25,0,17,0,42
2016,Seychelles,SYC,Canada,CAN,5,0,0,0,5
2016,Sierra Leone,SLE,Canada,CAN,0,0,13,0,13
2016,Somalia,SOM,Canada,CAN,323,0,120,57,500
2016,Spain,ESP,Canada,CAN,0,0,10,0,10
2016,Sudan,SDN,Canada,CAN,100,0,29,5,134
2016,South Sudan,SSD,Canada,CAN,5,0,0,0,5
2016,Slovakia,SVK,Canada,CAN,188,0,65,117,370
2016,Sweden,SWE,Canada,CAN,0,0,5,5,10
2016,Syrian Arab Rep.,SYR,Canada,CAN,751,0,25,23,799
2016,United Rep. of Tanzania,TZA,Canada,CAN,20,0,5,0,25
2016,Thailand,THA,Canada,CAN,0,0,14,0,14
2016,Tajikistan,TJK,Canada,CAN,5,0,5,0,10
2016,Togo,TGO,Canada,CAN,31,0,5,0,36
2016,Tunisia,TUN,Canada,CAN,17,0,21,5,43
2016,Turkey,TUR,Canada,CAN,392,0,71,12,475
2016,United Arab Emirates,ARE,Canada,CAN,5,0,0,0,5
2016,Uganda,UGA,Canada,CAN,66,0,22,0,88
2016,Ukraine,UKR,Canada,CAN,154,0,72,14,240
2016,United States of America,USA,Canada,CAN,0,0,67,30,97
2016,Uzbekistan,UZB,Canada,CAN,13,0,5,5,23
2016,Saint Vincent and the Grenadines,VCT,Canada,CAN,14,0,14,11,39
2016,Venezuela (Bolivarian Republic of),VEN,Canada,CAN,275,0,86,5,366
2016,Yemen,YEM,Canada,CAN,159,0,15,5,179
2016,Zambia,ZMB,Canada,CAN,0,0,5,0,5
2016,Zimbabwe,ZWE,Canada,CAN,55,0,42,0,97
2016,Stateless,XXA,Canada,CAN,5,0,0,0,5
2016,Chad,TCD,Central African Rep.,CAF,0,0,0,28,28
2016,Cameroon,CMR,Central African Rep.,CAF,0,0,0,10,10
2016,Dem. Rep. of the Congo,COD,Central African Rep.,CAF,0,0,0,62,62
2016,Rwanda,RWA,Central African Rep.,CAF,0,0,0,5,5
2016,Sudan,SDN,Central African Rep.,CAF,0,0,0,5,5
2016,Syrian Arab Rep.,SYR,Central African Rep.,CAF,0,0,0,10,10
2016,Cuba,CUB,Cayman Islands,CYM,10,0,146,0,156
2016,Mexico,MEX,Cayman Islands,CYM,0,0,5,0,5
2016,Colombia,COL,Chile,CHL,22,0,11,63,96
2016,Dominican Rep.,DOM,Chile,CHL,0,0,14,5,19
2016,El Salvador,SLV,Chile,CHL,5,0,0,0,5
2016,Syrian Arab Rep.,SYR,Chile,CHL,5,0,0,5,10
2016,Ukraine,UKR,Chile,CHL,0,0,0,5,5
2016,Burundi,BDI,Dem. Rep. of the Congo,COD,10,0,0,0,10
2016,Central African Rep.,CAF,Dem. Rep. of the Congo,COD,5,0,0,0,5
2016,Chad,TCD,Dem. Rep. of the Congo,COD,0,0,10,13,23
2016,Cameroon,CMR,Dem. Rep. of the Congo,COD,0,0,13,10,23
2016,Guinea,GIN,Dem. Rep. of the Congo,COD,0,0,0,14,14
2016,Nigeria,NGA,Dem. Rep. of the Congo,COD,0,0,5,5,10
2016,Senegal,SEN,Dem. Rep. of the Congo,COD,0,0,0,5,5
2016,Syrian Arab Rep.,SYR,Dem. Rep. of the Congo,COD,5,0,0,0,5
2016,Afghanistan,AFG,Colombia,COL,5,0,0,0,5
2016,Cuba,CUB,Colombia,COL,10,0,0,40,50
2016,Honduras,HND,Colombia,COL,5,0,0,0,5
2016,Iraq,IRQ,Colombia,COL,5,0,0,0,5
2016,El Salvador,SLV,Colombia,COL,5,0,0,0,5
2016,Venezuela (Bolivarian Republic of),VEN,Colombia,COL,5,0,0,55,60
2016,Albania,ALB,Costa Rica,CRI,0,0,5,0,5
2016,Bangladesh,BGD,Costa Rica,CRI,0,0,0,26,26
2016,Canada,CAN,Costa Rica,CRI,0,0,0,5,5
2016,Cameroon,CMR,Costa Rica,CRI,0,0,0,5,5
2016,Dem. Rep. of the Congo,COD,Costa Rica,CRI,0,0,5,70,75
2016,Colombia,COL,Costa Rica,CRI,88,0,645,232,965
2016,Cuba,CUB,Costa Rica,CRI,5,0,37,102,144
2016,Eritrea,ERI,Costa Rica,CRI,0,0,0,17,17
2016,Ethiopia,ETH,Costa Rica,CRI,0,0,0,5,5
2016,Gambia,GMB,Costa Rica,CRI,0,0,0,5,5
2016,Ghana,GHA,Costa Rica,CRI,0,0,5,75,80
2016,Guatemala,GTM,Costa Rica,CRI,0,0,0,14,14
2016,Guinea,GIN,Costa Rica,CRI,0,0,5,15,20
2016,Haiti,HTI,Costa Rica,CRI,0,0,5,5,10
2016,Honduras,HND,Costa Rica,CRI,19,0,91,28,138
2016,Cote d'Ivoire,CIV,Costa Rica,CRI,0,0,0,10,10
2016,Iraq,IRQ,Costa Rica,CRI,0,0,0,5,5
2016,Mexico,MEX,Costa Rica,CRI,5,0,0,0,5
2016,Mali,MLI,Costa Rica,CRI,0,0,0,16,16
2016,Nepal,NPL,Costa Rica,CRI,0,0,0,60,60
2016,Niger,NER,Costa Rica,CRI,0,0,0,5,5
2016,Nicaragua,NIC,Costa Rica,CRI,10,0,39,12,61
2016,Pakistan,PAK,Costa Rica,CRI,0,0,0,26,26
2016,Panama,PAN,Costa Rica,CRI,0,0,5,0,5
2016,El Salvador,SLV,Costa Rica,CRI,268,0,1058,264,1590
2016,Senegal,SEN,Costa Rica,CRI,0,0,0,15,15
2016,Somalia,SOM,Costa Rica,CRI,0,0,0,23,23
2016,Viet Nam,VNM,Costa Rica,CRI,0,0,10,0,10
2016,Syrian Arab Rep.,SYR,Costa Rica,CRI,0,0,0,5,5
2016,Togo,TGO,Costa Rica,CRI,0,0,0,14,14
2016,Ukraine,UKR,Costa Rica,CRI,5,0,0,0,5
2016,United States of America,USA,Costa Rica,CRI,0,0,5,0,5
2016,Venezuela (Bolivarian Republic of),VEN,Costa Rica,CRI,134,0,401,72,607
2016,Zambia,ZMB,Costa Rica,CRI,0,0,0,5,5
2016,Afghanistan,AFG,Cyprus,CYP,0,0,0,10,10
2016,Egypt,EGY,Cyprus,CYP,5,0,69,22,96
2016,Bangladesh,BGD,Cyprus,CYP,0,0,35,34,69
2016,Cameroon,CMR,Cyprus,CYP,11,0,0,0,11
2016,Dem. Rep. of the Congo,COD,Cyprus,CYP,0,0,5,0,5
2016,Comoros,COM,Cyprus,CYP,0,0,5,0,5
2016,Eritrea,ERI,Cyprus,CYP,5,0,0,0,5
2016,Ethiopia,ETH,Cyprus,CYP,0,0,0,5,5
2016,Gambia,GMB,Cyprus,CYP,0,0,5,0,5
2016,Palestinian,PSE,Cyprus,CYP,75,10,56,32,173
2016,Georgia,GEO,Cyprus,CYP,0,0,0,5,5
2016,Ghana,GHA,Cyprus,CYP,0,0,0,5,5
2016,Guinea,GIN,Cyprus,CYP,0,0,0,5,5
2016,Cote d'Ivoire,CIV,Cyprus,CYP,5,0,0,0,5
2016,India,IND,Cyprus,CYP,0,0,96,51,147
2016,Iran (Islamic Rep. of),IRN,Cyprus,CYP,10,0,5,17,32
2016,Iraq,IRQ,Cyprus,CYP,20,23,13,5,61
2016,Jordan,JOR,Cyprus,CYP,0,0,5,0,5
2016,Lebanon,LBN,Cyprus,CYP,0,0,16,11,27
2016,Sri Lanka,LKA,Cyprus,CYP,0,0,40,10,50
2016,Nepal,NPL,Cyprus,CYP,0,0,0,13,13
2016,Nigeria,NGA,Cyprus,CYP,0,0,11,0,11
2016,Pakistan,PAK,Cyprus,CYP,0,0,123,67,190
2016,Philippines,PHL,Cyprus,CYP,0,0,21,10,31
2016,Russian Federation,RUS,Cyprus,CYP,5,0,0,0,5
2016,Somalia,SOM,Cyprus,CYP,27,0,28,51,106
2016,Viet Nam,VNM,Cyprus,CYP,0,0,120,25,145
2016,Syrian Arab Rep.,SYR,Cyprus,CYP,47,1052,0,0,1099
2016,Turkey,TUR,Cyprus,CYP,0,0,5,11,16
2016,Ukraine,UKR,Cyprus,CYP,0,0,0,24,24
2016,Zimbabwe,ZWE,Cyprus,CYP,0,0,0,5,5
2016,Afghanistan,AFG,Czechia,CZE,5,16,0,12,33
2016,Algeria,DZA,Czechia,CZE,0,0,0,5,5
2016,Egypt,EGY,Czechia,CZE,0,0,0,5,5
2016,Armenia,ARM,Czechia,CZE,5,5,40,5,55
2016,Azerbaijan,AZE,Czechia,CZE,5,0,0,13,18
2016,Belarus,BLR,Czechia,CZE,0,13,0,0,13
2016,China,CHN,Czechia,CZE,0,0,0,5,5
2016,Cameroon,CMR,Czechia,CZE,0,0,0,5,5
2016,Dem. Rep. of the Congo,COD,Czechia,CZE,5,0,5,0,10
2016,Cuba,CUB,Czechia,CZE,0,44,0,24,68
2016,Eritrea,ERI,Czechia,CZE,0,5,0,0,5
2016,Ethiopia,ETH,Czechia,CZE,0,0,0,5,5
2016,Georgia,GEO,Czechia,CZE,0,0,34,13,47
2016,Ghana,GHA,Czechia,CZE,0,0,0,5,5
2016,Iran (Islamic Rep. of),IRN,Czechia,CZE,0,0,5,0,5
2016,Iraq,IRQ,Czechia,CZE,101,49,0,26,176
2016,Kazakhstan,KAZ,Czechia,CZE,0,0,14,0,14
2016,Kyrgyzstan,KGZ,Czechia,CZE,5,0,5,11,21
2016,Libya,LBY,Czechia,CZE,0,0,0,5,5
2016,Lebanon,LBN,Czechia,CZE,0,5,0,0,5
2016,Sri Lanka,LKA,Czechia,CZE,0,0,0,5,5
2016,Rep. of Moldova,MDA,Czechia,CZE,0,0,5,5,10
2016,Mongolia,MNG,Czechia,CZE,0,0,0,5,5
2016,Nigeria,NGA,Czechia,CZE,0,0,5,20,25
2016,Pakistan,PAK,Czechia,CZE,0,0,0,5,5
2016,Russian Federation,RUS,Czechia,CZE,5,5,26,17,53
2016,Serbia and Kosovo: S/RES/1244 (1999),SRB,Czechia,CZE,0,0,0,5,5
2016,Viet Nam,VNM,Czechia,CZE,0,0,56,16,72
2016,Slovakia,SVK,Czechia,CZE,0,0,0,5,5
2016,Syrian Arab Rep.,SYR,Czechia,CZE,5,89,0,10,104
2016,Turkmenistan,TKM,Czechia,CZE,5,0,0,0,5
2016,Tunisia,TUN,Czechia,CZE,0,0,0,5,5
2016,Turkey,TUR,Czechia,CZE,0,0,0,12,12
2016,Ukraine,UKR,Czechia,CZE,5,46,306,180,537
2016,Uzbekistan,UZB,Czechia,CZE,0,5,0,0,5
2016,Yemen,YEM,Czechia,CZE,0,10,0,0,10
2016,Stateless,XXA,Czechia,CZE,0,14,5,5,24
2016,Afghanistan,AFG,Denmark,DNK,43,187,654,0,884
2016,Albania,ALB,Denmark,DNK,0,0,59,0,59
2016,Algeria,DZA,Denmark,DNK,0,0,19,0,19
2016,Egypt,EGY,Denmark,DNK,0,0,16,0,16
2016,Armenia,ARM,Denmark,DNK,0,0,57,0,57
2016,Azerbaijan,AZE,Denmark,DNK,5,0,11,0,16
2016,Bangladesh,BGD,Denmark,DNK,0,0,15,0,15
2016,Belarus,BLR,Denmark,DNK,0,0,14,0,14
2016,Bosnia and Herzegovina,BIH,Denmark,DNK,0,0,18,0,18
2016,Bulgaria,BGR,Denmark,DNK,0,0,5,0,5
2016,China,CHN,Denmark,DNK,0,0,20,0,20
2016,Dem. Rep. of the Congo,COD,Denmark,DNK,5,0,5,0,10
2016,Eritrea,ERI,Denmark,DNK,501,28,22,0,551
2016,Ethiopia,ETH,Denmark,DNK,12,0,53,0,65
2016,Gambia,GMB,Denmark,DNK,0,0,5,0,5
2016,Georgia,GEO,Denmark,DNK,0,0,15,0,15
2016,Iran (Islamic Rep. of),IRN,Denmark,DNK,370,22,636,0,1028
2016,Iraq,IRQ,Denmark,DNK,36,23,394,0,453
2016,Jordan,JOR,Denmark,DNK,0,0,5,0,5
2016,Libya,LBY,Denmark,DNK,0,0,15,0,15
2016,Lebanon,LBN,Denmark,DNK,0,5,30,0,35
2016,Sri Lanka,LKA,Denmark,DNK,0,0,12,0,12
2016,North Macedonia,MKD,Denmark,DNK,0,0,23,0,23
2016,Morocco,MAR,Denmark,DNK,0,0,38,0,38
2016,Myanmar,MMR,Denmark,DNK,0,0,10,0,10
2016,Nigeria,NGA,Denmark,DNK,0,0,32,0,32
2016,Pakistan,PAK,Denmark,DNK,0,0,18,0,18
2016,Romania,ROU,Denmark,DNK,0,0,5,0,5
2016,Russian Federation,RUS,Denmark,DNK,10,0,76,0,86
2016,Rwanda,RWA,Denmark,DNK,0,0,5,0,5
2016,El Salvador,SLV,Denmark,DNK,0,0,5,0,5
2016,Serbia and Kosovo: S/RES/1244 (1999),SRB,Denmark,DNK,0,0,63,0,63
2016,Somalia,SOM,Denmark,DNK,0,39,85,0,124
2016,Viet Nam,VNM,Denmark,DNK,0,0,5,0,5
2016,Sudan,SDN,Denmark,DNK,0,0,42,0,42
2016,Syrian Arab Rep.,SYR,Denmark,DNK,3050,2195,42,0,5287
2016,Tunisia,TUN,Denmark,DNK,0,0,10,0,10
2016,Turkey,TUR,Denmark,DNK,0,0,10,0,10
2016,Uganda,UGA,Denmark,DNK,5,0,19,0,24
2016,Ukraine,UKR,Denmark,DNK,0,0,42,0,42
2016,United States of America,USA,Denmark,DNK,0,0,5,0,5
2016,Yemen,YEM,Denmark,DNK,0,0,11,0,11
2016,Stateless,XXA,Denmark,DNK,234,308,121,0,663
2016,Afghanistan,AFG,Estonia,EST,5,0,0,0,5
2016,Armenia,ARM,Estonia,EST,0,0,5,0,5
2016,Cameroon,CMR,Estonia,EST,0,0,5,0,5
2016,Georgia,GEO,Estonia,EST,5,0,0,0,5
2016,Iran (Islamic Rep. of),IRN,Estonia,EST,0,0,10,0,10
2016,Iraq,IRQ,Estonia,EST,14,12,0,5,31
2016,Sri Lanka,LKA,Estonia,EST,5,0,0,0,5
2016,Nigeria,NGA,Estonia,EST,0,0,5,0,5
2016,Russian Federation,RUS,Estonia,EST,12,0,0,0,12
2016,Sudan,SDN,Estonia,EST,5,0,0,0,5
2016,Syrian Arab Rep.,SYR,Estonia,EST,31,28,0,0,59
2016,Ukraine,UKR,Estonia,EST,0,22,13,5,40
2016,Afghanistan,AFG,Finland,FIN,449,490,3448,765,5152
2016,Albania,ALB,Finland,FIN,0,0,141,45,186
2016,Algeria,DZA,Finland,FIN,0,0,28,43,71
2016,Angola,AGO,Finland,FIN,0,0,5,5,10
2016,Egypt,EGY,Finland,FIN,5,0,18,5,28
2016,Armenia,ARM,Finland,FIN,0,0,5,0,5
2016,Azerbaijan,AZE,Finland,FIN,19,0,5,0,24
2016,Burundi,BDI,Finland,FIN,5,0,0,0,5
2016,Bangladesh,BGD,Finland,FIN,0,0,86,53,139
2016,Belarus,BLR,Finland,FIN,5,0,11,33,49
2016,Bosnia and Herzegovina,BIH,Finland,FIN,0,0,12,5,17
2016,Bulgaria,BGR,Finland,FIN,0,0,0,5,5
2016,China,CHN,Finland,FIN,11,0,0,0,11
2016,Cameroon,CMR,Finland,FIN,28,0,73,11,112
2016,Dem. Rep. of the Congo,COD,Finland,FIN,5,5,26,5,41
2016,Colombia,COL,Finland,FIN,0,0,0,5,5
2016,Cuba,CUB,Finland,FIN,0,0,0,5,5
2016,Eritrea,ERI,Finland,FIN,313,0,0,10,323
2016,Ethiopia,ETH,Finland,FIN,51,5,30,10,96
2016,Gambia,GMB,Finland,FIN,5,0,37,45,87
2016,Georgia,GEO,Finland,FIN,0,0,15,16,31
2016,Ghana,GHA,Finland,FIN,5,0,28,11,44
2016,Guinea,GIN,Finland,FIN,0,0,17,11,28
2016,Honduras,HND,Finland,FIN,0,5,0,0,5
2016,Cote d'Ivoire,CIV,Finland,FIN,0,0,12,5,17
2016,India,IND,Finland,FIN,0,0,78,97,175
2016,Iran (Islamic Rep. of),IRN,Finland,FIN,220,0,137,118,475
2016,Iraq,IRQ,Finland,FIN,2014,754,9510,3875,16153
2016,Israel,ISR,Finland,FIN,0,0,0,5,5
2016,Jordan,JOR,Finland,FIN,0,0,5,0,5
2016,Kazakhstan,KAZ,Finland,FIN,0,0,0,5,5
2016,Kenya,KEN,Finland,FIN,5,0,0,0,5
2016,Kyrgyzstan,KGZ,Finland,FIN,0,0,5,0,5
2016,Libya,LBY,Finland,FIN,5,5,5,13,28
2016,Lebanon,LBN,Finland,FIN,0,10,23,20,53
2016,Sri Lanka,LKA,Finland,FIN,5,0,37,0,42
2016,North Macedonia,MKD,Finland,FIN,0,0,17,5,22
2016,Rep. of Moldova,MDA,Finland,FIN,0,0,5,5,10
2016,Mexico,MEX,Finland,FIN,0,0,14,0,14
2016,Mali,MLI,Finland,FIN,0,0,0,13,13
2016,Morocco,MAR,Finland,FIN,14,5,58,75,152
2016,Myanmar,MMR,Finland,FIN,0,5,0,0,5
2016,Nepal,NPL,Finland,FIN,0,0,35,13,48
2016,Niger,NER,Finland,FIN,0,0,0,5,5
2016,Nigeria,NGA,Finland,FIN,10,0,134,74,218
2016,Pakistan,PAK,Finland,FIN,17,0,48,59,124
2016,Romania,ROU,Finland,FIN,0,0,5,0,5
2016,Russian Federation,RUS,Finland,FIN,52,0,102,48,202
2016,Rwanda,RWA,Finland,FIN,5,0,5,0,10
2016,El Salvador,SLV,Finland,FIN,0,5,0,0,5
2016,Serbia and Kosovo: S/RES/1244 (1999),SRB,Finland,FIN,0,0,92,33,125
2016,Senegal,SEN,Finland,FIN,0,0,5,12,17
2016,Somalia,SOM,Finland,FIN,321,105,977,139,1542
2016,Spain,ESP,Finland,FIN,0,0,5,0,5
2016,Viet Nam,VNM,Finland,FIN,5,0,0,5,10
2016,Sudan,SDN,Finland,FIN,11,0,12,11,34
2016,Slovakia,SVK,Finland,FIN,0,0,5,0,5
2016,Syrian Arab Rep.,SYR,Finland,FIN,779,336,5,123,1243
2016,United Rep. of Tanzania,TZA,Finland,FIN,0,0,5,0,5
2016,Tajikistan,TJK,Finland,FIN,0,0,0,5,5
2016,Togo,TGO,Finland,FIN,0,0,0,5,5
2016,Tunisia,TUN,Finland,FIN,0,0,10,15,25
2016,Turkey,TUR,Finland,FIN,0,0,39,25,64
2016,United Arab Emirates,ARE,Finland,FIN,0,0,0,5,5
2016,Uganda,UGA,Finland,FIN,12,0,0,0,12
2016,Ukraine,UKR,Finland,FIN,0,0,47,23,70
2016,United States of America,USA,Finland,FIN,5,0,0,5,10
2016,Uzbekistan,UZB,Finland,FIN,0,0,5,0,5
2016,Yemen,YEM,Finland,FIN,31,55,0,12,98
2016,Stateless,XXA,Finland,FIN,126,0,40,24,190
2016,Afghanistan,AFG,France,FRA,741,2529,773,0,4043
2016,Albania,ALB,France,FRA,75,328,3134,0,3537
2016,Algeria,DZA,France,FRA,95,68,2072,0,2235
2016,Angola,AGO,France,FRA,53,24,357,0,434
2016,Egypt,EGY,France,FRA,54,0,267,0,321
2016,Armenia,ARM,France,FRA,29,49,1013,0,1091
2016,Azerbaijan,AZE,France,FRA,53,16,367,0,436
2016,Burundi,BDI,France,FRA,138,0,10,0,148
2016,Benin,BEN,France,FRA,0,0,14,0,14
2016,Bangladesh,BGD,France,FRA,186,81,3486,0,3753
2016,Bhutan,BTN,France,FRA,0,0,5,0,5
2016,Burkina Faso,BFA,France,FRA,5,15,78,0,98
2016,Belarus,BLR,France,FRA,11,0,35,0,46
2016,Brazil,BRA,France,FRA,0,0,10,0,10
2016,Bosnia and Herzegovina,BIH,France,FRA,16,11,285,0,312
2016,Cambodia,KHM,France,FRA,0,0,18,0,18
2016,Central African Rep.,CAF,France,FRA,315,425,485,0,1225
2016,Chad,TCD,France,FRA,56,5,305,0,366
2016,China,CHN,France,FRA,779,0,1441,0,2220
2016,Cameroon,CMR,France,FRA,64,18,422,0,504
2016,Congo,COG,France,FRA,47,18,357,0,422
2016,Dem. Rep. of the Congo,COD,France,FRA,425,90,2780,0,3295
2016,Comoros,COM,France,FRA,31,5,156,0,192
2016,Colombia,COL,France,FRA,14,5,54,0,73
2016,Cuba,CUB,France,FRA,13,0,56,0,69
2016,Cabo Verde,CPV,France,FRA,0,0,5,0,5
2016,Djibouti,DJI,France,FRA,23,5,31,0,59
2016,Dominica,DMA,France,FRA,0,0,10,0,10
2016,Dominican Rep.,DOM,France,FRA,0,10,373,0,383
2016,Equatorial Guinea,GNQ,France,FRA,0,0,13,0,13
2016,Eritrea,ERI,France,FRA,709,0,887,0,1596
2016,Ethiopia,ETH,France,FRA,129,0,162,0,291
2016,Gabon,GAB,France,FRA,5,10,37,0,52
2016,Gambia,GMB,France,FRA,13,5,161,0,179
2016,Palestinian,PSE,France,FRA,134,5,42,0,181
2016,Georgia,GEO,France,FRA,42,66,966,0,1074
2016,Ghana,GHA,France,FRA,0,5,39,0,44
2016,Guinea-Bissau,GNB,France,FRA,5,0,95,0,100
2016,Guatemala,GTM,France,FRA,0,0,5,0,5
2016,Guinea,GIN,France,FRA,383,119,1256,0,1758
2016,Guyana,GUY,France,FRA,5,0,28,0,33
2016,Haiti,HTI,France,FRA,55,83,3913,0,4051
2016,Honduras,HND,France,FRA,0,5,0,0,5
2016,Croatia,HRV,France,FRA,0,0,5,0,5
2016,Cote d'Ivoire,CIV,France,FRA,170,62,1028,0,1260
2016,India,IND,France,FRA,5,5,89,0,99
2016,Iran (Islamic Rep. of),IRN,France,FRA,118,5,86,0,209
2016,Iraq,IRQ,France,FRA,1083,260,378,0,1721
2016,Israel,ISR,France,FRA,0,0,10,0,10
2016,Jordan,JOR,France,FRA,0,0,12,0,12
2016,Japan,JPN,France,FRA,0,0,5,0,5
2016,Kazakhstan,KAZ,France,FRA,10,5,70,0,85
2016,Kenya,KEN,France,FRA,15,0,46,0,61
2016,Kyrgyzstan,KGZ,France,FRA,5,0,21,0,26
2016,Kuwait,KWT,France,FRA,31,0,5,0,36
2016,Liberia,LBR,France,FRA,10,0,17,0,27
2016,Libya,LBY,France,FRA,111,27,105,0,243
2016,Saint Lucia,LCA,France,FRA,0,0,5,0,5
2016,Lebanon,LBN,France,FRA,10,0,42,0,52
2016,Sri Lanka,LKA,France,FRA,214,29,2010,0,2253
2016,Madagascar,MDG,France,FRA,5,5,79,0,89
2016,Mauritania,MRT,France,FRA,74,10,831,0,915
2016,North Macedonia,MKD,France,FRA,5,0,199,0,204
2016,Rep. of Moldova,MDA,France,FRA,0,0,22,0,22
2016,Mexico,MEX,France,FRA,0,5,5,0,10
2016,Mali,MLI,France,FRA,223,18,1480,0,1721
2016,Mongolia,MNG,France,FRA,12,11,102,0,125
2016,Morocco,MAR,France,FRA,64,5,274,0,343
2016,Mozambique,MOZ,France,FRA,0,0,5,0,5
2016,Montenegro,MNE,France,FRA,0,5,74,0,79
2016,Mauritius,MUS,France,FRA,0,0,14,0,14
2016,Myanmar,MMR,France,FRA,0,0,46,0,46
2016,Nepal,NPL,France,FRA,5,0,42,0,47
2016,Niger,NER,France,FRA,5,0,27,0,32
2016,Nigeria,NGA,France,FRA,141,48,1585,0,1774
2016,Pakistan,PAK,France,FRA,78,41,1737,0,1856
2016,Peru,PER,France,FRA,0,5,60,0,65
2016,Philippines,PHL,France,FRA,0,0,5,0,5
2016,Romania,ROU,France,FRA,0,0,5,0,5
2016,Russian Federation,RUS,France,FRA,288,119,1982,0,2389
2016,Rwanda,RWA,France,FRA,98,0,46,0,144
2016,El Salvador,SLV,France,FRA,0,11,5,0,16
2016,Saudi Arabia,SAU,France,FRA,5,0,0,0,5
2016,Serbia and Kosovo: S/RES/1244 (1999),SRB,France,FRA,124,212,2890,0,3226
2016,Senegal,SEN,France,FRA,96,18,354,0,468
2016,Sierra Leone,SLE,France,FRA,22,5,76,0,103
2016,Somalia,SOM,France,FRA,86,271,692,0,1049
2016,Viet Nam,VNM,France,FRA,5,0,20,0,25
2016,Sudan,SDN,France,FRA,2115,341,3354,0,5810
2016,Suriname,SUR,France,FRA,0,0,5,0,5
2016,South Sudan,SSD,France,FRA,5,0,13,0,18
2016,Syrian Arab Rep.,SYR,France,FRA,1916,1941,107,0,3964
2016,United Rep. of Tanzania,TZA,France,FRA,0,0,12,0,12
2016,Thailand,THA,France,FRA,0,0,5,0,5
2016,Tajikistan,TJK,France,FRA,5,0,5,0,10
2016,Togo,TGO,France,FRA,10,5,111,0,126
2016,Tunisia,TUN,France,FRA,21,11,198,0,230
2016,Turkey,TUR,France,FRA,98,21,1034,0,1153
2016,Uganda,UGA,France,FRA,11,0,5,0,16
2016,Ukraine,UKR,France,FRA,143,71,847,0,1061
2016,Uzbekistan,UZB,France,FRA,10,0,14,0,24
2016,Venezuela (Bolivarian Republic of),VEN,France,FRA,10,5,137,0,152
2016,Western Sahara,ESH,France,FRA,93,10,645,0,748
2016,Yemen,YEM,France,FRA,22,53,5,0,80
2016,Zimbabwe,ZWE,France,FRA,5,0,13,0,18
2016,Stateless,XXA,France,FRA,53,0,293,0,346
2016,Afghanistan,AFG,United Kingdom of Great Britain and Northern Ireland,GBR,512,313,1097,619,2541
2016,Albania,ALB,United Kingdom of Great Britain and Northern Ireland,GBR,17,219,800,316,1352
2016,Algeria,DZA,United Kingdom of Great Britain and Northern Ireland,GBR,12,5,102,40,159
2016,Angola,AGO,United Kingdom of Great Britain and Northern Ireland,GBR,5,5,37,5,52
2016,Egypt,EGY,United Kingdom of Great Britain and Northern Ireland,GBR,19,12,235,96,362
2016,Argentina,ARG,United Kingdom of Great Britain and Northern Ireland,GBR,0,0,5,0,5
2016,Armenia,ARM,United Kingdom of Great Britain and Northern Ireland,GBR,0,0,5,0,5
2016,Australia,AUS,United Kingdom of Great Britain and Northern Ireland,GBR,0,0,0,5,5
2016,Azerbaijan,AZE,United Kingdom of Great Britain and Northern Ireland,GBR,5,0,11,5,21
2016,Bahrain,BHR,United Kingdom of Great Britain and Northern Ireland,GBR,11,0,0,0,11
2016,Barbados,BRB,United Kingdom of Great Britain and Northern Ireland,GBR,0,0,10,0,10
2016,Burundi,BDI,United Kingdom of Great Britain and Northern Ireland,GBR,0,0,18,0,18
2016,Bangladesh,BGD,United Kingdom of Great Britain and Northern Ireland,GBR,70,11,1323,229,1633
2016,Burkina Faso,BFA,United Kingdom of Great Britain and Northern Ireland,GBR,0,0,5,0,5
2016,Belarus,BLR,United Kingdom of Great Britain and Northern Ireland,GBR,5,0,0,5,10
2016,Bolivia (Plurinational State of),BOL,United Kingdom of Great Britain and Northern Ireland,GBR,0,0,10,0,10
2016,Brazil,BRA,United Kingdom of Great Britain and Northern Ireland,GBR,0,0,16,10,26
2016,Bosnia and Herzegovina,BIH,United Kingdom of Great Britain and Northern Ireland,GBR,0,0,5,0,5
2016,Bulgaria,BGR,United Kingdom of Great Britain and Northern Ireland,GBR,0,0,5,0,5
2016,Canada,CAN,United Kingdom of Great Britain and Northern Ireland,GBR,5,0,5,0,10
2016,Central African Rep.,CAF,United Kingdom of Great Britain and Northern Ireland,GBR,0,0,0,5,5
2016,Chad,TCD,United Kingdom of Great Britain and Northern Ireland,GBR,0,0,5,0,5
2016,China,CHN,United Kingdom of Great Britain and Northern Ireland,GBR,16,14,565,231,826
2016,Cameroon,CMR,United Kingdom of Great Britain and Northern Ireland,GBR,22,5,85,12,124
2016,Congo,COG,United Kingdom of Great Britain and Northern Ireland,GBR,5,0,14,5,24
2016,Dem. Rep. of the Congo,COD,United Kingdom of Great Britain and Northern Ireland,GBR,44,13,112,11,180
2016,Comoros,COM,United Kingdom of Great Britain and Northern Ireland,GBR,0,0,0,5,5
2016,Colombia,COL,United Kingdom of Great Britain and Northern Ireland,GBR,0,0,5,0,5
2016,Dominica,DMA,United Kingdom of Great Britain and Northern Ireland,GBR,5,0,5,0,10
2016,Ecuador,ECU,United Kingdom of Great Britain and Northern Ireland,GBR,0,0,0,5,5
2016,Eritrea,ERI,United Kingdom of Great Britain and Northern Ireland,GBR,1007,250,517,131,1905
2016,Ethiopia,ETH,United Kingdom of Great Britain and Northern Ireland,GBR,185,18,164,25,392
2016,France,FRA,United Kingdom of Great Britain and Northern Ireland,GBR,0,0,5,0,5
2016,Gambia,GMB,United Kingdom of Great Britain and Northern Ireland,GBR,28,5,149,10,192
2016,Palestinian,PSE,United Kingdom of Great Britain and Northern Ireland,GBR,22,0,79,24,125
2016,Georgia,GEO,United Kingdom of Great Britain and Northern Ireland,GBR,0,0,35,10,45
2016,Germany,DEU,United Kingdom of Great Britain and Northern Ireland,GBR,0,0,5,0,5
2016,Ghana,GHA,United Kingdom of Great Britain and Northern Ireland,GBR,10,13,195,37,255
2016,Greece,GRC,United Kingdom of Great Britain and Northern Ireland,GBR,0,0,5,0,5
2016,Grenada,GRD,United Kingdom of Great Britain and Northern Ireland,GBR,0,0,5,0,5
2016,Guinea,GIN,United Kingdom of Great Britain and Northern Ireland,GBR,12,0,12,5,29
2016,Guyana,GUY,United Kingdom of Great Britain and Northern Ireland,GBR,0,0,5,0,5
2016,Honduras,HND,United Kingdom of Great Britain and Northern Ireland,GBR,0,0,5,0,5
2016,Cote d'Ivoire,CIV,United Kingdom of Great Britain and Northern Ireland,GBR,0,5,19,0,24
2016,India,IND,United Kingdom of Great Britain and Northern Ireland,GBR,5,5,1229,413,1652
2016,Indonesia,IDN,United Kingdom of Great Britain and Northern Ireland,GBR,0,0,5,5,10
2016,Iran (Islamic Rep. of),IRN,United Kingdom of Great Britain and Northern Ireland,GBR,1583,122,2185,611,4501
2016,Iraq,IRQ,United Kingdom of Great Britain and Northern Ireland,GBR,247,128,1948,800,3123
2016,Jamaica,JAM,United Kingdom of Great Britain and Northern Ireland,GBR,15,5,187,28,235
2016,Jordan,JOR,United Kingdom of Great Britain and Northern Ireland,GBR,0,0,10,10,20
2016,Kenya,KEN,United Kingdom of Great Britain and Northern Ireland,GBR,10,10,56,10,86
2016,Kyrgyzstan,KGZ,United Kingdom of Great Britain and Northern Ireland,GBR,0,0,5,5,10
2016,Rep. of Korea,KOR,United Kingdom of Great Britain and Northern Ireland,GBR,0,0,5,0,5
2016,Dem. People's Rep. of Korea,PRK,United Kingdom of Great Britain and Northern Ireland,GBR,0,0,22,5,27
2016,Kuwait,KWT,United Kingdom of Great Britain and Northern Ireland,GBR,47,0,32,5,84
2016,Liberia,LBR,United Kingdom of Great Britain and Northern Ireland,GBR,0,0,5,0,5
2016,Libya,LBY,United Kingdom of Great Britain and Northern Ireland,GBR,60,58,444,27,589
2016,Saint Lucia,LCA,United Kingdom of Great Britain and Northern Ireland,GBR,5,0,12,5,22
2016,Lebanon,LBN,United Kingdom of Great Britain and Northern Ireland,GBR,5,5,69,0,79
2016,Sri Lanka,LKA,United Kingdom of Great Britain and Northern Ireland,GBR,41,12,1000,120,1173
2016,Lithuania,LTU,United Kingdom of Great Britain and Northern Ireland,GBR,0,0,17,5,22
2016,Latvia,LVA,United Kingdom of Great Britain and Northern Ireland,GBR,0,0,5,5,10
2016,Maldives,MDV,United Kingdom of Great Britain and Northern Ireland,GBR,5,0,0,0,5
2016,Mexico,MEX,United Kingdom of Great Britain and Northern Ireland,GBR,5,0,15,5,25
2016,Mali,MLI,United Kingdom of Great Britain and Northern Ireland,GBR,0,0,5,5,10
2016,Malaysia,MYS,United Kingdom of Great Britain and Northern Ireland,GBR,14,0,54,10,78
2016,Malawi,MWI,United Kingdom of Great Britain and Northern Ireland,GBR,5,10,73,10,98
2016,Mongolia,MNG,United Kingdom of Great Britain and Northern Ireland,GBR,0,0,15,5,20
2016,Morocco,MAR,United Kingdom of Great Britain and Northern Ireland,GBR,0,0,54,15,69
2016,Mauritius,MUS,United Kingdom of Great Britain and Northern Ireland,GBR,0,5,54,5,64
2016,Myanmar,MMR,United Kingdom of Great Britain and Northern Ireland,GBR,10,0,69,5,84
2016,Namibia,NAM,United Kingdom of Great Britain and Northern Ireland,GBR,0,5,14,0,19
2016,Nepal,NPL,United Kingdom of Great Britain and Northern Ireland,GBR,0,0,105,35,140
2016,Netherlands,NLD,United Kingdom of Great Britain and Northern Ireland,GBR,0,0,5,0,5
2016,Nigeria,NGA,United Kingdom of Great Britain and Northern Ireland,GBR,212,60,1126,111,1509
2016,New Zealand,NZL,United Kingdom of Great Britain and Northern Ireland,GBR,0,0,0,5,5
2016,Pakistan,PAK,United Kingdom of Great Britain and Northern Ireland,GBR,409,30,2236,499,3174
2016,Philippines,PHL,United Kingdom of Great Britain and Northern Ireland,GBR,0,0,52,18,70
2016,Poland,POL,United Kingdom of Great Britain and Northern Ireland,GBR,0,0,32,5,37
2016,Portugal,PRT,United Kingdom of Great Britain and Northern Ireland,GBR,0,0,5,0,5
2016,Romania,ROU,United Kingdom of Great Britain and Northern Ireland,GBR,0,0,19,0,19
2016,South Africa,ZAF,United Kingdom of Great Britain and Northern Ireland,GBR,0,12,49,5,66
2016,Russian Federation,RUS,United Kingdom of Great Britain and Northern Ireland,GBR,25,0,49,10,84
2016,Rwanda,RWA,United Kingdom of Great Britain and Northern Ireland,GBR,0,0,17,0,17
2016,El Salvador,SLV,United Kingdom of Great Britain and Northern Ireland,GBR,10,5,25,5,45
2016,Saudi Arabia,SAU,United Kingdom of Great Britain and Northern Ireland,GBR,29,0,15,10,54
2016,Serbia and Kosovo: S/RES/1244 (1999),SRB,United Kingdom of Great Britain and Northern Ireland,GBR,0,0,13,0,13
2016,Senegal,SEN,United Kingdom of Great Britain and Northern Ireland,GBR,5,0,14,5,24
2016,Seychelles,SYC,United Kingdom of Great Britain and Northern Ireland,GBR,0,0,5,0,5
2016,Sierra Leone,SLE,United Kingdom of Great Britain and Northern Ireland,GBR,15,5,40,0,60
2016,Somalia,SOM,United Kingdom of Great Britain and Northern Ireland,GBR,95,28,167,38,328
2016,Viet Nam,VNM,United Kingdom of Great Britain and Northern Ireland,GBR,73,32,181,189,475
2016,Saint Kitts and Nevis,KNA,United Kingdom of Great Britain and Northern Ireland,GBR,0,0,5,0,5
2016,Sudan,SDN,United Kingdom of Great Britain and Northern Ireland,GBR,1241,5,145,97,1488
2016,South Sudan,SSD,United Kingdom of Great Britain and Northern Ireland,GBR,5,0,0,0,5
2016,Slovakia,SVK,United Kingdom of Great Britain and Northern Ireland,GBR,0,0,5,0,5
2016,Eswatini,SWZ,United Kingdom of Great Britain and Northern Ireland,GBR,0,0,12,0,12
2016,Sweden,SWE,United Kingdom of Great Britain and Northern Ireland,GBR,0,0,5,0,5
2016,Syrian Arab Rep.,SYR,United Kingdom of Great Britain and Northern Ireland,GBR,1752,12,143,253,2160
2016,United Rep. of Tanzania,TZA,United Kingdom of Great Britain and Northern Ireland,GBR,0,0,39,11,50
2016,Thailand,THA,United Kingdom of Great Britain and Northern Ireland,GBR,0,0,5,10,15
2016,Turkmenistan,TKM,United Kingdom of Great Britain and Northern Ireland,GBR,0,0,5,0,5
2016,Trinidad and Tobago,TTO,United Kingdom of Great Britain and Northern Ireland,GBR,0,0,35,5,40
2016,Tunisia,TUN,United Kingdom of Great Britain and Northern Ireland,GBR,5,0,26,5,36
2016,Turkey,TUR,United Kingdom of Great Britain and Northern Ireland,GBR,22,14,176,28,240
2016,Uganda,UGA,United Kingdom of Great Britain and Northern Ireland,GBR,118,0,128,10,256
2016,Ukraine,UKR,United Kingdom of Great Britain and Northern Ireland,GBR,0,0,105,32,137
2016,United States of America,USA,United Kingdom of Great Britain and Northern Ireland,GBR,5,0,24,23,52
2016,Uzbekistan,UZB,United Kingdom of Great Britain and Northern Ireland,GBR,10,0,12,0,22
2016,Saint Vincent and the Grenadines,VCT,United Kingdom of Great Britain and Northern Ireland,GBR,0,0,11,0,11
2016,Venezuela (Bolivarian Republic of),VEN,United Kingdom of Great Britain and Northern Ireland,GBR,5,0,5,0,10
2016,Western Sahara,ESH,United Kingdom of Great Britain and Northern Ireland,GBR,0,0,0,5,5
2016,Yemen,YEM,United Kingdom of Great Britain and Northern Ireland,GBR,32,16,37,10,95
2016,Zambia,ZMB,United Kingdom of Great Britain and Northern Ireland,GBR,0,0,20,5,25
2016,Zimbabwe,ZWE,United Kingdom of Great Britain and Northern Ireland,GBR,31,19,223,15,288
2016,Stateless,XXA,United Kingdom of Great Britain and Northern Ireland,GBR,373,5,231,42,651
2016,Afghanistan,AFG,Georgia,GEO,0,0,0,14,14
2016,Egypt,EGY,Georgia,GEO,0,0,38,31,69
2016,Azerbaijan,AZE,Georgia,GEO,0,0,0,13,13
2016,Bangladesh,BGD,Georgia,GEO,0,0,33,84,117
2016,Burkina Faso,BFA,Georgia,GEO,0,0,0,5,5
2016,Cameroon,CMR,Georgia,GEO,0,0,10,12,22
2016,Congo,COG,Georgia,GEO,0,0,0,5,5
2016,Gambia,GMB,Georgia,GEO,0,0,0,5,5
2016,Ghana,GHA,Georgia,GEO,0,0,0,14,14
2016,Cote d'Ivoire,CIV,Georgia,GEO,0,0,23,10,33
2016,India,IND,Georgia,GEO,0,0,10,38,48
2016,Iran (Islamic Rep. of),IRN,Georgia,GEO,16,0,12,24,52
2016,Iraq,IRQ,Georgia,GEO,10,142,102,277,531
2016,Jordan,JOR,Georgia,GEO,0,0,0,5,5
2016,Sri Lanka,LKA,Georgia,GEO,0,0,0,5,5
2016,Nepal,NPL,Georgia,GEO,0,0,0,5,5
2016,Nigeria,NGA,Georgia,GEO,0,0,14,59,73
2016,Pakistan,PAK,Georgia,GEO,5,0,14,5,24
2016,Russian Federation,RUS,Georgia,GEO,5,0,10,10,25
2016,Sierra Leone,SLE,Georgia,GEO,0,0,0,5,5
2016,Somalia,SOM,Georgia,GEO,0,0,20,24,44
2016,Syrian Arab Rep.,SYR,Georgia,GEO,0,14,0,0,14
2016,Turkey,TUR,Georgia,GEO,0,0,15,10,25
2016,Ukraine,UKR,Georgia,GEO,0,51,5,17,73
2016,Uzbekistan,UZB,Georgia,GEO,11,0,0,0,11
2016,Yemen,YEM,Georgia,GEO,0,0,0,5,5
2016,Burundi,BDI,Ghana,GHA,12,0,0,0,12
2016,Burkina Faso,BFA,Ghana,GHA,0,0,0,5,5
2016,Central African Rep.,CAF,Ghana,GHA,42,0,0,131,173
2016,Chad,TCD,Ghana,GHA,5,0,0,21,26
2016,Congo,COG,Ghana,GHA,0,0,10,34,44
2016,Dem. Rep. of the Congo,COD,Ghana,GHA,10,0,11,48,69
2016,Eritrea,ERI,Ghana,GHA,5,0,0,13,18
2016,Ethiopia,ETH,Ghana,GHA,0,0,0,10,10
2016,Palestinian,PSE,Ghana,GHA,13,0,0,0,13
2016,Cote d'Ivoire,CIV,Ghana,GHA,109,0,0,476,585
2016,Iraq,IRQ,Ghana,GHA,0,0,0,5,5
2016,Sri Lanka,LKA,Ghana,GHA,0,0,0,10,10
2016,Mali,MLI,Ghana,GHA,0,0,0,5,5
2016,Nigeria,NGA,Ghana,GHA,0,0,14,0,14
2016,Pakistan,PAK,Ghana,GHA,5,0,0,0,5
2016,Rwanda,RWA,Ghana,GHA,5,0,0,26,31
2016,Sierra Leone,SLE,Ghana,GHA,10,0,0,0,10
2016,Somalia,SOM,Ghana,GHA,5,0,0,15,20
2016,Sudan,SDN,Ghana,GHA,110,0,0,163,273
2016,Syrian Arab Rep.,SYR,Ghana,GHA,13,0,0,36,49
2016,Togo,TGO,Ghana,GHA,10,0,15,249,274
2016,Uzbekistan,UZB,Ghana,GHA,5,0,0,0,5
2016,Afghanistan,AFG,Greece,GRC,111,93,234,282,720
2016,Albania,ALB,Greece,GRC,0,5,968,102,1075
2016,Algeria,DZA,Greece,GRC,5,0,554,170,729
2016,Egypt,EGY,Greece,GRC,13,5,320,20,358
2016,Armenia,ARM,Greece,GRC,0,0,37,5,42
2016,Burundi,BDI,Greece,GRC,5,0,0,0,5
2016,Bangladesh,BGD,Greece,GRC,18,5,690,47,760
2016,Burkina Faso,BFA,Greece,GRC,0,0,18,0,18
2016,China,CHN,Greece,GRC,10,0,61,11,82
2016,Cameroon,CMR,Greece,GRC,18,0,127,31,176
2016,Congo,COG,Greece,GRC,0,0,18,5,23
2016,Dem. Rep. of the Congo,COD,Greece,GRC,22,0,42,29,93
2016,Comoros,COM,Greece,GRC,0,0,0,5,5
2016,Cuba,CUB,Greece,GRC,0,0,5,0,5
2016,Dominican Rep.,DOM,Greece,GRC,0,0,34,21,55
2016,Eritrea,ERI,Greece,GRC,48,0,25,33,106
2016,Ethiopia,ETH,Greece,GRC,21,0,36,10,67
2016,Gambia,GMB,Greece,GRC,10,0,32,0,42
2016,Palestinian,PSE,Greece,GRC,51,0,5,25,81
2016,Georgia,GEO,Greece,GRC,0,0,419,38,457
2016,Ghana,GHA,Greece,GRC,0,0,58,0,58
2016,Guinea,GIN,Greece,GRC,5,0,21,0,26
2016,Haiti,HTI,Greece,GRC,0,0,11,0,11
2016,Cote d'Ivoire,CIV,Greece,GRC,5,0,37,5,47
2016,India,IND,Greece,GRC,0,0,52,5,57
2016,Iran (Islamic Rep. of),IRN,Greece,GRC,159,0,141,200,500
2016,Iraq,IRQ,Greece,GRC,79,34,67,260,440
2016,Jordan,JOR,Greece,GRC,0,0,5,0,5
2016,Kenya,KEN,Greece,GRC,0,0,14,0,14
2016,Liberia,LBR,Greece,GRC,0,0,5,0,5
2016,Libya,LBY,Greece,GRC,5,0,5,5,15
2016,Lebanon,LBN,Greece,GRC,5,0,35,26,66
2016,Sri Lanka,LKA,Greece,GRC,0,0,5,0,5
2016,Mauritania,MRT,Greece,GRC,0,0,5,0,5
2016,Rep. of Moldova,MDA,Greece,GRC,0,0,18,16,34
2016,Mali,MLI,Greece,GRC,5,0,50,13,68
2016,Malaysia,MYS,Greece,GRC,0,0,0,5,5
2016,Morocco,MAR,Greece,GRC,18,0,269,114,401
2016,Myanmar,MMR,Greece,GRC,5,0,5,0,10
2016,Nepal,NPL,Greece,GRC,0,0,28,5,33
2016,Niger,NER,Greece,GRC,0,0,10,0,10
2016,Nigeria,NGA,Greece,GRC,18,0,240,21,279
2016,Pakistan,PAK,Greece,GRC,49,5,2318,328,2700
2016,Russian Federation,RUS,Greece,GRC,0,0,16,0,16
2016,Rwanda,RWA,Greece,GRC,0,0,5,0,5
2016,Senegal,SEN,Greece,GRC,0,0,61,12,73
2016,Sierra Leone,SLE,Greece,GRC,5,0,28,5,38
2016,Somalia,SOM,Greece,GRC,27,37,14,10,88
2016,Viet Nam,VNM,Greece,GRC,0,0,5,0,5
2016,Sudan,SDN,Greece,GRC,14,0,13,5,32
2016,South Sudan,SSD,Greece,GRC,5,0,0,0,5
2016,Syrian Arab Rep.,SYR,Greece,GRC,1661,0,20,608,2289
2016,United Rep. of Tanzania,TZA,Greece,GRC,0,0,5,0,5
2016,Togo,TGO,Greece,GRC,5,0,5,0,10
2016,Tunisia,TUN,Greece,GRC,0,0,27,12,39
2016,Turkey,TUR,Greece,GRC,10,0,41,28,79
2016,Uganda,UGA,Greece,GRC,0,0,28,0,28
2016,Ukraine,UKR,Greece,GRC,0,24,68,27,119
2016,Venezuela (Bolivarian Republic of),VEN,Greece,GRC,0,0,5,0,5
2016,Western Sahara,ESH,Greece,GRC,0,0,0,5,5
2016,Yemen,YEM,Greece,GRC,28,21,0,10,59
2016,Stateless,XXA,Greece,GRC,35,0,11,16,62
2016,Bangladesh,BGD,Guatemala,GTM,0,0,0,28,28
2016,Cambodia,KHM,Guatemala,GTM,0,0,0,5,5
2016,Ecuador,ECU,Guatemala,GTM,0,0,0,10,10
2016,Eritrea,ERI,Guatemala,GTM,0,0,0,5,5
2016,Ghana,GHA,Guatemala,GTM,0,0,0,20,20
2016,Honduras,HND,Guatemala,GTM,5,0,0,13,18
2016,Nepal,NPL,Guatemala,GTM,0,0,0,69,69
2016,Pakistan,PAK,Guatemala,GTM,0,0,0,10,10
2016,Russian Federation,RUS,Guatemala,GTM,0,0,5,0,5
2016,El Salvador,SLV,Guatemala,GTM,62,0,0,20,82
2016,Somalia,SOM,Guatemala,GTM,0,0,0,5,5
2016,United States of America,USA,Guatemala,GTM,0,0,0,5,5
2016,Venezuela (Bolivarian Republic of),VEN,Guatemala,GTM,5,0,0,0,5
2016,Dem. Rep. of the Congo,COD,Guinea,GIN,13,0,0,0,13
2016,Cote d'Ivoire,CIV,Guinea,GIN,17,0,22,34,73
2016,Liberia,LBR,Guinea,GIN,28,0,17,11,56
2016,Mali,MLI,Guinea,GIN,0,5,0,0,5
2016,Sierra Leone,SLE,Guinea,GIN,5,0,24,17,46
2016,Somalia,SOM,Guinea,GIN,5,0,0,0,5
2016,Afghanistan,AFG,Croatia,HRV,17,0,15,420,452
2016,Albania,ALB,Croatia,HRV,0,0,0,5,5
2016,Algeria,DZA,Croatia,HRV,0,0,34,89,123
2016,Egypt,EGY,Croatia,HRV,0,0,0,5,5
2016,Bangladesh,BGD,Croatia,HRV,0,0,0,11,11
2016,Bosnia and Herzegovina,BIH,Croatia,HRV,0,0,0,5,5
2016,Cuba,CUB,Croatia,HRV,0,0,0,5,5
2016,Eritrea,ERI,Croatia,HRV,5,0,0,0,5
2016,Palestinian,PSE,Croatia,HRV,0,0,0,16,16
2016,India,IND,Croatia,HRV,0,0,0,5,5
2016,Iran (Islamic Rep. of),IRN,Croatia,HRV,10,0,5,56,71
2016,Iraq,IRQ,Croatia,HRV,21,0,13,165,199
2016,Libya,LBY,Croatia,HRV,0,0,0,19,19
2016,Lebanon,LBN,Croatia,HRV,0,0,0,5,5
2016,Sri Lanka,LKA,Croatia,HRV,0,0,0,12,12
2016,North Macedonia,MKD,Croatia,HRV,0,0,5,0,5
2016,Morocco,MAR,Croatia,HRV,0,0,22,55,77
2016,Nigeria,NGA,Croatia,HRV,0,0,0,10,10
2016,Pakistan,PAK,Croatia,HRV,0,0,5,122,127
2016,Russian Federation,RUS,Croatia,HRV,0,0,0,5,5
2016,Serbia and Kosovo: S/RES/1244 (1999),SRB,Croatia,HRV,0,0,5,14,19
2016,Sierra Leone,SLE,Croatia,HRV,0,0,0,5,5
2016,Somalia,SOM,Croatia,HRV,14,0,0,0,14
2016,Syrian Arab Rep.,SYR,Croatia,HRV,24,14,5,142,185
2016,Tunisia,TUN,Croatia,HRV,0,0,0,5,5
2016,Turkey,TUR,Croatia,HRV,5,0,0,54,59
2016,Ukraine,UKR,Croatia,HRV,0,0,0,5,5
2016,Afghanistan,AFG,Iceland,ISL,0,5,0,20,25
2016,Albania,ALB,Iceland,ISL,0,0,186,67,253
2016,Algeria,DZA,Iceland,ISL,0,0,0,12,12
2016,Belarus,BLR,Iceland,ISL,0,0,13,0,13
2016,Colombia,COL,Iceland,ISL,0,0,0,11,11
2016,Eritrea,ERI,Iceland,ISL,0,0,0,5,5
2016,Palestinian,PSE,Iceland,ISL,0,0,0,12,12
2016,Georgia,GEO,Iceland,ISL,0,0,0,14,14
2016,Ghana,GHA,Iceland,ISL,0,0,5,17,22
2016,Iran (Islamic Rep. of),IRN,Iceland,ISL,13,0,0,5,18
2016,Iraq,IRQ,Iceland,ISL,5,21,0,50,76
2016,Kazakhstan,KAZ,Iceland,ISL,5,0,0,0,5
2016,North Macedonia,MKD,Iceland,ISL,0,0,184,110,294
2016,Morocco,MAR,Iceland,ISL,0,0,5,11,16
2016,Nigeria,NGA,Iceland,ISL,0,0,0,19,19
2016,Pakistan,PAK,Iceland,ISL,0,0,0,10,10
2016,Russian Federation,RUS,Iceland,ISL,0,0,0,5,5
2016,El Salvador,SLV,Iceland,ISL,5,0,0,0,5
2016,Serbia and Kosovo: S/RES/1244 (1999),SRB,Iceland,ISL,0,0,15,5,20
2016,Somalia,SOM,Iceland,ISL,0,0,0,14,14
2016,Syrian Arab Rep.,SYR,Iceland,ISL,12,5,0,14,31
2016,Tunisia,TUN,Iceland,ISL,0,0,0,5,5
2016,Ukraine,UKR,Iceland,ISL,0,5,5,5,15
2016,United States of America,USA,Iceland,ISL,0,0,0,5,5
2016,Stateless,XXA,Iceland,ISL,0,0,5,0,5
2016,Afghanistan,AFG,Ireland,IRL,37,0,47,86,170
2016,Albania,ALB,Ireland,IRL,5,0,164,73,242
2016,Algeria,DZA,Ireland,IRL,0,0,46,36,82
2016,Angola,AGO,Ireland,IRL,0,0,5,5,10
2016,Egypt,EGY,Ireland,IRL,5,0,0,13,18
2016,Burundi,BDI,Ireland,IRL,5,0,0,0,5
2016,Bangladesh,BGD,Ireland,IRL,0,0,115,125,240
2016,Brazil,BRA,Ireland,IRL,0,0,17,5,22
2016,China,CHN,Ireland,IRL,0,0,16,5,21
2016,Cameroon,CMR,Ireland,IRL,11,0,0,0,11
2016,Congo,COG,Ireland,IRL,0,0,5,0,5
2016,Dem. Rep. of the Congo,COD,Ireland,IRL,12,0,51,11,74
2016,Cuba,CUB,Ireland,IRL,0,0,5,0,5
2016,Eritrea,ERI,Ireland,IRL,5,0,0,0,5
2016,Gambia,GMB,Ireland,IRL,5,0,0,0,5
2016,Palestinian,PSE,Ireland,IRL,12,0,0,0,12
2016,Georgia,GEO,Ireland,IRL,5,0,37,26,68
2016,Ghana,GHA,Ireland,IRL,5,0,13,0,18
2016,Guinea,GIN,Ireland,IRL,0,0,0,5,5
2016,India,IND,Ireland,IRL,0,0,78,72,150
2016,Iran (Islamic Rep. of),IRN,Ireland,IRL,21,0,5,22,48
2016,Iraq,IRQ,Ireland,IRL,36,0,5,19,60
2016,Kyrgyzstan,KGZ,Ireland,IRL,5,0,0,0,5
2016,Kuwait,KWT,Ireland,IRL,13,0,5,0,18
2016,Libya,LBY,Ireland,IRL,53,0,5,14,72
2016,Lebanon,LBN,Ireland,IRL,0,0,5,0,5
2016,Lesotho,LSO,Ireland,IRL,0,0,5,0,5
2016,Sri Lanka,LKA,Ireland,IRL,0,0,5,10,15
2016,Rep. of Moldova,MDA,Ireland,IRL,0,0,0,5,5
2016,Malawi,MWI,Ireland,IRL,5,0,77,10,92
2016,Morocco,MAR,Ireland,IRL,0,0,0,5,5
2016,Mauritius,MUS,Ireland,IRL,0,0,13,5,18
2016,Myanmar,MMR,Ireland,IRL,0,0,5,0,5
2016,Nepal,NPL,Ireland,IRL,0,0,11,5,16
2016,Nigeria,NGA,Ireland,IRL,0,0,167,59,226
2016,Pakistan,PAK,Ireland,IRL,5,0,454,594,1053
2016,South Africa,ZAF,Ireland,IRL,0,0,70,12,82
2016,Russian Federation,RUS,Ireland,IRL,5,0,5,0,10
2016,Saudi Arabia,SAU,Ireland,IRL,0,0,0,5,5
2016,Serbia and Kosovo: S/RES/1244 (1999),SRB,Ireland,IRL,0,0,14,0,14
2016,Senegal,SEN,Ireland,IRL,0,0,5,0,5
2016,Somalia,SOM,Ireland,IRL,10,0,5,12,27
2016,Viet Nam,VNM,Ireland,IRL,0,0,5,0,5
2016,Sudan,SDN,Ireland,IRL,5,0,5,10,20
2016,Eswatini,SWZ,Ireland,IRL,0,0,5,0,5
2016,Syrian Arab Rep.,SYR,Ireland,IRL,150,0,0,16,166
2016,Togo,TGO,Ireland,IRL,0,0,5,0,5
2016,Tunisia,TUN,Ireland,IRL,0,0,0,5,5
2016,Uganda,UGA,Ireland,IRL,0,0,0,5,5
2016,Ukraine,UKR,Ireland,IRL,10,0,27,5,42
2016,United States of America,USA,Ireland,IRL,0,0,0,5,5
2016,Venezuela (Bolivarian Republic of),VEN,Ireland,IRL,0,0,11,5,16
2016,Zimbabwe,ZWE,Ireland,IRL,23,0,110,16,149
2016,Afghanistan,AFG,Italy,ITA,380,3621,124,0,4125
2016,Albania,ALB,Italy,ITA,36,66,123,0,225
2016,Algeria,DZA,Italy,ITA,5,13,106,0,124
2016,Angola,AGO,Italy,ITA,0,5,0,0,5
2016,Egypt,EGY,Italy,ITA,34,241,261,0,536
2016,Armenia,ARM,Italy,ITA,10,22,10,0,42
2016,Azerbaijan,AZE,Italy,ITA,13,0,0,0,13
2016,Burundi,BDI,Italy,ITA,0,5,0,0,5
2016,Benin,BEN,Italy,ITA,5,51,148,0,204
2016,Bangladesh,BGD,Italy,ITA,100,1510,4616,0,6226
2016,Bahamas,BHS,Italy,ITA,0,0,5,0,5
2016,Burkina Faso,BFA,Italy,ITA,5,158,369,0,532
2016,Belarus,BLR,Italy,ITA,0,5,0,0,5
2016,Bolivia (Plurinational State of),BOL,Italy,ITA,0,5,0,0,5
2016,Brazil,BRA,Italy,ITA,5,17,22,0,44
2016,Bosnia and Herzegovina,BIH,Italy,ITA,0,90,59,0,149
2016,Central African Rep.,CAF,Italy,ITA,0,13,0,0,13
2016,Chad,TCD,Italy,ITA,5,38,22,0,65
2016,China,CHN,Italy,ITA,12,14,240,0,266
2016,Chile,CHL,Italy,ITA,0,5,0,0,5
2016,Cameroon,CMR,Italy,ITA,88,253,334,0,675
2016,Congo,COG,Italy,ITA,23,40,24,0,87
2016,Dem. Rep. of the Congo,COD,Italy,ITA,30,53,20,0,103
2016,Comoros,COM,Italy,ITA,0,0,5,0,5
2016,Colombia,COL,Italy,ITA,12,24,13,0,49
2016,Cuba,CUB,Italy,ITA,5,18,18,0,41
2016,Cabo Verde,CPV,Italy,ITA,0,5,0,0,5
2016,Dominican Rep.,DOM,Italy,ITA,0,0,14,0,14
2016,Ecuador,ECU,Italy,ITA,0,5,12,0,17
2016,Equatorial Guinea,GNQ,Italy,ITA,0,0,5,0,5
2016,Eritrea,ERI,Italy,ITA,215,188,78,0,481
2016,Ethiopia,ETH,Italy,ITA,58,63,27,0,148
2016,Gabon,GAB,Italy,ITA,0,5,5,0,10
2016,Gambia,GMB,Italy,ITA,224,2591,5866,0,8681
2016,Palestinian,PSE,Italy,ITA,64,38,10,0,112
2016,Georgia,GEO,Italy,ITA,5,66,43,0,114
2016,Ghana,GHA,Italy,ITA,57,1242,2694,0,3993
2016,Guinea-Bissau,GNB,Italy,ITA,0,203,503,0,706
2016,Guinea,GIN,Italy,ITA,40,701,1813,0,2554
2016,Honduras,HND,Italy,ITA,0,11,0,0,11
2016,Cote d'Ivoire,CIV,Italy,ITA,111,1067,2633,0,3811
2016,India,IND,Italy,ITA,5,28,220,0,253
2016,Iran (Islamic Rep. of),IRN,Italy,ITA,65,177,58,0,300
2016,Iraq,IRQ,Italy,ITA,225,653,46,0,924
2016,Jordan,JOR,Italy,ITA,5,5,0,0,10
2016,Kenya,KEN,Italy,ITA,5,11,5,0,21
2016,Kyrgyzstan,KGZ,Italy,ITA,0,0,5,0,5
2016,Liberia,LBR,Italy,ITA,0,53,97,0,150
2016,Libya,LBY,Italy,ITA,34,177,25,0,236
2016,Lebanon,LBN,Italy,ITA,5,28,19,0,52
2016,Sri Lanka,LKA,Italy,ITA,5,49,45,0,99
2016,Madagascar,MDG,Italy,ITA,0,0,5,0,5
2016,Mauritania,MRT,Italy,ITA,20,29,34,0,83
2016,North Macedonia,MKD,Italy,ITA,0,5,5,0,10
2016,Rep. of Moldova,MDA,Italy,ITA,0,35,11,0,46
2016,Mali,MLI,Italy,ITA,58,2942,3897,0,6897
2016,Morocco,MAR,Italy,ITA,16,129,311,0,456
2016,Montenegro,MNE,Italy,ITA,0,15,11,0,26
2016,Mauritius,MUS,Italy,ITA,0,5,0,0,5
2016,Myanmar,MMR,Italy,ITA,0,0,5,0,5
2016,Nepal,NPL,Italy,ITA,0,21,10,0,31
2016,Niger,NER,Italy,ITA,0,42,121,0,163
2016,Nicaragua,NIC,Italy,ITA,0,0,13,0,13
2016,Nigeria,NGA,Italy,ITA,516,4077,13795,0,18388
2016,Pakistan,PAK,Italy,ITA,461,3829,7332,0,11622
2016,Peru,PER,Italy,ITA,0,12,12,0,24
2016,Philippines,PHL,Italy,ITA,0,10,18,0,28
2016,Russian Federation,RUS,Italy,ITA,5,19,11,0,35
2016,El Salvador,SLV,Italy,ITA,47,79,32,0,158
2016,Serbia and Kosovo: S/RES/1244 (1999),SRB,Italy,ITA,31,193,219,0,443
2016,Senegal,SEN,Italy,ITA,79,1646,4900,0,6625
2016,Sierra Leone,SLE,Italy,ITA,0,87,148,0,235
2016,Somalia,SOM,Italy,ITA,308,1094,46,0,1448
2016,Sudan,SDN,Italy,ITA,62,105,58,0,225
2016,South Sudan,SSD,Italy,ITA,0,0,5,0,5
2016,Syrian Arab Rep.,SYR,Italy,ITA,1101,67,16,0,1184
2016,United Rep. of Tanzania,TZA,Italy,ITA,0,5,0,0,5
2016,Tajikistan,TJK,Italy,ITA,5,0,0,0,5
2016,Togo,TGO,Italy,ITA,17,118,281,0,416
2016,Tunisia,TUN,Italy,ITA,5,63,146,0,214
2016,Turkey,TUR,Italy,ITA,52,201,48,0,301
2016,Uganda,UGA,Italy,ITA,11,5,5,0,21
2016,Ukraine,UKR,Italy,ITA,55,1795,1394,0,3244
2016,United States of America,USA,Italy,ITA,0,5,0,0,5
2016,Venezuela (Bolivarian Republic of),VEN,Italy,ITA,5,29,14,0,48
2016,Western Sahara,ESH,Italy,ITA,0,5,0,0,5
2016,Yemen,YEM,Italy,ITA,0,16,0,0,16
2016,Bangladesh,BGD,Japan,JPN,5,0,249,0,254
2016,India,IND,Japan,JPN,0,0,248,0,248
2016,Indonesia,IDN,Japan,JPN,0,0,1742,0,1742
2016,Sri Lanka,LKA,Japan,JPN,0,5,464,0,469
2016,Myanmar,MMR,Japan,JPN,0,0,319,0,319
2016,Nepal,NPL,Japan,JPN,0,0,841,0,841
2016,Pakistan,PAK,Japan,JPN,0,0,241,0,241
2016,Philippines,PHL,Japan,JPN,0,0,775,0,775
2016,Viet Nam,VNM,Japan,JPN,0,0,1213,0,1213
2016,Turkey,TUR,Japan,JPN,0,5,886,0,891
2016,Afghanistan,AFG,Kazakhstan,KAZ,67,0,135,0,202
2016,Syrian Arab Rep.,SYR,Kazakhstan,KAZ,0,0,12,0,12
2016,Uzbekistan,UZB,Kazakhstan,KAZ,0,0,5,0,5
2016,Afghanistan,AFG,Kyrgyzstan,KGZ,16,0,118,31,165
2016,Iran (Islamic Rep. of),IRN,Kyrgyzstan,KGZ,0,0,0,5,5
2016,Iraq,IRQ,Kyrgyzstan,KGZ,0,0,5,0,5
2016,Pakistan,PAK,Kyrgyzstan,KGZ,0,0,5,0,5
2016,Syrian Arab Rep.,SYR,Kyrgyzstan,KGZ,5,0,5,0,10
2016,Ukraine,UKR,Kyrgyzstan,KGZ,11,0,0,0,11
2016,Uzbekistan,UZB,Kyrgyzstan,KGZ,0,0,0,15,15
2016,Eritrea,ERI,Lesotho,LSO,5,0,0,0,5
2016,Ethiopia,ETH,Lesotho,LSO,10,0,0,0,10
2016,China,CHN,Liechtenstein,LIE,13,0,0,0,13
2016,Iraq,IRQ,Liechtenstein,LIE,5,0,0,0,5
2016,North Macedonia,MKD,Liechtenstein,LIE,0,0,10,0,10
2016,Serbia and Kosovo: S/RES/1244 (1999),SRB,Liechtenstein,LIE,0,0,19,0,19
2016,Ukraine,UKR,Liechtenstein,LIE,0,5,0,0,5
2016,Afghanistan,AFG,Lithuania,LTU,5,0,5,13,23
2016,Armenia,ARM,Lithuania,LTU,0,0,5,0,5
2016,Azerbaijan,AZE,Lithuania,LTU,11,0,0,5,16
2016,Belarus,BLR,Lithuania,LTU,0,0,5,13,18
2016,Georgia,GEO,Lithuania,LTU,0,0,12,0,12
2016,Iraq,IRQ,Lithuania,LTU,0,0,13,5,18
2016,Kazakhstan,KAZ,Lithuania,LTU,5,0,0,0,5
2016,Kyrgyzstan,KGZ,Lithuania,LTU,0,0,0,5,5
2016,Lebanon,LBN,Lithuania,LTU,0,0,5,0,5
2016,Pakistan,PAK,Lithuania,LTU,0,0,0,5,5
2016,Russian Federation,RUS,Lithuania,LTU,5,5,18,12,40
2016,Syrian Arab Rep.,SYR,Lithuania,LTU,133,5,0,0,138
2016,Tajikistan,TJK,Lithuania,LTU,10,0,0,0,10
2016,Ukraine,UKR,Lithuania,LTU,0,0,22,14,36
2016,Stateless,XXA,Lithuania,LTU,15,0,0,0,15
2016,Afghanistan,AFG,Luxembourg,LUX,10,0,5,13,28
2016,Albania,ALB,Luxembourg,LUX,5,0,106,5,116
2016,Algeria,DZA,Luxembourg,LUX,0,0,13,41,54
2016,Angola,AGO,Luxembourg,LUX,0,0,0,5,5
2016,Egypt,EGY,Luxembourg,LUX,0,0,0,5,5
2016,Armenia,ARM,Luxembourg,LUX,5,0,0,0,5
2016,Azerbaijan,AZE,Luxembourg,LUX,5,0,0,0,5
2016,Burundi,BDI,Luxembourg,LUX,0,0,0,5,5
2016,Belarus,BLR,Luxembourg,LUX,0,0,14,0,14
2016,Bosnia and Herzegovina,BIH,Luxembourg,LUX,0,0,39,0,39
2016,Cameroon,CMR,Luxembourg,LUX,0,0,5,16,21
2016,Dem. Rep. of the Congo,COD,Luxembourg,LUX,10,0,0,5,15
2016,Eritrea,ERI,Luxembourg,LUX,24,5,0,5,34
2016,Ethiopia,ETH,Luxembourg,LUX,5,0,0,0,5
2016,Gabon,GAB,Luxembourg,LUX,5,0,0,0,5
2016,Gambia,GMB,Luxembourg,LUX,0,0,0,5,5
2016,Palestinian,PSE,Luxembourg,LUX,22,0,0,5,27
2016,Georgia,GEO,Luxembourg,LUX,0,0,0,10,10
2016,Guinea,GIN,Luxembourg,LUX,0,0,0,11,11
2016,Cote d'Ivoire,CIV,Luxembourg,LUX,0,0,0,13,13
2016,Iran (Islamic Rep. of),IRN,Luxembourg,LUX,14,5,0,5,24
2016,Iraq,IRQ,Luxembourg,LUX,93,10,26,25,154
2016,Dem. People's Rep. of Korea,PRK,Luxembourg,LUX,0,0,0,14,14
2016,Liberia,LBR,Luxembourg,LUX,0,0,0,13,13
2016,Libya,LBY,Luxembourg,LUX,0,0,0,5,5
2016,North Macedonia,MKD,Luxembourg,LUX,0,0,5,13,18
2016,Mexico,MEX,Luxembourg,LUX,5,0,0,0,5
2016,Mali,MLI,Luxembourg,LUX,0,0,0,5,5
2016,Morocco,MAR,Luxembourg,LUX,0,0,10,11,21
2016,Montenegro,MNE,Luxembourg,LUX,0,5,28,0,33
2016,Nigeria,NGA,Luxembourg,LUX,5,0,10,24,39
2016,Russian Federation,RUS,Luxembourg,LUX,0,0,0,11,11
2016,Serbia and Kosovo: S/RES/1244 (1999),SRB,Luxembourg,LUX,0,0,136,30,166
2016,Senegal,SEN,Luxembourg,LUX,0,0,5,0,5
2016,Sierra Leone,SLE,Luxembourg,LUX,0,0,0,5,5
2016,Somalia,SOM,Luxembourg,LUX,5,0,0,17,22
2016,Sudan,SDN,Luxembourg,LUX,5,0,0,5,10
2016,Syrian Arab Rep.,SYR,Luxembourg,LUX,537,0,5,18,560
2016,Togo,TGO,Luxembourg,LUX,0,0,0,14,14
2016,Tunisia,TUN,Luxembourg,LUX,0,0,10,25,35
2016,Turkey,TUR,Luxembourg,LUX,5,0,0,0,5
2016,Ukraine,UKR,Luxembourg,LUX,0,0,10,0,10
2016,Afghanistan,AFG,Latvia,LVA,5,5,23,25,58
2016,Armenia,ARM,Latvia,LVA,0,0,0,5,5
2016,Dem. Rep. of the Congo,COD,Latvia,LVA,0,0,5,0,5
2016,Eritrea,ERI,Latvia,LVA,0,10,0,0,10
2016,Georgia,GEO,Latvia,LVA,0,0,0,35,35
2016,India,IND,Latvia,LVA,0,0,10,10,20
2016,Iran (Islamic Rep. of),IRN,Latvia,LVA,5,0,0,0,5
2016,Iraq,IRQ,Latvia,LVA,23,5,32,12,72
2016,Kazakhstan,KAZ,Latvia,LVA,0,5,0,0,5
2016,Nepal,NPL,Latvia,LVA,0,0,5,5,10
2016,Pakistan,PAK,Latvia,LVA,0,0,16,5,21
2016,Russian Federation,RUS,Latvia,LVA,12,0,5,5,22
2016,Viet Nam,VNM,Latvia,LVA,0,0,0,5,5
2016,Syrian Arab Rep.,SYR,Latvia,LVA,5,69,0,0,74
2016,Tajikistan,TJK,Latvia,LVA,0,0,0,5,5
2016,Ukraine,UKR,Latvia,LVA,0,0,10,0,10
2016,Afghanistan,AFG,Rep. of Moldova,MDA,0,0,12,0,12
2016,Armenia,ARM,Rep. of Moldova,MDA,0,0,5,0,5
2016,Iraq,IRQ,Rep. of Moldova,MDA,0,5,0,0,5
2016,Sri Lanka,LKA,Rep. of Moldova,MDA,0,0,13,0,13
2016,Nigeria,NGA,Rep. of Moldova,MDA,0,0,5,0,5
2016,Russian Federation,RUS,Rep. of Moldova,MDA,0,0,0,5,5
2016,Syrian Arab Rep.,SYR,Rep. of Moldova,MDA,0,16,5,5,26
2016,Tajikistan,TJK,Rep. of Moldova,MDA,5,0,0,0,5
2016,Turkey,TUR,Rep. of Moldova,MDA,0,0,0,5,5
2016,Ukraine,UKR,Rep. of Moldova,MDA,0,5,27,17,49
2016,Albania,ALB,Mexico,MEX,5,0,0,0,5
2016,Cameroon,CMR,Mexico,MEX,0,0,0,14,14
2016,Dem. Rep. of the Congo,COD,Mexico,MEX,0,0,5,0,5
2016,Colombia,COL,Mexico,MEX,13,0,21,5,39
2016,Cuba,CUB,Mexico,MEX,5,0,5,29,39
2016,Ecuador,ECU,Mexico,MEX,0,0,0,18,18
2016,Ghana,GHA,Mexico,MEX,0,0,5,0,5
2016,Guatemala,GTM,Mexico,MEX,151,0,126,102,379
2016,Haiti,HTI,Mexico,MEX,0,0,5,14,19
2016,Honduras,HND,Mexico,MEX,1399,0,1050,1129,3578
2016,Iran (Islamic Rep. of),IRN,Mexico,MEX,0,0,0,5,5
2016,Iraq,IRQ,Mexico,MEX,10,0,0,0,10
2016,Nicaragua,NIC,Mexico,MEX,10,0,29,21,60
2016,Nigeria,NGA,Mexico,MEX,5,0,0,0,5
2016,Pakistan,PAK,Mexico,MEX,5,0,0,0,5
2016,Russian Federation,RUS,Mexico,MEX,5,0,0,0,5
2016,El Salvador,SLV,Mexico,MEX,1423,0,661,914,2998
2016,Syrian Arab Rep.,SYR,Mexico,MEX,5,0,0,0,5
2016,Togo,TGO,Mexico,MEX,0,0,5,0,5
2016,United States of America,USA,Mexico,MEX,0,0,12,0,12
2016,Venezuela (Bolivarian Republic of),VEN,Mexico,MEX,239,0,0,10,249
2016,Central African Rep.,CAF,Mali,MLI,95,0,5,121,221
2016,Chad,TCD,Mali,MLI,5,0,0,0,5
2016,Congo,COG,Mali,MLI,10,0,0,0,10
2016,Dem. Rep. of the Congo,COD,Mali,MLI,0,0,0,5,5
2016,Syrian Arab Rep.,SYR,Mali,MLI,0,0,0,5,5
2016,Burundi,BDI,Malawi,MWI,87,0,26,979,1092
2016,Dem. Rep. of the Congo,COD,Malawi,MWI,706,0,0,1243,1949
2016,Ethiopia,ETH,Malawi,MWI,0,0,0,5,5
2016,Mozambique,MOZ,Malawi,MWI,0,0,0,6618,6618
2016,Rwanda,RWA,Malawi,MWI,74,0,0,224,298
2016,Somalia,SOM,Malawi,MWI,5,0,0,0,5
2016,Sudan,SDN,Malawi,MWI,0,0,0,5,5
2016,Angola,AGO,Mozambique,MOZ,0,0,0,5,5
2016,Burundi,BDI,Mozambique,MOZ,0,0,0,1231,1231
2016,Dem. Rep. of the Congo,COD,Mozambique,MOZ,0,0,0,184,184
2016,Ethiopia,ETH,Mozambique,MOZ,0,0,0,11,11
2016,Cote d'Ivoire,CIV,Mozambique,MOZ,0,0,0,5,5
2016,Rwanda,RWA,Mozambique,MOZ,0,0,0,261,261
2016,Sierra Leone,SLE,Mozambique,MOZ,0,0,0,5,5
2016,Somalia,SOM,Mozambique,MOZ,0,0,0,1339,1339
2016,Sudan,SDN,Mozambique,MOZ,0,0,0,10,10
2016,Uganda,UGA,Mozambique,MOZ,0,0,0,15,15
2016,Algeria,DZA,Malta,MLT,0,0,5,5,10
2016,Egypt,EGY,Malta,MLT,0,24,13,0,37
2016,Eritrea,ERI,Malta,MLT,5,96,17,5,123
2016,Ethiopia,ETH,Malta,MLT,5,18,0,0,23
2016,Gambia,GMB,Malta,MLT,0,5,0,0,5
2016,Palestinian,PSE,Malta,MLT,0,0,0,12,12
2016,Ghana,GHA,Malta,MLT,0,0,0,5,5
2016,Cote d'Ivoire,CIV,Malta,MLT,0,5,0,0,5
2016,Iran (Islamic Rep. of),IRN,Malta,MLT,11,0,0,0,11
2016,Iraq,IRQ,Malta,MLT,18,0,0,5,23
2016,Libya,LBY,Malta,MLT,92,485,10,87,674
2016,Mali,MLI,Malta,MLT,0,0,5,0,5
2016,Morocco,MAR,Malta,MLT,5,0,0,0,5
2016,Nigeria,NGA,Malta,MLT,10,18,5,0,33
2016,Pakistan,PAK,Malta,MLT,0,0,5,0,5
2016,Serbia and Kosovo: S/RES/1244 (1999),SRB,Malta,MLT,0,0,5,5,10
2016,Somalia,SOM,Malta,MLT,10,83,10,5,108
2016,Sudan,SDN,Malta,MLT,0,5,0,0,5
2016,Syrian Arab Rep.,SYR,Malta,MLT,23,317,0,22,362
2016,Tunisia,TUN,Malta,MLT,0,5,0,0,5
2016,Turkey,TUR,Malta,MLT,0,0,5,0,5
2016,Ukraine,UKR,Malta,MLT,0,31,0,11,42
2016,Venezuela (Bolivarian Republic of),VEN,Malta,MLT,0,0,5,5,10
2016,Afghanistan,AFG,Netherlands,NLD,426,0,838,400,1664
2016,Albania,ALB,Netherlands,NLD,0,0,621,1494,2115
2016,Algeria,DZA,Netherlands,NLD,0,0,158,534,692
2016,Angola,AGO,Netherlands,NLD,0,0,10,11,21
2016,Egypt,EGY,Netherlands,NLD,0,0,0,38,38
2016,Argentina,ARG,Netherlands,NLD,5,0,40,0,45
2016,Armenia,ARM,Netherlands,NLD,0,0,16,26,42
2016,Azerbaijan,AZE,Netherlands,NLD,5,0,10,23,38
2016,Burundi,BDI,Netherlands,NLD,5,0,5,11,21
2016,Bangladesh,BGD,Netherlands,NLD,5,0,15,5,25
2016,Burkina Faso,BFA,Netherlands,NLD,0,0,0,5,5
2016,Belarus,BLR,Netherlands,NLD,0,0,5,39,44
2016,Bosnia and Herzegovina,BIH,Netherlands,NLD,0,0,187,150,337
2016,Chad,TCD,Netherlands,NLD,0,0,5,0,5
2016,China,CHN,Netherlands,NLD,22,0,31,13,66
2016,Cameroon,CMR,Netherlands,NLD,0,0,5,13,18
2016,Congo,COG,Netherlands,NLD,5,0,21,11,37
2016,Dem. Rep. of the Congo,COD,Netherlands,NLD,0,0,0,5,5
2016,Colombia,COL,Netherlands,NLD,0,0,16,0,16
2016,Cuba,CUB,Netherlands,NLD,0,0,11,5,16
2016,Djibouti,DJI,Netherlands,NLD,0,0,0,5,5
2016,Eritrea,ERI,Netherlands,NLD,2812,0,145,335,3292
2016,Ethiopia,ETH,Netherlands,NLD,40,0,45,22,107
2016,Gabon,GAB,Netherlands,NLD,0,0,0,5,5
2016,Gambia,GMB,Netherlands,NLD,5,0,18,54,77
2016,Palestinian,PSE,Netherlands,NLD,19,0,5,5,29
2016,Georgia,GEO,Netherlands,NLD,5,0,108,363,476
2016,Ghana,GHA,Netherlands,NLD,0,0,10,12,22
2016,Guinea-Bissau,GNB,Netherlands,NLD,0,0,5,0,5
2016,Guinea,GIN,Netherlands,NLD,20,0,41,30,91
2016,Honduras,HND,Netherlands,NLD,0,0,5,0,5
2016,Cote d'Ivoire,CIV,Netherlands,NLD,0,0,5,14,19
2016,India,IND,Netherlands,NLD,5,0,22,31,58
2016,Iran (Islamic Rep. of),IRN,Netherlands,NLD,355,0,349,455,1159
2016,Iraq,IRQ,Netherlands,NLD,795,0,721,839,2355
2016,Jamaica,JAM,Netherlands,NLD,32,0,11,0,43
2016,Jordan,JOR,Netherlands,NLD,5,0,13,10,28
2016,Kazakhstan,KAZ,Netherlands,NLD,5,0,0,15,20
2016,Kenya,KEN,Netherlands,NLD,5,0,0,0,5
2016,Kyrgyzstan,KGZ,Netherlands,NLD,0,0,0,5,5
2016,Liberia,LBR,Netherlands,NLD,0,0,0,5,5
2016,Libya,LBY,Netherlands,NLD,5,0,49,103,157
2016,Lebanon,LBN,Netherlands,NLD,5,0,28,37,70
2016,Sri Lanka,LKA,Netherlands,NLD,5,0,13,10,28
2016,North Macedonia,MKD,Netherlands,NLD,0,0,172,263,435
2016,Rep. of Moldova,MDA,Netherlands,NLD,0,0,0,14,14
2016,Mexico,MEX,Netherlands,NLD,0,0,5,0,5
2016,Mali,MLI,Netherlands,NLD,0,0,5,19,24
2016,Mongolia,MNG,Netherlands,NLD,0,0,331,44,375
2016,Morocco,MAR,Netherlands,NLD,18,0,224,743,985
2016,Montenegro,MNE,Netherlands,NLD,0,0,23,10,33
2016,Myanmar,MMR,Netherlands,NLD,28,0,5,0,33
2016,Nepal,NPL,Netherlands,NLD,5,0,16,0,21
2016,Nigeria,NGA,Netherlands,NLD,26,0,103,85,214
2016,Pakistan,PAK,Netherlands,NLD,31,0,59,76,166
2016,South Africa,ZAF,Netherlands,NLD,0,0,10,0,10
2016,Russian Federation,RUS,Netherlands,NLD,18,0,48,87,153
2016,Rwanda,RWA,Netherlands,NLD,0,0,5,5,10
2016,El Salvador,SLV,Netherlands,NLD,0,0,5,5,10
2016,Saudi Arabia,SAU,Netherlands,NLD,5,0,0,5,10
2016,Serbia and Kosovo: S/RES/1244 (1999),SRB,Netherlands,NLD,0,0,658,1094,1752
2016,Senegal,SEN,Netherlands,NLD,0,0,12,35,47
2016,Sierra Leone,SLE,Netherlands,NLD,5,0,22,18,45
2016,Somalia,SOM,Netherlands,NLD,58,0,78,73,209
2016,Viet Nam,VNM,Netherlands,NLD,0,0,33,0,33
2016,Sudan,SDN,Netherlands,NLD,104,0,72,40,216
2016,Suriname,SUR,Netherlands,NLD,0,0,10,0,10
2016,Syrian Arab Rep.,SYR,Netherlands,NLD,12312,0,576,1018,13906
2016,United Rep. of Tanzania,TZA,Netherlands,NLD,0,0,5,0,5
2016,Tajikistan,TJK,Netherlands,NLD,0,0,5,18,23
2016,Trinidad and Tobago,TTO,Netherlands,NLD,20,0,0,0,20
2016,Tunisia,TUN,Netherlands,NLD,0,0,38,106,144
2016,Turkey,TUR,Netherlands,NLD,5,0,32,25,62
2016,Uganda,UGA,Netherlands,NLD,38,0,21,11,70
2016,Ukraine,UKR,Netherlands,NLD,5,0,170,361,536
2016,United States of America,USA,Netherlands,NLD,0,0,0,5,5
2016,Venezuela (Bolivarian Republic of),VEN,Netherlands,NLD,0,0,14,0,14
2016,Yemen,YEM,Netherlands,NLD,5,0,0,22,27
2016,Zimbabwe,ZWE,Netherlands,NLD,0,0,11,0,11
2016,Stateless,XXA,Netherlands,NLD,1654,0,86,132,1872
2016,Central African Rep.,CAF,Niger,NER,32,0,0,0,32
2016,Dem. Rep. of the Congo,COD,Niger,NER,5,0,0,0,5
2016,Libya,LBY,Niger,NER,5,0,0,0,5
2016,Nigeria,NGA,Niger,NER,0,0,0,11,11
2016,Central African Rep.,CAF,Nigeria,NGA,15,0,0,0,15
2016,Chad,TCD,Nigeria,NGA,0,0,0,11,11
2016,Dem. Rep. of the Congo,COD,Nigeria,NGA,15,0,0,0,15
2016,Eritrea,ERI,Nigeria,NGA,10,0,0,0,10
2016,Palestinian,PSE,Nigeria,NGA,5,0,0,0,5
2016,Cote d'Ivoire,CIV,Nigeria,NGA,0,0,11,0,11
2016,Mali,MLI,Nigeria,NGA,0,0,5,5,10
2016,Sudan,SDN,Nigeria,NGA,5,0,0,0,5
2016,Syrian Arab Rep.,SYR,Nigeria,NGA,54,0,0,0,54
2016,Togo,TGO,Nigeria,NGA,0,0,5,0,5
2016,Afghanistan,AFG,Norway,NOR,552,324,2775,727,4378
2016,Albania,ALB,Norway,NOR,0,0,103,30,133
2016,Algeria,DZA,Norway,NOR,0,0,13,40,53
2016,Angola,AGO,Norway,NOR,0,0,0,5,5
2016,Egypt,EGY,Norway,NOR,27,0,127,113,267
2016,Armenia,ARM,Norway,NOR,0,0,0,5,5
2016,Azerbaijan,AZE,Norway,NOR,5,0,5,10,20
2016,Burundi,BDI,Norway,NOR,11,0,0,0,11
2016,Bangladesh,BGD,Norway,NOR,0,0,26,60,86
2016,Belarus,BLR,Norway,NOR,0,0,0,11,11
2016,Bosnia and Herzegovina,BIH,Norway,NOR,0,0,5,5,10
2016,Bulgaria,BGR,Norway,NOR,5,0,0,0,5
2016,Canada,CAN,Norway,NOR,0,0,0,5,5
2016,China,CHN,Norway,NOR,24,0,5,10,39
2016,Cameroon,CMR,Norway,NOR,0,0,12,0,12
2016,Congo,COG,Norway,NOR,0,0,0,5,5
2016,Dem. Rep. of the Congo,COD,Norway,NOR,5,0,0,10,15
2016,Colombia,COL,Norway,NOR,0,0,5,0,5
2016,Czechia,CZE,Norway,NOR,0,0,5,0,5
2016,Djibouti,DJI,Norway,NOR,0,0,0,5,5
2016,Eritrea,ERI,Norway,NOR,1559,0,25,73,1657
2016,Ethiopia,ETH,Norway,NOR,217,0,278,40,535
2016,Gambia,GMB,Norway,NOR,0,0,25,14,39
2016,United Kingdom of Great Britain and Northern Ireland,GBR,Norway,NOR,0,0,5,0,5
2016,Georgia,GEO,Norway,NOR,0,0,5,5,10
2016,Germany,DEU,Norway,NOR,0,0,5,0,5
2016,Ghana,GHA,Norway,NOR,0,0,5,5,10
2016,Guinea,GIN,Norway,NOR,0,0,12,5,17
2016,Honduras,HND,Norway,NOR,0,0,5,0,5
2016,Cote d'Ivoire,CIV,Norway,NOR,0,0,5,0,5
2016,India,IND,Norway,NOR,0,0,12,36,48
2016,Iran (Islamic Rep. of),IRN,Norway,NOR,491,0,269,188,948
2016,Iraq,IRQ,Norway,NOR,187,34,1060,930,2211
2016,Israel,ISR,Norway,NOR,0,0,5,0,5
2016,Italy,ITA,Norway,NOR,0,0,5,0,5
2016,Jordan,JOR,Norway,NOR,0,0,10,10,20
2016,Kazakhstan,KAZ,Norway,NOR,0,0,0,5,5
2016,Kenya,KEN,Norway,NOR,0,0,5,0,5
2016,Kyrgyzstan,KGZ,Norway,NOR,0,0,0,11,11
2016,Rep. of Korea,KOR,Norway,NOR,0,0,5,0,5
2016,Libya,LBY,Norway,NOR,0,5,5,30,40
2016,Lebanon,LBN,Norway,NOR,10,0,69,43,122
2016,Sri Lanka,LKA,Norway,NOR,0,0,10,5,15
2016,Mauritania,MRT,Norway,NOR,0,0,0,5,5
2016,North Macedonia,MKD,Norway,NOR,0,0,16,11,27
2016,Rep. of Moldova,MDA,Norway,NOR,0,0,5,5,10
2016,Mali,MLI,Norway,NOR,0,0,0,10,10
2016,Mongolia,MNG,Norway,NOR,0,0,10,0,10
2016,Morocco,MAR,Norway,NOR,0,0,31,72,103
2016,Nepal,NPL,Norway,NOR,0,0,5,26,31
2016,Nigeria,NGA,Norway,NOR,5,0,24,36,65
2016,Pakistan,PAK,Norway,NOR,12,0,91,181,284
2016,Philippines,PHL,Norway,NOR,0,0,5,0,5
2016,Romania,ROU,Norway,NOR,0,0,10,0,10
2016,Russian Federation,RUS,Norway,NOR,0,0,35,33,68
2016,Saudi Arabia,SAU,Norway,NOR,0,0,0,10,10
2016,Serbia and Kosovo: S/RES/1244 (1999),SRB,Norway,NOR,0,0,43,12,55
2016,Senegal,SEN,Norway,NOR,0,0,16,5,21
2016,Sierra Leone,SLE,Norway,NOR,0,0,0,5,5
2016,Somalia,SOM,Norway,NOR,61,11,223,54,349
2016,Viet Nam,VNM,Norway,NOR,0,0,5,0,5
2016,Sudan,SDN,Norway,NOR,347,0,67,33,447
2016,South Sudan,SSD,Norway,NOR,0,0,5,0,5
2016,Sweden,SWE,Norway,NOR,0,0,5,0,5
2016,Syrian Arab Rep.,SYR,Norway,NOR,7394,0,11,1134,8539
2016,Tajikistan,TJK,Norway,NOR,0,0,14,5,19
2016,Tunisia,TUN,Norway,NOR,0,0,5,11,16
2016,Turkey,TUR,Norway,NOR,5,0,18,23,46
2016,Uganda,UGA,Norway,NOR,5,0,5,5,15
2016,Ukraine,UKR,Norway,NOR,0,0,14,31,45
2016,Uzbekistan,UZB,Norway,NOR,12,5,5,10,32
2016,Yemen,YEM,Norway,NOR,5,10,0,18,33
2016,Zimbabwe,ZWE,Norway,NOR,0,0,0,5,5
2016,Stateless,XXA,Norway,NOR,528,5,183,218,934
2016,Afghanistan,AFG,New Zealand,NZL,0,0,5,0,5
2016,Egypt,EGY,New Zealand,NZL,0,0,5,0,5
2016,Bahrain,BHR,New Zealand,NZL,0,0,5,0,5
2016,Bangladesh,BGD,New Zealand,NZL,0,0,14,0,14
2016,Bulgaria,BGR,New Zealand,NZL,0,0,5,0,5
2016,China,CHN,New Zealand,NZL,14,0,13,0,27
2016,Chile,CHL,New Zealand,NZL,5,0,0,0,5
2016,Dem. Rep. of the Congo,COD,New Zealand,NZL,0,0,5,0,5
2016,Colombia,COL,New Zealand,NZL,0,0,5,0,5
2016,Ethiopia,ETH,New Zealand,NZL,5,0,0,0,5
2016,Fiji,FJI,New Zealand,NZL,5,0,18,0,23
2016,Georgia,GEO,New Zealand,NZL,0,0,5,0,5
2016,Hungary,HUN,New Zealand,NZL,5,0,0,0,5
2016,India,IND,New Zealand,NZL,0,0,22,0,22
2016,Indonesia,IDN,New Zealand,NZL,0,0,5,0,5
2016,Iran (Islamic Rep. of),IRN,New Zealand,NZL,10,0,16,0,26
2016,Iraq,IRQ,New Zealand,NZL,18,0,5,0,23
2016,Sri Lanka,LKA,New Zealand,NZL,0,0,22,0,22
2016,Maldives,MDV,New Zealand,NZL,5,0,0,0,5
2016,Malaysia,MYS,New Zealand,NZL,5,0,5,0,10
2016,Nepal,NPL,New Zealand,NZL,0,0,5,0,5
2016,Pakistan,PAK,New Zealand,NZL,11,0,11,0,22
2016,Philippines,PHL,New Zealand,NZL,0,0,5,0,5
2016,South Africa,ZAF,New Zealand,NZL,0,0,18,0,18
2016,Saudi Arabia,SAU,New Zealand,NZL,5,0,10,0,15
2016,Somalia,SOM,New Zealand,NZL,0,0,5,0,5
2016,Syrian Arab Rep.,SYR,New Zealand,NZL,10,0,0,0,10
2016,Tonga,TON,New Zealand,NZL,0,0,5,0,5
2016,Turkey,TUR,New Zealand,NZL,13,0,0,0,13
2016,Tuvalu,TUV,New Zealand,NZL,0,0,5,0,5
2016,Uganda,UGA,New Zealand,NZL,0,0,5,0,5
2016,Zimbabwe,ZWE,New Zealand,NZL,5,0,0,0,5
2016,Angola,AGO,Panama,PAN,0,0,0,5,5
2016,Congo,COG,Panama,PAN,0,0,0,5,5
2016,Colombia,COL,Panama,PAN,23,0,5,648,676
2016,Cuba,CUB,Panama,PAN,0,0,0,137,137
2016,Dominican Rep.,DOM,Panama,PAN,0,0,0,28,28
2016,Ethiopia,ETH,Panama,PAN,0,0,0,5,5
2016,Ghana,GHA,Panama,PAN,0,0,0,5,5
2016,Guatemala,GTM,Panama,PAN,0,0,0,5,5
2016,Haiti,HTI,Panama,PAN,5,0,0,40,45
2016,Honduras,HND,Panama,PAN,0,0,0,36,36
2016,Nicaragua,NIC,Panama,PAN,0,0,0,417,417
2016,Pakistan,PAK,Panama,PAN,0,0,0,5,5
2016,El Salvador,SLV,Panama,PAN,0,0,0,119,119
2016,Syrian Arab Rep.,SYR,Panama,PAN,0,0,0,5,5
2016,Venezuela (Bolivarian Republic of),VEN,Panama,PAN,5,0,0,447,452
2016,Dem. Rep. of the Congo,COD,Paraguay,PRY,0,0,0,5,5
2016,Cuba,CUB,Paraguay,PRY,0,0,5,5,10
2016,Syrian Arab Rep.,SYR,Paraguay,PRY,24,0,0,5,29
2016,Turkey,TUR,Paraguay,PRY,5,0,0,0,5
2016,Venezuela (Bolivarian Republic of),VEN,Paraguay,PRY,5,0,0,0,5
2016,Bangladesh,BGD,Peru,PER,0,0,5,0,5
2016,Bolivia (Plurinational State of),BOL,Peru,PER,5,0,0,0,5
2016,Cameroon,CMR,Peru,PER,0,0,5,0,5
2016,Dem. Rep. of the Congo,COD,Peru,PER,5,0,0,0,5
2016,Colombia,COL,Peru,PER,32,0,32,13,77
2016,Cuba,CUB,Peru,PER,17,0,32,5,54
2016,Dominican Rep.,DOM,Peru,PER,5,0,12,0,17
2016,Palestinian,PSE,Peru,PER,5,0,0,0,5
2016,Ghana,GHA,Peru,PER,0,0,5,0,5
2016,Haiti,HTI,Peru,PER,20,0,0,0,20
2016,India,IND,Peru,PER,5,0,0,0,5
2016,Nigeria,NGA,Peru,PER,0,0,5,0,5
2016,Philippines,PHL,Peru,PER,0,0,5,0,5
2016,Syrian Arab Rep.,SYR,Peru,PER,5,0,0,0,5
2016,Ukraine,UKR,Peru,PER,5,0,0,0,5
2016,Venezuela (Bolivarian Republic of),VEN,Peru,PER,64,0,69,28,161
2016,Iran (Islamic Rep. of),IRN,Papua New Guinea,PNG,15,0,93,0,108
2016,Iraq,IRQ,Papua New Guinea,PNG,0,0,5,0,5
2016,Lebanon,LBN,Papua New Guinea,PNG,0,0,5,0,5
2016,Pakistan,PAK,Papua New Guinea,PNG,5,0,5,0,10
2016,Somalia,SOM,Papua New Guinea,PNG,5,0,0,0,5
2016,Afghanistan,AFG,Poland,POL,0,0,5,12,17
2016,Algeria,DZA,Poland,POL,0,0,0,5,5
2016,Egypt,EGY,Poland,POL,0,0,5,14,19
2016,Armenia,ARM,Poland,POL,0,0,14,296,310
2016,Azerbaijan,AZE,Poland,POL,0,0,5,5,10
2016,Bangladesh,BGD,Poland,POL,0,0,5,0,5
2016,Belarus,BLR,Poland,POL,5,0,10,14,29
2016,China,CHN,Poland,POL,0,0,0,14,14
2016,Cameroon,CMR,Poland,POL,0,5,0,0,5
2016,Congo,COG,Poland,POL,0,0,0,5,5
2016,Dem. Rep. of the Congo,COD,Poland,POL,0,0,5,0,5
2016,Georgia,GEO,Poland,POL,0,0,36,100,136
2016,Ghana,GHA,Poland,POL,0,0,5,0,5
2016,India,IND,Poland,POL,0,0,0,5,5
2016,Iran (Islamic Rep. of),IRN,Poland,POL,0,0,0,21,21
2016,Iraq,IRQ,Poland,POL,5,16,5,0,26
2016,Jordan,JOR,Poland,POL,0,0,0,5,5
2016,Kazakhstan,KAZ,Poland,POL,0,0,15,18,33
2016,Kyrgyzstan,KGZ,Poland,POL,0,0,31,55,86
2016,Libya,LBY,Poland,POL,0,5,0,5,10
2016,Lebanon,LBN,Poland,POL,0,0,0,5,5
2016,Sri Lanka,LKA,Poland,POL,0,0,0,5,5
2016,Rep. of Moldova,MDA,Poland,POL,0,0,10,0,10
2016,Mongolia,MNG,Poland,POL,0,0,0,5,5
2016,Morocco,MAR,Poland,POL,0,0,0,5,5
2016,Pakistan,PAK,Poland,POL,0,0,10,16,26
2016,Russian Federation,RUS,Poland,POL,10,57,1125,7701,8893
2016,Viet Nam,VNM,Poland,POL,0,0,51,29,80
2016,Sudan,SDN,Poland,POL,0,0,5,0,5
2016,Syrian Arab Rep.,SYR,Poland,POL,40,5,0,19,64
2016,Tajikistan,TJK,Poland,POL,5,5,110,651,771
2016,Turkmenistan,TKM,Poland,POL,10,0,0,0,10
2016,Tunisia,TUN,Poland,POL,0,0,0,5,5
2016,Turkey,TUR,Poland,POL,0,0,26,37,63
2016,Uganda,UGA,Poland,POL,5,0,0,0,5
2016,Ukraine,UKR,Poland,POL,16,51,696,434,1197
2016,Uzbekistan,UZB,Poland,POL,0,0,12,18,30
2016,Stateless,XXA,Poland,POL,0,0,0,13,13
2016,Afghanistan,AFG,Portugal,PRT,0,5,0,5,10
2016,Algeria,DZA,Portugal,PRT,0,0,0,10,10
2016,Angola,AGO,Portugal,PRT,0,0,5,19,24
2016,Bangladesh,BGD,Portugal,PRT,0,0,0,12,12
2016,Belarus,BLR,Portugal,PRT,0,0,0,5,5
2016,Brazil,BRA,Portugal,PRT,0,0,0,10,10
2016,China,CHN,Portugal,PRT,0,0,41,0,41
2016,Cameroon,CMR,Portugal,PRT,5,0,0,5,10
2016,Congo,COG,Portugal,PRT,0,0,5,25,30
2016,Dem. Rep. of the Congo,COD,Portugal,PRT,0,0,0,37,37
2016,Comoros,COM,Portugal,PRT,0,0,0,5,5
2016,Colombia,COL,Portugal,PRT,0,0,0,5,5
2016,Cuba,CUB,Portugal,PRT,0,0,0,5,5
2016,Eritrea,ERI,Portugal,PRT,30,0,0,123,153
2016,Gambia,GMB,Portugal,PRT,0,0,0,19,19
2016,Ghana,GHA,Portugal,PRT,0,0,0,5,5
2016,Guinea-Bissau,GNB,Portugal,PRT,0,0,0,5,5
2016,Guinea,GIN,Portugal,PRT,5,0,5,42,52
2016,Cote d'Ivoire,CIV,Portugal,PRT,5,0,5,0,10
2016,India,IND,Portugal,PRT,0,0,0,5,5
2016,Iran (Islamic Rep. of),IRN,Portugal,PRT,12,0,0,5,17
2016,Iraq,IRQ,Portugal,PRT,0,12,0,34,46
2016,Libya,LBY,Portugal,PRT,5,0,0,0,5
2016,Sri Lanka,LKA,Portugal,PRT,0,0,0,11,11
2016,Mauritania,MRT,Portugal,PRT,0,0,0,5,5
2016,Mali,MLI,Portugal,PRT,0,0,0,23,23
2016,Morocco,MAR,Portugal,PRT,0,0,5,0,5
2016,Nigeria,NGA,Portugal,PRT,0,0,0,5,5
2016,Pakistan,PAK,Portugal,PRT,10,10,24,27,71
2016,Russian Federation,RUS,Portugal,PRT,0,0,5,5,10
2016,Serbia and Kosovo: S/RES/1244 (1999),SRB,Portugal,PRT,0,0,0,5,5
2016,Senegal,SEN,Portugal,PRT,0,0,0,28,28
2016,Sierra Leone,SLE,Portugal,PRT,0,0,0,15,15
2016,Somalia,SOM,Portugal,PRT,0,0,0,5,5
2016,Syrian Arab Rep.,SYR,Portugal,PRT,31,34,0,96,161
2016,Togo,TGO,Portugal,PRT,5,0,0,0,5
2016,Ukraine,UKR,Portugal,PRT,5,191,5,60,261
2016,Venezuela (Bolivarian Republic of),VEN,Portugal,PRT,0,0,0,11,11
2016,Afghanistan,AFG,Romania,ROU,14,0,32,44,90
2016,Albania,ALB,Romania,ROU,0,0,0,10,10
2016,Algeria,DZA,Romania,ROU,0,0,0,5,5
2016,Egypt,EGY,Romania,ROU,0,0,11,0,11
2016,Burundi,BDI,Romania,ROU,5,0,0,0,5
2016,Bangladesh,BGD,Romania,ROU,0,0,14,0,14
2016,Central African Rep.,CAF,Romania,ROU,5,0,0,0,5
2016,China,CHN,Romania,ROU,0,0,5,0,5
2016,Cameroon,CMR,Romania,ROU,0,0,10,0,10
2016,Dem. Rep. of the Congo,COD,Romania,ROU,0,0,5,0,5
2016,Eritrea,ERI,Romania,ROU,44,0,0,0,44
2016,Ethiopia,ETH,Romania,ROU,5,0,0,0,5
2016,Palestinian,PSE,Romania,ROU,13,0,0,0,13
2016,India,IND,Romania,ROU,0,0,5,0,5
2016,Iran (Islamic Rep. of),IRN,Romania,ROU,0,0,5,13,18
2016,Iraq,IRQ,Romania,ROU,92,40,37,95,264
2016,Jordan,JOR,Romania,ROU,0,0,5,0,5
2016,Libya,LBY,Romania,ROU,0,0,0,5,5
2016,Sri Lanka,LKA,Romania,ROU,0,0,5,0,5
2016,Rep. of Moldova,MDA,Romania,ROU,0,0,5,5,10
2016,Morocco,MAR,Romania,ROU,0,0,5,5,10
2016,Nigeria,NGA,Romania,ROU,0,0,0,5,5
2016,Pakistan,PAK,Romania,ROU,0,0,40,15,55
2016,Philippines,PHL,Romania,ROU,0,0,10,0,10
2016,Rwanda,RWA,Romania,ROU,5,0,0,0,5
2016,Serbia and Kosovo: S/RES/1244 (1999),SRB,Romania,ROU,0,0,5,16,21
2016,Somalia,SOM,Romania,ROU,15,0,0,5,20
2016,Viet Nam,VNM,Romania,ROU,0,0,5,5,10
2016,Syrian Arab Rep.,SYR,Romania,ROU,359,143,5,149,656
2016,Tunisia,TUN,Romania,ROU,0,0,5,0,5
2016,Turkey,TUR,Romania,ROU,0,0,20,13,33
2016,Ukraine,UKR,Romania,ROU,5,0,0,5,10
2016,Yemen,YEM,Romania,ROU,12,5,5,0,22
2016,Stateless,XXA,Romania,ROU,31,0,5,0,36
2016,Algeria,DZA,South Africa,ZAF,0,0,21,0,21
2016,Angola,AGO,South Africa,ZAF,0,0,5,0,5
2016,Egypt,EGY,South Africa,ZAF,0,0,113,0,113
2016,Burundi,BDI,South Africa,ZAF,80,0,1547,0,1627
2016,Benin,BEN,South Africa,ZAF,0,0,23,0,23
2016,Bangladesh,BGD,South Africa,ZAF,17,0,2575,0,2592
2016,China,CHN,South Africa,ZAF,0,0,148,0,148
2016,Cameroon,CMR,South Africa,ZAF,5,0,152,0,157
2016,Congo,COG,South Africa,ZAF,196,0,747,0,943
2016,Dem. Rep. of the Congo,COD,South Africa,ZAF,1130,0,5875,0,7005
2016,Eritrea,ERI,South Africa,ZAF,78,0,181,0,259
2016,Estonia,EST,South Africa,ZAF,0,0,5,0,5
2016,Ethiopia,ETH,South Africa,ZAF,323,0,7460,0,7783
2016,Gabon,GAB,South Africa,ZAF,0,0,13,0,13
2016,Gambia,GMB,South Africa,ZAF,0,0,5,0,5
2016,Palestinian,PSE,South Africa,ZAF,0,0,5,0,5
2016,Ghana,GHA,South Africa,ZAF,0,0,984,0,984
2016,Guinea-Bissau,GNB,South Africa,ZAF,0,0,5,0,5
2016,Guinea,GIN,South Africa,ZAF,0,0,12,0,12
2016,Cote d'Ivoire,CIV,South Africa,ZAF,5,0,24,0,29
2016,India,IND,South Africa,ZAF,0,0,653,0,653
2016,Iraq,IRQ,South Africa,ZAF,0,0,5,0,5
2016,Jordan,JOR,South Africa,ZAF,0,0,5,0,5
2016,Kenya,KEN,South Africa,ZAF,5,0,178,0,183
2016,Liberia,LBR,South Africa,ZAF,0,0,25,0,25
2016,Libya,LBY,South Africa,ZAF,0,0,5,0,5
2016,Lesotho,LSO,South Africa,ZAF,0,0,22,0,22
2016,Sri Lanka,LKA,South Africa,ZAF,0,0,5,0,5
2016,Mali,MLI,South Africa,ZAF,0,0,18,0,18
2016,Malawi,MWI,South Africa,ZAF,0,0,1642,0,1642
2016,Morocco,MAR,South Africa,ZAF,0,0,5,0,5
2016,Mozambique,MOZ,South Africa,ZAF,0,0,470,0,470
2016,Nepal,NPL,South Africa,ZAF,0,0,62,0,62
2016,Niger,NER,South Africa,ZAF,0,0,18,0,18
2016,Nigeria,NGA,South Africa,ZAF,0,0,3096,0,3096
2016,Pakistan,PAK,South Africa,ZAF,0,0,1195,0,1195
2016,Rwanda,RWA,South Africa,ZAF,48,0,139,0,187
2016,Senegal,SEN,South Africa,ZAF,0,0,189,0,189
2016,Somalia,SOM,South Africa,ZAF,1169,0,904,0,2073
2016,Sudan,SDN,South Africa,ZAF,0,0,14,0,14
2016,Eswatini,SWZ,South Africa,ZAF,0,0,22,0,22
2016,Syrian Arab Rep.,SYR,South Africa,ZAF,12,0,12,0,24
2016,United Rep. of Tanzania,TZA,South Africa,ZAF,0,0,335,0,335
2016,Thailand,THA,South Africa,ZAF,0,0,41,0,41
2016,Togo,TGO,South Africa,ZAF,0,0,5,0,5
2016,Tunisia,TUN,South Africa,ZAF,0,0,5,0,5
2016,Turkey,TUR,South Africa,ZAF,5,0,0,0,5
2016,Uganda,UGA,South Africa,ZAF,5,0,849,0,854
2016,Yemen,YEM,South Africa,ZAF,0,0,5,0,5
2016,Zambia,ZMB,South Africa,ZAF,0,0,115,0,115
2016,Zimbabwe,ZWE,South Africa,ZAF,73,0,7869,0,7942
2016,Afghanistan,AFG,Russian Federation,RUS,0,0,0,276,276
2016,Egypt,EGY,Russian Federation,RUS,0,0,0,5,5
2016,Armenia,ARM,Russian Federation,RUS,0,0,0,5,5
2016,Azerbaijan,AZE,Russian Federation,RUS,0,0,0,11,11
2016,Belarus,BLR,Russian Federation,RUS,0,0,0,20,20
2016,Cameroon,CMR,Russian Federation,RUS,0,0,0,5,5
2016,Dem. Rep. of the Congo,COD,Russian Federation,RUS,0,0,0,12,12
2016,Palestinian,PSE,Russian Federation,RUS,0,0,0,10,10
2016,Georgia,GEO,Russian Federation,RUS,0,0,0,39,39
2016,India,IND,Russian Federation,RUS,0,0,0,5,5
2016,Iran (Islamic Rep. of),IRN,Russian Federation,RUS,0,0,0,5,5
2016,Iraq,IRQ,Russian Federation,RUS,0,0,0,22,22
2016,Kazakhstan,KAZ,Russian Federation,RUS,0,0,0,5,5
2016,Kyrgyzstan,KGZ,Russian Federation,RUS,0,0,0,14,14
2016,Dem. People's Rep. of Korea,PRK,Russian Federation,RUS,0,0,0,31,31
2016,Lebanon,LBN,Russian Federation,RUS,0,0,0,5,5
2016,Lithuania,LTU,Russian Federation,RUS,0,0,0,5,5
2016,Rep. of Moldova,MDA,Russian Federation,RUS,0,0,0,12,12
2016,Pakistan,PAK,Russian Federation,RUS,0,0,0,10,10
2016,Sudan,SDN,Russian Federation,RUS,0,0,0,5,5
2016,Syrian Arab Rep.,SYR,Russian Federation,RUS,0,0,0,362,362
2016,Tajikistan,TJK,Russian Federation,RUS,0,0,0,19,19
2016,Turkmenistan,TKM,Russian Federation,RUS,0,0,0,5,5
2016,Turkey,TUR,Russian Federation,RUS,0,0,0,5,5
2016,Ukraine,UKR,Russian Federation,RUS,33,0,0,302,335
2016,United States of America,USA,Russian Federation,RUS,0,0,0,10,10
2016,Uzbekistan,UZB,Russian Federation,RUS,0,0,0,34,34
2016,Yemen,YEM,Russian Federation,RUS,0,0,0,21,21
2016,Stateless,XXA,Russian Federation,RUS,0,0,0,5,5
2016,Afghanistan,AFG,El Salvador,SLV,0,0,0,5,5
2016,Afghanistan,AFG,Serbia and Kosovo: S/RES/1244 (1999),SRB,0,5,0,369,374
2016,Bangladesh,BGD,Serbia and Kosovo: S/RES/1244 (1999),SRB,0,0,0,5,5
2016,Bosnia and Herzegovina,BIH,Serbia and Kosovo: S/RES/1244 (1999),SRB,0,0,0,5,5
2016,Cameroon,CMR,Serbia and Kosovo: S/RES/1244 (1999),SRB,0,0,0,5,5
2016,Cuba,CUB,Serbia and Kosovo: S/RES/1244 (1999),SRB,5,0,0,0,5
2016,Palestinian,PSE,Serbia and Kosovo: S/RES/1244 (1999),SRB,0,0,0,13,13
2016,Ghana,GHA,Serbia and Kosovo: S/RES/1244 (1999),SRB,0,0,0,5,5
2016,Croatia,HRV,Serbia and Kosovo: S/RES/1244 (1999),SRB,0,0,0,5,5
2016,Iran (Islamic Rep. of),IRN,Serbia and Kosovo: S/RES/1244 (1999),SRB,0,0,0,20,20
2016,Iraq,IRQ,Serbia and Kosovo: S/RES/1244 (1999),SRB,0,0,0,150,150
2016,Libya,LBY,Serbia and Kosovo: S/RES/1244 (1999),SRB,5,10,26,5,46
2016,North Macedonia,MKD,Serbia and Kosovo: S/RES/1244 (1999),SRB,0,0,5,5,10
2016,Morocco,MAR,Serbia and Kosovo: S/RES/1244 (1999),SRB,0,0,0,5,5
2016,Pakistan,PAK,Serbia and Kosovo: S/RES/1244 (1999),SRB,0,0,5,63,68
2016,Russian Federation,RUS,Serbia and Kosovo: S/RES/1244 (1999),SRB,0,0,0,12,12
2016,Somalia,SOM,Serbia and Kosovo: S/RES/1244 (1999),SRB,0,5,0,0,5
2016,Sudan,SDN,Serbia and Kosovo: S/RES/1244 (1999),SRB,0,0,0,11,11
2016,Syrian Arab Rep.,SYR,Serbia and Kosovo: S/RES/1244 (1999),SRB,0,10,0,155,165
2016,Ukraine,UKR,Serbia and Kosovo: S/RES/1244 (1999),SRB,0,5,0,0,5
2016,Stateless,XXA,Serbia and Kosovo: S/RES/1244 (1999),SRB,0,0,0,5,5
2016,Sudan,SDN,Sierra Leone,SLE,0,0,0,5,5
2016,Afghanistan,AFG,Spain,ESP,15,27,5,0,47
2016,Algeria,DZA,Spain,ESP,5,0,403,0,408
2016,Egypt,EGY,Spain,ESP,0,0,13,0,13
2016,Armenia,ARM,Spain,ESP,0,0,10,0,10
2016,Benin,BEN,Spain,ESP,5,0,0,0,5
2016,Bangladesh,BGD,Spain,ESP,5,0,0,0,5
2016,Burkina Faso,BFA,Spain,ESP,0,0,5,0,5
2016,Bolivia (Plurinational State of),BOL,Spain,ESP,0,0,5,0,5
2016,Brazil,BRA,Spain,ESP,0,0,5,0,5
2016,Bosnia and Herzegovina,BIH,Spain,ESP,0,0,5,0,5
2016,Central African Rep.,CAF,Spain,ESP,0,17,0,0,17
2016,China,CHN,Spain,ESP,5,0,0,0,5
2016,Cameroon,CMR,Spain,ESP,24,0,19,0,43
2016,Dem. Rep. of the Congo,COD,Spain,ESP,0,0,19,0,19
2016,Colombia,COL,Spain,ESP,5,0,92,0,97
2016,Cuba,CUB,Spain,ESP,0,5,15,0,20
2016,Ecuador,ECU,Spain,ESP,0,0,5,0,5
2016,Eritrea,ERI,Spain,ESP,40,5,0,0,45
2016,Ethiopia,ETH,Spain,ESP,0,5,0,0,5
2016,Gambia,GMB,Spain,ESP,0,0,11,0,11
2016,Palestinian,PSE,Spain,ESP,29,63,19,0,111
2016,Georgia,GEO,Spain,ESP,0,0,10,0,10
2016,Guinea-Bissau,GNB,Spain,ESP,0,0,5,0,5
2016,Guinea,GIN,Spain,ESP,0,0,32,0,32
2016,Honduras,HND,Spain,ESP,0,0,5,0,5
2016,Cote d'Ivoire,CIV,Spain,ESP,0,0,11,0,11
2016,Iran (Islamic Rep. of),IRN,Spain,ESP,10,5,16,0,31
2016,Iraq,IRQ,Spain,ESP,28,57,0,0,85
2016,Israel,ISR,Spain,ESP,0,0,5,0,5
2016,Kazakhstan,KAZ,Spain,ESP,0,0,5,0,5
2016,Liberia,LBR,Spain,ESP,5,0,0,0,5
2016,Libya,LBY,Spain,ESP,0,5,0,0,5
2016,Lebanon,LBN,Spain,ESP,0,12,0,0,12
2016,Sri Lanka,LKA,Spain,ESP,0,0,5,0,5
2016,Mexico,MEX,Spain,ESP,5,0,0,0,5
2016,Mali,MLI,Spain,ESP,0,0,1016,0,1016
2016,Morocco,MAR,Spain,ESP,10,0,76,0,86
2016,Nigeria,NGA,Spain,ESP,23,0,21,0,44
2016,Pakistan,PAK,Spain,ESP,44,0,47,0,91
2016,Peru,PER,Spain,ESP,0,0,10,0,10
2016,Russian Federation,RUS,Spain,ESP,13,0,24,0,37
2016,El Salvador,SLV,Spain,ESP,0,0,10,0,10
2016,Serbia and Kosovo: S/RES/1244 (1999),SRB,Spain,ESP,0,0,10,0,10
2016,Senegal,SEN,Spain,ESP,0,0,5,0,5
2016,Sierra Leone,SLE,Spain,ESP,0,0,5,0,5
2016,Somalia,SOM,Spain,ESP,10,88,10,0,108
2016,Sudan,SDN,Spain,ESP,0,0,5,0,5
2016,Syrian Arab Rep.,SYR,Spain,ESP,53,6160,59,0,6272
2016,Togo,TGO,Spain,ESP,0,0,5,0,5
2016,Tunisia,TUN,Spain,ESP,0,0,12,0,12
2016,Ukraine,UKR,Spain,ESP,16,50,345,0,411
2016,Venezuela (Bolivarian Republic of),VEN,Spain,ESP,5,0,0,0,5
2016,Western Sahara,ESH,Spain,ESP,0,0,5,0,5
2016,Yemen,YEM,Spain,ESP,5,0,0,0,5
2016,Tibetan,TIB,Spain,ESP,5,0,0,0,5
2016,United States of America,USA,Saint Kitts and Nevis,KNA,0,0,5,0,5
2016,Egypt,EGY,Sudan,SDN,0,0,0,5,5
2016,Burundi,BDI,Sudan,SDN,5,0,0,0,5
2016,Cameroon,CMR,Sudan,SDN,5,0,0,0,5
2016,Dem. Rep. of the Congo,COD,Sudan,SDN,5,0,0,0,5
2016,Eritrea,ERI,Sudan,SDN,4273,5,5,36,4319
2016,Ethiopia,ETH,Sudan,SDN,308,10,76,43,437
2016,Somalia,SOM,Sudan,SDN,28,0,0,0,28
2016,Syrian Arab Rep.,SYR,Sudan,SDN,11,0,0,0,11
2016,Afghanistan,AFG,Slovakia,SVK,0,11,0,5,16
2016,Algeria,DZA,Slovakia,SVK,0,0,5,0,5
2016,Dem. Rep. of the Congo,COD,Slovakia,SVK,0,0,5,0,5
2016,India,IND,Slovakia,SVK,0,0,5,5,10
2016,Iran (Islamic Rep. of),IRN,Slovakia,SVK,0,0,0,5,5
2016,Iraq,IRQ,Slovakia,SVK,154,0,0,0,154
2016,North Macedonia,MKD,Slovakia,SVK,0,0,5,0,5
2016,Nigeria,NGA,Slovakia,SVK,0,0,5,0,5
2016,Pakistan,PAK,Slovakia,SVK,0,0,12,0,12
2016,Russian Federation,RUS,Slovakia,SVK,0,0,5,0,5
2016,Somalia,SOM,Slovakia,SVK,0,5,0,0,5
2016,Viet Nam,VNM,Slovakia,SVK,0,0,0,5,5
2016,Syrian Arab Rep.,SYR,Slovakia,SVK,0,0,0,13,13
2016,Ukraine,UKR,Slovakia,SVK,0,0,14,5,19
2016,Afghanistan,AFG,Slovenia,SVN,0,13,82,249,344
2016,Albania,ALB,Slovenia,SVN,0,0,0,5,5
2016,Algeria,DZA,Slovenia,SVN,0,0,15,19,34
2016,Egypt,EGY,Slovenia,SVN,0,0,5,0,5
2016,Bangladesh,BGD,Slovenia,SVN,0,0,0,5,5
2016,Bosnia and Herzegovina,BIH,Slovenia,SVN,0,0,0,5,5
2016,Cameroon,CMR,Slovenia,SVN,0,0,5,0,5
2016,Cuba,CUB,Slovenia,SVN,0,0,0,5,5
2016,Eritrea,ERI,Slovenia,SVN,21,0,0,5,26
2016,Ghana,GHA,Slovenia,SVN,0,0,5,0,5
2016,Iran (Islamic Rep. of),IRN,Slovenia,SVN,12,0,22,26,60
2016,Iraq,IRQ,Slovenia,SVN,29,0,26,70,125
2016,Kazakhstan,KAZ,Slovenia,SVN,5,0,0,0,5
2016,Libya,LBY,Slovenia,SVN,0,0,5,11,16
2016,Sri Lanka,LKA,Slovenia,SVN,0,0,5,0,5
2016,Morocco,MAR,Slovenia,SVN,0,0,16,20,36
2016,Nigeria,NGA,Slovenia,SVN,0,0,5,0,5
2016,Pakistan,PAK,Slovenia,SVN,0,0,53,43,96
2016,Russian Federation,RUS,Slovenia,SVN,0,0,5,0,5
2016,Serbia and Kosovo: S/RES/1244 (1999),SRB,Slovenia,SVN,0,0,5,22,27
2016,Syrian Arab Rep.,SYR,Slovenia,SVN,68,20,61,115,264
2016,Tunisia,TUN,Slovenia,SVN,0,0,5,5,10
2016,Turkey,TUR,Slovenia,SVN,0,0,11,13,24
2016,Burundi,BDI,Eswatini,SWZ,5,0,0,0,5
2016,Dem. Rep. of the Congo,COD,Eswatini,SWZ,15,0,0,0,15
2016,Rwanda,RWA,Eswatini,SWZ,10,0,0,0,10
2016,Afghanistan,AFG,Sweden,SWE,1352,2013,4031,4394,11790
2016,Albania,ALB,Sweden,SWE,12,23,867,318,1220
2016,Algeria,DZA,Sweden,SWE,0,5,49,178,232
2016,Angola,AGO,Sweden,SWE,0,0,0,10,10
2016,Egypt,EGY,Sweden,SWE,39,21,284,87,431
2016,Argentina,ARG,Sweden,SWE,0,0,5,0,5
2016,Armenia,ARM,Sweden,SWE,5,22,221,122,370
2016,Azerbaijan,AZE,Sweden,SWE,69,13,155,161,398
2016,Burundi,BDI,Sweden,SWE,24,5,15,21,65
2016,Bangladesh,BGD,Sweden,SWE,17,0,126,79,222
2016,Belarus,BLR,Sweden,SWE,10,5,80,123,218
2016,Bolivia (Plurinational State of),BOL,Sweden,SWE,5,0,11,5,21
2016,Brazil,BRA,Sweden,SWE,0,0,12,10,22
2016,Bosnia and Herzegovina,BIH,Sweden,SWE,0,0,195,55,250
2016,Bulgaria,BGR,Sweden,SWE,0,0,11,0,11
2016,Canada,CAN,Sweden,SWE,0,0,0,5,5
2016,Chad,TCD,Sweden,SWE,13,0,0,0,13
2016,China,CHN,Sweden,SWE,33,0,47,38,118
2016,Chile,CHL,Sweden,SWE,0,0,22,5,27
2016,Cameroon,CMR,Sweden,SWE,14,5,27,22,68
2016,Congo,COG,Sweden,SWE,5,0,5,11,21
2016,Dem. Rep. of the Congo,COD,Sweden,SWE,18,5,12,12,47
2016,Colombia,COL,Sweden,SWE,0,5,55,10,70
2016,Cuba,CUB,Sweden,SWE,0,0,21,22,43
2016,Djibouti,DJI,Sweden,SWE,5,0,19,10,34
2016,Equatorial Guinea,GNQ,Sweden,SWE,0,0,0,5,5
2016,Eritrea,ERI,Sweden,SWE,2680,2723,38,373,5814
2016,Ethiopia,ETH,Sweden,SWE,583,42,376,155,1156
2016,Gambia,GMB,Sweden,SWE,24,5,58,120,207
2016,Palestinian,PSE,Sweden,SWE,220,287,279,75,861
2016,United Kingdom of Great Britain and Northern Ireland,GBR,Sweden,SWE,0,0,5,0,5
2016,Georgia,GEO,Sweden,SWE,5,5,565,486,1061
2016,Germany,DEU,Sweden,SWE,0,0,0,5,5
2016,Ghana,GHA,Sweden,SWE,5,5,32,38,80
2016,Guinea-Bissau,GNB,Sweden,SWE,0,0,0,5,5
2016,Greece,GRC,Sweden,SWE,0,5,5,0,10
2016,Guinea,GIN,Sweden,SWE,10,0,13,23,46
2016,Honduras,HND,Sweden,SWE,0,5,10,5,20
2016,Hungary,HUN,Sweden,SWE,0,0,5,0,5
2016,Cote d'Ivoire,CIV,Sweden,SWE,0,0,13,18,31
2016,India,IND,Sweden,SWE,0,0,45,37,82
2016,Indonesia,IDN,Sweden,SWE,5,0,5,0,10
2016,Iran (Islamic Rep. of),IRN,Sweden,SWE,478,24,332,1148,1982
2016,Iraq,IRQ,Sweden,SWE,926,593,1781,6018,9318
2016,Israel,ISR,Sweden,SWE,0,5,15,5,25
2016,Italy,ITA,Sweden,SWE,0,0,5,0,5
2016,Jamaica,JAM,Sweden,SWE,0,0,0,5,5
2016,Jordan,JOR,Sweden,SWE,10,37,94,83,224
2016,Kazakhstan,KAZ,Sweden,SWE,0,17,98,161,276
2016,Kenya,KEN,Sweden,SWE,5,0,18,13,36
2016,Kyrgyzstan,KGZ,Sweden,SWE,5,0,82,131,218
2016,Rep. of Korea,KOR,Sweden,SWE,0,0,0,5,5
2016,Kuwait,KWT,Sweden,SWE,0,0,5,33,38
2016,Liberia,LBR,Sweden,SWE,0,0,0,12,12
2016,Libya,LBY,Sweden,SWE,32,16,66,137,251
2016,Lebanon,LBN,Sweden,SWE,14,64,220,261,559
2016,Sri Lanka,LKA,Sweden,SWE,0,0,13,5,18
2016,Lithuania,LTU,Sweden,SWE,0,0,0,5,5
2016,Latvia,LVA,Sweden,SWE,0,0,5,0,5
2016,Mauritania,MRT,Sweden,SWE,0,0,0,14,14
2016,North Macedonia,MKD,Sweden,SWE,0,5,116,94,215
2016,Rep. of Moldova,MDA,Sweden,SWE,0,5,23,16,44
2016,Mexico,MEX,Sweden,SWE,0,0,0,5,5
2016,Mali,MLI,Sweden,SWE,0,0,5,12,17
2016,Malaysia,MYS,Sweden,SWE,0,0,5,0,5
2016,Mongolia,MNG,Sweden,SWE,5,34,937,162,1138
2016,Morocco,MAR,Sweden,SWE,17,15,215,349,596
2016,Mozambique,MOZ,Sweden,SWE,0,0,0,5,5
2016,Montenegro,MNE,Sweden,SWE,0,0,21,5,26
2016,Nepal,NPL,Sweden,SWE,0,0,21,25,46
2016,Niger,NER,Sweden,SWE,5,0,0,5,10
2016,Nicaragua,NIC,Sweden,SWE,0,5,28,0,33
2016,Nigeria,NGA,Sweden,SWE,57,14,205,182,458
2016,Norway,NOR,Sweden,SWE,0,0,5,0,5
2016,Pakistan,PAK,Sweden,SWE,66,5,218,189,478
2016,Peru,PER,Sweden,SWE,0,0,14,0,14
2016,Philippines,PHL,Sweden,SWE,0,5,23,5,33
2016,Romania,ROU,Sweden,SWE,0,0,14,5,19
2016,South Africa,ZAF,Sweden,SWE,0,0,0,5,5
2016,Russian Federation,RUS,Sweden,SWE,106,29,235,159,529
2016,Rwanda,RWA,Sweden,SWE,0,0,0,12,12
2016,El Salvador,SLV,Sweden,SWE,10,17,177,18,222
2016,Saudi Arabia,SAU,Sweden,SWE,10,5,10,10,35
2016,Serbia and Kosovo: S/RES/1244 (1999),SRB,Sweden,SWE,5,23,494,248,770
2016,Senegal,SEN,Sweden,SWE,11,0,13,32,56
2016,Sierra Leone,SLE,Sweden,SWE,11,0,11,0,22
2016,Somalia,SOM,Sweden,SWE,1211,373,1009,586,3179
2016,Spain,ESP,Sweden,SWE,0,0,5,5,10
2016,Viet Nam,VNM,Sweden,SWE,0,0,16,5,21
2016,Sudan,SDN,Sweden,SWE,194,20,130,53,397
2016,South Sudan,SSD,Sweden,SWE,5,0,0,0,5
2016,Syrian Arab Rep.,SYR,Sweden,SWE,2504,40971,136,4035,47646
2016,United Rep. of Tanzania,TZA,Sweden,SWE,5,0,19,11,35
2016,Thailand,THA,Sweden,SWE,0,0,5,0,5
2016,Tajikistan,TJK,Sweden,SWE,11,5,26,38,80
2016,Turkmenistan,TKM,Sweden,SWE,0,0,0,5,5
2016,Togo,TGO,Sweden,SWE,0,0,5,0,5
2016,Tunisia,TUN,Sweden,SWE,5,11,61,61,138
2016,Turkey,TUR,Sweden,SWE,5,15,146,103,269
2016,Uganda,UGA,Sweden,SWE,59,5,26,22,112
2016,Ukraine,UKR,Sweden,SWE,15,47,1213,367,1642
2016,United States of America,USA,Sweden,SWE,0,0,15,16,31
2016,Uzbekistan,UZB,Sweden,SWE,61,22,142,84,309
2016,Venezuela (Bolivarian Republic of),VEN,Sweden,SWE,0,0,60,16,76
2016,Yemen,YEM,Sweden,SWE,101,158,22,40,321
2016,Zambia,ZMB,Sweden,SWE,5,0,0,5,10
2016,Zimbabwe,ZWE,Sweden,SWE,0,0,5,16,21
2016,Stateless,XXA,Sweden,SWE,4733,989,292,745,6759
2016,Afghanistan,AFG,Switzerland,CHE,215,1180,166,1436,2997
2016,Albania,ALB,Switzerland,CHE,0,0,96,74,170
2016,Algeria,DZA,Switzerland,CHE,5,11,113,463,592
2016,Angola,AGO,Switzerland,CHE,0,21,14,20,55
2016,Egypt,EGY,Switzerland,CHE,13,0,13,38,64
2016,Armenia,ARM,Switzerland,CHE,0,10,19,25,54
2016,Azerbaijan,AZE,Switzerland,CHE,19,0,14,5,38
2016,Burundi,BDI,Switzerland,CHE,11,0,0,0,11
2016,Benin,BEN,Switzerland,CHE,5,5,0,11,21
2016,Bangladesh,BGD,Switzerland,CHE,0,5,15,16,36
2016,Burkina Faso,BFA,Switzerland,CHE,0,5,5,25,35
2016,Belarus,BLR,Switzerland,CHE,0,0,12,55,67
2016,Bosnia and Herzegovina,BIH,Switzerland,CHE,0,17,46,36,99
2016,Bulgaria,BGR,Switzerland,CHE,0,0,5,0,5
2016,Central African Rep.,CAF,Switzerland,CHE,0,0,0,15,15
2016,Chad,TCD,Switzerland,CHE,0,0,0,22,22
2016,China,CHN,Switzerland,CHE,62,175,190,52,479
2016,Cameroon,CMR,Switzerland,CHE,0,10,13,194,217
2016,Congo,COG,Switzerland,CHE,0,0,0,5,5
2016,Dem. Rep. of the Congo,COD,Switzerland,CHE,32,51,51,62,196
2016,Colombia,COL,Switzerland,CHE,0,0,13,0,13
2016,Cuba,CUB,Switzerland,CHE,0,0,5,0,5
2016,Cabo Verde,CPV,Switzerland,CHE,0,0,5,0,5
2016,Djibouti,DJI,Switzerland,CHE,5,0,0,5,10
2016,Equatorial Guinea,GNQ,Switzerland,CHE,0,0,0,5,5
2016,Eritrea,ERI,Switzerland,CHE,3187,2565,719,1463,7934
2016,Ethiopia,ETH,Switzerland,CHE,83,138,168,505,894
2016,France,FRA,Switzerland,CHE,0,0,5,0,5
2016,Gambia,GMB,Switzerland,CHE,0,5,53,1141,1199
2016,Georgia,GEO,Switzerland,CHE,0,20,92,392,504
2016,Germany,DEU,Switzerland,CHE,0,0,0,5,5
2016,Ghana,GHA,Switzerland,CHE,0,0,15,89,104
2016,Guinea-Bissau,GNB,Switzerland,CHE,0,5,10,87,102
2016,Guinea,GIN,Switzerland,CHE,0,10,70,753,833
2016,Haiti,HTI,Switzerland,CHE,0,0,0,5,5
2016,Croatia,HRV,Switzerland,CHE,0,0,5,0,5
2016,Cote d'Ivoire,CIV,Switzerland,CHE,10,5,16,299,330
2016,India,IND,Switzerland,CHE,0,5,14,27,46
2016,Iran (Islamic Rep. of),IRN,Switzerland,CHE,51,42,105,222,420
2016,Iraq,IRQ,Switzerland,CHE,115,240,243,909,1507
2016,Israel,ISR,Switzerland,CHE,0,0,5,5,10
2016,Italy,ITA,Switzerland,CHE,0,0,0,5,5
2016,Jordan,JOR,Switzerland,CHE,0,5,11,5,21
2016,Kazakhstan,KAZ,Switzerland,CHE,0,0,0,5,5
2016,Kenya,KEN,Switzerland,CHE,0,5,0,5,10
2016,Liberia,LBR,Switzerland,CHE,5,0,5,25,35
2016,Libya,LBY,Switzerland,CHE,16,29,29,150,224
2016,Lebanon,LBN,Switzerland,CHE,0,5,5,41,51
2016,Sri Lanka,LKA,Switzerland,CHE,610,102,289,318,1319
2016,Madagascar,MDG,Switzerland,CHE,0,0,0,5,5
2016,Mauritania,MRT,Switzerland,CHE,0,0,5,18,23
2016,North Macedonia,MKD,Switzerland,CHE,0,13,95,55,163
2016,Rep. of Moldova,MDA,Switzerland,CHE,0,0,18,10,28
2016,Mali,MLI,Switzerland,CHE,0,5,16,196,217
2016,Mongolia,MNG,Switzerland,CHE,0,5,59,65,129
2016,Morocco,MAR,Switzerland,CHE,5,5,168,657,835
2016,Montenegro,MNE,Switzerland,CHE,0,5,0,5,10
2016,Myanmar,MMR,Switzerland,CHE,0,0,5,5,10
2016,Nepal,NPL,Switzerland,CHE,0,0,12,0,12
2016,Niger,NER,Switzerland,CHE,0,0,0,30,30
2016,Nigeria,NGA,Switzerland,CHE,5,5,114,1137,1261
2016,Pakistan,PAK,Switzerland,CHE,16,10,35,112,173
2016,Poland,POL,Switzerland,CHE,0,0,5,0,5
2016,Portugal,PRT,Switzerland,CHE,0,0,5,0,5
2016,Romania,ROU,Switzerland,CHE,0,0,5,5,10
2016,Russian Federation,RUS,Switzerland,CHE,38,15,32,119,204
2016,Rwanda,RWA,Switzerland,CHE,0,0,0,11,11
2016,Saudi Arabia,SAU,Switzerland,CHE,0,0,5,0,5
2016,Serbia and Kosovo: S/RES/1244 (1999),SRB,Switzerland,CHE,12,102,239,276,629
2016,Senegal,SEN,Switzerland,CHE,5,0,25,325,355
2016,Sierra Leone,SLE,Switzerland,CHE,0,0,11,111,122
2016,Somalia,SOM,Switzerland,CHE,136,454,108,683,1381
2016,Viet Nam,VNM,Switzerland,CHE,13,0,0,0,13
2016,Sudan,SDN,Switzerland,CHE,19,36,38,166,259
2016,South Sudan,SSD,Switzerland,CHE,0,0,5,12,17
2016,Syrian Arab Rep.,SYR,Switzerland,CHE,1054,1278,89,602,3023
2016,United Rep. of Tanzania,TZA,Switzerland,CHE,0,0,5,0,5
2016,Tajikistan,TJK,Switzerland,CHE,0,0,0,5,5
2016,Togo,TGO,Switzerland,CHE,13,0,14,31,58
2016,Tunisia,TUN,Switzerland,CHE,5,5,76,227,313
2016,Turkey,TUR,Switzerland,CHE,127,35,98,156,416
2016,Uganda,UGA,Switzerland,CHE,0,0,0,13,13
2016,Ukraine,UKR,Switzerland,CHE,5,19,87,73,184
2016,United States of America,USA,Switzerland,CHE,0,0,5,0,5
2016,Uzbekistan,UZB,Switzerland,CHE,0,0,0,5,5
2016,Western Sahara,ESH,Switzerland,CHE,0,0,0,5,5
2016,Yemen,YEM,Switzerland,CHE,10,25,0,25,60
2016,Stateless,XXA,Switzerland,CHE,0,5,0,5,10
2016,Burundi,BDI,United Rep. of Tanzania,TZA,14,0,0,0,14
2016,Dem. Rep. of the Congo,COD,United Rep. of Tanzania,TZA,98,0,145,0,243
2016,Myanmar,MMR,Thailand,THA,525,0,14,0,539
2016,Afghanistan,AFG,Ukraine,UKR,5,10,109,82,206
2016,Azerbaijan,AZE,Ukraine,UKR,0,0,0,5,5
2016,Bangladesh,BGD,Ukraine,UKR,0,0,16,5,21
2016,Belarus,BLR,Ukraine,UKR,0,0,5,5,10
2016,Cameroon,CMR,Ukraine,UKR,0,0,0,5,5
2016,Congo,COG,Ukraine,UKR,0,0,5,0,5
2016,Dem. Rep. of the Congo,COD,Ukraine,UKR,0,0,5,5,10
2016,Eritrea,ERI,Ukraine,UKR,0,0,5,0,5
2016,Palestinian,PSE,Ukraine,UKR,0,0,16,0,16
2016,Georgia,GEO,Ukraine,UKR,0,0,0,12,12
2016,Guinea,GIN,Ukraine,UKR,0,0,12,11,23
2016,Cote d'Ivoire,CIV,Ukraine,UKR,0,0,5,0,5
2016,India,IND,Ukraine,UKR,0,0,0,12,12
2016,Iran (Islamic Rep. of),IRN,Ukraine,UKR,5,0,15,5,25
2016,Iraq,IRQ,Ukraine,UKR,0,0,26,20,46
2016,Jordan,JOR,Ukraine,UKR,0,0,5,0,5
2016,Libya,LBY,Ukraine,UKR,0,0,5,0,5
2016,Saint Lucia,LCA,Ukraine,UKR,0,0,0,5,5
2016,Sri Lanka,LKA,Ukraine,UKR,0,0,0,17,17
2016,Rep. of Moldova,MDA,Ukraine,UKR,0,0,0,5,5
2016,Nepal,NPL,Ukraine,UKR,0,0,0,5,5
2016,Nigeria,NGA,Ukraine,UKR,0,0,0,5,5
2016,Pakistan,PAK,Ukraine,UKR,0,0,10,11,21
2016,Russian Federation,RUS,Ukraine,UKR,10,10,42,37,99
2016,Serbia and Kosovo: S/RES/1244 (1999),SRB,Ukraine,UKR,5,0,0,0,5
2016,Senegal,SEN,Ukraine,UKR,0,0,0,5,5
2016,Sierra Leone,SLE,Ukraine,UKR,0,0,0,5,5
2016,Somalia,SOM,Ukraine,UKR,0,0,28,14,42
2016,Viet Nam,VNM,Ukraine,UKR,0,0,0,5,5
2016,Sudan,SDN,Ukraine,UKR,0,0,0,12,12
2016,Syrian Arab Rep.,SYR,Ukraine,UKR,0,22,95,30,147
2016,Tajikistan,TJK,Ukraine,UKR,0,0,0,11,11
2016,Turkey,TUR,Ukraine,UKR,0,0,0,10,10
2016,Uzbekistan,UZB,Ukraine,UKR,0,0,19,11,30
2016,Stateless,XXA,Ukraine,UKR,0,0,0,10,10
2016,Argentina,ARG,Uruguay,URY,5,0,0,0,5
2016,Austria,AUT,Uruguay,URY,0,0,0,5,5
2016,Colombia,COL,Uruguay,URY,5,0,0,5,10
2016,Cuba,CUB,Uruguay,URY,5,0,5,50,60
2016,Libya,LBY,Uruguay,URY,5,0,0,0,5
2016,Nigeria,NGA,Uruguay,URY,5,0,0,0,5
2016,Russian Federation,RUS,Uruguay,URY,0,0,0,5,5
2016,Syrian Arab Rep.,SYR,Uruguay,URY,0,0,0,5,5
2016,Ukraine,UKR,Uruguay,URY,0,0,0,5,5
2016,Venezuela (Bolivarian Republic of),VEN,Uruguay,URY,0,0,0,5,5
2016,Bolivia (Plurinational State of),BOL,Venezuela (Bolivarian Republic of),VEN,0,0,0,5,5
2016,Chile,CHL,Venezuela (Bolivarian Republic of),VEN,5,0,0,0,5
2016,Colombia,COL,Venezuela (Bolivarian Republic of),VEN,1270,0,773,0,2043
2016,Cuba,CUB,Venezuela (Bolivarian Republic of),VEN,0,0,0,14,14
2016,Ecuador,ECU,Venezuela (Bolivarian Republic of),VEN,0,0,0,13,13
2016,Ethiopia,ETH,Venezuela (Bolivarian Republic of),VEN,0,0,0,5,5
2016,Gambia,GMB,Venezuela (Bolivarian Republic of),VEN,0,0,0,5,5
2016,Palestinian,PSE,Venezuela (Bolivarian Republic of),VEN,5,0,0,0,5
2016,Ghana,GHA,Venezuela (Bolivarian Republic of),VEN,0,0,0,5,5
2016,Haiti,HTI,Venezuela (Bolivarian Republic of),VEN,0,0,0,10,10
2016,Cote d'Ivoire,CIV,Venezuela (Bolivarian Republic of),VEN,0,0,0,5,5
2016,Iran (Islamic Rep. of),IRN,Venezuela (Bolivarian Republic of),VEN,0,0,0,18,18
2016,Iraq,IRQ,Venezuela (Bolivarian Republic of),VEN,10,0,0,0,10
2016,Liberia,LBR,Venezuela (Bolivarian Republic of),VEN,5,0,0,0,5
2016,Nigeria,NGA,Venezuela (Bolivarian Republic of),VEN,5,0,0,10,15
2016,Peru,PER,Venezuela (Bolivarian Republic of),VEN,0,0,0,14,14
2016,Sierra Leone,SLE,Venezuela (Bolivarian Republic of),VEN,0,0,0,5,5
2016,Somalia,SOM,Venezuela (Bolivarian Republic of),VEN,0,0,0,15,15
2016,Turkey,TUR,Venezuela (Bolivarian Republic of),VEN,5,0,0,0,5
2016,Stateless,XXA,Venezuela (Bolivarian Republic of),VEN,0,0,0,5,5
2016,Egypt,EGY,Zambia,ZMB,0,0,0,5,5
2016,Burundi,BDI,Zambia,ZMB,502,0,100,43,645
2016,Dem. Rep. of the Congo,COD,Zambia,ZMB,1601,0,337,267,2205
2016,Ethiopia,ETH,Zambia,ZMB,0,0,5,0,5
2016,Rwanda,RWA,Zambia,ZMB,5,0,0,5,10
2016,Somalia,SOM,Zambia,ZMB,17,0,23,110,150
2016,Syrian Arab Rep.,SYR,Zambia,ZMB,0,0,0,10,10
2016,Uganda,UGA,Zambia,ZMB,0,0,0,5,5
2016,Zimbabwe,ZWE,Zambia,ZMB,0,0,0,5,5
2016,Egypt,EGY,Zimbabwe,ZWE,0,0,0,13,13
2016,Burundi,BDI,Zimbabwe,ZWE,0,32,10,23,65
2016,Dem. Rep. of the Congo,COD,Zimbabwe,ZWE,0,493,101,66,660
2016,Ethiopia,ETH,Zimbabwe,ZWE,0,0,0,24,24
2016,Kenya,KEN,Zimbabwe,ZWE,0,0,5,0,5
2016,Rwanda,RWA,Zimbabwe,ZWE,0,0,0,17,17
2016,Somalia,SOM,Zimbabwe,ZWE,0,0,0,15,15
2017,Afghanistan,AFG,Albania,ALB,0,0,0,28,28
2017,Algeria,DZA,Albania,ALB,0,0,0,60,60
2017,Palestinian,PSE,Albania,ALB,0,0,0,10,10
2017,Iran (Islamic Rep. of),IRN,Albania,ALB,0,0,0,2751,2751
2017,Iraq,IRQ,Albania,ALB,0,0,0,5,5
2017,Libya,LBY,Albania,ALB,0,0,0,15,15
2017,Morocco,MAR,Albania,ALB,0,0,0,11,11
2017,Pakistan,PAK,Albania,ALB,0,0,0,17,17
2017,Serbia and Kosovo: S/RES/1244 (1999),SRB,Albania,ALB,0,0,0,5,5
2017,Syrian Arab Rep.,SYR,Albania,ALB,0,0,0,90,90
2017,Tunisia,TUN,Albania,ALB,0,0,0,5,5
2017,Turkey,TUR,Albania,ALB,5,0,0,5,10
2017,Venezuela (Bolivarian Republic of),VEN,Albania,ALB,0,5,0,0,5
2017,Armenia,ARM,Argentina,ARG,0,0,5,18,23
2017,Bangladesh,BGD,Argentina,ARG,0,0,5,0,5
2017,China,CHN,Argentina,ARG,0,0,20,0,20
2017,Cameroon,CMR,Argentina,ARG,0,0,0,5,5
2017,Colombia,COL,Argentina,ARG,5,0,5,21,31
2017,Cuba,CUB,Argentina,ARG,0,0,67,23,90
2017,Dominican Rep.,DOM,Argentina,ARG,0,0,47,5,52
2017,Gambia,GMB,Argentina,ARG,0,0,5,0,5
2017,Palestinian,PSE,Argentina,ARG,5,0,0,0,5
2017,Ghana,GHA,Argentina,ARG,0,0,14,0,14
2017,Haiti,HTI,Argentina,ARG,0,0,121,73,194
2017,India,IND,Argentina,ARG,0,0,23,5,28
2017,Iraq,IRQ,Argentina,ARG,0,0,0,5,5
2017,Nigeria,NGA,Argentina,ARG,0,0,0,5,5
2017,Peru,PER,Argentina,ARG,0,0,0,5,5
2017,Russian Federation,RUS,Argentina,ARG,0,0,5,5,10
2017,El Salvador,SLV,Argentina,ARG,5,0,0,0,5
2017,Senegal,SEN,Argentina,ARG,0,0,365,18,383
2017,Syrian Arab Rep.,SYR,Argentina,ARG,15,0,5,13,33
2017,Ukraine,UKR,Argentina,ARG,12,0,5,35,52
2017,Venezuela (Bolivarian Republic of),VEN,Argentina,ARG,0,0,0,14,14
2017,Azerbaijan,AZE,Armenia,ARM,5,0,0,0,5
2017,Cuba,CUB,Armenia,ARM,0,0,0,5,5
2017,Iran (Islamic Rep. of),IRN,Armenia,ARM,0,0,13,0,13
2017,Iraq,IRQ,Armenia,ARM,31,0,0,5,36
2017,Syrian Arab Rep.,SYR,Armenia,ARM,55,0,0,5,60
2017,Ukraine,UKR,Armenia,ARM,13,0,0,0,13
2017,Yemen,YEM,Armenia,ARM,0,0,0,5,5
2017,Afghanistan,AFG,Australia,AUS,1681,0,208,0,1889
2017,Albania,ALB,Australia,AUS,5,0,19,0,24
2017,Algeria,DZA,Australia,AUS,0,0,12,0,12
2017,Egypt,EGY,Australia,AUS,22,0,83,0,105
2017,Azerbaijan,AZE,Australia,AUS,5,0,5,0,10
2017,Bahrain,BHR,Australia,AUS,5,0,5,0,10
2017,Burundi,BDI,Australia,AUS,0,0,5,0,5
2017,Bangladesh,BGD,Australia,AUS,33,0,218,0,251
2017,Bahamas,BHS,Australia,AUS,0,0,5,0,5
2017,Brazil,BRA,Australia,AUS,0,0,18,0,18
2017,Cambodia,KHM,Australia,AUS,0,0,15,0,15
2017,Canada,CAN,Australia,AUS,0,0,5,0,5
2017,China,CHN,Australia,AUS,53,0,2781,0,2834
2017,Cameroon,CMR,Australia,AUS,0,0,5,0,5
2017,Congo,COG,Australia,AUS,5,0,0,0,5
2017,Dem. Rep. of the Congo,COD,Australia,AUS,5,0,16,0,21
2017,Colombia,COL,Australia,AUS,5,0,57,0,62
2017,Cuba,CUB,Australia,AUS,0,0,5,0,5
2017,Czechia,CZE,Australia,AUS,0,0,10,0,10
2017,Eritrea,ERI,Australia,AUS,30,0,0,0,30
2017,Estonia,EST,Australia,AUS,0,0,5,0,5
2017,Ethiopia,ETH,Australia,AUS,23,0,43,0,66
2017,Fiji,FJI,Australia,AUS,15,0,229,0,244
2017,France,FRA,Australia,AUS,0,0,5,0,5
2017,Gambia,GMB,Australia,AUS,0,0,5,0,5
2017,Palestinian,PSE,Australia,AUS,86,0,5,0,91
2017,United Kingdom of Great Britain and Northern Ireland,GBR,Australia,AUS,0,0,14,0,14
2017,Georgia,GEO,Australia,AUS,5,0,10,0,15
2017,Germany,DEU,Australia,AUS,0,0,5,0,5
2017,Ghana,GHA,Australia,AUS,5,0,16,0,21
2017,Greece,GRC,Australia,AUS,0,0,10,0,10
2017,India,IND,Australia,AUS,15,0,292,0,307
2017,Indonesia,IDN,Australia,AUS,24,0,197,0,221
2017,Iran (Islamic Rep. of),IRN,Australia,AUS,1878,0,538,0,2416
2017,Iraq,IRQ,Australia,AUS,769,0,426,0,1195
2017,Israel,ISR,Australia,AUS,0,0,12,0,12
2017,Jordan,JOR,Australia,AUS,11,0,40,0,51
2017,Japan,JPN,Australia,AUS,0,0,5,0,5
2017,Kazakhstan,KAZ,Australia,AUS,5,0,0,0,5
2017,Kenya,KEN,Australia,AUS,12,0,27,0,39
2017,Kyrgyzstan,KGZ,Australia,AUS,5,0,5,0,10
2017,Rep. of Korea,KOR,Australia,AUS,0,0,45,0,45
2017,Kuwait,KWT,Australia,AUS,5,0,5,0,10
2017,Lao People's Dem. Rep.,LAO,Australia,AUS,0,0,5,0,5
2017,Liberia,LBR,Australia,AUS,5,0,5,0,10
2017,Libya,LBY,Australia,AUS,110,0,99,0,209
2017,Lebanon,LBN,Australia,AUS,27,0,110,0,137
2017,Sri Lanka,LKA,Australia,AUS,625,0,1318,0,1943
2017,Latvia,LVA,Australia,AUS,0,0,5,0,5
2017,North Macedonia,MKD,Australia,AUS,0,0,5,0,5
2017,Rep. of Moldova,MDA,Australia,AUS,0,0,5,0,5
2017,Mexico,MEX,Australia,AUS,0,0,13,0,13
2017,Malaysia,MYS,Australia,AUS,12,0,7964,0,7976
2017,Mongolia,MNG,Australia,AUS,5,0,5,0,10
2017,Morocco,MAR,Australia,AUS,0,0,12,0,12
2017,Mauritius,MUS,Australia,AUS,0,0,22,0,22
2017,Myanmar,MMR,Australia,AUS,47,0,18,0,65
2017,Namibia,NAM,Australia,AUS,0,0,5,0,5
2017,Nepal,NPL,Australia,AUS,0,0,71,0,71
2017,Netherlands,NLD,Australia,AUS,0,0,10,0,10
2017,Nigeria,NGA,Australia,AUS,10,0,49,0,59
2017,New Zealand,NZL,Australia,AUS,11,0,0,0,11
2017,Oman,OMN,Australia,AUS,0,0,5,0,5
2017,Pakistan,PAK,Australia,AUS,669,0,500,0,1169
2017,Peru,PER,Australia,AUS,5,0,16,0,21
2017,Philippines,PHL,Australia,AUS,5,0,40,0,45
2017,Papua New Guinea,PNG,Australia,AUS,11,0,71,0,82
2017,Poland,POL,Australia,AUS,0,0,5,0,5
2017,South Africa,ZAF,Australia,AUS,5,0,23,0,28
2017,Russian Federation,RUS,Australia,AUS,12,0,0,0,12
2017,Rwanda,RWA,Australia,AUS,5,0,0,0,5
2017,El Salvador,SLV,Australia,AUS,0,0,10,0,10
2017,Saudi Arabia,SAU,Australia,AUS,16,0,10,0,26
2017,Serbia and Kosovo: S/RES/1244 (1999),SRB,Australia,AUS,0,0,5,0,5
2017,Singapore,SGP,Australia,AUS,0,0,12,0,12
2017,Sierra Leone,SLE,Australia,AUS,0,0,5,0,5
2017,Solomon Islands,SLB,Australia,AUS,0,0,11,0,11
2017,Somalia,SOM,Australia,AUS,50,0,5,0,55
2017,Viet Nam,VNM,Australia,AUS,62,0,719,0,781
2017,Sudan,SDN,Australia,AUS,163,0,15,0,178
2017,South Sudan,SSD,Australia,AUS,0,0,5,0,5
2017,Syrian Arab Rep.,SYR,Australia,AUS,101,0,5,0,106
2017,United Rep. of Tanzania,TZA,Australia,AUS,0,0,5,0,5
2017,Thailand,THA,Australia,AUS,5,0,203,0,208
2017,Timor-Leste,TLS,Australia,AUS,0,0,5,0,5
2017,Tonga,TON,Australia,AUS,10,0,35,0,45
2017,Tunisia,TUN,Australia,AUS,0,0,5,0,5
2017,Turkey,TUR,Australia,AUS,35,0,42,0,77
2017,United Arab Emirates,ARE,Australia,AUS,5,0,0,0,5
2017,Uganda,UGA,Australia,AUS,5,0,12,0,17
2017,Ukraine,UKR,Australia,AUS,0,0,18,0,18
2017,United States of America,USA,Australia,AUS,0,0,18,0,18
2017,Uzbekistan,UZB,Australia,AUS,5,0,0,0,5
2017,Venezuela (Bolivarian Republic of),VEN,Australia,AUS,12,0,0,0,12
2017,Samoa,WSM,Australia,AUS,0,0,10,0,10
2017,Yemen,YEM,Australia,AUS,11,0,0,0,11
2017,Zambia,ZMB,Australia,AUS,0,0,12,0,12
2017,Zimbabwe,ZWE,Australia,AUS,10,0,44,0,54
2017,Stateless,XXA,Australia,AUS,564,0,48,0,612
2017,Afghanistan,AFG,Azerbaijan,AZE,5,0,105,0,110
2017,Iran (Islamic Rep. of),IRN,Azerbaijan,AZE,0,0,11,0,11
2017,Iraq,IRQ,Azerbaijan,AZE,0,0,14,0,14
2017,Pakistan,PAK,Azerbaijan,AZE,0,0,15,0,15
2017,Russian Federation,RUS,Azerbaijan,AZE,0,0,5,0,5
2017,Syrian Arab Rep.,SYR,Azerbaijan,AZE,0,0,5,0,5
2017,Tajikistan,TJK,Azerbaijan,AZE,0,0,5,0,5
2017,Turkey,TUR,Azerbaijan,AZE,0,0,43,0,43
2017,Yemen,YEM,Azerbaijan,AZE,0,0,5,0,5
2017,Dem. Rep. of the Congo,COD,Burundi,BDI,5414,0,0,1173,6587
2017,Mali,MLI,Burundi,BDI,10,0,0,0,10
2017,Rwanda,RWA,Burundi,BDI,35,0,0,161,196
2017,Turkey,TUR,Burundi,BDI,21,0,0,0,21
2017,Afghanistan,AFG,Belgium,BEL,1310,1720,2130,0,5160
2017,Albania,ALB,Belgium,BEL,55,0,815,0,870
2017,Algeria,DZA,Belgium,BEL,25,0,85,0,110
2017,Angola,AGO,Belgium,BEL,10,0,95,0,105
2017,Egypt,EGY,Belgium,BEL,25,0,80,0,105
2017,Armenia,ARM,Belgium,BEL,30,10,155,0,195
2017,Azerbaijan,AZE,Belgium,BEL,5,0,30,0,35
2017,Burundi,BDI,Belgium,BEL,255,0,115,0,370
2017,Benin,BEN,Belgium,BEL,5,0,25,0,30
2017,Bangladesh,BGD,Belgium,BEL,5,0,85,0,90
2017,Bhutan,BTN,Belgium,BEL,0,0,5,0,5
2017,Burkina Faso,BFA,Belgium,BEL,35,0,40,0,75
2017,Belarus,BLR,Belgium,BEL,5,0,10,0,15
2017,Brazil,BRA,Belgium,BEL,0,0,10,0,10
2017,Bosnia and Herzegovina,BIH,Belgium,BEL,0,0,20,0,20
2017,Central African Rep.,CAF,Belgium,BEL,10,0,5,0,15
2017,Chad,TCD,Belgium,BEL,10,0,10,0,20
2017,China,CHN,Belgium,BEL,140,0,145,0,285
2017,Cameroon,CMR,Belgium,BEL,80,0,230,0,310
2017,Congo,COG,Belgium,BEL,0,0,20,0,20
2017,Dem. Rep. of the Congo,COD,Belgium,BEL,160,5,500,0,665
2017,Colombia,COL,Belgium,BEL,10,0,5,0,15
2017,Djibouti,DJI,Belgium,BEL,75,0,60,0,135
2017,Equatorial Guinea,GNQ,Belgium,BEL,0,0,5,0,5
2017,Eritrea,ERI,Belgium,BEL,450,0,60,0,510
2017,Ethiopia,ETH,Belgium,BEL,20,0,65,0,85
2017,Gabon,GAB,Belgium,BEL,0,0,5,0,5
2017,Gambia,GMB,Belgium,BEL,5,0,40,0,45
2017,Palestinian,PSE,Belgium,BEL,225,0,35,0,260
2017,Georgia,GEO,Belgium,BEL,15,0,105,0,120
2017,Ghana,GHA,Belgium,BEL,0,0,35,0,35
2017,Guinea-Bissau,GNB,Belgium,BEL,0,0,5,0,5
2017,Guatemala,GTM,Belgium,BEL,10,0,0,0,10
2017,Guinea,GIN,Belgium,BEL,460,0,410,0,870
2017,Haiti,HTI,Belgium,BEL,0,0,10,0,10
2017,Honduras,HND,Belgium,BEL,0,0,5,0,5
2017,Cote d'Ivoire,CIV,Belgium,BEL,35,0,80,0,115
2017,India,IND,Belgium,BEL,0,0,30,0,30
2017,Iran (Islamic Rep. of),IRN,Belgium,BEL,460,0,100,0,560
2017,Iraq,IRQ,Belgium,BEL,920,180,1650,0,2750
2017,Israel,ISR,Belgium,BEL,0,0,5,0,5
2017,Jordan,JOR,Belgium,BEL,10,0,20,0,30
2017,Kazakhstan,KAZ,Belgium,BEL,5,0,15,0,20
2017,Kenya,KEN,Belgium,BEL,5,0,10,0,15
2017,Kyrgyzstan,KGZ,Belgium,BEL,10,0,30,0,40
2017,Liberia,LBR,Belgium,BEL,0,0,10,0,10
2017,Libya,LBY,Belgium,BEL,15,40,5,0,60
2017,Lebanon,LBN,Belgium,BEL,15,5,115,0,135
2017,Sri Lanka,LKA,Belgium,BEL,35,0,85,0,120
2017,Madagascar,MDG,Belgium,BEL,0,0,5,0,5
2017,Mauritania,MRT,Belgium,BEL,25,0,105,0,130
2017,North Macedonia,MKD,Belgium,BEL,20,0,165,0,185
2017,Mali,MLI,Belgium,BEL,25,0,40,0,65
2017,Mongolia,MNG,Belgium,BEL,0,0,5,0,5
2017,Morocco,MAR,Belgium,BEL,40,0,190,0,230
2017,Montenegro,MNE,Belgium,BEL,5,0,10,0,15
2017,Nepal,NPL,Belgium,BEL,5,0,30,0,35
2017,Netherlands,NLD,Belgium,BEL,0,0,5,0,5
2017,Niger,NER,Belgium,BEL,15,0,55,0,70
2017,Nigeria,NGA,Belgium,BEL,10,0,105,0,115
2017,Norway,NOR,Belgium,BEL,0,0,5,0,5
2017,Pakistan,PAK,Belgium,BEL,60,0,205,0,265
2017,Philippines,PHL,Belgium,BEL,0,0,5,0,5
2017,Romania,ROU,Belgium,BEL,0,0,5,0,5
2017,Russian Federation,RUS,Belgium,BEL,210,0,420,0,630
2017,Rwanda,RWA,Belgium,BEL,95,0,280,0,375
2017,El Salvador,SLV,Belgium,BEL,15,0,0,0,15
2017,Serbia and Kosovo: S/RES/1244 (1999),SRB,Belgium,BEL,45,0,400,0,445
2017,Senegal,SEN,Belgium,BEL,40,0,120,0,160
2017,Sierra Leone,SLE,Belgium,BEL,5,0,30,0,35
2017,Somalia,SOM,Belgium,BEL,525,155,440,0,1120
2017,Viet Nam,VNM,Belgium,BEL,0,0,15,0,15
2017,Sudan,SDN,Belgium,BEL,60,0,65,0,125
2017,Suriname,SUR,Belgium,BEL,0,0,10,0,10
2017,South Sudan,SSD,Belgium,BEL,0,5,0,0,5
2017,Syrian Arab Rep.,SYR,Belgium,BEL,2110,770,240,0,3120
2017,United Rep. of Tanzania,TZA,Belgium,BEL,5,0,15,0,20
2017,Togo,TGO,Belgium,BEL,25,0,90,0,115
2017,Tunisia,TUN,Belgium,BEL,5,0,40,0,45
2017,Turkey,TUR,Belgium,BEL,570,0,265,0,835
2017,Uganda,UGA,Belgium,BEL,5,0,10,0,15
2017,Ukraine,UKR,Belgium,BEL,30,15,200,0,245
2017,Uzbekistan,UZB,Belgium,BEL,0,0,5,0,5
2017,Venezuela (Bolivarian Republic of),VEN,Belgium,BEL,15,0,0,0,15
2017,Yemen,YEM,Belgium,BEL,20,5,0,0,25
2017,Zimbabwe,ZWE,Belgium,BEL,0,0,5,0,5
2017,Stateless,XXA,Belgium,BEL,25,0,10,0,35
2017,Burundi,BDI,Benin,BEN,5,0,0,0,5
2017,Central African Rep.,CAF,Benin,BEN,227,0,0,0,227
2017,Dem. Rep. of the Congo,COD,Benin,BEN,5,0,0,0,5
2017,Syrian Arab Rep.,SYR,Benin,BEN,5,0,0,0,5
2017,Turkey,TUR,Benin,BEN,5,0,0,0,5
2017,Afghanistan,AFG,Belarus,BLR,0,12,0,0,12
2017,Armenia,ARM,Belarus,BLR,0,0,0,5,5
2017,Bangladesh,BGD,Belarus,BLR,0,0,0,5,5
2017,Palestinian,PSE,Belarus,BLR,0,0,5,0,5
2017,Georgia,GEO,Belarus,BLR,0,0,5,5,10
2017,Iran (Islamic Rep. of),IRN,Belarus,BLR,0,0,5,0,5
2017,Iraq,IRQ,Belarus,BLR,0,0,12,0,12
2017,Rep. of Moldova,MDA,Belarus,BLR,0,0,5,0,5
2017,Pakistan,PAK,Belarus,BLR,0,0,0,14,14
2017,Russian Federation,RUS,Belarus,BLR,0,0,15,5,20
2017,Syrian Arab Rep.,SYR,Belarus,BLR,0,15,0,5,20
2017,Tajikistan,TJK,Belarus,BLR,0,0,10,0,10
2017,Ukraine,UKR,Belarus,BLR,0,518,15,16,549
2017,Yemen,YEM,Belarus,BLR,0,10,0,0,10
2017,Burundi,BDI,Botswana,BWA,0,0,11,0,11
2017,Dem. Rep. of the Congo,COD,Botswana,BWA,31,0,18,0,49
2017,Somalia,SOM,Botswana,BWA,10,0,0,0,10
2017,Angola,AGO,Brazil,BRA,5,0,118,0,123
2017,Egypt,EGY,Brazil,BRA,14,0,5,0,19
2017,Benin,BEN,Brazil,BRA,0,0,5,0,5
2017,Bangladesh,BGD,Brazil,BRA,0,0,81,0,81
2017,Burkina Faso,BFA,Brazil,BRA,0,0,5,0,5
2017,Cameroon,CMR,Brazil,BRA,5,0,5,0,10
2017,Dem. Rep. of the Congo,COD,Brazil,BRA,106,0,12,0,118
2017,Colombia,COL,Brazil,BRA,5,0,0,0,5
2017,Cuba,CUB,Brazil,BRA,5,0,0,0,5
2017,Cabo Verde,CPV,Brazil,BRA,0,0,5,0,5
2017,Denmark,DNK,Brazil,BRA,0,0,5,0,5
2017,Dominican Rep.,DOM,Brazil,BRA,0,0,5,0,5
2017,Ethiopia,ETH,Brazil,BRA,5,0,0,0,5
2017,Gambia,GMB,Brazil,BRA,0,0,19,0,19
2017,Palestinian,PSE,Brazil,BRA,42,0,0,0,42
2017,Ghana,GHA,Brazil,BRA,0,0,15,0,15
2017,Guinea-Bissau,GNB,Brazil,BRA,0,0,60,0,60
2017,Guinea,GIN,Brazil,BRA,5,0,5,0,10
2017,Haiti,HTI,Brazil,BRA,5,0,0,0,5
2017,India,IND,Brazil,BRA,0,0,5,0,5
2017,Iran (Islamic Rep. of),IRN,Brazil,BRA,5,0,0,0,5
2017,Iraq,IRQ,Brazil,BRA,10,0,0,0,10
2017,Jordan,JOR,Brazil,BRA,5,0,0,0,5
2017,Lebanon,LBN,Brazil,BRA,5,0,60,0,65
2017,Mali,MLI,Brazil,BRA,5,0,54,0,59
2017,Mozambique,MOZ,Brazil,BRA,0,0,5,0,5
2017,Nigeria,NGA,Brazil,BRA,5,0,52,0,57
2017,Pakistan,PAK,Brazil,BRA,24,0,11,0,35
2017,Philippines,PHL,Brazil,BRA,0,0,5,0,5
2017,El Salvador,SLV,Brazil,BRA,5,0,0,0,5
2017,Senegal,SEN,Brazil,BRA,0,0,156,0,156
2017,Sierra Leone,SLE,Brazil,BRA,0,0,5,0,5
2017,Sudan,SDN,Brazil,BRA,5,0,0,0,5
2017,Syrian Arab Rep.,SYR,Brazil,BRA,314,0,0,0,314
2017,Togo,TGO,Brazil,BRA,0,0,5,0,5
2017,Ukraine,UKR,Brazil,BRA,5,0,0,0,5
2017,Afghanistan,AFG,Bosnia and Herzegovina,BIH,0,0,0,35,35
2017,Algeria,DZA,Bosnia and Herzegovina,BIH,0,0,0,5,5
2017,Iran (Islamic Rep. of),IRN,Bosnia and Herzegovina,BIH,0,0,0,5,5
2017,Iraq,IRQ,Bosnia and Herzegovina,BIH,0,0,0,12,12
2017,Lebanon,LBN,Bosnia and Herzegovina,BIH,0,0,0,5,5
2017,Morocco,MAR,Bosnia and Herzegovina,BIH,0,0,0,5,5
2017,Pakistan,PAK,Bosnia and Herzegovina,BIH,0,0,5,31,36
2017,Serbia and Kosovo: S/RES/1244 (1999),SRB,Bosnia and Herzegovina,BIH,0,0,0,5,5
2017,Syrian Arab Rep.,SYR,Bosnia and Herzegovina,BIH,0,0,0,41,41
2017,Turkey,TUR,Bosnia and Herzegovina,BIH,0,5,0,12,17
2017,Stateless,XXA,Bosnia and Herzegovina,BIH,0,0,0,5,5
2017,Viet Nam,VNM,Cambodia,KHM,5,0,0,121,126
2017,Afghanistan,AFG,Canada,CAN,294,0,44,179,517
2017,Albania,ALB,Canada,CAN,72,0,76,21,169
2017,Algeria,DZA,Canada,CAN,44,0,30,13,87
2017,Angola,AGO,Canada,CAN,23,0,13,10,46
2017,Antigua and Barbuda,ATG,Canada,CAN,12,0,11,0,23
2017,Egypt,EGY,Canada,CAN,183,0,41,153,377
2017,Argentina,ARG,Canada,CAN,0,0,5,0,5
2017,Armenia,ARM,Canada,CAN,5,0,0,0,5
2017,Azerbaijan,AZE,Canada,CAN,145,0,58,15,218
2017,Bahrain,BHR,Canada,CAN,14,0,5,0,19
2017,Barbados,BRB,Canada,CAN,30,0,5,5,40
2017,Burundi,BDI,Canada,CAN,497,0,31,255,783
2017,Benin,BEN,Canada,CAN,11,0,0,0,11
2017,Bangladesh,BGD,Canada,CAN,151,0,50,27,228
2017,Bahamas,BHS,Canada,CAN,70,0,25,5,100
2017,Burkina Faso,BFA,Canada,CAN,5,0,10,0,15
2017,Belarus,BLR,Canada,CAN,5,0,0,0,5
2017,Bolivia (Plurinational State of),BOL,Canada,CAN,0,0,0,12,12
2017,Botswana,BWA,Canada,CAN,12,0,5,5,22
2017,Brazil,BRA,Canada,CAN,5,0,36,20,61
2017,Bulgaria,BGR,Canada,CAN,10,0,0,0,10
2017,Belize,BLZ,Canada,CAN,5,0,0,0,5
2017,Cambodia,KHM,Canada,CAN,11,0,0,5,16
2017,Central African Rep.,CAF,Canada,CAN,10,0,0,0,10
2017,Chad,TCD,Canada,CAN,104,0,47,5,156
2017,China,CHN,Canada,CAN,543,0,600,119,1262
2017,Chile,CHL,Canada,CAN,5,0,18,10,33
2017,Cameroon,CMR,Canada,CAN,89,0,47,5,141
2017,Congo,COG,Canada,CAN,39,0,12,5,56
2017,Dem. Rep. of the Congo,COD,Canada,CAN,136,0,138,15,289
2017,Colombia,COL,Canada,CAN,547,0,194,65,806
2017,Costa Rica,CRI,Canada,CAN,0,0,12,0,12
2017,Cuba,CUB,Canada,CAN,33,0,35,5,73
2017,Czechia,CZE,Canada,CAN,36,0,10,56,102
2017,Djibouti,DJI,Canada,CAN,220,0,94,5,319
2017,Dominican Rep.,DOM,Canada,CAN,23,0,11,5,39
2017,Ecuador,ECU,Canada,CAN,10,0,10,5,25
2017,Eritrea,ERI,Canada,CAN,409,0,40,454,903
2017,Ethiopia,ETH,Canada,CAN,279,0,87,11,377
2017,Finland,FIN,Canada,CAN,0,0,5,0,5
2017,France,FRA,Canada,CAN,0,0,15,0,15
2017,Gabon,GAB,Canada,CAN,12,0,10,0,22
2017,Gambia,GMB,Canada,CAN,11,0,10,0,21
2017,Palestinian,PSE,Canada,CAN,299,0,72,18,389
2017,Georgia,GEO,Canada,CAN,38,0,44,16,98
2017,Ghana,GHA,Canada,CAN,33,0,59,19,111
2017,Greece,GRC,Canada,CAN,0,0,0,5,5
2017,Grenada,GRD,Canada,CAN,5,0,0,0,5
2017,Guatemala,GTM,Canada,CAN,18,0,29,10,57
2017,Guinea,GIN,Canada,CAN,44,0,19,5,68
2017,Guyana,GUY,Canada,CAN,5,0,13,5,23
2017,Haiti,HTI,Canada,CAN,221,0,543,201,965
2017,"China, Hong Kong SAR",HKG,Canada,CAN,0,0,0,5,5
2017,Honduras,HND,Canada,CAN,93,0,43,10,146
2017,Croatia,HRV,Canada,CAN,47,0,27,23,97
2017,Hungary,HUN,Canada,CAN,334,0,193,155,682
2017,Cote d'Ivoire,CIV,Canada,CAN,10,0,0,5,15
2017,India,IND,Canada,CAN,175,0,287,128,590
2017,Indonesia,IDN,Canada,CAN,11,0,10,0,21
2017,Ireland,IRL,Canada,CAN,0,0,5,12,17
2017,Iran (Islamic Rep. of),IRN,Canada,CAN,293,0,54,29,376
2017,Iraq,IRQ,Canada,CAN,399,0,142,196,737
2017,Israel,ISR,Canada,CAN,11,0,12,14,37
2017,Italy,ITA,Canada,CAN,0,0,30,5,35
2017,Jamaica,JAM,Canada,CAN,84,0,54,15,153
2017,Jordan,JOR,Canada,CAN,65,0,51,10,126
2017,Japan,JPN,Canada,CAN,0,0,0,5,5
2017,Kazakhstan,KAZ,Canada,CAN,22,0,5,0,27
2017,Kenya,KEN,Canada,CAN,38,0,35,0,73
2017,Kyrgyzstan,KGZ,Canada,CAN,5,0,5,0,10
2017,Rep. of Korea,KOR,Canada,CAN,11,0,0,5,16
2017,Dem. People's Rep. of Korea,PRK,Canada,CAN,0,0,5,24,29
2017,Kuwait,KWT,Canada,CAN,5,0,0,5,10
2017,Liberia,LBR,Canada,CAN,13,0,5,0,18
2017,Libya,LBY,Canada,CAN,242,0,15,10,267
2017,Saint Lucia,LCA,Canada,CAN,20,0,14,19,53
2017,Lebanon,LBN,Canada,CAN,123,0,74,19,216
2017,Sri Lanka,LKA,Canada,CAN,236,0,73,40,349
2017,Lithuania,LTU,Canada,CAN,0,0,5,0,5
2017,Latvia,LVA,Canada,CAN,5,0,0,5,10
2017,Mauritania,MRT,Canada,CAN,35,0,13,5,53
2017,Mexico,MEX,Canada,CAN,120,0,215,121,456
2017,Mali,MLI,Canada,CAN,19,0,31,0,50
2017,Malaysia,MYS,Canada,CAN,0,0,0,5,5
2017,Malawi,MWI,Canada,CAN,0,0,5,0,5
2017,Mongolia,MNG,Canada,CAN,11,0,0,5,16
2017,Morocco,MAR,Canada,CAN,10,0,16,5,31
2017,Montenegro,MNE,Canada,CAN,0,0,5,0,5
2017,Mauritius,MUS,Canada,CAN,5,0,0,0,5
2017,Myanmar,MMR,Canada,CAN,5,0,0,0,5
2017,Namibia,NAM,Canada,CAN,5,0,0,0,5
2017,Nepal,NPL,Canada,CAN,49,0,32,5,86
2017,Netherlands,NLD,Canada,CAN,0,0,5,5,10
2017,Niger,NER,Canada,CAN,5,0,0,5,10
2017,Nicaragua,NIC,Canada,CAN,5,0,5,0,10
2017,Nigeria,NGA,Canada,CAN,835,0,949,87,1871
2017,Pakistan,PAK,Canada,CAN,595,0,152,44,791
2017,Peru,PER,Canada,CAN,5,0,16,5,26
2017,Philippines,PHL,Canada,CAN,0,0,13,5,18
2017,Poland,POL,Canada,CAN,5,0,10,5,20
2017,Portugal,PRT,Canada,CAN,0,0,13,0,13
2017,Romania,ROU,Canada,CAN,12,0,5,93,110
2017,South Africa,ZAF,Canada,CAN,5,0,12,5,22
2017,Russian Federation,RUS,Canada,CAN,96,0,28,13,137
2017,Rwanda,RWA,Canada,CAN,64,0,22,5,91
2017,El Salvador,SLV,Canada,CAN,182,0,69,17,268
2017,Saudi Arabia,SAU,Canada,CAN,87,0,12,34,133
2017,Serbia and Kosovo: S/RES/1244 (1999),SRB,Canada,CAN,20,0,5,14,39
2017,Senegal,SEN,Canada,CAN,22,0,15,5,42
2017,Sierra Leone,SLE,Canada,CAN,13,0,0,0,13
2017,Somalia,SOM,Canada,CAN,341,0,184,129,654
2017,Spain,ESP,Canada,CAN,0,0,18,5,23
2017,Viet Nam,VNM,Canada,CAN,0,0,12,0,12
2017,Saint Kitts and Nevis,KNA,Canada,CAN,0,0,5,0,5
2017,Sudan,SDN,Canada,CAN,361,0,37,15,413
2017,South Sudan,SSD,Canada,CAN,5,0,0,0,5
2017,Slovakia,SVK,Canada,CAN,131,0,5,43,179
2017,Eswatini,SWZ,Canada,CAN,13,0,0,0,13
2017,Sweden,SWE,Canada,CAN,0,0,0,5,5
2017,Syrian Arab Rep.,SYR,Canada,CAN,343,0,13,442,798
2017,United Rep. of Tanzania,TZA,Canada,CAN,17,0,12,5,34
2017,Turks and Caicos Islands,TCA,Canada,CAN,0,0,5,0,5
2017,Tajikistan,TJK,Canada,CAN,10,0,0,0,10
2017,Turkmenistan,TKM,Canada,CAN,11,0,0,0,11
2017,Togo,TGO,Canada,CAN,13,0,0,0,13
2017,Trinidad and Tobago,TTO,Canada,CAN,5,0,5,0,10
2017,Tunisia,TUN,Canada,CAN,17,0,10,0,27
2017,Turkey,TUR,Canada,CAN,1244,0,156,54,1454
2017,Uganda,UGA,Canada,CAN,84,0,57,0,141
2017,Ukraine,UKR,Canada,CAN,102,0,48,12,162
2017,Uruguay,URY,Canada,CAN,0,0,5,0,5
2017,United States of America,USA,Canada,CAN,5,0,321,110,436
2017,Uzbekistan,UZB,Canada,CAN,14,0,14,0,28
2017,Saint Vincent and the Grenadines,VCT,Canada,CAN,11,0,10,13,34
2017,Venezuela (Bolivarian Republic of),VEN,Canada,CAN,404,0,95,16,515
2017,Yemen,YEM,Canada,CAN,262,0,12,126,400
2017,Zambia,ZMB,Canada,CAN,5,0,0,0,5
2017,Zimbabwe,ZWE,Canada,CAN,67,0,49,0,116
2017,Stateless,XXA,Canada,CAN,144,0,55,17,216
2017,Cuba,CUB,Cayman Islands,CYM,10,0,10,10,30
2017,Colombia,COL,Chile,CHL,75,0,57,225,357
2017,Cuba,CUB,Chile,CHL,0,0,33,11,44
2017,Dominican Rep.,DOM,Chile,CHL,0,0,5,5,10
2017,Ecuador,ECU,Chile,CHL,5,0,0,0,5
2017,Palestinian,PSE,Chile,CHL,5,0,0,0,5
2017,Mexico,MEX,Chile,CHL,0,0,0,5,5
2017,Turkey,TUR,Chile,CHL,5,0,0,0,5
2017,Venezuela (Bolivarian Republic of),VEN,Chile,CHL,0,0,0,19,19
2017,Central African Rep.,CAF,Congo,COG,1542,0,0,0,1542
2017,Dem. Rep. of the Congo,COD,Congo,COG,21,0,0,0,21
2017,Mali,MLI,Congo,COG,0,0,0,5,5
2017,Sudan,SDN,Congo,COG,5,0,0,0,5
2017,Syrian Arab Rep.,SYR,Congo,COG,5,0,0,0,5
2017,Burundi,BDI,Dem. Rep. of the Congo,COD,61,62,20,156,299
2017,Central African Rep.,CAF,Dem. Rep. of the Congo,COD,10,0,0,0,10
2017,Cote d'Ivoire,CIV,Dem. Rep. of the Congo,COD,0,0,11,0,11
2017,Rwanda,RWA,Dem. Rep. of the Congo,COD,29,0,5,181,215
2017,Somalia,SOM,Dem. Rep. of the Congo,COD,0,0,46,90,136
2017,Cuba,CUB,Colombia,COL,0,0,0,14,14
2017,Turkey,TUR,Colombia,COL,0,0,0,12,12
2017,Venezuela (Bolivarian Republic of),VEN,Colombia,COL,19,0,5,413,437
2017,Angola,AGO,Costa Rica,CRI,0,0,5,0,5
2017,China,CHN,Costa Rica,CRI,0,0,5,0,5
2017,Dem. Rep. of the Congo,COD,Costa Rica,CRI,5,0,13,24,42
2017,Colombia,COL,Costa Rica,CRI,37,0,167,218,422
2017,Cuba,CUB,Costa Rica,CRI,5,0,13,38,56
2017,Gambia,GMB,Costa Rica,CRI,0,0,5,0,5
2017,Ghana,GHA,Costa Rica,CRI,0,0,16,5,21
2017,Guatemala,GTM,Costa Rica,CRI,0,0,0,5,5
2017,Haiti,HTI,Costa Rica,CRI,0,0,10,53,63
2017,Honduras,HND,Costa Rica,CRI,23,0,10,32,65
2017,Nicaragua,NIC,Costa Rica,CRI,5,0,18,20,43
2017,El Salvador,SLV,Costa Rica,CRI,104,0,241,242,587
2017,Somalia,SOM,Costa Rica,CRI,0,0,0,5,5
2017,Ukraine,UKR,Costa Rica,CRI,5,0,0,0,5
2017,Venezuela (Bolivarian Republic of),VEN,Costa Rica,CRI,69,0,701,209,979
2017,Afghanistan,AFG,Cyprus,CYP,5,0,0,0,5
2017,Egypt,EGY,Cyprus,CYP,5,5,42,47,99
2017,Bangladesh,BGD,Cyprus,CYP,0,0,199,37,236
2017,China,CHN,Cyprus,CYP,0,0,0,5,5
2017,Cameroon,CMR,Cyprus,CYP,5,0,24,10,39
2017,Congo,COG,Cyprus,CYP,0,0,0,13,13
2017,Dem. Rep. of the Congo,COD,Cyprus,CYP,0,0,5,0,5
2017,Eritrea,ERI,Cyprus,CYP,45,0,0,0,45
2017,Gambia,GMB,Cyprus,CYP,0,0,11,0,11
2017,Palestinian,PSE,Cyprus,CYP,25,14,10,11,60
2017,Georgia,GEO,Cyprus,CYP,0,0,31,5,36
2017,Cote d'Ivoire,CIV,Cyprus,CYP,0,0,5,5,10
2017,India,IND,Cyprus,CYP,0,0,277,33,310
2017,Iran (Islamic Rep. of),IRN,Cyprus,CYP,0,5,10,23,38
2017,Iraq,IRQ,Cyprus,CYP,19,13,18,22,72
2017,Jordan,JOR,Cyprus,CYP,0,0,0,5,5
2017,Lebanon,LBN,Cyprus,CYP,0,0,5,0,5
2017,Sri Lanka,LKA,Cyprus,CYP,0,0,37,11,48
2017,Nepal,NPL,Cyprus,CYP,0,0,10,11,21
2017,Nigeria,NGA,Cyprus,CYP,0,0,23,12,35
2017,Pakistan,PAK,Cyprus,CYP,0,0,140,23,163
2017,Philippines,PHL,Cyprus,CYP,5,0,35,5,45
2017,Russian Federation,RUS,Cyprus,CYP,0,0,0,14,14
2017,Somalia,SOM,Cyprus,CYP,56,25,21,121,223
2017,Viet Nam,VNM,Cyprus,CYP,0,0,207,34,241
2017,Sudan,SDN,Cyprus,CYP,5,0,0,0,5
2017,Syrian Arab Rep.,SYR,Cyprus,CYP,16,958,0,107,1081
2017,Turkey,TUR,Cyprus,CYP,17,0,0,5,22
2017,Ukraine,UKR,Cyprus,CYP,0,0,86,23,109
2017,Yemen,YEM,Cyprus,CYP,5,0,0,0,5
2017,Afghanistan,AFG,Czechia,CZE,0,0,16,12,28
2017,Algeria,DZA,Czechia,CZE,0,0,11,5,16
2017,Egypt,EGY,Czechia,CZE,0,0,12,0,12
2017,Armenia,ARM,Czechia,CZE,0,0,26,60,86
2017,Azerbaijan,AZE,Czechia,CZE,5,0,33,56,94
2017,Belarus,BLR,Czechia,CZE,0,0,0,14,14
2017,China,CHN,Czechia,CZE,0,0,5,21,26
2017,Cameroon,CMR,Czechia,CZE,0,0,0,5,5
2017,Cuba,CUB,Czechia,CZE,0,5,23,58,86
2017,Ethiopia,ETH,Czechia,CZE,0,0,10,5,15
2017,Georgia,GEO,Czechia,CZE,0,0,34,73,107
2017,Ghana,GHA,Czechia,CZE,0,0,5,5,10
2017,Iraq,IRQ,Czechia,CZE,0,14,0,18,32
2017,Jordan,JOR,Czechia,CZE,0,0,5,0,5
2017,Kazakhstan,KAZ,Czechia,CZE,0,0,16,26,42
2017,Kyrgyzstan,KGZ,Czechia,CZE,0,0,12,5,17
2017,Libya,LBY,Czechia,CZE,0,5,0,0,5
2017,Lebanon,LBN,Czechia,CZE,0,0,0,5,5
2017,Rep. of Moldova,MDA,Czechia,CZE,0,0,5,5,10
2017,Mongolia,MNG,Czechia,CZE,0,0,12,0,12
2017,Myanmar,MMR,Czechia,CZE,5,0,0,0,5
2017,Nigeria,NGA,Czechia,CZE,0,0,10,23,33
2017,Pakistan,PAK,Czechia,CZE,0,0,0,10,10
2017,Russian Federation,RUS,Czechia,CZE,5,0,34,35,74
2017,Serbia and Kosovo: S/RES/1244 (1999),SRB,Czechia,CZE,0,0,5,5,10
2017,Viet Nam,VNM,Czechia,CZE,0,0,51,22,73
2017,Syrian Arab Rep.,SYR,Czechia,CZE,5,34,0,17,56
2017,Togo,TGO,Czechia,CZE,0,5,0,0,5
2017,Tunisia,TUN,Czechia,CZE,0,0,5,0,5
2017,Turkey,TUR,Czechia,CZE,5,0,15,11,31
2017,Ukraine,UKR,Czechia,CZE,10,25,276,196,507
2017,Uzbekistan,UZB,Czechia,CZE,0,12,0,5,17
2017,Yemen,YEM,Czechia,CZE,0,10,0,0,10
2017,Stateless,XXA,Czechia,CZE,0,13,0,5,18
2017,Afghanistan,AFG,Denmark,DNK,46,157,1051,0,1254
2017,Albania,ALB,Denmark,DNK,0,0,57,0,57
2017,Algeria,DZA,Denmark,DNK,0,0,25,0,25
2017,Egypt,EGY,Denmark,DNK,12,0,0,0,12
2017,Armenia,ARM,Denmark,DNK,0,0,32,0,32
2017,Bangladesh,BGD,Denmark,DNK,0,0,14,0,14
2017,Belarus,BLR,Denmark,DNK,0,0,5,0,5
2017,Bosnia and Herzegovina,BIH,Denmark,DNK,0,0,10,0,10
2017,China,CHN,Denmark,DNK,5,0,0,0,5
2017,Cameroon,CMR,Denmark,DNK,0,0,11,0,11
2017,Dem. Rep. of the Congo,COD,Denmark,DNK,5,0,13,0,18
2017,Colombia,COL,Denmark,DNK,5,0,0,0,5
2017,Eritrea,ERI,Denmark,DNK,242,21,5,0,268
2017,Ethiopia,ETH,Denmark,DNK,10,0,51,0,61
2017,Gambia,GMB,Denmark,DNK,0,0,11,0,11
2017,Ghana,GHA,Denmark,DNK,0,0,13,0,13
2017,Guinea,GIN,Denmark,DNK,0,0,5,0,5
2017,Cote d'Ivoire,CIV,Denmark,DNK,5,0,0,0,5
2017,India,IND,Denmark,DNK,0,0,5,0,5
2017,Iran (Islamic Rep. of),IRN,Denmark,DNK,537,14,837,0,1388
2017,Iraq,IRQ,Denmark,DNK,23,26,591,0,640
2017,Jordan,JOR,Denmark,DNK,0,0,5,0,5
2017,Kenya,KEN,Denmark,DNK,0,0,5,0,5
2017,Kuwait,KWT,Denmark,DNK,0,0,103,0,103
2017,Libya,LBY,Denmark,DNK,0,0,10,0,10
2017,Lebanon,LBN,Denmark,DNK,0,5,28,0,33
2017,Morocco,MAR,Denmark,DNK,0,0,40,0,40
2017,Myanmar,MMR,Denmark,DNK,0,0,5,0,5
2017,Nigeria,NGA,Denmark,DNK,0,0,37,0,37
2017,Pakistan,PAK,Denmark,DNK,0,5,24,0,29
2017,Russian Federation,RUS,Denmark,DNK,0,0,20,0,20
2017,Serbia and Kosovo: S/RES/1244 (1999),SRB,Denmark,DNK,0,0,61,0,61
2017,Sierra Leone,SLE,Denmark,DNK,0,0,5,0,5
2017,Somalia,SOM,Denmark,DNK,5,5,106,0,116
2017,Spain,ESP,Denmark,DNK,0,0,5,0,5
2017,Viet Nam,VNM,Denmark,DNK,0,0,5,0,5
2017,Sudan,SDN,Denmark,DNK,0,0,10,0,10
2017,Syrian Arab Rep.,SYR,Denmark,DNK,349,673,39,0,1061
2017,Tunisia,TUN,Denmark,DNK,0,0,5,0,5
2017,Turkey,TUR,Denmark,DNK,0,0,20,0,20
2017,Uganda,UGA,Denmark,DNK,0,5,30,0,35
2017,Ukraine,UKR,Denmark,DNK,0,0,30,0,30
2017,Venezuela (Bolivarian Republic of),VEN,Denmark,DNK,0,0,5,0,5
2017,Zimbabwe,ZWE,Denmark,DNK,5,0,5,0,10
2017,Stateless,XXA,Denmark,DNK,35,132,761,0,928
2017,Albania,ALB,Estonia,EST,0,0,10,0,10
2017,Egypt,EGY,Estonia,EST,0,0,0,5,5
2017,Cameroon,CMR,Estonia,EST,0,0,5,0,5
2017,Eritrea,ERI,Estonia,EST,0,5,0,0,5
2017,Georgia,GEO,Estonia,EST,0,0,0,5,5
2017,Iran (Islamic Rep. of),IRN,Estonia,EST,0,0,5,0,5
2017,Iraq,IRQ,Estonia,EST,0,5,0,0,5
2017,Russian Federation,RUS,Estonia,EST,0,0,13,0,13
2017,Sudan,SDN,Estonia,EST,0,5,0,0,5
2017,Syrian Arab Rep.,SYR,Estonia,EST,41,30,0,0,71
2017,Ukraine,UKR,Estonia,EST,0,10,5,5,20
2017,Afghanistan,AFG,France,FRA,689,5001,1154,28,6872
2017,Albania,ALB,France,FRA,135,527,9702,170,10534
2017,Algeria,DZA,France,FRA,85,50,2143,79,2357
2017,Angola,AGO,France,FRA,45,14,512,5,576
2017,Egypt,EGY,France,FRA,39,5,404,10,458
2017,Armenia,ARM,France,FRA,32,62,1540,23,1657
2017,Azerbaijan,AZE,France,FRA,49,18,320,5,392
2017,Burundi,BDI,France,FRA,113,0,11,5,129
2017,Bangladesh,BGD,France,FRA,152,102,3514,5,3773
2017,Burkina Faso,BFA,France,FRA,46,12,181,0,239
2017,Bosnia and Herzegovina,BIH,France,FRA,23,20,411,18,472
2017,Central African Rep.,CAF,France,FRA,166,158,399,5,728
2017,Chad,TCD,France,FRA,62,10,319,13,404
2017,China,CHN,France,FRA,605,0,1322,5,1932
2017,Cameroon,CMR,France,FRA,61,26,377,11,475
2017,Congo,COG,France,FRA,103,19,861,19,1002
2017,Dem. Rep. of the Congo,COD,France,FRA,485,103,2996,22,3606
2017,Comoros,COM,France,FRA,37,5,213,11,266
2017,Colombia,COL,France,FRA,15,18,86,5,124
2017,Djibouti,DJI,France,FRA,46,11,77,0,134
2017,Dominican Rep.,DOM,France,FRA,0,5,298,5,308
2017,Eritrea,ERI,France,FRA,652,0,241,21,914
2017,Ethiopia,ETH,France,FRA,295,5,305,74,679
2017,Gabon,GAB,France,FRA,22,10,190,15,237
2017,Gambia,GMB,France,FRA,26,5,170,5,206
2017,Palestinian,PSE,France,FRA,104,10,61,5,180
2017,Georgia,GEO,France,FRA,41,33,981,28,1083
2017,Guinea,GIN,France,FRA,733,121,3150,15,4019
2017,Haiti,HTI,France,FRA,70,106,6225,29,6430
2017,Cote d'Ivoire,CIV,France,FRA,308,67,2008,35,2418
2017,India,IND,France,FRA,11,5,166,0,182
2017,Iran (Islamic Rep. of),IRN,France,FRA,140,5,299,5,449
2017,Iraq,IRQ,France,FRA,1065,257,249,14,1585
2017,Libya,LBY,France,FRA,105,108,345,19,577
2017,Sri Lanka,LKA,France,FRA,189,49,1875,10,2123
2017,Mauritania,MRT,France,FRA,107,19,760,10,896
2017,North Macedonia,MKD,France,FRA,0,5,525,47,577
2017,Mali,MLI,France,FRA,234,21,1297,17,1569
2017,Mongolia,MNG,France,FRA,5,10,169,5,189
2017,Morocco,MAR,France,FRA,78,15,499,16,608
2017,Nigeria,NGA,France,FRA,145,85,1889,18,2137
2017,Pakistan,PAK,France,FRA,109,48,1994,17,2168
2017,Russian Federation,RUS,France,FRA,245,96,1506,27,1874
2017,Rwanda,RWA,France,FRA,93,0,82,5,180
2017,Serbia and Kosovo: S/RES/1244 (1999),SRB,France,FRA,122,166,3090,43,3421
2017,Senegal,SEN,France,FRA,145,15,853,17,1030
2017,Sierra Leone,SLE,France,FRA,20,5,132,0,157
2017,Somalia,SOM,France,FRA,95,268,525,27,915
2017,Sudan,SDN,France,FRA,3244,450,2518,78,6290
2017,Syrian Arab Rep.,SYR,France,FRA,1051,2446,175,89,3761
2017,Togo,TGO,France,FRA,17,5,142,0,164
2017,Turkey,TUR,France,FRA,148,19,1094,16,1277
2017,Ukraine,UKR,France,FRA,43,119,460,5,627
2017,Venezuela (Bolivarian Republic of),VEN,France,FRA,43,33,198,5,279
2017,Western Sahara,ESH,France,FRA,56,19,1320,5,1400
2017,Cote d'Ivoire,CIV,Gambia,GMB,5,0,0,0,5
2017,Afghanistan,AFG,United Kingdom of Great Britain and Northern Ireland,GBR,512,178,919,400,2009
2017,Albania,ALB,United Kingdom of Great Britain and Northern Ireland,GBR,30,64,706,278,1078
2017,Algeria,DZA,United Kingdom of Great Britain and Northern Ireland,GBR,10,5,119,43,177
2017,Angola,AGO,United Kingdom of Great Britain and Northern Ireland,GBR,5,0,43,10,58
2017,Egypt,EGY,United Kingdom of Great Britain and Northern Ireland,GBR,53,10,299,112,474
2017,Armenia,ARM,United Kingdom of Great Britain and Northern Ireland,GBR,5,0,28,5,38
2017,Australia,AUS,United Kingdom of Great Britain and Northern Ireland,GBR,0,0,0,5,5
2017,Azerbaijan,AZE,United Kingdom of Great Britain and Northern Ireland,GBR,5,0,33,0,38
2017,Bahrain,BHR,United Kingdom of Great Britain and Northern Ireland,GBR,5,0,0,0,5
2017,Burundi,BDI,United Kingdom of Great Britain and Northern Ireland,GBR,5,0,14,0,19
2017,Bangladesh,BGD,United Kingdom of Great Britain and Northern Ireland,GBR,55,10,1557,281,1903
2017,Belarus,BLR,United Kingdom of Great Britain and Northern Ireland,GBR,0,0,11,0,11
2017,Botswana,BWA,United Kingdom of Great Britain and Northern Ireland,GBR,0,0,15,0,15
2017,Brazil,BRA,United Kingdom of Great Britain and Northern Ireland,GBR,0,0,13,17,30
2017,Canada,CAN,United Kingdom of Great Britain and Northern Ireland,GBR,0,0,0,11,11
2017,Chad,TCD,United Kingdom of Great Britain and Northern Ireland,GBR,0,0,0,5,5
2017,China,CHN,United Kingdom of Great Britain and Northern Ireland,GBR,13,5,511,411,940
2017,Cameroon,CMR,United Kingdom of Great Britain and Northern Ireland,GBR,38,5,142,14,199
2017,Congo,COG,United Kingdom of Great Britain and Northern Ireland,GBR,5,0,20,5,30
2017,Dem. Rep. of the Congo,COD,United Kingdom of Great Britain and Northern Ireland,GBR,28,5,126,12,171
2017,Colombia,COL,United Kingdom of Great Britain and Northern Ireland,GBR,0,0,13,0,13
2017,Cuba,CUB,United Kingdom of Great Britain and Northern Ireland,GBR,0,0,5,0,5
2017,Czechia,CZE,United Kingdom of Great Britain and Northern Ireland,GBR,0,0,5,0,5
2017,Djibouti,DJI,United Kingdom of Great Britain and Northern Ireland,GBR,0,0,5,0,5
2017,Dominica,DMA,United Kingdom of Great Britain and Northern Ireland,GBR,5,0,0,0,5
2017,Eritrea,ERI,United Kingdom of Great Britain and Northern Ireland,GBR,1195,5,159,138,1497
2017,Ethiopia,ETH,United Kingdom of Great Britain and Northern Ireland,GBR,155,10,135,30,330
2017,Gabon,GAB,United Kingdom of Great Britain and Northern Ireland,GBR,0,0,5,0,5
2017,Gambia,GMB,United Kingdom of Great Britain and Northern Ireland,GBR,13,10,98,12,133
2017,Palestinian,PSE,United Kingdom of Great Britain and Northern Ireland,GBR,20,0,54,21,95
2017,Georgia,GEO,United Kingdom of Great Britain and Northern Ireland,GBR,0,0,40,21,61
2017,Ghana,GHA,United Kingdom of Great Britain and Northern Ireland,GBR,10,17,199,41,267
2017,Guinea-Bissau,GNB,United Kingdom of Great Britain and Northern Ireland,GBR,5,0,0,0,5
2017,Grenada,GRD,United Kingdom of Great Britain and Northern Ireland,GBR,0,0,10,5,15
2017,Guinea,GIN,United Kingdom of Great Britain and Northern Ireland,GBR,5,0,15,5,25
2017,Guyana,GUY,United Kingdom of Great Britain and Northern Ireland,GBR,0,0,0,5,5
2017,"China, Hong Kong SAR",HKG,United Kingdom of Great Britain and Northern Ireland,GBR,0,0,0,5,5
2017,Honduras,HND,United Kingdom of Great Britain and Northern Ireland,GBR,0,0,5,5,10
2017,Hungary,HUN,United Kingdom of Great Britain and Northern Ireland,GBR,0,0,5,0,5
2017,Cote d'Ivoire,CIV,United Kingdom of Great Britain and Northern Ireland,GBR,0,0,36,5,41
2017,India,IND,United Kingdom of Great Britain and Northern Ireland,GBR,0,27,1280,473,1780
2017,Iran (Islamic Rep. of),IRN,United Kingdom of Great Britain and Northern Ireland,GBR,1496,63,1324,451,3334
2017,Iraq,IRQ,United Kingdom of Great Britain and Northern Ireland,GBR,310,180,1470,673,2633
2017,Israel,ISR,United Kingdom of Great Britain and Northern Ireland,GBR,0,0,16,5,21
2017,Jamaica,JAM,United Kingdom of Great Britain and Northern Ireland,GBR,10,5,171,31,217
2017,Jordan,JOR,United Kingdom of Great Britain and Northern Ireland,GBR,0,0,27,11,38
2017,Japan,JPN,United Kingdom of Great Britain and Northern Ireland,GBR,0,0,0,5,5
2017,Kazakhstan,KAZ,United Kingdom of Great Britain and Northern Ireland,GBR,0,0,13,5,18
2017,Kenya,KEN,United Kingdom of Great Britain and Northern Ireland,GBR,5,0,75,5,85
2017,Kyrgyzstan,KGZ,United Kingdom of Great Britain and Northern Ireland,GBR,0,0,5,0,5
2017,Rep. of Korea,KOR,United Kingdom of Great Britain and Northern Ireland,GBR,0,0,5,0,5
2017,Dem. People's Rep. of Korea,PRK,United Kingdom of Great Britain and Northern Ireland,GBR,0,0,10,0,10
2017,Kuwait,KWT,United Kingdom of Great Britain and Northern Ireland,GBR,38,0,28,26,92
2017,Liberia,LBR,United Kingdom of Great Britain and Northern Ireland,GBR,0,0,5,0,5
2017,Libya,LBY,United Kingdom of Great Britain and Northern Ireland,GBR,128,145,227,37,537
2017,Saint Lucia,LCA,United Kingdom of Great Britain and Northern Ireland,GBR,0,0,14,5,19
2017,Lebanon,LBN,United Kingdom of Great Britain and Northern Ireland,GBR,13,0,70,14,97
2017,Sri Lanka,LKA,United Kingdom of Great Britain and Northern Ireland,GBR,48,10,870,95,1023
2017,Lithuania,LTU,United Kingdom of Great Britain and Northern Ireland,GBR,0,0,16,0,16
2017,Latvia,LVA,United Kingdom of Great Britain and Northern Ireland,GBR,0,0,5,0,5
2017,North Macedonia,MKD,United Kingdom of Great Britain and Northern Ireland,GBR,0,0,5,0,5
2017,Maldives,MDV,United Kingdom of Great Britain and Northern Ireland,GBR,0,0,13,0,13
2017,Mexico,MEX,United Kingdom of Great Britain and Northern Ireland,GBR,0,0,12,0,12
2017,Mali,MLI,United Kingdom of Great Britain and Northern Ireland,GBR,5,0,5,0,10
2017,Malaysia,MYS,United Kingdom of Great Britain and Northern Ireland,GBR,16,0,49,17,82
2017,Malawi,MWI,United Kingdom of Great Britain and Northern Ireland,GBR,0,13,63,0,76
2017,Mongolia,MNG,United Kingdom of Great Britain and Northern Ireland,GBR,0,0,19,0,19
2017,Morocco,MAR,United Kingdom of Great Britain and Northern Ireland,GBR,5,5,54,26,90
2017,Mozambique,MOZ,United Kingdom of Great Britain and Northern Ireland,GBR,0,0,5,0,5
2017,Mauritius,MUS,United Kingdom of Great Britain and Northern Ireland,GBR,0,0,54,15,69
2017,Myanmar,MMR,United Kingdom of Great Britain and Northern Ireland,GBR,5,0,27,5,37
2017,Namibia,NAM,United Kingdom of Great Britain and Northern Ireland,GBR,0,0,38,14,52
2017,Nepal,NPL,United Kingdom of Great Britain and Northern Ireland,GBR,0,0,145,46,191
2017,Netherlands,NLD,United Kingdom of Great Britain and Northern Ireland,GBR,0,0,5,0,5
2017,Nigeria,NGA,United Kingdom of Great Britain and Northern Ireland,GBR,86,68,1179,148,1481
2017,Oman,OMN,United Kingdom of Great Britain and Northern Ireland,GBR,0,0,15,0,15
2017,Pakistan,PAK,United Kingdom of Great Britain and Northern Ireland,GBR,346,38,2258,502,3144
2017,Peru,PER,United Kingdom of Great Britain and Northern Ireland,GBR,0,0,5,0,5
2017,Philippines,PHL,United Kingdom of Great Britain and Northern Ireland,GBR,0,0,63,22,85
2017,Papua New Guinea,PNG,United Kingdom of Great Britain and Northern Ireland,GBR,0,0,5,0,5
2017,Poland,POL,United Kingdom of Great Britain and Northern Ireland,GBR,0,0,18,0,18
2017,Portugal,PRT,United Kingdom of Great Britain and Northern Ireland,GBR,0,0,5,0,5
2017,Qatar,QAT,United Kingdom of Great Britain and Northern Ireland,GBR,5,0,0,0,5
2017,Romania,ROU,United Kingdom of Great Britain and Northern Ireland,GBR,0,0,11,0,11
2017,South Africa,ZAF,United Kingdom of Great Britain and Northern Ireland,GBR,0,5,53,5,63
2017,Russian Federation,RUS,United Kingdom of Great Britain and Northern Ireland,GBR,49,5,106,10,170
2017,Rwanda,RWA,United Kingdom of Great Britain and Northern Ireland,GBR,0,0,25,0,25
2017,El Salvador,SLV,United Kingdom of Great Britain and Northern Ireland,GBR,38,5,38,5,86
2017,Saudi Arabia,SAU,United Kingdom of Great Britain and Northern Ireland,GBR,22,0,21,5,48
2017,Serbia and Kosovo: S/RES/1244 (1999),SRB,United Kingdom of Great Britain and Northern Ireland,GBR,0,0,23,5,28
2017,Senegal,SEN,United Kingdom of Great Britain and Northern Ireland,GBR,5,0,18,0,23
2017,Seychelles,SYC,United Kingdom of Great Britain and Northern Ireland,GBR,0,0,5,0,5
2017,Singapore,SGP,United Kingdom of Great Britain and Northern Ireland,GBR,5,0,0,0,5
2017,Sierra Leone,SLE,United Kingdom of Great Britain and Northern Ireland,GBR,10,0,24,5,39
2017,Somalia,SOM,United Kingdom of Great Britain and Northern Ireland,GBR,152,10,146,41,349
2017,Viet Nam,VNM,United Kingdom of Great Britain and Northern Ireland,GBR,134,61,324,204,723
2017,Saint Kitts and Nevis,KNA,United Kingdom of Great Britain and Northern Ireland,GBR,0,0,0,5,5
2017,Sudan,SDN,United Kingdom of Great Britain and Northern Ireland,GBR,924,10,298,262,1494
2017,South Sudan,SSD,United Kingdom of Great Britain and Northern Ireland,GBR,5,0,5,0,10
2017,Sweden,SWE,United Kingdom of Great Britain and Northern Ireland,GBR,0,0,5,0,5
2017,Syrian Arab Rep.,SYR,United Kingdom of Great Britain and Northern Ireland,GBR,840,5,97,110,1052
2017,United Rep. of Tanzania,TZA,United Kingdom of Great Britain and Northern Ireland,GBR,5,5,31,0,41
2017,Thailand,THA,United Kingdom of Great Britain and Northern Ireland,GBR,0,0,18,5,23
2017,Tajikistan,TJK,United Kingdom of Great Britain and Northern Ireland,GBR,5,0,0,0,5
2017,Turkmenistan,TKM,United Kingdom of Great Britain and Northern Ireland,GBR,0,0,5,0,5
2017,Trinidad and Tobago,TTO,United Kingdom of Great Britain and Northern Ireland,GBR,12,0,28,5,45
2017,Tunisia,TUN,United Kingdom of Great Britain and Northern Ireland,GBR,5,0,31,5,41
2017,Turkey,TUR,United Kingdom of Great Britain and Northern Ireland,GBR,36,10,180,28,254
2017,Uganda,UGA,United Kingdom of Great Britain and Northern Ireland,GBR,61,5,64,5,135
2017,Ukraine,UKR,United Kingdom of Great Britain and Northern Ireland,GBR,13,5,107,45,170
2017,United States of America,USA,United Kingdom of Great Britain and Northern Ireland,GBR,0,0,22,15,37
2017,Uzbekistan,UZB,United Kingdom of Great Britain and Northern Ireland,GBR,0,0,5,11,16
2017,Saint Vincent and the Grenadines,VCT,United Kingdom of Great Britain and Northern Ireland,GBR,0,0,10,0,10
2017,Venezuela (Bolivarian Republic of),VEN,United Kingdom of Great Britain and Northern Ireland,GBR,0,0,26,0,26
2017,Yemen,YEM,United Kingdom of Great Britain and Northern Ireland,GBR,54,33,38,10,135
2017,Zambia,ZMB,United Kingdom of Great Britain and Northern Ireland,GBR,5,0,14,0,19
2017,Zimbabwe,ZWE,United Kingdom of Great Britain and Northern Ireland,GBR,19,11,240,16,286
2017,Stateless,XXA,United Kingdom of Great Britain and Northern Ireland,GBR,314,0,184,43,541
2017,Afghanistan,AFG,Georgia,GEO,0,0,34,10,44
2017,Egypt,EGY,Georgia,GEO,11,0,36,18,65
2017,Armenia,ARM,Georgia,GEO,0,0,0,5,5
2017,Azerbaijan,AZE,Georgia,GEO,5,0,5,14,24
2017,Bangladesh,BGD,Georgia,GEO,0,0,10,5,15
2017,Cameroon,CMR,Georgia,GEO,0,0,5,0,5
2017,Ghana,GHA,Georgia,GEO,0,0,0,5,5
2017,India,IND,Georgia,GEO,0,0,22,29,51
2017,Iran (Islamic Rep. of),IRN,Georgia,GEO,20,0,33,24,77
2017,Iraq,IRQ,Georgia,GEO,0,10,80,56,146
2017,Jordan,JOR,Georgia,GEO,0,0,0,5,5
2017,Lebanon,LBN,Georgia,GEO,0,0,5,0,5
2017,Sri Lanka,LKA,Georgia,GEO,0,0,5,0,5
2017,Morocco,MAR,Georgia,GEO,0,0,5,0,5
2017,Nepal,NPL,Georgia,GEO,0,0,5,5,10
2017,Nigeria,NGA,Georgia,GEO,0,0,24,10,34
2017,Pakistan,PAK,Georgia,GEO,5,0,17,5,27
2017,Russian Federation,RUS,Georgia,GEO,5,0,16,14,35
2017,Somalia,SOM,Georgia,GEO,0,0,0,10,10
2017,Sudan,SDN,Georgia,GEO,5,0,0,0,5
2017,Syrian Arab Rep.,SYR,Georgia,GEO,0,5,23,5,33
2017,Turkey,TUR,Georgia,GEO,0,0,36,5,41
2017,Ukraine,UKR,Georgia,GEO,0,17,5,10,32
2017,Yemen,YEM,Georgia,GEO,0,5,5,0,10
2017,Stateless,XXA,Georgia,GEO,0,0,5,0,5
2017,Central African Rep.,CAF,Ghana,GHA,0,0,0,10,10
2017,Chad,TCD,Ghana,GHA,16,0,0,5,21
2017,Cameroon,CMR,Ghana,GHA,0,0,0,5,5
2017,Dem. Rep. of the Congo,COD,Ghana,GHA,0,0,0,33,33
2017,Cote d'Ivoire,CIV,Ghana,GHA,116,0,0,10,126
2017,Liberia,LBR,Ghana,GHA,0,0,0,5,5
2017,Libya,LBY,Ghana,GHA,0,0,0,5,5
2017,Mali,MLI,Ghana,GHA,0,0,0,5,5
2017,Nigeria,NGA,Ghana,GHA,0,0,0,12,12
2017,Rwanda,RWA,Ghana,GHA,0,0,0,10,10
2017,Sierra Leone,SLE,Ghana,GHA,12,0,0,13,25
2017,Somalia,SOM,Ghana,GHA,0,0,0,33,33
2017,Sudan,SDN,Ghana,GHA,17,0,0,0,17
2017,South Sudan,SSD,Ghana,GHA,0,0,0,5,5
2017,Syrian Arab Rep.,SYR,Ghana,GHA,16,0,0,5,21
2017,Togo,TGO,Ghana,GHA,32,0,0,5,37
2017,Cote d'Ivoire,CIV,Guinea-Bissau,GNB,0,0,0,5,5
2017,Liberia,LBR,Guinea-Bissau,GNB,0,0,0,5,5
2017,Mali,MLI,Guinea-Bissau,GNB,0,0,0,5,5
2017,Nigeria,NGA,Guinea-Bissau,GNB,5,0,0,0,5
2017,Afghanistan,AFG,Greece,GRC,1152,455,492,1343,3442
2017,Albania,ALB,Greece,GRC,5,0,1595,289,1889
2017,Algeria,DZA,Greece,GRC,20,0,435,339,794
2017,Egypt,EGY,Greece,GRC,30,0,410,92,532
2017,Armenia,ARM,Greece,GRC,0,0,51,10,61
2017,Burundi,BDI,Greece,GRC,10,0,0,5,15
2017,Bangladesh,BGD,Greece,GRC,27,0,799,104,930
2017,Burkina Faso,BFA,Greece,GRC,0,0,5,5,10
2017,Bolivia (Plurinational State of),BOL,Greece,GRC,0,0,0,5,5
2017,Brazil,BRA,Greece,GRC,0,0,5,0,5
2017,Central African Rep.,CAF,Greece,GRC,5,0,0,0,5
2017,Chad,TCD,Greece,GRC,0,0,5,0,5
2017,China,CHN,Greece,GRC,10,0,88,25,123
2017,Cameroon,CMR,Greece,GRC,54,0,85,110,249
2017,Congo,COG,Greece,GRC,18,5,29,31,83
2017,Dem. Rep. of the Congo,COD,Greece,GRC,153,10,200,182,545
2017,Comoros,COM,Greece,GRC,0,0,5,5,10
2017,Dominican Rep.,DOM,Greece,GRC,5,0,33,43,81
2017,Eritrea,ERI,Greece,GRC,271,5,10,115,401
2017,Ethiopia,ETH,Greece,GRC,87,0,31,18,136
2017,Gabon,GAB,Greece,GRC,0,0,5,0,5
2017,Gambia,GMB,Greece,GRC,0,0,11,5,16
2017,Palestinian,PSE,Greece,GRC,442,5,14,133,594
2017,Georgia,GEO,Greece,GRC,0,0,557,97,654
2017,Ghana,GHA,Greece,GRC,0,0,24,13,37
2017,Guinea,GIN,Greece,GRC,12,0,33,16,61
2017,Haiti,HTI,Greece,GRC,0,0,14,5,19
2017,Cote d'Ivoire,CIV,Greece,GRC,5,0,13,18,36
2017,India,IND,Greece,GRC,0,0,60,26,86
2017,Indonesia,IDN,Greece,GRC,0,0,11,0,11
2017,Iran (Islamic Rep. of),IRN,Greece,GRC,360,10,249,333,952
2017,Iraq,IRQ,Greece,GRC,1245,428,521,838,3032
2017,Jamaica,JAM,Greece,GRC,0,0,0,5,5
2017,Jordan,JOR,Greece,GRC,11,0,0,0,11
2017,Kenya,KEN,Greece,GRC,0,0,5,0,5
2017,Kuwait,KWT,Greece,GRC,40,0,0,5,45
2017,Liberia,LBR,Greece,GRC,0,0,5,0,5
2017,Libya,LBY,Greece,GRC,5,0,0,15,20
2017,Lebanon,LBN,Greece,GRC,14,0,51,27,92
2017,Sri Lanka,LKA,Greece,GRC,5,0,5,15,25
2017,North Macedonia,MKD,Greece,GRC,0,0,0,5,5
2017,Rep. of Moldova,MDA,Greece,GRC,0,0,25,18,43
2017,Mali,MLI,Greece,GRC,5,10,21,19,55
2017,Morocco,MAR,Greece,GRC,43,0,187,135,365
2017,Myanmar,MMR,Greece,GRC,13,0,10,0,23
2017,Nepal,NPL,Greece,GRC,0,0,43,13,56
2017,Niger,NER,Greece,GRC,5,0,10,0,15
2017,Nigeria,NGA,Greece,GRC,21,5,103,26,155
2017,Pakistan,PAK,Greece,GRC,111,16,5613,705,6445
2017,Russian Federation,RUS,Greece,GRC,0,0,14,5,19
2017,Saudi Arabia,SAU,Greece,GRC,5,0,0,0,5
2017,Serbia and Kosovo: S/RES/1244 (1999),SRB,Greece,GRC,0,0,5,5,10
2017,Senegal,SEN,Greece,GRC,0,0,24,12,36
2017,Sierra Leone,SLE,Greece,GRC,5,0,24,11,40
2017,Somalia,SOM,Greece,GRC,32,26,5,28,91
2017,Sudan,SDN,Greece,GRC,29,0,16,5,50
2017,Syrian Arab Rep.,SYR,Greece,GRC,4807,0,20,1409,6236
2017,United Rep. of Tanzania,TZA,Greece,GRC,0,0,0,5,5
2017,Togo,TGO,Greece,GRC,0,0,0,5,5
2017,Tunisia,TUN,Greece,GRC,10,0,28,27,65
2017,Turkey,TUR,Greece,GRC,53,0,52,209,314
2017,Uganda,UGA,Greece,GRC,0,0,13,0,13
2017,Ukraine,UKR,Greece,GRC,0,17,50,23,90
2017,Uzbekistan,UZB,Greece,GRC,0,0,5,5,10
2017,Western Sahara,ESH,Greece,GRC,5,0,0,0,5
2017,Yemen,YEM,Greece,GRC,64,38,0,13,115
2017,Zimbabwe,ZWE,Greece,GRC,0,0,0,12,12
2017,Stateless,XXA,Greece,GRC,127,0,10,22,159
2017,Cuba,CUB,Guatemala,GTM,0,0,5,0,5
2017,Honduras,HND,Guatemala,GTM,0,0,0,5,5
2017,Nicaragua,NIC,Guatemala,GTM,0,0,0,5,5
2017,El Salvador,SLV,Guatemala,GTM,55,0,5,26,86
2017,Venezuela (Bolivarian Republic of),VEN,Guatemala,GTM,5,0,0,5,10
2017,Dem. Rep. of the Congo,COD,Guinea,GIN,5,0,0,0,5
2017,Cote d'Ivoire,CIV,Guinea,GIN,49,0,5,10,64
2017,Liberia,LBR,Guinea,GIN,0,0,0,11,11
2017,Mali,MLI,Guinea,GIN,0,0,0,5,5
2017,Sierra Leone,SLE,Guinea,GIN,30,0,0,19,49
2017,El Salvador,SLV,Honduras,HND,5,0,0,0,5
2017,Venezuela (Bolivarian Republic of),VEN,Honduras,HND,5,0,0,0,5
2017,Afghanistan,AFG,Croatia,HRV,5,0,56,596,657
2017,Albania,ALB,Croatia,HRV,0,0,0,5,5
2017,Algeria,DZA,Croatia,HRV,0,0,15,60,75
2017,Egypt,EGY,Croatia,HRV,5,0,0,0,5
2017,Bangladesh,BGD,Croatia,HRV,0,0,0,33,33
2017,Bosnia and Herzegovina,BIH,Croatia,HRV,0,0,0,5,5
2017,Cameroon,CMR,Croatia,HRV,0,0,0,10,10
2017,Cuba,CUB,Croatia,HRV,0,0,0,32,32
2017,Eritrea,ERI,Croatia,HRV,14,0,0,5,19
2017,Palestinian,PSE,Croatia,HRV,5,0,0,0,5
2017,India,IND,Croatia,HRV,0,0,0,5,5
2017,Iran (Islamic Rep. of),IRN,Croatia,HRV,0,0,30,78,108
2017,Iraq,IRQ,Croatia,HRV,24,0,44,66,134
2017,Libya,LBY,Croatia,HRV,0,0,0,31,31
2017,Sri Lanka,LKA,Croatia,HRV,0,0,0,5,5
2017,North Macedonia,MKD,Croatia,HRV,0,0,0,12,12
2017,Morocco,MAR,Croatia,HRV,0,0,5,26,31
2017,Nigeria,NGA,Croatia,HRV,0,0,0,5,5
2017,Pakistan,PAK,Croatia,HRV,0,0,0,232,232
2017,Serbia and Kosovo: S/RES/1244 (1999),SRB,Croatia,HRV,0,0,5,24,29
2017,Somalia,SOM,Croatia,HRV,0,0,0,5,5
2017,Syrian Arab Rep.,SYR,Croatia,HRV,111,19,27,113,270
2017,Tunisia,TUN,Croatia,HRV,0,0,5,18,23
2017,Turkey,TUR,Croatia,HRV,5,0,5,183,193
2017,Uzbekistan,UZB,Croatia,HRV,0,0,0,5,5
2017,Yemen,YEM,Croatia,HRV,5,0,0,0,5
2017,Afghanistan,AFG,Hungary,HUN,20,509,1220,847,2596
2017,Algeria,DZA,Hungary,HUN,0,0,91,36,127
2017,Egypt,EGY,Hungary,HUN,0,0,18,10,28
2017,Armenia,ARM,Hungary,HUN,0,0,10,17,27
2017,Azerbaijan,AZE,Hungary,HUN,0,5,0,0,5
2017,Bangladesh,BGD,Hungary,HUN,0,0,10,12,22
2017,China,CHN,Hungary,HUN,0,0,5,0,5
2017,Cameroon,CMR,Hungary,HUN,0,0,5,0,5
2017,Congo,COG,Hungary,HUN,5,0,5,0,10
2017,Cuba,CUB,Hungary,HUN,0,10,27,0,37
2017,Eritrea,ERI,Hungary,HUN,0,0,5,0,5
2017,Palestinian,PSE,Hungary,HUN,5,0,14,16,35
2017,Georgia,GEO,Hungary,HUN,0,0,0,5,5
2017,India,IND,Hungary,HUN,0,0,14,0,14
2017,Indonesia,IDN,Hungary,HUN,0,0,87,0,87
2017,Iran (Islamic Rep. of),IRN,Hungary,HUN,30,5,510,73,618
2017,Iraq,IRQ,Hungary,HUN,10,168,0,418,596
2017,Kyrgyzstan,KGZ,Hungary,HUN,0,0,5,0,5
2017,Libya,LBY,Hungary,HUN,0,0,14,0,14
2017,Lebanon,LBN,Hungary,HUN,0,0,10,0,10
2017,Sri Lanka,LKA,Hungary,HUN,0,0,0,5,5
2017,Mongolia,MNG,Hungary,HUN,0,0,0,5,5
2017,Morocco,MAR,Hungary,HUN,0,0,41,15,56
2017,Nepal,NPL,Hungary,HUN,0,0,0,11,11
2017,Nigeria,NGA,Hungary,HUN,0,0,17,11,28
2017,Pakistan,PAK,Hungary,HUN,11,0,154,143,308
2017,Russian Federation,RUS,Hungary,HUN,0,0,5,0,5
2017,Serbia and Kosovo: S/RES/1244 (1999),SRB,Hungary,HUN,0,0,0,22,22
2017,Somalia,SOM,Hungary,HUN,0,11,5,13,29
2017,Viet Nam,VNM,Hungary,HUN,0,0,0,5,5
2017,Sudan,SDN,Hungary,HUN,0,0,577,0,577
2017,Syrian Arab Rep.,SYR,Hungary,HUN,10,374,0,351,735
2017,Tajikistan,TJK,Hungary,HUN,0,0,5,5,10
2017,Tunisia,TUN,Hungary,HUN,0,0,5,0,5
2017,Turkey,TUR,Hungary,HUN,0,0,19,16,35
2017,Ukraine,UKR,Hungary,HUN,0,0,5,5,10
2017,Stateless,XXA,Hungary,HUN,5,0,0,0,5
2017,Afghanistan,AFG,Iceland,ISL,0,5,0,20,25
2017,Albania,ALB,Iceland,ISL,5,0,72,193,270
2017,Algeria,DZA,Iceland,ISL,0,0,0,10,10
2017,Egypt,EGY,Iceland,ISL,0,0,0,11,11
2017,Armenia,ARM,Iceland,ISL,0,0,5,0,5
2017,Belarus,BLR,Iceland,ISL,0,0,0,5,5
2017,Eritrea,ERI,Iceland,ISL,0,0,0,5,5
2017,Palestinian,PSE,Iceland,ISL,5,0,0,5,10
2017,Georgia,GEO,Iceland,ISL,0,5,72,195,272
2017,Ghana,GHA,Iceland,ISL,5,0,0,5,10
2017,India,IND,Iceland,ISL,0,0,0,5,5
2017,Iran (Islamic Rep. of),IRN,Iceland,ISL,0,0,0,16,16
2017,Iraq,IRQ,Iceland,ISL,18,5,0,53,76
2017,Israel,ISR,Iceland,ISL,0,0,5,0,5
2017,Kazakhstan,KAZ,Iceland,ISL,0,0,5,5,10
2017,Sri Lanka,LKA,Iceland,ISL,0,0,0,5,5
2017,North Macedonia,MKD,Iceland,ISL,0,0,81,149,230
2017,Morocco,MAR,Iceland,ISL,0,0,0,13,13
2017,Nigeria,NGA,Iceland,ISL,0,0,5,12,17
2017,Pakistan,PAK,Iceland,ISL,5,0,0,23,28
2017,Poland,POL,Iceland,ISL,0,0,0,5,5
2017,Romania,ROU,Iceland,ISL,0,0,0,5,5
2017,Russian Federation,RUS,Iceland,ISL,0,0,5,5,10
2017,El Salvador,SLV,Iceland,ISL,0,0,0,5,5
2017,Serbia and Kosovo: S/RES/1244 (1999),SRB,Iceland,ISL,0,0,26,12,38
2017,Somalia,SOM,Iceland,ISL,0,0,0,29,29
2017,Syrian Arab Rep.,SYR,Iceland,ISL,10,5,0,18,33
2017,Ukraine,UKR,Iceland,ISL,0,0,0,5,5
2017,United States of America,USA,Iceland,ISL,0,0,0,5,5
2017,Afghanistan,AFG,Ireland,IRL,5,17,5,0,27
2017,Albania,ALB,Ireland,IRL,0,0,33,10,43
2017,Algeria,DZA,Ireland,IRL,0,0,29,0,29
2017,Egypt,EGY,Ireland,IRL,0,0,5,0,5
2017,Australia,AUS,Ireland,IRL,0,0,0,5,5
2017,Bangladesh,BGD,Ireland,IRL,0,0,28,5,33
2017,Botswana,BWA,Ireland,IRL,0,0,5,0,5
2017,Brazil,BRA,Ireland,IRL,0,0,0,14,14
2017,China,CHN,Ireland,IRL,0,0,13,5,18
2017,Dem. Rep. of the Congo,COD,Ireland,IRL,0,18,25,0,43
2017,Palestinian,PSE,Ireland,IRL,5,0,0,0,5
2017,Georgia,GEO,Ireland,IRL,0,0,52,11,63
2017,Ghana,GHA,Ireland,IRL,0,0,17,0,17
2017,India,IND,Ireland,IRL,0,0,25,10,35
2017,Iran (Islamic Rep. of),IRN,Ireland,IRL,5,0,0,0,5
2017,Iraq,IRQ,Ireland,IRL,64,5,5,0,74
2017,Kuwait,KWT,Ireland,IRL,0,0,5,0,5
2017,Liberia,LBR,Ireland,IRL,0,0,5,0,5
2017,Libya,LBY,Ireland,IRL,23,12,0,0,35
2017,Rep. of Moldova,MDA,Ireland,IRL,0,0,5,0,5
2017,Malaysia,MYS,Ireland,IRL,0,0,5,0,5
2017,Malawi,MWI,Ireland,IRL,0,10,68,0,78
2017,Mongolia,MNG,Ireland,IRL,0,0,5,0,5
2017,Mauritius,MUS,Ireland,IRL,0,0,20,0,20
2017,Nepal,NPL,Ireland,IRL,0,0,11,0,11
2017,Nigeria,NGA,Ireland,IRL,0,0,201,18,219
2017,Pakistan,PAK,Ireland,IRL,0,0,192,21,213
2017,South Africa,ZAF,Ireland,IRL,0,0,73,5,78
2017,Russian Federation,RUS,Ireland,IRL,0,0,5,0,5
2017,Rwanda,RWA,Ireland,IRL,0,0,5,0,5
2017,Somalia,SOM,Ireland,IRL,5,5,0,0,10
2017,Sudan,SDN,Ireland,IRL,0,0,5,0,5
2017,Eswatini,SWZ,Ireland,IRL,0,0,5,0,5
2017,Syrian Arab Rep.,SYR,Ireland,IRL,542,0,0,0,542
2017,Uganda,UGA,Ireland,IRL,0,0,5,0,5
2017,Ukraine,UKR,Ireland,IRL,0,0,17,12,29
2017,Venezuela (Bolivarian Republic of),VEN,Ireland,IRL,5,0,5,0,10
2017,Zimbabwe,ZWE,Ireland,IRL,10,5,131,0,146
2017,Afghanistan,AFG,Italy,ITA,361,1442,169,184,2156
2017,Albania,ALB,Italy,ITA,25,83,124,44,276
2017,Algeria,DZA,Italy,ITA,10,22,43,35,110
2017,Angola,AGO,Italy,ITA,0,5,0,0,5
2017,Egypt,EGY,Italy,ITA,31,300,296,138,765
2017,Argentina,ARG,Italy,ITA,5,0,0,0,5
2017,Armenia,ARM,Italy,ITA,0,21,11,5,37
2017,Azerbaijan,AZE,Italy,ITA,0,5,0,0,5
2017,Burundi,BDI,Italy,ITA,0,5,0,0,5
2017,Benin,BEN,Italy,ITA,5,56,108,21,190
2017,Bangladesh,BGD,Italy,ITA,81,1802,3894,690,6467
2017,Bahamas,BHS,Italy,ITA,0,0,5,0,5
2017,Burkina Faso,BFA,Italy,ITA,11,160,326,57,554
2017,Belarus,BLR,Italy,ITA,0,5,5,0,10
2017,Bolivia (Plurinational State of),BOL,Italy,ITA,0,0,0,5,5
2017,Brazil,BRA,Italy,ITA,14,26,16,5,61
2017,Bosnia and Herzegovina,BIH,Italy,ITA,5,60,21,5,91
2017,Central African Rep.,CAF,Italy,ITA,10,10,0,10,30
2017,Chad,TCD,Italy,ITA,5,27,19,26,77
2017,China,CHN,Italy,ITA,5,29,321,42,397
2017,Cameroon,CMR,Italy,ITA,156,324,493,374,1347
2017,Congo,COG,Italy,ITA,23,45,20,15,103
2017,Dem. Rep. of the Congo,COD,Italy,ITA,24,68,14,13,119
2017,Comoros,COM,Italy,ITA,0,0,0,13,13
2017,Colombia,COL,Italy,ITA,21,29,24,5,79
2017,Cuba,CUB,Italy,ITA,5,33,17,5,60
2017,Dominican Rep.,DOM,Italy,ITA,0,13,0,0,13
2017,Ecuador,ECU,Italy,ITA,0,14,0,0,14
2017,Equatorial Guinea,GNQ,Italy,ITA,0,0,0,5,5
2017,Eritrea,ERI,Italy,ITA,164,111,108,302,685
2017,Ethiopia,ETH,Italy,ITA,106,84,33,72,295
2017,Gabon,GAB,Italy,ITA,0,0,5,0,5
2017,Gambia,GMB,Italy,ITA,136,2469,3825,627,7057
2017,Palestinian,PSE,Italy,ITA,153,26,75,51,305
2017,Georgia,GEO,Italy,ITA,0,84,45,28,157
2017,Ghana,GHA,Italy,ITA,52,1220,2187,402,3861
2017,Guinea-Bissau,GNB,Italy,ITA,0,185,377,48,610
2017,Guinea,GIN,Italy,ITA,54,1147,2407,1300,4908
2017,Honduras,HND,Italy,ITA,16,10,5,0,31
2017,Cote d'Ivoire,CIV,Italy,ITA,197,1294,2845,1696,6032
2017,India,IND,Italy,ITA,10,78,188,116,392
2017,Iran (Islamic Rep. of),IRN,Italy,ITA,83,63,83,62,291
2017,Iraq,IRQ,Italy,ITA,341,930,138,141,1550
2017,Israel,ISR,Italy,ITA,0,5,0,0,5
2017,Jordan,JOR,Italy,ITA,5,0,5,0,10
2017,Kenya,KEN,Italy,ITA,5,0,13,0,18
2017,Kyrgyzstan,KGZ,Italy,ITA,5,15,0,0,20
2017,Rep. of Korea,KOR,Italy,ITA,0,5,0,0,5
2017,Liberia,LBR,Italy,ITA,5,62,125,27,219
2017,Libya,LBY,Italy,ITA,63,172,32,55,322
2017,Lebanon,LBN,Italy,ITA,12,29,17,18,76
2017,Sri Lanka,LKA,Italy,ITA,10,36,46,16,108
2017,Mauritania,MRT,Italy,ITA,11,22,27,14,74
2017,North Macedonia,MKD,Italy,ITA,0,12,14,0,26
2017,Rep. of Moldova,MDA,Italy,ITA,0,17,22,5,44
2017,Mali,MLI,Italy,ITA,75,1839,2575,780,5269
2017,Malawi,MWI,Italy,ITA,0,0,0,5,5
2017,Morocco,MAR,Italy,ITA,56,222,1004,608,1890
2017,Montenegro,MNE,Italy,ITA,0,5,0,0,5
2017,Mauritius,MUS,Italy,ITA,0,10,0,0,10
2017,Nepal,NPL,Italy,ITA,5,18,13,0,36
2017,Niger,NER,Italy,ITA,10,76,102,39,227
2017,Nicaragua,NIC,Italy,ITA,0,5,10,0,15
2017,Nigeria,NGA,Italy,ITA,787,3557,12441,2418,19203
2017,Pakistan,PAK,Italy,ITA,337,2438,6140,1574,10489
2017,Peru,PER,Italy,ITA,0,13,12,5,30
2017,Philippines,PHL,Italy,ITA,0,13,40,39,92
2017,South Africa,ZAF,Italy,ITA,0,5,0,0,5
2017,Russian Federation,RUS,Italy,ITA,21,22,5,5,53
2017,Rwanda,RWA,Italy,ITA,0,5,0,0,5
2017,El Salvador,SLV,Italy,ITA,149,239,49,47,484
2017,Serbia and Kosovo: S/RES/1244 (1999),SRB,Italy,ITA,10,115,193,86,404
2017,Senegal,SEN,Italy,ITA,79,1387,3700,757,5923
2017,Sierra Leone,SLE,Italy,ITA,23,125,253,139,540
2017,Somalia,SOM,Italy,ITA,812,1248,66,192,2318
2017,Viet Nam,VNM,Italy,ITA,0,5,0,0,5
2017,Sudan,SDN,Italy,ITA,78,114,80,184,456
2017,Syrian Arab Rep.,SYR,Italy,ITA,1009,22,82,77,1190
2017,United Rep. of Tanzania,TZA,Italy,ITA,5,0,5,0,10
2017,Togo,TGO,Italy,ITA,25,127,250,54,456
2017,Tunisia,TUN,Italy,ITA,11,57,211,114,393
2017,Turkey,TUR,Italy,ITA,65,179,58,24,326
2017,Uganda,UGA,Italy,ITA,10,0,5,0,15
2017,Ukraine,UKR,Italy,ITA,42,1222,460,109,1833
2017,Venezuela (Bolivarian Republic of),VEN,Italy,ITA,36,76,5,5,122
2017,Yemen,YEM,Italy,ITA,20,20,0,5,45
2017,Zimbabwe,ZWE,Italy,ITA,0,0,5,0,5
2017,Stateless,XXA,Italy,ITA,0,5,0,0,5
2017,Egypt,EGY,Japan,JPN,5,0,0,0,5
2017,Bangladesh,BGD,Japan,JPN,0,0,181,37,218
2017,Cambodia,KHM,Japan,JPN,0,0,63,28,91
2017,China,CHN,Japan,JPN,0,0,80,42,122
2017,Cameroon,CMR,Japan,JPN,0,0,0,14,14
2017,Ghana,GHA,Japan,JPN,0,5,78,14,97
2017,India,IND,Japan,JPN,0,5,65,81,151
2017,Indonesia,IDN,Japan,JPN,0,0,1315,145,1460
2017,Iran (Islamic Rep. of),IRN,Japan,JPN,0,0,77,18,95
2017,Sri Lanka,LKA,Japan,JPN,0,5,384,99,488
2017,Mongolia,MNG,Japan,JPN,0,0,0,14,14
2017,Myanmar,MMR,Japan,JPN,0,5,474,155,634
2017,Nepal,NPL,Japan,JPN,0,0,1645,141,1786
2017,Nigeria,NGA,Japan,JPN,0,0,93,10,103
2017,Pakistan,PAK,Japan,JPN,0,0,137,38,175
2017,Philippines,PHL,Japan,JPN,0,0,1795,285,2080
2017,Russian Federation,RUS,Japan,JPN,0,0,0,10,10
2017,Senegal,SEN,Japan,JPN,0,0,0,10,10
2017,Viet Nam,VNM,Japan,JPN,0,0,2295,218,2513
2017,Syrian Arab Rep.,SYR,Japan,JPN,5,5,0,0,10
2017,Tunisia,TUN,Japan,JPN,0,0,0,10,10
2017,Turkey,TUR,Japan,JPN,0,5,675,187,867
2017,Afghanistan,AFG,Kazakhstan,KAZ,57,0,169,20,246
2017,Syrian Arab Rep.,SYR,Kazakhstan,KAZ,5,0,0,0,5
2017,Turkey,TUR,Kazakhstan,KAZ,0,0,10,5,15
2017,Afghanistan,AFG,Kyrgyzstan,KGZ,5,0,83,18,106
2017,Iran (Islamic Rep. of),IRN,Kyrgyzstan,KGZ,0,0,5,0,5
2017,Iraq,IRQ,Kyrgyzstan,KGZ,0,0,0,5,5
2017,Pakistan,PAK,Kyrgyzstan,KGZ,0,0,5,0,5
2017,Syrian Arab Rep.,SYR,Kyrgyzstan,KGZ,5,0,0,0,5
2017,Ukraine,UKR,Kyrgyzstan,KGZ,5,0,0,0,5
2017,Uzbekistan,UZB,Kyrgyzstan,KGZ,0,0,0,12,12
2017,Dem. Rep. of the Congo,COD,Lesotho,LSO,5,0,0,0,5
2017,Uganda,UGA,Lesotho,LSO,5,0,0,0,5
2017,Afghanistan,AFG,Liechtenstein,LIE,0,5,0,0,5
2017,Azerbaijan,AZE,Liechtenstein,LIE,0,0,0,5,5
2017,Belarus,BLR,Liechtenstein,LIE,0,0,0,10,10
2017,China,CHN,Liechtenstein,LIE,5,0,0,5,10
2017,Eritrea,ERI,Liechtenstein,LIE,0,0,0,5,5
2017,Georgia,GEO,Liechtenstein,LIE,0,0,0,5,5
2017,North Macedonia,MKD,Liechtenstein,LIE,0,0,0,11,11
2017,Pakistan,PAK,Liechtenstein,LIE,0,0,0,5,5
2017,Russian Federation,RUS,Liechtenstein,LIE,0,0,5,0,5
2017,Serbia and Kosovo: S/RES/1244 (1999),SRB,Liechtenstein,LIE,0,0,10,20,30
2017,Somalia,SOM,Liechtenstein,LIE,0,0,0,13,13
2017,Syrian Arab Rep.,SYR,Liechtenstein,LIE,10,0,0,0,10
2017,Ukraine,UKR,Liechtenstein,LIE,0,0,0,12,12
2017,Afghanistan,AFG,Lithuania,LTU,10,0,0,22,32
2017,Armenia,ARM,Lithuania,LTU,0,0,12,5,17
2017,Azerbaijan,AZE,Lithuania,LTU,0,0,5,0,5
2017,Belarus,BLR,Lithuania,LTU,0,0,12,5,17
2017,Cuba,CUB,Lithuania,LTU,0,0,10,0,10
2017,Eritrea,ERI,Lithuania,LTU,16,10,0,0,26
2017,Georgia,GEO,Lithuania,LTU,0,0,0,10,10
2017,Iraq,IRQ,Lithuania,LTU,13,0,10,0,23
2017,Kyrgyzstan,KGZ,Lithuania,LTU,0,0,5,0,5
2017,Sri Lanka,LKA,Lithuania,LTU,0,0,5,0,5
2017,Pakistan,PAK,Lithuania,LTU,0,0,0,5,5
2017,Russian Federation,RUS,Lithuania,LTU,5,0,19,40,64
2017,Syrian Arab Rep.,SYR,Lithuania,LTU,201,0,0,0,201
2017,Tajikistan,TJK,Lithuania,LTU,12,0,5,12,29
2017,Turkey,TUR,Lithuania,LTU,14,0,5,0,19
2017,Ukraine,UKR,Lithuania,LTU,0,5,0,10,15
2017,Stateless,XXA,Lithuania,LTU,13,0,0,0,13
2017,Afghanistan,AFG,Luxembourg,LUX,160,20,5,0,185
2017,Albania,ALB,Luxembourg,LUX,0,0,130,0,130
2017,Algeria,DZA,Luxembourg,LUX,0,0,15,0,15
2017,Bosnia and Herzegovina,BIH,Luxembourg,LUX,0,0,60,0,60
2017,Cameroon,CMR,Luxembourg,LUX,0,0,5,0,5
2017,Eritrea,ERI,Luxembourg,LUX,95,5,0,0,100
2017,Ethiopia,ETH,Luxembourg,LUX,5,0,0,0,5
2017,Iran (Islamic Rep. of),IRN,Luxembourg,LUX,25,0,5,0,30
2017,Iraq,IRQ,Luxembourg,LUX,290,5,120,0,415
2017,Libya,LBY,Luxembourg,LUX,0,0,5,0,5
2017,North Macedonia,MKD,Luxembourg,LUX,0,0,20,0,20
2017,Morocco,MAR,Luxembourg,LUX,0,0,15,0,15
2017,Montenegro,MNE,Luxembourg,LUX,0,0,20,0,20
2017,Nigeria,NGA,Luxembourg,LUX,0,0,10,0,10
2017,Russian Federation,RUS,Luxembourg,LUX,0,0,5,0,5
2017,Serbia and Kosovo: S/RES/1244 (1999),SRB,Luxembourg,LUX,0,0,120,0,120
2017,Slovakia,SVK,Luxembourg,LUX,0,0,5,0,5
2017,Syrian Arab Rep.,SYR,Luxembourg,LUX,450,0,5,0,455
2017,Tunisia,TUN,Luxembourg,LUX,0,0,10,0,10
2017,Turkey,TUR,Luxembourg,LUX,0,0,10,0,10
2017,Ukraine,UKR,Luxembourg,LUX,0,0,10,0,10
2017,Stateless,XXA,Luxembourg,LUX,15,0,0,0,15
2017,Afghanistan,AFG,Latvia,LVA,15,0,0,0,15
2017,Armenia,ARM,Latvia,LVA,0,0,11,0,11
2017,Azerbaijan,AZE,Latvia,LVA,0,0,5,5,10
2017,Bangladesh,BGD,Latvia,LVA,0,0,5,5,10
2017,Belarus,BLR,Latvia,LVA,0,0,0,5,5
2017,Eritrea,ERI,Latvia,LVA,0,19,0,0,19
2017,Georgia,GEO,Latvia,LVA,0,0,0,10,10
2017,India,IND,Latvia,LVA,0,0,5,0,5
2017,Iraq,IRQ,Latvia,LVA,0,0,0,5,5
2017,Kyrgyzstan,KGZ,Latvia,LVA,0,0,5,0,5
2017,Lebanon,LBN,Latvia,LVA,0,0,5,0,5
2017,Sri Lanka,LKA,Latvia,LVA,0,0,5,0,5
2017,Pakistan,PAK,Latvia,LVA,0,0,0,5,5
2017,Philippines,PHL,Latvia,LVA,0,0,0,5,5
2017,Russian Federation,RUS,Latvia,LVA,5,0,12,5,22
2017,Viet Nam,VNM,Latvia,LVA,0,0,12,23,35
2017,Syrian Arab Rep.,SYR,Latvia,LVA,0,212,0,5,217
2017,Tajikistan,TJK,Latvia,LVA,5,0,13,0,18
2017,Turkey,TUR,Latvia,LVA,15,0,0,0,15
2017,Ukraine,UKR,Latvia,LVA,0,0,0,5,5
2017,Armenia,ARM,Rep. of Moldova,MDA,0,0,0,5,5
2017,Georgia,GEO,Rep. of Moldova,MDA,0,0,5,0,5
2017,Kyrgyzstan,KGZ,Rep. of Moldova,MDA,5,0,0,0,5
2017,Russian Federation,RUS,Rep. of Moldova,MDA,0,0,0,5,5
2017,Syrian Arab Rep.,SYR,Rep. of Moldova,MDA,0,10,0,0,10
2017,Turkey,TUR,Rep. of Moldova,MDA,0,0,5,0,5
2017,Ukraine,UKR,Rep. of Moldova,MDA,0,0,27,5,32
2017,Uzbekistan,UZB,Rep. of Moldova,MDA,0,0,5,0,5
2017,Brazil,BRA,Mexico,MEX,0,0,0,5,5
2017,Canada,CAN,Mexico,MEX,0,0,0,17,17
2017,Cameroon,CMR,Mexico,MEX,0,0,5,48,53
2017,Congo,COG,Mexico,MEX,0,0,0,5,5
2017,Colombia,COL,Mexico,MEX,10,0,17,5,32
2017,Cuba,CUB,Mexico,MEX,23,0,130,519,672
2017,Ecuador,ECU,Mexico,MEX,0,0,5,10,15
2017,Ghana,GHA,Mexico,MEX,0,0,0,12,12
2017,Guatemala,GTM,Mexico,MEX,123,0,116,132,371
2017,Haiti,HTI,Mexico,MEX,0,0,15,48,63
2017,Honduras,HND,Mexico,MEX,770,0,767,774,2311
2017,Iran (Islamic Rep. of),IRN,Mexico,MEX,10,0,0,0,10
2017,Israel,ISR,Mexico,MEX,0,0,5,75,80
2017,Nicaragua,NIC,Mexico,MEX,0,0,19,21,40
2017,Nigeria,NGA,Mexico,MEX,0,0,5,0,5
2017,Pakistan,PAK,Mexico,MEX,0,0,0,5,5
2017,Russian Federation,RUS,Mexico,MEX,0,0,5,5,10
2017,El Salvador,SLV,Mexico,MEX,966,0,543,545,2054
2017,Somalia,SOM,Mexico,MEX,0,0,13,0,13
2017,Syrian Arab Rep.,SYR,Mexico,MEX,0,0,0,5,5
2017,Ukraine,UKR,Mexico,MEX,5,0,0,0,5
2017,United States of America,USA,Mexico,MEX,0,0,0,104,104
2017,Venezuela (Bolivarian Republic of),VEN,Mexico,MEX,907,0,5,63,975
2017,Yemen,YEM,Mexico,MEX,5,0,0,0,5
2017,Central African Rep.,CAF,Mali,MLI,436,0,0,0,436
2017,Dem. Rep. of the Congo,COD,Mali,MLI,12,0,0,0,12
2017,Cote d'Ivoire,CIV,Mali,MLI,0,0,0,80,80
2017,Syrian Arab Rep.,SYR,Mali,MLI,5,0,0,0,5
2017,Turkey,TUR,Mali,MLI,0,0,0,162,162
2017,Burundi,BDI,Malawi,MWI,5,12,0,20,37
2017,Dem. Rep. of the Congo,COD,Malawi,MWI,5,25,0,107,137
2017,Mozambique,MOZ,Malawi,MWI,0,0,0,1743,1743
2017,Rwanda,RWA,Malawi,MWI,0,30,0,10,40
2017,Angola,AGO,Mozambique,MOZ,0,0,0,5,5
2017,Dem. Rep. of the Congo,COD,Mozambique,MOZ,0,0,0,31,31
2017,Ethiopia,ETH,Mozambique,MOZ,0,0,0,5,5
2017,Somalia,SOM,Mozambique,MOZ,0,0,0,244,244
2017,Uganda,UGA,Mozambique,MOZ,0,0,0,10,10
2017,Afghanistan,AFG,Malta,MLT,0,0,0,5,5
2017,Egypt,EGY,Malta,MLT,0,10,5,0,15
2017,Burkina Faso,BFA,Malta,MLT,0,0,0,5,5
2017,Chad,TCD,Malta,MLT,0,5,0,0,5
2017,Eritrea,ERI,Malta,MLT,5,90,10,39,144
2017,Ethiopia,ETH,Malta,MLT,5,5,5,5,20
2017,Palestinian,PSE,Malta,MLT,0,13,0,5,18
2017,Ghana,GHA,Malta,MLT,0,0,0,5,5
2017,"China, Hong Kong SAR",HKG,Malta,MLT,0,0,5,0,5
2017,Cote d'Ivoire,CIV,Malta,MLT,0,0,5,0,5
2017,Iraq,IRQ,Malta,MLT,28,0,5,10,43
2017,Liberia,LBR,Malta,MLT,0,5,0,0,5
2017,Libya,LBY,Malta,MLT,52,279,0,81,412
2017,North Macedonia,MKD,Malta,MLT,0,0,0,5,5
2017,Morocco,MAR,Malta,MLT,0,0,0,5,5
2017,Nigeria,NGA,Malta,MLT,5,16,17,5,43
2017,Russian Federation,RUS,Malta,MLT,0,0,5,0,5
2017,Somalia,SOM,Malta,MLT,5,46,5,103,159
2017,Sudan,SDN,Malta,MLT,0,5,0,14,19
2017,Syrian Arab Rep.,SYR,Malta,MLT,51,152,0,67,270
2017,Turkey,TUR,Malta,MLT,0,0,0,5,5
2017,Ukraine,UKR,Malta,MLT,0,10,81,18,109
2017,Venezuela (Bolivarian Republic of),VEN,Malta,MLT,0,0,5,0,5
2017,Burundi,BDI,Namibia,NAM,26,0,12,0,38
2017,Dem. Rep. of the Congo,COD,Namibia,NAM,172,0,130,0,302
2017,Nigeria,NGA,Namibia,NAM,0,0,5,0,5
2017,Rwanda,RWA,Namibia,NAM,0,0,15,0,15
2017,United Rep. of Tanzania,TZA,Namibia,NAM,0,0,5,0,5
2017,Uganda,UGA,Namibia,NAM,0,0,5,0,5
2017,Zimbabwe,ZWE,Namibia,NAM,12,0,0,0,12
2017,Afghanistan,AFG,Netherlands,NLD,428,127,917,76,1548
2017,Albania,ALB,Netherlands,NLD,0,0,336,122,458
2017,Algeria,DZA,Netherlands,NLD,0,0,250,128,378
2017,Angola,AGO,Netherlands,NLD,0,0,5,0,5
2017,Egypt,EGY,Netherlands,NLD,25,0,77,11,113
2017,Armenia,ARM,Netherlands,NLD,0,0,41,10,51
2017,Azerbaijan,AZE,Netherlands,NLD,0,0,28,26,54
2017,Burundi,BDI,Netherlands,NLD,0,0,20,0,20
2017,Bangladesh,BGD,Netherlands,NLD,0,0,13,0,13
2017,Belarus,BLR,Netherlands,NLD,0,0,5,0,5
2017,Brazil,BRA,Netherlands,NLD,0,0,5,0,5
2017,Bosnia and Herzegovina,BIH,Netherlands,NLD,0,0,61,0,61
2017,China,CHN,Netherlands,NLD,105,0,62,5,172
2017,Cameroon,CMR,Netherlands,NLD,5,0,12,0,17
2017,Congo,COG,Netherlands,NLD,5,0,32,0,37
2017,Colombia,COL,Netherlands,NLD,0,0,29,0,29
2017,Cuba,CUB,Netherlands,NLD,0,0,70,10,80
2017,Eritrea,ERI,Netherlands,NLD,879,12,132,25,1048
2017,Ethiopia,ETH,Netherlands,NLD,38,0,60,0,98
2017,Gambia,GMB,Netherlands,NLD,0,0,51,11,62
2017,Georgia,GEO,Netherlands,NLD,0,0,221,64,285
2017,Ghana,GHA,Netherlands,NLD,0,0,12,0,12
2017,Guinea,GIN,Netherlands,NLD,5,0,79,5,89
2017,Honduras,HND,Netherlands,NLD,0,0,5,0,5
2017,Cote d'Ivoire,CIV,Netherlands,NLD,0,0,5,0,5
2017,India,IND,Netherlands,NLD,0,0,29,18,47
2017,Iran (Islamic Rep. of),IRN,Netherlands,NLD,594,91,721,59,1465
2017,Iraq,IRQ,Netherlands,NLD,360,62,779,167,1368
2017,Jamaica,JAM,Netherlands,NLD,10,0,0,0,10
2017,Jordan,JOR,Netherlands,NLD,0,0,15,0,15
2017,Libya,LBY,Netherlands,NLD,5,0,90,53,148
2017,Lebanon,LBN,Netherlands,NLD,5,0,27,5,37
2017,Sri Lanka,LKA,Netherlands,NLD,5,0,21,5,31
2017,Mauritania,MRT,Netherlands,NLD,0,0,5,0,5
2017,North Macedonia,MKD,Netherlands,NLD,0,0,101,12,113
2017,Rep. of Moldova,MDA,Netherlands,NLD,0,0,150,14,164
2017,Mali,MLI,Netherlands,NLD,0,0,10,5,15
2017,Mongolia,MNG,Netherlands,NLD,0,0,13,0,13
2017,Morocco,MAR,Netherlands,NLD,11,0,273,121,405
2017,Myanmar,MMR,Netherlands,NLD,5,0,13,0,18
2017,Nigeria,NGA,Netherlands,NLD,15,0,112,5,132
2017,Pakistan,PAK,Netherlands,NLD,45,5,76,5,131
2017,Russian Federation,RUS,Netherlands,NLD,18,0,29,10,57
2017,El Salvador,SLV,Netherlands,NLD,0,0,10,0,10
2017,Serbia and Kosovo: S/RES/1244 (1999),SRB,Netherlands,NLD,0,0,232,15,247
2017,Senegal,SEN,Netherlands,NLD,0,0,0,14,14
2017,Sierra Leone,SLE,Netherlands,NLD,5,0,18,0,23
2017,Somalia,SOM,Netherlands,NLD,61,0,99,5,165
2017,Viet Nam,VNM,Netherlands,NLD,0,0,36,29,65
2017,Sudan,SDN,Netherlands,NLD,73,0,62,14,149
2017,Syrian Arab Rep.,SYR,Netherlands,NLD,1722,5,419,116,2262
2017,United Rep. of Tanzania,TZA,Netherlands,NLD,0,0,5,0,5
2017,Tajikistan,TJK,Netherlands,NLD,0,0,0,10,10
2017,Trinidad and Tobago,TTO,Netherlands,NLD,16,0,0,0,16
2017,Tunisia,TUN,Netherlands,NLD,0,0,36,20,56
2017,Turkey,TUR,Netherlands,NLD,204,142,79,21,446
2017,Uganda,UGA,Netherlands,NLD,32,0,45,0,77
2017,Ukraine,UKR,Netherlands,NLD,0,0,71,15,86
2017,United States of America,USA,Netherlands,NLD,0,0,5,0,5
2017,Venezuela (Bolivarian Republic of),VEN,Netherlands,NLD,0,0,35,0,35
2017,Yemen,YEM,Netherlands,NLD,155,0,10,5,170
2017,Zimbabwe,ZWE,Netherlands,NLD,0,0,10,0,10
2017,Stateless,XXA,Netherlands,NLD,200,5,92,5,302
2017,Central African Rep.,CAF,Niger,NER,0,0,0,31,31
2017,Dem. Rep. of the Congo,COD,Niger,NER,0,0,12,0,12
2017,Cote d'Ivoire,CIV,Niger,NER,0,0,5,12,17
2017,Nigeria,NGA,Niger,NER,0,0,5,0,5
2017,Turkey,TUR,Niger,NER,0,0,0,16,16
2017,Honduras,HND,Nicaragua,NIC,0,0,0,5,5
2017,El Salvador,SLV,Nicaragua,NIC,0,0,0,37,37
2017,Central African Rep.,CAF,Nigeria,NGA,11,211,5,34,261
2017,Chad,TCD,Nigeria,NGA,5,0,5,0,10
2017,Cameroon,CMR,Nigeria,NGA,67,0,5,0,72
2017,Dem. Rep. of the Congo,COD,Nigeria,NGA,15,0,0,0,15
2017,Eritrea,ERI,Nigeria,NGA,5,0,0,0,5
2017,Cote d'Ivoire,CIV,Nigeria,NGA,0,0,0,5,5
2017,Mali,MLI,Nigeria,NGA,0,0,0,11,11
2017,Syrian Arab Rep.,SYR,Nigeria,NGA,55,0,0,21,76
2017,Turkey,TUR,Nigeria,NGA,139,0,0,0,139
2017,Afghanistan,AFG,Norway,NOR,134,57,1260,83,1534
2017,Albania,ALB,Norway,NOR,5,0,63,20,88
2017,Algeria,DZA,Norway,NOR,0,0,5,16,21
2017,Angola,AGO,Norway,NOR,0,0,0,11,11
2017,Egypt,EGY,Norway,NOR,0,0,0,14,14
2017,Armenia,ARM,Norway,NOR,0,0,10,0,10
2017,Australia,AUS,Norway,NOR,0,0,5,0,5
2017,Azerbaijan,AZE,Norway,NOR,0,0,5,0,5
2017,Burundi,BDI,Norway,NOR,0,0,5,0,5
2017,Bangladesh,BGD,Norway,NOR,0,0,5,0,5
2017,Belarus,BLR,Norway,NOR,0,0,0,5,5
2017,Bosnia and Herzegovina,BIH,Norway,NOR,0,0,5,106,111
2017,China,CHN,Norway,NOR,17,0,0,10,27
2017,Cameroon,CMR,Norway,NOR,0,0,5,0,5
2017,Dem. Rep. of the Congo,COD,Norway,NOR,0,0,11,5,16
2017,Colombia,COL,Norway,NOR,0,0,16,0,16
2017,Eritrea,ERI,Norway,NOR,746,0,19,40,805
2017,Ethiopia,ETH,Norway,NOR,59,0,69,20,148
2017,Gambia,GMB,Norway,NOR,0,0,5,5,10
2017,Georgia,GEO,Norway,NOR,0,0,29,5,34
2017,Ghana,GHA,Norway,NOR,5,0,0,0,5
2017,Guinea,GIN,Norway,NOR,0,0,0,10,10
2017,Croatia,HRV,Norway,NOR,0,0,0,5,5
2017,Cote d'Ivoire,CIV,Norway,NOR,0,0,0,5,5
2017,Iran (Islamic Rep. of),IRN,Norway,NOR,195,0,148,46,389
2017,Iraq,IRQ,Norway,NOR,339,5,381,56,781
2017,Jordan,JOR,Norway,NOR,0,0,5,10,15
2017,Kazakhstan,KAZ,Norway,NOR,0,0,5,0,5
2017,Rep. of Korea,KOR,Norway,NOR,0,0,5,0,5
2017,Liberia,LBR,Norway,NOR,0,0,0,5,5
2017,Libya,LBY,Norway,NOR,5,11,5,5,26
2017,Lebanon,LBN,Norway,NOR,0,0,5,10,15
2017,Sri Lanka,LKA,Norway,NOR,0,0,10,0,10
2017,Mauritania,MRT,Norway,NOR,0,0,0,5,5
2017,North Macedonia,MKD,Norway,NOR,0,0,5,0,5
2017,Mongolia,MNG,Norway,NOR,0,0,13,0,13
2017,Morocco,MAR,Norway,NOR,0,0,28,31,59
2017,Mozambique,MOZ,Norway,NOR,0,0,0,5,5
2017,Myanmar,MMR,Norway,NOR,5,0,5,0,10
2017,Nigeria,NGA,Norway,NOR,5,0,5,15,25
2017,Pakistan,PAK,Norway,NOR,0,0,15,15,30
2017,Philippines,PHL,Norway,NOR,0,0,5,0,5
2017,Poland,POL,Norway,NOR,0,0,0,5,5
2017,Russian Federation,RUS,Norway,NOR,5,0,26,30,61
2017,Rwanda,RWA,Norway,NOR,0,0,0,5,5
2017,Serbia and Kosovo: S/RES/1244 (1999),SRB,Norway,NOR,0,0,18,10,28
2017,Senegal,SEN,Norway,NOR,0,0,0,5,5
2017,Somalia,SOM,Norway,NOR,45,14,46,12,117
2017,Viet Nam,VNM,Norway,NOR,0,0,0,5,5
2017,Sudan,SDN,Norway,NOR,14,0,12,25,51
2017,South Sudan,SSD,Norway,NOR,10,0,0,0,10
2017,Slovakia,SVK,Norway,NOR,0,0,20,0,20
2017,Sweden,SWE,Norway,NOR,0,0,5,0,5
2017,Syrian Arab Rep.,SYR,Norway,NOR,1818,10,31,97,1956
2017,United Rep. of Tanzania,TZA,Norway,NOR,0,0,0,5,5
2017,Turkey,TUR,Norway,NOR,120,0,20,27,167
2017,Uganda,UGA,Norway,NOR,5,0,0,5,10
2017,Ukraine,UKR,Norway,NOR,0,0,21,12,33
2017,United States of America,USA,Norway,NOR,0,0,10,0,10
2017,Uzbekistan,UZB,Norway,NOR,0,0,0,5,5
2017,Venezuela (Bolivarian Republic of),VEN,Norway,NOR,0,0,12,0,12
2017,Yemen,YEM,Norway,NOR,12,38,0,5,55
2017,Stateless,XXA,Norway,NOR,218,5,45,47,315
2017,Afghanistan,AFG,New Zealand,NZL,0,0,13,0,13
2017,Egypt,EGY,New Zealand,NZL,0,0,5,0,5
2017,Bangladesh,BGD,New Zealand,NZL,0,0,15,0,15
2017,Brazil,BRA,New Zealand,NZL,0,0,5,0,5
2017,China,CHN,New Zealand,NZL,35,0,20,0,55
2017,Colombia,COL,New Zealand,NZL,0,0,5,0,5
2017,Czechia,CZE,New Zealand,NZL,0,0,5,0,5
2017,Fiji,FJI,New Zealand,NZL,0,0,0,5,5
2017,Hungary,HUN,New Zealand,NZL,0,0,12,5,17
2017,India,IND,New Zealand,NZL,5,0,13,5,23
2017,Indonesia,IDN,New Zealand,NZL,5,0,0,0,5
2017,Iran (Islamic Rep. of),IRN,New Zealand,NZL,13,0,0,0,13
2017,Iraq,IRQ,New Zealand,NZL,14,0,5,0,19
2017,Jordan,JOR,New Zealand,NZL,5,0,0,0,5
2017,Rep. of Korea,KOR,New Zealand,NZL,0,0,5,0,5
2017,Libya,LBY,New Zealand,NZL,5,0,0,0,5
2017,Sri Lanka,LKA,New Zealand,NZL,0,0,22,0,22
2017,Malaysia,MYS,New Zealand,NZL,0,0,11,0,11
2017,Oman,OMN,New Zealand,NZL,0,0,5,0,5
2017,Pakistan,PAK,New Zealand,NZL,0,0,10,0,10
2017,Philippines,PHL,New Zealand,NZL,0,0,5,0,5
2017,South Africa,ZAF,New Zealand,NZL,0,0,12,0,12
2017,Russian Federation,RUS,New Zealand,NZL,0,0,11,0,11
2017,Saudi Arabia,SAU,New Zealand,NZL,12,0,0,5,17
2017,Syrian Arab Rep.,SYR,New Zealand,NZL,5,0,0,0,5
2017,Thailand,THA,New Zealand,NZL,0,0,5,0,5
2017,Turkey,TUR,New Zealand,NZL,5,0,15,0,20
2017,United States of America,USA,New Zealand,NZL,0,0,5,0,5
2017,Samoa,WSM,New Zealand,NZL,0,0,5,0,5
2017,Zimbabwe,ZWE,New Zealand,NZL,0,0,5,0,5
2017,Colombia,COL,Panama,PAN,52,0,28,544,624
2017,Cuba,CUB,Panama,PAN,5,0,0,108,113
2017,Dominican Rep.,DOM,Panama,PAN,0,0,0,11,11
2017,Ecuador,ECU,Panama,PAN,0,0,0,5,5
2017,Guatemala,GTM,Panama,PAN,0,0,0,5,5
2017,Haiti,HTI,Panama,PAN,0,0,0,11,11
2017,Honduras,HND,Panama,PAN,0,0,0,24,24
2017,Jamaica,JAM,Panama,PAN,0,0,0,5,5
2017,Nicaragua,NIC,Panama,PAN,0,0,0,369,369
2017,Russian Federation,RUS,Panama,PAN,0,0,0,5,5
2017,El Salvador,SLV,Panama,PAN,28,0,5,107,140
2017,Venezuela (Bolivarian Republic of),VEN,Panama,PAN,5,0,0,1433,1438
2017,Yemen,YEM,Panama,PAN,0,0,0,23,23
2017,Cuba,CUB,Paraguay,PRY,10,0,5,0,15
2017,Syrian Arab Rep.,SYR,Paraguay,PRY,5,0,0,5,10
2017,Bangladesh,BGD,Peru,PER,5,0,0,0,5
2017,Cameroon,CMR,Peru,PER,5,0,0,0,5
2017,Colombia,COL,Peru,PER,13,0,15,26,54
2017,Cuba,CUB,Peru,PER,36,0,78,48,162
2017,Dominican Rep.,DOM,Peru,PER,0,0,0,10,10
2017,Ecuador,ECU,Peru,PER,0,0,0,5,5
2017,Palestinian,PSE,Peru,PER,0,0,0,5,5
2017,Haiti,HTI,Peru,PER,0,0,11,0,11
2017,India,IND,Peru,PER,0,0,5,0,5
2017,Nepal,NPL,Peru,PER,0,0,5,0,5
2017,Senegal,SEN,Peru,PER,0,0,0,5,5
2017,Syrian Arab Rep.,SYR,Peru,PER,5,0,0,0,5
2017,Venezuela (Bolivarian Republic of),VEN,Peru,PER,102,0,412,155,669
2017,Afghanistan,AFG,Poland,POL,0,5,5,18,28
2017,Algeria,DZA,Poland,POL,0,0,11,0,11
2017,Egypt,EGY,Poland,POL,5,0,0,5,10
2017,Armenia,ARM,Poland,POL,0,0,61,33,94
2017,Azerbaijan,AZE,Poland,POL,0,0,21,5,26
2017,Bangladesh,BGD,Poland,POL,0,0,13,0,13
2017,Burkina Faso,BFA,Poland,POL,0,0,5,0,5
2017,Belarus,BLR,Poland,POL,5,0,17,26,48
2017,Bulgaria,BGR,Poland,POL,0,0,0,5,5
2017,Central African Rep.,CAF,Poland,POL,5,0,0,0,5
2017,China,CHN,Poland,POL,0,0,5,5,10
2017,Cameroon,CMR,Poland,POL,5,0,0,0,5
2017,Dem. Rep. of the Congo,COD,Poland,POL,0,0,5,0,5
2017,Cuba,CUB,Poland,POL,0,0,5,0,5
2017,Eritrea,ERI,Poland,POL,0,0,0,10,10
2017,Ethiopia,ETH,Poland,POL,0,0,5,0,5
2017,Palestinian,PSE,Poland,POL,5,0,0,0,5
2017,Georgia,GEO,Poland,POL,0,0,22,34,56
2017,India,IND,Poland,POL,0,0,0,14,14
2017,Iran (Islamic Rep. of),IRN,Poland,POL,5,0,11,5,21
2017,Iraq,IRQ,Poland,POL,12,10,5,28,55
2017,Jamaica,JAM,Poland,POL,0,0,0,5,5
2017,Kazakhstan,KAZ,Poland,POL,0,0,27,0,27
2017,Kyrgyzstan,KGZ,Poland,POL,0,0,25,16,41
2017,Libya,LBY,Poland,POL,5,5,0,0,10
2017,Lebanon,LBN,Poland,POL,0,0,5,0,5
2017,Sri Lanka,LKA,Poland,POL,5,0,0,0,5
2017,Mongolia,MNG,Poland,POL,0,0,10,0,10
2017,Nigeria,NGA,Poland,POL,0,0,0,5,5
2017,Pakistan,PAK,Poland,POL,5,0,11,10,26
2017,Russian Federation,RUS,Poland,POL,14,72,1260,2142,3488
2017,Viet Nam,VNM,Poland,POL,0,0,20,16,36
2017,Syrian Arab Rep.,SYR,Poland,POL,18,12,0,21,51
2017,Tajikistan,TJK,Poland,POL,5,29,153,61,248
2017,Turkey,TUR,Poland,POL,0,0,19,18,37
2017,Ukraine,UKR,Poland,POL,56,199,354,248,857
2017,Stateless,XXA,Poland,POL,5,0,0,5,10
2017,Afghanistan,AFG,Portugal,PRT,5,0,0,0,5
2017,Algeria,DZA,Portugal,PRT,0,0,15,0,15
2017,Angola,AGO,Portugal,PRT,0,0,60,0,60
2017,Brazil,BRA,Portugal,PRT,0,0,5,0,5
2017,Central African Rep.,CAF,Portugal,PRT,0,5,5,0,10
2017,Cameroon,CMR,Portugal,PRT,0,0,20,0,20
2017,Congo,COG,Portugal,PRT,0,5,45,0,50
2017,Dem. Rep. of the Congo,COD,Portugal,PRT,0,10,115,0,125
2017,Eritrea,ERI,Portugal,PRT,85,0,0,0,85
2017,Gambia,GMB,Portugal,PRT,0,0,15,0,15
2017,Ghana,GHA,Portugal,PRT,0,0,5,0,5
2017,Guinea-Bissau,GNB,Portugal,PRT,0,0,5,0,5
2017,Guinea,GIN,Portugal,PRT,0,10,10,0,20
2017,Cote d'Ivoire,CIV,Portugal,PRT,0,0,10,0,10
2017,Iran (Islamic Rep. of),IRN,Portugal,PRT,5,0,0,0,5
2017,Iraq,IRQ,Portugal,PRT,5,35,0,0,40
2017,Sri Lanka,LKA,Portugal,PRT,5,5,0,0,10
2017,Mauritania,MRT,Portugal,PRT,0,0,10,0,10
2017,Mali,MLI,Portugal,PRT,0,5,10,0,15
2017,Morocco,MAR,Portugal,PRT,0,0,10,0,10
2017,Nigeria,NGA,Portugal,PRT,0,0,5,0,5
2017,Pakistan,PAK,Portugal,PRT,0,10,0,0,10
2017,Russian Federation,RUS,Portugal,PRT,0,0,5,0,5
2017,Senegal,SEN,Portugal,PRT,0,0,20,0,20
2017,Sierra Leone,SLE,Portugal,PRT,0,5,25,0,30
2017,Syrian Arab Rep.,SYR,Portugal,PRT,0,225,5,0,230
2017,United Rep. of Tanzania,TZA,Portugal,PRT,0,0,5,0,5
2017,Togo,TGO,Portugal,PRT,0,0,5,0,5
2017,Ukraine,UKR,Portugal,PRT,5,40,10,0,55
2017,Venezuela (Bolivarian Republic of),VEN,Portugal,PRT,0,0,10,0,10
2017,Zimbabwe,ZWE,Portugal,PRT,0,0,5,0,5
2017,Stateless,XXA,Portugal,PRT,0,15,0,0,15
2017,Afghanistan,AFG,Romania,ROU,23,29,84,55,191
2017,Albania,ALB,Romania,ROU,0,0,5,0,5
2017,Algeria,DZA,Romania,ROU,0,0,10,0,10
2017,Angola,AGO,Romania,ROU,0,5,0,0,5
2017,Egypt,EGY,Romania,ROU,0,0,14,0,14
2017,Bangladesh,BGD,Romania,ROU,0,0,27,0,27
2017,China,CHN,Romania,ROU,0,0,5,0,5
2017,Cameroon,CMR,Romania,ROU,5,0,5,0,10
2017,Cuba,CUB,Romania,ROU,0,0,11,0,11
2017,Eritrea,ERI,Romania,ROU,14,0,0,0,14
2017,Ethiopia,ETH,Romania,ROU,0,0,5,0,5
2017,Palestinian,PSE,Romania,ROU,5,5,13,0,23
2017,Ghana,GHA,Romania,ROU,0,0,5,0,5
2017,India,IND,Romania,ROU,0,0,29,5,34
2017,Iran (Islamic Rep. of),IRN,Romania,ROU,10,0,52,31,93
2017,Iraq,IRQ,Romania,ROU,325,106,331,527,1289
2017,Israel,ISR,Romania,ROU,0,0,5,0,5
2017,Jordan,JOR,Romania,ROU,0,0,5,0,5
2017,Libya,LBY,Romania,ROU,0,0,12,0,12
2017,Sri Lanka,LKA,Romania,ROU,0,0,10,0,10
2017,Rep. of Moldova,MDA,Romania,ROU,0,0,10,0,10
2017,Morocco,MAR,Romania,ROU,0,0,5,0,5
2017,Myanmar,MMR,Romania,ROU,5,0,0,0,5
2017,Nigeria,NGA,Romania,ROU,0,0,5,0,5
2017,Pakistan,PAK,Romania,ROU,0,5,242,66,313
2017,Philippines,PHL,Romania,ROU,0,0,5,0,5
2017,Serbia and Kosovo: S/RES/1244 (1999),SRB,Romania,ROU,0,0,11,0,11
2017,Somalia,SOM,Romania,ROU,13,0,12,0,25
2017,Syrian Arab Rep.,SYR,Romania,ROU,432,195,13,52,692
2017,Tunisia,TUN,Romania,ROU,0,0,10,0,10
2017,Turkey,TUR,Romania,ROU,10,0,24,5,39
2017,Ukraine,UKR,Romania,ROU,0,0,10,0,10
2017,Yemen,YEM,Romania,ROU,0,10,0,0,10
2017,Stateless,XXA,Romania,ROU,15,14,11,0,40
2017,Algeria,DZA,South Africa,ZAF,0,0,71,0,71
2017,Egypt,EGY,South Africa,ZAF,0,0,91,0,91
2017,Burundi,BDI,South Africa,ZAF,29,0,877,0,906
2017,Bangladesh,BGD,South Africa,ZAF,0,0,3644,0,3644
2017,Cameroon,CMR,South Africa,ZAF,0,0,353,0,353
2017,Congo,COG,South Africa,ZAF,42,0,270,0,312
2017,Dem. Rep. of the Congo,COD,South Africa,ZAF,970,0,4297,0,5267
2017,Eritrea,ERI,South Africa,ZAF,105,0,124,0,229
2017,Ethiopia,ETH,South Africa,ZAF,356,0,3341,0,3697
2017,Ghana,GHA,South Africa,ZAF,0,0,593,0,593
2017,Cote d'Ivoire,CIV,South Africa,ZAF,5,0,0,0,5
2017,India,IND,South Africa,ZAF,0,0,748,0,748
2017,Kenya,KEN,South Africa,ZAF,0,0,124,0,124
2017,Malawi,MWI,South Africa,ZAF,0,0,885,0,885
2017,Mozambique,MOZ,South Africa,ZAF,0,0,237,0,237
2017,Nepal,NPL,South Africa,ZAF,0,0,29,0,29
2017,Nigeria,NGA,South Africa,ZAF,0,0,1645,0,1645
2017,Pakistan,PAK,South Africa,ZAF,0,0,1946,0,1946
2017,Rwanda,RWA,South Africa,ZAF,5,0,101,0,106
2017,Senegal,SEN,South Africa,ZAF,0,0,205,0,205
2017,Somalia,SOM,South Africa,ZAF,732,0,1500,0,2232
2017,Syrian Arab Rep.,SYR,South Africa,ZAF,5,0,0,0,5
2017,United Rep. of Tanzania,TZA,South Africa,ZAF,0,0,151,0,151
2017,Uganda,UGA,South Africa,ZAF,0,0,784,0,784
2017,Zimbabwe,ZWE,South Africa,ZAF,12,0,3230,0,3242
2017,Afghanistan,AFG,Russian Federation,RUS,10,0,0,181,191
2017,Egypt,EGY,Russian Federation,RUS,0,0,0,5,5
2017,Azerbaijan,AZE,Russian Federation,RUS,0,0,0,5,5
2017,Bangladesh,BGD,Russian Federation,RUS,0,0,0,5,5
2017,Belarus,BLR,Russian Federation,RUS,0,0,0,5,5
2017,Dem. Rep. of the Congo,COD,Russian Federation,RUS,0,0,0,5,5
2017,Palestinian,PSE,Russian Federation,RUS,0,0,0,5,5
2017,Georgia,GEO,Russian Federation,RUS,0,0,0,5,5
2017,Iraq,IRQ,Russian Federation,RUS,0,0,0,5,5
2017,Kazakhstan,KAZ,Russian Federation,RUS,0,0,0,5,5
2017,Kyrgyzstan,KGZ,Russian Federation,RUS,0,0,0,10,10
2017,Dem. People's Rep. of Korea,PRK,Russian Federation,RUS,0,0,0,12,12
2017,Rep. of Moldova,MDA,Russian Federation,RUS,5,0,0,0,5
2017,Sudan,SDN,Russian Federation,RUS,0,0,0,5,5
2017,Syrian Arab Rep.,SYR,Russian Federation,RUS,0,0,0,163,163
2017,Tajikistan,TJK,Russian Federation,RUS,0,0,0,11,11
2017,Turkmenistan,TKM,Russian Federation,RUS,0,0,0,5,5
2017,Ukraine,UKR,Russian Federation,RUS,14,0,0,91,105
2017,Uzbekistan,UZB,Russian Federation,RUS,0,0,0,22,22
2017,Venezuela (Bolivarian Republic of),VEN,Russian Federation,RUS,0,0,0,5,5
2017,Yemen,YEM,Russian Federation,RUS,0,0,0,13,13
2017,Stateless,XXA,Russian Federation,RUS,0,0,0,5,5
2017,Burundi,BDI,Rwanda,RWA,0,0,0,12,12
2017,Dem. Rep. of the Congo,COD,Rwanda,RWA,11,0,0,5,16
2017,Afghanistan,AFG,Serbia and Kosovo: S/RES/1244 (1999),SRB,0,0,0,112,112
2017,Algeria,DZA,Serbia and Kosovo: S/RES/1244 (1999),SRB,0,0,5,13,18
2017,Bulgaria,BGR,Serbia and Kosovo: S/RES/1244 (1999),SRB,0,0,0,5,5
2017,Cameroon,CMR,Serbia and Kosovo: S/RES/1244 (1999),SRB,0,0,0,5,5
2017,Cuba,CUB,Serbia and Kosovo: S/RES/1244 (1999),SRB,0,0,0,29,29
2017,Palestinian,PSE,Serbia and Kosovo: S/RES/1244 (1999),SRB,0,0,0,5,5
2017,Ghana,GHA,Serbia and Kosovo: S/RES/1244 (1999),SRB,0,0,0,5,5
2017,Iran (Islamic Rep. of),IRN,Serbia and Kosovo: S/RES/1244 (1999),SRB,0,0,0,5,5
2017,Iraq,IRQ,Serbia and Kosovo: S/RES/1244 (1999),SRB,0,0,0,37,37
2017,Libya,LBY,Serbia and Kosovo: S/RES/1244 (1999),SRB,0,10,0,21,31
2017,North Macedonia,MKD,Serbia and Kosovo: S/RES/1244 (1999),SRB,0,0,0,5,5
2017,Morocco,MAR,Serbia and Kosovo: S/RES/1244 (1999),SRB,0,0,0,5,5
2017,Pakistan,PAK,Serbia and Kosovo: S/RES/1244 (1999),SRB,0,0,5,36,41
2017,Russian Federation,RUS,Serbia and Kosovo: S/RES/1244 (1999),SRB,0,0,0,5,5
2017,Somalia,SOM,Serbia and Kosovo: S/RES/1244 (1999),SRB,0,0,5,0,5
2017,Syrian Arab Rep.,SYR,Serbia and Kosovo: S/RES/1244 (1999),SRB,0,0,0,42,42
2017,Ukraine,UKR,Serbia and Kosovo: S/RES/1244 (1999),SRB,0,0,5,0,5
2017,Mali,MLI,Sierra Leone,SLE,0,0,5,0,5
2017,Afghanistan,AFG,Spain,ESP,15,36,18,5,74
2017,Albania,ALB,Spain,ESP,0,0,13,0,13
2017,Algeria,DZA,Spain,ESP,10,0,415,57,482
2017,Egypt,EGY,Spain,ESP,5,0,18,0,23
2017,Argentina,ARG,Spain,ESP,0,0,13,0,13
2017,Armenia,ARM,Spain,ESP,5,0,31,0,36
2017,Azerbaijan,AZE,Spain,ESP,13,0,0,0,13
2017,Benin,BEN,Spain,ESP,0,0,5,5,10
2017,Bangladesh,BGD,Spain,ESP,0,5,47,0,52
2017,Burkina Faso,BFA,Spain,ESP,0,0,16,0,16
2017,Belarus,BLR,Spain,ESP,0,0,5,0,5
2017,Bolivia (Plurinational State of),BOL,Spain,ESP,0,0,5,0,5
2017,Brazil,BRA,Spain,ESP,0,0,10,5,15
2017,Central African Rep.,CAF,Spain,ESP,0,25,5,15,45
2017,Chad,TCD,Spain,ESP,0,0,5,0,5
2017,Chile,CHL,Spain,ESP,0,0,10,0,10
2017,Cameroon,CMR,Spain,ESP,5,0,44,11,60
2017,Congo,COG,Spain,ESP,0,0,5,0,5
2017,Dem. Rep. of the Congo,COD,Spain,ESP,0,5,5,0,10
2017,Colombia,COL,Spain,ESP,10,0,197,12,219
2017,Cuba,CUB,Spain,ESP,0,10,29,0,39
2017,Dominican Rep.,DOM,Spain,ESP,0,0,50,50,100
2017,Ecuador,ECU,Spain,ESP,0,0,5,0,5
2017,Equatorial Guinea,GNQ,Spain,ESP,5,0,15,5,25
2017,Eritrea,ERI,Spain,ESP,122,5,0,0,127
2017,Ethiopia,ETH,Spain,ESP,0,0,5,0,5
2017,Gambia,GMB,Spain,ESP,0,0,92,5,97
2017,Palestinian,PSE,Spain,ESP,126,141,65,363,695
2017,Georgia,GEO,Spain,ESP,0,0,41,5,46
2017,Ghana,GHA,Spain,ESP,0,0,13,5,18
2017,Guinea-Bissau,GNB,Spain,ESP,5,0,5,0,10
2017,Guatemala,GTM,Spain,ESP,0,0,5,0,5
2017,Guinea,GIN,Spain,ESP,5,0,30,5,40
2017,Haiti,HTI,Spain,ESP,0,0,5,0,5
2017,Honduras,HND,Spain,ESP,5,0,26,5,36
2017,Cote d'Ivoire,CIV,Spain,ESP,0,5,45,5,55
2017,India,IND,Spain,ESP,5,0,0,0,5
2017,Iran (Islamic Rep. of),IRN,Spain,ESP,11,0,101,12,124
2017,Iraq,IRQ,Spain,ESP,26,83,41,106,256
2017,Jordan,JOR,Spain,ESP,5,0,12,10,27
2017,Kazakhstan,KAZ,Spain,ESP,0,0,5,0,5
2017,Kenya,KEN,Spain,ESP,0,0,5,0,5
2017,Liberia,LBR,Spain,ESP,0,0,5,0,5
2017,Libya,LBY,Spain,ESP,10,10,54,5,79
2017,Lebanon,LBN,Spain,ESP,11,5,30,5,51
2017,Sri Lanka,LKA,Spain,ESP,0,0,0,12,12
2017,Mauritania,MRT,Spain,ESP,0,0,13,0,13
2017,Mali,MLI,Spain,ESP,10,20,454,71,555
2017,Mongolia,MNG,Spain,ESP,0,0,5,0,5
2017,Morocco,MAR,Spain,ESP,60,0,114,17,191
2017,Niger,NER,Spain,ESP,0,0,5,0,5
2017,Nicaragua,NIC,Spain,ESP,0,0,5,0,5
2017,Nigeria,NGA,Spain,ESP,13,0,45,5,63
2017,Pakistan,PAK,Spain,ESP,45,0,22,5,72
2017,Paraguay,PRY,Spain,ESP,0,0,5,0,5
2017,Peru,PER,Spain,ESP,0,0,70,5,75
2017,Russian Federation,RUS,Spain,ESP,22,0,60,5,87
2017,El Salvador,SLV,Spain,ESP,0,0,58,5,63
2017,Serbia and Kosovo: S/RES/1244 (1999),SRB,Spain,ESP,0,0,10,0,10
2017,Senegal,SEN,Spain,ESP,0,0,14,5,19
2017,Sierra Leone,SLE,Spain,ESP,0,0,5,0,5
2017,Somalia,SOM,Spain,ESP,0,37,18,0,55
2017,Sudan,SDN,Spain,ESP,0,5,0,0,5
2017,Syrian Arab Rep.,SYR,Spain,ESP,19,3529,102,243,3893
2017,Tajikistan,TJK,Spain,ESP,5,0,0,0,5
2017,Togo,TGO,Spain,ESP,0,0,5,0,5
2017,Tunisia,TUN,Spain,ESP,0,0,11,5,16
2017,Turkey,TUR,Spain,ESP,10,0,13,0,23
2017,Uganda,UGA,Spain,ESP,0,0,5,0,5
2017,Ukraine,UKR,Spain,ESP,27,273,3017,82,3399
2017,United States of America,USA,Spain,ESP,0,0,5,0,5
2017,Venezuela (Bolivarian Republic of),VEN,Spain,ESP,16,0,1502,5,1523
2017,Western Sahara,ESH,Spain,ESP,0,0,5,0,5
2017,Yemen,YEM,Spain,ESP,13,0,0,5,18
2017,Tibetan,TIB,Spain,ESP,5,0,0,0,5
2017,Eritrea,ERI,Sudan,SDN,11,0,0,0,11
2017,Ethiopia,ETH,Sudan,SDN,5,0,0,314,319
2017,Syrian Arab Rep.,SYR,Sudan,SDN,0,0,0,47,47
2017,Congo,COG,Eswatini,SWZ,5,0,0,0,5
2017,Dem. Rep. of the Congo,COD,Eswatini,SWZ,18,0,0,0,18
2017,Rwanda,RWA,Eswatini,SWZ,12,0,0,0,12
2017,Somalia,SOM,Eswatini,SWZ,17,0,0,0,17
2017,Afghanistan,AFG,Sweden,SWE,4476,4110,15560,659,24805
2017,Albania,ALB,Sweden,SWE,5,0,459,278,742
2017,Algeria,DZA,Sweden,SWE,5,0,37,106,148
2017,Angola,AGO,Sweden,SWE,0,0,0,15,15
2017,Egypt,EGY,Sweden,SWE,16,0,129,82,227
2017,Armenia,ARM,Sweden,SWE,0,0,113,43,156
2017,Azerbaijan,AZE,Sweden,SWE,16,0,77,74,167
2017,Burundi,BDI,Sweden,SWE,22,0,16,5,43
2017,Bangladesh,BGD,Sweden,SWE,19,0,108,23,150
2017,Burkina Faso,BFA,Sweden,SWE,0,0,0,5,5
2017,Belarus,BLR,Sweden,SWE,5,0,38,85,128
2017,Bolivia (Plurinational State of),BOL,Sweden,SWE,0,0,5,0,5
2017,Brazil,BRA,Sweden,SWE,0,0,13,0,13
2017,Bosnia and Herzegovina,BIH,Sweden,SWE,0,0,94,46,140
2017,Bulgaria,BGR,Sweden,SWE,0,0,5,5,10
2017,Canada,CAN,Sweden,SWE,0,0,5,0,5
2017,Chad,TCD,Sweden,SWE,0,0,0,5,5
2017,China,CHN,Sweden,SWE,5,0,19,14,38
2017,Chile,CHL,Sweden,SWE,0,0,20,5,25
2017,Cameroon,CMR,Sweden,SWE,5,0,24,19,48
2017,Congo,COG,Sweden,SWE,0,0,13,10,23
2017,Dem. Rep. of the Congo,COD,Sweden,SWE,13,0,12,11,36
2017,Colombia,COL,Sweden,SWE,0,0,137,19,156
2017,Cuba,CUB,Sweden,SWE,0,0,11,23,34
2017,Denmark,DNK,Sweden,SWE,0,0,0,5,5
2017,Djibouti,DJI,Sweden,SWE,0,0,13,10,23
2017,Dominican Rep.,DOM,Sweden,SWE,0,0,0,5,5
2017,Equatorial Guinea,GNQ,Sweden,SWE,0,0,0,5,5
2017,Eritrea,ERI,Sweden,SWE,1200,331,76,106,1713
2017,Ethiopia,ETH,Sweden,SWE,420,15,488,66,989
2017,Gambia,GMB,Sweden,SWE,5,0,55,74,134
2017,Palestinian,PSE,Sweden,SWE,88,5,176,71,340
2017,Georgia,GEO,Sweden,SWE,0,0,509,355,864
2017,Ghana,GHA,Sweden,SWE,0,0,15,16,31
2017,Guinea-Bissau,GNB,Sweden,SWE,0,0,0,5,5
2017,Greece,GRC,Sweden,SWE,0,0,5,5,10
2017,Guinea,GIN,Sweden,SWE,5,0,5,20,30
2017,Honduras,HND,Sweden,SWE,0,0,12,0,12
2017,Cote d'Ivoire,CIV,Sweden,SWE,0,0,5,11,16
2017,India,IND,Sweden,SWE,0,0,37,27,64
2017,Iran (Islamic Rep. of),IRN,Sweden,SWE,1039,22,954,252,2267
2017,Iraq,IRQ,Sweden,SWE,1909,1389,5264,990,9552
2017,Israel,ISR,Sweden,SWE,0,0,14,0,14
2017,Jordan,JOR,Sweden,SWE,10,0,111,67,188
2017,Kazakhstan,KAZ,Sweden,SWE,0,0,87,126,213
2017,Kenya,KEN,Sweden,SWE,0,0,10,13,23
2017,Kyrgyzstan,KGZ,Sweden,SWE,5,0,48,87,140
2017,Kuwait,KWT,Sweden,SWE,5,0,25,5,35
2017,Liberia,LBR,Sweden,SWE,0,0,0,5,5
2017,Libya,LBY,Sweden,SWE,5,5,26,76,112
2017,Lebanon,LBN,Sweden,SWE,5,5,228,63,301
2017,Sri Lanka,LKA,Sweden,SWE,0,0,15,10,25
2017,Mauritania,MRT,Sweden,SWE,0,0,0,5,5
2017,North Macedonia,MKD,Sweden,SWE,0,0,109,90,199
2017,Rep. of Moldova,MDA,Sweden,SWE,0,0,14,5,19
2017,Mexico,MEX,Sweden,SWE,0,0,10,0,10
2017,Mali,MLI,Sweden,SWE,0,0,5,5,10
2017,Mongolia,MNG,Sweden,SWE,0,5,245,59,309
2017,Morocco,MAR,Sweden,SWE,24,0,158,283,465
2017,Montenegro,MNE,Sweden,SWE,0,0,20,5,25
2017,Myanmar,MMR,Sweden,SWE,5,0,0,0,5
2017,Nepal,NPL,Sweden,SWE,0,0,20,0,20
2017,Netherlands,NLD,Sweden,SWE,0,0,5,0,5
2017,Niger,NER,Sweden,SWE,0,0,0,5,5
2017,Nicaragua,NIC,Sweden,SWE,0,0,51,5,56
2017,Nigeria,NGA,Sweden,SWE,28,0,105,138,271
2017,Pakistan,PAK,Sweden,SWE,64,0,202,73,339
2017,Paraguay,PRY,Sweden,SWE,0,0,5,0,5
2017,Peru,PER,Sweden,SWE,0,0,35,10,45
2017,Philippines,PHL,Sweden,SWE,0,0,10,5,15
2017,Portugal,PRT,Sweden,SWE,0,0,0,5,5
2017,South Africa,ZAF,Sweden,SWE,0,0,5,0,5
2017,Russian Federation,RUS,Sweden,SWE,23,10,141,133,307
2017,Rwanda,RWA,Sweden,SWE,5,0,5,5,15
2017,El Salvador,SLV,Sweden,SWE,0,0,169,18,187
2017,Saudi Arabia,SAU,Sweden,SWE,0,0,5,13,18
2017,Serbia and Kosovo: S/RES/1244 (1999),SRB,Sweden,SWE,0,0,367,137,504
2017,Senegal,SEN,Sweden,SWE,0,0,10,14,24
2017,Sierra Leone,SLE,Sweden,SWE,5,0,0,13,18
2017,Somalia,SOM,Sweden,SWE,771,125,858,245,1999
2017,Spain,ESP,Sweden,SWE,0,0,0,5,5
2017,Viet Nam,VNM,Sweden,SWE,0,0,13,5,18
2017,Sudan,SDN,Sweden,SWE,134,0,76,30,240
2017,South Sudan,SSD,Sweden,SWE,5,0,0,0,5
2017,Syrian Arab Rep.,SYR,Sweden,SWE,932,5573,143,539,7187
2017,United Rep. of Tanzania,TZA,Sweden,SWE,5,0,5,18,28
2017,Thailand,THA,Sweden,SWE,0,0,10,5,15
2017,Tajikistan,TJK,Sweden,SWE,5,0,17,20,42
2017,Togo,TGO,Sweden,SWE,0,0,0,5,5
2017,Tunisia,TUN,Sweden,SWE,0,0,42,43,85
2017,Turkey,TUR,Sweden,SWE,5,0,151,160,316
2017,Uganda,UGA,Sweden,SWE,30,0,16,20,66
2017,Ukraine,UKR,Sweden,SWE,5,5,401,211,622
2017,United States of America,USA,Sweden,SWE,0,0,5,15,20
2017,Uzbekistan,UZB,Sweden,SWE,30,10,125,71,236
2017,Venezuela (Bolivarian Republic of),VEN,Sweden,SWE,0,0,64,5,69
2017,Yemen,YEM,Sweden,SWE,52,119,5,52,228
2017,Zambia,ZMB,Sweden,SWE,0,0,0,5,5
2017,Zimbabwe,ZWE,Sweden,SWE,0,0,0,5,5
2017,Stateless,XXA,Sweden,SWE,1281,205,617,200,2303
2017,Afghanistan,AFG,Switzerland,CHE,402,2568,274,380,3624
2017,Albania,ALB,Switzerland,CHE,5,5,95,42,147
2017,Algeria,DZA,Switzerland,CHE,12,5,100,456,573
2017,Angola,AGO,Switzerland,CHE,0,29,5,50,84
2017,Egypt,EGY,Switzerland,CHE,12,0,12,42,66
2017,Armenia,ARM,Switzerland,CHE,0,13,32,22,67
2017,Azerbaijan,AZE,Switzerland,CHE,5,0,11,17,33
2017,Bahrain,BHR,Switzerland,CHE,0,0,0,5,5
2017,Burundi,BDI,Switzerland,CHE,18,5,0,0,23
2017,Benin,BEN,Switzerland,CHE,0,0,0,15,15
2017,Bangladesh,BGD,Switzerland,CHE,5,0,35,12,52
2017,Burkina Faso,BFA,Switzerland,CHE,0,5,0,32,37
2017,Belarus,BLR,Switzerland,CHE,0,0,15,58,73
2017,Brazil,BRA,Switzerland,CHE,0,0,5,0,5
2017,Bosnia and Herzegovina,BIH,Switzerland,CHE,0,5,23,28,56
2017,Bulgaria,BGR,Switzerland,CHE,0,0,5,0,5
2017,Central African Rep.,CAF,Switzerland,CHE,0,0,0,15,15
2017,Chad,TCD,Switzerland,CHE,0,0,5,12,17
2017,China,CHN,Switzerland,CHE,60,181,127,21,389
2017,Cameroon,CMR,Switzerland,CHE,5,5,13,210,233
2017,Congo,COG,Switzerland,CHE,0,5,0,5,10
2017,Dem. Rep. of the Congo,COD,Switzerland,CHE,15,50,30,76,171
2017,Colombia,COL,Switzerland,CHE,13,0,5,5,23
2017,Cuba,CUB,Switzerland,CHE,0,0,0,5,5
2017,Czechia,CZE,Switzerland,CHE,0,0,10,0,10
2017,Denmark,DNK,Switzerland,CHE,0,0,5,0,5
2017,Djibouti,DJI,Switzerland,CHE,0,0,5,0,5
2017,Eritrea,ERI,Switzerland,CHE,3464,1860,1093,539,6956
2017,Ethiopia,ETH,Switzerland,CHE,112,162,181,191,646
2017,France,FRA,Switzerland,CHE,0,0,5,5,10
2017,Gabon,GAB,Switzerland,CHE,0,0,0,5,5
2017,Gambia,GMB,Switzerland,CHE,0,5,22,379,406
2017,Georgia,GEO,Switzerland,CHE,0,31,164,411,606
2017,Germany,DEU,Switzerland,CHE,0,0,0,5,5
2017,Ghana,GHA,Switzerland,CHE,0,0,5,55,60
2017,Guinea-Bissau,GNB,Switzerland,CHE,0,5,5,57,67
2017,Guinea,GIN,Switzerland,CHE,5,30,112,786,933
2017,Hungary,HUN,Switzerland,CHE,0,0,0,5,5
2017,Cote d'Ivoire,CIV,Switzerland,CHE,0,5,10,348,363
2017,India,IND,Switzerland,CHE,0,0,15,28,43
2017,Iran (Islamic Rep. of),IRN,Switzerland,CHE,83,48,126,112,369
2017,Iraq,IRQ,Switzerland,CHE,220,543,191,448,1402
2017,Italy,ITA,Switzerland,CHE,0,0,5,5,10
2017,Japan,JPN,Switzerland,CHE,0,0,0,5,5
2017,Kazakhstan,KAZ,Switzerland,CHE,0,0,12,5,17
2017,Kenya,KEN,Switzerland,CHE,0,0,0,5,5
2017,Kyrgyzstan,KGZ,Switzerland,CHE,0,0,10,0,10
2017,Rep. of Korea,KOR,Switzerland,CHE,0,0,5,0,5
2017,Liberia,LBR,Switzerland,CHE,0,0,5,30,35
2017,Libya,LBY,Switzerland,CHE,20,5,22,141,188
2017,Lebanon,LBN,Switzerland,CHE,5,0,5,13,23
2017,Sri Lanka,LKA,Switzerland,CHE,320,88,393,252,1053
2017,Mauritania,MRT,Switzerland,CHE,0,0,5,15,20
2017,North Macedonia,MKD,Switzerland,CHE,0,10,56,41,107
2017,Rep. of Moldova,MDA,Switzerland,CHE,0,0,11,5,16
2017,Mali,MLI,Switzerland,CHE,0,5,5,116,126
2017,Mongolia,MNG,Switzerland,CHE,0,5,17,16,38
2017,Morocco,MAR,Switzerland,CHE,0,12,69,419,500
2017,Montenegro,MNE,Switzerland,CHE,0,0,12,5,17
2017,Myanmar,MMR,Switzerland,CHE,5,0,0,0,5
2017,Nepal,NPL,Switzerland,CHE,0,0,5,0,5
2017,Niger,NER,Switzerland,CHE,0,0,0,21,21
2017,Nigeria,NGA,Switzerland,CHE,0,16,47,674,737
2017,Pakistan,PAK,Switzerland,CHE,16,19,50,88,173
2017,Poland,POL,Switzerland,CHE,0,0,5,0,5
2017,Romania,ROU,Switzerland,CHE,0,0,0,11,11
2017,South Africa,ZAF,Switzerland,CHE,0,0,5,0,5
2017,Russian Federation,RUS,Switzerland,CHE,33,13,32,116,194
2017,Rwanda,RWA,Switzerland,CHE,5,0,0,0,5
2017,El Salvador,SLV,Switzerland,CHE,0,5,10,0,15
2017,Saudi Arabia,SAU,Switzerland,CHE,0,5,0,0,5
2017,Serbia and Kosovo: S/RES/1244 (1999),SRB,Switzerland,CHE,0,72,122,167,361
2017,Senegal,SEN,Switzerland,CHE,0,0,12,115,127
2017,Sierra Leone,SLE,Switzerland,CHE,0,5,0,133,138
2017,Somalia,SOM,Switzerland,CHE,146,480,87,510,1223
2017,Spain,ESP,Switzerland,CHE,0,0,5,0,5
2017,Viet Nam,VNM,Switzerland,CHE,0,0,5,0,5
2017,Sudan,SDN,Switzerland,CHE,26,30,38,75,169
2017,South Sudan,SSD,Switzerland,CHE,5,0,0,10,15
2017,Syrian Arab Rep.,SYR,Switzerland,CHE,1070,1296,89,278,2733
2017,United Rep. of Tanzania,TZA,Switzerland,CHE,0,5,0,0,5
2017,Tajikistan,TJK,Switzerland,CHE,10,0,0,0,10
2017,Togo,TGO,Switzerland,CHE,22,0,13,40,75
2017,Tunisia,TUN,Switzerland,CHE,0,5,50,140,195
2017,Turkey,TUR,Switzerland,CHE,165,33,177,201,576
2017,Uganda,UGA,Switzerland,CHE,5,0,5,5,15
2017,Ukraine,UKR,Switzerland,CHE,0,5,44,58,107
2017,United States of America,USA,Switzerland,CHE,0,0,0,5,5
2017,Uzbekistan,UZB,Switzerland,CHE,0,0,0,5,5
2017,Venezuela (Bolivarian Republic of),VEN,Switzerland,CHE,0,0,5,5,10
2017,Western Sahara,ESH,Switzerland,CHE,0,0,0,11,11
2017,Yemen,YEM,Switzerland,CHE,5,10,10,22,47
2017,Zimbabwe,ZWE,Switzerland,CHE,0,0,0,5,5
2017,Stateless,XXA,Switzerland,CHE,5,5,0,14,24
2017,Burundi,BDI,United Rep. of Tanzania,TZA,26,0,0,0,26
2017,Dem. Rep. of the Congo,COD,United Rep. of Tanzania,TZA,687,0,145,0,832
2017,Myanmar,MMR,Thailand,THA,676,0,5,0,681
2017,Afghanistan,AFG,Ukraine,UKR,5,23,26,57,111
2017,Algeria,DZA,Ukraine,UKR,0,0,0,5,5
2017,Egypt,EGY,Ukraine,UKR,5,0,0,0,5
2017,Armenia,ARM,Ukraine,UKR,0,0,0,5,5
2017,Azerbaijan,AZE,Ukraine,UKR,0,0,0,5,5
2017,Bangladesh,BGD,Ukraine,UKR,0,0,10,60,70
2017,Belarus,BLR,Ukraine,UKR,0,0,12,0,12
2017,China,CHN,Ukraine,UKR,0,0,0,5,5
2017,Cameroon,CMR,Ukraine,UKR,0,0,0,17,17
2017,Congo,COG,Ukraine,UKR,0,0,0,5,5
2017,Dem. Rep. of the Congo,COD,Ukraine,UKR,0,0,5,5,10
2017,Eritrea,ERI,Ukraine,UKR,0,0,0,5,5
2017,Guinea,GIN,Ukraine,UKR,0,5,0,5,10
2017,India,IND,Ukraine,UKR,0,0,0,12,12
2017,Iran (Islamic Rep. of),IRN,Ukraine,UKR,0,0,5,10,15
2017,Iraq,IRQ,Ukraine,UKR,0,5,16,25,46
2017,Israel,ISR,Ukraine,UKR,0,0,0,5,5
2017,Kazakhstan,KAZ,Ukraine,UKR,0,0,0,5,5
2017,Kyrgyzstan,KGZ,Ukraine,UKR,0,0,0,14,14
2017,Sri Lanka,LKA,Ukraine,UKR,0,0,0,5,5
2017,Lithuania,LTU,Ukraine,UKR,0,0,0,5,5
2017,Nigeria,NGA,Ukraine,UKR,0,0,0,5,5
2017,Pakistan,PAK,Ukraine,UKR,0,0,0,12,12
2017,Russian Federation,RUS,Ukraine,UKR,10,5,37,51,103
2017,Senegal,SEN,Ukraine,UKR,0,0,0,5,5
2017,Somalia,SOM,Ukraine,UKR,0,0,12,5,17
2017,Viet Nam,VNM,Ukraine,UKR,0,0,0,5,5
2017,Sudan,SDN,Ukraine,UKR,0,0,0,10,10
2017,Syrian Arab Rep.,SYR,Ukraine,UKR,0,27,50,20,97
2017,Tajikistan,TJK,Ukraine,UKR,0,0,12,5,17
2017,Turkey,TUR,Ukraine,UKR,0,0,5,5,10
2017,Uzbekistan,UZB,Ukraine,UKR,0,0,19,22,41
2017,Yemen,YEM,Ukraine,UKR,0,0,5,0,5
2017,Zimbabwe,ZWE,Ukraine,UKR,0,0,0,5,5
2017,Stateless,XXA,Ukraine,UKR,0,0,5,14,19
2017,Colombia,COL,Uruguay,URY,10,0,0,0,10
2017,Cuba,CUB,Uruguay,URY,0,0,19,596,615
2017,Nigeria,NGA,Uruguay,URY,0,0,5,0,5
2017,Paraguay,PRY,Uruguay,URY,5,0,0,0,5
2017,Syrian Arab Rep.,SYR,Uruguay,URY,0,0,0,5,5
2017,Turkey,TUR,Uruguay,URY,5,0,0,0,5
2017,United States of America,USA,Uruguay,URY,0,0,0,5,5
2017,Venezuela (Bolivarian Republic of),VEN,Uruguay,URY,0,0,0,5,5
2017,Burundi,BDI,Zambia,ZMB,228,0,17,258,503
2017,Dem. Rep. of the Congo,COD,Zambia,ZMB,15232,0,155,663,16050
2017,Eritrea,ERI,Zambia,ZMB,5,0,0,0,5
2017,Palestinian,PSE,Zambia,ZMB,0,0,0,5,5
2017,Cote d'Ivoire,CIV,Zambia,ZMB,0,0,0,5,5
2017,Nigeria,NGA,Zambia,ZMB,0,0,0,5,5
2017,Rwanda,RWA,Zambia,ZMB,5,0,0,0,5
2017,Somalia,SOM,Zambia,ZMB,98,0,10,130,238
2017,Syrian Arab Rep.,SYR,Zambia,ZMB,5,0,0,0,5
2017,Turkey,TUR,Zambia,ZMB,12,0,0,0,12
2017,Burundi,BDI,Zimbabwe,ZWE,5,0,106,10,121
2017,Central African Rep.,CAF,Zimbabwe,ZWE,0,0,0,5,5
2017,Dem. Rep. of the Congo,COD,Zimbabwe,ZWE,644,0,90,154,888
2017,Eritrea,ERI,Zimbabwe,ZWE,0,0,0,5,5
2017,Cote d'Ivoire,CIV,Zimbabwe,ZWE,0,0,0,5,5
2017,Mali,MLI,Zimbabwe,ZWE,0,0,5,60,65
2017,Rwanda,RWA,Zimbabwe,ZWE,0,0,36,0,36
2017,Somalia,SOM,Zimbabwe,ZWE,0,0,0,10,10
2017,Sudan,SDN,Zimbabwe,ZWE,11,0,5,11,27
2017,Uganda,UGA,Zimbabwe,ZWE,0,0,0,5,5
2018,Afghanistan,AFG,Albania,ALB,0,0,0,36,36
2018,Algeria,DZA,Albania,ALB,0,0,0,212,212
2018,Egypt,EGY,Albania,ALB,0,0,0,23,23
2018,Eritrea,ERI,Albania,ALB,0,0,0,14,14
2018,Palestinian,PSE,Albania,ALB,0,10,0,271,281
2018,India,IND,Albania,ALB,0,0,0,5,5
2018,Iran (Islamic Rep. of),IRN,Albania,ALB,0,0,0,44,44
2018,Iraq,IRQ,Albania,ALB,0,0,0,428,428
2018,Kuwait,KWT,Albania,ALB,0,0,0,5,5
2018,Libya,LBY,Albania,ALB,0,0,0,126,126
2018,Morocco,MAR,Albania,ALB,0,0,0,199,199
2018,Myanmar,MMR,Albania,ALB,0,0,0,10,10
2018,Pakistan,PAK,Albania,ALB,0,0,0,644,644
2018,Somalia,SOM,Albania,ALB,0,0,0,5,5
2018,Syrian Arab Rep.,SYR,Albania,ALB,0,5,0,2108,2113
2018,Tunisia,TUN,Albania,ALB,0,0,0,15,15
2018,Turkey,TUR,Albania,ALB,0,0,0,22,22
2018,Western Sahara,ESH,Albania,ALB,0,0,0,5,5
2018,Yemen,YEM,Albania,ALB,0,0,0,54,54
2018,Armenia,ARM,Argentina,ARG,0,0,10,34,44
2018,Bangladesh,BGD,Argentina,ARG,0,0,5,0,5
2018,China,CHN,Argentina,ARG,0,0,21,5,26
2018,Chile,CHL,Argentina,ARG,0,0,0,5,5
2018,Dem. Rep. of the Congo,COD,Argentina,ARG,0,0,18,0,18
2018,Colombia,COL,Argentina,ARG,5,0,5,28,38
2018,Cuba,CUB,Argentina,ARG,0,0,47,33,80
2018,Dominican Rep.,DOM,Argentina,ARG,0,0,16,24,40
2018,Palestinian,PSE,Argentina,ARG,5,0,0,0,5
2018,Ghana,GHA,Argentina,ARG,0,0,5,0,5
2018,Haiti,HTI,Argentina,ARG,0,0,56,71,127
2018,India,IND,Argentina,ARG,0,0,0,13,13
2018,Jamaica,JAM,Argentina,ARG,5,0,0,5,10
2018,Morocco,MAR,Argentina,ARG,0,0,0,5,5
2018,Nigeria,NGA,Argentina,ARG,0,0,0,5,5
2018,Pakistan,PAK,Argentina,ARG,0,0,0,5,5
2018,Peru,PER,Argentina,ARG,0,0,0,5,5
2018,Russian Federation,RUS,Argentina,ARG,5,0,5,5,15
2018,Senegal,SEN,Argentina,ARG,0,0,236,5,241
2018,Syrian Arab Rep.,SYR,Argentina,ARG,15,0,5,5,25
2018,Ukraine,UKR,Argentina,ARG,13,0,0,35,48
2018,Venezuela (Bolivarian Republic of),VEN,Argentina,ARG,14,0,0,37,51
2018,Stateless,XXA,Argentina,ARG,5,0,0,0,5
2018,Afghanistan,AFG,Armenia,ARM,0,0,5,5,10
2018,Azerbaijan,AZE,Armenia,ARM,0,0,0,5,5
2018,Bangladesh,BGD,Armenia,ARM,0,0,5,5,10
2018,Iran (Islamic Rep. of),IRN,Armenia,ARM,0,0,13,17,30
2018,Iraq,IRQ,Armenia,ARM,25,0,0,21,46
2018,Syrian Arab Rep.,SYR,Armenia,ARM,20,0,0,5,25
2018,Turkey,TUR,Armenia,ARM,0,0,5,0,5
2018,Ukraine,UKR,Armenia,ARM,0,0,0,5,5
2018,Uzbekistan,UZB,Armenia,ARM,0,0,5,0,5
2018,Yemen,YEM,Armenia,ARM,17,0,0,5,22
2018,Afghanistan,AFG,Australia,AUS,1009,0,295,0,1304
2018,Egypt,EGY,Australia,AUS,36,0,106,0,142
2018,Bangladesh,BGD,Australia,AUS,5,0,219,0,224
2018,Cambodia,KHM,Australia,AUS,0,0,18,0,18
2018,China,CHN,Australia,AUS,107,0,3080,720,3907
2018,Cameroon,CMR,Australia,AUS,0,0,5,0,5
2018,Ethiopia,ETH,Australia,AUS,53,0,65,10,128
2018,Fiji,FJI,Australia,AUS,0,0,235,24,259
2018,Palestinian,PSE,Australia,AUS,94,0,0,0,94
2018,United Kingdom of Great Britain and Northern Ireland,GBR,Australia,AUS,0,0,39,0,39
2018,Ghana,GHA,Australia,AUS,0,0,83,0,83
2018,India,IND,Australia,AUS,22,0,401,237,660
2018,Indonesia,IDN,Australia,AUS,55,0,543,44,642
2018,Iran (Islamic Rep. of),IRN,Australia,AUS,2581,0,1350,25,3956
2018,Iraq,IRQ,Australia,AUS,942,0,421,70,1433
2018,Jordan,JOR,Australia,AUS,10,0,0,0,10
2018,Japan,JPN,Australia,AUS,0,0,0,5,5
2018,Rep. of Korea,KOR,Australia,AUS,0,0,61,0,61
2018,Liberia,LBR,Australia,AUS,10,0,0,0,10
2018,Libya,LBY,Australia,AUS,60,0,0,5,65
2018,Lebanon,LBN,Australia,AUS,18,0,193,20,231
2018,Sri Lanka,LKA,Australia,AUS,562,0,1801,14,2377
2018,Malaysia,MYS,Australia,AUS,113,0,9310,1038,10461
2018,Mongolia,MNG,Australia,AUS,0,0,14,0,14
2018,Mauritius,MUS,Australia,AUS,0,0,0,5,5
2018,Myanmar,MMR,Australia,AUS,89,0,5,0,94
2018,Nepal,NPL,Australia,AUS,0,0,80,15,95
2018,Nigeria,NGA,Australia,AUS,17,0,23,13,53
2018,Pakistan,PAK,Australia,AUS,676,0,536,39,1251
2018,Philippines,PHL,Australia,AUS,0,0,13,5,18
2018,Papua New Guinea,PNG,Australia,AUS,30,0,5,0,35
2018,Rwanda,RWA,Australia,AUS,12,0,0,0,12
2018,Saudi Arabia,SAU,Australia,AUS,0,0,5,0,5
2018,Sierra Leone,SLE,Australia,AUS,0,0,94,0,94
2018,Somalia,SOM,Australia,AUS,341,0,0,5,346
2018,Viet Nam,VNM,Australia,AUS,53,0,1532,131,1716
2018,Sudan,SDN,Australia,AUS,245,0,0,0,245
2018,Eswatini,SWZ,Australia,AUS,0,0,0,5,5
2018,Syrian Arab Rep.,SYR,Australia,AUS,111,0,5,0,116
2018,Thailand,THA,Australia,AUS,0,0,403,97,500
2018,Turkey,TUR,Australia,AUS,153,0,52,5,210
2018,Stateless,XXA,Australia,AUS,1699,0,216,5,1920
2018,Afghanistan,AFG,Azerbaijan,AZE,10,0,267,5,282
2018,Egypt,EGY,Azerbaijan,AZE,0,0,5,0,5
2018,Bangladesh,BGD,Azerbaijan,AZE,0,0,5,0,5
2018,India,IND,Azerbaijan,AZE,0,0,10,0,10
2018,Iran (Islamic Rep. of),IRN,Azerbaijan,AZE,0,0,12,10,22
2018,Iraq,IRQ,Azerbaijan,AZE,0,0,16,0,16
2018,Libya,LBY,Azerbaijan,AZE,5,0,0,0,5
2018,Sri Lanka,LKA,Azerbaijan,AZE,0,0,5,0,5
2018,Nepal,NPL,Azerbaijan,AZE,0,0,5,0,5
2018,Pakistan,PAK,Azerbaijan,AZE,0,0,165,22,187
2018,Russian Federation,RUS,Azerbaijan,AZE,0,0,5,0,5
2018,Syrian Arab Rep.,SYR,Azerbaijan,AZE,0,0,28,0,28
2018,Turkey,TUR,Azerbaijan,AZE,0,0,16,0,16
2018,Uzbekistan,UZB,Azerbaijan,AZE,0,0,5,0,5
2018,Central African Rep.,CAF,Burundi,BDI,5,0,0,0,5
2018,Dem. Rep. of the Congo,COD,Burundi,BDI,10507,0,0,1177,11684
2018,Rwanda,RWA,Burundi,BDI,46,0,0,142,188
2018,United Rep. of Tanzania,TZA,Burundi,BDI,5,0,0,0,5
2018,Uganda,UGA,Burundi,BDI,5,0,0,0,5
2018,Afghanistan,AFG,Belgium,BEL,820,1080,1850,0,3750
2018,Albania,ALB,Belgium,BEL,50,0,575,0,625
2018,Algeria,DZA,Belgium,BEL,10,0,80,0,90
2018,Angola,AGO,Belgium,BEL,5,0,55,0,60
2018,Egypt,EGY,Belgium,BEL,10,0,55,0,65
2018,Armenia,ARM,Belgium,BEL,25,0,125,0,150
2018,Azerbaijan,AZE,Belgium,BEL,20,5,30,0,55
2018,Burundi,BDI,Belgium,BEL,330,0,35,0,365
2018,Benin,BEN,Belgium,BEL,5,0,25,0,30
2018,Bangladesh,BGD,Belgium,BEL,0,0,50,0,50
2018,Bhutan,BTN,Belgium,BEL,0,0,5,0,5
2018,Burkina Faso,BFA,Belgium,BEL,10,0,30,0,40
2018,Belarus,BLR,Belgium,BEL,5,0,15,0,20
2018,Brazil,BRA,Belgium,BEL,5,0,10,0,15
2018,Bosnia and Herzegovina,BIH,Belgium,BEL,5,0,20,0,25
2018,Central African Rep.,CAF,Belgium,BEL,5,0,5,0,10
2018,China,CHN,Belgium,BEL,95,0,95,0,190
2018,Chile,CHL,Belgium,BEL,0,0,5,0,5
2018,Cameroon,CMR,Belgium,BEL,65,0,190,0,255
2018,Congo,COG,Belgium,BEL,5,0,10,0,15
2018,Dem. Rep. of the Congo,COD,Belgium,BEL,155,10,445,0,610
2018,Colombia,COL,Belgium,BEL,25,5,40,0,70
2018,Cuba,CUB,Belgium,BEL,5,0,5,0,10
2018,Djibouti,DJI,Belgium,BEL,35,0,45,0,80
2018,Equatorial Guinea,GNQ,Belgium,BEL,0,0,5,0,5
2018,Eritrea,ERI,Belgium,BEL,520,0,45,0,565
2018,Ethiopia,ETH,Belgium,BEL,20,0,40,0,60
2018,Gabon,GAB,Belgium,BEL,0,0,10,0,10
2018,Gambia,GMB,Belgium,BEL,5,0,25,0,30
2018,Georgia,GEO,Belgium,BEL,20,0,145,0,165
2018,Ghana,GHA,Belgium,BEL,0,0,35,0,35
2018,Guinea-Bissau,GNB,Belgium,BEL,0,0,5,0,5
2018,Guatemala,GTM,Belgium,BEL,25,0,0,0,25
2018,Guinea,GIN,Belgium,BEL,260,5,415,0,680
2018,Honduras,HND,Belgium,BEL,20,0,0,0,20
2018,Hungary,HUN,Belgium,BEL,0,0,5,0,5
2018,Cote d'Ivoire,CIV,Belgium,BEL,25,0,65,0,90
2018,India,IND,Belgium,BEL,0,0,65,0,65
2018,Iran (Islamic Rep. of),IRN,Belgium,BEL,265,0,80,0,345
2018,Iraq,IRQ,Belgium,BEL,375,90,1005,0,1470
2018,Israel,ISR,Belgium,BEL,0,0,5,0,5
2018,Jordan,JOR,Belgium,BEL,0,0,20,0,20
2018,Kazakhstan,KAZ,Belgium,BEL,15,0,10,0,25
2018,Kenya,KEN,Belgium,BEL,0,0,5,0,5
2018,Kyrgyzstan,KGZ,Belgium,BEL,20,0,10,0,30
2018,Liberia,LBR,Belgium,BEL,0,0,10,0,10
2018,Libya,LBY,Belgium,BEL,5,20,5,0,30
2018,Lebanon,LBN,Belgium,BEL,10,0,85,0,95
2018,Sri Lanka,LKA,Belgium,BEL,15,0,115,0,130
2018,Mauritania,MRT,Belgium,BEL,25,0,65,0,90
2018,North Macedonia,MKD,Belgium,BEL,15,0,155,0,170
2018,Mali,MLI,Belgium,BEL,5,0,20,0,25
2018,Mongolia,MNG,Belgium,BEL,0,0,10,0,10
2018,Morocco,MAR,Belgium,BEL,20,0,170,0,190
2018,Montenegro,MNE,Belgium,BEL,5,0,5,0,10
2018,Nepal,NPL,Belgium,BEL,0,0,10,0,10
2018,Niger,NER,Belgium,BEL,10,0,30,0,40
2018,Nigeria,NGA,Belgium,BEL,5,0,65,0,70
2018,Peru,PER,Belgium,BEL,0,0,5,0,5
2018,Spain,ESP,Belgium,BEL,0,0,5,0,5
2018,Central African Rep.,CAF,Benin,BEN,112,0,0,0,112
2018,Chad,TCD,Benin,BEN,5,0,0,0,5
2018,Dem. Rep. of the Congo,COD,Benin,BEN,5,0,0,0,5
2018,Cote d'Ivoire,CIV,Benin,BEN,0,0,12,0,12
2018,Mali,MLI,Benin,BEN,15,0,0,0,15
2018,Syrian Arab Rep.,SYR,Benin,BEN,5,0,0,0,5
2018,Turkey,TUR,Benin,BEN,5,0,0,0,5
2018,Yemen,YEM,Benin,BEN,10,0,0,0,10
2018,Central African Rep.,CAF,Burkina Faso,BFA,29,0,0,5,34
2018,Chad,TCD,Burkina Faso,BFA,5,0,0,0,5
2018,Turkey,TUR,Burkina Faso,BFA,5,0,0,0,5
2018,Afghanistan,AFG,Belarus,BLR,0,0,0,5,5
2018,Bangladesh,BGD,Belarus,BLR,0,0,5,5,10
2018,Bulgaria,BGR,Belarus,BLR,0,0,0,5,5
2018,India,IND,Belarus,BLR,0,0,5,0,5
2018,Iran (Islamic Rep. of),IRN,Belarus,BLR,0,0,5,0,5
2018,Iraq,IRQ,Belarus,BLR,0,0,5,13,18
2018,Russian Federation,RUS,Belarus,BLR,0,0,5,5,10
2018,Syrian Arab Rep.,SYR,Belarus,BLR,0,14,0,0,14
2018,Turkey,TUR,Belarus,BLR,5,0,0,5,10
2018,Ukraine,UKR,Belarus,BLR,0,836,17,30,883
2018,Uzbekistan,UZB,Belarus,BLR,0,0,0,5,5
2018,Yemen,YEM,Belarus,BLR,0,5,0,0,5
2018,Burundi,BDI,Botswana,BWA,5,0,0,0,5
2018,Dem. Rep. of the Congo,COD,Botswana,BWA,65,0,5,10,80
2018,Somalia,SOM,Botswana,BWA,0,0,5,0,5
2018,Zimbabwe,ZWE,Botswana,BWA,0,0,0,5,5
2018,Afghanistan,AFG,Brazil,BRA,22,0,5,0,27
2018,Angola,AGO,Brazil,BRA,21,0,277,357,655
2018,Egypt,EGY,Brazil,BRA,10,0,0,13,23
2018,Argentina,ARG,Brazil,BRA,0,0,0,5,5
2018,Burundi,BDI,Brazil,BRA,5,0,0,0,5
2018,Benin,BEN,Brazil,BRA,0,0,16,10,26
2018,Bangladesh,BGD,Brazil,BRA,0,0,201,31,232
2018,Burkina Faso,BFA,Brazil,BRA,0,0,10,0,10
2018,Bolivia (Plurinational State of),BOL,Brazil,BRA,0,0,0,5,5
2018,China,CHN,Brazil,BRA,5,0,5,314,324
2018,Cameroon,CMR,Brazil,BRA,5,0,5,12,22
2018,Dem. Rep. of the Congo,COD,Brazil,BRA,184,0,60,30,274
2018,Colombia,COL,Brazil,BRA,10,0,0,46,56
2018,Cuba,CUB,Brazil,BRA,47,0,55,308,410
2018,Cabo Verde,CPV,Brazil,BRA,0,0,5,12,17
2018,Dominican Rep.,DOM,Brazil,BRA,0,0,107,17,124
2018,Ethiopia,ETH,Brazil,BRA,5,0,0,0,5
2018,Gambia,GMB,Brazil,BRA,0,0,37,5,42
2018,Palestinian,PSE,Brazil,BRA,57,0,0,5,62
2018,Ghana,GHA,Brazil,BRA,0,0,74,89,163
2018,Guinea-Bissau,GNB,Brazil,BRA,0,0,254,33,287
2018,Guinea,GIN,Brazil,BRA,10,0,27,21,58
2018,Guyana,GUY,Brazil,BRA,5,0,0,0,5
2018,Haiti,HTI,Brazil,BRA,0,0,1375,1198,2573
2018,Cote d'Ivoire,CIV,Brazil,BRA,0,0,14,0,14
2018,India,IND,Brazil,BRA,5,0,10,12,27
2018,Iran (Islamic Rep. of),IRN,Brazil,BRA,5,0,0,5,10
2018,Iraq,IRQ,Brazil,BRA,15,0,5,5,25
2018,Israel,ISR,Brazil,BRA,0,0,0,5,5
2018,Jordan,JOR,Brazil,BRA,0,0,5,5,10
2018,Rep. of Korea,KOR,Brazil,BRA,0,0,0,12,12
2018,Libya,LBY,Brazil,BRA,0,0,0,5,5
2018,Lebanon,LBN,Brazil,BRA,5,0,54,63,122
2018,Mauritania,MRT,Brazil,BRA,0,0,5,5,10
2018,Mali,MLI,Brazil,BRA,5,0,19,5,29
2018,Morocco,MAR,Brazil,BRA,5,0,13,23,41
2018,Mozambique,MOZ,Brazil,BRA,0,0,5,0,5
2018,Nepal,NPL,Brazil,BRA,5,0,0,5,10
2018,Nigeria,NGA,Brazil,BRA,14,0,128,88,230
2018,Pakistan,PAK,Brazil,BRA,56,0,98,40,194
2018,Paraguay,PRY,Brazil,BRA,0,0,0,5,5
2018,Peru,PER,Brazil,BRA,0,0,0,14,14
2018,Philippines,PHL,Brazil,BRA,0,0,5,5,10
2018,Portugal,PRT,Brazil,BRA,0,0,5,5,10
2018,South Africa,ZAF,Brazil,BRA,0,0,5,5,10
2018,Russian Federation,RUS,Brazil,BRA,0,0,0,5,5
2018,El Salvador,SLV,Brazil,BRA,0,0,0,5,5
2018,Senegal,SEN,Brazil,BRA,0,0,2830,196,3026
2018,Sierra Leone,SLE,Brazil,BRA,5,0,68,10,83
2018,Somalia,SOM,Brazil,BRA,0,0,13,0,13
2018,Spain,ESP,Brazil,BRA,0,0,0,5,5
2018,Sudan,SDN,Brazil,BRA,5,0,0,0,5
2018,Syrian Arab Rep.,SYR,Brazil,BRA,556,0,0,105,661
2018,United Rep. of Tanzania,TZA,Brazil,BRA,0,0,5,0,5
2018,Togo,TGO,Brazil,BRA,5,0,20,23,48
2018,Tunisia,TUN,Brazil,BRA,0,0,5,0,5
2018,Turkey,TUR,Brazil,BRA,0,0,0,19,19
2018,Uganda,UGA,Brazil,BRA,0,0,0,5,5
2018,Ukraine,UKR,Brazil,BRA,5,0,0,0,5
2018,Uruguay,URY,Brazil,BRA,0,0,5,0,5
2018,Venezuela (Bolivarian Republic of),VEN,Brazil,BRA,5,0,0,2930,2935
2018,Yemen,YEM,Brazil,BRA,0,0,0,5,5
2018,Afghanistan,AFG,Bosnia and Herzegovina,BIH,0,0,0,97,97
2018,Algeria,DZA,Bosnia and Herzegovina,BIH,0,0,10,77,87
2018,Egypt,EGY,Bosnia and Herzegovina,BIH,0,0,0,5,5
2018,Azerbaijan,AZE,Bosnia and Herzegovina,BIH,0,0,0,5,5
2018,Palestinian,PSE,Bosnia and Herzegovina,BIH,0,0,0,32,32
2018,India,IND,Bosnia and Herzegovina,BIH,0,0,0,5,5
2018,Iran (Islamic Rep. of),IRN,Bosnia and Herzegovina,BIH,0,0,0,52,52
2018,Iraq,IRQ,Bosnia and Herzegovina,BIH,0,0,0,53,53
2018,Libya,LBY,Bosnia and Herzegovina,BIH,0,0,0,49,49
2018,Morocco,MAR,Bosnia and Herzegovina,BIH,0,0,5,32,37
2018,Nepal,NPL,Bosnia and Herzegovina,BIH,0,0,0,10,10
2018,Pakistan,PAK,Bosnia and Herzegovina,BIH,0,0,5,183,188
2018,Russian Federation,RUS,Bosnia and Herzegovina,BIH,0,0,14,5,19
2018,Syrian Arab Rep.,SYR,Bosnia and Herzegovina,BIH,0,5,0,129,134
2018,Tunisia,TUN,Bosnia and Herzegovina,BIH,0,0,0,5,5
2018,Turkey,TUR,Bosnia and Herzegovina,BIH,0,5,5,5,15
2018,Yemen,YEM,Bosnia and Herzegovina,BIH,0,0,0,5,5
2018,Stateless,XXA,Bosnia and Herzegovina,BIH,0,0,0,5,5
2018,Honduras,HND,Belize,BLZ,5,0,11,10,26
2018,El Salvador,SLV,Belize,BLZ,24,0,59,67,150
2018,Afghanistan,AFG,Canada,CAN,469,0,80,41,590
2018,Albania,ALB,Canada,CAN,68,0,61,14,143
2018,Algeria,DZA,Canada,CAN,69,0,22,11,102
2018,Angola,AGO,Canada,CAN,43,0,29,13,85
2018,Antigua and Barbuda,ATG,Canada,CAN,5,0,16,0,21
2018,Egypt,EGY,Canada,CAN,443,0,45,35,523
2018,Argentina,ARG,Canada,CAN,0,0,12,0,12
2018,Armenia,ARM,Canada,CAN,5,0,0,0,5
2018,Australia,AUS,Canada,CAN,0,0,0,5,5
2018,Austria,AUT,Canada,CAN,0,0,12,0,12
2018,Azerbaijan,AZE,Canada,CAN,132,0,80,14,226
2018,Bahrain,BHR,Canada,CAN,13,0,0,0,13
2018,Barbados,BRB,Canada,CAN,34,0,5,5,44
2018,Burundi,BDI,Canada,CAN,383,0,10,23,416
2018,Belgium,BEL,Canada,CAN,5,0,0,0,5
2018,Benin,BEN,Canada,CAN,11,0,5,0,16
2018,Bangladesh,BGD,Canada,CAN,152,0,90,73,315
2018,Bahamas,BHS,Canada,CAN,37,0,38,20,95
2018,Burkina Faso,BFA,Canada,CAN,5,0,0,5,10
2018,Belarus,BLR,Canada,CAN,13,0,0,5,18
2018,Bolivia (Plurinational State of),BOL,Canada,CAN,5,0,5,0,10
2018,Botswana,BWA,Canada,CAN,15,0,0,5,20
2018,Brazil,BRA,Canada,CAN,17,0,78,26,121
2018,Bosnia and Herzegovina,BIH,Canada,CAN,0,0,10,0,10
2018,Bulgaria,BGR,Canada,CAN,12,0,0,10,22
2018,Belize,BLZ,Canada,CAN,5,0,0,0,5
2018,Cambodia,KHM,Canada,CAN,5,0,0,5,10
2018,Central African Rep.,CAF,Canada,CAN,5,0,0,0,5
2018,Chad,TCD,Canada,CAN,69,0,25,10,104
2018,China,CHN,Canada,CAN,607,0,743,213,1563
2018,Chile,CHL,Canada,CAN,13,0,43,5,61
2018,Cameroon,CMR,Canada,CAN,105,0,46,10,161
2018,Congo,COG,Canada,CAN,29,0,10,5,44
2018,Dem. Rep. of the Congo,COD,Canada,CAN,169,0,95,30,294
2018,Colombia,COL,Canada,CAN,528,0,315,115,958
2018,Cuba,CUB,Canada,CAN,23,0,17,11,51
2018,Cyprus,CYP,Canada,CAN,11,0,0,0,11
2018,Czechia,CZE,Canada,CAN,77,0,5,77,159
2018,Denmark,DNK,Canada,CAN,0,0,5,0,5
2018,Djibouti,DJI,Canada,CAN,272,0,50,12,334
2018,Dominica,DMA,Canada,CAN,5,0,0,0,5
2018,Dominican Rep.,DOM,Canada,CAN,5,0,11,0,16
2018,Ecuador,ECU,Canada,CAN,5,0,15,0,20
2018,Equatorial Guinea,GNQ,Canada,CAN,5,0,0,0,5
2018,Eritrea,ERI,Canada,CAN,632,0,47,53,732
2018,Ethiopia,ETH,Canada,CAN,324,0,109,42,475
2018,Fiji,FJI,Canada,CAN,5,0,0,0,5
2018,Finland,FIN,Canada,CAN,0,0,5,0,5
2018,France,FRA,Canada,CAN,0,0,5,13,18
2018,Gambia,GMB,Canada,CAN,12,0,11,10,33
2018,Palestinian,PSE,Canada,CAN,345,0,90,16,451
2018,United Kingdom of Great Britain and Northern Ireland,GBR,Canada,CAN,0,0,5,0,5
2018,Georgia,GEO,Canada,CAN,84,0,55,35,174
2018,Germany,DEU,Canada,CAN,0,0,0,13,13
2018,Ghana,GHA,Canada,CAN,57,0,82,14,153
2018,Greece,GRC,Canada,CAN,0,0,5,17,22
2018,Grenada,GRD,Canada,CAN,0,0,11,0,11
2018,Guatemala,GTM,Canada,CAN,63,0,34,31,128
2018,Guinea,GIN,Canada,CAN,38,0,10,5,53
2018,Guyana,GUY,Canada,CAN,13,0,34,5,52
2018,Haiti,HTI,Canada,CAN,555,0,1349,133,2037
2018,"China, Hong Kong SAR",HKG,Canada,CAN,0,0,5,13,18
2018,Honduras,HND,Canada,CAN,90,0,56,23,169
2018,Croatia,HRV,Canada,CAN,78,0,63,32,173
2018,Hungary,HUN,Canada,CAN,634,0,262,267,1163
2018,Cote d'Ivoire,CIV,Canada,CAN,19,0,13,5,37
2018,India,IND,Canada,CAN,264,0,234,323,821
2018,Indonesia,IDN,Canada,CAN,15,0,10,0,25
2018,Ireland,IRL,Canada,CAN,0,0,5,0,5
2018,Iran (Islamic Rep. of),IRN,Canada,CAN,429,0,96,58,583
2018,Iraq,IRQ,Canada,CAN,369,0,125,43,537
2018,Israel,ISR,Canada,CAN,37,0,22,10,69
2018,Italy,ITA,Canada,CAN,0,0,30,5,35
2018,Jamaica,JAM,Canada,CAN,66,0,49,59,174
2018,Jordan,JOR,Canada,CAN,110,0,68,32,210
2018,Japan,JPN,Canada,CAN,0,0,0,5,5
2018,Kazakhstan,KAZ,Canada,CAN,52,0,12,0,64
2018,Kenya,KEN,Canada,CAN,51,0,44,5,100
2018,Kyrgyzstan,KGZ,Canada,CAN,10,0,5,0,15
2018,Rep. of Korea,KOR,Canada,CAN,5,0,13,5,23
2018,Dem. People's Rep. of Korea,PRK,Canada,CAN,0,0,5,39,44
2018,Liberia,LBR,Canada,CAN,11,0,0,0,11
2018,Libya,LBY,Canada,CAN,226,0,12,5,243
2018,Saint Lucia,LCA,Canada,CAN,53,0,35,31,119
2018,Lebanon,LBN,Canada,CAN,111,0,122,19,252
2018,Sri Lanka,LKA,Canada,CAN,407,0,72,59,538
2018,Lithuania,LTU,Canada,CAN,0,0,13,0,13
2018,Luxembourg,LUX,Canada,CAN,0,0,5,0,5
2018,Latvia,LVA,Canada,CAN,5,0,0,0,5
2018,Madagascar,MDG,Canada,CAN,5,0,0,0,5
2018,Mauritania,MRT,Canada,CAN,19,0,5,5,29
2018,North Macedonia,MKD,Canada,CAN,10,0,0,0,10
2018,Rep. of Moldova,MDA,Canada,CAN,12,0,0,5,17
2018,Mexico,MEX,Canada,CAN,209,0,369,312,890
2018,Mali,MLI,Canada,CAN,21,0,14,5,40
2018,Malaysia,MYS,Canada,CAN,0,0,0,5,5
2018,Malawi,MWI,Canada,CAN,5,0,0,0,5
2018,Mongolia,MNG,Canada,CAN,20,0,5,5,30
2018,Morocco,MAR,Canada,CAN,15,0,5,10,30
2018,Malta,MLT,Canada,CAN,5,0,0,0,5
2018,Mauritius,MUS,Canada,CAN,5,0,0,0,5
2018,Myanmar,MMR,Canada,CAN,5,0,0,0,5
2018,Namibia,NAM,Canada,CAN,17,0,10,10,37
2018,Nepal,NPL,Canada,CAN,102,0,38,5,145
2018,Netherlands,NLD,Canada,CAN,0,0,5,0,5
2018,Niger,NER,Canada,CAN,0,0,12,0,12
2018,Nicaragua,NIC,Canada,CAN,0,0,5,11,16
2018,Nigeria,NGA,Canada,CAN,826,0,1791,206,2823
2018,Pakistan,PAK,Canada,CAN,782,0,311,99,1192
2018,Panama,PAN,Canada,CAN,11,0,0,0,11
2018,Peru,PER,Canada,CAN,14,0,17,5,36
2018,Philippines,PHL,Canada,CAN,10,0,41,0,51
2018,Poland,POL,Canada,CAN,13,0,29,24,66
2018,Portugal,PRT,Canada,CAN,0,0,10,0,10
2018,Romania,ROU,Canada,CAN,39,0,23,496,558
2018,South Africa,ZAF,Canada,CAN,10,0,42,0,52
2018,Russian Federation,RUS,Canada,CAN,86,0,16,13,115
2018,Rwanda,RWA,Canada,CAN,68,0,15,5,88
2018,El Salvador,SLV,Canada,CAN,298,0,103,34,435
2018,Saudi Arabia,SAU,Canada,CAN,101,0,5,10,116
2018,Serbia and Kosovo: S/RES/1244 (1999),SRB,Canada,CAN,35,0,26,26,87
2018,Senegal,SEN,Canada,CAN,15,0,5,10,30
2018,Singapore,SGP,Canada,CAN,0,0,5,0,5
2018,Sierra Leone,SLE,Canada,CAN,11,0,5,5,21
2018,Somalia,SOM,Canada,CAN,338,0,208,126,672
2018,Spain,ESP,Canada,CAN,0,0,10,5,15
2018,Viet Nam,VNM,Canada,CAN,10,0,10,0,20
2018,Sudan,SDN,Canada,CAN,383,0,95,45,523
2018,Slovakia,SVK,Canada,CAN,312,0,40,100,452
2018,Slovenia,SVN,Canada,CAN,5,0,0,0,5
2018,Eswatini,SWZ,Canada,CAN,13,0,0,0,13
2018,Syrian Arab Rep.,SYR,Canada,CAN,474,0,20,86,580
2018,United Rep. of Tanzania,TZA,Canada,CAN,18,0,38,5,61
2018,Thailand,THA,Canada,CAN,5,0,0,0,5
2018,Tajikistan,TJK,Canada,CAN,14,0,0,0,14
2018,Turkmenistan,TKM,Canada,CAN,5,0,0,0,5
2018,Togo,TGO,Canada,CAN,13,0,5,0,18
2018,Trinidad and Tobago,TTO,Canada,CAN,0,0,5,11,16
2018,Tunisia,TUN,Canada,CAN,13,0,5,0,18
2018,Turkey,TUR,Canada,CAN,1439,0,128,67,1634
2018,United Arab Emirates,ARE,Canada,CAN,5,0,0,0,5
2018,Uganda,UGA,Canada,CAN,79,0,28,5,112
2018,Ukraine,UKR,Canada,CAN,246,0,45,16,307
2018,United States of America,USA,Canada,CAN,19,0,685,166,870
2018,Uzbekistan,UZB,Canada,CAN,23,0,21,5,49
2018,Saint Vincent and the Grenadines,VCT,Canada,CAN,25,0,31,28,84
2018,Venezuela (Bolivarian Republic of),VEN,Canada,CAN,529,0,128,27,684
2018,Yemen,YEM,Canada,CAN,453,0,22,5,480
2018,Zambia,ZMB,Canada,CAN,5,0,0,0,5
2018,Zimbabwe,ZWE,Canada,CAN,59,0,29,11,99
2018,Stateless,XXA,Canada,CAN,106,0,35,10,151
2018,Cuba,CUB,Cayman Islands,CYM,5,0,10,0,15
2018,Colombia,COL,Chile,CHL,103,0,80,670,853
2018,Cuba,CUB,Chile,CHL,0,0,190,934,1124
2018,Dominican Rep.,DOM,Chile,CHL,0,0,5,32,37
2018,Ecuador,ECU,Chile,CHL,0,0,0,5,5
2018,Palestinian,PSE,Chile,CHL,5,0,0,0,5
2018,Haiti,HTI,Chile,CHL,0,0,0,5,5
2018,Honduras,HND,Chile,CHL,5,0,0,0,5
2018,Peru,PER,Chile,CHL,0,0,0,5,5
2018,Russian Federation,RUS,Chile,CHL,5,0,0,0,5
2018,Syrian Arab Rep.,SYR,Chile,CHL,20,0,0,5,25
2018,Turkey,TUR,Chile,CHL,25,0,0,0,25
2018,Venezuela (Bolivarian Republic of),VEN,Chile,CHL,10,0,0,140,150
2018,Burundi,BDI,Dem. Rep. of the Congo,COD,26,0,5,0,31
2018,Central African Rep.,CAF,Dem. Rep. of the Congo,COD,24,0,34,0,58
2018,Congo,COG,Dem. Rep. of the Congo,COD,0,0,13,0,13
2018,Cote d'Ivoire,CIV,Dem. Rep. of the Congo,COD,0,0,11,0,11
2018,Rwanda,RWA,Dem. Rep. of the Congo,COD,14,0,0,0,14
2018,Somalia,SOM,Dem. Rep. of the Congo,COD,0,0,5,0,5
2018,Sudan,SDN,Dem. Rep. of the Congo,COD,5,0,0,0,5
2018,South Sudan,SSD,Dem. Rep. of the Congo,COD,5,0,5,0,10
2018,Dem. Rep. of the Congo,COD,Colombia,COL,0,0,0,5,5
2018,Cuba,CUB,Colombia,COL,5,0,0,0,5
2018,Pakistan,PAK,Colombia,COL,0,0,0,5,5
2018,Turkey,TUR,Colombia,COL,0,0,0,5,5
2018,Venezuela (Bolivarian Republic of),VEN,Colombia,COL,32,0,5,288,325
2018,Congo,COG,Costa Rica,CRI,0,0,5,0,5
2018,Colombia,COL,Costa Rica,CRI,11,0,58,248,317
2018,Cuba,CUB,Costa Rica,CRI,5,0,32,15,52
2018,Ghana,GHA,Costa Rica,CRI,0,0,5,19,24
2018,Guatemala,GTM,Costa Rica,CRI,0,0,13,5,18
2018,Guinea,GIN,Costa Rica,CRI,0,0,0,5,5
2018,Haiti,HTI,Costa Rica,CRI,0,0,10,18,28
2018,Honduras,HND,Costa Rica,CRI,12,0,17,64,93
2018,Mexico,MEX,Costa Rica,CRI,0,0,0,10,10
2018,Nicaragua,NIC,Costa Rica,CRI,5,0,211,292,508
2018,Nigeria,NGA,Costa Rica,CRI,0,0,0,5,5
2018,Panama,PAN,Costa Rica,CRI,0,0,5,0,5
2018,Peru,PER,Costa Rica,CRI,0,0,0,5,5
2018,Romania,ROU,Costa Rica,CRI,0,0,5,0,5
2018,El Salvador,SLV,Costa Rica,CRI,111,0,401,293,805
2018,United States of America,USA,Costa Rica,CRI,0,0,0,5,5
2018,Venezuela (Bolivarian Republic of),VEN,Costa Rica,CRI,24,0,514,406,944
2018,Afghanistan,AFG,Cyprus,CYP,5,0,0,0,5
2018,Egypt,EGY,Cyprus,CYP,12,0,95,70,177
2018,Bangladesh,BGD,Cyprus,CYP,0,0,207,25,232
2018,Cameroon,CMR,Cyprus,CYP,26,0,28,0,54
2018,Congo,COG,Cyprus,CYP,0,0,0,14,14
2018,Dem. Rep. of the Congo,COD,Cyprus,CYP,5,0,0,0,5
2018,Ethiopia,ETH,Cyprus,CYP,0,0,5,11,16
2018,Gambia,GMB,Cyprus,CYP,5,0,14,0,19
2018,Palestinian,PSE,Cyprus,CYP,23,10,0,0,33
2018,Georgia,GEO,Cyprus,CYP,0,0,5,13,18
2018,Guinea,GIN,Cyprus,CYP,0,0,0,5,5
2018,Cote d'Ivoire,CIV,Cyprus,CYP,0,0,5,0,5
2018,India,IND,Cyprus,CYP,0,0,265,48,313
2018,Iran (Islamic Rep. of),IRN,Cyprus,CYP,22,5,17,17,61
2018,Iraq,IRQ,Cyprus,CYP,12,17,46,64,139
2018,Jordan,JOR,Cyprus,CYP,0,0,5,5,10
2018,Lebanon,LBN,Cyprus,CYP,0,5,0,5,10
2018,Sri Lanka,LKA,Cyprus,CYP,0,0,110,33,143
2018,Morocco,MAR,Cyprus,CYP,0,0,0,5,5
2018,Nepal,NPL,Cyprus,CYP,0,0,64,39,103
2018,Nigeria,NGA,Cyprus,CYP,0,0,0,13,13
2018,Pakistan,PAK,Cyprus,CYP,0,0,137,65,202
2018,Philippines,PHL,Cyprus,CYP,0,0,5,21,26
2018,Russian Federation,RUS,Cyprus,CYP,5,0,0,0,5
2018,Somalia,SOM,Cyprus,CYP,14,22,0,0,36
2018,Viet Nam,VNM,Cyprus,CYP,0,0,196,31,227
2018,Sudan,SDN,Cyprus,CYP,0,5,0,0,5
2018,Syrian Arab Rep.,SYR,Cyprus,CYP,45,937,0,0,982
2018,Tunisia,TUN,Cyprus,CYP,5,0,0,0,5
2018,Turkey,TUR,Cyprus,CYP,18,0,12,5,35
2018,Ukraine,UKR,Cyprus,CYP,0,0,0,19,19
2018,Uzbekistan,UZB,Cyprus,CYP,0,0,0,5,5
2018,Yemen,YEM,Cyprus,CYP,0,11,0,0,11
2018,Zimbabwe,ZWE,Cyprus,CYP,0,0,5,0,5
2018,Afghanistan,AFG,Czechia,CZE,0,0,0,18,18
2018,Albania,ALB,Czechia,CZE,0,0,0,5,5
2018,Algeria,DZA,Czechia,CZE,0,0,10,5,15
2018,Egypt,EGY,Czechia,CZE,5,0,0,0,5
2018,Armenia,ARM,Czechia,CZE,0,0,46,77,123
2018,Azerbaijan,AZE,Czechia,CZE,0,0,56,36,92
2018,Belarus,BLR,Czechia,CZE,0,0,0,11,11
2018,China,CHN,Czechia,CZE,10,0,70,5,85
2018,Cameroon,CMR,Czechia,CZE,0,0,5,0,5
2018,Dem. Rep. of the Congo,COD,Czechia,CZE,0,0,5,5,10
2018,Cuba,CUB,Czechia,CZE,0,0,32,149,181
2018,Ethiopia,ETH,Czechia,CZE,0,0,0,5,5
2018,Palestinian,PSE,Czechia,CZE,0,0,0,5,5
2018,Georgia,GEO,Czechia,CZE,0,0,48,115,163
2018,Ghana,GHA,Czechia,CZE,0,0,5,0,5
2018,India,IND,Czechia,CZE,0,0,0,5,5
2018,Iran (Islamic Rep. of),IRN,Czechia,CZE,0,0,0,16,16
2018,Iraq,IRQ,Czechia,CZE,0,33,13,34,80
2018,Kazakhstan,KAZ,Czechia,CZE,0,5,12,5,22
2018,Kyrgyzstan,KGZ,Czechia,CZE,0,0,0,5,5
2018,Libya,LBY,Czechia,CZE,0,0,0,5,5
2018,Sri Lanka,LKA,Czechia,CZE,0,5,0,0,5
2018,Rep. of Moldova,MDA,Czechia,CZE,0,0,16,5,21
2018,Mongolia,MNG,Czechia,CZE,0,0,12,10,22
2018,Morocco,MAR,Czechia,CZE,0,0,0,5,5
2018,Myanmar,MMR,Czechia,CZE,5,0,0,0,5
2018,Nigeria,NGA,Czechia,CZE,0,0,5,13,18
2018,Pakistan,PAK,Czechia,CZE,0,0,0,5,5
2018,Russian Federation,RUS,Czechia,CZE,5,0,26,39,70
2018,Serbia and Kosovo: S/RES/1244 (1999),SRB,Czechia,CZE,0,0,12,0,12
2018,Viet Nam,VNM,Czechia,CZE,0,0,73,30,103
2018,Slovakia,SVK,Czechia,CZE,0,0,0,5,5
2018,Syrian Arab Rep.,SYR,Czechia,CZE,5,51,0,10,66
2018,Tunisia,TUN,Czechia,CZE,0,0,10,0,10
2018,Turkey,TUR,Czechia,CZE,0,0,24,19,43
2018,Ukraine,UKR,Czechia,CZE,5,13,222,137,377
2018,Uzbekistan,UZB,Czechia,CZE,0,0,38,20,58
2018,Stateless,XXA,Czechia,CZE,0,13,0,5,18
2018,Afghanistan,AFG,Denmark,DNK,5,20,131,0,156
2018,Albania,ALB,Denmark,DNK,0,0,40,0,40
2018,Algeria,DZA,Denmark,DNK,0,0,10,0,10
2018,Armenia,ARM,Denmark,DNK,0,0,13,0,13
2018,Azerbaijan,AZE,Denmark,DNK,0,0,17,0,17
2018,Burundi,BDI,Denmark,DNK,0,0,5,0,5
2018,Bangladesh,BGD,Denmark,DNK,0,0,5,0,5
2018,Belarus,BLR,Denmark,DNK,0,0,18,0,18
2018,Bosnia and Herzegovina,BIH,Denmark,DNK,0,0,5,0,5
2018,China,CHN,Denmark,DNK,0,0,5,0,5
2018,Cameroon,CMR,Denmark,DNK,0,0,5,0,5
2018,Colombia,COL,Denmark,DNK,0,0,19,0,19
2018,Eritrea,ERI,Denmark,DNK,585,20,5,0,610
2018,Ethiopia,ETH,Denmark,DNK,0,0,5,0,5
2018,Georgia,GEO,Denmark,DNK,0,0,190,0,190
2018,Ghana,GHA,Denmark,DNK,0,0,5,0,5
2018,Guinea,GIN,Denmark,DNK,0,0,5,0,5
2018,India,IND,Denmark,DNK,0,0,5,0,5
2018,Indonesia,IDN,Denmark,DNK,0,0,5,0,5
2018,Iran (Islamic Rep. of),IRN,Denmark,DNK,61,5,65,0,131
2018,Iraq,IRQ,Denmark,DNK,0,0,49,0,49
2018,Kenya,KEN,Denmark,DNK,0,0,5,0,5
2018,Lebanon,LBN,Denmark,DNK,0,0,5,0,5
2018,Sri Lanka,LKA,Denmark,DNK,0,0,19,0,19
2018,Lithuania,LTU,Denmark,DNK,0,0,5,0,5
2018,North Macedonia,MKD,Denmark,DNK,0,0,11,0,11
2018,Morocco,MAR,Denmark,DNK,0,0,42,0,42
2018,Myanmar,MMR,Denmark,DNK,0,0,5,0,5
2018,Nepal,NPL,Denmark,DNK,0,0,5,0,5
2018,Nigeria,NGA,Denmark,DNK,0,0,17,0,17
2018,Pakistan,PAK,Denmark,DNK,0,0,12,0,12
2018,Poland,POL,Denmark,DNK,0,0,5,0,5
2018,Russian Federation,RUS,Denmark,DNK,0,0,34,0,34
2018,Rwanda,RWA,Denmark,DNK,5,0,0,0,5
2018,El Salvador,SLV,Denmark,DNK,0,0,10,0,10
2018,Serbia and Kosovo: S/RES/1244 (1999),SRB,Denmark,DNK,0,0,19,0,19
2018,Senegal,SEN,Denmark,DNK,0,0,5,0,5
2018,Somalia,SOM,Denmark,DNK,0,5,52,0,57
2018,Syrian Arab Rep.,SYR,Denmark,DNK,152,378,5,0,535
2018,Tunisia,TUN,Denmark,DNK,0,0,5,0,5
2018,Turkey,TUR,Denmark,DNK,5,0,11,0,16
2018,Uganda,UGA,Denmark,DNK,0,0,10,0,10
2018,Ukraine,UKR,Denmark,DNK,0,0,25,0,25
2018,United States of America,USA,Denmark,DNK,0,0,5,0,5
2018,Venezuela (Bolivarian Republic of),VEN,Denmark,DNK,0,0,13,0,13
2018,Yemen,YEM,Denmark,DNK,0,0,5,0,5
2018,Zambia,ZMB,Denmark,DNK,0,0,5,0,5
2018,Stateless,XXA,Denmark,DNK,10,28,27,0,65
2018,Albania,ALB,Estonia,EST,0,0,5,0,5
2018,Egypt,EGY,Estonia,EST,0,0,5,0,5
2018,Armenia,ARM,Estonia,EST,0,0,5,0,5
2018,Azerbaijan,AZE,Estonia,EST,5,0,0,0,5
2018,Bangladesh,BGD,Estonia,EST,0,0,5,0,5
2018,Belarus,BLR,Estonia,EST,0,0,5,0,5
2018,India,IND,Estonia,EST,0,0,5,0,5
2018,Iran (Islamic Rep. of),IRN,Estonia,EST,0,0,5,0,5
2018,Iraq,IRQ,Estonia,EST,5,0,0,0,5
2018,Morocco,MAR,Estonia,EST,0,0,5,0,5
2018,Pakistan,PAK,Estonia,EST,0,0,5,0,5
2018,Russian Federation,RUS,Estonia,EST,0,0,14,0,14
2018,Syrian Arab Rep.,SYR,Estonia,EST,5,0,0,0,5
2018,Ukraine,UKR,Estonia,EST,0,0,5,0,5
2018,Venezuela (Bolivarian Republic of),VEN,Estonia,EST,0,0,0,5,5
2018,Afghanistan,AFG,Finland,FIN,256,136,363,29,784
2018,Albania,ALB,Finland,FIN,0,0,30,5,35
2018,Algeria,DZA,Finland,FIN,0,0,5,15,20
2018,Angola,AGO,Finland,FIN,0,0,0,39,39
2018,Egypt,EGY,Finland,FIN,0,0,5,5,10
2018,Armenia,ARM,Finland,FIN,0,0,0,5,5
2018,Azerbaijan,AZE,Finland,FIN,0,0,0,10,10
2018,Bangladesh,BGD,Finland,FIN,0,0,17,0,17
2018,Belarus,BLR,Finland,FIN,0,0,5,26,31
2018,China,CHN,Finland,FIN,37,0,30,5,72
2018,Cameroon,CMR,Finland,FIN,5,0,18,10,33
2018,Dem. Rep. of the Congo,COD,Finland,FIN,5,0,10,5,20
2018,Cuba,CUB,Finland,FIN,0,0,5,5,10
2018,Eritrea,ERI,Finland,FIN,276,0,0,5,281
2018,Ethiopia,ETH,Finland,FIN,13,0,12,5,30
2018,Gambia,GMB,Finland,FIN,0,0,10,18,28
2018,Georgia,GEO,Finland,FIN,0,0,40,52,92
2018,Ghana,GHA,Finland,FIN,0,0,5,5,10
2018,Honduras,HND,Finland,FIN,5,0,0,0,5
2018,Cote d'Ivoire,CIV,Finland,FIN,0,0,0,5,5
2018,India,IND,Finland,FIN,0,0,12,5,17
2018,Indonesia,IDN,Finland,FIN,0,0,10,0,10
2018,Iran (Islamic Rep. of),IRN,Finland,FIN,28,5,40,55,128
2018,Iraq,IRQ,Finland,FIN,676,165,615,88,1544
2018,Kazakhstan,KAZ,Finland,FIN,0,0,0,5,5
2018,Libya,LBY,Finland,FIN,0,0,0,13,13
2018,Lebanon,LBN,Finland,FIN,0,0,0,5,5
2018,Sri Lanka,LKA,Finland,FIN,0,0,18,5,23
2018,North Macedonia,MKD,Finland,FIN,0,0,0,5,5
2018,Morocco,MAR,Finland,FIN,0,0,5,30,35
2018,Nigeria,NGA,Finland,FIN,5,0,25,37,67
2018,Pakistan,PAK,Finland,FIN,5,0,22,15,42
2018,Russian Federation,RUS,Finland,FIN,11,0,123,46,180
2018,Rwanda,RWA,Finland,FIN,0,0,5,0,5
2018,El Salvador,SLV,Finland,FIN,0,0,5,0,5
2018,Serbia and Kosovo: S/RES/1244 (1999),SRB,Finland,FIN,0,0,0,11,11
2018,Senegal,SEN,Finland,FIN,0,0,5,5,10
2018,Somalia,SOM,Finland,FIN,164,26,123,34,347
2018,South Sudan,SSD,Finland,FIN,0,0,0,5,5
2018,Syrian Arab Rep.,SYR,Finland,FIN,97,34,0,32,163
2018,Tunisia,TUN,Finland,FIN,0,0,5,5,10
2018,Turkey,TUR,Finland,FIN,51,0,41,13,105
2018,Uganda,UGA,Finland,FIN,5,0,0,0,5
2018,Ukraine,UKR,Finland,FIN,0,0,20,5,25
2018,United States of America,USA,Finland,FIN,0,0,0,5,5
2018,Venezuela (Bolivarian Republic of),VEN,Finland,FIN,0,0,10,0,10
2018,Yemen,YEM,Finland,FIN,12,30,0,15,57
2018,Zambia,ZMB,Finland,FIN,0,0,5,0,5
2018,Zimbabwe,ZWE,Finland,FIN,0,5,0,0,5
2018,Stateless,XXA,Finland,FIN,28,0,10,5,43
2018,Afghanistan,AFG,France,FRA,402,4542,2616,64,7624
2018,Albania,ALB,France,FRA,74,453,5742,67,6336
2018,Algeria,DZA,France,FRA,98,79,2471,72,2720
2018,Angola,AGO,France,FRA,49,33,667,10,759
2018,Egypt,EGY,France,FRA,33,5,436,5,479
2018,Armenia,ARM,France,FRA,39,87,1845,16,1987
2018,Azerbaijan,AZE,France,FRA,25,10,269,5,309
2018,Bahrain,BHR,France,FRA,5,0,0,0,5
2018,Burundi,BDI,France,FRA,242,0,56,5,303
2018,Benin,BEN,France,FRA,5,5,73,5,88
2018,Bangladesh,BGD,France,FRA,146,109,3352,5,3612
2018,Burkina Faso,BFA,France,FRA,21,10,120,0,151
2018,Belarus,BLR,France,FRA,5,0,35,0,40
2018,Bolivia (Plurinational State of),BOL,France,FRA,0,0,5,0,5
2018,Brazil,BRA,France,FRA,5,0,41,0,46
2018,Bosnia and Herzegovina,BIH,France,FRA,19,21,471,22,533
2018,Cambodia,KHM,France,FRA,10,0,39,0,49
2018,Central African Rep.,CAF,France,FRA,185,109,239,16,549
2018,Chad,TCD,France,FRA,134,15,646,5,800
2018,China,CHN,France,FRA,1283,0,1412,10,2705
2018,Chile,CHL,France,FRA,5,0,0,0,5
2018,Cameroon,CMR,France,FRA,122,35,664,5,826
2018,Congo,COG,France,FRA,108,31,942,11,1092
2018,Dem. Rep. of the Congo,COD,France,FRA,511,104,2857,25,3497
2018,Comoros,COM,France,FRA,17,5,205,5,232
2018,Colombia,COL,France,FRA,17,34,142,5,198
2018,Costa Rica,CRI,France,FRA,0,5,0,0,5
2018,Cuba,CUB,France,FRA,20,0,64,5,89
2018,Djibouti,DJI,France,FRA,23,10,60,0,93
2018,Dominican Rep.,DOM,France,FRA,0,5,491,15,511
2018,Eritrea,ERI,France,FRA,1215,0,264,5,1484
2018,Ethiopia,ETH,France,FRA,274,10,458,0,742
2018,Gabon,GAB,France,FRA,46,25,305,10,386
2018,Gambia,GMB,France,FRA,21,10,169,0,200
2018,Palestinian,PSE,France,FRA,104,10,62,5,181
2018,Georgia,GEO,France,FRA,68,104,3579,59,3810
2018,Ghana,GHA,France,FRA,5,0,45,0,50
2018,Guinea-Bissau,GNB,France,FRA,18,5,117,0,140
2018,Guinea,GIN,France,FRA,908,177,3904,34,5023
2018,Guyana,GUY,France,FRA,0,0,14,0,14
2018,Haiti,HTI,France,FRA,59,60,3297,23,3439
2018,Honduras,HND,France,FRA,0,5,19,0,24
2018,Cote d'Ivoire,CIV,France,FRA,741,125,3828,41,4735
2018,India,IND,France,FRA,10,5,126,5,146
2018,Iran (Islamic Rep. of),IRN,France,FRA,98,10,314,10,432
2018,Iraq,IRQ,France,FRA,811,118,374,16,1319
2018,Jamaica,JAM,France,FRA,0,0,5,0,5
2018,Jordan,JOR,France,FRA,0,0,5,0,5
2018,Kazakhstan,KAZ,France,FRA,13,11,161,5,190
2018,Kenya,KEN,France,FRA,10,5,36,0,51
2018,Kyrgyzstan,KGZ,France,FRA,5,0,11,0,16
2018,Kuwait,KWT,France,FRA,44,0,27,0,71
2018,Lao People's Dem. Rep.,LAO,France,FRA,5,0,0,0,5
2018,Liberia,LBR,France,FRA,5,0,40,0,45
2018,Libya,LBY,France,FRA,53,96,275,11,435
2018,Saint Lucia,LCA,France,FRA,0,0,5,0,5
2018,Lebanon,LBN,France,FRA,5,5,33,0,43
2018,Sri Lanka,LKA,France,FRA,180,71,1627,11,1889
2018,Madagascar,MDG,France,FRA,5,5,102,0,112
2018,Mauritania,MRT,France,FRA,86,10,764,10,870
2018,North Macedonia,MKD,France,FRA,10,5,911,56,982
2018,Rep. of Moldova,MDA,France,FRA,0,0,93,10,103
2018,Maldives,MDV,France,FRA,5,0,0,0,5
2018,Mexico,MEX,France,FRA,0,0,14,0,14
2018,Mali,MLI,France,FRA,420,23,1845,38,2326
2018,Malaysia,MYS,France,FRA,0,0,5,0,5
2018,Mongolia,MNG,France,FRA,13,13,156,0,182
2018,Morocco,MAR,France,FRA,87,32,448,11,578
2018,Montenegro,MNE,France,FRA,5,0,102,0,107
2018,Mauritius,MUS,France,FRA,14,0,0,0,14
2018,Myanmar,MMR,France,FRA,5,0,30,0,35
2018,Nepal,NPL,France,FRA,5,5,79,0,89
2018,Niger,NER,France,FRA,16,5,59,0,80
2018,Nicaragua,NIC,France,FRA,5,0,10,0,15
2018,Nigeria,NGA,France,FRA,146,36,2769,24,2975
2018,Pakistan,PAK,France,FRA,47,46,2553,10,2656
2018,Peru,PER,France,FRA,0,17,79,0,96
2018,Philippines,PHL,France,FRA,0,0,5,0,5
2018,South Africa,ZAF,France,FRA,10,5,5,0,20
2018,Russian Federation,RUS,France,FRA,205,56,1462,46,1769
2018,Rwanda,RWA,France,FRA,138,0,134,0,272
2018,El Salvador,SLV,France,FRA,0,17,25,0,42
2018,Serbia and Kosovo: S/RES/1244 (1999),SRB,France,FRA,103,219,3151,78,3551
2018,Senegal,SEN,France,FRA,165,27,1339,26,1557
2018,Sierra Leone,SLE,France,FRA,14,5,140,0,159
2018,Somalia,SOM,France,FRA,183,391,1029,5,1608
2018,Viet Nam,VNM,France,FRA,5,0,37,0,42
2018,Sudan,SDN,France,FRA,2368,410,1672,33,4483
2018,Suriname,SUR,France,FRA,0,0,5,0,5
2018,South Sudan,SSD,France,FRA,10,0,16,0,26
2018,Syrian Arab Rep.,SYR,France,FRA,926,2497,302,38,3763
2018,Togo,TGO,France,FRA,27,5,192,5,229
2018,Tunisia,TUN,France,FRA,33,5,246,19,303
2018,Turkey,TUR,France,FRA,371,11,1385,17,1784
2018,Uganda,UGA,France,FRA,12,0,23,0,35
2018,Ukraine,UKR,France,FRA,41,54,373,15,483
2018,Uzbekistan,UZB,France,FRA,5,0,12,0,17
2018,Venezuela (Bolivarian Republic of),VEN,France,FRA,134,36,182,5,357
2018,Western Sahara,ESH,France,FRA,34,0,657,0,691
2018,Yemen,YEM,France,FRA,49,72,22,0,143
2018,Zimbabwe,ZWE,France,FRA,0,0,10,0,10
2018,Stateless,XXA,France,FRA,71,0,256,15,342
2018,Afghanistan,AFG,United Kingdom of Great Britain and Northern Ireland,GBR,639,142,806,323,1910
2018,Albania,ALB,United Kingdom of Great Britain and Northern Ireland,GBR,28,54,1085,394,1561
2018,Algeria,DZA,United Kingdom of Great Britain and Northern Ireland,GBR,12,13,148,66,239
2018,Angola,AGO,United Kingdom of Great Britain and Northern Ireland,GBR,0,10,45,5,60
2018,Antigua and Barbuda,ATG,United Kingdom of Great Britain and Northern Ireland,GBR,0,0,5,0,5
2018,Egypt,EGY,United Kingdom of Great Britain and Northern Ireland,GBR,33,10,327,87,457
2018,Argentina,ARG,United Kingdom of Great Britain and Northern Ireland,GBR,0,0,5,0,5
2018,Armenia,ARM,United Kingdom of Great Britain and Northern Ireland,GBR,0,0,37,5,42
2018,Australia,AUS,United Kingdom of Great Britain and Northern Ireland,GBR,0,0,5,0,5
2018,Azerbaijan,AZE,United Kingdom of Great Britain and Northern Ireland,GBR,45,5,50,10,110
2018,Bahrain,BHR,United Kingdom of Great Britain and Northern Ireland,GBR,10,0,10,5,25
2018,Barbados,BRB,United Kingdom of Great Britain and Northern Ireland,GBR,12,0,0,0,12
2018,Burundi,BDI,United Kingdom of Great Britain and Northern Ireland,GBR,5,0,18,0,23
2018,Benin,BEN,United Kingdom of Great Britain and Northern Ireland,GBR,5,0,5,0,10
2018,Bangladesh,BGD,United Kingdom of Great Britain and Northern Ireland,GBR,84,29,1316,175,1604
2018,Belarus,BLR,United Kingdom of Great Britain and Northern Ireland,GBR,5,0,14,0,19
2018,Bolivia (Plurinational State of),BOL,United Kingdom of Great Britain and Northern Ireland,GBR,0,0,5,0,5
2018,Botswana,BWA,United Kingdom of Great Britain and Northern Ireland,GBR,5,0,15,0,20
2018,Brazil,BRA,United Kingdom of Great Britain and Northern Ireland,GBR,5,0,28,18,51
2018,Canada,CAN,United Kingdom of Great Britain and Northern Ireland,GBR,0,0,5,5,10
2018,Chad,TCD,United Kingdom of Great Britain and Northern Ireland,GBR,5,0,5,10,20
2018,China,CHN,United Kingdom of Great Britain and Northern Ireland,GBR,19,10,488,562,1079
2018,Chile,CHL,United Kingdom of Great Britain and Northern Ireland,GBR,0,0,5,0,5
2018,Cameroon,CMR,United Kingdom of Great Britain and Northern Ireland,GBR,64,15,171,5,255
2018,Congo,COG,United Kingdom of Great Britain and Northern Ireland,GBR,5,5,16,0,26
2018,Dem. Rep. of the Congo,COD,United Kingdom of Great Britain and Northern Ireland,GBR,48,14,181,10,253
2018,Comoros,COM,United Kingdom of Great Britain and Northern Ireland,GBR,0,0,5,0,5
2018,Colombia,COL,United Kingdom of Great Britain and Northern Ireland,GBR,0,0,16,5,21
2018,Dominica,DMA,United Kingdom of Great Britain and Northern Ireland,GBR,5,0,5,5,15
2018,Dominican Rep.,DOM,United Kingdom of Great Britain and Northern Ireland,GBR,0,0,5,0,5
2018,Ecuador,ECU,United Kingdom of Great Britain and Northern Ireland,GBR,0,0,5,0,5
2018,Eritrea,ERI,United Kingdom of Great Britain and Northern Ireland,GBR,839,5,62,421,1327
2018,Ethiopia,ETH,United Kingdom of Great Britain and Northern Ireland,GBR,170,15,190,153,528
2018,France,FRA,United Kingdom of Great Britain and Northern Ireland,GBR,0,0,5,0,5
2018,Gabon,GAB,United Kingdom of Great Britain and Northern Ireland,GBR,0,0,5,0,5
2018,Gambia,GMB,United Kingdom of Great Britain and Northern Ireland,GBR,25,5,83,12,125
2018,Palestinian,PSE,United Kingdom of Great Britain and Northern Ireland,GBR,52,14,73,72,211
2018,Georgia,GEO,United Kingdom of Great Britain and Northern Ireland,GBR,14,0,41,23,78
2018,Ghana,GHA,United Kingdom of Great Britain and Northern Ireland,GBR,13,12,174,35,234
2018,Grenada,GRD,United Kingdom of Great Britain and Northern Ireland,GBR,0,0,12,0,12
2018,Guatemala,GTM,United Kingdom of Great Britain and Northern Ireland,GBR,0,0,10,0,10
2018,Guinea,GIN,United Kingdom of Great Britain and Northern Ireland,GBR,19,0,18,10,47
2018,Guyana,GUY,United Kingdom of Great Britain and Northern Ireland,GBR,5,0,0,0,5
2018,"China, Hong Kong SAR",HKG,United Kingdom of Great Britain and Northern Ireland,GBR,0,0,0,5,5
2018,Honduras,HND,United Kingdom of Great Britain and Northern Ireland,GBR,5,0,13,12,30
2018,Croatia,HRV,United Kingdom of Great Britain and Northern Ireland,GBR,0,0,5,0,5
2018,Hungary,HUN,United Kingdom of Great Britain and Northern Ireland,GBR,0,0,5,0,5
2018,Cote d'Ivoire,CIV,United Kingdom of Great Britain and Northern Ireland,GBR,5,5,37,0,47
2018,India,IND,United Kingdom of Great Britain and Northern Ireland,GBR,0,34,772,386,1192
2018,Indonesia,IDN,United Kingdom of Great Britain and Northern Ireland,GBR,10,0,13,5,28
2018,Iran (Islamic Rep. of),IRN,United Kingdom of Great Britain and Northern Ireland,GBR,1118,91,1187,421,2817
2018,Iraq,IRQ,United Kingdom of Great Britain and Northern Ireland,GBR,359,241,1650,735,2985
2018,Italy,ITA,United Kingdom of Great Britain and Northern Ireland,GBR,0,0,5,0,5
2018,Jamaica,JAM,United Kingdom of Great Britain and Northern Ireland,GBR,14,10,110,17,151
2018,Jordan,JOR,United Kingdom of Great Britain and Northern Ireland,GBR,5,0,23,5,33
2018,Japan,JPN,United Kingdom of Great Britain and Northern Ireland,GBR,0,0,5,0,5
2018,Kazakhstan,KAZ,United Kingdom of Great Britain and Northern Ireland,GBR,5,0,16,0,21
2018,Kenya,KEN,United Kingdom of Great Britain and Northern Ireland,GBR,5,10,87,5,107
2018,Kyrgyzstan,KGZ,United Kingdom of Great Britain and Northern Ireland,GBR,0,0,14,0,14
2018,Rep. of Korea,KOR,United Kingdom of Great Britain and Northern Ireland,GBR,0,0,5,5,10
2018,Dem. People's Rep. of Korea,PRK,United Kingdom of Great Britain and Northern Ireland,GBR,0,5,11,0,16
2018,Kuwait,KWT,United Kingdom of Great Britain and Northern Ireland,GBR,132,0,31,72,235
2018,Liberia,LBR,United Kingdom of Great Britain and Northern Ireland,GBR,0,0,5,0,5
2018,Libya,LBY,United Kingdom of Great Britain and Northern Ireland,GBR,219,1034,5,44,1302
2018,Saint Lucia,LCA,United Kingdom of Great Britain and Northern Ireland,GBR,0,0,12,5,17
2018,Lebanon,LBN,United Kingdom of Great Britain and Northern Ireland,GBR,22,0,56,16,94
2018,Lesotho,LSO,United Kingdom of Great Britain and Northern Ireland,GBR,0,0,5,0,5
2018,Sri Lanka,LKA,United Kingdom of Great Britain and Northern Ireland,GBR,60,10,669,107,846
2018,Lithuania,LTU,United Kingdom of Great Britain and Northern Ireland,GBR,0,0,5,0,5
2018,Latvia,LVA,United Kingdom of Great Britain and Northern Ireland,GBR,0,0,5,0,5
2018,Maldives,MDV,United Kingdom of Great Britain and Northern Ireland,GBR,5,0,0,0,5
2018,Mexico,MEX,United Kingdom of Great Britain and Northern Ireland,GBR,5,0,13,5,23
2018,Mali,MLI,United Kingdom of Great Britain and Northern Ireland,GBR,0,0,0,5,5
2018,Malaysia,MYS,United Kingdom of Great Britain and Northern Ireland,GBR,67,0,87,32,186
2018,Malawi,MWI,United Kingdom of Great Britain and Northern Ireland,GBR,5,5,61,0,71
2018,Mongolia,MNG,United Kingdom of Great Britain and Northern Ireland,GBR,0,0,10,5,15
2018,Morocco,MAR,United Kingdom of Great Britain and Northern Ireland,GBR,13,10,71,26,120
2018,Mozambique,MOZ,United Kingdom of Great Britain and Northern Ireland,GBR,0,0,10,0,10
2018,Mauritius,MUS,United Kingdom of Great Britain and Northern Ireland,GBR,0,0,30,10,40
2018,Myanmar,MMR,United Kingdom of Great Britain and Northern Ireland,GBR,5,0,38,10,53
2018,Namibia,NAM,United Kingdom of Great Britain and Northern Ireland,GBR,10,10,99,73,192
2018,Nepal,NPL,United Kingdom of Great Britain and Northern Ireland,GBR,0,5,81,34,120
2018,Nigeria,NGA,United Kingdom of Great Britain and Northern Ireland,GBR,117,199,984,85,1385
2018,Oman,OMN,United Kingdom of Great Britain and Northern Ireland,GBR,0,0,11,0,11
2018,Pakistan,PAK,United Kingdom of Great Britain and Northern Ireland,GBR,416,38,1791,418,2663
2018,Philippines,PHL,United Kingdom of Great Britain and Northern Ireland,GBR,0,5,68,14,87
2018,Poland,POL,United Kingdom of Great Britain and Northern Ireland,GBR,0,0,25,0,25
2018,Romania,ROU,United Kingdom of Great Britain and Northern Ireland,GBR,0,0,11,5,16
2018,South Africa,ZAF,United Kingdom of Great Britain and Northern Ireland,GBR,0,5,62,5,72
2018,Russian Federation,RUS,United Kingdom of Great Britain and Northern Ireland,GBR,98,0,88,21,207
2018,Rwanda,RWA,United Kingdom of Great Britain and Northern Ireland,GBR,5,0,30,0,35
2018,El Salvador,SLV,United Kingdom of Great Britain and Northern Ireland,GBR,19,0,70,5,94
2018,Saudi Arabia,SAU,United Kingdom of Great Britain and Northern Ireland,GBR,28,5,23,11,67
2018,Serbia and Kosovo: S/RES/1244 (1999),SRB,United Kingdom of Great Britain and Northern Ireland,GBR,0,0,13,5,18
2018,Senegal,SEN,United Kingdom of Great Britain and Northern Ireland,GBR,5,12,27,5,49
2018,Singapore,SGP,United Kingdom of Great Britain and Northern Ireland,GBR,0,0,12,0,12
2018,Sierra Leone,SLE,United Kingdom of Great Britain and Northern Ireland,GBR,18,5,38,10,71
2018,Somalia,SOM,United Kingdom of Great Britain and Northern Ireland,GBR,120,10,96,39,265
2018,Viet Nam,VNM,United Kingdom of Great Britain and Northern Ireland,GBR,233,59,404,225,921
2018,Saint Kitts and Nevis,KNA,United Kingdom of Great Britain and Northern Ireland,GBR,0,5,0,0,5
2018,Sudan,SDN,United Kingdom of Great Britain and Northern Ireland,GBR,608,23,308,483,1422
2018,South Sudan,SSD,United Kingdom of Great Britain and Northern Ireland,GBR,10,0,11,5,26
2018,Slovakia,SVK,United Kingdom of Great Britain and Northern Ireland,GBR,0,0,5,0,5
2018,Syrian Arab Rep.,SYR,United Kingdom of Great Britain and Northern Ireland,GBR,652,0,50,79,781
2018,United Rep. of Tanzania,TZA,United Kingdom of Great Britain and Northern Ireland,GBR,5,0,41,5,51
2018,Thailand,THA,United Kingdom of Great Britain and Northern Ireland,GBR,5,0,26,0,31
2018,Turkmenistan,TKM,United Kingdom of Great Britain and Northern Ireland,GBR,0,5,0,0,5
2018,Trinidad and Tobago,TTO,United Kingdom of Great Britain and Northern Ireland,GBR,14,0,29,0,43
2018,Tunisia,TUN,United Kingdom of Great Britain and Northern Ireland,GBR,5,5,29,5,44
2018,Turkey,TUR,United Kingdom of Great Britain and Northern Ireland,GBR,368,10,334,53,765
2018,United Arab Emirates,ARE,United Kingdom of Great Britain and Northern Ireland,GBR,0,0,0,5,5
2018,Uganda,UGA,United Kingdom of Great Britain and Northern Ireland,GBR,68,12,69,5,154
2018,Ukraine,UKR,United Kingdom of Great Britain and Northern Ireland,GBR,5,10,151,62,228
2018,United States of America,USA,United Kingdom of Great Britain and Northern Ireland,GBR,10,0,23,21,54
2018,Uzbekistan,UZB,United Kingdom of Great Britain and Northern Ireland,GBR,5,0,20,5,30
2018,Saint Vincent and the Grenadines,VCT,United Kingdom of Great Britain and Northern Ireland,GBR,5,0,13,0,18
2018,Venezuela (Bolivarian Republic of),VEN,United Kingdom of Great Britain and Northern Ireland,GBR,5,0,27,5,37
2018,Yemen,YEM,United Kingdom of Great Britain and Northern Ireland,GBR,83,92,32,5,212
2018,Zambia,ZMB,United Kingdom of Great Britain and Northern Ireland,GBR,0,10,14,5,29
2018,Zimbabwe,ZWE,United Kingdom of Great Britain and Northern Ireland,GBR,14,5,154,27,200
2018,Stateless,XXA,United Kingdom of Great Britain and Northern Ireland,GBR,285,5,162,117,569
2018,Afghanistan,AFG,Georgia,GEO,0,0,22,0,22
2018,Egypt,EGY,Georgia,GEO,25,0,65,24,114
2018,Azerbaijan,AZE,Georgia,GEO,0,0,5,0,5
2018,Bangladesh,BGD,Georgia,GEO,0,0,34,18,52
2018,Belarus,BLR,Georgia,GEO,0,0,0,5,5
2018,Congo,COG,Georgia,GEO,0,0,5,0,5
2018,Eritrea,ERI,Georgia,GEO,0,0,59,12,71
2018,India,IND,Georgia,GEO,0,0,14,10,24
2018,Iran (Islamic Rep. of),IRN,Georgia,GEO,5,0,23,51,79
2018,Iraq,IRQ,Georgia,GEO,18,5,33,17,73
2018,Jordan,JOR,Georgia,GEO,0,0,5,0,5
2018,Kazakhstan,KAZ,Georgia,GEO,0,0,5,0,5
2018,Sri Lanka,LKA,Georgia,GEO,0,0,5,0,5
2018,Nigeria,NGA,Georgia,GEO,0,0,12,5,17
2018,Pakistan,PAK,Georgia,GEO,0,0,58,31,89
2018,Russian Federation,RUS,Georgia,GEO,0,0,31,13,44
2018,Saudi Arabia,SAU,Georgia,GEO,0,0,0,5,5
2018,Somalia,SOM,Georgia,GEO,0,0,11,5,16
2018,Sudan,SDN,Georgia,GEO,0,0,5,5,10
2018,Syrian Arab Rep.,SYR,Georgia,GEO,0,0,24,5,29
2018,Turkey,TUR,Georgia,GEO,0,0,26,10,36
2018,Ukraine,UKR,Georgia,GEO,0,5,5,0,10
2018,Yemen,YEM,Georgia,GEO,5,18,63,5,91
2018,Stateless,XXA,Georgia,GEO,0,0,14,0,14
2018,Central African Rep.,CAF,Ghana,GHA,11,0,0,0,11
2018,Dem. Rep. of the Congo,COD,Ghana,GHA,14,0,0,0,14
2018,Eritrea,ERI,Ghana,GHA,75,0,0,0,75
2018,Cote d'Ivoire,CIV,Ghana,GHA,155,0,0,20,175
2018,Sierra Leone,SLE,Ghana,GHA,5,0,0,0,5
2018,Sudan,SDN,Ghana,GHA,120,0,0,0,120
2018,Syrian Arab Rep.,SYR,Ghana,GHA,117,0,0,0,117
2018,Afghanistan,AFG,Greece,GRC,1570,963,842,1955,5330
2018,Albania,ALB,Greece,GRC,5,0,2448,483,2936
2018,Algeria,DZA,Greece,GRC,22,0,249,345,616
2018,Angola,AGO,Greece,GRC,0,0,10,0,10
2018,Egypt,EGY,Greece,GRC,71,0,463,128,662
2018,Armenia,ARM,Greece,GRC,0,0,45,20,65
2018,Burundi,BDI,Greece,GRC,14,0,0,0,14
2018,Bangladesh,BGD,Greece,GRC,23,5,976,162,1166
2018,Burkina Faso,BFA,Greece,GRC,0,0,13,5,18
2018,Belarus,BLR,Greece,GRC,0,0,5,0,5
2018,Bulgaria,BGR,Greece,GRC,0,0,0,5,5
2018,Central African Rep.,CAF,Greece,GRC,5,0,0,0,5
2018,China,CHN,Greece,GRC,13,0,176,56,245
2018,Cameroon,CMR,Greece,GRC,120,5,209,141,475
2018,Congo,COG,Greece,GRC,31,5,48,21,105
2018,Dem. Rep. of the Congo,COD,Greece,GRC,204,14,348,231,797
2018,Comoros,COM,Greece,GRC,0,0,14,0,14
2018,Cuba,CUB,Greece,GRC,0,0,5,5,10
2018,Dominican Rep.,DOM,Greece,GRC,0,0,5,27,32
2018,Equatorial Guinea,GNQ,Greece,GRC,5,0,5,0,10
2018,Eritrea,ERI,Greece,GRC,152,0,10,51,213
2018,Ethiopia,ETH,Greece,GRC,67,0,97,19,183
2018,Gambia,GMB,Greece,GRC,5,0,19,0,24
2018,Palestinian,PSE,Greece,GRC,676,10,10,169,865
2018,Georgia,GEO,Greece,GRC,0,0,851,247,1098
2018,Ghana,GHA,Greece,GRC,0,0,64,23,87
2018,Guinea,GIN,Greece,GRC,19,5,49,20,93
2018,Haiti,HTI,Greece,GRC,0,0,0,14,14
2018,Cote d'Ivoire,CIV,Greece,GRC,5,0,16,11,32
2018,India,IND,Greece,GRC,0,0,99,36,135
2018,Indonesia,IDN,Greece,GRC,5,0,15,5,25
2018,Iran (Islamic Rep. of),IRN,Greece,GRC,438,22,219,379,1058
2018,Iraq,IRQ,Greece,GRC,2235,1257,1720,1623,6835
2018,Jordan,JOR,Greece,GRC,11,0,0,10,21
2018,Kazakhstan,KAZ,Greece,GRC,0,0,5,5,10
2018,Kenya,KEN,Greece,GRC,0,0,5,0,5
2018,Kuwait,KWT,Greece,GRC,44,0,0,18,62
2018,Libya,LBY,Greece,GRC,0,10,10,23,43
2018,Lebanon,LBN,Greece,GRC,11,0,31,15,57
2018,Sri Lanka,LKA,Greece,GRC,5,0,15,26,46
2018,Mauritania,MRT,Greece,GRC,5,0,0,0,5
2018,North Macedonia,MKD,Greece,GRC,0,0,5,5,10
2018,Rep. of Moldova,MDA,Greece,GRC,0,0,27,14,41
2018,Mali,MLI,Greece,GRC,5,5,28,5,43
2018,Morocco,MAR,Greece,GRC,39,0,131,171,341
2018,Myanmar,MMR,Greece,GRC,20,0,20,5,45
2018,Nepal,NPL,Greece,GRC,5,0,15,27,47
2018,Niger,NER,Greece,GRC,0,0,0,5,5
2018,Nigeria,NGA,Greece,GRC,13,0,72,26,111
2018,Pakistan,PAK,Greece,GRC,148,10,5826,1162,7146
2018,Philippines,PHL,Greece,GRC,0,0,5,0,5
2018,Russian Federation,RUS,Greece,GRC,0,0,30,15,45
2018,Rwanda,RWA,Greece,GRC,5,0,0,0,5
2018,El Salvador,SLV,Greece,GRC,5,0,0,0,5
2018,Serbia and Kosovo: S/RES/1244 (1999),SRB,Greece,GRC,0,0,5,5,10
2018,Senegal,SEN,Greece,GRC,0,0,18,5,23
2018,Sierra Leone,SLE,Greece,GRC,5,0,19,5,29
2018,Somalia,SOM,Greece,GRC,50,133,11,37,231
2018,Viet Nam,VNM,Greece,GRC,0,0,5,13,18
2018,Sudan,SDN,Greece,GRC,44,0,16,5,65
2018,South Sudan,SSD,Greece,GRC,5,0,0,5,10
2018,Syrian Arab Rep.,SYR,Greece,GRC,5976,5,18,1488,7487
2018,United Rep. of Tanzania,TZA,Greece,GRC,0,0,5,0,5
2018,Tajikistan,TJK,Greece,GRC,5,0,0,0,5
2018,Togo,TGO,Greece,GRC,5,0,15,5,25
2018,Tunisia,TUN,Greece,GRC,5,0,31,30,66
2018,Turkey,TUR,Greece,GRC,258,0,42,1228,1528
2018,Uganda,UGA,Greece,GRC,5,0,10,0,15
2018,Ukraine,UKR,Greece,GRC,0,10,46,28,84
2018,United States of America,USA,Greece,GRC,0,0,0,5,5
2018,Uzbekistan,UZB,Greece,GRC,0,0,5,0,5
2018,Venezuela (Bolivarian Republic of),VEN,Greece,GRC,5,0,16,5,26
2018,Western Sahara,ESH,Greece,GRC,5,0,5,0,10
2018,Yemen,YEM,Greece,GRC,100,109,0,27,236
2018,Zimbabwe,ZWE,Greece,GRC,0,0,11,0,11
2018,Stateless,XXA,Greece,GRC,137,0,5,24,166
2018,Colombia,COL,Guatemala,GTM,0,0,0,5,5
2018,Honduras,HND,Guatemala,GTM,0,0,0,11,11
2018,Mexico,MEX,Guatemala,GTM,0,0,0,5,5
2018,Nicaragua,NIC,Guatemala,GTM,0,0,0,17,17
2018,El Salvador,SLV,Guatemala,GTM,10,0,0,5,15
2018,Venezuela (Bolivarian Republic of),VEN,Guatemala,GTM,10,0,0,0,10
2018,Congo,COG,Guinea,GIN,12,0,0,0,12
2018,Dem. Rep. of the Congo,COD,Guinea,GIN,10,0,0,0,10
2018,Gambia,GMB,Guinea,GIN,5,0,0,0,5
2018,Cote d'Ivoire,CIV,Guinea,GIN,43,0,0,0,43
2018,Liberia,LBR,Guinea,GIN,5,0,0,0,5
2018,Sierra Leone,SLE,Guinea,GIN,43,0,0,0,43
2018,Cuba,CUB,Honduras,HND,0,0,0,12,12
2018,Nicaragua,NIC,Honduras,HND,0,0,0,33,33
2018,El Salvador,SLV,Honduras,HND,0,0,0,16,16
2018,Venezuela (Bolivarian Republic of),VEN,Honduras,HND,5,0,0,0,5
2018,Afghanistan,AFG,Croatia,HRV,5,0,5,212,222
2018,Albania,ALB,Croatia,HRV,0,0,0,5,5
2018,Algeria,DZA,Croatia,HRV,0,0,35,31,66
2018,Egypt,EGY,Croatia,HRV,0,0,0,11,11
2018,Bangladesh,BGD,Croatia,HRV,0,0,5,11,16
2018,Bosnia and Herzegovina,BIH,Croatia,HRV,0,0,5,0,5
2018,Dem. Rep. of the Congo,COD,Croatia,HRV,0,0,0,5,5
2018,Cuba,CUB,Croatia,HRV,0,0,0,5,5
2018,Palestinian,PSE,Croatia,HRV,5,0,0,5,10
2018,India,IND,Croatia,HRV,0,0,0,21,21
2018,Iran (Islamic Rep. of),IRN,Croatia,HRV,0,0,18,110,128
2018,Iraq,IRQ,Croatia,HRV,28,0,10,17,55
2018,Libya,LBY,Croatia,HRV,0,0,5,16,21
2018,Morocco,MAR,Croatia,HRV,0,0,11,16,27
2018,Nigeria,NGA,Croatia,HRV,5,0,0,0,5
2018,Pakistan,PAK,Croatia,HRV,0,0,5,46,51
2018,Russian Federation,RUS,Croatia,HRV,0,0,0,10,10
2018,Serbia and Kosovo: S/RES/1244 (1999),SRB,Croatia,HRV,0,0,5,5,10
2018,Syrian Arab Rep.,SYR,Croatia,HRV,166,19,10,30,225
2018,Tunisia,TUN,Croatia,HRV,0,0,13,18,31
2018,Turkey,TUR,Croatia,HRV,0,0,0,19,19
2018,Yemen,YEM,Croatia,HRV,5,0,0,0,5
2018,Afghanistan,AFG,Hungary,HUN,12,128,230,48,418
2018,Egypt,EGY,Hungary,HUN,0,0,5,0,5
2018,Cameroon,CMR,Hungary,HUN,10,0,0,0,10
2018,Dem. Rep. of the Congo,COD,Hungary,HUN,5,0,0,0,5
2018,Cuba,CUB,Hungary,HUN,5,0,0,0,5
2018,Ethiopia,ETH,Hungary,HUN,5,0,0,0,5
2018,Palestinian,PSE,Hungary,HUN,0,5,0,5,10
2018,Georgia,GEO,Hungary,HUN,0,0,5,0,5
2018,Germany,DEU,Hungary,HUN,0,0,5,0,5
2018,Iran (Islamic Rep. of),IRN,Hungary,HUN,23,10,27,5,65
2018,Iraq,IRQ,Hungary,HUN,0,74,257,28,359
2018,Morocco,MAR,Hungary,HUN,0,0,0,5,5
2018,Nigeria,NGA,Hungary,HUN,5,0,0,0,5
2018,Pakistan,PAK,Hungary,HUN,5,0,21,21,47
2018,Russian Federation,RUS,Hungary,HUN,0,0,5,0,5
2018,Serbia and Kosovo: S/RES/1244 (1999),SRB,Hungary,HUN,0,0,0,22,22
2018,Somalia,SOM,Hungary,HUN,0,5,5,0,10
2018,Syrian Arab Rep.,SYR,Hungary,HUN,0,46,16,21,83
2018,Turkey,TUR,Hungary,HUN,0,0,5,0,5
2018,Afghanistan,AFG,Iceland,ISL,5,0,0,21,26
2018,Albania,ALB,Iceland,ISL,0,0,52,62,114
2018,Algeria,DZA,Iceland,ISL,0,0,0,5,5
2018,Azerbaijan,AZE,Iceland,ISL,0,0,5,0,5
2018,Bangladesh,BGD,Iceland,ISL,0,0,0,10,10
2018,Bosnia and Herzegovina,BIH,Iceland,ISL,0,0,5,0,5
2018,Dem. Rep. of the Congo,COD,Iceland,ISL,0,0,0,5,5
2018,Palestinian,PSE,Iceland,ISL,5,5,0,20,30
2018,Georgia,GEO,Iceland,ISL,0,0,63,19,82
2018,Cote d'Ivoire,CIV,Iceland,ISL,0,0,0,5,5
2018,Iran (Islamic Rep. of),IRN,Iceland,ISL,5,0,0,17,22
2018,Iraq,IRQ,Iceland,ISL,35,5,15,38,93
2018,North Macedonia,MKD,Iceland,ISL,0,0,16,0,16
2018,Rep. of Moldova,MDA,Iceland,ISL,0,0,0,5,5
2018,Morocco,MAR,Iceland,ISL,0,0,0,12,12
2018,Nigeria,NGA,Iceland,ISL,0,0,0,5,5
2018,Pakistan,PAK,Iceland,ISL,5,0,5,27,37
2018,Poland,POL,Iceland,ISL,0,0,0,5,5
2018,Russian Federation,RUS,Iceland,ISL,0,0,0,11,11
2018,El Salvador,SLV,Iceland,ISL,5,0,0,0,5
2018,Serbia and Kosovo: S/RES/1244 (1999),SRB,Iceland,ISL,0,0,14,5,19
2018,Somalia,SOM,Iceland,ISL,5,0,0,23,28
2018,South Sudan,SSD,Iceland,ISL,5,0,0,0,5
2018,Syrian Arab Rep.,SYR,Iceland,ISL,5,5,0,11,21
2018,Turkey,TUR,Iceland,ISL,0,0,0,5,5
2018,Ukraine,UKR,Iceland,ISL,0,0,14,5,19
2018,United States of America,USA,Iceland,ISL,0,0,0,5,5
2018,Venezuela (Bolivarian Republic of),VEN,Iceland,ISL,5,5,0,0,10
2018,Yemen,YEM,Iceland,ISL,5,0,0,0,5
2018,Afghanistan,AFG,Ireland,IRL,37,64,10,19,130
2018,Albania,ALB,Ireland,IRL,0,5,371,85,461
2018,Algeria,DZA,Ireland,IRL,5,0,73,16,94
2018,Angola,AGO,Ireland,IRL,0,0,10,0,10
2018,Egypt,EGY,Ireland,IRL,5,0,12,5,22
2018,Armenia,ARM,Ireland,IRL,5,0,0,0,5
2018,Bahrain,BHR,Ireland,IRL,5,0,0,0,5
2018,Burundi,BDI,Ireland,IRL,0,0,5,0,5
2018,Bangladesh,BGD,Ireland,IRL,5,5,138,5,153
2018,Botswana,BWA,Ireland,IRL,0,0,13,0,13
2018,Brazil,BRA,Ireland,IRL,0,0,38,5,43
2018,China,CHN,Ireland,IRL,5,5,11,0,21
2018,Cameroon,CMR,Ireland,IRL,0,0,15,5,20
2018,Congo,COG,Ireland,IRL,0,0,5,0,5
2018,Dem. Rep. of the Congo,COD,Ireland,IRL,12,11,83,5,111
2018,Eritrea,ERI,Ireland,IRL,5,0,0,5,10
2018,Ethiopia,ETH,Ireland,IRL,0,0,5,0,5
2018,Gambia,GMB,Ireland,IRL,0,0,5,0,5
2018,Palestinian,PSE,Ireland,IRL,23,0,0,5,28
2018,Georgia,GEO,Ireland,IRL,5,0,240,17,262
2018,Ghana,GHA,Ireland,IRL,0,0,16,5,21
2018,Guinea,GIN,Ireland,IRL,0,0,5,0,5
2018,India,IND,Ireland,IRL,0,0,27,15,42
2018,Iran (Islamic Rep. of),IRN,Ireland,IRL,11,0,0,5,16
2018,Iraq,IRQ,Ireland,IRL,27,5,23,13,68
2018,Jordan,JOR,Ireland,IRL,5,0,0,0,5
2018,Kenya,KEN,Ireland,IRL,0,0,0,5,5
2018,Dem. People's Rep. of Korea,PRK,Ireland,IRL,5,0,0,0,5
2018,Kuwait,KWT,Ireland,IRL,12,0,0,0,12
2018,Libya,LBY,Ireland,IRL,25,29,0,12,66
2018,Lebanon,LBN,Ireland,IRL,0,0,5,0,5
2018,Sri Lanka,LKA,Ireland,IRL,0,5,5,0,10
2018,Rep. of Moldova,MDA,Ireland,IRL,0,0,5,0,5
2018,Mexico,MEX,Ireland,IRL,0,0,5,0,5
2018,Malawi,MWI,Ireland,IRL,5,5,62,5,77
2018,Mongolia,MNG,Ireland,IRL,0,0,5,0,5
2018,Morocco,MAR,Ireland,IRL,0,0,14,0,14
2018,Mauritius,MUS,Ireland,IRL,0,0,12,0,12
2018,Myanmar,MMR,Ireland,IRL,5,0,0,0,5
2018,Nepal,NPL,Ireland,IRL,5,0,0,0,5
2018,Nigeria,NGA,Ireland,IRL,10,0,162,57,229
2018,Pakistan,PAK,Ireland,IRL,16,15,317,41,390
2018,South Africa,ZAF,Ireland,IRL,5,0,86,11,102
2018,Russian Federation,RUS,Ireland,IRL,0,0,12,0,12
2018,Rwanda,RWA,Ireland,IRL,0,0,5,0,5
2018,Serbia and Kosovo: S/RES/1244 (1999),SRB,Ireland,IRL,0,0,20,0,20
2018,Senegal,SEN,Ireland,IRL,0,0,5,0,5
2018,Sierra Leone,SLE,Ireland,IRL,0,5,10,0,15
2018,Somalia,SOM,Ireland,IRL,14,5,5,14,38
2018,Sudan,SDN,Ireland,IRL,5,0,5,14,24
2018,Syrian Arab Rep.,SYR,Ireland,IRL,389,0,5,13,407
2018,Togo,TGO,Ireland,IRL,0,0,5,0,5
2018,Tunisia,TUN,Ireland,IRL,0,0,11,0,11
2018,Uganda,UGA,Ireland,IRL,0,0,5,0,5
2018,Ukraine,UKR,Ireland,IRL,5,0,26,0,31
2018,United States of America,USA,Ireland,IRL,0,0,5,0,5
2018,Venezuela (Bolivarian Republic of),VEN,Ireland,IRL,11,5,13,0,29
2018,Yemen,YEM,Ireland,IRL,5,5,0,0,10
2018,Zimbabwe,ZWE,Ireland,IRL,25,5,130,5,165
2018,Afghanistan,AFG,Italy,ITA,307,640,131,45,1123
2018,Albania,ALB,Italy,ITA,43,115,362,0,520
2018,Algeria,DZA,Italy,ITA,5,17,110,0,132
2018,Angola,AGO,Italy,ITA,0,0,5,0,5
2018,Egypt,EGY,Italy,ITA,41,248,507,0,796
2018,Argentina,ARG,Italy,ITA,0,5,5,0,10
2018,Armenia,ARM,Italy,ITA,21,25,26,0,72
2018,Azerbaijan,AZE,Italy,ITA,5,5,13,0,23
2018,Burundi,BDI,Italy,ITA,5,5,0,0,10
2018,Benin,BEN,Italy,ITA,5,49,119,0,173
2018,Bangladesh,BGD,Italy,ITA,159,2670,7710,0,10539
2018,Bahamas,BHS,Italy,ITA,0,5,0,0,5
2018,Burkina Faso,BFA,Italy,ITA,10,196,571,0,777
2018,Belarus,BLR,Italy,ITA,0,14,0,0,14
2018,Bolivia (Plurinational State of),BOL,Italy,ITA,5,0,5,0,10
2018,Brazil,BRA,Italy,ITA,23,27,38,0,88
2018,Bosnia and Herzegovina,BIH,Italy,ITA,0,45,35,0,80
2018,Central African Rep.,CAF,Italy,ITA,11,5,5,0,21
2018,Chad,TCD,Italy,ITA,5,29,31,0,65
2018,China,CHN,Italy,ITA,10,18,308,0,336
2018,Chile,CHL,Italy,ITA,0,0,5,0,5
2018,Cameroon,CMR,Italy,ITA,224,307,728,0,1259
2018,Congo,COG,Italy,ITA,10,5,15,0,30
2018,Dem. Rep. of the Congo,COD,Italy,ITA,22,40,24,0,86
2018,Comoros,COM,Italy,ITA,0,0,5,0,5
2018,Colombia,COL,Italy,ITA,56,53,58,0,167
2018,Costa Rica,CRI,Italy,ITA,5,0,0,0,5
2018,Cuba,CUB,Italy,ITA,10,18,56,0,84
2018,Cabo Verde,CPV,Italy,ITA,0,5,0,0,5
2018,Dominican Rep.,DOM,Italy,ITA,0,0,13,0,13
2018,Ecuador,ECU,Italy,ITA,0,5,5,0,10
2018,Eritrea,ERI,Italy,ITA,249,27,172,5,453
2018,Ethiopia,ETH,Italy,ITA,79,69,51,0,199
2018,Gabon,GAB,Italy,ITA,0,14,0,0,14
2018,Gambia,GMB,Italy,ITA,137,2181,4654,0,6972
2018,Palestinian,PSE,Italy,ITA,73,27,37,0,137
2018,Georgia,GEO,Italy,ITA,12,183,235,0,430
2018,Ghana,GHA,Italy,ITA,62,933,2992,0,3987
2018,Guinea-Bissau,GNB,Italy,ITA,10,152,446,0,608
2018,Guatemala,GTM,Italy,ITA,0,0,5,0,5
2018,Guinea,GIN,Italy,ITA,129,1199,3472,5,4805
2018,Honduras,HND,Italy,ITA,19,54,10,0,83
2018,Cote d'Ivoire,CIV,Italy,ITA,236,1085,3952,5,5278
2018,India,IND,Italy,ITA,24,96,422,0,542
2018,Iran (Islamic Rep. of),IRN,Italy,ITA,84,66,65,0,215
2018,Iraq,IRQ,Italy,ITA,341,889,176,10,1416
2018,Jordan,JOR,Italy,ITA,5,5,0,0,10
2018,Kazakhstan,KAZ,Italy,ITA,0,13,5,0,18
2018,Kenya,KEN,Italy,ITA,0,5,16,0,21
2018,Kyrgyzstan,KGZ,Italy,ITA,10,53,57,0,120
2018,Kuwait,KWT,Italy,ITA,0,5,5,0,10
2018,Liberia,LBR,Italy,ITA,5,52,155,13,225
2018,Libya,LBY,Italy,ITA,90,215,77,5,387
2018,Lebanon,LBN,Italy,ITA,26,24,25,0,75
2018,Sri Lanka,LKA,Italy,ITA,15,77,114,0,206
2018,Madagascar,MDG,Italy,ITA,0,5,0,0,5
2018,Mauritania,MRT,Italy,ITA,15,5,26,0,46
2018,North Macedonia,MKD,Italy,ITA,0,13,21,0,34
2018,Rep. of Moldova,MDA,Italy,ITA,0,10,17,0,27
2018,Mali,MLI,Italy,ITA,114,1714,3812,20,5660
2018,Malaysia,MYS,Italy,ITA,0,0,5,0,5
2018,Morocco,MAR,Italy,ITA,66,281,1054,0,1401
2018,Montenegro,MNE,Italy,ITA,0,5,0,0,5
2018,Mauritius,MUS,Italy,ITA,5,0,5,0,10
2018,Myanmar,MMR,Italy,ITA,14,0,5,0,19
2018,Nepal,NPL,Italy,ITA,5,14,74,0,93
2018,Niger,NER,Italy,ITA,14,144,259,0,417
2018,Nicaragua,NIC,Italy,ITA,5,0,5,0,10
2018,Nigeria,NGA,Italy,ITA,1335,3365,15152,16,19868
2018,Pakistan,PAK,Italy,ITA,437,2000,7320,38,9795
2018,Paraguay,PRY,Italy,ITA,0,5,0,0,5
2018,Peru,PER,Italy,ITA,12,18,43,0,73
2018,Philippines,PHL,Italy,ITA,0,37,67,0,104
2018,Russian Federation,RUS,Italy,ITA,13,51,48,0,112
2018,El Salvador,SLV,Italy,ITA,293,670,182,0,1145
2018,Saudi Arabia,SAU,Italy,ITA,5,0,5,0,10
2018,Serbia and Kosovo: S/RES/1244 (1999),SRB,Italy,ITA,13,81,181,0,275
2018,Senegal,SEN,Italy,ITA,111,1366,5063,0,6540
2018,Sierra Leone,SLE,Italy,ITA,29,164,504,0,697
2018,Somalia,SOM,Italy,ITA,623,617,140,0,1380
2018,Sudan,SDN,Italy,ITA,97,69,137,5,308
2018,South Sudan,SSD,Italy,ITA,5,0,0,0,5
2018,Syrian Arab Rep.,SYR,Italy,ITA,369,5,36,0,410
2018,United Rep. of Tanzania,TZA,Italy,ITA,5,0,0,0,5
2018,Tajikistan,TJK,Italy,ITA,5,0,0,0,5
2018,Togo,TGO,Italy,ITA,14,107,379,0,500
2018,Tunisia,TUN,Italy,ITA,15,57,650,0,722
2018,Turkey,TUR,Italy,ITA,85,130,61,5,281
2018,Uganda,UGA,Italy,ITA,5,5,0,0,10
2018,Ukraine,UKR,Italy,ITA,41,874,1034,0,1949
2018,Uzbekistan,UZB,Italy,ITA,14,0,0,0,14
2018,Venezuela (Bolivarian Republic of),VEN,Italy,ITA,112,274,22,0,408
2018,Yemen,YEM,Italy,ITA,13,10,0,0,23
2018,Zambia,ZMB,Italy,ITA,0,0,5,0,5
2018,Zimbabwe,ZWE,Italy,ITA,5,0,5,0,10
2018,Afghanistan,AFG,Japan,JPN,5,0,0,0,5
2018,Cambodia,KHM,Japan,JPN,0,0,273,0,273
2018,China,CHN,Japan,JPN,5,0,243,140,388
2018,Dem. Rep. of the Congo,COD,Japan,JPN,13,0,0,0,13
2018,Ethiopia,ETH,Japan,JPN,5,0,0,0,5
2018,India,IND,Japan,JPN,0,0,214,144,358
2018,Indonesia,IDN,Japan,JPN,0,0,1480,210,1690
2018,Sri Lanka,LKA,Japan,JPN,0,0,1080,194,1274
2018,Myanmar,MMR,Japan,JPN,0,0,325,140,465
2018,Nepal,NPL,Japan,JPN,0,0,1759,411,2170
2018,Pakistan,PAK,Japan,JPN,0,0,0,108,108
2018,Philippines,PHL,Japan,JPN,0,0,2664,902,3566
2018,Viet Nam,VNM,Japan,JPN,0,0,981,207,1188
2018,Syrian Arab Rep.,SYR,Japan,JPN,5,0,0,0,5
2018,Turkey,TUR,Japan,JPN,0,0,769,150,919
2018,Afghanistan,AFG,Kenya,KEN,0,0,0,5,5
2018,Angola,AGO,Kenya,KEN,0,0,0,5,5
2018,Burundi,BDI,Kenya,KEN,0,3071,0,1099,4170
2018,Congo,COG,Kenya,KEN,0,10,0,36,46
2018,Dem. Rep. of the Congo,COD,Kenya,KEN,0,10739,0,787,11526
2018,Eritrea,ERI,Kenya,KEN,0,23,0,26,49
2018,Ethiopia,ETH,Kenya,KEN,5,1519,0,5018,6542
2018,Cote d'Ivoire,CIV,Kenya,KEN,0,0,0,5,5
2018,Nigeria,NGA,Kenya,KEN,0,5,0,0,5
2018,Pakistan,PAK,Kenya,KEN,0,0,0,5,5
2018,Rwanda,RWA,Kenya,KEN,0,59,0,142,201
2018,Somalia,SOM,Kenya,KEN,0,11,0,469,480
2018,Sudan,SDN,Kenya,KEN,0,856,0,115,971
2018,South Sudan,SSD,Kenya,KEN,0,0,0,38,38
2018,United Rep. of Tanzania,TZA,Kenya,KEN,0,5,0,5,10
2018,Uganda,UGA,Kenya,KEN,0,277,0,353,630
2018,Yemen,YEM,Kenya,KEN,0,0,0,10,10
2018,Zimbabwe,ZWE,Kenya,KEN,0,5,0,5,10
2018,Afghanistan,AFG,Kyrgyzstan,KGZ,5,0,44,5,54
2018,Iraq,IRQ,Kyrgyzstan,KGZ,5,0,0,0,5
2018,Syrian Arab Rep.,SYR,Kyrgyzstan,KGZ,12,0,0,0,12
2018,Tajikistan,TJK,Kyrgyzstan,KGZ,5,0,0,0,5
2018,Ukraine,UKR,Kyrgyzstan,KGZ,10,0,0,0,10
2018,Syrian Arab Rep.,SYR,Liberia,LBR,5,0,0,0,5
2018,Dem. Rep. of the Congo,COD,Lesotho,LSO,14,0,0,0,14
2018,Afghanistan,AFG,Liechtenstein,LIE,0,0,0,5,5
2018,Belarus,BLR,Liechtenstein,LIE,0,0,5,13,18
2018,Georgia,GEO,Liechtenstein,LIE,0,0,0,5,5
2018,Morocco,MAR,Liechtenstein,LIE,0,0,0,5,5
2018,Nigeria,NGA,Liechtenstein,LIE,0,0,0,5,5
2018,Serbia and Kosovo: S/RES/1244 (1999),SRB,Liechtenstein,LIE,0,0,19,0,19
2018,Somalia,SOM,Liechtenstein,LIE,0,0,0,5,5
2018,Syrian Arab Rep.,SYR,Liechtenstein,LIE,0,0,0,5,5
2018,Ukraine,UKR,Liechtenstein,LIE,0,0,0,5,5
2018,Afghanistan,AFG,Lithuania,LTU,0,11,0,0,11
2018,Armenia,ARM,Lithuania,LTU,0,0,10,11,21
2018,Azerbaijan,AZE,Lithuania,LTU,0,0,11,0,11
2018,Belarus,BLR,Lithuania,LTU,0,0,24,10,34
2018,Iran (Islamic Rep. of),IRN,Lithuania,LTU,0,0,0,5,5
2018,Iraq,IRQ,Lithuania,LTU,0,0,0,14,14
2018,Kyrgyzstan,KGZ,Lithuania,LTU,0,0,11,0,11
2018,Sri Lanka,LKA,Lithuania,LTU,0,0,0,13,13
2018,Pakistan,PAK,Lithuania,LTU,0,0,5,0,5
2018,Russian Federation,RUS,Lithuania,LTU,18,5,19,31,73
2018,Syrian Arab Rep.,SYR,Lithuania,LTU,74,0,0,0,74
2018,Tajikistan,TJK,Lithuania,LTU,29,0,23,30,82
2018,Turkey,TUR,Lithuania,LTU,15,0,0,0,15
2018,Ukraine,UKR,Lithuania,LTU,0,0,18,11,29
2018,Afghanistan,AFG,Luxembourg,LUX,45,35,5,0,85
2018,Albania,ALB,Luxembourg,LUX,0,0,40,0,40
2018,Algeria,DZA,Luxembourg,LUX,0,0,20,0,20
2018,Egypt,EGY,Luxembourg,LUX,0,0,5,0,5
2018,Armenia,ARM,Luxembourg,LUX,0,0,5,0,5
2018,Azerbaijan,AZE,Luxembourg,LUX,0,0,5,0,5
2018,Benin,BEN,Luxembourg,LUX,0,0,5,0,5
2018,Belarus,BLR,Luxembourg,LUX,0,0,5,0,5
2018,Dem. Rep. of the Congo,COD,Luxembourg,LUX,5,0,5,0,10
2018,Eritrea,ERI,Luxembourg,LUX,305,5,10,0,320
2018,Ethiopia,ETH,Luxembourg,LUX,20,0,10,0,30
2018,Gabon,GAB,Luxembourg,LUX,0,0,5,0,5
2018,Georgia,GEO,Luxembourg,LUX,0,0,70,0,70
2018,Cote d'Ivoire,CIV,Luxembourg,LUX,0,0,5,0,5
2018,India,IND,Luxembourg,LUX,0,0,5,0,5
2018,Iran (Islamic Rep. of),IRN,Luxembourg,LUX,60,0,0,0,60
2018,Iraq,IRQ,Luxembourg,LUX,140,5,20,0,165
2018,Mali,MLI,Luxembourg,LUX,0,0,5,0,5
2018,Morocco,MAR,Luxembourg,LUX,0,0,15,0,15
2018,Nigeria,NGA,Luxembourg,LUX,0,0,10,0,10
2018,Afghanistan,AFG,Latvia,LVA,5,0,0,5,10
2018,Egypt,EGY,Latvia,LVA,0,0,5,0,5
2018,Azerbaijan,AZE,Latvia,LVA,0,0,12,0,12
2018,Belarus,BLR,Latvia,LVA,0,0,0,5,5
2018,Eritrea,ERI,Latvia,LVA,0,5,0,0,5
2018,Georgia,GEO,Latvia,LVA,0,0,5,5,10
2018,India,IND,Latvia,LVA,0,0,0,5,5
2018,Iraq,IRQ,Latvia,LVA,0,0,10,5,15
2018,Kazakhstan,KAZ,Latvia,LVA,0,0,11,0,11
2018,Pakistan,PAK,Latvia,LVA,0,0,5,0,5
2018,Russian Federation,RUS,Latvia,LVA,12,0,18,14,44
2018,Viet Nam,VNM,Latvia,LVA,0,0,5,10,15
2018,Syrian Arab Rep.,SYR,Latvia,LVA,5,13,0,0,18
2018,Tajikistan,TJK,Latvia,LVA,0,0,5,5,10
2018,Turkey,TUR,Latvia,LVA,5,0,5,0,10
2018,Ukraine,UKR,Latvia,LVA,0,0,0,5,5
2018,Uzbekistan,UZB,Latvia,LVA,0,0,5,0,5
2018,India,IND,"China, Macao SAR",MAC,0,0,0,5,5
2018,Afghanistan,AFG,Rep. of Moldova,MDA,0,5,0,0,5
2018,Armenia,ARM,Rep. of Moldova,MDA,0,0,5,5,10
2018,Cote d'Ivoire,CIV,Rep. of Moldova,MDA,0,0,5,0,5
2018,Russian Federation,RUS,Rep. of Moldova,MDA,0,0,5,5,10
2018,Syrian Arab Rep.,SYR,Rep. of Moldova,MDA,0,16,0,0,16
2018,Turkey,TUR,Rep. of Moldova,MDA,11,0,18,0,29
2018,Ukraine,UKR,Rep. of Moldova,MDA,0,0,0,11,11
2018,Argentina,ARG,Mexico,MEX,0,0,5,0,5
2018,Brazil,BRA,Mexico,MEX,0,0,0,5,5
2018,Belize,BLZ,Mexico,MEX,0,0,0,5,5
2018,Cambodia,KHM,Mexico,MEX,5,0,0,38,43
2018,Congo,COG,Mexico,MEX,0,0,0,5,5
2018,Colombia,COL,Mexico,MEX,14,0,16,46,76
2018,Cuba,CUB,Mexico,MEX,10,0,5,228,243
2018,Dominican Rep.,DOM,Mexico,MEX,0,0,0,5,5
2018,Ecuador,ECU,Mexico,MEX,0,0,0,11,11
2018,Ghana,GHA,Mexico,MEX,0,0,0,5,5
2018,Guatemala,GTM,Mexico,MEX,59,65,111,312,547
2018,Guinea,GIN,Mexico,MEX,0,5,0,0,5
2018,Haiti,HTI,Mexico,MEX,0,0,10,59,69
2018,Honduras,HND,Mexico,MEX,506,660,717,2605,4488
2018,India,IND,Mexico,MEX,0,0,0,5,5
2018,Italy,ITA,Mexico,MEX,5,0,0,0,5
2018,Nicaragua,NIC,Mexico,MEX,26,45,12,104,187
2018,Nigeria,NGA,Mexico,MEX,0,0,0,5,5
2018,Pakistan,PAK,Mexico,MEX,5,0,0,0,5
2018,Panama,PAN,Mexico,MEX,5,0,0,0,5
2018,Portugal,PRT,Mexico,MEX,5,0,0,0,5
2018,Russian Federation,RUS,Mexico,MEX,5,0,0,0,5
2018,El Salvador,SLV,Mexico,MEX,557,674,391,1172,2794
2018,Somalia,SOM,Mexico,MEX,0,0,0,5,5
2018,Uganda,UGA,Mexico,MEX,0,0,0,5,5
2018,United States of America,USA,Mexico,MEX,0,0,5,5,10
2018,Uzbekistan,UZB,Mexico,MEX,0,0,0,5,5
2018,Venezuela (Bolivarian Republic of),VEN,Mexico,MEX,3248,14,41,442,3745
2018,Yemen,YEM,Mexico,MEX,11,0,0,0,11
2018,Burkina Faso,BFA,Mali,MLI,8457,0,0,0,8457
2018,Central African Rep.,CAF,Mali,MLI,0,0,0,91,91
2018,Niger,NER,Mali,MLI,1024,0,0,0,1024
2018,Burundi,BDI,Malawi,MWI,824,0,0,35,859
2018,Dem. Rep. of the Congo,COD,Malawi,MWI,3930,0,0,118,4048
2018,Cote d'Ivoire,CIV,Malawi,MWI,5,0,0,0,5
2018,Mozambique,MOZ,Malawi,MWI,0,0,0,3364,3364
2018,Rwanda,RWA,Malawi,MWI,27,0,0,13,40
2018,Somalia,SOM,Malawi,MWI,10,0,0,0,10
2018,South Sudan,SSD,Malawi,MWI,0,0,0,5,5
2018,Dem. Rep. of the Congo,COD,Mozambique,MOZ,0,0,0,171,171
2018,Kenya,KEN,Mozambique,MOZ,0,0,0,5,5
2018,Afghanistan,AFG,Malta,MLT,0,0,5,0,5
2018,Egypt,EGY,Malta,MLT,0,0,14,0,14
2018,Bangladesh,BGD,Malta,MLT,0,0,70,17,87
2018,Burkina Faso,BFA,Malta,MLT,5,0,0,0,5
2018,Chad,TCD,Malta,MLT,0,0,5,0,5
2018,China,CHN,Malta,MLT,0,0,0,5,5
2018,Colombia,COL,Malta,MLT,0,0,5,0,5
2018,Eritrea,ERI,Malta,MLT,5,76,5,43,129
2018,Ethiopia,ETH,Malta,MLT,5,10,0,24,39
2018,Gambia,GMB,Malta,MLT,5,0,0,16,21
2018,Palestinian,PSE,Malta,MLT,0,0,5,5,10
2018,Georgia,GEO,Malta,MLT,0,0,11,0,11
2018,Ghana,GHA,Malta,MLT,0,0,0,5,5
2018,Guinea-Bissau,GNB,Malta,MLT,0,0,0,5,5
2018,Guinea,GIN,Malta,MLT,0,0,0,5,5
2018,Cote d'Ivoire,CIV,Malta,MLT,0,0,12,0,12
2018,Iran (Islamic Rep. of),IRN,Malta,MLT,0,0,0,5,5
2018,Iraq,IRQ,Malta,MLT,5,0,10,29,44
2018,Libya,LBY,Malta,MLT,20,207,5,104,336
2018,North Macedonia,MKD,Malta,MLT,0,0,5,0,5
2018,Mongolia,MNG,Malta,MLT,0,0,0,5,5
2018,Morocco,MAR,Malta,MLT,0,0,13,0,13
2018,Nigeria,NGA,Malta,MLT,5,12,12,5,34
2018,Pakistan,PAK,Malta,MLT,5,0,14,12,31
2018,Russian Federation,RUS,Malta,MLT,5,0,5,0,10
2018,Senegal,SEN,Malta,MLT,0,0,0,10,10
2018,Sierra Leone,SLE,Malta,MLT,0,0,5,5,10
2018,Somalia,SOM,Malta,MLT,5,36,5,448,494
2018,Sudan,SDN,Malta,MLT,5,0,5,10,20
2018,Syrian Arab Rep.,SYR,Malta,MLT,57,150,0,144,351
2018,Ukraine,UKR,Malta,MLT,0,10,32,21,63
2018,Venezuela (Bolivarian Republic of),VEN,Malta,MLT,0,0,23,5,28
2018,Burundi,BDI,Namibia,NAM,5,0,0,95,100
2018,Dem. Rep. of the Congo,COD,Namibia,NAM,354,0,0,637,991
2018,Nigeria,NGA,Namibia,NAM,0,0,0,5,5
2018,Rwanda,RWA,Namibia,NAM,0,0,0,15,15
2018,Somalia,SOM,Namibia,NAM,0,0,0,5,5
2018,Sudan,SDN,Namibia,NAM,5,0,0,0,5
2018,United Rep. of Tanzania,TZA,Namibia,NAM,0,0,0,5,5
2018,Uganda,UGA,Namibia,NAM,0,0,0,5,5
2018,Zimbabwe,ZWE,Namibia,NAM,0,0,0,40,40
2018,Afghanistan,AFG,Netherlands,NLD,63,15,196,0,274
2018,Albania,ALB,Netherlands,NLD,0,0,495,46,541
2018,Algeria,DZA,Netherlands,NLD,0,0,315,22,337
2018,Angola,AGO,Netherlands,NLD,0,0,5,0,5
2018,Egypt,EGY,Netherlands,NLD,26,0,61,0,87
2018,Armenia,ARM,Netherlands,NLD,0,0,13,0,13
2018,Azerbaijan,AZE,Netherlands,NLD,0,0,18,80,98
2018,Bahrain,BHR,Netherlands,NLD,5,0,0,0,5
2018,Burundi,BDI,Netherlands,NLD,0,0,13,0,13
2018,Belarus,BLR,Netherlands,NLD,0,0,5,0,5
2018,Bosnia and Herzegovina,BIH,Netherlands,NLD,0,0,52,0,52
2018,China,CHN,Netherlands,NLD,52,0,24,0,76
2018,Cameroon,CMR,Netherlands,NLD,0,0,12,0,12
2018,Congo,COG,Netherlands,NLD,0,0,17,0,17
2018,Colombia,COL,Netherlands,NLD,0,0,14,0,14
2018,Cuba,CUB,Netherlands,NLD,5,0,286,31,322
2018,Eritrea,ERI,Netherlands,NLD,256,13,199,5,473
2018,Ethiopia,ETH,Netherlands,NLD,5,0,30,0,35
2018,Gambia,GMB,Netherlands,NLD,0,0,26,5,31
2018,Palestinian,PSE,Netherlands,NLD,0,0,10,0,10
2018,Georgia,GEO,Netherlands,NLD,0,0,335,5,340
2018,Ghana,GHA,Netherlands,NLD,0,0,11,0,11
2018,Guinea,GIN,Netherlands,NLD,11,0,43,0,54
2018,Cote d'Ivoire,CIV,Netherlands,NLD,0,0,5,0,5
2018,India,IND,Netherlands,NLD,0,0,28,5,33
2018,Iran (Islamic Rep. of),IRN,Netherlands,NLD,223,53,233,22,531
2018,Iraq,IRQ,Netherlands,NLD,65,13,196,31,305
2018,Jamaica,JAM,Netherlands,NLD,10,0,0,0,10
2018,Jordan,JOR,Netherlands,NLD,0,0,16,0,16
2018,Liberia,LBR,Netherlands,NLD,0,0,5,0,5
2018,Libya,LBY,Netherlands,NLD,12,0,79,10,101
2018,Lebanon,LBN,Netherlands,NLD,5,0,12,0,17
2018,Sri Lanka,LKA,Netherlands,NLD,0,0,10,0,10
2018,North Macedonia,MKD,Netherlands,NLD,0,0,94,0,94
2018,Rep. of Moldova,MDA,Netherlands,NLD,0,0,200,68,268
2018,Mali,MLI,Netherlands,NLD,0,0,5,0,5
2018,Mongolia,MNG,Netherlands,NLD,0,0,5,0,5
2018,Morocco,MAR,Netherlands,NLD,0,0,292,26,318
2018,Myanmar,MMR,Netherlands,NLD,0,0,12,0,12
2018,Nigeria,NGA,Netherlands,NLD,10,0,66,5,81
2018,Pakistan,PAK,Netherlands,NLD,52,0,28,0,80
2018,Russian Federation,RUS,Netherlands,NLD,40,0,33,10,83
2018,Serbia and Kosovo: S/RES/1244 (1999),SRB,Netherlands,NLD,0,0,154,0,154
2018,Senegal,SEN,Netherlands,NLD,0,0,5,0,5
2018,Sierra Leone,SLE,Netherlands,NLD,0,0,5,0,5
2018,Somalia,SOM,Netherlands,NLD,10,0,37,0,47
2018,Viet Nam,VNM,Netherlands,NLD,0,0,30,0,30
2018,Sudan,SDN,Netherlands,NLD,27,0,42,5,74
2018,Suriname,SUR,Netherlands,NLD,0,0,5,0,5
2018,Syrian Arab Rep.,SYR,Netherlands,NLD,1240,10,368,15,1633
2018,Tajikistan,TJK,Netherlands,NLD,0,0,0,63,63
2018,Togo,TGO,Netherlands,NLD,0,0,5,0,5
2018,Trinidad and Tobago,TTO,Netherlands,NLD,18,0,10,0,28
2018,Tunisia,TUN,Netherlands,NLD,0,0,55,0,55
2018,Turkey,TUR,Netherlands,NLD,202,137,106,20,465
2018,Uganda,UGA,Netherlands,NLD,23,0,25,5,53
2018,Ukraine,UKR,Netherlands,NLD,0,0,202,16,218
2018,United States of America,USA,Netherlands,NLD,0,5,0,0,5
2018,Uzbekistan,UZB,Netherlands,NLD,0,0,5,0,5
2018,Venezuela (Bolivarian Republic of),VEN,Netherlands,NLD,0,0,70,0,70
2018,Yemen,YEM,Netherlands,NLD,127,0,10,0,137
2018,Stateless,XXA,Netherlands,NLD,39,0,25,0,64
2018,Central African Rep.,CAF,Nigeria,NGA,36,0,0,0,36
2018,Cameroon,CMR,Nigeria,NGA,64,0,0,0,64
2018,Dem. Rep. of the Congo,COD,Nigeria,NGA,14,0,36,0,50
2018,Eritrea,ERI,Nigeria,NGA,5,0,0,0,5
2018,Mali,MLI,Nigeria,NGA,0,0,5,0,5
2018,Niger,NER,Nigeria,NGA,5,0,0,0,5
2018,Syrian Arab Rep.,SYR,Nigeria,NGA,73,0,0,0,73
2018,Turkey,TUR,Nigeria,NGA,23,0,0,0,23
2018,Afghanistan,AFG,Norway,NOR,25,15,73,19,132
2018,Albania,ALB,Norway,NOR,0,0,32,11,43
2018,Algeria,DZA,Norway,NOR,0,0,0,12,12
2018,Angola,AGO,Norway,NOR,0,0,0,26,26
2018,Egypt,EGY,Norway,NOR,0,0,0,13,13
2018,Azerbaijan,AZE,Norway,NOR,0,0,0,5,5
2018,Bangladesh,BGD,Norway,NOR,0,0,0,5,5
2018,Belarus,BLR,Norway,NOR,0,0,0,5,5
2018,Bosnia and Herzegovina,BIH,Norway,NOR,0,0,5,0,5
2018,China,CHN,Norway,NOR,0,0,0,12,12
2018,Cameroon,CMR,Norway,NOR,0,0,12,0,12
2018,Dem. Rep. of the Congo,COD,Norway,NOR,0,0,0,12,12
2018,Cuba,CUB,Norway,NOR,0,0,0,5,5
2018,Eritrea,ERI,Norway,NOR,438,24,22,40,524
2018,Ethiopia,ETH,Norway,NOR,21,0,60,22,103
2018,Gambia,GMB,Norway,NOR,5,0,0,0,5
2018,Georgia,GEO,Norway,NOR,0,0,20,10,30
2018,Guinea,GIN,Norway,NOR,0,0,0,14,14
2018,Cote d'Ivoire,CIV,Norway,NOR,0,0,0,5,5
2018,India,IND,Norway,NOR,0,0,5,5,10
2018,Iran (Islamic Rep. of),IRN,Norway,NOR,38,0,65,36,139
2018,Iraq,IRQ,Norway,NOR,20,0,34,46,100
2018,Jordan,JOR,Norway,NOR,0,0,0,5,5
2018,Kazakhstan,KAZ,Norway,NOR,0,0,0,5,5
2018,Kenya,KEN,Norway,NOR,0,0,0,5,5
2018,Liberia,LBR,Norway,NOR,0,0,0,5,5
2018,Libya,LBY,Norway,NOR,5,0,0,5,10
2018,Lebanon,LBN,Norway,NOR,0,0,0,5,5
2018,Sri Lanka,LKA,Norway,NOR,0,0,5,0,5
2018,North Macedonia,MKD,Norway,NOR,0,0,10,0,10
2018,Morocco,MAR,Norway,NOR,0,0,5,15,20
2018,Myanmar,MMR,Norway,NOR,0,0,0,5,5
2018,Nigeria,NGA,Norway,NOR,0,0,15,13,28
2018,Pakistan,PAK,Norway,NOR,0,0,10,18,28
2018,Philippines,PHL,Norway,NOR,0,0,10,0,10
2018,Russian Federation,RUS,Norway,NOR,5,0,10,15,30
2018,Saudi Arabia,SAU,Norway,NOR,5,0,0,5,10
2018,Serbia and Kosovo: S/RES/1244 (1999),SRB,Norway,NOR,0,0,19,11,30
2018,Senegal,SEN,Norway,NOR,0,0,0,5,5
2018,Somalia,SOM,Norway,NOR,16,0,36,10,62
2018,Sudan,SDN,Norway,NOR,10,0,5,12,27
2018,Syrian Arab Rep.,SYR,Norway,NOR,569,0,0,85,654
2018,Tajikistan,TJK,Norway,NOR,0,0,0,5,5
2018,Tunisia,TUN,Norway,NOR,0,0,0,5,5
2018,Turkey,TUR,Norway,NOR,70,0,10,36,116
2018,Uganda,UGA,Norway,NOR,5,0,0,0,5
2018,Ukraine,UKR,Norway,NOR,0,0,26,10,36
2018,Uzbekistan,UZB,Norway,NOR,0,0,5,5,10
2018,Venezuela (Bolivarian Republic of),VEN,Norway,NOR,0,0,5,0,5
2018,Yemen,YEM,Norway,NOR,0,12,0,0,12
2018,Zimbabwe,ZWE,Norway,NOR,0,0,0,10,10
2018,Stateless,XXA,Norway,NOR,53,0,18,20,91
2018,Afghanistan,AFG,New Zealand,NZL,10,0,13,0,23
2018,Egypt,EGY,New Zealand,NZL,0,0,0,5,5
2018,Bangladesh,BGD,New Zealand,NZL,5,0,16,0,21
2018,Cambodia,KHM,New Zealand,NZL,5,0,0,0,5
2018,China,CHN,New Zealand,NZL,50,0,39,5,94
2018,Colombia,COL,New Zealand,NZL,5,0,5,0,10
2018,Ethiopia,ETH,New Zealand,NZL,0,0,5,0,5
2018,Fiji,FJI,New Zealand,NZL,0,0,5,0,5
2018,India,IND,New Zealand,NZL,5,0,30,5,40
2018,Iran (Islamic Rep. of),IRN,New Zealand,NZL,5,0,11,0,16
2018,Iraq,IRQ,New Zealand,NZL,0,0,5,0,5
2018,Jordan,JOR,New Zealand,NZL,0,0,10,0,10
2018,Sri Lanka,LKA,New Zealand,NZL,0,0,22,5,27
2018,Malaysia,MYS,New Zealand,NZL,0,0,0,12,12
2018,Myanmar,MMR,New Zealand,NZL,0,0,10,0,10
2018,Nigeria,NGA,New Zealand,NZL,0,0,10,0,10
2018,Pakistan,PAK,New Zealand,NZL,5,0,19,0,24
2018,Philippines,PHL,New Zealand,NZL,0,0,10,0,10
2018,Russian Federation,RUS,New Zealand,NZL,15,0,0,0,15
2018,Saudi Arabia,SAU,New Zealand,NZL,0,0,14,0,14
2018,Singapore,SGP,New Zealand,NZL,0,0,5,0,5
2018,Viet Nam,VNM,New Zealand,NZL,0,0,5,0,5
2018,Syrian Arab Rep.,SYR,New Zealand,NZL,5,0,0,0,5
2018,Turkey,TUR,New Zealand,NZL,13,0,10,0,23
2018,Ukraine,UKR,New Zealand,NZL,0,0,0,5,5
2018,Venezuela (Bolivarian Republic of),VEN,New Zealand,NZL,5,0,0,0,5
2018,Yemen,YEM,New Zealand,NZL,5,0,0,0,5
2018,Angola,AGO,Panama,PAN,0,0,0,5,5
2018,Colombia,COL,Panama,PAN,31,0,5,427,463
2018,Cuba,CUB,Panama,PAN,0,0,0,424,424
2018,Dominican Rep.,DOM,Panama,PAN,0,0,0,13,13
2018,Ecuador,ECU,Panama,PAN,0,0,0,5,5
2018,Haiti,HTI,Panama,PAN,0,0,0,5,5
2018,Honduras,HND,Panama,PAN,0,0,0,18,18
2018,Jamaica,JAM,Panama,PAN,0,0,0,5,5
2018,Nicaragua,NIC,Panama,PAN,0,0,0,213,213
2018,Peru,PER,Panama,PAN,0,0,0,5,5
2018,El Salvador,SLV,Panama,PAN,40,0,0,78,118
2018,Syrian Arab Rep.,SYR,Panama,PAN,5,0,0,0,5
2018,Venezuela (Bolivarian Republic of),VEN,Panama,PAN,13,0,0,3155,3168
2018,Bangladesh,BGD,Peru,PER,0,0,0,14,14
2018,Bolivia (Plurinational State of),BOL,Peru,PER,5,0,0,0,5
2018,Brazil,BRA,Peru,PER,5,0,0,0,5
2018,Cameroon,CMR,Peru,PER,10,0,0,0,10
2018,Colombia,COL,Peru,PER,10,0,5,67,82
2018,Cuba,CUB,Peru,PER,70,0,96,24,190
2018,Dominican Rep.,DOM,Peru,PER,5,0,0,0,5
2018,Ghana,GHA,Peru,PER,0,0,0,5,5
2018,Haiti,HTI,Peru,PER,20,0,0,5,25
2018,Philippines,PHL,Peru,PER,5,0,0,0,5
2018,Romania,ROU,Peru,PER,0,0,5,0,5
2018,El Salvador,SLV,Peru,PER,0,0,5,0,5
2018,Senegal,SEN,Peru,PER,0,0,0,5,5
2018,Syrian Arab Rep.,SYR,Peru,PER,5,0,0,0,5
2018,Turkey,TUR,Peru,PER,39,0,0,0,39
2018,Ukraine,UKR,Peru,PER,0,0,5,0,5
2018,Venezuela (Bolivarian Republic of),VEN,Peru,PER,390,0,191,1430,2011
2018,Iran (Islamic Rep. of),IRN,Papua New Guinea,PNG,0,0,5,0,5
2018,Afghanistan,AFG,Poland,POL,10,5,0,19,34
2018,Algeria,DZA,Poland,POL,0,0,0,13,13
2018,Egypt,EGY,Poland,POL,11,0,5,5,21
2018,Armenia,ARM,Poland,POL,0,0,52,36,88
2018,Azerbaijan,AZE,Poland,POL,0,5,25,10,40
2018,Bangladesh,BGD,Poland,POL,0,0,18,10,28
2018,Belarus,BLR,Poland,POL,5,5,19,10,39
2018,Bulgaria,BGR,Poland,POL,0,0,0,5,5
2018,China,CHN,Poland,POL,0,0,5,0,5
2018,Cameroon,CMR,Poland,POL,0,0,5,0,5
2018,Congo,COG,Poland,POL,0,0,5,0,5
2018,Cuba,CUB,Poland,POL,0,0,5,0,5
2018,Palestinian,PSE,Poland,POL,0,0,0,5,5
2018,Georgia,GEO,Poland,POL,0,0,49,12,61
2018,Guinea,GIN,Poland,POL,0,0,5,0,5
2018,India,IND,Poland,POL,0,0,12,5,17
2018,Iran (Islamic Rep. of),IRN,Poland,POL,10,0,13,5,28
2018,Iraq,IRQ,Poland,POL,19,10,10,22,61
2018,Kazakhstan,KAZ,Poland,POL,0,0,13,5,18
2018,Kyrgyzstan,KGZ,Poland,POL,5,0,42,5,52
2018,Libya,LBY,Poland,POL,0,12,0,0,12
2018,Lebanon,LBN,Poland,POL,0,0,5,0,5
2018,Rep. of Moldova,MDA,Poland,POL,0,0,5,5,10
2018,Nigeria,NGA,Poland,POL,0,0,12,0,12
2018,Pakistan,PAK,Poland,POL,14,0,26,14,54
2018,Russian Federation,RUS,Poland,POL,10,61,1210,1587,2868
2018,Viet Nam,VNM,Poland,POL,0,0,17,11,28
2018,Sudan,SDN,Poland,POL,0,0,5,0,5
2018,Syrian Arab Rep.,SYR,Poland,POL,17,5,0,0,22
2018,Tajikistan,TJK,Poland,POL,10,14,77,34,135
2018,Turkmenistan,TKM,Poland,POL,10,0,0,0,10
2018,Turkey,TUR,Poland,POL,26,0,20,15,61
2018,Ukraine,UKR,Poland,POL,11,74,443,89,617
2018,Uzbekistan,UZB,Poland,POL,0,0,0,5,5
2018,Yemen,YEM,Poland,POL,0,5,0,0,5
2018,Stateless,XXA,Poland,POL,13,0,0,5,18
2018,Afghanistan,AFG,Portugal,PRT,0,0,0,5,5
2018,Albania,ALB,Portugal,PRT,0,0,0,10,10
2018,Algeria,DZA,Portugal,PRT,0,0,5,0,5
2018,Angola,AGO,Portugal,PRT,0,0,65,150,215
2018,Armenia,ARM,Portugal,PRT,0,0,0,5,5
2018,Azerbaijan,AZE,Portugal,PRT,0,0,0,5,5
2018,Bangladesh,BGD,Portugal,PRT,0,0,5,0,5
2018,Burkina Faso,BFA,Portugal,PRT,0,0,0,5,5
2018,Brazil,BRA,Portugal,PRT,0,0,15,5,20
2018,China,CHN,Portugal,PRT,0,0,0,25,25
2018,Cameroon,CMR,Portugal,PRT,0,0,15,10,25
2018,Congo,COG,Portugal,PRT,0,0,5,5,10
2018,Dem. Rep. of the Congo,COD,Portugal,PRT,0,5,100,25,130
2018,Comoros,COM,Portugal,PRT,0,0,25,0,25
2018,Colombia,COL,Portugal,PRT,0,5,10,5,20
2018,Eritrea,ERI,Portugal,PRT,55,0,0,0,55
2018,Ethiopia,ETH,Portugal,PRT,5,0,0,0,5
2018,Gambia,GMB,Portugal,PRT,0,0,0,15,15
2018,Georgia,GEO,Portugal,PRT,0,0,0,5,5
2018,Ghana,GHA,Portugal,PRT,0,0,5,5,10
2018,Guinea-Bissau,GNB,Portugal,PRT,0,0,10,35,45
2018,Guinea,GIN,Portugal,PRT,0,0,20,60,80
2018,Haiti,HTI,Portugal,PRT,0,0,5,0,5
2018,Cote d'Ivoire,CIV,Portugal,PRT,0,0,5,15,20
2018,Iran (Islamic Rep. of),IRN,Portugal,PRT,0,0,0,15,15
2018,Iraq,IRQ,Portugal,PRT,20,85,5,0,110
2018,Kenya,KEN,Portugal,PRT,0,0,0,5,5
2018,Sri Lanka,LKA,Portugal,PRT,0,0,0,10,10
2018,Mauritania,MRT,Portugal,PRT,0,0,5,0,5
2018,Mali,MLI,Portugal,PRT,0,0,5,5,10
2018,Morocco,MAR,Portugal,PRT,0,0,10,20,30
2018,Nigeria,NGA,Portugal,PRT,0,0,10,10,20
2018,Pakistan,PAK,Portugal,PRT,0,5,20,20,45
2018,Russian Federation,RUS,Portugal,PRT,0,0,5,10,15
2018,Senegal,SEN,Portugal,PRT,0,0,10,10,20
2018,Sierra Leone,SLE,Portugal,PRT,0,0,5,15,20
2018,Somalia,SOM,Portugal,PRT,5,0,0,30,35
2018,Sudan,SDN,Portugal,PRT,20,0,0,5,25
2018,Syrian Arab Rep.,SYR,Portugal,PRT,65,230,0,0,295
2018,United Rep. of Tanzania,TZA,Portugal,PRT,0,0,0,5,5
2018,Tajikistan,TJK,Portugal,PRT,0,0,0,5,5
2018,Togo,TGO,Portugal,PRT,0,0,10,0,10
2018,Turkey,TUR,Portugal,PRT,0,0,0,25,25
2018,Ukraine,UKR,Portugal,PRT,0,50,20,35,105
2018,Venezuela (Bolivarian Republic of),VEN,Portugal,PRT,0,0,10,30,40
2018,Yemen,YEM,Portugal,PRT,0,5,0,0,5
2018,Zimbabwe,ZWE,Portugal,PRT,0,0,0,5,5
2018,Stateless,XXA,Portugal,PRT,0,10,0,0,10
2018,Afghanistan,AFG,Romania,ROU,10,5,54,44,113
2018,Albania,ALB,Romania,ROU,0,0,0,5,5
2018,Algeria,DZA,Romania,ROU,0,0,5,5,10
2018,Egypt,EGY,Romania,ROU,0,0,5,0,5
2018,Bangladesh,BGD,Romania,ROU,0,0,70,17,87
2018,China,CHN,Romania,ROU,0,0,5,0,5
2018,Cameroon,CMR,Romania,ROU,0,0,10,0,10
2018,Congo,COG,Romania,ROU,0,0,5,0,5
2018,Dem. Rep. of the Congo,COD,Romania,ROU,0,0,10,0,10
2018,Eritrea,ERI,Romania,ROU,5,0,0,0,5
2018,Palestinian,PSE,Romania,ROU,10,0,12,18,40
2018,Georgia,GEO,Romania,ROU,0,0,0,5,5
2018,Guinea,GIN,Romania,ROU,0,0,5,0,5
2018,India,IND,Romania,ROU,0,0,47,11,58
2018,Iran (Islamic Rep. of),IRN,Romania,ROU,22,0,71,134,227
2018,Iraq,IRQ,Romania,ROU,93,56,313,982,1444
2018,Lebanon,LBN,Romania,ROU,0,0,0,5,5
2018,Sri Lanka,LKA,Romania,ROU,0,0,27,0,27
2018,Rep. of Moldova,MDA,Romania,ROU,0,0,12,10,22
2018,Morocco,MAR,Romania,ROU,0,0,5,0,5
2018,Nigeria,NGA,Romania,ROU,0,0,17,0,17
2018,Pakistan,PAK,Romania,ROU,5,5,43,5,58
2018,Philippines,PHL,Romania,ROU,0,0,5,0,5
2018,Russian Federation,RUS,Romania,ROU,0,0,5,0,5
2018,Rwanda,RWA,Romania,ROU,0,0,5,0,5
2018,Serbia and Kosovo: S/RES/1244 (1999),SRB,Romania,ROU,0,0,14,5,19
2018,Somalia,SOM,Romania,ROU,23,5,5,0,33
2018,Viet Nam,VNM,Romania,ROU,0,0,5,0,5
2018,Sudan,SDN,Romania,ROU,0,0,5,0,5
2018,Syrian Arab Rep.,SYR,Romania,ROU,117,209,5,61,392
2018,Tunisia,TUN,Romania,ROU,0,0,5,5,10
2018,Turkey,TUR,Romania,ROU,10,0,54,35,99
2018,Ukraine,UKR,Romania,ROU,0,0,15,5,20
2018,Venezuela (Bolivarian Republic of),VEN,Romania,ROU,0,0,5,5,10
2018,Yemen,YEM,Romania,ROU,5,0,5,0,10
2018,Stateless,XXA,Romania,ROU,5,5,5,0,15
2018,Algeria,DZA,South Africa,ZAF,0,0,5,0,5
2018,Egypt,EGY,South Africa,ZAF,0,0,43,0,43
2018,Burundi,BDI,South Africa,ZAF,31,0,418,0,449
2018,Benin,BEN,South Africa,ZAF,0,0,5,0,5
2018,Bangladesh,BGD,South Africa,ZAF,0,0,1224,0,1224
2018,Cameroon,CMR,South Africa,ZAF,0,0,124,0,124
2018,Congo,COG,South Africa,ZAF,12,0,52,0,64
2018,Dem. Rep. of the Congo,COD,South Africa,ZAF,262,0,1549,0,1811
2018,Eritrea,ERI,South Africa,ZAF,17,0,152,0,169
2018,Ethiopia,ETH,South Africa,ZAF,167,0,1402,0,1569
2018,Gambia,GMB,South Africa,ZAF,0,0,5,0,5
2018,Ghana,GHA,South Africa,ZAF,0,0,166,0,166
2018,India,IND,South Africa,ZAF,0,0,156,0,156
2018,Kenya,KEN,South Africa,ZAF,0,0,32,0,32
2018,Liberia,LBR,South Africa,ZAF,0,0,5,0,5
2018,Mali,MLI,South Africa,ZAF,0,0,5,0,5
2018,Malawi,MWI,South Africa,ZAF,0,0,253,0,253
2018,Mozambique,MOZ,South Africa,ZAF,0,0,52,0,52
2018,Nepal,NPL,South Africa,ZAF,0,0,11,0,11
2018,Nigeria,NGA,South Africa,ZAF,0,0,413,0,413
2018,Pakistan,PAK,South Africa,ZAF,0,0,385,0,385
2018,Rwanda,RWA,South Africa,ZAF,0,0,42,0,42
2018,Senegal,SEN,South Africa,ZAF,0,0,83,0,83
2018,Somalia,SOM,South Africa,ZAF,136,0,281,0,417
2018,Syrian Arab Rep.,SYR,South Africa,ZAF,0,0,5,0,5
2018,United Rep. of Tanzania,TZA,South Africa,ZAF,0,0,52,0,52
2018,Thailand,THA,South Africa,ZAF,0,0,10,0,10
2018,Uganda,UGA,South Africa,ZAF,0,0,271,0,271
2018,Zambia,ZMB,South Africa,ZAF,0,0,19,0,19
2018,Zimbabwe,ZWE,South Africa,ZAF,5,0,788,0,793
2018,Afghanistan,AFG,Russian Federation,RUS,0,0,0,180,180
2018,Argentina,ARG,Russian Federation,RUS,0,0,0,5,5
2018,Azerbaijan,AZE,Russian Federation,RUS,0,0,0,10,10
2018,Cameroon,CMR,Russian Federation,RUS,0,0,0,5,5
2018,Dem. Rep. of the Congo,COD,Russian Federation,RUS,0,0,0,5,5
2018,Georgia,GEO,Russian Federation,RUS,0,0,0,5,5
2018,Germany,DEU,Russian Federation,RUS,0,0,0,5,5
2018,Kazakhstan,KAZ,Russian Federation,RUS,0,0,0,10,10
2018,Kyrgyzstan,KGZ,Russian Federation,RUS,0,0,0,10,10
2018,Dem. People's Rep. of Korea,PRK,Russian Federation,RUS,0,0,0,5,5
2018,Rep. of Moldova,MDA,Russian Federation,RUS,5,0,0,5,10
2018,Pakistan,PAK,Russian Federation,RUS,0,0,0,5,5
2018,Sudan,SDN,Russian Federation,RUS,0,0,0,5,5
2018,Syrian Arab Rep.,SYR,Russian Federation,RUS,0,0,0,123,123
2018,Tajikistan,TJK,Russian Federation,RUS,0,0,0,18,18
2018,Turkmenistan,TKM,Russian Federation,RUS,0,0,0,5,5
2018,Ukraine,UKR,Russian Federation,RUS,21,0,0,70,91
2018,Uzbekistan,UZB,Russian Federation,RUS,0,0,0,16,16
2018,Yemen,YEM,Russian Federation,RUS,0,0,0,22,22
2018,Burundi,BDI,Rwanda,RWA,25,0,0,44,69
2018,Dem. Rep. of the Congo,COD,Rwanda,RWA,5,0,0,151,156
2018,Eritrea,ERI,Rwanda,RWA,0,0,0,5,5
2018,South Sudan,SSD,Rwanda,RWA,5,0,0,0,5
2018,Honduras,HND,El Salvador,SLV,5,0,0,0,5
2018,Nicaragua,NIC,El Salvador,SLV,0,0,5,5,10
2018,Afghanistan,AFG,Serbia and Kosovo: S/RES/1244 (1999),SRB,5,0,5,56,66
2018,Algeria,DZA,Serbia and Kosovo: S/RES/1244 (1999),SRB,0,0,0,45,45
2018,Cuba,CUB,Serbia and Kosovo: S/RES/1244 (1999),SRB,0,0,0,10,10
2018,Palestinian,PSE,Serbia and Kosovo: S/RES/1244 (1999),SRB,0,0,0,76,76
2018,Ghana,GHA,Serbia and Kosovo: S/RES/1244 (1999),SRB,0,0,0,10,10
2018,Iran (Islamic Rep. of),IRN,Serbia and Kosovo: S/RES/1244 (1999),SRB,5,0,5,80,90
2018,Iraq,IRQ,Serbia and Kosovo: S/RES/1244 (1999),SRB,0,0,0,50,50
2018,Libya,LBY,Serbia and Kosovo: S/RES/1244 (1999),SRB,0,11,0,32,43
2018,Morocco,MAR,Serbia and Kosovo: S/RES/1244 (1999),SRB,0,0,0,38,38
2018,Nigeria,NGA,Serbia and Kosovo: S/RES/1244 (1999),SRB,0,0,0,5,5
2018,Pakistan,PAK,Serbia and Kosovo: S/RES/1244 (1999),SRB,0,0,5,74,79
2018,Syrian Arab Rep.,SYR,Serbia and Kosovo: S/RES/1244 (1999),SRB,0,0,0,248,248
2018,Tunisia,TUN,Serbia and Kosovo: S/RES/1244 (1999),SRB,0,0,0,5,5
2018,Turkey,TUR,Serbia and Kosovo: S/RES/1244 (1999),SRB,62,0,0,13,75
2018,Afghanistan,AFG,Spain,ESP,15,45,14,0,74
2018,Albania,ALB,Spain,ESP,0,0,15,0,15
2018,Algeria,DZA,Spain,ESP,0,0,211,0,211
2018,Egypt,EGY,Spain,ESP,0,0,23,0,23
2018,Argentina,ARG,Spain,ESP,0,0,10,0,10
2018,Armenia,ARM,Spain,ESP,5,0,54,0,59
2018,Azerbaijan,AZE,Spain,ESP,15,0,0,0,15
2018,Benin,BEN,Spain,ESP,0,0,5,0,5
2018,Bangladesh,BGD,Spain,ESP,0,0,71,0,71
2018,Burkina Faso,BFA,Spain,ESP,0,0,13,0,13
2018,Belarus,BLR,Spain,ESP,0,0,5,0,5
2018,Brazil,BRA,Spain,ESP,0,0,5,0,5
2018,Bosnia and Herzegovina,BIH,Spain,ESP,0,0,5,0,5
2018,Bulgaria,BGR,Spain,ESP,0,0,5,0,5
2018,Central African Rep.,CAF,Spain,ESP,0,31,0,0,31
2018,Chad,TCD,Spain,ESP,0,0,5,0,5
2018,China,CHN,Spain,ESP,0,0,219,0,219
2018,Cameroon,CMR,Spain,ESP,17,0,43,0,60
2018,Dem. Rep. of the Congo,COD,Spain,ESP,0,0,14,0,14
2018,Colombia,COL,Spain,ESP,50,0,690,0,740
2018,Costa Rica,CRI,Spain,ESP,0,0,15,0,15
2018,Cuba,CUB,Spain,ESP,0,5,13,0,18
2018,Dominican Rep.,DOM,Spain,ESP,0,0,29,0,29
2018,Ecuador,ECU,Spain,ESP,0,0,10,0,10
2018,Eritrea,ERI,Spain,ESP,52,0,0,0,52
2018,Ethiopia,ETH,Spain,ESP,0,0,10,0,10
2018,Gambia,GMB,Spain,ESP,5,0,65,0,70
2018,Palestinian,PSE,Spain,ESP,87,122,41,0,250
2018,Georgia,GEO,Spain,ESP,0,0,67,0,67
2018,Ghana,GHA,Spain,ESP,0,0,20,0,20
2018,Guinea-Bissau,GNB,Spain,ESP,0,0,5,0,5
2018,Guatemala,GTM,Spain,ESP,5,0,22,0,27
2018,Guinea,GIN,Spain,ESP,5,0,133,0,138
2018,Haiti,HTI,Spain,ESP,0,0,5,0,5
2018,Honduras,HND,Spain,ESP,10,0,103,0,113
2018,Cote d'Ivoire,CIV,Spain,ESP,5,5,79,0,89
2018,India,IND,Spain,ESP,0,0,28,0,28
2018,Iran (Islamic Rep. of),IRN,Spain,ESP,5,0,13,0,18
2018,Iraq,IRQ,Spain,ESP,13,54,19,0,86
2018,Italy,ITA,Spain,ESP,0,0,5,0,5
2018,Lebanon,LBN,Spain,ESP,0,0,45,0,45
2018,Sri Lanka,LKA,Spain,ESP,11,0,0,0,11
2018,Mauritania,MRT,Spain,ESP,0,0,5,0,5
2018,Rep. of Moldova,MDA,Spain,ESP,0,0,21,0,21
2018,Mexico,MEX,Spain,ESP,5,0,40,0,45
2018,Mali,MLI,Spain,ESP,5,5,178,0,188
2018,Mongolia,MNG,Spain,ESP,5,0,0,0,5
2018,Morocco,MAR,Spain,ESP,64,0,132,0,196
2018,Niger,NER,Spain,ESP,0,0,5,0,5
2018,Nicaragua,NIC,Spain,ESP,5,0,18,0,23
2018,Nigeria,NGA,Spain,ESP,10,0,12,0,22
2018,Pakistan,PAK,Spain,ESP,25,5,58,0,88
2018,Panama,PAN,Spain,ESP,0,0,10,0,10
2018,Peru,PER,Spain,ESP,0,0,30,0,30
2018,Romania,ROU,Spain,ESP,0,0,5,0,5
2018,Russian Federation,RUS,Spain,ESP,32,0,75,0,107
2018,Rwanda,RWA,Spain,ESP,0,0,5,0,5
2018,El Salvador,SLV,Spain,ESP,0,0,114,0,114
2018,Serbia and Kosovo: S/RES/1244 (1999),SRB,Spain,ESP,0,0,12,0,12
2018,Senegal,SEN,Spain,ESP,0,0,46,0,46
2018,Sierra Leone,SLE,Spain,ESP,0,0,19,0,19
2018,Somalia,SOM,Spain,ESP,0,89,31,0,120
2018,Sudan,SDN,Spain,ESP,0,0,12,0,12
2018,Syrian Arab Rep.,SYR,Spain,ESP,31,1996,135,0,2162
2018,Tunisia,TUN,Spain,ESP,0,0,13,0,13
2018,Turkey,TUR,Spain,ESP,17,0,5,0,22
2018,Ukraine,UKR,Spain,ESP,73,122,2681,0,2876
2018,United States of America,USA,Spain,ESP,0,0,5,0,5
2018,Uzbekistan,UZB,Spain,ESP,5,0,0,0,5
2018,Venezuela (Bolivarian Republic of),VEN,Spain,ESP,29,0,1630,0,1659
2018,Western Sahara,ESH,Spain,ESP,0,0,12,0,12
2018,Yemen,YEM,Spain,ESP,10,72,0,0,82
2018,Cuba,CUB,Saint Kitts and Nevis,KNA,5,0,0,0,5
2018,Egypt,EGY,Sudan,SDN,0,0,0,16,16
2018,Burundi,BDI,Sudan,SDN,5,0,0,0,5
2018,Congo,COG,Sudan,SDN,0,0,0,5,5
2018,Dem. Rep. of the Congo,COD,Sudan,SDN,10,0,0,0,10
2018,Eritrea,ERI,Sudan,SDN,2673,0,5,0,2678
2018,Ethiopia,ETH,Sudan,SDN,898,0,467,0,1365
2018,Palestinian,PSE,Sudan,SDN,0,0,0,30,30
2018,Iraq,IRQ,Sudan,SDN,0,0,0,5,5
2018,Nigeria,NGA,Sudan,SDN,0,0,0,10,10
2018,Somalia,SOM,Sudan,SDN,166,0,0,0,166
2018,Syrian Arab Rep.,SYR,Sudan,SDN,5,0,0,253,258
2018,Yemen,YEM,Sudan,SDN,0,0,0,2472,2472
2018,Burundi,BDI,South Sudan,SSD,0,11,0,0,11
2018,Eritrea,ERI,South Sudan,SSD,0,41,0,0,41
2018,Ethiopia,ETH,South Sudan,SSD,0,12,0,0,12
2018,Afghanistan,AFG,Slovenia,SVN,5,0,106,370,481
2018,Albania,ALB,Slovenia,SVN,0,0,0,16,16
2018,Algeria,DZA,Slovenia,SVN,0,0,102,420,522
2018,Egypt,EGY,Slovenia,SVN,0,0,5,10,15
2018,Azerbaijan,AZE,Slovenia,SVN,0,0,0,10,10
2018,Bangladesh,BGD,Slovenia,SVN,0,0,0,60,60
2018,China,CHN,Slovenia,SVN,0,0,0,5,5
2018,Dem. Rep. of the Congo,COD,Slovenia,SVN,0,0,5,0,5
2018,Eritrea,ERI,Slovenia,SVN,27,0,0,20,47
2018,Gambia,GMB,Slovenia,SVN,0,0,5,0,5
2018,Palestinian,PSE,Slovenia,SVN,0,0,0,19,19
2018,Ghana,GHA,Slovenia,SVN,0,0,0,5,5
2018,India,IND,Slovenia,SVN,0,0,5,31,36
2018,Iran (Islamic Rep. of),IRN,Slovenia,SVN,5,0,27,122,154
2018,Iraq,IRQ,Slovenia,SVN,5,0,15,63,83
2018,Libya,LBY,Slovenia,SVN,0,0,10,22,32
2018,Sri Lanka,LKA,Slovenia,SVN,0,0,0,5,5
2018,Morocco,MAR,Slovenia,SVN,0,0,35,145,180
2018,Myanmar,MMR,Slovenia,SVN,0,0,0,5,5
2018,Nepal,NPL,Slovenia,SVN,0,0,0,27,27
2018,Nigeria,NGA,Slovenia,SVN,0,0,5,0,5
2018,Pakistan,PAK,Slovenia,SVN,0,0,16,782,798
2018,Russian Federation,RUS,Slovenia,SVN,0,0,5,16,21
2018,Serbia and Kosovo: S/RES/1244 (1999),SRB,Slovenia,SVN,0,0,15,38,53
2018,Viet Nam,VNM,Slovenia,SVN,0,0,0,5,5
2018,Syrian Arab Rep.,SYR,Slovenia,SVN,41,0,21,88,150
2018,Tunisia,TUN,Slovenia,SVN,0,0,17,27,44
2018,Turkey,TUR,Slovenia,SVN,12,0,15,62,89
2018,Burundi,BDI,Eswatini,SWZ,18,0,0,0,18
2018,Congo,COG,Eswatini,SWZ,10,0,0,0,10
2018,Dem. Rep. of the Congo,COD,Eswatini,SWZ,14,0,0,0,14
2018,Ethiopia,ETH,Eswatini,SWZ,5,0,0,0,5
2018,Rwanda,RWA,Eswatini,SWZ,11,0,0,0,11
2018,Somalia,SOM,Eswatini,SWZ,15,0,0,0,15
2018,Afghanistan,AFG,Sweden,SWE,1286,714,4549,185,6734
2018,Albania,ALB,Sweden,SWE,0,5,396,172,573
2018,Algeria,DZA,Sweden,SWE,0,0,45,71,116
2018,Angola,AGO,Sweden,SWE,0,0,16,24,40
2018,Egypt,EGY,Sweden,SWE,17,0,175,68,260
2018,Armenia,ARM,Sweden,SWE,0,0,113,37,150
2018,Azerbaijan,AZE,Sweden,SWE,27,5,155,104,291
2018,Bahrain,BHR,Sweden,SWE,0,0,5,0,5
2018,Burundi,BDI,Sweden,SWE,14,0,18,19,51
2018,Benin,BEN,Sweden,SWE,5,0,0,0,5
2018,Bangladesh,BGD,Sweden,SWE,21,0,130,32,183
2018,Burkina Faso,BFA,Sweden,SWE,0,0,0,5,5
2018,Belarus,BLR,Sweden,SWE,5,0,52,66,123
2018,Bolivia (Plurinational State of),BOL,Sweden,SWE,0,0,23,10,33
2018,Brazil,BRA,Sweden,SWE,0,0,5,5,10
2018,Bosnia and Herzegovina,BIH,Sweden,SWE,0,0,62,24,86
2018,Canada,CAN,Sweden,SWE,0,0,5,5,10
2018,Central African Rep.,CAF,Sweden,SWE,0,0,0,5,5
2018,Chad,TCD,Sweden,SWE,0,0,0,5,5
2018,China,CHN,Sweden,SWE,10,0,19,11,40
2018,Chile,CHL,Sweden,SWE,0,0,27,5,32
2018,Cameroon,CMR,Sweden,SWE,10,0,54,28,92
2018,Congo,COG,Sweden,SWE,0,0,5,0,5
2018,Dem. Rep. of the Congo,COD,Sweden,SWE,0,0,20,18,38
2018,Colombia,COL,Sweden,SWE,5,0,198,31,234
2018,Cuba,CUB,Sweden,SWE,0,0,20,33,53
2018,Djibouti,DJI,Sweden,SWE,0,0,5,5,10
2018,Dominica,DMA,Sweden,SWE,0,0,0,5,5
2018,Ecuador,ECU,Sweden,SWE,0,0,19,0,19
2018,Equatorial Guinea,GNQ,Sweden,SWE,5,0,0,0,5
2018,Eritrea,ERI,Sweden,SWE,585,46,75,130,836
2018,Ethiopia,ETH,Sweden,SWE,160,10,282,64,516
2018,Gabon,GAB,Sweden,SWE,0,0,5,0,5
2018,Gambia,GMB,Sweden,SWE,13,0,58,54,125
2018,Palestinian,PSE,Sweden,SWE,47,10,216,75,348
2018,United Kingdom of Great Britain and Northern Ireland,GBR,Sweden,SWE,0,0,5,0,5
2018,Georgia,GEO,Sweden,SWE,0,0,751,387,1138
2018,Ghana,GHA,Sweden,SWE,5,0,19,24,48
2018,Guinea-Bissau,GNB,Sweden,SWE,0,0,0,5,5
2018,Greece,GRC,Sweden,SWE,0,0,0,5,5
2018,Guatemala,GTM,Sweden,SWE,0,0,5,0,5
2018,Guinea,GIN,Sweden,SWE,0,0,13,18,31
2018,Honduras,HND,Sweden,SWE,0,0,22,5,27
2018,Croatia,HRV,Sweden,SWE,0,0,0,5,5
2018,Hungary,HUN,Sweden,SWE,0,0,5,0,5
2018,Cote d'Ivoire,CIV,Sweden,SWE,0,0,5,14,19
2018,India,IND,Sweden,SWE,0,0,34,24,58
2018,Iran (Islamic Rep. of),IRN,Sweden,SWE,655,11,1004,217,1887
2018,Iraq,IRQ,Sweden,SWE,616,187,2621,330,3754
2018,Israel,ISR,Sweden,SWE,0,0,5,0,5
2018,Italy,ITA,Sweden,SWE,0,0,0,5,5
2018,Jordan,JOR,Sweden,SWE,10,0,108,25,143
2018,Kazakhstan,KAZ,Sweden,SWE,5,5,85,97,192
2018,Kenya,KEN,Sweden,SWE,10,0,11,10,31
2018,Kyrgyzstan,KGZ,Sweden,SWE,0,0,79,68,147
2018,Rep. of Korea,KOR,Sweden,SWE,0,0,5,0,5
2018,Kuwait,KWT,Sweden,SWE,0,0,41,5,46
2018,Liberia,LBR,Sweden,SWE,0,0,5,0,5
2018,Libya,LBY,Sweden,SWE,5,0,19,72,96
2018,Lebanon,LBN,Sweden,SWE,15,0,191,87,293
2018,Sri Lanka,LKA,Sweden,SWE,0,0,11,16,27
2018,Mauritania,MRT,Sweden,SWE,0,0,5,5,10
2018,North Macedonia,MKD,Sweden,SWE,0,0,55,19,74
2018,Rep. of Moldova,MDA,Sweden,SWE,0,0,10,5,15
2018,Mexico,MEX,Sweden,SWE,0,0,5,5,10
2018,Mali,MLI,Sweden,SWE,0,0,5,5,10
2018,Malaysia,MYS,Sweden,SWE,5,0,0,0,5
2018,Mongolia,MNG,Sweden,SWE,0,0,318,55,373
2018,Morocco,MAR,Sweden,SWE,10,0,162,206,378
2018,Montenegro,MNE,Sweden,SWE,0,0,19,5,24
2018,Nepal,NPL,Sweden,SWE,0,0,15,0,15
2018,Nicaragua,NIC,Sweden,SWE,0,0,124,15,139
2018,Nigeria,NGA,Sweden,SWE,27,0,183,141,351
2018,Norway,NOR,Sweden,SWE,0,0,0,5,5
2018,Pakistan,PAK,Sweden,SWE,44,0,142,83,269
2018,Paraguay,PRY,Sweden,SWE,0,0,5,0,5
2018,Peru,PER,Sweden,SWE,0,0,90,24,114
2018,Philippines,PHL,Sweden,SWE,0,0,19,5,24
2018,Poland,POL,Sweden,SWE,0,0,5,0,5
2018,Romania,ROU,Sweden,SWE,0,0,0,5,5
2018,South Africa,ZAF,Sweden,SWE,0,0,0,12,12
2018,Russian Federation,RUS,Sweden,SWE,44,0,167,113,324
2018,Rwanda,RWA,Sweden,SWE,0,0,11,5,16
2018,El Salvador,SLV,Sweden,SWE,0,5,172,19,196
2018,Saudi Arabia,SAU,Sweden,SWE,0,0,0,13,13
2018,Serbia and Kosovo: S/RES/1244 (1999),SRB,Sweden,SWE,0,0,182,113,295
2018,Senegal,SEN,Sweden,SWE,0,0,13,17,30
2018,Sierra Leone,SLE,Sweden,SWE,0,0,5,14,19
2018,Somalia,SOM,Sweden,SWE,379,55,550,190,1174
2018,Spain,ESP,Sweden,SWE,0,0,5,5,10
2018,Viet Nam,VNM,Sweden,SWE,0,0,37,13,50
2018,Sudan,SDN,Sweden,SWE,51,0,57,14,122
2018,South Sudan,SSD,Sweden,SWE,0,0,0,5,5
2018,Slovakia,SVK,Sweden,SWE,0,0,5,0,5
2018,Syrian Arab Rep.,SYR,Sweden,SWE,330,2493,186,440,3449
2018,United Rep. of Tanzania,TZA,Sweden,SWE,5,0,18,5,28
2018,Thailand,THA,Sweden,SWE,0,0,13,0,13
2018,Tajikistan,TJK,Sweden,SWE,0,0,35,18,53
2018,Tunisia,TUN,Sweden,SWE,0,0,56,54,110
2018,Turkey,TUR,Sweden,SWE,589,0,379,88,1056
2018,Uganda,UGA,Sweden,SWE,17,0,24,17,58
2018,Ukraine,UKR,Sweden,SWE,5,0,348,126,479
2018,United States of America,USA,Sweden,SWE,0,0,12,5,17
2018,Uzbekistan,UZB,Sweden,SWE,15,0,180,182,377
2018,Venezuela (Bolivarian Republic of),VEN,Sweden,SWE,0,0,77,14,91
2018,Yemen,YEM,Sweden,SWE,76,151,5,27,259
2018,Zambia,ZMB,Sweden,SWE,0,0,5,0,5
2018,Zimbabwe,ZWE,Sweden,SWE,0,0,5,0,5
2018,Stateless,XXA,Sweden,SWE,278,114,312,161,865
2018,Afghanistan,AFG,Switzerland,CHE,741,3942,194,353,5230
2018,Albania,ALB,Switzerland,CHE,5,5,69,31,110
2018,Algeria,DZA,Switzerland,CHE,5,0,129,624,758
2018,Angola,AGO,Switzerland,CHE,0,22,10,42,74
2018,Egypt,EGY,Switzerland,CHE,5,5,5,27,42
2018,Armenia,ARM,Switzerland,CHE,0,17,39,31,87
2018,Azerbaijan,AZE,Switzerland,CHE,11,5,14,29,59
2018,Burundi,BDI,Switzerland,CHE,23,5,0,0,28
2018,Benin,BEN,Switzerland,CHE,0,0,5,5,10
2018,Bangladesh,BGD,Switzerland,CHE,0,0,0,13,13
2018,Burkina Faso,BFA,Switzerland,CHE,0,0,0,11,11
2018,Belarus,BLR,Switzerland,CHE,0,0,21,41,62
2018,Bosnia and Herzegovina,BIH,Switzerland,CHE,0,5,26,32,63
2018,Canada,CAN,Switzerland,CHE,0,0,0,5,5
2018,Central African Rep.,CAF,Switzerland,CHE,0,5,0,0,5
2018,Chad,TCD,Switzerland,CHE,0,5,0,5,10
2018,China,CHN,Switzerland,CHE,62,211,138,15,426
2018,Cameroon,CMR,Switzerland,CHE,0,5,19,63,87
2018,Congo,COG,Switzerland,CHE,5,0,0,0,5
2018,Dem. Rep. of the Congo,COD,Switzerland,CHE,10,33,38,26,107
2018,Colombia,COL,Switzerland,CHE,0,5,45,5,55
2018,Cuba,CUB,Switzerland,CHE,0,0,0,5,5
2018,Czechia,CZE,Switzerland,CHE,0,0,5,0,5
2018,Djibouti,DJI,Switzerland,CHE,0,0,0,5,5
2018,Equatorial Guinea,GNQ,Switzerland,CHE,0,5,0,0,5
2018,Eritrea,ERI,Switzerland,CHE,2981,908,943,284,5116
2018,Ethiopia,ETH,Switzerland,CHE,89,133,208,124,554
2018,France,FRA,Switzerland,CHE,0,0,0,5,5
2018,Gabon,GAB,Switzerland,CHE,0,0,5,0,5
2018,Gambia,GMB,Switzerland,CHE,0,5,19,207,231
2018,Georgia,GEO,Switzerland,CHE,0,28,414,508,950
2018,Germany,DEU,Switzerland,CHE,0,0,11,0,11
2018,Ghana,GHA,Switzerland,CHE,0,0,13,43,56
2018,Guinea-Bissau,GNB,Switzerland,CHE,0,5,5,28,38
2018,Guinea,GIN,Switzerland,CHE,5,14,70,220,309
2018,Honduras,HND,Switzerland,CHE,0,0,5,0,5
2018,Hungary,HUN,Switzerland,CHE,0,0,0,5,5
2018,Cote d'Ivoire,CIV,Switzerland,CHE,5,15,5,74,99
2018,India,IND,Switzerland,CHE,0,0,23,17,40
2018,Iran (Islamic Rep. of),IRN,Switzerland,CHE,107,86,237,122,552
2018,Iraq,IRQ,Switzerland,CHE,215,615,342,246,1418
2018,Israel,ISR,Switzerland,CHE,0,0,0,5,5
2018,Italy,ITA,Switzerland,CHE,0,0,0,5,5
2018,Jordan,JOR,Switzerland,CHE,5,0,0,5,10
2018,Kenya,KEN,Switzerland,CHE,0,0,0,5,5
2018,Liberia,LBR,Switzerland,CHE,0,0,0,10,10
2018,Libya,LBY,Switzerland,CHE,10,11,13,134,168
2018,Lebanon,LBN,Switzerland,CHE,0,0,5,21,26
2018,Sri Lanka,LKA,Switzerland,CHE,322,99,586,148,1155
2018,Lithuania,LTU,Switzerland,CHE,0,0,5,0,5
2018,Mauritania,MRT,Switzerland,CHE,0,0,0,13,13
2018,North Macedonia,MKD,Switzerland,CHE,5,0,46,29,80
2018,Rep. of Moldova,MDA,Switzerland,CHE,0,0,5,5,10
2018,Mexico,MEX,Switzerland,CHE,0,0,5,0,5
2018,Mali,MLI,Switzerland,CHE,5,5,5,49,64
2018,Mongolia,MNG,Switzerland,CHE,0,16,14,42,72
2018,Morocco,MAR,Switzerland,CHE,10,0,64,438,512
2018,Mozambique,MOZ,Switzerland,CHE,0,0,0,5,5
2018,Montenegro,MNE,Switzerland,CHE,0,5,0,0,5
2018,Myanmar,MMR,Switzerland,CHE,0,0,0,5,5
2018,Nepal,NPL,Switzerland,CHE,0,0,5,0,5
2018,Niger,NER,Switzerland,CHE,0,0,0,10,10
2018,Nicaragua,NIC,Switzerland,CHE,0,0,5,0,5
2018,Nigeria,NGA,Switzerland,CHE,5,29,31,506,571
2018,Pakistan,PAK,Switzerland,CHE,29,31,99,74,233
2018,Poland,POL,Switzerland,CHE,0,0,0,5,5
2018,Romania,ROU,Switzerland,CHE,0,0,13,0,13
2018,South Africa,ZAF,Switzerland,CHE,0,0,0,5,5
2018,Russian Federation,RUS,Switzerland,CHE,25,28,34,118,205
2018,Rwanda,RWA,Switzerland,CHE,5,0,0,0,5
2018,El Salvador,SLV,Switzerland,CHE,5,0,5,0,10
2018,Saudi Arabia,SAU,Switzerland,CHE,0,0,0,5,5
2018,Serbia and Kosovo: S/RES/1244 (1999),SRB,Switzerland,CHE,5,40,127,108,280
2018,Senegal,SEN,Switzerland,CHE,10,5,10,57,82
2018,Sierra Leone,SLE,Switzerland,CHE,0,0,5,26,31
2018,Somalia,SOM,Switzerland,CHE,159,355,84,362,960
2018,Spain,ESP,Switzerland,CHE,0,0,5,5,10
2018,Sudan,SDN,Switzerland,CHE,14,21,38,27,100
2018,South Sudan,SSD,Switzerland,CHE,0,0,0,5,5
2018,Slovakia,SVK,Switzerland,CHE,0,0,0,5,5
2018,Syrian Arab Rep.,SYR,Switzerland,CHE,1070,1563,180,181,2994
2018,United Rep. of Tanzania,TZA,Switzerland,CHE,0,0,0,5,5
2018,Tajikistan,TJK,Switzerland,CHE,5,0,0,12,17
2018,Togo,TGO,Switzerland,CHE,12,5,18,15,50
2018,Tunisia,TUN,Switzerland,CHE,0,0,49,278,327
2018,Turkey,TUR,Switzerland,CHE,280,45,184,130,639
2018,Uganda,UGA,Switzerland,CHE,0,0,5,14,19
2018,Ukraine,UKR,Switzerland,CHE,10,5,40,36,91
2018,United States of America,USA,Switzerland,CHE,0,0,11,0,11
2018,Uzbekistan,UZB,Switzerland,CHE,0,5,0,0,5
2018,Venezuela (Bolivarian Republic of),VEN,Switzerland,CHE,0,0,29,5,34
2018,Western Sahara,ESH,Switzerland,CHE,0,0,5,0,5
2018,Yemen,YEM,Switzerland,CHE,18,18,5,14,55
2018,Stateless,XXA,Switzerland,CHE,5,0,5,12,22
2018,Burundi,BDI,United Rep. of Tanzania,TZA,0,0,0,6074,6074
2018,Dem. Rep. of the Congo,COD,United Rep. of Tanzania,TZA,5,0,0,195,200
2018,Myanmar,MMR,Thailand,THA,10,0,0,0,10
2018,Central African Rep.,CAF,Togo,TGO,10,0,65,0,75
2018,Cameroon,CMR,Togo,TGO,5,0,0,0,5
2018,Dem. Rep. of the Congo,COD,Togo,TGO,10,0,0,0,10
2018,Cote d'Ivoire,CIV,Togo,TGO,11,0,22,0,33
2018,Mali,MLI,Togo,TGO,0,0,5,0,5
2018,Rwanda,RWA,Togo,TGO,5,0,0,0,5
2018,Turkey,TUR,Togo,TGO,27,0,0,0,27
2018,Burundi,BDI,Uganda,UGA,1271,0,52,976,2299
2018,Central African Rep.,CAF,Uganda,UGA,0,0,0,5,5
2018,Dem. Rep. of the Congo,COD,Uganda,UGA,11677,0,895,2885,15457
2018,Eritrea,ERI,Uganda,UGA,530,0,896,5932,7358
2018,Ethiopia,ETH,Uganda,UGA,307,0,102,554,963
2018,Palestinian,PSE,Uganda,UGA,0,0,0,5,5
2018,Kenya,KEN,Uganda,UGA,5,0,0,5,10
2018,Pakistan,PAK,Uganda,UGA,0,0,100,100,200
2018,Rwanda,RWA,Uganda,UGA,289,0,137,296,722
2018,Somalia,SOM,Uganda,UGA,5771,0,0,5330,11101
2018,Sudan,SDN,Uganda,UGA,10,0,5,586,601
2018,South Sudan,SSD,Uganda,UGA,5,0,0,290,295
2018,Syrian Arab Rep.,SYR,Uganda,UGA,0,0,0,5,5
2018,Turkey,TUR,Uganda,UGA,13,0,0,5,18
2018,Yemen,YEM,Uganda,UGA,0,0,5,0,5
2018,Afghanistan,AFG,Ukraine,UKR,11,20,26,79,136
2018,Algeria,DZA,Ukraine,UKR,0,0,0,5,5
2018,Angola,AGO,Ukraine,UKR,0,0,0,5,5
2018,Azerbaijan,AZE,Ukraine,UKR,0,0,0,5,5
2018,Bangladesh,BGD,Ukraine,UKR,0,0,12,61,73
2018,Belarus,BLR,Ukraine,UKR,0,0,0,11,11
2018,Cameroon,CMR,Ukraine,UKR,0,0,0,10,10
2018,Congo,COG,Ukraine,UKR,0,0,0,5,5
2018,Dem. Rep. of the Congo,COD,Ukraine,UKR,0,0,5,0,5
2018,Eritrea,ERI,Ukraine,UKR,0,0,0,5,5
2018,Ethiopia,ETH,Ukraine,UKR,0,0,0,5,5
2018,Palestinian,PSE,Ukraine,UKR,0,0,0,5,5
2018,Georgia,GEO,Ukraine,UKR,0,0,0,5,5
2018,Ghana,GHA,Ukraine,UKR,0,0,0,5,5
2018,Guinea,GIN,Ukraine,UKR,0,0,0,10,10
2018,Cote d'Ivoire,CIV,Ukraine,UKR,0,0,0,5,5
2018,India,IND,Ukraine,UKR,0,5,5,15,25
2018,Iran (Islamic Rep. of),IRN,Ukraine,UKR,0,0,12,5,17
2018,Iraq,IRQ,Ukraine,UKR,0,5,5,27,37
2018,Jordan,JOR,Ukraine,UKR,0,0,5,5,10
2018,Kazakhstan,KAZ,Ukraine,UKR,0,0,5,0,5
2018,Kyrgyzstan,KGZ,Ukraine,UKR,0,0,0,5,5
2018,Libya,LBY,Ukraine,UKR,0,0,5,0,5
2018,Lebanon,LBN,Ukraine,UKR,0,0,0,12,12
2018,Sri Lanka,LKA,Ukraine,UKR,0,0,0,5,5
2018,Rep. of Moldova,MDA,Ukraine,UKR,0,0,5,0,5
2018,Morocco,MAR,Ukraine,UKR,0,0,5,0,5
2018,Nigeria,NGA,Ukraine,UKR,0,0,0,31,31
2018,Pakistan,PAK,Ukraine,UKR,0,0,5,15,20
2018,Russian Federation,RUS,Ukraine,UKR,0,15,45,49,109
2018,Senegal,SEN,Ukraine,UKR,0,0,5,5,10
2018,Somalia,SOM,Ukraine,UKR,0,0,5,35,40
2018,Sudan,SDN,Ukraine,UKR,0,0,0,5,5
2018,Syrian Arab Rep.,SYR,Ukraine,UKR,0,26,59,44,129
2018,Tajikistan,TJK,Ukraine,UKR,0,0,30,5,35
2018,Turkey,TUR,Ukraine,UKR,0,0,0,12,12
2018,Uzbekistan,UZB,Ukraine,UKR,5,0,10,21,36
2018,Yemen,YEM,Ukraine,UKR,0,0,12,5,17
2018,Stateless,XXA,Ukraine,UKR,0,5,11,0,16
2018,Angola,AGO,Uruguay,URY,10,0,5,0,15
2018,Brazil,BRA,Uruguay,URY,0,0,0,5,5
2018,Colombia,COL,Uruguay,URY,14,0,0,5,19
2018,Cuba,CUB,Uruguay,URY,5,0,39,2318,2362
2018,France,FRA,Uruguay,URY,0,0,5,0,5
2018,Nigeria,NGA,Uruguay,URY,5,0,0,5,10
2018,El Salvador,SLV,Uruguay,URY,10,0,0,0,10
2018,Senegal,SEN,Uruguay,URY,0,0,5,0,5
2018,Venezuela (Bolivarian Republic of),VEN,Uruguay,URY,12,0,5,5,22
2018,Colombia,COL,Venezuela (Bolivarian Republic of),VEN,615,0,1400,86,2101
2018,Burundi,BDI,Zambia,ZMB,1170,0,5,13,1188
2018,Congo,COG,Zambia,ZMB,5,0,0,0,5
2018,Dem. Rep. of the Congo,COD,Zambia,ZMB,10478,0,33,164,10675
2018,Eritrea,ERI,Zambia,ZMB,14,0,0,0,14
2018,Ethiopia,ETH,Zambia,ZMB,5,0,0,0,5
2018,Rwanda,RWA,Zambia,ZMB,19,0,0,26,45
2018,Sierra Leone,SLE,Zambia,ZMB,0,0,0,5,5
2018,Somalia,SOM,Zambia,ZMB,667,0,0,39,706
2018,Syrian Arab Rep.,SYR,Zambia,ZMB,5,0,0,0,5
2018,Turkey,TUR,Zambia,ZMB,24,0,0,0,24
2018,Burundi,BDI,Zimbabwe,ZWE,0,0,0,22,22
2018,Dem. Rep. of the Congo,COD,Zimbabwe,ZWE,209,0,10,354,573
2018,Eritrea,ERI,Zimbabwe,ZWE,0,0,0,5,5
2018,Ethiopia,ETH,Zimbabwe,ZWE,0,0,0,12,12
2018,Cote d'Ivoire,CIV,Zimbabwe,ZWE,0,0,0,10,10
2018,Mozambique,MOZ,Zimbabwe,ZWE,0,0,0,335,335
2018,South Africa,ZAF,Zimbabwe,ZWE,0,0,0,5,5
2018,Somalia,SOM,Zimbabwe,ZWE,0,0,0,5,5
2018,Sudan,SDN,Zimbabwe,ZWE,0,10,0,0,10
2019,Afghanistan,AFG,Albania,ALB,0,0,0,5,5
2019,Algeria,DZA,Albania,ALB,0,0,0,17,17
2019,Palestinian,PSE,Albania,ALB,0,0,0,5,5
2019,Iran (Islamic Rep. of),IRN,Albania,ALB,0,0,0,5,5
2019,Iraq,IRQ,Albania,ALB,13,0,0,23,36
2019,Libya,LBY,Albania,ALB,0,0,0,28,28
2019,Morocco,MAR,Albania,ALB,0,0,0,36,36
2019,Serbia and Kosovo: S/RES/1244 (1999),SRB,Albania,ALB,0,0,0,5,5
2019,Syrian Arab Rep.,SYR,Albania,ALB,10,0,0,69,79
2019,Afghanistan,AFG,Argentina,ARG,5,0,0,0,5
2019,Angola,AGO,Argentina,ARG,0,0,5,0,5
2019,Armenia,ARM,Argentina,ARG,0,0,27,29,56
2019,Brazil,BRA,Argentina,ARG,0,0,0,5,5
2019,China,CHN,Argentina,ARG,0,0,14,0,14
2019,Cameroon,CMR,Argentina,ARG,0,0,0,5,5
2019,Dem. Rep. of the Congo,COD,Argentina,ARG,5,0,0,0,5
2019,Colombia,COL,Argentina,ARG,12,0,0,59,71
2019,Cuba,CUB,Argentina,ARG,5,0,45,75,125
2019,Dominican Rep.,DOM,Argentina,ARG,0,0,64,41,105
2019,France,FRA,Argentina,ARG,0,0,0,5,5
2019,Palestinian,PSE,Argentina,ARG,5,0,0,0,5
2019,Ghana,GHA,Argentina,ARG,0,0,5,5,10
2019,Guatemala,GTM,Argentina,ARG,5,0,0,0,5
2019,Haiti,HTI,Argentina,ARG,5,0,221,102,328
2019,Honduras,HND,Argentina,ARG,0,0,0,5,5
2019,India,IND,Argentina,ARG,0,0,22,11,33
2019,Iraq,IRQ,Argentina,ARG,0,0,0,5,5
2019,Jamaica,JAM,Argentina,ARG,5,0,0,0,5
2019,Nicaragua,NIC,Argentina,ARG,5,0,0,0,5
2019,Nigeria,NGA,Argentina,ARG,0,0,0,17,17
2019,Pakistan,PAK,Argentina,ARG,5,0,5,5,15
2019,Peru,PER,Argentina,ARG,5,0,0,5,10
2019,Russian Federation,RUS,Argentina,ARG,11,0,0,15,26
2019,El Salvador,SLV,Argentina,ARG,14,0,0,0,14
2019,Senegal,SEN,Argentina,ARG,0,0,173,38,211
2019,Syrian Arab Rep.,SYR,Argentina,ARG,19,0,5,10,34
2019,Ukraine,UKR,Argentina,ARG,10,0,5,30,45
2019,Venezuela (Bolivarian Republic of),VEN,Argentina,ARG,293,0,5,159,457
2019,Yemen,YEM,Argentina,ARG,5,0,0,0,5
2019,Afghanistan,AFG,Armenia,ARM,0,0,0,5,5
2019,Egypt,EGY,Armenia,ARM,5,0,0,0,5
2019,Cuba,CUB,Armenia,ARM,0,0,18,16,34
2019,India,IND,Armenia,ARM,0,0,0,5,5
2019,Iran (Islamic Rep. of),IRN,Armenia,ARM,33,0,13,24,70
2019,Iraq,IRQ,Armenia,ARM,5,0,0,21,26
2019,Lebanon,LBN,Armenia,ARM,5,0,0,0,5
2019,Pakistan,PAK,Armenia,ARM,0,0,0,5,5
2019,Russian Federation,RUS,Armenia,ARM,0,0,5,0,5
2019,Syrian Arab Rep.,SYR,Armenia,ARM,29,0,0,0,29
2019,Turkey,TUR,Armenia,ARM,5,0,0,0,5
2019,Yemen,YEM,Armenia,ARM,5,0,0,0,5
2019,Afghanistan,AFG,Australia,AUS,529,0,42,0,571
2019,Albania,ALB,Australia,AUS,0,0,5,0,5
2019,Egypt,EGY,Australia,AUS,26,0,39,10,75
2019,Bangladesh,BGD,Australia,AUS,11,0,215,20,246
2019,Cambodia,KHM,Australia,AUS,10,0,0,0,10
2019,China,CHN,Australia,AUS,89,0,2702,509,3300
2019,Ethiopia,ETH,Australia,AUS,16,0,58,0,74
2019,Fiji,FJI,Australia,AUS,0,0,636,91,727
2019,Palestinian,PSE,Australia,AUS,65,0,5,0,70
2019,United Kingdom of Great Britain and Northern Ireland,GBR,Australia,AUS,0,0,13,5,18
2019,Ghana,GHA,Australia,AUS,0,0,43,0,43
2019,Greece,GRC,Australia,AUS,0,0,5,0,5
2019,India,IND,Australia,AUS,29,0,876,267,1172
2019,Indonesia,IDN,Australia,AUS,16,0,57,35,108
2019,Iran (Islamic Rep. of),IRN,Australia,AUS,1313,0,441,20,1774
2019,Iraq,IRQ,Australia,AUS,260,0,250,14,524
2019,Rep. of Korea,KOR,Australia,AUS,0,0,16,10,26
2019,Libya,LBY,Australia,AUS,65,0,0,0,65
2019,Lebanon,LBN,Australia,AUS,12,0,263,36,311
2019,Sri Lanka,LKA,Australia,AUS,181,0,384,42,607
2019,Maldives,MDV,Australia,AUS,5,0,0,0,5
2019,Malaysia,MYS,Australia,AUS,42,0,6639,549,7230
2019,Myanmar,MMR,Australia,AUS,31,0,16,0,47
2019,Nepal,NPL,Australia,AUS,0,0,23,5,28
2019,Nigeria,NGA,Australia,AUS,5,0,51,5,61
2019,Pakistan,PAK,Australia,AUS,336,0,531,47,914
2019,Peru,PER,Australia,AUS,5,0,0,0,5
2019,Philippines,PHL,Australia,AUS,0,0,12,20,32
2019,Papua New Guinea,PNG,Australia,AUS,64,0,169,5,238
2019,South Africa,ZAF,Australia,AUS,0,0,135,10,145
2019,Saudi Arabia,SAU,Australia,AUS,41,0,20,5,66
2019,Sierra Leone,SLE,Australia,AUS,0,0,16,0,16
2019,Somalia,SOM,Australia,AUS,63,0,0,0,63
2019,Viet Nam,VNM,Australia,AUS,12,0,362,97,471
2019,Sudan,SDN,Australia,AUS,60,0,12,0,72
2019,Syrian Arab Rep.,SYR,Australia,AUS,39,0,0,0,39
2019,Thailand,THA,Australia,AUS,0,0,1113,88,1201
2019,Tonga,TON,Australia,AUS,0,0,13,0,13
2019,Turkey,TUR,Australia,AUS,169,0,67,0,236
2019,Tuvalu,TUV,Australia,AUS,0,0,0,10,10
2019,Venezuela (Bolivarian Republic of),VEN,Australia,AUS,46,0,44,5,95
2019,Yemen,YEM,Australia,AUS,32,0,0,0,32
2019,Zambia,ZMB,Australia,AUS,0,0,5,0,5
2019,Stateless,XXA,Australia,AUS,397,0,70,5,472
2019,Afghanistan,AFG,Azerbaijan,AZE,10,0,401,35,446
2019,Egypt,EGY,Azerbaijan,AZE,0,0,10,10,20
2019,Bangladesh,BGD,Azerbaijan,AZE,0,0,5,0,5
2019,Iran (Islamic Rep. of),IRN,Azerbaijan,AZE,0,0,14,10,24
2019,Iraq,IRQ,Azerbaijan,AZE,12,0,5,0,17
2019,Nepal,NPL,Azerbaijan,AZE,0,0,5,0,5
2019,Pakistan,PAK,Azerbaijan,AZE,0,0,122,26,148
2019,Syrian Arab Rep.,SYR,Azerbaijan,AZE,0,0,21,0,21
2019,Turkey,TUR,Azerbaijan,AZE,0,0,5,0,5
2019,Yemen,YEM,Azerbaijan,AZE,0,0,5,0,5
2019,Dem. Rep. of the Congo,COD,Burundi,BDI,8617,68,150,297,9132
2019,Rwanda,RWA,Burundi,BDI,66,0,0,0,66
2019,Afghanistan,AFG,Belgium,BEL,154,171,287,366,978
2019,Albania,ALB,Belgium,BEL,10,0,189,55,254
2019,Algeria,DZA,Belgium,BEL,5,0,33,5,43
2019,Angola,AGO,Belgium,BEL,0,0,40,5,45
2019,Egypt,EGY,Belgium,BEL,19,0,5,10,34
2019,Armenia,ARM,Belgium,BEL,5,5,28,20,58
2019,Azerbaijan,AZE,Belgium,BEL,0,0,14,0,14
2019,Burundi,BDI,Belgium,BEL,126,0,27,5,158
2019,Benin,BEN,Belgium,BEL,0,0,11,0,11
2019,Bangladesh,BGD,Belgium,BEL,0,0,0,14,14
2019,Burkina Faso,BFA,Belgium,BEL,5,0,14,0,19
2019,Brazil,BRA,Belgium,BEL,5,0,10,0,15
2019,Bosnia and Herzegovina,BIH,Belgium,BEL,0,0,5,0,5
2019,Bulgaria,BGR,Belgium,BEL,0,0,5,0,5
2019,Central African Rep.,CAF,Belgium,BEL,5,0,5,0,10
2019,Chad,TCD,Belgium,BEL,5,0,0,0,5
2019,China,CHN,Belgium,BEL,42,0,13,12,67
2019,Cameroon,CMR,Belgium,BEL,36,0,72,30,138
2019,Congo,COG,Belgium,BEL,0,0,0,5,5
2019,Dem. Rep. of the Congo,COD,Belgium,BEL,55,5,95,37,192
2019,Colombia,COL,Belgium,BEL,18,5,92,0,115
2019,Cuba,CUB,Belgium,BEL,0,0,5,0,5
2019,Djibouti,DJI,Belgium,BEL,14,0,0,5,19
2019,Dominican Rep.,DOM,Belgium,BEL,0,0,5,0,5
2019,Ecuador,ECU,Belgium,BEL,0,0,5,0,5
2019,Eritrea,ERI,Belgium,BEL,193,0,5,13,211
2019,Ethiopia,ETH,Belgium,BEL,0,0,15,19,34
2019,Gabon,GAB,Belgium,BEL,5,0,5,0,10
2019,Gambia,GMB,Belgium,BEL,0,0,11,0,11
2019,Palestinian,PSE,Belgium,BEL,97,0,182,21,300
2019,Georgia,GEO,Belgium,BEL,14,0,36,15,65
2019,Ghana,GHA,Belgium,BEL,0,0,14,5,19
2019,Guatemala,GTM,Belgium,BEL,5,0,0,0,5
2019,Guinea,GIN,Belgium,BEL,99,0,184,54,337
2019,Honduras,HND,Belgium,BEL,5,0,0,0,5
2019,Cote d'Ivoire,CIV,Belgium,BEL,14,0,24,10,48
2019,India,IND,Belgium,BEL,0,0,14,12,26
2019,Iran (Islamic Rep. of),IRN,Belgium,BEL,209,0,49,14,272
2019,Iraq,IRQ,Belgium,BEL,177,63,301,313,854
2019,Kazakhstan,KAZ,Belgium,BEL,0,0,5,0,5
2019,Kenya,KEN,Belgium,BEL,0,0,5,0,5
2019,Kyrgyzstan,KGZ,Belgium,BEL,0,5,12,0,17
2019,Liberia,LBR,Belgium,BEL,0,0,5,5,10
2019,Libya,LBY,Belgium,BEL,0,38,0,0,38
2019,Lebanon,LBN,Belgium,BEL,0,0,38,10,48
2019,Sri Lanka,LKA,Belgium,BEL,0,0,22,41,63
2019,Mauritania,MRT,Belgium,BEL,15,0,23,5,43
2019,North Macedonia,MKD,Belgium,BEL,0,0,49,15,64
2019,Rep. of Moldova,MDA,Belgium,BEL,0,0,5,0,5
2019,Mexico,MEX,Belgium,BEL,0,0,10,0,10
2019,Mali,MLI,Belgium,BEL,5,0,5,0,10
2019,Mongolia,MNG,Belgium,BEL,0,0,5,0,5
2019,Morocco,MAR,Belgium,BEL,16,0,62,28,106
2019,Montenegro,MNE,Belgium,BEL,0,0,5,0,5
2019,Nepal,NPL,Belgium,BEL,0,0,0,5,5
2019,Niger,NER,Belgium,BEL,10,0,10,5,25
2019,Nicaragua,NIC,Belgium,BEL,11,0,5,0,16
2019,Nigeria,NGA,Belgium,BEL,10,0,23,5,38
2019,Pakistan,PAK,Belgium,BEL,10,0,20,25,55
2019,Romania,ROU,Belgium,BEL,0,0,5,0,5
2019,Russian Federation,RUS,Belgium,BEL,81,0,135,71,287
2019,Rwanda,RWA,Belgium,BEL,37,0,27,26,90
2019,El Salvador,SLV,Belgium,BEL,96,0,0,0,96
2019,Serbia and Kosovo: S/RES/1244 (1999),SRB,Belgium,BEL,12,0,100,40,152
2019,Senegal,SEN,Belgium,BEL,10,0,18,5,33
2019,Sierra Leone,SLE,Belgium,BEL,0,0,14,5,19
2019,Somalia,SOM,Belgium,BEL,73,17,57,69,216
2019,Viet Nam,VNM,Belgium,BEL,0,0,5,5,10
2019,Sudan,SDN,Belgium,BEL,10,0,22,5,37
2019,Suriname,SUR,Belgium,BEL,0,0,5,0,5
2019,Syrian Arab Rep.,SYR,Belgium,BEL,713,163,199,65,1140
2019,United Rep. of Tanzania,TZA,Belgium,BEL,0,0,0,5,5
2019,Tajikistan,TJK,Belgium,BEL,0,0,5,0,5
2019,Togo,TGO,Belgium,BEL,13,0,21,5,39
2019,Tunisia,TUN,Belgium,BEL,0,0,13,0,13
2019,Turkey,TUR,Belgium,BEL,368,0,104,42,514
2019,Ukraine,UKR,Belgium,BEL,16,0,39,17,72
2019,United States of America,USA,Belgium,BEL,0,0,0,5,5
2019,Uzbekistan,UZB,Belgium,BEL,0,0,0,5,5
2019,Venezuela (Bolivarian Republic of),VEN,Belgium,BEL,83,5,179,5,272
2019,Yemen,YEM,Belgium,BEL,0,13,5,0,18
2019,Stateless,XXA,Belgium,BEL,0,0,0,5,5
2019,Central African Rep.,CAF,Benin,BEN,38,0,0,0,38
2019,Cameroon,CMR,Benin,BEN,5,0,0,0,5
2019,Cote d'Ivoire,CIV,Benin,BEN,0,0,5,0,5
2019,Togo,TGO,Benin,BEN,0,0,18,0,18
2019,Yemen,YEM,Benin,BEN,5,0,0,0,5
2019,Central African Rep.,CAF,Burkina Faso,BFA,19,0,0,5,24
2019,Turkey,TUR,Burkina Faso,BFA,10,0,0,0,10
2019,Afghanistan,AFG,Belarus,BLR,10,5,21,0,36
2019,Armenia,ARM,Belarus,BLR,0,0,5,0,5
2019,Cuba,CUB,Belarus,BLR,0,0,5,0,5
2019,India,IND,Belarus,BLR,0,0,0,5,5
2019,Iraq,IRQ,Belarus,BLR,0,0,0,5,5
2019,Kyrgyzstan,KGZ,Belarus,BLR,0,0,0,5,5
2019,Latvia,LVA,Belarus,BLR,0,0,0,5,5
2019,Russian Federation,RUS,Belarus,BLR,0,0,10,0,10
2019,Syrian Arab Rep.,SYR,Belarus,BLR,0,13,0,0,13
2019,Turkey,TUR,Belarus,BLR,0,0,5,0,5
2019,Ukraine,UKR,Belarus,BLR,0,588,0,14,602
2019,Yemen,YEM,Belarus,BLR,0,5,0,0,5
2019,Argentina,ARG,Bolivia (Plurinational State of),BOL,0,0,5,0,5
2019,Colombia,COL,Bolivia (Plurinational State of),BOL,5,0,5,11,21
2019,Cuba,CUB,Bolivia (Plurinational State of),BOL,0,0,0,12,12
2019,Ecuador,ECU,Bolivia (Plurinational State of),BOL,5,0,0,0,5
2019,Peru,PER,Bolivia (Plurinational State of),BOL,0,0,5,0,5
2019,Venezuela (Bolivarian Republic of),VEN,Bolivia (Plurinational State of),BOL,0,0,480,194,674
2019,Burundi,BDI,Botswana,BWA,24,0,0,10,34
2019,Dem. Rep. of the Congo,COD,Botswana,BWA,49,0,0,11,60
2019,Namibia,NAM,Botswana,BWA,0,0,0,15,15
2019,Zimbabwe,ZWE,Botswana,BWA,0,0,0,5,5
2019,Afghanistan,AFG,Brazil,BRA,11,0,0,0,11
2019,Angola,AGO,Brazil,BRA,5,0,176,49,230
2019,Egypt,EGY,Brazil,BRA,11,0,5,5,21
2019,Benin,BEN,Brazil,BRA,0,0,11,0,11
2019,Bangladesh,BGD,Brazil,BRA,5,0,46,12,63
2019,China,CHN,Brazil,BRA,5,0,5,26,36
2019,Cameroon,CMR,Brazil,BRA,5,0,0,11,16
2019,Dem. Rep. of the Congo,COD,Brazil,BRA,86,0,11,39,136
2019,Colombia,COL,Brazil,BRA,0,0,0,11,11
2019,Cuba,CUB,Brazil,BRA,38,0,10,229,277
2019,Cabo Verde,CPV,Brazil,BRA,0,0,5,0,5
2019,Dominican Rep.,DOM,Brazil,BRA,0,0,5,5,10
2019,Gambia,GMB,Brazil,BRA,0,0,14,5,19
2019,Palestinian,PSE,Brazil,BRA,20,0,0,0,20
2019,Ghana,GHA,Brazil,BRA,0,0,10,14,24
2019,Guinea-Bissau,GNB,Brazil,BRA,0,0,58,16,74
2019,Guinea,GIN,Brazil,BRA,11,0,11,0,22
2019,Haiti,HTI,Brazil,BRA,0,0,12,259,271
2019,Honduras,HND,Brazil,BRA,5,0,0,0,5
2019,Cote d'Ivoire,CIV,Brazil,BRA,5,0,0,0,5
2019,India,IND,Brazil,BRA,0,0,0,5,5
2019,Iran (Islamic Rep. of),IRN,Brazil,BRA,5,0,0,0,5
2019,Iraq,IRQ,Brazil,BRA,5,0,0,0,5
2019,Jordan,JOR,Brazil,BRA,0,0,5,0,5
2019,Kenya,KEN,Brazil,BRA,5,0,5,0,10
2019,Lebanon,LBN,Brazil,BRA,0,0,45,5,50
2019,Mauritania,MRT,Brazil,BRA,19,0,0,0,19
2019,Mali,MLI,Brazil,BRA,12,0,10,0,22
2019,Morocco,MAR,Brazil,BRA,0,0,0,12,12
2019,Nepal,NPL,Brazil,BRA,0,0,5,0,5
2019,Nigeria,NGA,Brazil,BRA,0,0,17,32,49
2019,Pakistan,PAK,Brazil,BRA,15,0,11,14,40
2019,Peru,PER,Brazil,BRA,0,0,0,5,5
2019,Philippines,PHL,Brazil,BRA,0,0,0,5,5
2019,South Africa,ZAF,Brazil,BRA,0,0,5,0,5
2019,El Salvador,SLV,Brazil,BRA,28,0,0,0,28
2019,Senegal,SEN,Brazil,BRA,0,0,94,12,106
2019,Sierra Leone,SLE,Brazil,BRA,0,0,5,5,10
2019,Syrian Arab Rep.,SYR,Brazil,BRA,324,0,0,11,335
2019,Togo,TGO,Brazil,BRA,5,0,10,5,20
2019,Tunisia,TUN,Brazil,BRA,0,0,0,5,5
2019,Turkey,TUR,Brazil,BRA,0,0,0,5,5
2019,Ukraine,UKR,Brazil,BRA,5,0,0,0,5
2019,Venezuela (Bolivarian Republic of),VEN,Brazil,BRA,20908,0,0,4892,25800
2019,Yemen,YEM,Brazil,BRA,0,0,0,5,5
2019,Afghanistan,AFG,Bosnia and Herzegovina,BIH,0,0,14,177,191
2019,Algeria,DZA,Bosnia and Herzegovina,BIH,0,0,0,5,5
2019,Palestinian,PSE,Bosnia and Herzegovina,BIH,0,0,0,15,15
2019,India,IND,Bosnia and Herzegovina,BIH,0,0,0,11,11
2019,Iran (Islamic Rep. of),IRN,Bosnia and Herzegovina,BIH,5,0,5,313,323
2019,Iraq,IRQ,Bosnia and Herzegovina,BIH,0,0,0,188,188
2019,Libya,LBY,Bosnia and Herzegovina,BIH,0,0,5,0,5
2019,Morocco,MAR,Bosnia and Herzegovina,BIH,0,0,0,10,10
2019,Nepal,NPL,Bosnia and Herzegovina,BIH,0,0,0,5,5
2019,Pakistan,PAK,Bosnia and Herzegovina,BIH,0,0,5,165,170
2019,Somalia,SOM,Bosnia and Herzegovina,BIH,0,0,0,5,5
2019,Syrian Arab Rep.,SYR,Bosnia and Herzegovina,BIH,0,13,0,66,79
2019,Turkey,TUR,Bosnia and Herzegovina,BIH,0,29,0,15,44
2019,Yemen,YEM,Bosnia and Herzegovina,BIH,0,0,0,5,5
2019,Cuba,CUB,Belize,BLZ,0,0,0,5,5
2019,Guatemala,GTM,Belize,BLZ,0,0,0,52,52
2019,Honduras,HND,Belize,BLZ,0,0,10,266,276
2019,Nicaragua,NIC,Belize,BLZ,0,0,0,50,50
2019,El Salvador,SLV,Belize,BLZ,0,0,23,1286,1309
2019,Afghanistan,AFG,Canada,CAN,507,0,78,21,606
2019,Albania,ALB,Canada,CAN,68,0,33,5,106
2019,Algeria,DZA,Canada,CAN,72,0,70,28,170
2019,Angola,AGO,Canada,CAN,113,0,94,18,225
2019,Antigua and Barbuda,ATG,Canada,CAN,0,0,12,0,12
2019,Egypt,EGY,Canada,CAN,1030,0,102,29,1161
2019,Armenia,ARM,Canada,CAN,14,0,0,0,14
2019,Austria,AUT,Canada,CAN,0,0,0,5,5
2019,Azerbaijan,AZE,Canada,CAN,133,0,39,14,186
2019,Bahrain,BHR,Canada,CAN,14,0,0,0,14
2019,Barbados,BRB,Canada,CAN,38,0,14,5,57
2019,Burundi,BDI,Canada,CAN,861,0,15,16,892
2019,Belgium,BEL,Canada,CAN,0,0,11,5,16
2019,Benin,BEN,Canada,CAN,0,0,11,0,11
2019,Bangladesh,BGD,Canada,CAN,253,0,155,49,457
2019,Bahamas,BHS,Canada,CAN,102,0,61,18,181
2019,Burkina Faso,BFA,Canada,CAN,15,0,5,5,25
2019,Bolivia (Plurinational State of),BOL,Canada,CAN,0,0,5,0,5
2019,Botswana,BWA,Canada,CAN,0,0,5,0,5
2019,Brazil,BRA,Canada,CAN,32,0,111,19,162
2019,Bulgaria,BGR,Canada,CAN,32,0,0,20,52
2019,Belize,BLZ,Canada,CAN,0,0,5,0,5
2019,Cambodia,KHM,Canada,CAN,11,0,5,0,16
2019,Central African Rep.,CAF,Canada,CAN,5,0,0,0,5
2019,Chad,TCD,Canada,CAN,96,0,10,13,119
2019,China,CHN,Canada,CAN,492,0,477,85,1054
2019,Chile,CHL,Canada,CAN,24,0,44,5,73
2019,Cameroon,CMR,Canada,CAN,143,0,53,21,217
2019,Congo,COG,Canada,CAN,21,0,18,5,44
2019,Dem. Rep. of the Congo,COD,Canada,CAN,220,0,226,78,524
2019,Colombia,COL,Canada,CAN,937,0,398,176,1511
2019,Costa Rica,CRI,Canada,CAN,0,0,10,0,10
2019,Cuba,CUB,Canada,CAN,17,0,12,10,39
2019,Cyprus,CYP,Canada,CAN,0,0,5,0,5
2019,Czechia,CZE,Canada,CAN,55,0,10,43,108
2019,Denmark,DNK,Canada,CAN,5,0,5,0,10
2019,Djibouti,DJI,Canada,CAN,150,0,32,14,196
2019,Dominica,DMA,Canada,CAN,0,0,5,5,10
2019,Dominican Rep.,DOM,Canada,CAN,16,0,18,11,45
2019,Ecuador,ECU,Canada,CAN,5,0,13,5,23
2019,Equatorial Guinea,GNQ,Canada,CAN,0,0,5,0,5
2019,Eritrea,ERI,Canada,CAN,516,0,57,53,626
2019,Ethiopia,ETH,Canada,CAN,308,0,129,25,462
2019,Fiji,FJI,Canada,CAN,5,0,0,0,5
2019,France,FRA,Canada,CAN,0,0,11,5,16
2019,Gabon,GAB,Canada,CAN,14,0,0,0,14
2019,Gambia,GMB,Canada,CAN,5,0,13,5,23
2019,Palestinian,PSE,Canada,CAN,432,0,148,26,606
2019,Georgia,GEO,Canada,CAN,51,0,29,11,91
2019,Germany,DEU,Canada,CAN,5,0,5,12,22
2019,Ghana,GHA,Canada,CAN,38,0,70,10,118
2019,Greece,GRC,Canada,CAN,5,0,5,0,10
2019,Guatemala,GTM,Canada,CAN,60,0,19,25,104
2019,Guinea,GIN,Canada,CAN,45,0,21,13,79
2019,Guyana,GUY,Canada,CAN,12,0,19,0,31
2019,Haiti,HTI,Canada,CAN,1226,0,1774,116,3116
2019,"China, Hong Kong SAR",HKG,Canada,CAN,0,0,5,0,5
2019,Honduras,HND,Canada,CAN,88,0,26,18,132
2019,Croatia,HRV,Canada,CAN,5,0,0,0,5
2019,Hungary,HUN,Canada,CAN,134,0,61,140,335
2019,Iceland,ISL,Canada,CAN,5,0,0,0,5
2019,Cote d'Ivoire,CIV,Canada,CAN,12,0,13,5,30
2019,India,IND,Canada,CAN,359,0,503,331,1193
2019,Indonesia,IDN,Canada,CAN,24,0,5,0,29
2019,Ireland,IRL,Canada,CAN,0,0,0,17,17
2019,Iran (Islamic Rep. of),IRN,Canada,CAN,2674,0,169,83,2926
2019,Iraq,IRQ,Canada,CAN,468,0,119,41,628
2019,Israel,ISR,Canada,CAN,25,0,18,5,48
2019,Italy,ITA,Canada,CAN,5,0,19,20,44
2019,Jamaica,JAM,Canada,CAN,80,0,67,20,167
2019,Jordan,JOR,Canada,CAN,141,0,155,27,323
2019,Japan,JPN,Canada,CAN,0,0,5,0,5
2019,Kazakhstan,KAZ,Canada,CAN,12,0,0,0,12
2019,Kenya,KEN,Canada,CAN,74,0,44,18,136
2019,Kyrgyzstan,KGZ,Canada,CAN,5,0,0,0,5
2019,Rep. of Korea,KOR,Canada,CAN,0,0,11,0,11
2019,Kuwait,KWT,Canada,CAN,15,0,0,5,20
2019,Liberia,LBR,Canada,CAN,14,0,5,0,19
2019,Libya,LBY,Canada,CAN,331,0,40,21,392
2019,Saint Lucia,LCA,Canada,CAN,5,0,14,0,19
2019,Lebanon,LBN,Canada,CAN,158,0,81,14,253
2019,Sri Lanka,LKA,Canada,CAN,230,0,78,21,329
2019,Latvia,LVA,Canada,CAN,5,0,0,0,5
2019,Mauritania,MRT,Canada,CAN,14,0,5,5,24
2019,Rep. of Moldova,MDA,Canada,CAN,5,0,0,0,5
2019,Mexico,MEX,Canada,CAN,601,0,1013,679,2293
2019,Mali,MLI,Canada,CAN,14,0,0,5,19
2019,Malaysia,MYS,Canada,CAN,13,0,0,0,13
2019,Malawi,MWI,Canada,CAN,5,0,5,0,10
2019,Mongolia,MNG,Canada,CAN,17,0,0,5,22
2019,Morocco,MAR,Canada,CAN,5,0,13,0,18
2019,Mozambique,MOZ,Canada,CAN,0,0,5,0,5
2019,Mauritius,MUS,Canada,CAN,5,0,0,0,5
2019,Myanmar,MMR,Canada,CAN,14,0,5,0,19
2019,Nepal,NPL,Canada,CAN,70,0,17,10,97
2019,Netherlands,NLD,Canada,CAN,5,0,11,0,16
2019,Niger,NER,Canada,CAN,15,0,11,5,31
2019,Nicaragua,NIC,Canada,CAN,145,0,5,12,162
2019,Nigeria,NGA,Canada,CAN,1698,0,3835,133,5666
2019,Norway,NOR,Canada,CAN,0,0,5,0,5
2019,Pakistan,PAK,Canada,CAN,1376,0,456,69,1901
2019,Panama,PAN,Canada,CAN,5,0,13,0,18
2019,Paraguay,PRY,Canada,CAN,5,0,0,0,5
2019,Peru,PER,Canada,CAN,42,0,30,11,83
2019,Philippines,PHL,Canada,CAN,10,0,5,5,20
2019,Poland,POL,Canada,CAN,11,0,17,15,43
2019,Portugal,PRT,Canada,CAN,0,0,0,5,5
2019,Romania,ROU,Canada,CAN,170,0,73,526,769
2019,South Africa,ZAF,Canada,CAN,28,0,61,10,99
2019,Russian Federation,RUS,Canada,CAN,105,0,14,11,130
2019,Rwanda,RWA,Canada,CAN,269,0,20,13,302
2019,El Salvador,SLV,Canada,CAN,253,0,138,17,408
2019,Saudi Arabia,SAU,Canada,CAN,200,0,24,29,253
2019,Serbia and Kosovo: S/RES/1244 (1999),SRB,Canada,CAN,23,0,10,17,50
2019,Senegal,SEN,Canada,CAN,11,0,18,5,34
2019,Singapore,SGP,Canada,CAN,0,0,5,0,5
2019,Sierra Leone,SLE,Canada,CAN,5,0,0,0,5
2019,Somalia,SOM,Canada,CAN,225,0,84,39,348
2019,Spain,ESP,Canada,CAN,5,0,12,5,22
2019,Viet Nam,VNM,Canada,CAN,15,0,5,5,25
2019,Sudan,SDN,Canada,CAN,633,0,26,34,693
2019,South Sudan,SSD,Canada,CAN,10,0,0,0,10
2019,Slovakia,SVK,Canada,CAN,141,0,15,42,198
2019,Sweden,SWE,Canada,CAN,0,0,0,10,10
2019,Syrian Arab Rep.,SYR,Canada,CAN,646,0,42,56,744
2019,United Rep. of Tanzania,TZA,Canada,CAN,33,0,5,10,48
2019,Tajikistan,TJK,Canada,CAN,5,0,0,0,5
2019,Turkmenistan,TKM,Canada,CAN,5,0,0,0,5
2019,Togo,TGO,Canada,CAN,14,0,5,0,19
2019,Trinidad and Tobago,TTO,Canada,CAN,11,0,5,0,16
2019,Tunisia,TUN,Canada,CAN,20,0,11,5,36
2019,Turkey,TUR,Canada,CAN,1967,0,51,57,2075
2019,United Arab Emirates,ARE,Canada,CAN,0,0,0,5,5
2019,Uganda,UGA,Canada,CAN,175,0,47,13,235
2019,Ukraine,UKR,Canada,CAN,59,0,36,12,107
2019,Uruguay,URY,Canada,CAN,0,0,5,0,5
2019,United States of America,USA,Canada,CAN,29,0,1136,127,1292
2019,Uzbekistan,UZB,Canada,CAN,12,0,5,0,17
2019,Saint Vincent and the Grenadines,VCT,Canada,CAN,5,0,12,0,17
2019,Venezuela (Bolivarian Republic of),VEN,Canada,CAN,1305,0,123,41,1469
2019,Yemen,YEM,Canada,CAN,686,0,29,13,728
2019,Zambia,ZMB,Canada,CAN,5,0,0,0,5
2019,Zimbabwe,ZWE,Canada,CAN,73,0,30,5,108
2019,Cuba,CUB,Cayman Islands,CYM,14,0,0,0,14
2019,Mexico,MEX,Cayman Islands,CYM,0,0,5,0,5
2019,Angola,AGO,Chile,CHL,0,0,0,5,5
2019,Colombia,COL,Chile,CHL,10,0,190,1257,1457
2019,Cuba,CUB,Chile,CHL,0,0,318,1794,2112
2019,Dominican Rep.,DOM,Chile,CHL,0,0,13,46,59
2019,Palestinian,PSE,Chile,CHL,0,0,5,5,10
2019,Haiti,HTI,Chile,CHL,0,0,0,5,5
2019,Peru,PER,Chile,CHL,0,0,0,5,5
2019,Syrian Arab Rep.,SYR,Chile,CHL,5,0,0,5,10
2019,Venezuela (Bolivarian Republic of),VEN,Chile,CHL,5,0,29,526,560
2019,Yemen,YEM,Chile,CHL,0,0,0,5,5
2019,Algeria,DZA,Congo,COG,0,0,0,5,5
2019,Angola,AGO,Congo,COG,0,0,0,32,32
2019,Burundi,BDI,Congo,COG,0,0,0,5,5
2019,Central African Rep.,CAF,Congo,COG,29,0,0,1691,1720
2019,Chad,TCD,Congo,COG,0,0,0,15,15
2019,Cameroon,CMR,Congo,COG,0,0,0,11,11
2019,Dem. Rep. of the Congo,COD,Congo,COG,0,0,110,1559,1669
2019,Guinea,GIN,Congo,COG,0,0,0,5,5
2019,Cote d'Ivoire,CIV,Congo,COG,0,0,0,28,28
2019,Liberia,LBR,Congo,COG,0,0,0,10,10
2019,Mauritania,MRT,Congo,COG,0,0,0,49,49
2019,Mali,MLI,Congo,COG,0,0,0,11,11
2019,Niger,NER,Congo,COG,0,0,0,5,5
2019,Rwanda,RWA,Congo,COG,0,0,53,85,138
2019,Sudan,SDN,Congo,COG,0,0,0,26,26
2019,South Sudan,SSD,Congo,COG,0,0,0,11,11
2019,Syrian Arab Rep.,SYR,Congo,COG,0,0,0,5,5
2019,Turkey,TUR,Congo,COG,0,0,0,5,5
2019,Burundi,BDI,Dem. Rep. of the Congo,COD,2725,0,0,0,2725
2019,Central African Rep.,CAF,Dem. Rep. of the Congo,COD,1254,0,0,0,1254
2019,Cameroon,CMR,Dem. Rep. of the Congo,COD,0,0,0,10,10
2019,Congo,COG,Dem. Rep. of the Congo,COD,0,0,10,0,10
2019,Cote d'Ivoire,CIV,Dem. Rep. of the Congo,COD,5,0,0,0,5
2019,Liberia,LBR,Dem. Rep. of the Congo,COD,5,0,0,0,5
2019,Mali,MLI,Dem. Rep. of the Congo,COD,0,0,0,5,5
2019,Nepal,NPL,Dem. Rep. of the Congo,COD,0,0,0,5,5
2019,Rwanda,RWA,Dem. Rep. of the Congo,COD,38,0,0,0,38
2019,South Sudan,SSD,Dem. Rep. of the Congo,COD,7121,0,0,0,7121
2019,Turkey,TUR,Colombia,COL,5,0,0,0,5
2019,Venezuela (Bolivarian Republic of),VEN,Colombia,COL,332,0,0,4052,4384
2019,Argentina,ARG,Costa Rica,CRI,0,0,0,5,5
2019,Burkina Faso,BFA,Costa Rica,CRI,0,0,5,0,5
2019,China,CHN,Costa Rica,CRI,0,0,0,12,12
2019,Dem. Rep. of the Congo,COD,Costa Rica,CRI,5,0,5,0,10
2019,Colombia,COL,Costa Rica,CRI,10,0,104,317,431
2019,Cuba,CUB,Costa Rica,CRI,5,0,26,95,126
2019,Dominican Rep.,DOM,Costa Rica,CRI,0,0,0,5,5
2019,Guatemala,GTM,Costa Rica,CRI,0,0,5,11,16
2019,Haiti,HTI,Costa Rica,CRI,0,0,10,20,30
2019,Honduras,HND,Costa Rica,CRI,15,0,10,75,100
2019,Mexico,MEX,Costa Rica,CRI,0,0,0,5,5
2019,Nicaragua,NIC,Costa Rica,CRI,943,0,2948,7053,10944
2019,Russian Federation,RUS,Costa Rica,CRI,5,0,0,0,5
2019,El Salvador,SLV,Costa Rica,CRI,207,0,1436,673,2316
2019,Spain,ESP,Costa Rica,CRI,0,0,0,5,5
2019,United States of America,USA,Costa Rica,CRI,5,0,0,0,5
2019,Venezuela (Bolivarian Republic of),VEN,Costa Rica,CRI,135,0,282,741,1158
2019,Egypt,EGY,Cyprus,CYP,5,0,169,76,250
2019,Bangladesh,BGD,Cyprus,CYP,0,0,327,110,437
2019,China,CHN,Cyprus,CYP,0,0,0,5,5
2019,Cameroon,CMR,Cyprus,CYP,10,0,14,16,40
2019,Congo,COG,Cyprus,CYP,0,0,12,0,12
2019,Dem. Rep. of the Congo,COD,Cyprus,CYP,0,5,10,0,15
2019,Gambia,GMB,Cyprus,CYP,0,0,0,5,5
2019,Palestinian,PSE,Cyprus,CYP,36,22,0,0,58
2019,Georgia,GEO,Cyprus,CYP,0,0,319,197,516
2019,Guinea,GIN,Cyprus,CYP,0,0,0,5,5
2019,India,IND,Cyprus,CYP,0,0,419,304,723
2019,Iran (Islamic Rep. of),IRN,Cyprus,CYP,14,0,29,36,79
2019,Iraq,IRQ,Cyprus,CYP,24,5,70,83,182
2019,Jordan,JOR,Cyprus,CYP,0,0,0,27,27
2019,Libya,LBY,Cyprus,CYP,0,10,0,0,10
2019,Lebanon,LBN,Cyprus,CYP,0,0,0,17,17
2019,Sri Lanka,LKA,Cyprus,CYP,0,0,84,42,126
2019,Morocco,MAR,Cyprus,CYP,0,0,0,5,5
2019,Nepal,NPL,Cyprus,CYP,0,0,102,47,149
2019,Nigeria,NGA,Cyprus,CYP,0,0,19,26,45
2019,Pakistan,PAK,Cyprus,CYP,0,0,241,225,466
2019,Philippines,PHL,Cyprus,CYP,0,0,48,37,85
2019,Russian Federation,RUS,Cyprus,CYP,0,0,0,10,10
2019,Somalia,SOM,Cyprus,CYP,11,27,0,10,48
2019,Viet Nam,VNM,Cyprus,CYP,0,0,170,110,280
2019,Syrian Arab Rep.,SYR,Cyprus,CYP,38,1074,0,0,1112
2019,Turkey,TUR,Cyprus,CYP,0,5,0,12,17
2019,Uzbekistan,UZB,Cyprus,CYP,0,0,0,5,5
2019,Yemen,YEM,Cyprus,CYP,0,5,0,0,5
2019,Afghanistan,AFG,Czechia,CZE,0,0,5,20,25
2019,Albania,ALB,Czechia,CZE,0,0,5,0,5
2019,Algeria,DZA,Czechia,CZE,0,0,12,5,17
2019,Egypt,EGY,Czechia,CZE,5,0,0,5,10
2019,Armenia,ARM,Czechia,CZE,0,0,66,363,429
2019,Azerbaijan,AZE,Czechia,CZE,0,0,26,35,61
2019,Belarus,BLR,Czechia,CZE,0,5,14,5,24
2019,China,CHN,Czechia,CZE,0,10,0,13,23
2019,Comoros,COM,Czechia,CZE,0,0,0,5,5
2019,Cuba,CUB,Czechia,CZE,5,0,14,17,36
2019,Ethiopia,ETH,Czechia,CZE,0,0,5,0,5
2019,Georgia,GEO,Czechia,CZE,0,0,149,79,228
2019,India,IND,Czechia,CZE,0,0,5,10,15
2019,Iran (Islamic Rep. of),IRN,Czechia,CZE,0,0,16,24,40
2019,Iraq,IRQ,Czechia,CZE,0,0,22,15,37
2019,Israel,ISR,Czechia,CZE,0,0,5,0,5
2019,Jordan,JOR,Czechia,CZE,5,0,0,0,5
2019,Kazakhstan,KAZ,Czechia,CZE,0,0,29,51,80
2019,Kyrgyzstan,KGZ,Czechia,CZE,5,5,16,12,38
2019,Libya,LBY,Czechia,CZE,0,10,0,10,20
2019,Rep. of Moldova,MDA,Czechia,CZE,0,0,36,10,46
2019,Mongolia,MNG,Czechia,CZE,0,0,12,20,32
2019,Morocco,MAR,Czechia,CZE,0,0,0,5,5
2019,Nigeria,NGA,Czechia,CZE,0,0,5,13,18
2019,Pakistan,PAK,Czechia,CZE,0,0,10,11,21
2019,Poland,POL,Czechia,CZE,0,0,0,5,5
2019,Russian Federation,RUS,Czechia,CZE,27,0,35,36,98
2019,Saudi Arabia,SAU,Czechia,CZE,0,5,0,0,5
2019,Serbia and Kosovo: S/RES/1244 (1999),SRB,Czechia,CZE,0,0,13,0,13
2019,Somalia,SOM,Czechia,CZE,0,5,0,0,5
2019,Viet Nam,VNM,Czechia,CZE,0,0,100,37,137
2019,Syrian Arab Rep.,SYR,Czechia,CZE,0,21,0,10,31
2019,Tunisia,TUN,Czechia,CZE,0,0,5,5,10
2019,Turkey,TUR,Czechia,CZE,5,0,17,15,37
2019,Ukraine,UKR,Czechia,CZE,5,10,271,147,433
2019,Uzbekistan,UZB,Czechia,CZE,0,0,58,23,81
2019,Venezuela (Bolivarian Republic of),VEN,Czechia,CZE,0,0,0,5,5
2019,Yemen,YEM,Czechia,CZE,0,13,0,0,13
2019,Stateless,XXA,Czechia,CZE,0,14,0,0,14
2019,Afghanistan,AFG,Denmark,DNK,5,11,56,0,72
2019,Albania,ALB,Denmark,DNK,0,0,53,0,53
2019,Algeria,DZA,Denmark,DNK,0,0,13,0,13
2019,Armenia,ARM,Denmark,DNK,0,0,17,0,17
2019,Bosnia and Herzegovina,BIH,Denmark,DNK,0,0,5,0,5
2019,Bulgaria,BGR,Denmark,DNK,0,0,5,0,5
2019,China,CHN,Denmark,DNK,5,0,5,0,10
2019,Cameroon,CMR,Denmark,DNK,0,0,12,0,12
2019,Dem. Rep. of the Congo,COD,Denmark,DNK,0,0,13,0,13
2019,Colombia,COL,Denmark,DNK,0,0,24,0,24
2019,Cuba,CUB,Denmark,DNK,0,0,5,0,5
2019,Eritrea,ERI,Denmark,DNK,207,498,26,0,731
2019,Georgia,GEO,Denmark,DNK,0,0,133,0,133
2019,India,IND,Denmark,DNK,0,0,11,0,11
2019,Indonesia,IDN,Denmark,DNK,0,0,5,0,5
2019,Iran (Islamic Rep. of),IRN,Denmark,DNK,47,10,95,0,152
2019,Iraq,IRQ,Denmark,DNK,0,11,72,0,83
2019,Jordan,JOR,Denmark,DNK,0,0,17,0,17
2019,Kenya,KEN,Denmark,DNK,0,0,5,0,5
2019,Kuwait,KWT,Denmark,DNK,0,0,5,0,5
2019,Libya,LBY,Denmark,DNK,0,0,5,0,5
2019,Lebanon,LBN,Denmark,DNK,5,0,5,0,10
2019,Sri Lanka,LKA,Denmark,DNK,0,0,10,0,10
2019,Lithuania,LTU,Denmark,DNK,0,0,11,0,11
2019,Latvia,LVA,Denmark,DNK,0,0,5,0,5
2019,Morocco,MAR,Denmark,DNK,0,0,37,0,37
2019,Myanmar,MMR,Denmark,DNK,0,0,13,0,13
2019,Nicaragua,NIC,Denmark,DNK,0,0,23,0,23
2019,Nigeria,NGA,Denmark,DNK,0,0,17,0,17
2019,Pakistan,PAK,Denmark,DNK,5,0,13,0,18
2019,Poland,POL,Denmark,DNK,0,0,5,0,5
2019,Romania,ROU,Denmark,DNK,0,0,10,0,10
2019,Russian Federation,RUS,Denmark,DNK,5,0,38,0,43
2019,Rwanda,RWA,Denmark,DNK,0,0,5,0,5
2019,Serbia and Kosovo: S/RES/1244 (1999),SRB,Denmark,DNK,0,0,21,0,21
2019,Senegal,SEN,Denmark,DNK,0,0,5,0,5
2019,Somalia,SOM,Denmark,DNK,5,14,122,0,141
2019,Sudan,SDN,Denmark,DNK,0,0,5,0,5
2019,Sweden,SWE,Denmark,DNK,0,0,5,0,5
2019,Syrian Arab Rep.,SYR,Denmark,DNK,137,336,28,0,501
2019,Tunisia,TUN,Denmark,DNK,0,0,10,0,10
2019,Turkey,TUR,Denmark,DNK,5,0,16,0,21
2019,Uganda,UGA,Denmark,DNK,0,0,5,0,5
2019,Ukraine,UKR,Denmark,DNK,0,0,20,0,20
2019,United States of America,USA,Denmark,DNK,0,0,5,0,5
2019,Venezuela (Bolivarian Republic of),VEN,Denmark,DNK,0,0,5,0,5
2019,Stateless,XXA,Denmark,DNK,215,5,94,0,314
2019,Eritrea,ERI,Djibouti,DJI,50,0,0,49,99
2019,Ethiopia,ETH,Djibouti,DJI,0,0,0,61,61
2019,Somalia,SOM,Djibouti,DJI,0,0,0,11,11
2019,Egypt,EGY,Estonia,EST,5,0,0,0,5
2019,Armenia,ARM,Estonia,EST,0,0,5,0,5
2019,Georgia,GEO,Estonia,EST,0,0,5,0,5
2019,Iran (Islamic Rep. of),IRN,Estonia,EST,5,0,0,0,5
2019,Pakistan,PAK,Estonia,EST,5,0,0,0,5
2019,Russian Federation,RUS,Estonia,EST,12,0,13,0,25
2019,Syrian Arab Rep.,SYR,Estonia,EST,5,5,0,0,10
2019,Turkey,TUR,Estonia,EST,17,0,0,0,17
2019,Ukraine,UKR,Estonia,EST,5,0,10,0,15
2019,Afghanistan,AFG,Fiji,FJI,5,0,0,0,5
2019,Pakistan,PAK,Fiji,FJI,5,0,0,0,5
2019,Afghanistan,AFG,France,FRA,495,4037,3093,41,7666
2019,Albania,ALB,France,FRA,114,304,7166,147,7731
2019,Algeria,DZA,France,FRA,110,54,1985,62,2211
2019,Angola,AGO,France,FRA,48,25,535,5,613
2019,Egypt,EGY,France,FRA,41,5,312,0,358
2019,Armenia,ARM,France,FRA,27,41,1339,35,1442
2019,Austria,AUT,France,FRA,0,0,5,0,5
2019,Azerbaijan,AZE,France,FRA,35,5,179,5,224
2019,Burundi,BDI,France,FRA,257,0,103,0,360
2019,Benin,BEN,France,FRA,16,5,70,5,96
2019,Bangladesh,BGD,France,FRA,182,79,3437,10,3708
2019,Burkina Faso,BFA,France,FRA,17,5,98,0,120
2019,Belarus,BLR,France,FRA,10,0,36,10,56
2019,Bolivia (Plurinational State of),BOL,France,FRA,0,0,13,0,13
2019,Brazil,BRA,France,FRA,5,0,43,5,53
2019,Bosnia and Herzegovina,BIH,France,FRA,21,10,374,10,415
2019,Bulgaria,BGR,France,FRA,0,0,5,0,5
2019,Cambodia,KHM,France,FRA,5,0,40,0,45
2019,Canada,CAN,France,FRA,0,0,5,0,5
2019,Central African Rep.,CAF,France,FRA,242,84,212,0,538
2019,Chad,TCD,France,FRA,121,17,591,10,739
2019,China,CHN,France,FRA,1180,0,1530,5,2715
2019,Chile,CHL,France,FRA,0,0,5,0,5
2019,Cameroon,CMR,France,FRA,102,24,416,13,555
2019,Congo,COG,France,FRA,77,14,506,10,607
2019,Dem. Rep. of the Congo,COD,France,FRA,663,97,2234,13,3007
2019,Comoros,COM,France,FRA,36,10,471,28,545
2019,Colombia,COL,France,FRA,13,35,148,12,208
2019,Cuba,CUB,France,FRA,11,0,69,0,80
2019,Djibouti,DJI,France,FRA,5,0,24,0,29
2019,Dominica,DMA,France,FRA,0,0,5,0,5
2019,Dominican Rep.,DOM,France,FRA,5,15,351,13,384
2019,Ecuador,ECU,France,FRA,0,0,5,0,5
2019,Equatorial Guinea,GNQ,France,FRA,0,0,5,0,5
2019,Eritrea,ERI,France,FRA,1153,5,248,5,1411
2019,Ethiopia,ETH,France,FRA,186,5,239,5,435
2019,Gabon,GAB,France,FRA,17,5,130,10,162
2019,Gambia,GMB,France,FRA,26,5,142,0,173
2019,Palestinian,PSE,France,FRA,135,5,129,5,274
2019,United Kingdom of Great Britain and Northern Ireland,GBR,France,FRA,0,0,5,0,5
2019,Georgia,GEO,France,FRA,101,118,7058,101,7378
2019,Germany,DEU,France,FRA,0,0,5,0,5
2019,Ghana,GHA,France,FRA,5,0,83,0,88
2019,Guinea-Bissau,GNB,France,FRA,5,5,57,0,67
2019,Greece,GRC,France,FRA,0,0,10,0,10
2019,Guinea,GIN,France,FRA,910,124,5452,22,6508
2019,Guyana,GUY,France,FRA,0,0,19,0,19
2019,Haiti,HTI,France,FRA,163,98,3884,27,4172
2019,Honduras,HND,France,FRA,0,0,13,0,13
2019,Croatia,HRV,France,FRA,0,0,5,0,5
2019,Hungary,HUN,France,FRA,0,0,5,0,5
2019,Cote d'Ivoire,CIV,France,FRA,673,131,2968,51,3823
2019,India,IND,France,FRA,5,5,276,19,305
2019,Iran (Islamic Rep. of),IRN,France,FRA,105,5,365,13,488
2019,Iraq,IRQ,France,FRA,676,33,379,31,1119
2019,Italy,ITA,France,FRA,0,0,5,0,5
2019,Jamaica,JAM,France,FRA,5,0,5,0,10
2019,Jordan,JOR,France,FRA,0,0,12,0,12
2019,Japan,JPN,France,FRA,0,0,5,0,5
2019,Kazakhstan,KAZ,France,FRA,5,5,138,13,161
2019,Kenya,KEN,France,FRA,5,5,17,0,27
2019,Kyrgyzstan,KGZ,France,FRA,5,0,16,5,26
2019,Kuwait,KWT,France,FRA,23,0,14,0,37
2019,Lao People's Dem. Rep.,LAO,France,FRA,0,0,5,0,5
2019,Liberia,LBR,France,FRA,5,5,16,0,26
2019,Libya,LBY,France,FRA,63,114,244,5,426
2019,Saint Lucia,LCA,France,FRA,5,0,5,0,10
2019,Lebanon,LBN,France,FRA,5,5,92,5,107
2019,Sri Lanka,LKA,France,FRA,214,29,1307,10,1560
2019,Madagascar,MDG,France,FRA,0,0,44,5,49
2019,Mauritania,MRT,France,FRA,136,5,1088,11,1240
2019,North Macedonia,MKD,France,FRA,5,5,521,61,592
2019,Rep. of Moldova,MDA,France,FRA,0,0,433,35,468
2019,Mali,MLI,France,FRA,328,20,3207,33,3588
2019,Malaysia,MYS,France,FRA,0,0,5,0,5
2019,Mongolia,MNG,France,FRA,10,12,141,5,168
2019,Morocco,MAR,France,FRA,72,15,416,19,522
2019,Montenegro,MNE,France,FRA,0,0,69,5,74
2019,Myanmar,MMR,France,FRA,5,0,12,0,17
2019,Nepal,NPL,France,FRA,0,5,74,0,79
2019,Niger,NER,France,FRA,5,5,35,0,45
2019,Nicaragua,NIC,France,FRA,24,0,5,5,34
2019,Nigeria,NGA,France,FRA,187,31,2488,15,2721
2019,Pakistan,PAK,France,FRA,48,17,1969,28,2062
2019,Peru,PER,France,FRA,0,12,58,0,70
2019,Romania,ROU,France,FRA,0,0,5,0,5
2019,South Africa,ZAF,France,FRA,5,0,16,0,21
2019,Russian Federation,RUS,France,FRA,232,53,1492,34,1811
2019,Rwanda,RWA,France,FRA,137,0,105,0,242
2019,El Salvador,SLV,France,FRA,5,5,11,0,21
2019,Saudi Arabia,SAU,France,FRA,5,0,0,0,5
2019,Serbia and Kosovo: S/RES/1244 (1999),SRB,France,FRA,132,111,2454,71,2768
2019,Senegal,SEN,France,FRA,143,23,1483,21,1670
2019,Sierra Leone,SLE,France,FRA,34,10,149,0,193
2019,Somalia,SOM,France,FRA,164,309,1337,10,1820
2019,Viet Nam,VNM,France,FRA,10,0,40,5,55
2019,Sudan,SDN,France,FRA,2397,199,1359,28,3983
2019,Suriname,SUR,France,FRA,0,0,5,0,5
2019,South Sudan,SSD,France,FRA,25,5,20,0,50
2019,Syrian Arab Rep.,SYR,France,FRA,869,1604,553,26,3052
2019,United Rep. of Tanzania,TZA,France,FRA,0,0,17,0,17
2019,Tajikistan,TJK,France,FRA,0,0,54,0,54
2019,Togo,TGO,France,FRA,5,5,109,0,119
2019,Tunisia,TUN,France,FRA,18,13,278,13,322
2019,Turkey,TUR,France,FRA,393,10,1569,37,2009
2019,Uganda,UGA,France,FRA,13,0,13,0,26
2019,Ukraine,UKR,France,FRA,50,32,450,79,611
2019,United States of America,USA,France,FRA,0,0,10,0,10
2019,Uzbekistan,UZB,France,FRA,0,0,10,0,10
2019,Venezuela (Bolivarian Republic of),VEN,France,FRA,169,49,245,23,486
2019,Western Sahara,ESH,France,FRA,29,15,229,0,273
2019,Yemen,YEM,France,FRA,32,69,71,5,177
2019,Zimbabwe,ZWE,France,FRA,0,0,5,0,5
2019,Stateless,XXA,France,FRA,56,0,308,16,380
2019,Afghanistan,AFG,United Kingdom of Great Britain and Northern Ireland,GBR,993,156,517,195,1861
2019,Albania,ALB,United Kingdom of Great Britain and Northern Ireland,GBR,279,55,1249,495,2078
2019,Algeria,DZA,United Kingdom of Great Britain and Northern Ireland,GBR,5,5,89,75,174
2019,Angola,AGO,United Kingdom of Great Britain and Northern Ireland,GBR,13,0,32,0,45
2019,Egypt,EGY,United Kingdom of Great Britain and Northern Ireland,GBR,59,5,161,26,251
2019,Australia,AUS,United Kingdom of Great Britain and Northern Ireland,GBR,0,0,0,5,5
2019,Azerbaijan,AZE,United Kingdom of Great Britain and Northern Ireland,GBR,19,5,20,0,44
2019,Bahrain,BHR,United Kingdom of Great Britain and Northern Ireland,GBR,11,0,0,0,11
2019,Burundi,BDI,United Kingdom of Great Britain and Northern Ireland,GBR,5,0,0,0,5
2019,Benin,BEN,United Kingdom of Great Britain and Northern Ireland,GBR,0,0,5,5,10
2019,Bangladesh,BGD,United Kingdom of Great Britain and Northern Ireland,GBR,88,45,578,112,823
2019,Bahamas,BHS,United Kingdom of Great Britain and Northern Ireland,GBR,0,0,5,0,5
2019,Belarus,BLR,United Kingdom of Great Britain and Northern Ireland,GBR,5,0,0,5,10
2019,Bolivia (Plurinational State of),BOL,United Kingdom of Great Britain and Northern Ireland,GBR,5,0,24,10,39
2019,Botswana,BWA,United Kingdom of Great Britain and Northern Ireland,GBR,10,0,13,0,23
2019,Brazil,BRA,United Kingdom of Great Britain and Northern Ireland,GBR,0,5,56,56,117
2019,Bosnia and Herzegovina,BIH,United Kingdom of Great Britain and Northern Ireland,GBR,0,5,0,0,5
2019,Bulgaria,BGR,United Kingdom of Great Britain and Northern Ireland,GBR,0,0,5,0,5
2019,Canada,CAN,United Kingdom of Great Britain and Northern Ireland,GBR,0,0,5,5,10
2019,Chad,TCD,United Kingdom of Great Britain and Northern Ireland,GBR,15,0,0,5,20
2019,China,CHN,United Kingdom of Great Britain and Northern Ireland,GBR,37,31,380,405,853
2019,Chile,CHL,United Kingdom of Great Britain and Northern Ireland,GBR,0,0,0,5,5
2019,Cameroon,CMR,United Kingdom of Great Britain and Northern Ireland,GBR,52,5,57,10,124
2019,Congo,COG,United Kingdom of Great Britain and Northern Ireland,GBR,5,0,5,0,10
2019,Dem. Rep. of the Congo,COD,United Kingdom of Great Britain and Northern Ireland,GBR,42,5,75,5,127
2019,Dominica,DMA,United Kingdom of Great Britain and Northern Ireland,GBR,5,0,5,0,10
2019,Ecuador,ECU,United Kingdom of Great Britain and Northern Ireland,GBR,0,0,11,0,11
2019,Eritrea,ERI,United Kingdom of Great Britain and Northern Ireland,GBR,1785,5,83,193,2066
2019,Ethiopia,ETH,United Kingdom of Great Britain and Northern Ireland,GBR,86,19,233,59,397
2019,Gambia,GMB,United Kingdom of Great Britain and Northern Ireland,GBR,20,5,44,10,79
2019,Palestinian,PSE,United Kingdom of Great Britain and Northern Ireland,GBR,57,17,74,23,171
2019,Georgia,GEO,United Kingdom of Great Britain and Northern Ireland,GBR,5,0,40,66,111
2019,Ghana,GHA,United Kingdom of Great Britain and Northern Ireland,GBR,10,22,127,53,212
2019,Guinea-Bissau,GNB,United Kingdom of Great Britain and Northern Ireland,GBR,0,0,5,0,5
2019,Grenada,GRD,United Kingdom of Great Britain and Northern Ireland,GBR,0,5,5,0,10
2019,Guatemala,GTM,United Kingdom of Great Britain and Northern Ireland,GBR,0,0,0,5,5
2019,Guinea,GIN,United Kingdom of Great Britain and Northern Ireland,GBR,17,0,13,5,35
2019,"China, Hong Kong SAR",HKG,United Kingdom of Great Britain and Northern Ireland,GBR,0,0,5,0,5
2019,Honduras,HND,United Kingdom of Great Britain and Northern Ireland,GBR,5,5,41,17,68
2019,Hungary,HUN,United Kingdom of Great Britain and Northern Ireland,GBR,0,0,5,0,5
2019,Cote d'Ivoire,CIV,United Kingdom of Great Britain and Northern Ireland,GBR,19,0,28,0,47
2019,India,IND,United Kingdom of Great Britain and Northern Ireland,GBR,5,61,803,695,1564
2019,Indonesia,IDN,United Kingdom of Great Britain and Northern Ireland,GBR,13,0,0,0,13
2019,Iran (Islamic Rep. of),IRN,United Kingdom of Great Britain and Northern Ireland,GBR,2723,14,877,570,4184
2019,Iraq,IRQ,United Kingdom of Great Britain and Northern Ireland,GBR,573,287,1789,495,3144
2019,Israel,ISR,United Kingdom of Great Britain and Northern Ireland,GBR,0,0,0,5,5
2019,Italy,ITA,United Kingdom of Great Britain and Northern Ireland,GBR,0,0,5,0,5
2019,Jamaica,JAM,United Kingdom of Great Britain and Northern Ireland,GBR,5,5,60,10,80
2019,Jordan,JOR,United Kingdom of Great Britain and Northern Ireland,GBR,11,0,36,5,52
2019,Japan,JPN,United Kingdom of Great Britain and Northern Ireland,GBR,0,0,5,0,5
2019,Kazakhstan,KAZ,United Kingdom of Great Britain and Northern Ireland,GBR,0,0,15,5,20
2019,Kenya,KEN,United Kingdom of Great Britain and Northern Ireland,GBR,18,12,77,10,117
2019,Kyrgyzstan,KGZ,United Kingdom of Great Britain and Northern Ireland,GBR,0,0,14,0,14
2019,Dem. People's Rep. of Korea,PRK,United Kingdom of Great Britain and Northern Ireland,GBR,0,0,14,0,14
2019,Kuwait,KWT,United Kingdom of Great Britain and Northern Ireland,GBR,104,0,35,14,153
2019,Liberia,LBR,United Kingdom of Great Britain and Northern Ireland,GBR,0,0,0,5,5
2019,Libya,LBY,United Kingdom of Great Britain and Northern Ireland,GBR,80,698,5,35,818
2019,Saint Lucia,LCA,United Kingdom of Great Britain and Northern Ireland,GBR,0,0,14,5,19
2019,Lebanon,LBN,United Kingdom of Great Britain and Northern Ireland,GBR,5,5,24,5,39
2019,Sri Lanka,LKA,United Kingdom of Great Britain and Northern Ireland,GBR,94,45,217,61,417
2019,Lithuania,LTU,United Kingdom of Great Britain and Northern Ireland,GBR,0,0,5,5,10
2019,Latvia,LVA,United Kingdom of Great Britain and Northern Ireland,GBR,0,0,5,0,5
2019,Maldives,MDV,United Kingdom of Great Britain and Northern Ireland,GBR,0,0,0,11,11
2019,Mexico,MEX,United Kingdom of Great Britain and Northern Ireland,GBR,0,0,5,5,10
2019,Mali,MLI,United Kingdom of Great Britain and Northern Ireland,GBR,0,0,5,0,5
2019,Malaysia,MYS,United Kingdom of Great Britain and Northern Ireland,GBR,30,0,40,26,96
2019,Malawi,MWI,United Kingdom of Great Britain and Northern Ireland,GBR,5,19,25,0,49
2019,Mongolia,MNG,United Kingdom of Great Britain and Northern Ireland,GBR,0,5,16,5,26
2019,Morocco,MAR,United Kingdom of Great Britain and Northern Ireland,GBR,20,0,29,29,78
2019,Mauritius,MUS,United Kingdom of Great Britain and Northern Ireland,GBR,0,5,58,5,68
2019,Myanmar,MMR,United Kingdom of Great Britain and Northern Ireland,GBR,5,0,12,0,17
2019,Namibia,NAM,United Kingdom of Great Britain and Northern Ireland,GBR,15,0,185,36,236
2019,Nepal,NPL,United Kingdom of Great Britain and Northern Ireland,GBR,0,5,54,14,73
2019,Niger,NER,United Kingdom of Great Britain and Northern Ireland,GBR,183,0,5,0,188
2019,Nicaragua,NIC,United Kingdom of Great Britain and Northern Ireland,GBR,10,0,26,5,41
2019,Nigeria,NGA,United Kingdom of Great Britain and Northern Ireland,GBR,0,249,750,92,1091
2019,Oman,OMN,United Kingdom of Great Britain and Northern Ireland,GBR,0,0,0,11,11
2019,Pakistan,PAK,United Kingdom of Great Britain and Northern Ireland,GBR,401,99,821,267,1588
2019,Philippines,PHL,United Kingdom of Great Britain and Northern Ireland,GBR,0,5,34,10,49
2019,Poland,POL,United Kingdom of Great Britain and Northern Ireland,GBR,0,0,13,0,13
2019,Portugal,PRT,United Kingdom of Great Britain and Northern Ireland,GBR,0,0,5,0,5
2019,Romania,ROU,United Kingdom of Great Britain and Northern Ireland,GBR,0,0,5,0,5
2019,South Africa,ZAF,United Kingdom of Great Britain and Northern Ireland,GBR,0,10,67,13,90
2019,Russian Federation,RUS,United Kingdom of Great Britain and Northern Ireland,GBR,154,0,79,22,255
2019,Rwanda,RWA,United Kingdom of Great Britain and Northern Ireland,GBR,0,0,14,0,14
2019,El Salvador,SLV,United Kingdom of Great Britain and Northern Ireland,GBR,108,44,304,50,506
2019,Saudi Arabia,SAU,United Kingdom of Great Britain and Northern Ireland,GBR,52,0,17,14,83
2019,Serbia and Kosovo: S/RES/1244 (1999),SRB,United Kingdom of Great Britain and Northern Ireland,GBR,5,5,14,5,29
2019,Senegal,SEN,United Kingdom of Great Britain and Northern Ireland,GBR,0,0,12,0,12
2019,Sierra Leone,SLE,United Kingdom of Great Britain and Northern Ireland,GBR,21,5,26,5,57
2019,Somalia,SOM,United Kingdom of Great Britain and Northern Ireland,GBR,154,13,78,18,263
2019,Viet Nam,VNM,United Kingdom of Great Britain and Northern Ireland,GBR,266,84,336,115,801
2019,Sudan,SDN,United Kingdom of Great Britain and Northern Ireland,GBR,1625,18,144,160,1947
2019,South Sudan,SSD,United Kingdom of Great Britain and Northern Ireland,GBR,12,0,5,0,17
2019,Syrian Arab Rep.,SYR,United Kingdom of Great Britain and Northern Ireland,GBR,711,5,27,82,825
2019,United Rep. of Tanzania,TZA,United Kingdom of Great Britain and Northern Ireland,GBR,5,5,32,0,42
2019,Thailand,THA,United Kingdom of Great Britain and Northern Ireland,GBR,5,0,12,5,22
2019,Tajikistan,TJK,United Kingdom of Great Britain and Northern Ireland,GBR,0,0,0,5,5
2019,Timor-Leste,TLS,United Kingdom of Great Britain and Northern Ireland,GBR,0,0,5,0,5
2019,Trinidad and Tobago,TTO,United Kingdom of Great Britain and Northern Ireland,GBR,5,0,16,5,26
2019,Tunisia,TUN,United Kingdom of Great Britain and Northern Ireland,GBR,0,0,17,10,27
2019,Turkey,TUR,United Kingdom of Great Britain and Northern Ireland,GBR,660,10,192,51,913
2019,United Arab Emirates,ARE,United Kingdom of Great Britain and Northern Ireland,GBR,5,0,0,0,5
2019,Uganda,UGA,United Kingdom of Great Britain and Northern Ireland,GBR,31,5,25,5,66
2019,Ukraine,UKR,United Kingdom of Great Britain and Northern Ireland,GBR,5,10,134,48,197
2019,United States of America,USA,United Kingdom of Great Britain and Northern Ireland,GBR,10,0,10,20,40
2019,Uzbekistan,UZB,United Kingdom of Great Britain and Northern Ireland,GBR,5,0,5,0,10
2019,Saint Vincent and the Grenadines,VCT,United Kingdom of Great Britain and Northern Ireland,GBR,5,5,0,0,10
2019,Venezuela (Bolivarian Republic of),VEN,United Kingdom of Great Britain and Northern Ireland,GBR,0,0,13,0,13
2019,Yemen,YEM,United Kingdom of Great Britain and Northern Ireland,GBR,88,128,11,17,244
2019,Zambia,ZMB,United Kingdom of Great Britain and Northern Ireland,GBR,0,14,0,0,14
2019,Zimbabwe,ZWE,United Kingdom of Great Britain and Northern Ireland,GBR,23,10,78,12,123
2019,Stateless,XXA,United Kingdom of Great Britain and Northern Ireland,GBR,329,10,65,142,546
2019,Afghanistan,AFG,Georgia,GEO,10,0,29,5,44
2019,Egypt,EGY,Georgia,GEO,18,0,20,24,62
2019,Armenia,ARM,Georgia,GEO,0,0,5,0,5
2019,Azerbaijan,AZE,Georgia,GEO,0,0,13,5,18
2019,Bangladesh,BGD,Georgia,GEO,0,0,18,5,23
2019,Dem. Rep. of the Congo,COD,Georgia,GEO,5,0,0,5,10
2019,Cuba,CUB,Georgia,GEO,0,0,0,5,5
2019,Eritrea,ERI,Georgia,GEO,0,0,0,5,5
2019,Ethiopia,ETH,Georgia,GEO,0,0,0,5,5
2019,Ghana,GHA,Georgia,GEO,0,0,5,0,5
2019,Cote d'Ivoire,CIV,Georgia,GEO,0,0,0,5,5
2019,India,IND,Georgia,GEO,0,0,24,45,69
2019,Iran (Islamic Rep. of),IRN,Georgia,GEO,0,0,71,119,190
2019,Iraq,IRQ,Georgia,GEO,5,5,21,11,42
2019,Jordan,JOR,Georgia,GEO,0,0,0,10,10
2019,Lebanon,LBN,Georgia,GEO,0,0,5,0,5
2019,Nigeria,NGA,Georgia,GEO,0,0,14,5,19
2019,Pakistan,PAK,Georgia,GEO,0,0,5,5,10
2019,South Africa,ZAF,Georgia,GEO,0,0,0,5,5
2019,Russian Federation,RUS,Georgia,GEO,5,0,37,10,52
2019,Saudi Arabia,SAU,Georgia,GEO,0,0,0,5,5
2019,Sierra Leone,SLE,Georgia,GEO,0,0,5,0,5
2019,Somalia,SOM,Georgia,GEO,0,0,0,5,5
2019,Sudan,SDN,Georgia,GEO,0,0,0,5,5
2019,Syrian Arab Rep.,SYR,Georgia,GEO,0,5,15,0,20
2019,Turkey,TUR,Georgia,GEO,0,0,79,24,103
2019,Ukraine,UKR,Georgia,GEO,0,0,0,11,11
2019,Yemen,YEM,Georgia,GEO,0,24,5,16,45
2019,Congo,COG,Ghana,GHA,0,0,0,11,11
2019,Dem. Rep. of the Congo,COD,Ghana,GHA,0,0,0,16,16
2019,Eritrea,ERI,Ghana,GHA,0,0,0,22,22
2019,Ethiopia,ETH,Ghana,GHA,0,0,0,5,5
2019,Cote d'Ivoire,CIV,Ghana,GHA,69,0,0,62,131
2019,Nigeria,NGA,Ghana,GHA,0,0,0,10,10
2019,Sierra Leone,SLE,Ghana,GHA,0,0,0,5,5
2019,Sudan,SDN,Ghana,GHA,60,0,0,5,65
2019,Syrian Arab Rep.,SYR,Ghana,GHA,0,0,0,12,12
2019,Togo,TGO,Ghana,GHA,0,0,0,13,13
2019,Afghanistan,AFG,Greece,GRC,1692,2257,1462,3697,9108
2019,Albania,ALB,Greece,GRC,10,0,1886,721,2617
2019,Algeria,DZA,Greece,GRC,12,0,140,438,590
2019,Angola,AGO,Greece,GRC,0,0,0,14,14
2019,Egypt,EGY,Greece,GRC,79,0,638,472,1189
2019,Armenia,ARM,Greece,GRC,0,0,43,26,69
2019,Burundi,BDI,Greece,GRC,13,0,0,0,13
2019,Bangladesh,BGD,Greece,GRC,22,0,1044,332,1398
2019,Burkina Faso,BFA,Greece,GRC,0,0,12,10,22
2019,Belarus,BLR,Greece,GRC,0,0,13,0,13
2019,Brazil,BRA,Greece,GRC,0,0,0,5,5
2019,Chad,TCD,Greece,GRC,5,0,0,0,5
2019,China,CHN,Greece,GRC,14,0,148,168,330
2019,Cameroon,CMR,Greece,GRC,155,10,232,227,624
2019,Congo,COG,Greece,GRC,32,0,34,23,89
2019,Dem. Rep. of the Congo,COD,Greece,GRC,156,26,347,407,936
2019,Comoros,COM,Greece,GRC,0,0,5,5,10
2019,Colombia,COL,Greece,GRC,0,0,5,0,5
2019,Cuba,CUB,Greece,GRC,0,0,5,10,15
2019,Djibouti,DJI,Greece,GRC,5,0,0,0,5
2019,Dominican Rep.,DOM,Greece,GRC,0,0,5,14,19
2019,Eritrea,ERI,Greece,GRC,267,0,5,50,322
2019,Ethiopia,ETH,Greece,GRC,53,0,28,21,102
2019,Gabon,GAB,Greece,GRC,0,0,0,5,5
2019,Gambia,GMB,Greece,GRC,5,0,28,18,51
2019,Palestinian,PSE,Greece,GRC,1379,87,18,374,1858
2019,Georgia,GEO,Greece,GRC,0,0,779,388,1167
2019,Ghana,GHA,Greece,GRC,5,0,97,38,140
2019,Guinea-Bissau,GNB,Greece,GRC,0,0,0,5,5
2019,Guinea,GIN,Greece,GRC,14,0,38,24,76
2019,Haiti,HTI,Greece,GRC,0,0,0,5,5
2019,Cote d'Ivoire,CIV,Greece,GRC,0,0,14,11,25
2019,India,IND,Greece,GRC,0,0,108,43,151
2019,Indonesia,IDN,Greece,GRC,0,0,10,5,15
2019,Iran (Islamic Rep. of),IRN,Greece,GRC,389,11,251,637,1288
2019,Iraq,IRQ,Greece,GRC,1808,967,1285,2197,6257
2019,Jordan,JOR,Greece,GRC,5,0,10,21,36
2019,Kazakhstan,KAZ,Greece,GRC,0,0,0,5,5
2019,Kenya,KEN,Greece,GRC,0,0,0,5,5
2019,Kuwait,KWT,Greece,GRC,19,0,0,30,49
2019,Libya,LBY,Greece,GRC,0,0,10,34,44
2019,Lebanon,LBN,Greece,GRC,14,0,21,13,48
2019,Sri Lanka,LKA,Greece,GRC,0,0,19,39,58
2019,Mauritania,MRT,Greece,GRC,5,0,0,5,10
2019,North Macedonia,MKD,Greece,GRC,0,0,5,0,5
2019,Rep. of Moldova,MDA,Greece,GRC,0,0,14,17,31
2019,Mali,MLI,Greece,GRC,5,5,14,16,40
2019,Morocco,MAR,Greece,GRC,25,0,89,162,276
2019,Myanmar,MMR,Greece,GRC,27,0,5,5,37
2019,Nepal,NPL,Greece,GRC,0,0,55,36,91
2019,Nigeria,NGA,Greece,GRC,12,0,63,79,154
2019,Pakistan,PAK,Greece,GRC,106,12,4342,1724,6184
2019,Paraguay,PRY,Greece,GRC,0,0,5,0,5
2019,Philippines,PHL,Greece,GRC,0,0,5,0,5
2019,Russian Federation,RUS,Greece,GRC,5,0,15,18,38
2019,El Salvador,SLV,Greece,GRC,5,0,0,0,5
2019,Serbia and Kosovo: S/RES/1244 (1999),SRB,Greece,GRC,0,0,0,5,5
2019,Senegal,SEN,Greece,GRC,0,0,16,17,33
2019,Sierra Leone,SLE,Greece,GRC,5,0,18,13,36
2019,Somalia,SOM,Greece,GRC,239,298,17,91,645
2019,Viet Nam,VNM,Greece,GRC,0,0,0,14,14
2019,Sudan,SDN,Greece,GRC,17,5,17,15,54
2019,South Sudan,SSD,Greece,GRC,5,5,0,0,10
2019,Syrian Arab Rep.,SYR,Greece,GRC,6566,0,37,2385,8988
2019,Turkmenistan,TKM,Greece,GRC,5,0,0,5,10
2019,Togo,TGO,Greece,GRC,18,0,43,10,71
2019,Tunisia,TUN,Greece,GRC,0,0,12,26,38
2019,Turkey,TUR,Greece,GRC,168,0,45,3299,3512
2019,Uganda,UGA,Greece,GRC,5,0,10,10,25
2019,Ukraine,UKR,Greece,GRC,0,5,71,28,104
2019,Uzbekistan,UZB,Greece,GRC,0,0,0,5,5
2019,Venezuela (Bolivarian Republic of),VEN,Greece,GRC,0,0,10,5,15
2019,Western Sahara,ESH,Greece,GRC,5,0,0,0,5
2019,Yemen,YEM,Greece,GRC,55,150,0,37,242
2019,Zimbabwe,ZWE,Greece,GRC,5,0,0,0,5
2019,Stateless,XXA,Greece,GRC,88,0,5,166,259
2019,Honduras,HND,Guatemala,GTM,5,0,5,5,15
2019,Nicaragua,NIC,Guatemala,GTM,0,0,5,43,48
2019,Russian Federation,RUS,Guatemala,GTM,5,0,0,0,5
2019,El Salvador,SLV,Guatemala,GTM,13,0,10,10,33
2019,Venezuela (Bolivarian Republic of),VEN,Guatemala,GTM,10,0,0,0,10
2019,Cameroon,CMR,Guinea,GIN,5,0,0,0,5
2019,Dem. Rep. of the Congo,COD,Guinea,GIN,0,0,0,5,5
2019,Eritrea,ERI,Guinea,GIN,10,0,0,0,10
2019,Cote d'Ivoire,CIV,Guinea,GIN,27,0,0,0,27
2019,Liberia,LBR,Guinea,GIN,10,0,0,41,51
2019,Sierra Leone,SLE,Guinea,GIN,282,0,5,0,287
2019,Syrian Arab Rep.,SYR,Guinea,GIN,11,0,0,0,11
2019,Nicaragua,NIC,Honduras,HND,35,0,0,41,76
2019,El Salvador,SLV,Honduras,HND,10,0,0,0,10
2019,Afghanistan,AFG,Croatia,HRV,0,0,10,136,146
2019,Algeria,DZA,Croatia,HRV,0,0,81,10,91
2019,Egypt,EGY,Croatia,HRV,0,0,0,5,5
2019,Cuba,CUB,Croatia,HRV,0,0,5,11,16
2019,Palestinian,PSE,Croatia,HRV,0,0,0,29,29
2019,Iran (Islamic Rep. of),IRN,Croatia,HRV,5,0,21,111,137
2019,Iraq,IRQ,Croatia,HRV,10,0,5,174,189
2019,Libya,LBY,Croatia,HRV,0,0,5,23,28
2019,Morocco,MAR,Croatia,HRV,0,0,17,5,22
2019,Pakistan,PAK,Croatia,HRV,0,0,5,15,20
2019,Russian Federation,RUS,Croatia,HRV,0,0,0,5,5
2019,Serbia and Kosovo: S/RES/1244 (1999),SRB,Croatia,HRV,0,0,5,0,5
2019,Somalia,SOM,Croatia,HRV,5,0,0,5,10
2019,Syrian Arab Rep.,SYR,Croatia,HRV,127,0,5,0,132
2019,Tunisia,TUN,Croatia,HRV,0,0,17,5,22
2019,Turkey,TUR,Croatia,HRV,0,0,10,30,40
2019,Ukraine,UKR,Croatia,HRV,0,0,5,0,5
2019,Yemen,YEM,Croatia,HRV,0,0,0,5,5
2019,Stateless,XXA,Croatia,HRV,0,0,0,17,17
2019,Afghanistan,AFG,Hungary,HUN,0,5,316,17,338
2019,Eritrea,ERI,Hungary,HUN,5,0,0,0,5
2019,Ghana,GHA,Hungary,HUN,0,0,5,0,5
2019,Iran (Islamic Rep. of),IRN,Hungary,HUN,5,14,21,0,40
2019,Iraq,IRQ,Hungary,HUN,0,0,260,20,280
2019,Nigeria,NGA,Hungary,HUN,0,0,5,0,5
2019,Pakistan,PAK,Hungary,HUN,11,0,0,0,11
2019,Somalia,SOM,Hungary,HUN,0,0,5,0,5
2019,Syrian Arab Rep.,SYR,Hungary,HUN,0,0,13,11,24
2019,Tajikistan,TJK,Hungary,HUN,0,0,10,0,10
2019,Turkey,TUR,Hungary,HUN,0,0,5,0,5
2019,Afghanistan,AFG,Iceland,ISL,10,10,0,44,64
2019,Albania,ALB,Iceland,ISL,0,0,22,18,40
2019,Egypt,EGY,Iceland,ISL,12,0,5,0,17
2019,Azerbaijan,AZE,Iceland,ISL,0,0,0,5,5
2019,China,CHN,Iceland,ISL,0,0,0,5,5
2019,Colombia,COL,Iceland,ISL,0,0,10,0,10
2019,Palestinian,PSE,Iceland,ISL,5,10,0,5,20
2019,Georgia,GEO,Iceland,ISL,0,0,14,14,28
2019,Ghana,GHA,Iceland,ISL,0,0,5,10,15
2019,India,IND,Iceland,ISL,0,0,0,5,5
2019,Iran (Islamic Rep. of),IRN,Iceland,ISL,16,0,0,27,43
2019,Iraq,IRQ,Iceland,ISL,23,10,33,115,181
2019,Kazakhstan,KAZ,Iceland,ISL,0,0,5,0,5
2019,Libya,LBY,Iceland,ISL,0,0,0,5,5
2019,Lebanon,LBN,Iceland,ISL,5,0,0,0,5
2019,Rep. of Moldova,MDA,Iceland,ISL,0,0,46,12,58
2019,Morocco,MAR,Iceland,ISL,0,0,5,10,15
2019,Nigeria,NGA,Iceland,ISL,5,0,5,48,58
2019,Pakistan,PAK,Iceland,ISL,0,0,12,14,26
2019,Peru,PER,Iceland,ISL,5,0,0,0,5
2019,Romania,ROU,Iceland,ISL,0,0,0,5,5
2019,Russian Federation,RUS,Iceland,ISL,0,0,5,13,18
2019,El Salvador,SLV,Iceland,ISL,0,5,0,0,5
2019,Somalia,SOM,Iceland,ISL,5,5,5,40,55
2019,Syrian Arab Rep.,SYR,Iceland,ISL,5,10,0,21,36
2019,Tunisia,TUN,Iceland,ISL,0,0,0,10,10
2019,Turkey,TUR,Iceland,ISL,5,0,0,0,5
2019,Ukraine,UKR,Iceland,ISL,0,0,24,5,29
2019,Venezuela (Bolivarian Republic of),VEN,Iceland,ISL,5,152,0,0,157
2019,Yemen,YEM,Iceland,ISL,0,0,0,5,5
2019,Afghanistan,AFG,Ireland,IRL,32,26,5,46,109
2019,Albania,ALB,Ireland,IRL,5,0,404,826,1235
2019,Algeria,DZA,Ireland,IRL,5,5,79,30,119
2019,Angola,AGO,Ireland,IRL,0,0,13,0,13
2019,Egypt,EGY,Ireland,IRL,5,0,22,15,42
2019,Armenia,ARM,Ireland,IRL,0,0,5,0,5
2019,Bangladesh,BGD,Ireland,IRL,5,10,96,5,116
2019,Belarus,BLR,Ireland,IRL,0,0,5,0,5
2019,Bolivia (Plurinational State of),BOL,Ireland,IRL,12,0,0,0,12
2019,Botswana,BWA,Ireland,IRL,0,0,5,5,10
2019,Brazil,BRA,Ireland,IRL,5,0,68,10,83
2019,Chad,TCD,Ireland,IRL,0,0,0,5,5
2019,China,CHN,Ireland,IRL,12,0,11,50,73
2019,Chile,CHL,Ireland,IRL,0,0,0,5,5
2019,Cameroon,CMR,Ireland,IRL,5,0,13,0,18
2019,Dem. Rep. of the Congo,COD,Ireland,IRL,51,12,78,5,146
2019,Eritrea,ERI,Ireland,IRL,28,0,0,5,33
2019,Ethiopia,ETH,Ireland,IRL,5,0,0,5,10
2019,Palestinian,PSE,Ireland,IRL,28,0,5,5,38
2019,Georgia,GEO,Ireland,IRL,5,0,340,68,413
2019,Ghana,GHA,Ireland,IRL,5,0,16,0,21
2019,Guatemala,GTM,Ireland,IRL,5,0,0,0,5
2019,Cote d'Ivoire,CIV,Ireland,IRL,0,0,5,0,5
2019,India,IND,Ireland,IRL,0,0,34,21,55
2019,Iran (Islamic Rep. of),IRN,Ireland,IRL,15,0,5,15,35
2019,Iraq,IRQ,Ireland,IRL,18,5,16,28,67
2019,Israel,ISR,Ireland,IRL,11,0,0,0,11
2019,Kenya,KEN,Ireland,IRL,11,0,0,0,11
2019,Kyrgyzstan,KGZ,Ireland,IRL,0,0,5,0,5
2019,Rep. of Korea,KOR,Ireland,IRL,0,0,0,5,5
2019,Kuwait,KWT,Ireland,IRL,0,0,0,13,13
2019,Libya,LBY,Ireland,IRL,49,20,0,5,74
2019,Lebanon,LBN,Ireland,IRL,0,0,5,0,5
2019,Sri Lanka,LKA,Ireland,IRL,0,0,0,5,5
2019,Malaysia,MYS,Ireland,IRL,0,0,14,0,14
2019,Malawi,MWI,Ireland,IRL,10,5,82,5,102
2019,Mongolia,MNG,Ireland,IRL,0,0,12,0,12
2019,Morocco,MAR,Ireland,IRL,0,0,5,14,19
2019,Mauritius,MUS,Ireland,IRL,5,5,14,5,29
2019,Myanmar,MMR,Ireland,IRL,5,0,0,0,5
2019,Nepal,NPL,Ireland,IRL,5,0,5,0,10
2019,Nicaragua,NIC,Ireland,IRL,5,0,0,0,5
2019,Nigeria,NGA,Ireland,IRL,23,0,151,41,215
2019,Pakistan,PAK,Ireland,IRL,41,5,343,50,439
2019,South Africa,ZAF,Ireland,IRL,0,0,127,45,172
2019,Russian Federation,RUS,Ireland,IRL,13,0,5,0,18
2019,Rwanda,RWA,Ireland,IRL,5,0,0,0,5
2019,El Salvador,SLV,Ireland,IRL,5,0,0,0,5
2019,Saudi Arabia,SAU,Ireland,IRL,5,0,0,0,5
2019,Serbia and Kosovo: S/RES/1244 (1999),SRB,Ireland,IRL,0,0,12,0,12
2019,Sierra Leone,SLE,Ireland,IRL,15,0,5,0,20
2019,Somalia,SOM,Ireland,IRL,23,16,0,25,64
2019,Viet Nam,VNM,Ireland,IRL,0,0,5,5,10
2019,Sudan,SDN,Ireland,IRL,40,5,5,5,55
2019,Eswatini,SWZ,Ireland,IRL,0,0,15,0,15
2019,Syrian Arab Rep.,SYR,Ireland,IRL,85,0,0,27,112
2019,Trinidad and Tobago,TTO,Ireland,IRL,5,0,0,0,5
2019,Tunisia,TUN,Ireland,IRL,0,0,0,5,5
2019,Uganda,UGA,Ireland,IRL,5,0,5,0,10
2019,Ukraine,UKR,Ireland,IRL,5,0,13,0,18
2019,United States of America,USA,Ireland,IRL,0,0,5,5,10
2019,Venezuela (Bolivarian Republic of),VEN,Ireland,IRL,34,5,10,0,49
2019,Yemen,YEM,Ireland,IRL,5,0,0,0,5
2019,Zambia,ZMB,Ireland,IRL,0,0,5,0,5
2019,Zimbabwe,ZWE,Ireland,IRL,70,10,246,10,336
2019,Afghanistan,AFG,Italy,ITA,276,632,61,38,1007
2019,Albania,ALB,Italy,ITA,96,29,1451,5,1581
2019,Algeria,DZA,Italy,ITA,23,5,156,0,184
2019,Angola,AGO,Italy,ITA,0,5,5,0,10
2019,Egypt,EGY,Italy,ITA,65,26,824,0,915
2019,Argentina,ARG,Italy,ITA,0,0,15,0,15
2019,Armenia,ARM,Italy,ITA,27,29,100,5,161
2019,Azerbaijan,AZE,Italy,ITA,22,0,20,0,42
2019,Burundi,BDI,Italy,ITA,0,5,0,0,5
2019,Benin,BEN,Italy,ITA,23,5,89,0,117
2019,Bangladesh,BGD,Italy,ITA,280,255,7751,5,8291
2019,Burkina Faso,BFA,Italy,ITA,28,63,361,0,452
2019,Belarus,BLR,Italy,ITA,0,0,31,0,31
2019,Bolivia (Plurinational State of),BOL,Italy,ITA,5,0,16,0,21
2019,Brazil,BRA,Italy,ITA,65,5,186,0,256
2019,Bosnia and Herzegovina,BIH,Italy,ITA,5,5,61,0,71
2019,Central African Rep.,CAF,Italy,ITA,5,5,0,0,10
2019,Chad,TCD,Italy,ITA,5,11,44,0,60
2019,China,CHN,Italy,ITA,51,5,697,0,753
2019,Chile,CHL,Italy,ITA,0,0,12,0,12
2019,Cameroon,CMR,Italy,ITA,278,138,658,0,1074
2019,Dem. Rep. of the Congo,COD,Italy,ITA,41,15,65,0,121
2019,Comoros,COM,Italy,ITA,0,0,20,0,20
2019,Colombia,COL,Italy,ITA,162,79,443,0,684
2019,Cuba,CUB,Italy,ITA,23,10,158,0,191
2019,Cabo Verde,CPV,Italy,ITA,0,0,5,0,5
2019,Dominican Rep.,DOM,Italy,ITA,10,0,33,0,43
2019,Ecuador,ECU,Italy,ITA,0,0,25,0,25
2019,Equatorial Guinea,GNQ,Italy,ITA,0,0,5,0,5
2019,Eritrea,ERI,Italy,ITA,116,27,93,0,236
2019,Ethiopia,ETH,Italy,ITA,37,11,31,0,79
2019,Gabon,GAB,Italy,ITA,0,0,10,0,10
2019,Gambia,GMB,Italy,ITA,280,138,3972,5,4395
2019,Palestinian,PSE,Italy,ITA,33,5,18,0,56
2019,Georgia,GEO,Italy,ITA,169,54,1144,0,1367
2019,Germany,DEU,Italy,ITA,0,0,5,0,5
2019,Ghana,GHA,Italy,ITA,134,96,2626,0,2856
2019,Guinea-Bissau,GNB,Italy,ITA,15,24,535,0,574
2019,Guatemala,GTM,Italy,ITA,5,5,11,0,21
2019,Guinea,GIN,Italy,ITA,213,86,2760,0,3059
2019,Honduras,HND,Italy,ITA,87,83,186,0,356
2019,Cote d'Ivoire,CIV,Italy,ITA,344,141,3257,5,3747
2019,India,IND,Italy,ITA,59,15,1124,0,1198
2019,Indonesia,IDN,Italy,ITA,0,5,0,0,5
2019,Iran (Islamic Rep. of),IRN,Italy,ITA,182,5,82,0,269
2019,Iraq,IRQ,Italy,ITA,326,494,250,15,1085
2019,Jamaica,JAM,Italy,ITA,5,0,0,0,5
2019,Jordan,JOR,Italy,ITA,0,0,12,0,12
2019,Kazakhstan,KAZ,Italy,ITA,5,5,24,0,34
2019,Kenya,KEN,Italy,ITA,5,0,29,0,34
2019,Kyrgyzstan,KGZ,Italy,ITA,14,0,123,0,137
2019,Kuwait,KWT,Italy,ITA,5,0,0,0,5
2019,Liberia,LBR,Italy,ITA,16,15,192,13,236
2019,Libya,LBY,Italy,ITA,117,178,96,0,391
2019,Lebanon,LBN,Italy,ITA,42,5,20,0,67
2019,Liechtenstein,LIE,Italy,ITA,0,0,5,0,5
2019,Sri Lanka,LKA,Italy,ITA,35,23,554,0,612
2019,Madagascar,MDG,Italy,ITA,0,0,10,0,10
2019,Mauritania,MRT,Italy,ITA,10,0,23,0,33
2019,North Macedonia,MKD,Italy,ITA,10,0,43,0,53
2019,Rep. of Moldova,MDA,Italy,ITA,11,5,67,0,83
2019,Mexico,MEX,Italy,ITA,5,0,13,0,18
2019,Mali,MLI,Italy,ITA,167,672,3346,17,4202
2019,Malaysia,MYS,Italy,ITA,5,0,5,0,10
2019,Morocco,MAR,Italy,ITA,153,55,2347,0,2555
2019,Montenegro,MNE,Italy,ITA,0,0,5,0,5
2019,Mauritius,MUS,Italy,ITA,0,0,12,0,12
2019,Myanmar,MMR,Italy,ITA,0,0,14,0,14
2019,Nepal,NPL,Italy,ITA,15,0,101,0,116
2019,Niger,NER,Italy,ITA,19,84,154,0,257
2019,Nicaragua,NIC,Italy,ITA,24,5,31,0,60
2019,Nigeria,NGA,Italy,ITA,2474,448,13721,26,16669
2019,Pakistan,PAK,Italy,ITA,718,1096,10156,46,12016
2019,Paraguay,PRY,Italy,ITA,0,0,5,0,5
2019,Peru,PER,Italy,ITA,118,30,1155,0,1303
2019,Philippines,PHL,Italy,ITA,14,10,163,0,187
2019,South Africa,ZAF,Italy,ITA,0,5,5,0,10
2019,Russian Federation,RUS,Italy,ITA,57,31,189,0,277
2019,Rwanda,RWA,Italy,ITA,5,0,5,0,10
2019,El Salvador,SLV,Italy,ITA,704,956,1577,0,3237
2019,Saudi Arabia,SAU,Italy,ITA,10,5,0,0,15
2019,Serbia and Kosovo: S/RES/1244 (1999),SRB,Italy,ITA,10,12,64,0,86
2019,Senegal,SEN,Italy,ITA,213,134,5327,5,5679
2019,Sierra Leone,SLE,Italy,ITA,67,12,438,0,517
2019,Somalia,SOM,Italy,ITA,362,294,51,5,712
2019,Viet Nam,VNM,Italy,ITA,0,0,5,0,5
2019,Sudan,SDN,Italy,ITA,104,36,99,0,239
2019,South Sudan,SSD,Italy,ITA,0,14,0,0,14
2019,Syrian Arab Rep.,SYR,Italy,ITA,113,16,25,0,154
2019,United Rep. of Tanzania,TZA,Italy,ITA,0,0,5,0,5
2019,Thailand,THA,Italy,ITA,0,0,5,0,5
2019,Tajikistan,TJK,Italy,ITA,0,0,5,0,5
2019,Togo,TGO,Italy,ITA,25,26,338,0,389
2019,Tunisia,TUN,Italy,ITA,36,5,838,0,879
2019,Turkey,TUR,Italy,ITA,271,76,252,5,604
2019,United Arab Emirates,ARE,Italy,ITA,5,0,0,0,5
2019,Uganda,UGA,Italy,ITA,12,0,5,0,17
2019,Ukraine,UKR,Italy,ITA,105,387,3515,0,4007
2019,United States of America,USA,Italy,ITA,0,0,5,0,5
2019,Uzbekistan,UZB,Italy,ITA,0,0,5,0,5
2019,Venezuela (Bolivarian Republic of),VEN,Italy,ITA,445,980,136,0,1561
2019,Yemen,YEM,Italy,ITA,13,0,0,0,13
2019,Zimbabwe,ZWE,Italy,ITA,5,0,0,0,5
2019,Afghanistan,AFG,Japan,JPN,16,0,0,0,0
2019,Bangladesh,BGD,Japan,JPN,0,0,52,52,0
2019,Cambodia,KHM,Japan,JPN,0,0,0,156,0
2019,China,CHN,Japan,JPN,0,0,60,60,0
2019,India,IND,Japan,JPN,0,0,126,126,0
2019,Sri Lanka,LKA,Japan,JPN,0,5,1002,267,1274
2019,Myanmar,MMR,Japan,JPN,0,0,129,130,0
2019,Nepal,NPL,Japan,JPN,0,0,761,536,0
2019,Nigeria,NGA,Japan,JPN,0,5,0,0,0
2019,Pakistan,PAK,Japan,JPN,0,0,0,141,0
2019,Philippines,PHL,Japan,JPN,0,0,846,181,0
2019,Turkey,TUR,Japan,JPN,0,12,424,182,0
2019,Afghanistan,AFG,Kazakhstan,KAZ,10,0,142,14,166
2019,China,CHN,Kazakhstan,KAZ,0,0,5,0,5
2019,Syrian Arab Rep.,SYR,Kazakhstan,KAZ,0,0,11,0,11
2019,Afghanistan,AFG,Kenya,KEN,0,0,0,5,5
2019,Angola,AGO,Kenya,KEN,0,0,0,5,5
2019,Burundi,BDI,Kenya,KEN,995,0,0,823,1818
2019,Cameroon,CMR,Kenya,KEN,0,0,0,5,5
2019,Congo,COG,Kenya,KEN,10,0,0,18,28
2019,Dem. Rep. of the Congo,COD,Kenya,KEN,3744,0,32,1895,5671
2019,Eritrea,ERI,Kenya,KEN,100,0,0,370,470
2019,Ethiopia,ETH,Kenya,KEN,974,0,31,910,1915
2019,Rwanda,RWA,Kenya,KEN,44,0,0,158,202
2019,Somalia,SOM,Kenya,KEN,38,0,0,645,683
2019,Sudan,SDN,Kenya,KEN,188,0,0,315,503
2019,South Sudan,SSD,Kenya,KEN,0,0,0,16,16
2019,Syrian Arab Rep.,SYR,Kenya,KEN,5,0,0,5,10
2019,United Rep. of Tanzania,TZA,Kenya,KEN,0,0,0,5,5
2019,Turkey,TUR,Kenya,KEN,41,0,0,0,41
2019,Uganda,UGA,Kenya,KEN,112,0,0,227,339
2019,Yemen,YEM,Kenya,KEN,17,0,0,34,51
2019,Afghanistan,AFG,Kyrgyzstan,KGZ,5,0,26,25,56
2019,China,CHN,Kyrgyzstan,KGZ,0,0,0,5,5
2019,Iraq,IRQ,Kyrgyzstan,KGZ,5,0,0,0,5
2019,Syrian Arab Rep.,SYR,Kyrgyzstan,KGZ,14,0,0,0,14
2019,Turkey,TUR,Kyrgyzstan,KGZ,0,0,0,23,23
2019,Ukraine,UKR,Kyrgyzstan,KGZ,5,0,0,0,5
2019,Dem. Rep. of the Congo,COD,Liberia,LBR,12,0,0,0,12
2019,Iraq,IRQ,Liberia,LBR,0,0,0,5,5
2019,Nigeria,NGA,Liberia,LBR,0,0,0,10,10
2019,Rwanda,RWA,Liberia,LBR,0,0,0,5,5
2019,Turkey,TUR,Liberia,LBR,0,0,0,5,5
2019,Dem. Rep. of the Congo,COD,Lesotho,LSO,54,0,0,0,54
2019,Eritrea,ERI,Lesotho,LSO,20,0,0,0,20
2019,Ethiopia,ETH,Lesotho,LSO,0,5,0,0,5
2019,Eritrea,ERI,Liechtenstein,LIE,0,0,0,5,5
2019,Georgia,GEO,Liechtenstein,LIE,0,0,0,5,5
2019,Iran (Islamic Rep. of),IRN,Liechtenstein,LIE,0,5,0,0,5
2019,Serbia and Kosovo: S/RES/1244 (1999),SRB,Liechtenstein,LIE,0,0,5,0,5
2019,Afghanistan,AFG,Lithuania,LTU,13,0,5,5,23
2019,Armenia,ARM,Lithuania,LTU,0,0,0,10,10
2019,Azerbaijan,AZE,Lithuania,LTU,5,0,5,17,27
2019,Belarus,BLR,Lithuania,LTU,0,0,0,11,11
2019,Iran (Islamic Rep. of),IRN,Lithuania,LTU,0,0,0,14,14
2019,Iraq,IRQ,Lithuania,LTU,0,5,0,19,24
2019,Kazakhstan,KAZ,Lithuania,LTU,0,0,5,0,5
2019,Kyrgyzstan,KGZ,Lithuania,LTU,0,0,12,0,12
2019,Sri Lanka,LKA,Lithuania,LTU,0,0,0,14,14
2019,Nigeria,NGA,Lithuania,LTU,0,0,5,5,10
2019,Russian Federation,RUS,Lithuania,LTU,10,0,71,44,125
2019,Syrian Arab Rep.,SYR,Lithuania,LTU,16,0,0,5,21
2019,Tajikistan,TJK,Lithuania,LTU,16,5,92,34,147
2019,Turkey,TUR,Lithuania,LTU,18,0,0,0,18
2019,Ukraine,UKR,Lithuania,LTU,0,0,15,0,15
2019,Uzbekistan,UZB,Lithuania,LTU,0,0,5,0,5
2019,Stateless,XXA,Lithuania,LTU,0,0,0,5,5
2019,Afghanistan,AFG,Luxembourg,LUX,50,5,15,0,70
2019,Albania,ALB,Luxembourg,LUX,0,0,50,0,50
2019,Algeria,DZA,Luxembourg,LUX,0,0,30,0,30
2019,Egypt,EGY,Luxembourg,LUX,0,0,5,0,5
2019,Benin,BEN,Luxembourg,LUX,0,0,10,0,10
2019,Belarus,BLR,Luxembourg,LUX,0,0,5,0,5
2019,Cameroon,CMR,Luxembourg,LUX,0,0,10,0,10
2019,Eritrea,ERI,Luxembourg,LUX,180,0,20,0,200
2019,Ethiopia,ETH,Luxembourg,LUX,5,0,10,0,15
2019,Georgia,GEO,Luxembourg,LUX,0,0,20,0,20
2019,Guinea,GIN,Luxembourg,LUX,0,0,25,0,25
2019,Cote d'Ivoire,CIV,Luxembourg,LUX,0,0,10,0,10
2019,Iran (Islamic Rep. of),IRN,Luxembourg,LUX,20,5,5,0,30
2019,Iraq,IRQ,Luxembourg,LUX,55,0,75,0,130
2019,Libya,LBY,Luxembourg,LUX,0,0,5,0,5
2019,Lebanon,LBN,Luxembourg,LUX,0,0,5,0,5
2019,North Macedonia,MKD,Luxembourg,LUX,0,0,10,0,10
2019,Morocco,MAR,Luxembourg,LUX,0,0,15,0,15
2019,Montenegro,MNE,Luxembourg,LUX,0,0,10,0,10
2019,Nigeria,NGA,Luxembourg,LUX,0,0,5,0,5
2019,Russian Federation,RUS,Luxembourg,LUX,0,0,10,0,10
2019,Serbia and Kosovo: S/RES/1244 (1999),SRB,Luxembourg,LUX,0,0,30,0,30
2019,Senegal,SEN,Luxembourg,LUX,0,0,5,0,5
2019,Somalia,SOM,Luxembourg,LUX,0,0,15,0,15
2019,Sudan,SDN,Luxembourg,LUX,5,0,15,0,20
2019,Syrian Arab Rep.,SYR,Luxembourg,LUX,265,0,30,0,295
2019,Togo,TGO,Luxembourg,LUX,0,0,5,0,5
2019,Tunisia,TUN,Luxembourg,LUX,0,0,20,0,20
2019,Turkey,TUR,Luxembourg,LUX,10,0,15,0,25
2019,Ukraine,UKR,Luxembourg,LUX,0,0,15,0,15
2019,Venezuela (Bolivarian Republic of),VEN,Luxembourg,LUX,0,15,0,0,15
2019,Yemen,YEM,Luxembourg,LUX,10,0,5,0,15
2019,Stateless,XXA,Luxembourg,LUX,5,0,0,0,5
2019,Afghanistan,AFG,Latvia,LVA,0,0,0,5,5
2019,Egypt,EGY,Latvia,LVA,0,0,10,0,10
2019,Armenia,ARM,Latvia,LVA,0,0,5,0,5
2019,Azerbaijan,AZE,Latvia,LVA,5,0,13,5,23
2019,Bangladesh,BGD,Latvia,LVA,0,0,5,0,5
2019,Belarus,BLR,Latvia,LVA,0,0,0,5,5
2019,Cuba,CUB,Latvia,LVA,0,0,5,5,10
2019,Georgia,GEO,Latvia,LVA,0,0,11,0,11
2019,India,IND,Latvia,LVA,0,0,13,0,13
2019,Iraq,IRQ,Latvia,LVA,0,0,0,10,10
2019,Sri Lanka,LKA,Latvia,LVA,0,0,0,5,5
2019,Mongolia,MNG,Latvia,LVA,0,0,5,0,5
2019,Nigeria,NGA,Latvia,LVA,0,0,10,0,10
2019,Russian Federation,RUS,Latvia,LVA,19,0,16,5,40
2019,Syrian Arab Rep.,SYR,Latvia,LVA,0,0,0,5,5
2019,Ukraine,UKR,Latvia,LVA,0,0,11,0,11
2019,Uzbekistan,UZB,Latvia,LVA,0,0,0,5,5
2019,Afghanistan,AFG,Rep. of Moldova,MDA,0,5,0,0,5
2019,Armenia,ARM,Rep. of Moldova,MDA,0,0,5,5,10
2019,Azerbaijan,AZE,Rep. of Moldova,MDA,0,0,10,0,10
2019,Bangladesh,BGD,Rep. of Moldova,MDA,0,0,28,0,28
2019,Cameroon,CMR,Rep. of Moldova,MDA,0,0,0,5,5
2019,India,IND,Rep. of Moldova,MDA,0,0,0,5,5
2019,Russian Federation,RUS,Rep. of Moldova,MDA,0,0,5,0,5
2019,Syrian Arab Rep.,SYR,Rep. of Moldova,MDA,0,5,0,0,5
2019,Turkmenistan,TKM,Rep. of Moldova,MDA,0,0,0,5,5
2019,Turkey,TUR,Rep. of Moldova,MDA,14,0,5,0,19
2019,Ukraine,UKR,Rep. of Moldova,MDA,0,0,5,0,5
2019,Uzbekistan,UZB,Rep. of Moldova,MDA,0,0,5,0,5
2019,Yemen,YEM,Rep. of Moldova,MDA,0,5,0,0,5
2019,Angola,AGO,Mexico,MEX,0,0,0,5,5
2019,Argentina,ARG,Mexico,MEX,0,0,0,5,5
2019,Bangladesh,BGD,Mexico,MEX,5,0,0,0,5
2019,Bolivia (Plurinational State of),BOL,Mexico,MEX,0,0,5,0,5
2019,Brazil,BRA,Mexico,MEX,0,0,11,0,11
2019,Belize,BLZ,Mexico,MEX,5,0,0,0,5
2019,Chile,CHL,Mexico,MEX,5,0,14,5,24
2019,Cameroon,CMR,Mexico,MEX,0,0,0,33,33
2019,Congo,COG,Mexico,MEX,5,0,0,0,5
2019,Dem. Rep. of the Congo,COD,Mexico,MEX,0,0,0,5,5
2019,Colombia,COL,Mexico,MEX,36,5,21,54,116
2019,Cuba,CUB,Mexico,MEX,200,46,960,946,2152
2019,Dominica,DMA,Mexico,MEX,0,0,5,0,5
2019,Dominican Rep.,DOM,Mexico,MEX,0,0,0,5,5
2019,Ecuador,ECU,Mexico,MEX,0,0,0,13,13
2019,Eritrea,ERI,Mexico,MEX,0,0,0,5,5
2019,Palestinian,PSE,Mexico,MEX,0,0,0,5,5
2019,Ghana,GHA,Mexico,MEX,5,5,0,0,10
2019,Guatemala,GTM,Mexico,MEX,300,113,262,511,1186
2019,Guinea,GIN,Mexico,MEX,0,0,0,5,5
2019,Haiti,HTI,Mexico,MEX,22,12,179,145,358
2019,Honduras,HND,Mexico,MEX,4250,394,1088,5423,11155
2019,Iran (Islamic Rep. of),IRN,Mexico,MEX,0,0,0,5,5
2019,Jamaica,JAM,Mexico,MEX,5,0,0,0,5
2019,Nicaragua,NIC,Mexico,MEX,263,182,52,503,1000
2019,Nigeria,NGA,Mexico,MEX,10,0,0,0,10
2019,Panama,PAN,Mexico,MEX,0,0,0,5,5
2019,Peru,PER,Mexico,MEX,5,0,0,5,10
2019,Russian Federation,RUS,Mexico,MEX,11,0,0,0,11
2019,El Salvador,SLV,Mexico,MEX,1623,488,379,1473,3963
2019,Sierra Leone,SLE,Mexico,MEX,0,0,0,5,5
2019,Syrian Arab Rep.,SYR,Mexico,MEX,0,0,0,5,5
2019,Uganda,UGA,Mexico,MEX,0,0,0,12,12
2019,Ukraine,UKR,Mexico,MEX,0,0,0,5,5
2019,United States of America,USA,Mexico,MEX,11,0,5,11,27
2019,Venezuela (Bolivarian Republic of),VEN,Mexico,MEX,4080,0,51,443,4574
2019,Yemen,YEM,Mexico,MEX,0,0,0,5,5
2019,Central African Rep.,CAF,Mali,MLI,127,0,0,10,137
2019,Cameroon,CMR,Mali,MLI,5,0,0,0,5
2019,Congo,COG,Mali,MLI,5,0,0,0,5
2019,Dem. Rep. of the Congo,COD,Mali,MLI,16,0,0,0,16
2019,Cote d'Ivoire,CIV,Mali,MLI,0,0,0,5,5
2019,Pakistan,PAK,Mali,MLI,10,0,0,0,10
2019,Togo,TGO,Mali,MLI,5,0,0,5,10
2019,Burundi,BDI,Malawi,MWI,33,0,0,5,38
2019,Dem. Rep. of the Congo,COD,Malawi,MWI,254,0,0,13,267
2019,Rwanda,RWA,Malawi,MWI,112,0,0,0,112
2019,Somalia,SOM,Malawi,MWI,0,0,0,5,5
2019,Rwanda,RWA,Mozambique,MOZ,0,0,0,190,190
2019,Somalia,SOM,Mozambique,MOZ,0,0,0,758,758
2019,Afghanistan,AFG,Malta,MLT,0,0,0,5,5
2019,Algeria,DZA,Malta,MLT,0,0,0,5,5
2019,Egypt,EGY,Malta,MLT,0,0,15,5,20
2019,Benin,BEN,Malta,MLT,0,0,0,5,5
2019,Bangladesh,BGD,Malta,MLT,0,5,102,35,142
2019,Cameroon,CMR,Malta,MLT,0,0,0,20,20
2019,Eritrea,ERI,Malta,MLT,0,19,0,25,44
2019,Ethiopia,ETH,Malta,MLT,0,0,5,5,10
2019,Gambia,GMB,Malta,MLT,0,0,0,175,175
2019,Ghana,GHA,Malta,MLT,0,0,0,20,20
2019,Guinea-Bissau,GNB,Malta,MLT,0,0,0,5,5
2019,Guinea,GIN,Malta,MLT,0,0,0,21,21
2019,Cote d'Ivoire,CIV,Malta,MLT,0,0,0,61,61
2019,Iran (Islamic Rep. of),IRN,Malta,MLT,0,0,0,5,5
2019,Iraq,IRQ,Malta,MLT,5,0,0,5,10
2019,Libya,LBY,Malta,MLT,10,43,0,75,128
2019,North Macedonia,MKD,Malta,MLT,0,0,5,0,5
2019,Mali,MLI,Malta,MLT,0,0,0,27,27
2019,Morocco,MAR,Malta,MLT,0,0,32,17,49
2019,Nigeria,NGA,Malta,MLT,0,0,10,103,113
2019,Pakistan,PAK,Malta,MLT,0,0,0,18,18
2019,Senegal,SEN,Malta,MLT,0,0,0,26,26
2019,Sierra Leone,SLE,Malta,MLT,0,0,0,5,5
2019,Somalia,SOM,Malta,MLT,0,10,0,199,209
2019,Sudan,SDN,Malta,MLT,5,0,0,88,93
2019,South Sudan,SSD,Malta,MLT,0,0,0,11,11
2019,Syrian Arab Rep.,SYR,Malta,MLT,5,203,0,71,279
2019,Turkey,TUR,Malta,MLT,0,0,5,0,5
2019,Ukraine,UKR,Malta,MLT,0,0,0,12,12
2019,Venezuela (Bolivarian Republic of),VEN,Malta,MLT,0,0,13,0,13
2019,Zimbabwe,ZWE,Malta,MLT,0,0,0,5,5
2019,Burundi,BDI,Namibia,NAM,23,0,0,0,23
2019,Central African Rep.,CAF,Namibia,NAM,5,0,0,0,5
2019,Cameroon,CMR,Namibia,NAM,14,0,0,0,14
2019,Dem. Rep. of the Congo,COD,Namibia,NAM,725,0,0,0,725
2019,Uganda,UGA,Namibia,NAM,5,0,0,0,5
2019,Afghanistan,AFG,Netherlands,NLD,29,28,92,32,181
2019,Albania,ALB,Netherlands,NLD,0,0,143,59,202
2019,Algeria,DZA,Netherlands,NLD,0,0,306,195,501
2019,Angola,AGO,Netherlands,NLD,0,0,11,5,16
2019,Egypt,EGY,Netherlands,NLD,21,0,26,17,64
2019,Armenia,ARM,Netherlands,NLD,5,0,5,13,23
2019,Azerbaijan,AZE,Netherlands,NLD,5,5,12,134,156
2019,Bahrain,BHR,Netherlands,NLD,0,0,5,0,5
2019,Burundi,BDI,Netherlands,NLD,0,0,5,0,5
2019,Benin,BEN,Netherlands,NLD,0,0,5,0,5
2019,Bangladesh,BGD,Netherlands,NLD,0,0,12,5,17
2019,Belarus,BLR,Netherlands,NLD,0,0,5,26,31
2019,Brazil,BRA,Netherlands,NLD,0,0,5,5,10
2019,Bosnia and Herzegovina,BIH,Netherlands,NLD,0,0,59,10,69
2019,Chad,TCD,Netherlands,NLD,0,0,0,5,5
2019,China,CHN,Netherlands,NLD,83,0,13,5,101
2019,Cameroon,CMR,Netherlands,NLD,0,0,10,5,15
2019,Congo,COG,Netherlands,NLD,0,0,28,5,33
2019,Dem. Rep. of the Congo,COD,Netherlands,NLD,0,0,11,0,11
2019,Colombia,COL,Netherlands,NLD,5,0,23,21,49
2019,Cuba,CUB,Netherlands,NLD,0,0,18,5,23
2019,Dominican Rep.,DOM,Netherlands,NLD,0,0,0,5,5
2019,Ecuador,ECU,Netherlands,NLD,0,0,5,0,5
2019,Eritrea,ERI,Netherlands,NLD,361,29,139,25,554
2019,Ethiopia,ETH,Netherlands,NLD,0,0,14,5,19
2019,Gambia,GMB,Netherlands,NLD,5,0,28,14,47
2019,Palestinian,PSE,Netherlands,NLD,0,0,11,0,11
2019,Georgia,GEO,Netherlands,NLD,0,0,298,41,339
2019,Ghana,GHA,Netherlands,NLD,0,0,26,10,36
2019,Guinea-Bissau,GNB,Netherlands,NLD,0,0,5,0,5
2019,Guinea,GIN,Netherlands,NLD,10,0,52,15,77
2019,Haiti,HTI,Netherlands,NLD,0,0,5,0,5
2019,Cote d'Ivoire,CIV,Netherlands,NLD,0,0,12,5,17
2019,India,IND,Netherlands,NLD,0,0,14,23,37
2019,Indonesia,IDN,Netherlands,NLD,0,0,0,5,5
2019,Iran (Islamic Rep. of),IRN,Netherlands,NLD,207,82,268,101,658
2019,Iraq,IRQ,Netherlands,NLD,69,5,162,68,304
2019,Jamaica,JAM,Netherlands,NLD,11,0,5,0,16
2019,Jordan,JOR,Netherlands,NLD,0,0,27,18,45
2019,Kazakhstan,KAZ,Netherlands,NLD,5,0,0,0,5
2019,Kenya,KEN,Netherlands,NLD,0,0,10,0,10
2019,Kyrgyzstan,KGZ,Netherlands,NLD,0,0,0,5,5
2019,Liberia,LBR,Netherlands,NLD,0,0,11,0,11
2019,Libya,LBY,Netherlands,NLD,5,5,42,67,119
2019,Lebanon,LBN,Netherlands,NLD,14,0,11,10,35
2019,Sri Lanka,LKA,Netherlands,NLD,0,0,21,5,26
2019,North Macedonia,MKD,Netherlands,NLD,0,0,272,10,282
2019,Rep. of Moldova,MDA,Netherlands,NLD,0,0,343,148,491
2019,Mali,MLI,Netherlands,NLD,0,0,5,5,10
2019,Mongolia,MNG,Netherlands,NLD,0,0,5,0,5
2019,Morocco,MAR,Netherlands,NLD,10,0,294,268,572
2019,Montenegro,MNE,Netherlands,NLD,0,0,12,10,22
2019,Myanmar,MMR,Netherlands,NLD,5,0,5,0,10
2019,Niger,NER,Netherlands,NLD,0,0,5,5,10
2019,Nicaragua,NIC,Netherlands,NLD,0,0,12,0,12
2019,Nigeria,NGA,Netherlands,NLD,5,0,112,57,174
2019,Pakistan,PAK,Netherlands,NLD,58,10,50,16,134
2019,Peru,PER,Netherlands,NLD,0,0,0,5,5
2019,Philippines,PHL,Netherlands,NLD,0,0,5,0,5
2019,South Africa,ZAF,Netherlands,NLD,0,0,5,0,5
2019,Russian Federation,RUS,Netherlands,NLD,44,5,25,14,88
2019,Rwanda,RWA,Netherlands,NLD,0,0,0,5,5
2019,El Salvador,SLV,Netherlands,NLD,0,0,11,0,11
2019,Saudi Arabia,SAU,Netherlands,NLD,11,0,0,0,11
2019,Serbia and Kosovo: S/RES/1244 (1999),SRB,Netherlands,NLD,0,0,345,28,373
2019,Senegal,SEN,Netherlands,NLD,0,0,22,5,27
2019,Sierra Leone,SLE,Netherlands,NLD,10,0,12,5,27
2019,Somalia,SOM,Netherlands,NLD,18,0,40,19,77
2019,Viet Nam,VNM,Netherlands,NLD,0,0,17,23,40
2019,Sudan,SDN,Netherlands,NLD,27,0,38,26,91
2019,Suriname,SUR,Netherlands,NLD,0,0,5,0,5
2019,Syrian Arab Rep.,SYR,Netherlands,NLD,1667,14,322,74,2077
2019,United Rep. of Tanzania,TZA,Netherlands,NLD,0,0,5,0,5
2019,Tajikistan,TJK,Netherlands,NLD,0,0,5,69,74
2019,Turkmenistan,TKM,Netherlands,NLD,0,0,5,0,5
2019,Trinidad and Tobago,TTO,Netherlands,NLD,0,0,11,0,11
2019,Tunisia,TUN,Netherlands,NLD,5,0,68,29,102
2019,Turkey,TUR,Netherlands,NLD,631,284,45,32,992
2019,Uganda,UGA,Netherlands,NLD,10,0,47,0,57
2019,Ukraine,UKR,Netherlands,NLD,0,0,48,21,69
2019,United States of America,USA,Netherlands,NLD,0,13,5,0,18
2019,Venezuela (Bolivarian Republic of),VEN,Netherlands,NLD,5,5,58,30,98
2019,Yemen,YEM,Netherlands,NLD,420,5,28,5,458
2019,Zimbabwe,ZWE,Netherlands,NLD,0,0,5,0,5
2019,Stateless,XXA,Netherlands,NLD,79,0,35,0,114
2019,Central African Rep.,CAF,Niger,NER,102,0,0,5,107
2019,Chad,TCD,Niger,NER,0,0,0,5,5
2019,Cameroon,CMR,Niger,NER,0,0,0,12,12
2019,Dem. Rep. of the Congo,COD,Niger,NER,10,0,5,0,15
2019,Eritrea,ERI,Niger,NER,5,0,0,0,5
2019,Ethiopia,ETH,Niger,NER,5,0,0,0,5
2019,Guinea,GIN,Niger,NER,0,0,5,5,10
2019,Cote d'Ivoire,CIV,Niger,NER,0,0,0,5,5
2019,Nigeria,NGA,Niger,NER,0,0,5,7250,7255
2019,Sudan,SDN,Niger,NER,358,0,36,148,542
2019,Togo,TGO,Niger,NER,5,0,0,0,5
2019,Benin,BEN,Nigeria,NGA,5,0,0,0,5
2019,Central African Rep.,CAF,Nigeria,NGA,16,0,0,0,16
2019,Chad,TCD,Nigeria,NGA,0,0,0,14,14
2019,Cameroon,CMR,Nigeria,NGA,19315,0,0,0,19315
2019,Dem. Rep. of the Congo,COD,Nigeria,NGA,5,0,0,140,145
2019,Guinea,GIN,Nigeria,NGA,0,0,0,5,5
2019,Cote d'Ivoire,CIV,Nigeria,NGA,0,0,0,19,19
2019,Liberia,LBR,Nigeria,NGA,0,0,0,5,5
2019,Lebanon,LBN,Nigeria,NGA,0,0,0,5,5
2019,Mali,MLI,Nigeria,NGA,0,0,0,16,16
2019,Syrian Arab Rep.,SYR,Nigeria,NGA,30,0,0,0,30
2019,Togo,TGO,Nigeria,NGA,0,0,0,10,10
2019,Turkey,TUR,Nigeria,NGA,5,0,0,0,5
2019,Afghanistan,AFG,Norway,NOR,33,20,70,14,137
2019,Albania,ALB,Norway,NOR,0,0,61,13,74
2019,Algeria,DZA,Norway,NOR,0,0,0,17,17
2019,Angola,AGO,Norway,NOR,0,0,5,12,17
2019,Armenia,ARM,Norway,NOR,5,0,0,0,5
2019,Bosnia and Herzegovina,BIH,Norway,NOR,0,0,5,0,5
2019,China,CHN,Norway,NOR,15,0,5,5,25
2019,Cameroon,CMR,Norway,NOR,0,0,11,0,11
2019,Dem. Rep. of the Congo,COD,Norway,NOR,5,0,0,5,10
2019,Colombia,COL,Norway,NOR,0,0,11,12,23
2019,Eritrea,ERI,Norway,NOR,156,10,5,25,196
2019,Ethiopia,ETH,Norway,NOR,11,0,17,15,43
2019,Gambia,GMB,Norway,NOR,0,0,0,5,5
2019,Georgia,GEO,Norway,NOR,0,0,14,10,24
2019,Germany,DEU,Norway,NOR,0,0,10,0,10
2019,Greece,GRC,Norway,NOR,0,0,5,0,5
2019,Guinea,GIN,Norway,NOR,0,0,5,0,5
2019,Iran (Islamic Rep. of),IRN,Norway,NOR,21,0,37,32,90
2019,Iraq,IRQ,Norway,NOR,14,0,27,24,65
2019,Kazakhstan,KAZ,Norway,NOR,5,0,5,0,10
2019,Kenya,KEN,Norway,NOR,5,0,0,5,10
2019,Libya,LBY,Norway,NOR,0,0,0,10,10
2019,Lebanon,LBN,Norway,NOR,0,0,0,5,5
2019,Sri Lanka,LKA,Norway,NOR,0,0,12,0,12
2019,Mauritania,MRT,Norway,NOR,0,0,0,5,5
2019,Rep. of Moldova,MDA,Norway,NOR,0,0,5,0,5
2019,Mali,MLI,Norway,NOR,0,0,0,5,5
2019,Malaysia,MYS,Norway,NOR,0,0,5,0,5
2019,Morocco,MAR,Norway,NOR,0,0,10,12,22
2019,Nicaragua,NIC,Norway,NOR,5,0,5,0,10
2019,Nigeria,NGA,Norway,NOR,5,0,0,14,19
2019,Pakistan,PAK,Norway,NOR,5,0,10,14,29
2019,Peru,PER,Norway,NOR,0,0,11,0,11
2019,Poland,POL,Norway,NOR,5,0,5,0,10
2019,Romania,ROU,Norway,NOR,0,0,5,0,5
2019,Russian Federation,RUS,Norway,NOR,11,0,61,17,89
2019,El Salvador,SLV,Norway,NOR,5,0,0,0,5
2019,Serbia and Kosovo: S/RES/1244 (1999),SRB,Norway,NOR,0,0,14,16,30
2019,Somalia,SOM,Norway,NOR,14,0,20,14,48
2019,Viet Nam,VNM,Norway,NOR,0,0,5,0,5
2019,Sudan,SDN,Norway,NOR,22,0,5,5,32
2019,South Sudan,SSD,Norway,NOR,5,0,0,5,10
2019,Sweden,SWE,Norway,NOR,0,0,5,0,5
2019,Syrian Arab Rep.,SYR,Norway,NOR,437,0,5,60,502
2019,Turkmenistan,TKM,Norway,NOR,5,0,0,0,5
2019,Tunisia,TUN,Norway,NOR,0,0,0,5,5
2019,Turkey,TUR,Norway,NOR,771,0,28,15,814
2019,Uganda,UGA,Norway,NOR,5,0,0,5,10
2019,Ukraine,UKR,Norway,NOR,0,0,23,0,23
2019,Uzbekistan,UZB,Norway,NOR,0,0,11,0,11
2019,Venezuela (Bolivarian Republic of),VEN,Norway,NOR,5,0,22,0,27
2019,Yemen,YEM,Norway,NOR,0,14,0,0,14
2019,Zambia,ZMB,Norway,NOR,0,0,0,5,5
2019,Stateless,XXA,Norway,NOR,53,0,68,31,152
2019,Bangladesh,BGD,Nauru,NRU,5,0,0,0,5
2019,Iran (Islamic Rep. of),IRN,Nauru,NRU,11,0,0,0,11
2019,Sri Lanka,LKA,Nauru,NRU,5,0,0,0,5
2019,Afghanistan,AFG,New Zealand,NZL,0,0,5,0,5
2019,Egypt,EGY,New Zealand,NZL,10,0,0,0,10
2019,Bangladesh,BGD,New Zealand,NZL,0,0,5,5,10
2019,China,CHN,New Zealand,NZL,51,0,38,5,94
2019,Colombia,COL,New Zealand,NZL,0,0,11,0,11
2019,Czechia,CZE,New Zealand,NZL,5,0,5,0,10
2019,Fiji,FJI,New Zealand,NZL,0,0,0,5,5
2019,India,IND,New Zealand,NZL,5,0,37,0,42
2019,Iran (Islamic Rep. of),IRN,New Zealand,NZL,13,0,0,0,13
2019,Sri Lanka,LKA,New Zealand,NZL,5,0,18,5,28
2019,Malaysia,MYS,New Zealand,NZL,5,0,14,0,19
2019,Mongolia,MNG,New Zealand,NZL,0,0,5,0,5
2019,Myanmar,MMR,New Zealand,NZL,5,0,0,0,5
2019,Nigeria,NGA,New Zealand,NZL,0,0,5,0,5
2019,Pakistan,PAK,New Zealand,NZL,5,0,12,0,17
2019,Philippines,PHL,New Zealand,NZL,5,0,5,0,10
2019,South Africa,ZAF,New Zealand,NZL,0,0,5,5,10
2019,Russian Federation,RUS,New Zealand,NZL,11,0,0,0,11
2019,Saudi Arabia,SAU,New Zealand,NZL,12,0,10,0,22
2019,Sudan,SDN,New Zealand,NZL,5,0,0,0,5
2019,Syrian Arab Rep.,SYR,New Zealand,NZL,5,0,0,0,5
2019,Turkey,TUR,New Zealand,NZL,0,0,5,0,5
2019,Ukraine,UKR,New Zealand,NZL,0,0,5,0,5
2019,Uruguay,URY,New Zealand,NZL,0,0,5,0,5
2019,United States of America,USA,New Zealand,NZL,0,0,5,0,5
2019,Zimbabwe,ZWE,New Zealand,NZL,0,0,10,0,10
2019,Colombia,COL,Panama,PAN,21,0,10,594,625
2019,Cuba,CUB,Panama,PAN,0,0,0,1215,1215
2019,Dominican Rep.,DOM,Panama,PAN,0,0,0,22,22
2019,Ecuador,ECU,Panama,PAN,0,0,0,10,10
2019,Guatemala,GTM,Panama,PAN,0,0,0,5,5
2019,Haiti,HTI,Panama,PAN,0,0,0,5,5
2019,Honduras,HND,Panama,PAN,0,0,0,23,23
2019,Nicaragua,NIC,Panama,PAN,5,0,0,1076,1081
2019,Nigeria,NGA,Panama,PAN,0,0,0,5,5
2019,Peru,PER,Panama,PAN,0,0,0,5,5
2019,El Salvador,SLV,Panama,PAN,5,0,0,250,255
2019,Syrian Arab Rep.,SYR,Panama,PAN,0,0,0,5,5
2019,Venezuela (Bolivarian Republic of),VEN,Panama,PAN,15,0,0,2386,2401
2019,Cuba,CUB,Paraguay,PRY,12,0,0,0,12
2019,Peru,PER,Paraguay,PRY,5,0,0,0,5
2019,El Salvador,SLV,Paraguay,PRY,5,0,0,0,5
2019,Venezuela (Bolivarian Republic of),VEN,Paraguay,PRY,723,0,0,0,723
2019,Cameroon,CMR,Peru,PER,5,0,5,0,10
2019,Colombia,COL,Peru,PER,10,0,0,5,15
2019,Cuba,CUB,Peru,PER,79,0,59,18,156
2019,Dominican Rep.,DOM,Peru,PER,5,0,0,0,5
2019,Haiti,HTI,Peru,PER,11,0,5,0,16
2019,Nicaragua,NIC,Peru,PER,5,0,0,0,5
2019,Philippines,PHL,Peru,PER,0,0,5,5,10
2019,Turkey,TUR,Peru,PER,5,0,0,0,5
2019,Venezuela (Bolivarian Republic of),VEN,Peru,PER,578,0,171,2641,3390
2019,Iran (Islamic Rep. of),IRN,Papua New Guinea,PNG,11,0,0,0,11
2019,Afghanistan,AFG,Poland,POL,5,10,0,48,63
2019,Algeria,DZA,Poland,POL,0,0,12,0,12
2019,Angola,AGO,Poland,POL,0,0,5,0,5
2019,Egypt,EGY,Poland,POL,5,0,5,15,25
2019,Armenia,ARM,Poland,POL,0,0,28,37,65
2019,Azerbaijan,AZE,Poland,POL,0,5,19,5,29
2019,Bangladesh,BGD,Poland,POL,0,0,10,0,10
2019,Belarus,BLR,Poland,POL,5,0,29,10,44
2019,China,CHN,Poland,POL,0,0,0,13,13
2019,Congo,COG,Poland,POL,0,0,0,5,5
2019,Cuba,CUB,Poland,POL,0,0,5,15,20
2019,Eritrea,ERI,Poland,POL,0,0,0,5,5
2019,Ethiopia,ETH,Poland,POL,0,0,5,0,5
2019,Finland,FIN,Poland,POL,0,0,0,5,5
2019,Gambia,GMB,Poland,POL,0,0,0,5,5
2019,Palestinian,PSE,Poland,POL,0,0,0,5,5
2019,Georgia,GEO,Poland,POL,0,0,39,28,67
2019,India,IND,Poland,POL,0,0,13,0,13
2019,Iran (Islamic Rep. of),IRN,Poland,POL,19,0,20,12,51
2019,Iraq,IRQ,Poland,POL,14,5,13,14,46
2019,Jordan,JOR,Poland,POL,0,0,0,5,5
2019,Kazakhstan,KAZ,Poland,POL,0,0,29,10,39
2019,Kyrgyzstan,KGZ,Poland,POL,0,0,36,5,41
2019,Lebanon,LBN,Poland,POL,0,0,0,10,10
2019,Sri Lanka,LKA,Poland,POL,0,0,5,0,5
2019,Rep. of Moldova,MDA,Poland,POL,0,0,0,5,5
2019,Mongolia,MNG,Poland,POL,0,0,0,5,5
2019,Morocco,MAR,Poland,POL,0,0,0,5,5
2019,Nigeria,NGA,Poland,POL,0,0,11,0,11
2019,Pakistan,PAK,Poland,POL,0,0,13,10,23
2019,Russian Federation,RUS,Poland,POL,10,68,960,1542,2580
2019,Somalia,SOM,Poland,POL,0,5,0,0,5
2019,Viet Nam,VNM,Poland,POL,0,0,23,17,40
2019,Syrian Arab Rep.,SYR,Poland,POL,5,5,0,10,20
2019,Tajikistan,TJK,Poland,POL,10,21,60,31,122
2019,Turkmenistan,TKM,Poland,POL,5,0,0,0,5
2019,Tunisia,TUN,Poland,POL,0,0,0,5,5
2019,Turkey,TUR,Poland,POL,50,0,5,13,68
2019,Uganda,UGA,Poland,POL,0,0,5,0,5
2019,Ukraine,UKR,Poland,POL,5,11,356,86,458
2019,Uzbekistan,UZB,Poland,POL,0,5,0,5,10
2019,Yemen,YEM,Poland,POL,0,0,0,5,5
2019,Stateless,XXA,Poland,POL,0,0,0,12,12
2019,Afghanistan,AFG,Portugal,PRT,5,0,0,15,20
2019,Albania,ALB,Portugal,PRT,0,0,0,5,5
2019,Algeria,DZA,Portugal,PRT,0,0,0,13,13
2019,Angola,AGO,Portugal,PRT,0,0,0,173,173
2019,Egypt,EGY,Portugal,PRT,0,0,0,5,5
2019,Azerbaijan,AZE,Portugal,PRT,0,0,0,5,5
2019,Bangladesh,BGD,Portugal,PRT,0,0,0,5,5
2019,Burkina Faso,BFA,Portugal,PRT,0,0,0,5,5
2019,Brazil,BRA,Portugal,PRT,0,0,0,5,5
2019,China,CHN,Portugal,PRT,0,0,0,5,5
2019,Cameroon,CMR,Portugal,PRT,0,0,0,31,31
2019,Congo,COG,Portugal,PRT,0,0,0,13,13
2019,Dem. Rep. of the Congo,COD,Portugal,PRT,5,0,0,55,60
2019,Comoros,COM,Portugal,PRT,0,0,0,5,5
2019,Colombia,COL,Portugal,PRT,0,0,0,5,5
2019,Cuba,CUB,Portugal,PRT,0,0,0,10,10
2019,Eritrea,ERI,Portugal,PRT,13,0,0,0,13
2019,Gambia,GMB,Portugal,PRT,0,0,0,126,126
2019,Ghana,GHA,Portugal,PRT,0,0,0,10,10
2019,Guinea-Bissau,GNB,Portugal,PRT,0,0,0,116,116
2019,Guinea,GIN,Portugal,PRT,0,5,0,83,88
2019,Haiti,HTI,Portugal,PRT,0,0,0,5,5
2019,Cote d'Ivoire,CIV,Portugal,PRT,0,0,0,15,15
2019,Iran (Islamic Rep. of),IRN,Portugal,PRT,5,0,0,12,17
2019,Iraq,IRQ,Portugal,PRT,18,5,0,5,28
2019,Sri Lanka,LKA,Portugal,PRT,0,0,0,5,5
2019,Mauritania,MRT,Portugal,PRT,0,0,0,5,5
2019,Mali,MLI,Portugal,PRT,0,0,0,19,19
2019,Morocco,MAR,Portugal,PRT,0,0,0,12,12
2019,Mozambique,MOZ,Portugal,PRT,0,0,0,5,5
2019,Nigeria,NGA,Portugal,PRT,0,0,0,30,30
2019,Pakistan,PAK,Portugal,PRT,5,0,0,5,10
2019,Russian Federation,RUS,Portugal,PRT,0,0,0,5,5
2019,Senegal,SEN,Portugal,PRT,0,0,0,43,43
2019,Sierra Leone,SLE,Portugal,PRT,0,0,0,27,27
2019,Somalia,SOM,Portugal,PRT,0,0,0,13,13
2019,Sudan,SDN,Portugal,PRT,26,0,0,5,31
2019,South Sudan,SSD,Portugal,PRT,15,0,0,0,15
2019,Syrian Arab Rep.,SYR,Portugal,PRT,95,72,0,0,167
2019,Togo,TGO,Portugal,PRT,0,0,0,26,26
2019,Turkey,TUR,Portugal,PRT,5,0,0,0,5
2019,Ukraine,UKR,Portugal,PRT,0,13,0,27,40
2019,Venezuela (Bolivarian Republic of),VEN,Portugal,PRT,0,0,0,43,43
2019,Stateless,XXA,Portugal,PRT,0,5,0,5,10
2019,Afghanistan,AFG,Romania,ROU,22,15,68,52,157
2019,Albania,ALB,Romania,ROU,0,0,0,5,5
2019,Algeria,DZA,Romania,ROU,0,0,62,23,85
2019,Angola,AGO,Romania,ROU,0,0,5,0,5
2019,Armenia,ARM,Romania,ROU,0,0,0,5,5
2019,Bangladesh,BGD,Romania,ROU,5,0,117,29,151
2019,China,CHN,Romania,ROU,0,0,5,5,10
2019,Cameroon,CMR,Romania,ROU,0,0,41,5,46
2019,Congo,COG,Romania,ROU,0,0,5,0,5
2019,Dem. Rep. of the Congo,COD,Romania,ROU,0,0,5,0,5
2019,Comoros,COM,Romania,ROU,5,0,5,0,10
2019,Colombia,COL,Romania,ROU,0,0,5,0,5
2019,Eritrea,ERI,Romania,ROU,12,0,0,0,12
2019,Ethiopia,ETH,Romania,ROU,0,0,11,0,11
2019,Palestinian,PSE,Romania,ROU,5,5,23,5,38
2019,Guinea,GIN,Romania,ROU,0,0,14,0,14
2019,Cote d'Ivoire,CIV,Romania,ROU,0,0,5,0,5
2019,India,IND,Romania,ROU,0,0,59,5,64
2019,Iran (Islamic Rep. of),IRN,Romania,ROU,25,5,62,39,131
2019,Iraq,IRQ,Romania,ROU,33,39,159,365,596
2019,Jordan,JOR,Romania,ROU,0,0,10,0,10
2019,Libya,LBY,Romania,ROU,0,0,5,11,16
2019,Lebanon,LBN,Romania,ROU,0,0,5,0,5
2019,Sri Lanka,LKA,Romania,ROU,0,0,21,20,41
2019,Rep. of Moldova,MDA,Romania,ROU,0,0,5,11,16
2019,Mali,MLI,Romania,ROU,5,0,0,0,5
2019,Morocco,MAR,Romania,ROU,0,0,33,12,45
2019,Myanmar,MMR,Romania,ROU,0,0,5,0,5
2019,Nepal,NPL,Romania,ROU,0,0,0,5,5
2019,Nigeria,NGA,Romania,ROU,0,0,14,5,19
2019,Pakistan,PAK,Romania,ROU,5,5,50,5,65
2019,South Africa,ZAF,Romania,ROU,0,0,5,0,5
2019,Serbia and Kosovo: S/RES/1244 (1999),SRB,Romania,ROU,0,0,5,0,5
2019,Senegal,SEN,Romania,ROU,0,0,5,0,5
2019,Somalia,SOM,Romania,ROU,40,14,29,22,105
2019,Viet Nam,VNM,Romania,ROU,0,0,0,12,12
2019,Sudan,SDN,Romania,ROU,0,0,11,0,11
2019,Syrian Arab Rep.,SYR,Romania,ROU,147,158,10,51,366
2019,Tunisia,TUN,Romania,ROU,0,0,16,12,28
2019,Turkey,TUR,Romania,ROU,10,0,39,54,103
2019,Uganda,UGA,Romania,ROU,5,0,0,0,5
2019,Ukraine,UKR,Romania,ROU,0,0,11,12,23
2019,Yemen,YEM,Romania,ROU,5,11,0,0,16
2019,Stateless,XXA,Romania,ROU,0,0,14,0,14
2019,Afghanistan,AFG,South Africa,ZAF,0,0,5,0,5
2019,Algeria,DZA,South Africa,ZAF,0,0,103,0,103
2019,Angola,AGO,South Africa,ZAF,0,0,12,0,12
2019,Egypt,EGY,South Africa,ZAF,0,0,87,0,87
2019,Bahrain,BHR,South Africa,ZAF,0,0,5,0,5
2019,Burundi,BDI,South Africa,ZAF,70,0,831,0,901
2019,Benin,BEN,South Africa,ZAF,0,0,10,0,10
2019,Bangladesh,BGD,South Africa,ZAF,0,0,3730,0,3730
2019,Burkina Faso,BFA,South Africa,ZAF,0,0,5,0,5
2019,Botswana,BWA,South Africa,ZAF,0,0,5,0,5
2019,Central African Rep.,CAF,South Africa,ZAF,5,0,0,0,5
2019,China,CHN,South Africa,ZAF,0,0,5,0,5
2019,Cameroon,CMR,South Africa,ZAF,10,0,399,0,409
2019,Congo,COG,South Africa,ZAF,48,0,275,0,323
2019,Dem. Rep. of the Congo,COD,South Africa,ZAF,554,0,2913,0,3467
2019,Eritrea,ERI,South Africa,ZAF,34,0,134,0,168
2019,Ethiopia,ETH,South Africa,ZAF,356,0,3506,5,3867
2019,Palestinian,PSE,South Africa,ZAF,0,0,10,0,10
2019,Ghana,GHA,South Africa,ZAF,0,0,553,0,553
2019,Guinea,GIN,South Africa,ZAF,0,0,10,0,10
2019,Cote d'Ivoire,CIV,South Africa,ZAF,0,0,12,0,12
2019,India,IND,South Africa,ZAF,0,0,993,0,993
2019,Jordan,JOR,South Africa,ZAF,0,0,10,0,10
2019,Kenya,KEN,South Africa,ZAF,5,0,64,0,69
2019,Liberia,LBR,South Africa,ZAF,0,0,14,0,14
2019,Lebanon,LBN,South Africa,ZAF,0,0,5,0,5
2019,Lesotho,LSO,South Africa,ZAF,0,0,5,0,5
2019,Sri Lanka,LKA,South Africa,ZAF,0,0,5,0,5
2019,Mali,MLI,South Africa,ZAF,0,0,23,0,23
2019,Malawi,MWI,South Africa,ZAF,0,0,563,0,563
2019,Morocco,MAR,South Africa,ZAF,0,0,5,0,5
2019,Mozambique,MOZ,South Africa,ZAF,0,0,75,0,75
2019,Nepal,NPL,South Africa,ZAF,0,0,70,0,70
2019,Niger,NER,South Africa,ZAF,0,0,26,0,26
2019,Nigeria,NGA,South Africa,ZAF,0,0,1114,0,1114
2019,Pakistan,PAK,South Africa,ZAF,0,0,2442,0,2442
2019,Rwanda,RWA,South Africa,ZAF,22,0,88,0,110
2019,Senegal,SEN,South Africa,ZAF,0,0,156,0,156
2019,Sierra Leone,SLE,South Africa,ZAF,0,0,5,0,5
2019,Somalia,SOM,South Africa,ZAF,673,0,1179,0,1852
2019,Sudan,SDN,South Africa,ZAF,0,0,10,0,10
2019,Eswatini,SWZ,South Africa,ZAF,0,0,11,0,11
2019,Syrian Arab Rep.,SYR,South Africa,ZAF,0,0,5,0,5
2019,United Rep. of Tanzania,TZA,South Africa,ZAF,0,0,80,0,80
2019,Thailand,THA,South Africa,ZAF,0,0,23,0,23
2019,Uganda,UGA,South Africa,ZAF,5,0,495,5,505
2019,Venezuela (Bolivarian Republic of),VEN,South Africa,ZAF,0,0,5,0,5
2019,Yemen,YEM,South Africa,ZAF,0,0,10,0,10
2019,Zambia,ZMB,South Africa,ZAF,0,0,33,0,33
2019,Zimbabwe,ZWE,South Africa,ZAF,57,0,1935,0,1992
2019,Afghanistan,AFG,Russian Federation,RUS,0,0,0,181,181
2019,Armenia,ARM,Russian Federation,RUS,0,0,0,5,5
2019,Belgium,BEL,Russian Federation,RUS,0,0,0,15,15
2019,Bangladesh,BGD,Russian Federation,RUS,0,0,0,5,5
2019,Eritrea,ERI,Russian Federation,RUS,0,0,0,12,12
2019,Palestinian,PSE,Russian Federation,RUS,0,0,0,5,5
2019,Kazakhstan,KAZ,Russian Federation,RUS,0,0,0,5,5
2019,Kyrgyzstan,KGZ,Russian Federation,RUS,0,0,0,5,5
2019,Dem. People's Rep. of Korea,PRK,Russian Federation,RUS,0,0,0,5,5
2019,Niger,NER,Russian Federation,RUS,0,0,0,5,5
2019,Syrian Arab Rep.,SYR,Russian Federation,RUS,0,0,0,64,64
2019,Tajikistan,TJK,Russian Federation,RUS,0,0,0,10,10
2019,Turkmenistan,TKM,Russian Federation,RUS,0,0,0,5,5
2019,Ukraine,UKR,Russian Federation,RUS,16,0,0,27,43
2019,Uzbekistan,UZB,Russian Federation,RUS,5,0,0,5,10
2019,Yemen,YEM,Russian Federation,RUS,0,0,0,14,14
2019,Burundi,BDI,Rwanda,RWA,5,0,0,19,24
2019,Dem. Rep. of the Congo,COD,Rwanda,RWA,52,0,0,98,150
2019,Eritrea,ERI,Rwanda,RWA,105,0,0,0,105
2019,Somalia,SOM,Rwanda,RWA,13,0,0,0,13
2019,Sudan,SDN,Rwanda,RWA,13,0,0,0,13
2019,Nicaragua,NIC,El Salvador,SLV,0,0,0,15,15
2019,Afghanistan,AFG,Serbia and Kosovo: S/RES/1244 (1999),SRB,5,0,5,90,100
2019,Algeria,DZA,Serbia and Kosovo: S/RES/1244 (1999),SRB,0,0,0,116,116
2019,Egypt,EGY,Serbia and Kosovo: S/RES/1244 (1999),SRB,0,0,0,5,5
2019,Burundi,BDI,Serbia and Kosovo: S/RES/1244 (1999),SRB,0,0,0,5,5
2019,Bangladesh,BGD,Serbia and Kosovo: S/RES/1244 (1999),SRB,0,0,0,5,5
2019,Bulgaria,BGR,Serbia and Kosovo: S/RES/1244 (1999),SRB,0,0,5,0,5
2019,Cuba,CUB,Serbia and Kosovo: S/RES/1244 (1999),SRB,0,0,0,5,5
2019,Palestinian,PSE,Serbia and Kosovo: S/RES/1244 (1999),SRB,0,0,0,91,91
2019,Ghana,GHA,Serbia and Kosovo: S/RES/1244 (1999),SRB,0,0,0,5,5
2019,India,IND,Serbia and Kosovo: S/RES/1244 (1999),SRB,0,0,5,0,5
2019,Iran (Islamic Rep. of),IRN,Serbia and Kosovo: S/RES/1244 (1999),SRB,5,0,53,97,155
2019,Iraq,IRQ,Serbia and Kosovo: S/RES/1244 (1999),SRB,0,5,5,558,568
2019,Libya,LBY,Serbia and Kosovo: S/RES/1244 (1999),SRB,0,5,0,46,51
2019,Lebanon,LBN,Serbia and Kosovo: S/RES/1244 (1999),SRB,0,0,0,14,14
2019,Morocco,MAR,Serbia and Kosovo: S/RES/1244 (1999),SRB,0,0,0,133,133
2019,Nigeria,NGA,Serbia and Kosovo: S/RES/1244 (1999),SRB,0,0,5,0,5
2019,Pakistan,PAK,Serbia and Kosovo: S/RES/1244 (1999),SRB,0,5,0,19,24
2019,Russian Federation,RUS,Serbia and Kosovo: S/RES/1244 (1999),SRB,5,0,0,0,5
2019,Serbia and Kosovo: S/RES/1244 (1999),SRB,Serbia and Kosovo: S/RES/1244 (1999),SRB,0,0,0,5,5
2019,Somalia,SOM,Serbia and Kosovo: S/RES/1244 (1999),SRB,0,0,0,10,10
2019,Syrian Arab Rep.,SYR,Serbia and Kosovo: S/RES/1244 (1999),SRB,0,5,0,891,896
2019,Tunisia,TUN,Serbia and Kosovo: S/RES/1244 (1999),SRB,0,0,0,10,10
2019,Turkey,TUR,Serbia and Kosovo: S/RES/1244 (1999),SRB,34,0,0,13,47
2019,Ukraine,UKR,Serbia and Kosovo: S/RES/1244 (1999),SRB,0,0,0,5,5
2019,Yemen,YEM,Serbia and Kosovo: S/RES/1244 (1999),SRB,0,0,0,21,21
2019,Afghanistan,AFG,Spain,ESP,21,43,19,0,83
2019,Albania,ALB,Spain,ESP,0,0,34,0,34
2019,Algeria,DZA,Spain,ESP,10,10,513,0,533
2019,Angola,AGO,Spain,ESP,0,0,10,0,10
2019,Egypt,EGY,Spain,ESP,24,0,26,0,50
2019,Argentina,ARG,Spain,ESP,0,0,14,0,14
2019,Armenia,ARM,Spain,ESP,5,5,75,0,85
2019,Azerbaijan,AZE,Spain,ESP,13,0,0,0,13
2019,Burundi,BDI,Spain,ESP,5,0,0,0,5
2019,Bangladesh,BGD,Spain,ESP,5,0,311,0,316
2019,Burkina Faso,BFA,Spain,ESP,0,0,13,0,13
2019,Belarus,BLR,Spain,ESP,5,0,0,0,5
2019,Bolivia (Plurinational State of),BOL,Spain,ESP,0,0,33,0,33
2019,Brazil,BRA,Spain,ESP,14,0,147,0,161
2019,Central African Rep.,CAF,Spain,ESP,5,14,13,0,32
2019,Chad,TCD,Spain,ESP,5,0,5,0,10
2019,China,CHN,Spain,ESP,0,0,12,0,12
2019,Chile,CHL,Spain,ESP,0,0,5,0,5
2019,Cameroon,CMR,Spain,ESP,32,0,83,0,115
2019,Congo,COG,Spain,ESP,23,10,51,0,84
2019,Dem. Rep. of the Congo,COD,Spain,ESP,5,10,51,0,66
2019,Colombia,COL,Spain,ESP,48,10,3896,0,3954
2019,Costa Rica,CRI,Spain,ESP,0,0,5,0,5
2019,Cuba,CUB,Spain,ESP,16,0,257,0,273
2019,Dominican Rep.,DOM,Spain,ESP,5,0,107,0,112
2019,Ecuador,ECU,Spain,ESP,0,0,29,0,29
2019,Equatorial Guinea,GNQ,Spain,ESP,17,0,16,0,33
2019,Eritrea,ERI,Spain,ESP,29,0,0,0,29
2019,Ethiopia,ETH,Spain,ESP,5,0,0,0,5
2019,Gambia,GMB,Spain,ESP,24,0,113,0,137
2019,Palestinian,PSE,Spain,ESP,26,107,1053,0,1186
2019,Georgia,GEO,Spain,ESP,5,5,380,0,390
2019,Ghana,GHA,Spain,ESP,0,0,40,0,40
2019,Guinea-Bissau,GNB,Spain,ESP,0,0,11,0,11
2019,Guatemala,GTM,Spain,ESP,10,0,19,0,29
2019,Guinea,GIN,Spain,ESP,11,0,233,0,244
2019,Haiti,HTI,Spain,ESP,0,0,16,0,16
2019,Honduras,HND,Spain,ESP,226,13,779,0,1018
2019,Cote d'Ivoire,CIV,Spain,ESP,29,11,193,0,233
2019,India,IND,Spain,ESP,0,0,20,0,20
2019,Iran (Islamic Rep. of),IRN,Spain,ESP,84,5,15,0,104
2019,Iraq,IRQ,Spain,ESP,0,5,29,0,34
2019,Jamaica,JAM,Spain,ESP,32,0,0,0,32
2019,Jordan,JOR,Spain,ESP,0,10,0,0,10
2019,Kazakhstan,KAZ,Spain,ESP,0,5,0,0,5
2019,Kyrgyzstan,KGZ,Spain,ESP,0,0,12,0,12
2019,Liberia,LBR,Spain,ESP,0,0,15,0,15
2019,Libya,LBY,Spain,ESP,12,15,5,0,32
2019,Lebanon,LBN,Spain,ESP,0,0,22,0,22
2019,Sri Lanka,LKA,Spain,ESP,0,5,5,0,10
2019,Mauritania,MRT,Spain,ESP,5,0,5,0,10
2019,North Macedonia,MKD,Spain,ESP,0,0,5,0,5
2019,Rep. of Moldova,MDA,Spain,ESP,0,0,10,0,10
2019,Mexico,MEX,Spain,ESP,0,0,10,0,10
2019,Mali,MLI,Spain,ESP,5,55,165,0,225
2019,Mongolia,MNG,Spain,ESP,0,0,12,0,12
2019,Morocco,MAR,Spain,ESP,192,5,364,0,561
2019,Myanmar,MMR,Spain,ESP,5,0,0,0,5
2019,Niger,NER,Spain,ESP,5,0,0,0,5
2019,Nicaragua,NIC,Spain,ESP,167,0,694,0,861
2019,Nigeria,NGA,Spain,ESP,35,0,97,0,132
2019,Pakistan,PAK,Spain,ESP,25,0,99,0,124
2019,Panama,PAN,Spain,ESP,0,0,5,0,5
2019,Paraguay,PRY,Spain,ESP,5,0,40,0,45
2019,Peru,PER,Spain,ESP,25,0,533,0,558
2019,South Africa,ZAF,Spain,ESP,0,0,5,0,5
2019,Russian Federation,RUS,Spain,ESP,66,0,61,0,127
2019,El Salvador,SLV,Spain,ESP,245,22,1722,0,1989
2019,Saudi Arabia,SAU,Spain,ESP,5,0,0,0,5
2019,Serbia and Kosovo: S/RES/1244 (1999),SRB,Spain,ESP,5,0,11,0,16
2019,Senegal,SEN,Spain,ESP,0,0,194,0,194
2019,Sierra Leone,SLE,Spain,ESP,0,0,5,0,5
2019,Somalia,SOM,Spain,ESP,0,68,10,0,78
2019,Viet Nam,VNM,Spain,ESP,0,0,5,0,5
2019,Sudan,SDN,Spain,ESP,14,0,5,0,19
2019,South Sudan,SSD,Spain,ESP,5,0,0,0,5
2019,Syrian Arab Rep.,SYR,Spain,ESP,38,1081,615,0,1734
2019,Tunisia,TUN,Spain,ESP,5,0,88,0,93
2019,Turkey,TUR,Spain,ESP,5,0,25,0,30
2019,Uganda,UGA,Spain,ESP,0,0,5,0,5
2019,Ukraine,UKR,Spain,ESP,13,56,1024,0,1093
2019,Uruguay,URY,Spain,ESP,0,0,5,0,5
2019,United States of America,USA,Spain,ESP,0,0,10,0,10
2019,Uzbekistan,UZB,Spain,ESP,0,0,5,0,5
2019,Venezuela (Bolivarian Republic of),VEN,Spain,ESP,48,35128,181,0,35357
2019,Western Sahara,ESH,Spain,ESP,0,0,42,0,42
2019,Yemen,YEM,Spain,ESP,0,103,170,0,273
2019,Eritrea,ERI,Sudan,SDN,1801,0,0,1312,3113
2019,Ethiopia,ETH,Sudan,SDN,11,0,17,331,359
2019,Somalia,SOM,Sudan,SDN,32,0,0,119,151
2019,Yemen,YEM,Sudan,SDN,0,0,0,14,14
2019,Burundi,BDI,South Sudan,SSD,54,0,0,0,54
2019,Eritrea,ERI,South Sudan,SSD,117,0,0,56,173
2019,Ethiopia,ETH,South Sudan,SSD,17,0,0,5,22
2019,Afghanistan,AFG,Slovakia,SVK,0,16,12,65,93
2019,Algeria,DZA,Slovakia,SVK,0,0,0,5,5
2019,Armenia,ARM,Slovakia,SVK,0,0,5,10,15
2019,Azerbaijan,AZE,Slovakia,SVK,0,0,5,0,5
2019,Bangladesh,BGD,Slovakia,SVK,0,0,0,12,12
2019,India,IND,Slovakia,SVK,0,0,5,5,10
2019,Iran (Islamic Rep. of),IRN,Slovakia,SVK,5,0,10,44,59
2019,Iraq,IRQ,Slovakia,SVK,0,0,0,5,5
2019,Morocco,MAR,Slovakia,SVK,0,0,5,0,5
2019,Myanmar,MMR,Slovakia,SVK,0,0,0,5,5
2019,Pakistan,PAK,Slovakia,SVK,0,0,5,5,10
2019,Russian Federation,RUS,Slovakia,SVK,0,0,0,5,5
2019,Serbia and Kosovo: S/RES/1244 (1999),SRB,Slovakia,SVK,0,0,5,0,5
2019,Sudan,SDN,Slovakia,SVK,0,0,0,5,5
2019,Turkey,TUR,Slovakia,SVK,0,0,5,5,10
2019,Ukraine,UKR,Slovakia,SVK,0,0,12,0,12
2019,Yemen,YEM,Slovakia,SVK,5,0,0,0,5
2019,Afghanistan,AFG,Slovenia,SVN,5,0,73,369,447
2019,Albania,ALB,Slovenia,SVN,0,0,0,5,5
2019,Algeria,DZA,Slovenia,SVN,0,0,120,934,1054
2019,Egypt,EGY,Slovenia,SVN,0,0,0,41,41
2019,Azerbaijan,AZE,Slovenia,SVN,0,0,0,10,10
2019,Bangladesh,BGD,Slovenia,SVN,0,0,5,175,180
2019,Bosnia and Herzegovina,BIH,Slovenia,SVN,0,0,5,0,5
2019,China,CHN,Slovenia,SVN,0,0,0,10,10
2019,Dem. Rep. of the Congo,COD,Slovenia,SVN,0,0,5,0,5
2019,Cuba,CUB,Slovenia,SVN,0,0,10,18,28
2019,Eritrea,ERI,Slovenia,SVN,0,0,11,0,11
2019,Gambia,GMB,Slovenia,SVN,0,0,5,0,5
2019,Palestinian,PSE,Slovenia,SVN,0,0,5,27,32
2019,India,IND,Slovenia,SVN,0,0,0,29,29
2019,Iran (Islamic Rep. of),IRN,Slovenia,SVN,10,0,36,102,148
2019,Iraq,IRQ,Slovenia,SVN,5,0,32,70,107
2019,Libya,LBY,Slovenia,SVN,0,0,18,38,56
2019,Sri Lanka,LKA,Slovenia,SVN,0,0,0,5,5
2019,Morocco,MAR,Slovenia,SVN,0,0,53,649,702
2019,Nepal,NPL,Slovenia,SVN,0,0,0,5,5
2019,Nigeria,NGA,Slovenia,SVN,0,0,12,0,12
2019,Pakistan,PAK,Slovenia,SVN,0,0,26,511,537
2019,Philippines,PHL,Slovenia,SVN,0,0,0,5,5
2019,Russian Federation,RUS,Slovenia,SVN,5,0,0,12,17
2019,Serbia and Kosovo: S/RES/1244 (1999),SRB,Slovenia,SVN,0,0,17,10,27
2019,Somalia,SOM,Slovenia,SVN,5,0,0,0,5
2019,Viet Nam,VNM,Slovenia,SVN,0,0,0,5,5
2019,Syrian Arab Rep.,SYR,Slovenia,SVN,17,0,14,59,90
2019,Tajikistan,TJK,Slovenia,SVN,0,0,0,10,10
2019,Tunisia,TUN,Slovenia,SVN,0,0,17,108,125
2019,Turkey,TUR,Slovenia,SVN,28,0,10,55,93
2019,Yemen,YEM,Slovenia,SVN,0,0,0,5,5
2019,Congo,COG,Eswatini,SWZ,10,0,0,0,10
2019,Dem. Rep. of the Congo,COD,Eswatini,SWZ,23,0,0,0,23
2019,Rwanda,RWA,Eswatini,SWZ,13,0,0,0,13
2019,Somalia,SOM,Eswatini,SWZ,10,0,0,0,10
2019,Afghanistan,AFG,Sweden,SWE,223,53,458,133,867
2019,Albania,ALB,Sweden,SWE,0,0,400,111,511
2019,Algeria,DZA,Sweden,SWE,0,0,36,43,79
2019,Angola,AGO,Sweden,SWE,0,0,5,26,31
2019,Egypt,EGY,Sweden,SWE,23,5,274,53,355
2019,Argentina,ARG,Sweden,SWE,0,0,13,5,18
2019,Armenia,ARM,Sweden,SWE,0,0,64,18,82
2019,Azerbaijan,AZE,Sweden,SWE,45,0,226,78,349
2019,Bahrain,BHR,Sweden,SWE,0,5,0,0,5
2019,Burundi,BDI,Sweden,SWE,45,5,44,10,104
2019,Benin,BEN,Sweden,SWE,0,0,5,0,5
2019,Bangladesh,BGD,Sweden,SWE,10,0,149,18,177
2019,Burkina Faso,BFA,Sweden,SWE,0,0,5,0,5
2019,Belarus,BLR,Sweden,SWE,0,0,33,38,71
2019,Bolivia (Plurinational State of),BOL,Sweden,SWE,0,0,25,5,30
2019,Brazil,BRA,Sweden,SWE,0,0,18,5,23
2019,Bosnia and Herzegovina,BIH,Sweden,SWE,0,0,53,20,73
2019,Bulgaria,BGR,Sweden,SWE,0,0,5,0,5
2019,Canada,CAN,Sweden,SWE,0,0,0,5,5
2019,Chad,TCD,Sweden,SWE,0,0,0,5,5
2019,China,CHN,Sweden,SWE,11,0,16,17,44
2019,Chile,CHL,Sweden,SWE,0,0,33,5,38
2019,Cameroon,CMR,Sweden,SWE,25,0,62,26,113
2019,Congo,COG,Sweden,SWE,0,0,0,15,15
2019,Dem. Rep. of the Congo,COD,Sweden,SWE,5,5,26,10,46
2019,Colombia,COL,Sweden,SWE,12,0,462,45,519
2019,Cuba,CUB,Sweden,SWE,0,0,13,16,29
2019,Djibouti,DJI,Sweden,SWE,0,0,5,5,10
2019,Ecuador,ECU,Sweden,SWE,0,0,14,0,14
2019,Eritrea,ERI,Sweden,SWE,549,52,83,139,823
2019,Ethiopia,ETH,Sweden,SWE,43,0,194,58,295
2019,France,FRA,Sweden,SWE,0,0,5,0,5
2019,Gabon,GAB,Sweden,SWE,0,0,0,5,5
2019,Gambia,GMB,Sweden,SWE,10,0,49,82,141
2019,Palestinian,PSE,Sweden,SWE,60,5,325,143,533
2019,Georgia,GEO,Sweden,SWE,0,0,933,151,1084
2019,Ghana,GHA,Sweden,SWE,0,0,21,29,50
2019,Guinea-Bissau,GNB,Sweden,SWE,0,0,5,5,10
2019,Guatemala,GTM,Sweden,SWE,0,0,11,0,11
2019,Guinea,GIN,Sweden,SWE,5,0,13,26,44
2019,Honduras,HND,Sweden,SWE,5,0,26,0,31
2019,Cote d'Ivoire,CIV,Sweden,SWE,14,0,0,5,19
2019,India,IND,Sweden,SWE,0,0,54,28,82
2019,Iran (Islamic Rep. of),IRN,Sweden,SWE,348,0,605,201,1154
2019,Iraq,IRQ,Sweden,SWE,142,55,733,331,1261
2019,Israel,ISR,Sweden,SWE,0,0,12,0,12
2019,Italy,ITA,Sweden,SWE,0,0,5,0,5
2019,Jordan,JOR,Sweden,SWE,16,5,110,55,186
2019,Japan,JPN,Sweden,SWE,0,0,5,0,5
2019,Kazakhstan,KAZ,Sweden,SWE,10,0,187,95,292
2019,Kenya,KEN,Sweden,SWE,5,0,10,5,20
2019,Kyrgyzstan,KGZ,Sweden,SWE,0,5,136,41,182
2019,Rep. of Korea,KOR,Sweden,SWE,0,0,5,0,5
2019,Kuwait,KWT,Sweden,SWE,0,0,5,5,10
2019,Liberia,LBR,Sweden,SWE,0,0,14,0,14
2019,Libya,LBY,Sweden,SWE,0,5,35,45,85
2019,Lebanon,LBN,Sweden,SWE,10,0,98,56,164
2019,Sri Lanka,LKA,Sweden,SWE,0,0,19,11,30
2019,Mauritania,MRT,Sweden,SWE,0,0,0,5,5
2019,North Macedonia,MKD,Sweden,SWE,0,0,90,36,126
2019,Rep. of Moldova,MDA,Sweden,SWE,0,0,11,0,11
2019,Mexico,MEX,Sweden,SWE,0,0,13,0,13
2019,Mali,MLI,Sweden,SWE,0,0,5,5,10
2019,Malaysia,MYS,Sweden,SWE,0,0,5,0,5
2019,Mongolia,MNG,Sweden,SWE,0,0,241,72,313
2019,Morocco,MAR,Sweden,SWE,10,0,114,176,300
2019,Montenegro,MNE,Sweden,SWE,0,0,14,0,14
2019,Mauritius,MUS,Sweden,SWE,0,0,5,0,5
2019,Myanmar,MMR,Sweden,SWE,0,0,5,0,5
2019,Nepal,NPL,Sweden,SWE,0,0,12,0,12
2019,Niger,NER,Sweden,SWE,0,0,0,5,5
2019,Nicaragua,NIC,Sweden,SWE,69,0,312,14,395
2019,Nigeria,NGA,Sweden,SWE,37,0,163,143,343
2019,Norway,NOR,Sweden,SWE,0,0,0,5,5
2019,Pakistan,PAK,Sweden,SWE,65,0,246,72,383
2019,Peru,PER,Sweden,SWE,0,0,198,22,220
2019,Philippines,PHL,Sweden,SWE,0,0,15,0,15
2019,Romania,ROU,Sweden,SWE,0,0,5,0,5
2019,South Africa,ZAF,Sweden,SWE,0,0,5,0,5
2019,Russian Federation,RUS,Sweden,SWE,46,0,153,125,324
2019,Rwanda,RWA,Sweden,SWE,10,0,28,0,38
2019,El Salvador,SLV,Sweden,SWE,12,0,269,17,298
2019,Saudi Arabia,SAU,Sweden,SWE,0,0,0,14,14
2019,Serbia and Kosovo: S/RES/1244 (1999),SRB,Sweden,SWE,0,5,230,80,315
2019,Senegal,SEN,Sweden,SWE,0,0,5,20,25
2019,Sierra Leone,SLE,Sweden,SWE,0,0,13,5,18
2019,Somalia,SOM,Sweden,SWE,183,25,210,177,595
2019,Spain,ESP,Sweden,SWE,0,0,0,5,5
2019,Viet Nam,VNM,Sweden,SWE,0,0,32,13,45
2019,Sudan,SDN,Sweden,SWE,54,0,61,10,125
2019,Slovakia,SVK,Sweden,SWE,0,0,5,0,5
2019,Syrian Arab Rep.,SYR,Sweden,SWE,207,1644,99,445,2395
2019,United Rep. of Tanzania,TZA,Sweden,SWE,10,0,29,10,49
2019,Thailand,THA,Sweden,SWE,0,0,13,0,13
2019,Tajikistan,TJK,Sweden,SWE,12,0,27,21,60
2019,Tunisia,TUN,Sweden,SWE,0,0,59,43,102
2019,Turkey,TUR,Sweden,SWE,241,0,229,60,530
2019,Uganda,UGA,Sweden,SWE,21,0,23,12,56
2019,Ukraine,UKR,Sweden,SWE,0,0,624,183,807
2019,Uruguay,URY,Sweden,SWE,0,0,5,0,5
2019,United States of America,USA,Sweden,SWE,0,0,25,10,35
2019,Uzbekistan,UZB,Sweden,SWE,11,0,250,176,437
2019,Venezuela (Bolivarian Republic of),VEN,Sweden,SWE,13,0,163,12,188
2019,Yemen,YEM,Sweden,SWE,41,230,10,37,318
2019,Zambia,ZMB,Sweden,SWE,0,0,0,5,5
2019,Zimbabwe,ZWE,Sweden,SWE,0,0,5,5,10
2019,Stateless,XXA,Sweden,SWE,277,107,280,174,838
2019,Afghanistan,AFG,Switzerland,CHE,374,1374,83,319,2150
2019,Albania,ALB,Switzerland,CHE,0,19,85,33,137
2019,Algeria,DZA,Switzerland,CHE,5,0,203,663,871
2019,Angola,AGO,Switzerland,CHE,0,29,10,35,74
2019,Egypt,EGY,Switzerland,CHE,5,0,10,25,40
2019,Armenia,ARM,Switzerland,CHE,5,5,16,30,56
2019,Australia,AUS,Switzerland,CHE,0,0,5,0,5
2019,Azerbaijan,AZE,Switzerland,CHE,13,10,17,48,88
2019,Burundi,BDI,Switzerland,CHE,20,5,5,0,30
2019,Benin,BEN,Switzerland,CHE,0,0,0,5,5
2019,Bangladesh,BGD,Switzerland,CHE,0,0,5,12,17
2019,Burkina Faso,BFA,Switzerland,CHE,0,0,0,11,11
2019,Belarus,BLR,Switzerland,CHE,0,0,12,27,39
2019,Brazil,BRA,Switzerland,CHE,0,0,5,0,5
2019,Bosnia and Herzegovina,BIH,Switzerland,CHE,0,5,19,14,38
2019,Bulgaria,BGR,Switzerland,CHE,0,0,5,0,5
2019,Central African Rep.,CAF,Switzerland,CHE,5,0,0,5,10
2019,Chad,TCD,Switzerland,CHE,0,0,12,0,12
2019,China,CHN,Switzerland,CHE,66,142,113,27,348
2019,Cameroon,CMR,Switzerland,CHE,5,25,20,29,79
2019,Congo,COG,Switzerland,CHE,0,0,5,0,5
2019,Dem. Rep. of the Congo,COD,Switzerland,CHE,15,46,31,29,121
2019,Colombia,COL,Switzerland,CHE,15,12,74,14,115
2019,Cuba,CUB,Switzerland,CHE,0,0,5,0,5
2019,Djibouti,DJI,Switzerland,CHE,0,0,0,5,5
2019,Eritrea,ERI,Switzerland,CHE,2797,714,567,92,4170
2019,Ethiopia,ETH,Switzerland,CHE,58,116,168,45,387
2019,Gabon,GAB,Switzerland,CHE,0,5,0,0,5
2019,Gambia,GMB,Switzerland,CHE,0,5,10,108,123
2019,Georgia,GEO,Switzerland,CHE,0,15,301,372,688
2019,Germany,DEU,Switzerland,CHE,0,0,0,5,5
2019,Ghana,GHA,Switzerland,CHE,0,0,0,30,30
2019,Guinea-Bissau,GNB,Switzerland,CHE,0,0,5,20,25
2019,Guinea,GIN,Switzerland,CHE,0,10,42,111,163
2019,Haiti,HTI,Switzerland,CHE,0,0,5,0,5
2019,Honduras,HND,Switzerland,CHE,0,0,5,0,5
2019,Hungary,HUN,Switzerland,CHE,0,0,5,0,5
2019,Cote d'Ivoire,CIV,Switzerland,CHE,5,24,11,34,74
2019,India,IND,Switzerland,CHE,0,5,12,5,22
2019,Iran (Islamic Rep. of),IRN,Switzerland,CHE,112,86,323,158,679
2019,Iraq,IRQ,Switzerland,CHE,105,289,144,214,752
2019,Israel,ISR,Switzerland,CHE,0,0,0,5,5
2019,Italy,ITA,Switzerland,CHE,0,0,5,5,10
2019,Jamaica,JAM,Switzerland,CHE,5,0,0,0,5
2019,Jordan,JOR,Switzerland,CHE,0,0,5,0,5
2019,Kazakhstan,KAZ,Switzerland,CHE,0,5,0,14,19
2019,Kenya,KEN,Switzerland,CHE,0,0,0,5,5
2019,Kuwait,KWT,Switzerland,CHE,0,5,0,0,5
2019,Liberia,LBR,Switzerland,CHE,0,0,0,12,12
2019,Libya,LBY,Switzerland,CHE,5,19,21,95,140
2019,Lebanon,LBN,Switzerland,CHE,0,5,14,5,24
2019,Sri Lanka,LKA,Switzerland,CHE,307,85,548,171,1111
2019,Mauritania,MRT,Switzerland,CHE,0,0,0,5,5
2019,North Macedonia,MKD,Switzerland,CHE,0,0,22,17,39
2019,Rep. of Moldova,MDA,Switzerland,CHE,0,0,13,5,18
2019,Mexico,MEX,Switzerland,CHE,0,0,5,0,5
2019,Mali,MLI,Switzerland,CHE,0,0,5,20,25
2019,Mongolia,MNG,Switzerland,CHE,0,12,11,5,28
2019,Morocco,MAR,Switzerland,CHE,5,0,61,329,395
2019,Montenegro,MNE,Switzerland,CHE,0,0,0,5,5
2019,Nepal,NPL,Switzerland,CHE,0,5,5,0,10
2019,Niger,NER,Switzerland,CHE,0,0,0,11,11
2019,Nicaragua,NIC,Switzerland,CHE,0,0,14,5,19
2019,Nigeria,NGA,Switzerland,CHE,0,29,44,339,412
2019,Pakistan,PAK,Switzerland,CHE,12,27,46,59,144
2019,Peru,PER,Switzerland,CHE,0,0,5,0,5
2019,Philippines,PHL,Switzerland,CHE,0,5,0,0,5
2019,Poland,POL,Switzerland,CHE,0,0,5,0,5
2019,Romania,ROU,Switzerland,CHE,0,0,5,0,5
2019,South Africa,ZAF,Switzerland,CHE,0,0,5,0,5
2019,Russian Federation,RUS,Switzerland,CHE,20,10,32,91,153
2019,Rwanda,RWA,Switzerland,CHE,0,0,5,0,5
2019,El Salvador,SLV,Switzerland,CHE,0,0,0,11,11
2019,Saudi Arabia,SAU,Switzerland,CHE,0,5,0,5,10
2019,Serbia and Kosovo: S/RES/1244 (1999),SRB,Switzerland,CHE,5,40,99,128,272
2019,Senegal,SEN,Switzerland,CHE,0,5,5,28,38
2019,Sierra Leone,SLE,Switzerland,CHE,0,0,5,11,16
2019,Somalia,SOM,Switzerland,CHE,170,382,74,124,750
2019,Spain,ESP,Switzerland,CHE,0,0,5,0,5
2019,Viet Nam,VNM,Switzerland,CHE,0,0,0,5,5
2019,Sudan,SDN,Switzerland,CHE,25,10,12,22,69
2019,South Sudan,SSD,Switzerland,CHE,0,5,0,0,5
2019,Slovakia,SVK,Switzerland,CHE,0,0,5,0,5
2019,Syrian Arab Rep.,SYR,Switzerland,CHE,654,1243,183,139,2219
2019,United Rep. of Tanzania,TZA,Switzerland,CHE,0,0,5,0,5
2019,Tajikistan,TJK,Switzerland,CHE,5,0,0,5,10
2019,Togo,TGO,Switzerland,CHE,13,5,5,5,28
2019,Tunisia,TUN,Switzerland,CHE,0,0,39,121,160
2019,Turkey,TUR,Switzerland,CHE,633,45,165,152,995
2019,Uganda,UGA,Switzerland,CHE,0,0,5,10,15
2019,Ukraine,UKR,Switzerland,CHE,0,5,29,28,62
2019,United States of America,USA,Switzerland,CHE,0,0,0,12,12
2019,Venezuela (Bolivarian Republic of),VEN,Switzerland,CHE,5,5,22,5,37
2019,Western Sahara,ESH,Switzerland,CHE,0,0,0,5,5
2019,Yemen,YEM,Switzerland,CHE,13,10,0,10,33
2019,Zimbabwe,ZWE,Switzerland,CHE,0,0,5,0,5
2019,Stateless,XXA,Switzerland,CHE,5,5,0,0,10
2019,Myanmar,MMR,Thailand,THA,15,0,0,0,15
2019,Central African Rep.,CAF,Togo,TGO,5,0,28,0,33
2019,Cameroon,CMR,Togo,TGO,0,0,5,0,5
2019,Dem. Rep. of the Congo,COD,Togo,TGO,5,0,0,0,5
2019,Palestinian,PSE,Togo,TGO,5,0,0,0,5
2019,Cote d'Ivoire,CIV,Togo,TGO,19,0,33,0,52
2019,Syrian Arab Rep.,SYR,Togo,TGO,5,0,0,0,5
2019,Turkey,TUR,Togo,TGO,23,0,0,0,23
2019,Afghanistan,AFG,Turkey,TUR,2387,0,2515,11224,16126
2019,Iran (Islamic Rep. of),IRN,Turkey,TUR,872,0,350,4711,5933
2019,Iraq,IRQ,Turkey,TUR,2011,0,2111,25128,29250
2019,Burundi,BDI,Uganda,UGA,8619,0,410,0,9029
2019,Central African Rep.,CAF,Uganda,UGA,0,0,0,5,5
2019,Cameroon,CMR,Uganda,UGA,5,0,0,0,5
2019,Dem. Rep. of the Congo,COD,Uganda,UGA,23306,0,1436,0,24742
2019,Eritrea,ERI,Uganda,UGA,1074,0,488,1839,3401
2019,Ethiopia,ETH,Uganda,UGA,209,0,40,180,429
2019,Guinea,GIN,Uganda,UGA,5,0,0,0,5
2019,Pakistan,PAK,Uganda,UGA,0,0,0,76,76
2019,Rwanda,RWA,Uganda,UGA,460,0,379,0,839
2019,Somalia,SOM,Uganda,UGA,12107,0,0,2859,14966
2019,Sudan,SDN,Uganda,UGA,320,0,5,0,325
2019,South Sudan,SSD,Uganda,UGA,17,0,0,302,319
2019,Turkey,TUR,Uganda,UGA,20,0,0,0,20
2019,Afghanistan,AFG,Ukraine,UKR,17,11,36,1081,1145
2019,Algeria,DZA,Ukraine,UKR,0,0,0,5,5
2019,Angola,AGO,Ukraine,UKR,0,0,0,5,5
2019,Egypt,EGY,Ukraine,UKR,0,0,0,12,12
2019,Armenia,ARM,Ukraine,UKR,0,0,0,17,17
2019,Bangladesh,BGD,Ukraine,UKR,0,0,10,28,38
2019,Belarus,BLR,Ukraine,UKR,0,0,12,5,17
2019,Cameroon,CMR,Ukraine,UKR,0,0,5,41,46
2019,Congo,COG,Ukraine,UKR,0,0,5,5,10
2019,Dem. Rep. of the Congo,COD,Ukraine,UKR,0,0,5,0,5
2019,Cuba,CUB,Ukraine,UKR,0,0,0,5,5
2019,Gambia,GMB,Ukraine,UKR,0,0,5,0,5
2019,Palestinian,PSE,Ukraine,UKR,0,0,0,49,49
2019,Georgia,GEO,Ukraine,UKR,0,0,0,38,38
2019,Ghana,GHA,Ukraine,UKR,0,0,0,10,10
2019,Guinea,GIN,Ukraine,UKR,0,0,5,40,45
2019,Haiti,HTI,Ukraine,UKR,0,0,0,5,5
2019,Cote d'Ivoire,CIV,Ukraine,UKR,0,0,0,11,11
2019,India,IND,Ukraine,UKR,0,0,0,5,5
2019,Iran (Islamic Rep. of),IRN,Ukraine,UKR,0,0,11,23,34
2019,Iraq,IRQ,Ukraine,UKR,0,0,10,52,62
2019,Jordan,JOR,Ukraine,UKR,0,0,0,11,11
2019,Kazakhstan,KAZ,Ukraine,UKR,0,0,5,0,5
2019,Kyrgyzstan,KGZ,Ukraine,UKR,5,0,0,0,5
2019,Liberia,LBR,Ukraine,UKR,0,0,0,5,5
2019,Libya,LBY,Ukraine,UKR,0,0,0,12,12
2019,Lebanon,LBN,Ukraine,UKR,0,0,5,0,5
2019,Rep. of Moldova,MDA,Ukraine,UKR,0,0,0,5,5
2019,Morocco,MAR,Ukraine,UKR,0,0,5,0,5
2019,Myanmar,MMR,Ukraine,UKR,0,0,0,5,5
2019,Nepal,NPL,Ukraine,UKR,0,0,0,5,5
2019,Nigeria,NGA,Ukraine,UKR,0,0,5,73,78
2019,Pakistan,PAK,Ukraine,UKR,0,0,18,77,95
2019,Russian Federation,RUS,Ukraine,UKR,10,18,90,0,118
2019,Senegal,SEN,Ukraine,UKR,0,0,0,5,5
2019,Somalia,SOM,Ukraine,UKR,0,0,5,131,136
2019,Viet Nam,VNM,Ukraine,UKR,0,0,0,18,18
2019,Sudan,SDN,Ukraine,UKR,0,0,5,34,39
2019,Syrian Arab Rep.,SYR,Ukraine,UKR,0,10,40,100,150
2019,Tajikistan,TJK,Ukraine,UKR,5,0,40,0,45
2019,Turkmenistan,TKM,Ukraine,UKR,0,0,0,5,5
2019,Togo,TGO,Ukraine,UKR,0,0,0,5,5
2019,Tunisia,TUN,Ukraine,UKR,0,0,0,5,5
2019,Turkey,TUR,Ukraine,UKR,5,0,0,5,10
2019,Uganda,UGA,Ukraine,UKR,0,0,5,0,5
2019,Uzbekistan,UZB,Ukraine,UKR,0,0,10,0,10
2019,Yemen,YEM,Ukraine,UKR,0,0,13,0,13
2019,Stateless,XXA,Ukraine,UKR,0,5,10,0,15
2019,Angola,AGO,Uruguay,URY,5,0,0,0,5
2019,Argentina,ARG,Uruguay,URY,0,0,0,5,5
2019,Brazil,BRA,Uruguay,URY,0,0,0,5,5
2019,Colombia,COL,Uruguay,URY,14,0,0,0,14
2019,Cuba,CUB,Uruguay,URY,10,0,90,4565,4665
2019,Dominican Rep.,DOM,Uruguay,URY,0,0,0,13,13
2019,Nicaragua,NIC,Uruguay,URY,5,0,0,5,10
2019,Nigeria,NGA,Uruguay,URY,0,0,0,13,13
2019,Paraguay,PRY,Uruguay,URY,5,0,0,0,5
2019,El Salvador,SLV,Uruguay,URY,0,0,0,13,13
2019,Senegal,SEN,Uruguay,URY,0,0,0,41,41
2019,Spain,ESP,Uruguay,URY,0,0,0,5,5
2019,Syrian Arab Rep.,SYR,Uruguay,URY,0,0,0,5,5
2019,Turkey,TUR,Uruguay,URY,10,0,0,0,10
2019,Venezuela (Bolivarian Republic of),VEN,Uruguay,URY,58,0,0,28,86
2019,Colombia,COL,Venezuela (Bolivarian Republic of),VEN,248,0,543,0,791
2019,Burundi,BDI,Zambia,ZMB,884,0,12,162,1058
2019,Cameroon,CMR,Zambia,ZMB,5,0,0,0,5
2019,Dem. Rep. of the Congo,COD,Zambia,ZMB,4378,0,0,116,4494
2019,Eritrea,ERI,Zambia,ZMB,5,0,0,0,5
2019,Rwanda,RWA,Zambia,ZMB,14,0,0,0,14
2019,Somalia,SOM,Zambia,ZMB,437,0,0,52,489
2019,Syrian Arab Rep.,SYR,Zambia,ZMB,0,0,0,5,5
2019,Turkey,TUR,Zambia,ZMB,12,0,0,0,12
2019,Uganda,UGA,Zambia,ZMB,10,0,0,0,10
2019,Dem. Rep. of the Congo,COD,Zimbabwe,ZWE,396,0,118,0,514
2019,South Sudan,SSD,Zimbabwe,ZWE,0,0,0,5,5
2020,Palestinian,PSE,Albania,ALB,0,0,0,5,5
2020,Syrian Arab Rep.,SYR,Albania,ALB,5,0,0,0,5
2020,Egypt,EGY,Argentina,ARG,0,0,5,0,5
2020,Bangladesh,BGD,Argentina,ARG,0,0,5,0,5
2020,Bolivia (Plurinational State of),BOL,Argentina,ARG,60,0,0,5,65
2020,China,CHN,Argentina,ARG,0,0,5,0,5
2020,Dem. Rep. of the Congo,COD,Argentina,ARG,0,0,5,0,5
2020,Colombia,COL,Argentina,ARG,5,0,0,5,10
2020,Cuba,CUB,Argentina,ARG,5,0,59,5,69
2020,Dominican Rep.,DOM,Argentina,ARG,0,0,55,5,60
2020,Palestinian,PSE,Argentina,ARG,5,0,0,0,5
2020,Ghana,GHA,Argentina,ARG,0,0,29,0,29
2020,Haiti,HTI,Argentina,ARG,5,0,66,0,71
2020,Honduras,HND,Argentina,ARG,0,0,5,0,5
2020,India,IND,Argentina,ARG,0,0,16,0,16
2020,Jordan,JOR,Argentina,ARG,5,0,0,0,5
2020,Morocco,MAR,Argentina,ARG,0,0,0,5,5
2020,Nicaragua,NIC,Argentina,ARG,5,0,0,0,5
2020,Nigeria,NGA,Argentina,ARG,0,0,5,0,5
2020,Peru,PER,Argentina,ARG,5,0,0,0,5
2020,El Salvador,SLV,Argentina,ARG,14,0,0,0,14
2020,Senegal,SEN,Argentina,ARG,0,0,54,0,54
2020,Syrian Arab Rep.,SYR,Argentina,ARG,5,0,0,0,5
2020,Ukraine,UKR,Argentina,ARG,0,0,5,0,5
2020,Venezuela (Bolivarian Republic of),VEN,Argentina,ARG,5,0,0,44,49
2020,Afghanistan,AFG,Armenia,ARM,0,0,0,5,5
2020,Azerbaijan,AZE,Armenia,ARM,0,0,0,5,5
2020,Congo,COG,Armenia,ARM,5,0,0,0,5
2020,Cuba,CUB,Armenia,ARM,0,0,10,0,10
2020,Georgia,GEO,Armenia,ARM,0,0,0,5,5
2020,India,IND,Armenia,ARM,0,0,0,5,5
2020,Iran (Islamic Rep. of),IRN,Armenia,ARM,37,0,43,26,106
2020,Iraq,IRQ,Armenia,ARM,11,0,0,0,11
2020,Lebanon,LBN,Armenia,ARM,5,0,0,17,22
2020,Pakistan,PAK,Armenia,ARM,0,0,0,5,5
2020,Syrian Arab Rep.,SYR,Armenia,ARM,23,0,0,11,34
2020,Turkey,TUR,Armenia,ARM,5,0,5,0,10
2020,Afghanistan,AFG,Australia,AUS,276,0,54,36,366
2020,Albania,ALB,Australia,AUS,0,0,20,5,25
2020,Algeria,DZA,Australia,AUS,5,0,0,0,5
2020,Egypt,EGY,Australia,AUS,32,0,26,0,58
2020,Argentina,ARG,Australia,AUS,0,0,5,5,10
2020,Burundi,BDI,Australia,AUS,13,0,0,0,13
2020,Bangladesh,BGD,Australia,AUS,25,0,329,96,450
2020,Brazil,BRA,Australia,AUS,0,0,17,0,17
2020,Bosnia and Herzegovina,BIH,Australia,AUS,0,0,5,0,5
2020,Cambodia,KHM,Australia,AUS,15,0,31,10,56
2020,China,CHN,Australia,AUS,93,0,4322,226,4641
2020,Chile,CHL,Australia,AUS,0,0,10,5,15
2020,Cameroon,CMR,Australia,AUS,0,0,14,0,14
2020,Congo,COG,Australia,AUS,5,0,0,0,5
2020,Colombia,COL,Australia,AUS,0,0,11,0,11
2020,Eritrea,ERI,Australia,AUS,12,0,0,0,12
2020,Ethiopia,ETH,Australia,AUS,15,0,10,0,25
2020,Fiji,FJI,Australia,AUS,13,0,792,36,841
2020,France,FRA,Australia,AUS,0,0,5,5,10
2020,Palestinian,PSE,Australia,AUS,19,0,5,15,39
2020,United Kingdom of Great Britain and Northern Ireland,GBR,Australia,AUS,0,0,32,0,32
2020,Ghana,GHA,Australia,AUS,14,0,5,0,19
2020,Greece,GRC,Australia,AUS,0,0,19,0,19
2020,"China, Hong Kong SAR",HKG,Australia,AUS,0,0,12,28,40
2020,Honduras,HND,Australia,AUS,0,0,0,5,5
2020,India,IND,Australia,AUS,20,0,896,396,1312
2020,Indonesia,IDN,Australia,AUS,14,0,664,54,732
2020,Ireland,IRL,Australia,AUS,0,0,10,0,10
2020,Iran (Islamic Rep. of),IRN,Australia,AUS,918,0,422,455,1795
2020,Iraq,IRQ,Australia,AUS,157,0,109,49,315
2020,Israel,ISR,Australia,AUS,0,0,5,0,5
2020,Italy,ITA,Australia,AUS,0,0,14,0,14
2020,Jordan,JOR,Australia,AUS,0,0,14,0,14
2020,Kenya,KEN,Australia,AUS,5,0,20,10,35
2020,Rep. of Korea,KOR,Australia,AUS,0,0,48,0,48
2020,Lao People's Dem. Rep.,LAO,Australia,AUS,0,0,5,72,77
2020,Liberia,LBR,Australia,AUS,5,0,5,0,10
2020,Libya,LBY,Australia,AUS,55,0,0,0,55
2020,Lebanon,LBN,Australia,AUS,47,0,197,0,244
2020,Sri Lanka,LKA,Australia,AUS,91,0,283,263,637
2020,North Macedonia,MKD,Australia,AUS,0,0,0,5,5
2020,Malaysia,MYS,Australia,AUS,44,0,3671,237,3952
2020,Mongolia,MNG,Australia,AUS,0,0,13,0,13
2020,Morocco,MAR,Australia,AUS,0,0,5,0,5
2020,Mauritius,MUS,Australia,AUS,0,0,11,5,16
2020,Myanmar,MMR,Australia,AUS,24,0,54,14,92
2020,Nepal,NPL,Australia,AUS,10,0,96,0,106
2020,Nigeria,NGA,Australia,AUS,27,0,161,5,193
2020,Nauru,NRU,Australia,AUS,5,0,0,0,5
2020,New Zealand,NZL,Australia,AUS,0,0,5,0,5
2020,Pakistan,PAK,Australia,AUS,239,0,398,33,670
2020,Peru,PER,Australia,AUS,0,0,5,0,5
2020,Philippines,PHL,Australia,AUS,5,0,282,0,287
2020,Papua New Guinea,PNG,Australia,AUS,49,0,29,0,78
2020,Poland,POL,Australia,AUS,0,0,5,0,5
2020,South Africa,ZAF,Australia,AUS,5,0,83,0,88
2020,Russian Federation,RUS,Australia,AUS,5,0,12,0,17
2020,Rwanda,RWA,Australia,AUS,20,0,10,0,30
2020,El Salvador,SLV,Australia,AUS,5,0,0,0,5
2020,Saudi Arabia,SAU,Australia,AUS,62,0,10,0,72
2020,Serbia and Kosovo: S/RES/1244 (1999),SRB,Australia,AUS,0,0,5,0,5
2020,Singapore,SGP,Australia,AUS,0,0,27,0,27
2020,Sierra Leone,SLE,Australia,AUS,5,0,0,0,5
2020,Solomon Islands,SLB,Australia,AUS,5,0,25,10,40
2020,Somalia,SOM,Australia,AUS,12,0,5,5,22
2020,Viet Nam,VNM,Australia,AUS,13,0,1273,141,1427
2020,Sudan,SDN,Australia,AUS,15,0,52,18,85
2020,South Sudan,SSD,Australia,AUS,0,0,10,11,21
2020,Syrian Arab Rep.,SYR,Australia,AUS,32,0,5,25,62
2020,Thailand,THA,Australia,AUS,5,0,810,0,815
2020,Timor-Leste,TLS,Australia,AUS,0,0,0,19,19
2020,Tonga,TON,Australia,AUS,0,0,60,19,79
2020,Turkey,TUR,Australia,AUS,113,0,52,5,170
2020,Uganda,UGA,Australia,AUS,5,0,0,0,5
2020,Ukraine,UKR,Australia,AUS,0,0,28,5,33
2020,United States of America,USA,Australia,AUS,5,0,5,5,15
2020,Uzbekistan,UZB,Australia,AUS,0,0,0,5,5
2020,Vanuatu,VUT,Australia,AUS,0,0,5,0,5
2020,Venezuela (Bolivarian Republic of),VEN,Australia,AUS,67,0,27,0,94
2020,Samoa,WSM,Australia,AUS,0,0,5,5,10
2020,Yemen,YEM,Australia,AUS,102,0,0,0,102
2020,Zimbabwe,ZWE,Australia,AUS,35,0,61,0,96
2020,Stateless,XXA,Australia,AUS,151,0,44,231,426
2020,Afghanistan,AFG,Azerbaijan,AZE,0,0,109,5,114
2020,Egypt,EGY,Azerbaijan,AZE,0,0,5,0,5
2020,Cameroon,CMR,Azerbaijan,AZE,0,0,5,0,5
2020,India,IND,Azerbaijan,AZE,0,0,5,0,5
2020,Iran (Islamic Rep. of),IRN,Azerbaijan,AZE,0,0,12,0,12
2020,Iraq,IRQ,Azerbaijan,AZE,0,0,5,0,5
2020,Sri Lanka,LKA,Azerbaijan,AZE,0,0,5,0,5
2020,Pakistan,PAK,Azerbaijan,AZE,0,0,61,5,66
2020,Russian Federation,RUS,Azerbaijan,AZE,0,0,0,5,5
2020,Dem. Rep. of the Congo,COD,Burundi,BDI,3823,0,888,0,4711
2020,Rwanda,RWA,Burundi,BDI,48,0,38,248,334
2020,South Sudan,SSD,Burundi,BDI,5,0,0,0,5
2020,Afghanistan,AFG,Belgium,BEL,210,365,1155,0,1730
2020,Albania,ALB,Belgium,BEL,5,0,415,0,420
2020,Algeria,DZA,Belgium,BEL,5,0,35,0,40
2020,Angola,AGO,Belgium,BEL,10,0,45,0,55
2020,Egypt,EGY,Belgium,BEL,0,0,35,0,35
2020,Armenia,ARM,Belgium,BEL,10,5,75,0,90
2020,Azerbaijan,AZE,Belgium,BEL,10,0,15,0,25
2020,Burundi,BDI,Belgium,BEL,325,0,30,0,355
2020,Belgium,BEL,Belgium,BEL,0,0,5,0,5
2020,Benin,BEN,Belgium,BEL,0,0,25,0,25
2020,Bangladesh,BGD,Belgium,BEL,5,0,20,0,25
2020,Burkina Faso,BFA,Belgium,BEL,0,0,10,0,10
2020,Belarus,BLR,Belgium,BEL,0,0,10,0,10
2020,Brazil,BRA,Belgium,BEL,0,0,40,0,40
2020,Bosnia and Herzegovina,BIH,Belgium,BEL,0,0,25,0,25
2020,Bulgaria,BGR,Belgium,BEL,0,0,5,0,5
2020,Central African Rep.,CAF,Belgium,BEL,5,0,5,0,10
2020,Chad,TCD,Belgium,BEL,10,0,10,0,20
2020,China,CHN,Belgium,BEL,60,0,45,0,105
2020,Chile,CHL,Belgium,BEL,0,0,5,0,5
2020,Cameroon,CMR,Belgium,BEL,55,20,180,0,255
2020,Congo,COG,Belgium,BEL,0,0,10,0,10
2020,Dem. Rep. of the Congo,COD,Belgium,BEL,45,5,255,0,305
2020,Colombia,COL,Belgium,BEL,40,0,235,0,275
2020,Cuba,CUB,Belgium,BEL,0,0,5,0,5
2020,Djibouti,DJI,Belgium,BEL,25,0,35,0,60
2020,Eritrea,ERI,Belgium,BEL,610,0,145,0,755
2020,Ethiopia,ETH,Belgium,BEL,5,0,25,0,30
2020,Gabon,GAB,Belgium,BEL,0,0,5,0,5
2020,Gambia,GMB,Belgium,BEL,10,0,35,0,45
2020,Palestinian,PSE,Belgium,BEL,355,0,1305,0,1660
2020,Georgia,GEO,Belgium,BEL,30,0,150,0,180
2020,Ghana,GHA,Belgium,BEL,0,0,15,0,15
2020,Guinea-Bissau,GNB,Belgium,BEL,0,0,5,0,5
2020,Guinea,GIN,Belgium,BEL,180,5,670,0,855
2020,Cote d'Ivoire,CIV,Belgium,BEL,25,0,60,0,85
2020,India,IND,Belgium,BEL,0,0,15,0,15
2020,Indonesia,IDN,Belgium,BEL,0,0,5,0,5
2020,Iran (Islamic Rep. of),IRN,Belgium,BEL,140,0,170,0,310
2020,Iraq,IRQ,Belgium,BEL,160,60,795,0,1015
2020,Israel,ISR,Belgium,BEL,0,0,5,0,5
2020,Jordan,JOR,Belgium,BEL,0,0,20,0,20
2020,Kazakhstan,KAZ,Belgium,BEL,5,0,10,0,15
2020,Kenya,KEN,Belgium,BEL,0,0,5,0,5
2020,Kyrgyzstan,KGZ,Belgium,BEL,20,0,20,0,40
2020,Kuwait,KWT,Belgium,BEL,0,0,5,0,5
2020,Liberia,LBR,Belgium,BEL,0,0,15,0,15
2020,Libya,LBY,Belgium,BEL,0,30,15,0,45
2020,Lebanon,LBN,Belgium,BEL,0,0,45,0,45
2020,Sri Lanka,LKA,Belgium,BEL,5,0,55,0,60
2020,Mauritania,MRT,Belgium,BEL,10,0,55,0,65
2020,North Macedonia,MKD,Belgium,BEL,5,0,80,0,85
2020,Mexico,MEX,Belgium,BEL,0,0,5,0,5
2020,Mali,MLI,Belgium,BEL,5,0,30,0,35
2020,Malaysia,MYS,Belgium,BEL,0,0,5,0,5
2020,Mongolia,MNG,Belgium,BEL,0,0,5,0,5
2020,Morocco,MAR,Belgium,BEL,10,0,65,0,75
2020,Montenegro,MNE,Belgium,BEL,5,0,0,0,5
2020,Nepal,NPL,Belgium,BEL,0,0,5,0,5
2020,Niger,NER,Belgium,BEL,5,0,60,0,65
2020,Nicaragua,NIC,Belgium,BEL,5,0,5,0,10
2020,Nigeria,NGA,Belgium,BEL,0,0,40,0,40
2020,Pakistan,PAK,Belgium,BEL,20,0,110,0,130
2020,Romania,ROU,Belgium,BEL,0,0,5,0,5
2020,Russian Federation,RUS,Belgium,BEL,85,0,215,0,300
2020,Rwanda,RWA,Belgium,BEL,60,0,190,0,250
2020,El Salvador,SLV,Belgium,BEL,35,40,830,0,905
2020,Serbia and Kosovo: S/RES/1244 (1999),SRB,Belgium,BEL,25,0,195,0,220
2020,Senegal,SEN,Belgium,BEL,25,0,90,0,115
2020,Sierra Leone,SLE,Belgium,BEL,0,0,20,0,20
2020,Somalia,SOM,Belgium,BEL,270,80,270,0,620
2020,Spain,ESP,Belgium,BEL,0,0,5,0,5
2020,Viet Nam,VNM,Belgium,BEL,0,0,5,0,5
2020,Sudan,SDN,Belgium,BEL,35,0,50,0,85
2020,Suriname,SUR,Belgium,BEL,0,0,95,0,95
2020,South Sudan,SSD,Belgium,BEL,5,0,5,0,10
2020,Syrian Arab Rep.,SYR,Belgium,BEL,1145,165,990,0,2300
2020,United Rep. of Tanzania,TZA,Belgium,BEL,0,0,15,0,15
2020,Togo,TGO,Belgium,BEL,10,0,45,0,55
2020,Tunisia,TUN,Belgium,BEL,0,0,20,0,20
2020,Turkey,TUR,Belgium,BEL,360,0,215,0,575
2020,Uganda,UGA,Belgium,BEL,0,0,10,0,10
2020,Ukraine,UKR,Belgium,BEL,20,0,60,0,80
2020,Uzbekistan,UZB,Belgium,BEL,0,0,5,0,5
2020,Venezuela (Bolivarian Republic of),VEN,Belgium,BEL,70,5,230,0,305
2020,Yemen,YEM,Belgium,BEL,25,190,35,0,250
2020,Stateless,XXA,Belgium,BEL,0,0,5,0,5
2020,Syrian Arab Rep.,SYR,Benin,BEN,0,0,0,5,5
2020,Benin,BEN,Burkina Faso,BFA,10,0,0,0,10
2020,Central African Rep.,CAF,Burkina Faso,BFA,14,0,0,0,14
2020,Turkey,TUR,Burkina Faso,BFA,5,0,0,0,5
2020,Afghanistan,AFG,Belarus,BLR,0,12,0,0,12
2020,Egypt,EGY,Belarus,BLR,0,0,5,0,5
2020,Armenia,ARM,Belarus,BLR,0,0,5,0,5
2020,Azerbaijan,AZE,Belarus,BLR,0,0,5,0,5
2020,Bangladesh,BGD,Belarus,BLR,0,0,5,0,5
2020,Cameroon,CMR,Belarus,BLR,0,5,0,0,5
2020,Cuba,CUB,Belarus,BLR,0,0,5,0,5
2020,Palestinian,PSE,Belarus,BLR,5,0,0,0,5
2020,Iraq,IRQ,Belarus,BLR,0,0,5,0,5
2020,Kazakhstan,KAZ,Belarus,BLR,0,0,10,0,10
2020,Mongolia,MNG,Belarus,BLR,0,0,5,0,5
2020,Pakistan,PAK,Belarus,BLR,0,0,0,5,5
2020,Russian Federation,RUS,Belarus,BLR,0,0,10,5,15
2020,Syrian Arab Rep.,SYR,Belarus,BLR,0,10,0,0,10
2020,Tajikistan,TJK,Belarus,BLR,0,0,5,0,5
2020,Turkey,TUR,Belarus,BLR,0,0,0,5,5
2020,Ukraine,UKR,Belarus,BLR,0,421,10,12,443
2020,Uzbekistan,UZB,Belarus,BLR,0,0,5,0,5
2020,Yemen,YEM,Belarus,BLR,0,5,0,0,5
2020,Colombia,COL,Bolivia (Plurinational State of),BOL,0,0,10,17,27
2020,Cuba,CUB,Bolivia (Plurinational State of),BOL,0,0,0,5,5
2020,Ecuador,ECU,Bolivia (Plurinational State of),BOL,0,0,0,5,5
2020,Peru,PER,Bolivia (Plurinational State of),BOL,11,0,5,5,21
2020,Venezuela (Bolivarian Republic of),VEN,Bolivia (Plurinational State of),BOL,242,0,273,404,919
2020,Dem. Rep. of the Congo,COD,Botswana,BWA,0,0,31,0,31
2020,Namibia,NAM,Botswana,BWA,0,0,0,5,5
2020,Afghanistan,AFG,Brazil,BRA,12,0,0,0,12
2020,Angola,AGO,Brazil,BRA,11,0,94,0,105
2020,Egypt,EGY,Brazil,BRA,10,0,10,0,20
2020,Argentina,ARG,Brazil,BRA,0,0,15,0,15
2020,Bangladesh,BGD,Brazil,BRA,0,0,13,0,13
2020,China,CHN,Brazil,BRA,5,0,5,0,10
2020,Cameroon,CMR,Brazil,BRA,10,0,5,0,15
2020,Dem. Rep. of the Congo,COD,Brazil,BRA,34,0,42,0,76
2020,Colombia,COL,Brazil,BRA,5,0,5,0,10
2020,Cuba,CUB,Brazil,BRA,123,0,25,0,148
2020,Cabo Verde,CPV,Brazil,BRA,0,0,5,0,5
2020,Dominican Rep.,DOM,Brazil,BRA,0,0,5,0,5
2020,Ethiopia,ETH,Brazil,BRA,5,0,0,0,5
2020,Gambia,GMB,Brazil,BRA,0,0,5,0,5
2020,Palestinian,PSE,Brazil,BRA,5,0,0,0,5
2020,Ghana,GHA,Brazil,BRA,0,0,5,0,5
2020,Guinea-Bissau,GNB,Brazil,BRA,5,0,22,0,27
2020,Guinea,GIN,Brazil,BRA,0,0,14,0,14
2020,Cote d'Ivoire,CIV,Brazil,BRA,0,0,10,0,10
2020,India,IND,Brazil,BRA,0,0,5,0,5
2020,Iran (Islamic Rep. of),IRN,Brazil,BRA,5,0,0,0,5
2020,Iraq,IRQ,Brazil,BRA,5,0,0,0,5
2020,Jordan,JOR,Brazil,BRA,0,0,5,0,5
2020,Kenya,KEN,Brazil,BRA,0,0,5,0,5
2020,Lebanon,LBN,Brazil,BRA,5,0,43,0,48
2020,Mauritania,MRT,Brazil,BRA,29,0,0,0,29
2020,Mali,MLI,Brazil,BRA,0,0,15,0,15
2020,Morocco,MAR,Brazil,BRA,10,0,11,0,21
2020,Mozambique,MOZ,Brazil,BRA,0,0,5,0,5
2020,Nepal,NPL,Brazil,BRA,0,0,5,0,5
2020,Nigeria,NGA,Brazil,BRA,5,0,51,0,56
2020,Pakistan,PAK,Brazil,BRA,27,0,15,0,42
2020,Philippines,PHL,Brazil,BRA,0,0,12,0,12
2020,Russian Federation,RUS,Brazil,BRA,5,0,0,0,5
2020,El Salvador,SLV,Brazil,BRA,0,0,0,5,5
2020,Senegal,SEN,Brazil,BRA,0,0,5,0,5
2020,Sierra Leone,SLE,Brazil,BRA,0,0,14,0,14
2020,Sudan,SDN,Brazil,BRA,5,0,0,0,5
2020,Syrian Arab Rep.,SYR,Brazil,BRA,179,0,0,10,189
2020,United Rep. of Tanzania,TZA,Brazil,BRA,0,0,10,0,10
2020,Togo,TGO,Brazil,BRA,13,0,13,0,26
2020,Tunisia,TUN,Brazil,BRA,0,0,5,0,5
2020,Turkey,TUR,Brazil,BRA,0,0,5,0,5
2020,Ukraine,UKR,Brazil,BRA,5,0,0,0,5
2020,Venezuela (Bolivarian Republic of),VEN,Brazil,BRA,25734,0,0,0,25734
2020,Yemen,YEM,Brazil,BRA,5,0,0,0,5
2020,Afghanistan,AFG,Bosnia and Herzegovina,BIH,0,0,5,132,137
2020,Algeria,DZA,Bosnia and Herzegovina,BIH,0,0,0,5,5
2020,Azerbaijan,AZE,Bosnia and Herzegovina,BIH,0,5,0,0,5
2020,Palestinian,PSE,Bosnia and Herzegovina,BIH,0,0,0,5,5
2020,India,IND,Bosnia and Herzegovina,BIH,0,0,0,5,5
2020,Iran (Islamic Rep. of),IRN,Bosnia and Herzegovina,BIH,0,0,10,95,105
2020,Iraq,IRQ,Bosnia and Herzegovina,BIH,0,0,5,236,241
2020,Morocco,MAR,Bosnia and Herzegovina,BIH,0,0,5,0,5
2020,Nepal,NPL,Bosnia and Herzegovina,BIH,0,0,0,5,5
2020,Pakistan,PAK,Bosnia and Herzegovina,BIH,0,0,19,56,75
2020,Syrian Arab Rep.,SYR,Bosnia and Herzegovina,BIH,0,5,0,41,46
2020,Tunisia,TUN,Bosnia and Herzegovina,BIH,0,0,0,5,5
2020,Turkey,TUR,Bosnia and Herzegovina,BIH,0,18,0,39,57
2020,Yemen,YEM,Bosnia and Herzegovina,BIH,0,0,5,5,10
2020,El Salvador,SLV,Belize,BLZ,0,0,0,10,10
2020,Viet Nam,VNM,Cambodia,KHM,0,0,0,15,15
2020,Afghanistan,AFG,Canada,CAN,206,0,47,0,263
2020,Albania,ALB,Canada,CAN,30,0,44,0,75
2020,Algeria,DZA,Canada,CAN,162,0,90,0,272
2020,Angola,AGO,Canada,CAN,96,0,131,0,238
2020,Egypt,EGY,Canada,CAN,448,0,73,27,548
2020,Azerbaijan,AZE,Canada,CAN,89,0,0,0,99
2020,Barbados,BRB,Canada,CAN,0,0,5,0,32
2020,Burundi,BDI,Canada,CAN,441,0,0,5,463
2020,Bangladesh,BGD,Canada,CAN,154,0,101,0,267
2020,Bahamas,BHS,Canada,CAN,44,0,5,23,83
2020,Burkina Faso,BFA,Canada,CAN,0,0,0,0,23
2020,Belarus,BLR,Canada,CAN,0,0,5,0,5
2020,Brazil,BRA,Canada,CAN,23,0,77,5,108
2020,Bulgaria,BGR,Canada,CAN,0,0,0,0,20
2020,Chad,TCD,Canada,CAN,104,0,0,0,128
2020,China,CHN,Canada,CAN,551,0,279,5,882
2020,Chile,CHL,Canada,CAN,0,0,10,0,38
2020,Cameroon,CMR,Canada,CAN,122,0,38,0,174
2020,Congo,COG,Canada,CAN,24,0,0,0,35
2020,Dem. Rep. of the Congo,COD,Canada,CAN,213,0,160,0,395
2020,Colombia,COL,Canada,CAN,796,0,359,0,1213
2020,Costa Rica,CRI,Canada,CAN,0,0,5,0,5
2020,Cuba,CUB,Canada,CAN,22,0,5,0,35
2020,Czechia,CZE,Canada,CAN,0,0,0,29,43
2020,Djibouti,DJI,Canada,CAN,40,0,5,0,72
2020,Dominica,DMA,Canada,CAN,0,0,5,0,5
2020,Dominican Rep.,DOM,Canada,CAN,0,0,5,0,32
2020,Ecuador,ECU,Canada,CAN,0,0,0,0,23
2020,Eritrea,ERI,Canada,CAN,243,0,28,60,331
2020,Ethiopia,ETH,Canada,CAN,287,0,98,0,401
2020,France,FRA,Canada,CAN,0,0,24,0,35
2020,Palestinian,PSE,Canada,CAN,357,0,75,0,438
2020,United Kingdom of Great Britain and Northern Ireland,GBR,Canada,CAN,0,0,5,0,5
2020,Georgia,GEO,Canada,CAN,37,0,25,0,65
2020,Ghana,GHA,Canada,CAN,0,0,33,5,54
2020,Greece,GRC,Canada,CAN,0,0,5,0,5
2020,Guatemala,GTM,Canada,CAN,48,0,5,5,75
2020,Guinea,GIN,Canada,CAN,47,0,5,0,61
2020,Haiti,HTI,Canada,CAN,456,0,605,54,1115
2020,Honduras,HND,Canada,CAN,90,0,31,0,132
2020,Hungary,HUN,Canada,CAN,608,0,53,44,708
2020,Cote d'Ivoire,CIV,Canada,CAN,25,0,5,0,40
2020,India,IND,Canada,CAN,261,0,543,176,980
2020,Ireland,IRL,Canada,CAN,0,0,5,0,5
2020,Iran (Islamic Rep. of),IRN,Canada,CAN,1409,0,0,39,1475
2020,Iraq,IRQ,Canada,CAN,136,0,42,5,204
2020,Italy,ITA,Canada,CAN,0,0,5,0,28
2020,Jamaica,JAM,Canada,CAN,92,0,81,13,195
2020,Jordan,JOR,Canada,CAN,127,0,66,0,209
2020,Kenya,KEN,Canada,CAN,117,0,59,0,182
2020,Rep. of Korea,KOR,Canada,CAN,0,0,11,0,11
2020,Dem. People's Rep. of Korea,PRK,Canada,CAN,0,0,10,11,21
2020,Kuwait,KWT,Canada,CAN,36,0,5,0,42
2020,Liberia,LBR,Canada,CAN,0,0,0,0,22
2020,Libya,LBY,Canada,CAN,182,0,36,29,247
2020,Saint Lucia,LCA,Canada,CAN,0,0,10,0,10
2020,Lebanon,LBN,Canada,CAN,119,0,48,0,182
2020,Sri Lanka,LKA,Canada,CAN,190,0,68,0,282
2020,Mauritania,MRT,Canada,CAN,0,0,0,0,21
2020,Mexico,MEX,Canada,CAN,659,0,1049,426,2134
2020,Mali,MLI,Canada,CAN,24,0,0,0,27
2020,Malawi,MWI,Canada,CAN,0,0,5,0,30
2020,Morocco,MAR,Canada,CAN,24,0,10,0,40
2020,Nepal,NPL,Canada,CAN,59,0,0,0,63
2020,Nicaragua,NIC,Canada,CAN,154,0,5,0,172
2020,Nigeria,NGA,Canada,CAN,1419,0,1646,36,3113
2020,Norway,NOR,Canada,CAN,0,0,0,5,5
2020,Pakistan,PAK,Canada,CAN,752,0,304,0,1124
2020,Peru,PER,Canada,CAN,0,0,5,0,27
2020,Philippines,PHL,Canada,CAN,19,0,55,14,88
2020,Poland,POL,Canada,CAN,0,0,5,0,29
2020,Portugal,PRT,Canada,CAN,0,0,59,0,59
2020,Qatar,QAT,Canada,CAN,0,0,5,0,5
2020,Romania,ROU,Canada,CAN,62,0,33,157,252
2020,South Africa,ZAF,Canada,CAN,0,0,47,5,68
2020,Russian Federation,RUS,Canada,CAN,33,0,5,0,50
2020,Rwanda,RWA,Canada,CAN,170,0,51,0,231
2020,El Salvador,SLV,Canada,CAN,107,0,5,5,148
2020,Saudi Arabia,SAU,Canada,CAN,129,0,5,0,141
2020,Serbia and Kosovo: S/RES/1244 (1999),SRB,Canada,CAN,0,0,5,0,5
2020,Senegal,SEN,Canada,CAN,28,0,43,0,76
2020,Somalia,SOM,Canada,CAN,126,0,5,0,160
2020,Spain,ESP,Canada,CAN,0,0,0,0,26
2020,Viet Nam,VNM,Canada,CAN,0,0,10,0,39
2020,Sudan,SDN,Canada,CAN,412,0,5,22,457
2020,Slovakia,SVK,Canada,CAN,36,0,5,29,72
2020,Syrian Arab Rep.,SYR,Canada,CAN,158,0,0,0,180
2020,United Rep. of Tanzania,TZA,Canada,CAN,38,0,0,0,47
2020,Trinidad and Tobago,TTO,Canada,CAN,0,0,5,0,26
2020,Turkey,TUR,Canada,CAN,614,0,5,28,668
2020,United Arab Emirates,ARE,Canada,CAN,30,0,5,0,35
2020,Uganda,UGA,Canada,CAN,164,0,38,0,213
2020,Ukraine,UKR,Canada,CAN,72,0,10,0,96
2020,United States of America,USA,Canada,CAN,0,0,550,62,639
2020,Saint Vincent and the Grenadines,VCT,Canada,CAN,0,0,10,5,15
2020,Venezuela (Bolivarian Republic of),VEN,Canada,CAN,545,0,56,23,624
2020,Yemen,YEM,Canada,CAN,252,0,0,0,258
2020,Zimbabwe,ZWE,Canada,CAN,135,0,24,0,165
2020,Stateless,XXA,Canada,CAN,119,0,0,0,140
2020,Colombia,COL,Chile,CHL,5,0,1139,0,1144
2020,Cuba,CUB,Chile,CHL,0,0,383,0,383
2020,Venezuela (Bolivarian Republic of),VEN,Chile,CHL,0,0,399,0,399
2020,Central African Rep.,CAF,Congo,COG,1075,0,0,0,1075
2020,Dem. Rep. of the Congo,COD,Congo,COG,0,0,0,5,5
2020,Burundi,BDI,Dem. Rep. of the Congo,COD,0,0,0,1663,1663
2020,Central African Rep.,CAF,Dem. Rep. of the Congo,COD,0,0,20,22,42
2020,Chad,TCD,Dem. Rep. of the Congo,COD,5,0,0,0,5
2020,Cote d'Ivoire,CIV,Dem. Rep. of the Congo,COD,0,0,5,0,5
2020,Sudan,SDN,Dem. Rep. of the Congo,COD,0,0,0,5,5
2020,South Sudan,SSD,Dem. Rep. of the Congo,COD,0,0,0,10,10
2020,Syrian Arab Rep.,SYR,Dem. Rep. of the Congo,COD,0,0,0,13,13
2020,Uganda,UGA,Dem. Rep. of the Congo,COD,5,0,0,0,5
2020,Cuba,CUB,Colombia,COL,5,0,0,0,5
2020,Pakistan,PAK,Colombia,COL,0,0,5,0,5
2020,Venezuela (Bolivarian Republic of),VEN,Colombia,COL,346,0,0,723,1069
2020,Argentina,ARG,Costa Rica,CRI,0,0,5,5,10
2020,Burundi,BDI,Costa Rica,CRI,5,0,0,0,5
2020,China,CHN,Costa Rica,CRI,0,0,5,0,5
2020,Chile,CHL,Costa Rica,CRI,0,0,5,0,5
2020,Dem. Rep. of the Congo,COD,Costa Rica,CRI,0,0,0,10,10
2020,Colombia,COL,Costa Rica,CRI,20,0,187,438,645
2020,Cuba,CUB,Costa Rica,CRI,45,0,133,185,363
2020,Dominican Rep.,DOM,Costa Rica,CRI,0,0,0,14,14
2020,Guatemala,GTM,Costa Rica,CRI,0,0,0,5,5
2020,Haiti,HTI,Costa Rica,CRI,0,0,11,40,51
2020,Honduras,HND,Costa Rica,CRI,16,0,34,92,142
2020,Mexico,MEX,Costa Rica,CRI,5,0,12,0,17
2020,Nepal,NPL,Costa Rica,CRI,0,0,0,5,5
2020,Nicaragua,NIC,Costa Rica,CRI,2419,0,2135,9649,14203
2020,El Salvador,SLV,Costa Rica,CRI,229,0,311,403,943
2020,Spain,ESP,Costa Rica,CRI,0,0,0,5,5
2020,Syrian Arab Rep.,SYR,Costa Rica,CRI,0,0,0,5,5
2020,United States of America,USA,Costa Rica,CRI,0,0,0,5,5
2020,Venezuela (Bolivarian Republic of),VEN,Costa Rica,CRI,686,0,619,837,2142
2020,Egypt,EGY,Cyprus,CYP,5,0,103,133,241
2020,Armenia,ARM,Cyprus,CYP,0,0,5,0,5
2020,Bangladesh,BGD,Cyprus,CYP,0,0,172,179,351
2020,Cameroon,CMR,Cyprus,CYP,12,5,52,22,91
2020,Congo,COG,Cyprus,CYP,0,0,5,0,5
2020,Dem. Rep. of the Congo,COD,Cyprus,CYP,0,0,21,5,26
2020,Ethiopia,ETH,Cyprus,CYP,0,0,0,5,5
2020,Gambia,GMB,Cyprus,CYP,0,0,5,0,5
2020,Palestinian,PSE,Cyprus,CYP,34,11,0,5,50
2020,Georgia,GEO,Cyprus,CYP,0,0,285,547,832
2020,Guinea,GIN,Cyprus,CYP,0,0,5,5,10
2020,India,IND,Cyprus,CYP,0,0,224,396,620
2020,Iran (Islamic Rep. of),IRN,Cyprus,CYP,13,5,0,103,121
2020,Iraq,IRQ,Cyprus,CYP,13,5,24,5,47
2020,Jordan,JOR,Cyprus,CYP,0,0,0,14,14
2020,Kyrgyzstan,KGZ,Cyprus,CYP,0,0,0,5,5
2020,Lebanon,LBN,Cyprus,CYP,0,0,11,5,16
2020,Sri Lanka,LKA,Cyprus,CYP,0,0,36,57,93
2020,Morocco,MAR,Cyprus,CYP,0,0,5,0,5
2020,Nepal,NPL,Cyprus,CYP,0,0,33,59,92
2020,Nigeria,NGA,Cyprus,CYP,0,0,49,26,75
2020,Pakistan,PAK,Cyprus,CYP,0,0,553,240,793
2020,Philippines,PHL,Cyprus,CYP,0,0,59,32,91
2020,Russian Federation,RUS,Cyprus,CYP,0,0,0,10,10
2020,Sierra Leone,SLE,Cyprus,CYP,0,0,5,0,5
2020,Somalia,SOM,Cyprus,CYP,26,72,5,62,165
2020,Viet Nam,VNM,Cyprus,CYP,0,0,35,93,128
2020,Syrian Arab Rep.,SYR,Cyprus,CYP,22,1397,0,45,1464
2020,Turkey,TUR,Cyprus,CYP,16,0,5,18,39
2020,Ukraine,UKR,Cyprus,CYP,0,0,0,11,11
2020,Venezuela (Bolivarian Republic of),VEN,Cyprus,CYP,0,0,0,5,5
2020,Afghanistan,AFG,Czechia,CZE,0,0,5,14,19
2020,Algeria,DZA,Czechia,CZE,0,0,5,5,10
2020,Egypt,EGY,Czechia,CZE,0,0,5,0,5
2020,Armenia,ARM,Czechia,CZE,0,0,23,29,52
2020,Azerbaijan,AZE,Czechia,CZE,0,0,36,23,59
2020,Bangladesh,BGD,Czechia,CZE,0,0,0,5,5
2020,Belarus,BLR,Czechia,CZE,5,0,5,10,20
2020,China,CHN,Czechia,CZE,5,0,0,5,10
2020,Cameroon,CMR,Czechia,CZE,0,0,0,5,5
2020,Cuba,CUB,Czechia,CZE,0,0,19,13,32
2020,Eritrea,ERI,Czechia,CZE,0,0,0,5,5
2020,Ethiopia,ETH,Czechia,CZE,0,0,0,5,5
2020,Georgia,GEO,Czechia,CZE,0,0,98,70,168
2020,Ghana,GHA,Czechia,CZE,0,0,5,0,5
2020,India,IND,Czechia,CZE,0,0,10,5,15
2020,Iran (Islamic Rep. of),IRN,Czechia,CZE,0,0,12,5,17
2020,Iraq,IRQ,Czechia,CZE,0,0,5,10,15
2020,Jordan,JOR,Czechia,CZE,0,0,5,0,5
2020,Kazakhstan,KAZ,Czechia,CZE,5,0,33,28,66
2020,Kyrgyzstan,KGZ,Czechia,CZE,0,0,5,11,16
2020,Libya,LBY,Czechia,CZE,0,10,0,0,10
2020,Lebanon,LBN,Czechia,CZE,0,0,0,5,5
2020,Rep. of Moldova,MDA,Czechia,CZE,0,0,29,14,43
2020,Mongolia,MNG,Czechia,CZE,0,0,0,5,5
2020,Morocco,MAR,Czechia,CZE,0,0,0,5,5
2020,Nigeria,NGA,Czechia,CZE,0,0,12,10,22
2020,Pakistan,PAK,Czechia,CZE,0,0,12,5,17
2020,Russian Federation,RUS,Czechia,CZE,19,5,44,22,90
2020,Serbia and Kosovo: S/RES/1244 (1999),SRB,Czechia,CZE,0,0,5,0,5
2020,Viet Nam,VNM,Czechia,CZE,0,0,73,27,100
2020,Syrian Arab Rep.,SYR,Czechia,CZE,0,24,0,5,29
2020,Tunisia,TUN,Czechia,CZE,0,0,5,5,10
2020,Turkey,TUR,Czechia,CZE,0,0,16,16,32
2020,Ukraine,UKR,Czechia,CZE,0,12,248,132,392
2020,Uzbekistan,UZB,Czechia,CZE,5,0,48,33,86
2020,Venezuela (Bolivarian Republic of),VEN,Czechia,CZE,0,5,24,0,29
2020,Yemen,YEM,Czechia,CZE,0,5,0,0,5
2020,Stateless,XXA,Czechia,CZE,0,13,0,0,13
2020,Afghanistan,AFG,Denmark,DNK,5,0,36,0,41
2020,Albania,ALB,Denmark,DNK,0,0,14,0,14
2020,Algeria,DZA,Denmark,DNK,0,0,5,0,5
2020,Armenia,ARM,Denmark,DNK,0,0,5,0,5
2020,Bangladesh,BGD,Denmark,DNK,0,0,5,0,5
2020,Dem. Rep. of the Congo,COD,Denmark,DNK,0,0,5,0,5
2020,Colombia,COL,Denmark,DNK,0,0,12,0,12
2020,Eritrea,ERI,Denmark,DNK,45,39,5,0,89
2020,Ethiopia,ETH,Denmark,DNK,0,0,5,0,5
2020,Germany,DEU,Denmark,DNK,0,0,42,0,42
2020,Ghana,GHA,Denmark,DNK,0,0,5,0,5
2020,Iran (Islamic Rep. of),IRN,Denmark,DNK,10,0,24,0,34
2020,Iraq,IRQ,Denmark,DNK,0,5,18,0,23
2020,Lebanon,LBN,Denmark,DNK,0,0,5,0,5
2020,Sri Lanka,LKA,Denmark,DNK,0,0,5,0,5
2020,Morocco,MAR,Denmark,DNK,0,0,16,0,16
2020,Pakistan,PAK,Denmark,DNK,0,0,11,0,11
2020,Romania,ROU,Denmark,DNK,0,0,5,0,5
2020,Russian Federation,RUS,Denmark,DNK,0,0,12,0,12
2020,Serbia and Kosovo: S/RES/1244 (1999),SRB,Denmark,DNK,0,0,14,0,14
2020,Somalia,SOM,Denmark,DNK,16,5,66,0,87
2020,Viet Nam,VNM,Denmark,DNK,0,0,5,0,5
2020,Syrian Arab Rep.,SYR,Denmark,DNK,75,130,29,0,234
2020,Turkey,TUR,Denmark,DNK,0,0,5,0,5
2020,Ukraine,UKR,Denmark,DNK,0,0,16,0,16
2020,Venezuela (Bolivarian Republic of),VEN,Denmark,DNK,0,0,10,0,10
2020,Yemen,YEM,Denmark,DNK,5,0,0,0,5
2020,Stateless,XXA,Denmark,DNK,51,5,73,0,129
2020,Dem. Rep. of the Congo,COD,Djibouti,DJI,5,0,0,0,5
2020,Eritrea,ERI,Djibouti,DJI,58,0,0,10,68
2020,Ethiopia,ETH,Djibouti,DJI,563,0,0,0,563
2020,Iraq,IRQ,Djibouti,DJI,5,0,0,0,5
2020,Colombia,COL,Dominican Rep.,DOM,0,0,0,10,10
2020,Cuba,CUB,Dominican Rep.,DOM,0,0,0,5,5
2020,Venezuela (Bolivarian Republic of),VEN,Dominican Rep.,DOM,0,0,5,13,18
2020,Albania,ALB,Estonia,EST,0,0,5,0,5
2020,Eritrea,ERI,Estonia,EST,0,5,0,0,5
2020,Iran (Islamic Rep. of),IRN,Estonia,EST,0,0,5,0,5
2020,Russian Federation,RUS,Estonia,EST,14,0,21,0,35
2020,Syrian Arab Rep.,SYR,Estonia,EST,5,0,0,0,5
2020,Tajikistan,TJK,Estonia,EST,0,0,5,0,5
2020,Turkey,TUR,Estonia,EST,5,0,0,0,5
2020,Afghanistan,AFG,Fiji,FJI,5,0,0,0,5
2020,Afghanistan,AFG,Finland,FIN,159,82,155,58,454
2020,Albania,ALB,Finland,FIN,0,0,10,0,10
2020,Algeria,DZA,Finland,FIN,0,0,0,5,5
2020,Angola,AGO,Finland,FIN,0,0,5,11,16
2020,Egypt,EGY,Finland,FIN,13,0,5,0,18
2020,Azerbaijan,AZE,Finland,FIN,5,0,0,0,5
2020,Bangladesh,BGD,Finland,FIN,5,0,5,0,10
2020,Belarus,BLR,Finland,FIN,0,0,5,16,21
2020,China,CHN,Finland,FIN,18,0,0,5,23
2020,Cameroon,CMR,Finland,FIN,13,5,16,15,49
2020,Congo,COG,Finland,FIN,0,0,0,5,5
2020,Dem. Rep. of the Congo,COD,Finland,FIN,5,0,11,5,21
2020,Colombia,COL,Finland,FIN,0,0,12,5,17
2020,Cuba,CUB,Finland,FIN,0,0,5,5,10
2020,Eritrea,ERI,Finland,FIN,5,0,0,0,5
2020,Ethiopia,ETH,Finland,FIN,14,0,0,0,14
2020,Gambia,GMB,Finland,FIN,0,0,5,13,18
2020,Georgia,GEO,Finland,FIN,0,0,23,15,38
2020,Ghana,GHA,Finland,FIN,0,0,12,0,12
2020,Guinea,GIN,Finland,FIN,5,0,0,0,5
2020,Honduras,HND,Finland,FIN,0,13,10,0,23
2020,Cote d'Ivoire,CIV,Finland,FIN,0,0,5,0,5
2020,Iran (Islamic Rep. of),IRN,Finland,FIN,43,0,31,10,84
2020,Iraq,IRQ,Finland,FIN,415,38,213,62,728
2020,Kazakhstan,KAZ,Finland,FIN,0,0,5,0,5
2020,Kenya,KEN,Finland,FIN,5,0,0,0,5
2020,Liberia,LBR,Finland,FIN,0,0,0,5,5
2020,Libya,LBY,Finland,FIN,0,5,0,0,5
2020,Lebanon,LBN,Finland,FIN,0,0,5,0,5
2020,Sri Lanka,LKA,Finland,FIN,0,0,11,0,11
2020,Lithuania,LTU,Finland,FIN,0,0,5,0,5
2020,Mexico,MEX,Finland,FIN,0,0,5,0,5
2020,Malaysia,MYS,Finland,FIN,0,0,5,0,5
2020,Mongolia,MNG,Finland,FIN,0,0,5,0,5
2020,Morocco,MAR,Finland,FIN,0,0,11,5,16
2020,Nicaragua,NIC,Finland,FIN,22,0,5,0,27
2020,Nigeria,NGA,Finland,FIN,5,0,38,39,82
2020,Pakistan,PAK,Finland,FIN,5,0,5,0,10
2020,Peru,PER,Finland,FIN,0,0,5,0,5
2020,South Africa,ZAF,Finland,FIN,0,0,0,5,5
2020,Russian Federation,RUS,Finland,FIN,104,5,131,37,277
2020,Rwanda,RWA,Finland,FIN,11,0,0,0,11
2020,Serbia and Kosovo: S/RES/1244 (1999),SRB,Finland,FIN,0,0,5,0,5
2020,Senegal,SEN,Finland,FIN,0,0,0,5,5
2020,Sierra Leone,SLE,Finland,FIN,0,0,0,5,5
2020,Somalia,SOM,Finland,FIN,138,13,33,28,212
2020,Spain,ESP,Finland,FIN,0,0,0,5,5
2020,Sudan,SDN,Finland,FIN,11,0,0,0,11
2020,Sweden,SWE,Finland,FIN,0,0,0,5,5
2020,Syrian Arab Rep.,SYR,Finland,FIN,34,5,5,24,68
2020,Tajikistan,TJK,Finland,FIN,5,0,5,0,10
2020,Tunisia,TUN,Finland,FIN,0,0,0,5,5
2020,Turkey,TUR,Finland,FIN,154,0,31,12,197
2020,Ukraine,UKR,Finland,FIN,0,0,10,5,15
2020,United States of America,USA,Finland,FIN,0,0,10,0,10
2020,Venezuela (Bolivarian Republic of),VEN,Finland,FIN,0,0,5,0,5
2020,Yemen,YEM,Finland,FIN,11,24,0,5,40
2020,Stateless,XXA,Finland,FIN,13,0,5,0,18
2020,Afghanistan,AFG,France,FRA,526,4286,2632,93,7537
2020,Albania,ALB,France,FRA,65,239,3847,191,4342
2020,Algeria,DZA,France,FRA,101,47,1836,102,2086
2020,Angola,AGO,France,FRA,64,21,1092,10,1187
2020,Egypt,EGY,France,FRA,29,0,221,13,263
2020,Argentina,ARG,France,FRA,0,0,5,0,5
2020,Armenia,ARM,France,FRA,36,60,1766,16,1878
2020,Azerbaijan,AZE,France,FRA,44,0,452,10,506
2020,Burundi,BDI,France,FRA,190,0,234,0,424
2020,Benin,BEN,France,FRA,20,10,76,0,106
2020,Bangladesh,BGD,France,FRA,224,50,4607,43,4924
2020,Burkina Faso,BFA,France,FRA,37,5,126,5,173
2020,Belarus,BLR,France,FRA,10,0,42,5,57
2020,Brazil,BRA,France,FRA,5,5,37,0,47
2020,Bosnia and Herzegovina,BIH,France,FRA,13,5,775,51,844
2020,Cambodia,KHM,France,FRA,5,0,34,0,39
2020,Central African Rep.,CAF,France,FRA,151,39,235,10,435
2020,Chad,TCD,France,FRA,69,11,364,14,458
2020,China,CHN,France,FRA,1501,5,499,0,2005
2020,Chile,CHL,France,FRA,0,0,13,5,18
2020,Cameroon,CMR,France,FRA,176,47,699,20,942
2020,Congo,COG,France,FRA,85,29,600,15,729
2020,Dem. Rep. of the Congo,COD,France,FRA,635,82,2291,21,3029
2020,Comoros,COM,France,FRA,89,10,945,42,1086
2020,Colombia,COL,France,FRA,22,22,262,23,329
2020,Cuba,CUB,France,FRA,31,0,238,0,269
2020,Djibouti,DJI,France,FRA,5,0,39,0,44
2020,Dominican Rep.,DOM,France,FRA,5,12,112,12,141
2020,Ecuador,ECU,France,FRA,0,0,5,0,5
2020,Equatorial Guinea,GNQ,France,FRA,5,0,10,0,15
2020,Eritrea,ERI,France,FRA,854,0,262,10,1126
2020,Ethiopia,ETH,France,FRA,144,5,236,5,390
2020,Gabon,GAB,France,FRA,16,12,121,18,167
2020,Gambia,GMB,France,FRA,24,5,155,0,184
2020,Palestinian,PSE,France,FRA,123,5,59,0,187
2020,Georgia,GEO,France,FRA,58,82,3106,76,3322
2020,Ghana,GHA,France,FRA,5,0,53,0,58
2020,Guinea-Bissau,GNB,France,FRA,5,0,51,5,61
2020,Guatemala,GTM,France,FRA,0,5,0,0,5
2020,Guinea,GIN,France,FRA,1295,111,4598,25,6029
2020,Haiti,HTI,France,FRA,177,156,2949,61,3343
2020,Honduras,HND,France,FRA,0,0,18,0,18
2020,Cote d'Ivoire,CIV,France,FRA,932,139,3765,51,4887
2020,India,IND,France,FRA,10,0,268,5,283
2020,Iran (Islamic Rep. of),IRN,France,FRA,91,0,212,5,308
2020,Iraq,IRQ,France,FRA,257,64,407,28,756
2020,Kazakhstan,KAZ,France,FRA,10,5,355,13,383
2020,Kenya,KEN,France,FRA,0,0,22,0,22
2020,Kyrgyzstan,KGZ,France,FRA,0,0,15,5,20
2020,Kuwait,KWT,France,FRA,41,0,221,14,276
2020,Liberia,LBR,France,FRA,5,0,26,0,31
2020,Libya,LBY,France,FRA,65,77,172,5,319
2020,Lebanon,LBN,France,FRA,10,0,104,5,119
2020,Sri Lanka,LKA,France,FRA,180,36,1338,20,1574
2020,Madagascar,MDG,France,FRA,5,5,60,10,80
2020,Mauritania,MRT,France,FRA,162,0,938,18,1118
2020,North Macedonia,MKD,France,FRA,0,0,537,87,624
2020,Rep. of Moldova,MDA,France,FRA,5,5,1424,56,1490
2020,Mexico,MEX,France,FRA,0,0,5,0,5
2020,Mali,MLI,France,FRA,309,59,1878,55,2301
2020,Mongolia,MNG,France,FRA,11,11,124,10,156
2020,Morocco,MAR,France,FRA,86,19,440,28,573
2020,Mauritius,MUS,France,FRA,5,0,0,0,5
2020,Nepal,NPL,France,FRA,5,0,87,0,92
2020,Niger,NER,France,FRA,5,0,52,0,57
2020,Nigeria,NGA,France,FRA,106,12,2814,30,2962
2020,Pakistan,PAK,France,FRA,73,26,2742,44,2885
2020,Peru,PER,France,FRA,5,10,46,0,61
2020,Philippines,PHL,France,FRA,0,0,5,0,5
2020,South Africa,ZAF,France,FRA,11,0,10,0,21
2020,Russian Federation,RUS,France,FRA,314,69,1870,70,2323
2020,Rwanda,RWA,France,FRA,120,0,135,5,260
2020,El Salvador,SLV,France,FRA,5,0,15,0,20
2020,Saudi Arabia,SAU,France,FRA,14,0,10,0,24
2020,Serbia and Kosovo: S/RES/1244 (1999),SRB,France,FRA,81,85,2572,175,2913
2020,Senegal,SEN,France,FRA,212,18,1453,18,1701
2020,Sierra Leone,SLE,France,FRA,31,0,114,0,145
2020,Somalia,SOM,France,FRA,203,248,1080,12,1543
2020,Viet Nam,VNM,France,FRA,5,0,32,5,42
2020,Sudan,SDN,France,FRA,944,60,737,20,1761
2020,Suriname,SUR,France,FRA,0,0,10,0,10
2020,Syrian Arab Rep.,SYR,France,FRA,730,1686,669,44,3129
2020,Thailand,THA,France,FRA,5,0,0,0,5
2020,Tajikistan,TJK,France,FRA,0,0,14,0,14
2020,Togo,TGO,France,FRA,25,0,87,0,112
2020,Tunisia,TUN,France,FRA,25,5,308,15,353
2020,Turkey,TUR,France,FRA,376,14,2142,33,2565
2020,Uganda,UGA,France,FRA,10,0,14,0,24
2020,Ukraine,UKR,France,FRA,40,39,993,72,1144
2020,United States of America,USA,France,FRA,0,0,20,0,20
2020,Uzbekistan,UZB,France,FRA,0,0,14,0,14
2020,Venezuela (Bolivarian Republic of),VEN,France,FRA,186,33,255,18,492
2020,Western Sahara,ESH,France,FRA,23,0,195,5,223
2020,Yemen,YEM,France,FRA,31,30,63,0,124
2020,Stateless,XXA,France,FRA,47,0,265,5,317
2020,Afghanistan,AFG,United Kingdom of Great Britain and Northern Ireland,GBR,554,15,336,309,1214
2020,Albania,ALB,United Kingdom of Great Britain and Northern Ireland,GBR,395,32,540,586,1553
2020,Algeria,DZA,United Kingdom of Great Britain and Northern Ireland,GBR,10,0,32,61,103
2020,Angola,AGO,United Kingdom of Great Britain and Northern Ireland,GBR,0,0,45,5,50
2020,Egypt,EGY,United Kingdom of Great Britain and Northern Ireland,GBR,68,0,74,31,173
2020,Argentina,ARG,United Kingdom of Great Britain and Northern Ireland,GBR,0,0,5,0,5
2020,Azerbaijan,AZE,United Kingdom of Great Britain and Northern Ireland,GBR,0,0,12,0,12
2020,Bahrain,BHR,United Kingdom of Great Britain and Northern Ireland,GBR,0,0,11,0,11
2020,Burundi,BDI,United Kingdom of Great Britain and Northern Ireland,GBR,0,0,5,0,5
2020,Benin,BEN,United Kingdom of Great Britain and Northern Ireland,GBR,0,0,10,0,10
2020,Bangladesh,BGD,United Kingdom of Great Britain and Northern Ireland,GBR,55,15,318,81,469
2020,Burkina Faso,BFA,United Kingdom of Great Britain and Northern Ireland,GBR,0,5,0,0,5
2020,Belarus,BLR,United Kingdom of Great Britain and Northern Ireland,GBR,5,0,0,5,10
2020,Bolivia (Plurinational State of),BOL,United Kingdom of Great Britain and Northern Ireland,GBR,0,0,5,0,5
2020,Brazil,BRA,United Kingdom of Great Britain and Northern Ireland,GBR,5,0,66,37,108
2020,Canada,CAN,United Kingdom of Great Britain and Northern Ireland,GBR,0,0,5,5,10
2020,Central African Rep.,CAF,United Kingdom of Great Britain and Northern Ireland,GBR,0,0,0,5,5
2020,Chad,TCD,United Kingdom of Great Britain and Northern Ireland,GBR,10,0,5,38,53
2020,China,CHN,United Kingdom of Great Britain and Northern Ireland,GBR,35,16,184,284,519
2020,Chile,CHL,United Kingdom of Great Britain and Northern Ireland,GBR,0,0,0,5,5
2020,Cameroon,CMR,United Kingdom of Great Britain and Northern Ireland,GBR,53,5,45,10,113
2020,Dem. Rep. of the Congo,COD,United Kingdom of Great Britain and Northern Ireland,GBR,22,0,24,5,51
2020,Colombia,COL,United Kingdom of Great Britain and Northern Ireland,GBR,0,0,11,0,11
2020,Cuba,CUB,United Kingdom of Great Britain and Northern Ireland,GBR,0,0,5,0,5
2020,Dominica,DMA,United Kingdom of Great Britain and Northern Ireland,GBR,0,0,0,32,32
2020,Equatorial Guinea,GNQ,United Kingdom of Great Britain and Northern Ireland,GBR,0,0,5,0,5
2020,Eritrea,ERI,United Kingdom of Great Britain and Northern Ireland,GBR,827,0,46,247,1120
2020,Ethiopia,ETH,United Kingdom of Great Britain and Northern Ireland,GBR,30,5,113,66,214
2020,Gambia,GMB,United Kingdom of Great Britain and Northern Ireland,GBR,16,5,19,15,55
2020,Palestinian,PSE,United Kingdom of Great Britain and Northern Ireland,GBR,56,20,41,20,137
2020,Georgia,GEO,United Kingdom of Great Britain and Northern Ireland,GBR,5,0,23,97,125
2020,Ghana,GHA,United Kingdom of Great Britain and Northern Ireland,GBR,17,5,66,29,117
2020,Grenada,GRD,United Kingdom of Great Britain and Northern Ireland,GBR,0,0,11,0,11
2020,Guatemala,GTM,United Kingdom of Great Britain and Northern Ireland,GBR,0,0,5,0,5
2020,Guinea,GIN,United Kingdom of Great Britain and Northern Ireland,GBR,10,0,0,10,20
2020,Guyana,GUY,United Kingdom of Great Britain and Northern Ireland,GBR,5,0,0,0,5
2020,"China, Hong Kong SAR",HKG,United Kingdom of Great Britain and Northern Ireland,GBR,0,5,0,15,20
2020,Honduras,HND,United Kingdom of Great Britain and Northern Ireland,GBR,5,13,34,14,66
2020,Cote d'Ivoire,CIV,United Kingdom of Great Britain and Northern Ireland,GBR,0,0,0,14,14
2020,India,IND,United Kingdom of Great Britain and Northern Ireland,GBR,5,28,547,358,938
2020,Indonesia,IDN,United Kingdom of Great Britain and Northern Ireland,GBR,12,0,0,0,12
2020,Iran (Islamic Rep. of),IRN,United Kingdom of Great Britain and Northern Ireland,GBR,1362,5,364,796,2527
2020,Iraq,IRQ,United Kingdom of Great Britain and Northern Ireland,GBR,356,177,871,799,2203
2020,Israel,ISR,United Kingdom of Great Britain and Northern Ireland,GBR,0,0,5,0,5
2020,Jamaica,JAM,United Kingdom of Great Britain and Northern Ireland,GBR,5,0,22,0,27
2020,Jordan,JOR,United Kingdom of Great Britain and Northern Ireland,GBR,17,5,27,0,49
2020,Japan,JPN,United Kingdom of Great Britain and Northern Ireland,GBR,0,0,0,5,5
2020,Kazakhstan,KAZ,United Kingdom of Great Britain and Northern Ireland,GBR,0,0,14,0,14
2020,Kenya,KEN,United Kingdom of Great Britain and Northern Ireland,GBR,16,5,35,5,61
2020,Kyrgyzstan,KGZ,United Kingdom of Great Britain and Northern Ireland,GBR,0,0,10,0,10
2020,Kuwait,KWT,United Kingdom of Great Britain and Northern Ireland,GBR,61,0,19,49,129
2020,Liberia,LBR,United Kingdom of Great Britain and Northern Ireland,GBR,0,0,5,0,5
2020,Libya,LBY,United Kingdom of Great Britain and Northern Ireland,GBR,72,542,0,42,656
2020,Saint Lucia,LCA,United Kingdom of Great Britain and Northern Ireland,GBR,0,0,5,5,10
2020,Lebanon,LBN,United Kingdom of Great Britain and Northern Ireland,GBR,10,0,18,5,33
2020,Sri Lanka,LKA,United Kingdom of Great Britain and Northern Ireland,GBR,39,16,168,43,266
2020,Lithuania,LTU,United Kingdom of Great Britain and Northern Ireland,GBR,0,0,5,0,5
2020,Mauritania,MRT,United Kingdom of Great Britain and Northern Ireland,GBR,0,0,0,5,5
2020,Maldives,MDV,United Kingdom of Great Britain and Northern Ireland,GBR,0,0,0,5,5
2020,Mexico,MEX,United Kingdom of Great Britain and Northern Ireland,GBR,0,0,5,5,10
2020,Mali,MLI,United Kingdom of Great Britain and Northern Ireland,GBR,0,0,0,14,14
2020,Malaysia,MYS,United Kingdom of Great Britain and Northern Ireland,GBR,41,0,38,17,96
2020,Malawi,MWI,United Kingdom of Great Britain and Northern Ireland,GBR,5,5,19,0,29
2020,Mongolia,MNG,United Kingdom of Great Britain and Northern Ireland,GBR,5,0,16,5,26
2020,Morocco,MAR,United Kingdom of Great Britain and Northern Ireland,GBR,12,5,24,27,68
2020,Mauritius,MUS,United Kingdom of Great Britain and Northern Ireland,GBR,0,5,17,0,22
2020,Myanmar,MMR,United Kingdom of Great Britain and Northern Ireland,GBR,12,0,0,0,12
2020,Namibia,NAM,United Kingdom of Great Britain and Northern Ireland,GBR,13,0,148,20,181
2020,Nepal,NPL,United Kingdom of Great Britain and Northern Ireland,GBR,0,5,21,25,51
2020,Niger,NER,United Kingdom of Great Britain and Northern Ireland,GBR,0,0,0,5,5
2020,Nicaragua,NIC,United Kingdom of Great Britain and Northern Ireland,GBR,19,0,14,5,38
2020,Nigeria,NGA,United Kingdom of Great Britain and Northern Ireland,GBR,177,84,468,81,810
2020,Oman,OMN,United Kingdom of Great Britain and Northern Ireland,GBR,0,0,0,12,12
2020,Pakistan,PAK,United Kingdom of Great Britain and Northern Ireland,GBR,268,76,540,290,1174
2020,Philippines,PHL,United Kingdom of Great Britain and Northern Ireland,GBR,5,0,13,5,23
2020,Poland,POL,United Kingdom of Great Britain and Northern Ireland,GBR,0,0,5,0,5
2020,Qatar,QAT,United Kingdom of Great Britain and Northern Ireland,GBR,5,0,0,0,5
2020,Romania,ROU,United Kingdom of Great Britain and Northern Ireland,GBR,0,0,10,0,10
2020,South Africa,ZAF,United Kingdom of Great Britain and Northern Ireland,GBR,0,10,55,10,75
2020,Russian Federation,RUS,United Kingdom of Great Britain and Northern Ireland,GBR,113,0,72,24,209
2020,Rwanda,RWA,United Kingdom of Great Britain and Northern Ireland,GBR,13,0,0,0,13
2020,El Salvador,SLV,United Kingdom of Great Britain and Northern Ireland,GBR,48,168,167,52,435
2020,Saudi Arabia,SAU,United Kingdom of Great Britain and Northern Ireland,GBR,48,0,5,18,71
2020,Serbia and Kosovo: S/RES/1244 (1999),SRB,United Kingdom of Great Britain and Northern Ireland,GBR,5,0,5,0,10
2020,Senegal,SEN,United Kingdom of Great Britain and Northern Ireland,GBR,5,0,5,13,23
2020,Sierra Leone,SLE,United Kingdom of Great Britain and Northern Ireland,GBR,11,0,25,5,41
2020,Somalia,SOM,United Kingdom of Great Britain and Northern Ireland,GBR,102,10,34,27,173
2020,Viet Nam,VNM,United Kingdom of Great Britain and Northern Ireland,GBR,313,19,148,106,586
2020,Saint Kitts and Nevis,KNA,United Kingdom of Great Britain and Northern Ireland,GBR,0,0,5,0,5
2020,Sudan,SDN,United Kingdom of Great Britain and Northern Ireland,GBR,817,5,55,518,1395
2020,South Sudan,SSD,United Kingdom of Great Britain and Northern Ireland,GBR,5,5,5,10,25
2020,Slovakia,SVK,United Kingdom of Great Britain and Northern Ireland,GBR,0,0,5,0,5
2020,Syrian Arab Rep.,SYR,United Kingdom of Great Britain and Northern Ireland,GBR,552,5,19,191,767
2020,United Rep. of Tanzania,TZA,United Kingdom of Great Britain and Northern Ireland,GBR,10,5,18,0,33
2020,Thailand,THA,United Kingdom of Great Britain and Northern Ireland,GBR,0,0,11,0,11
2020,Tajikistan,TJK,United Kingdom of Great Britain and Northern Ireland,GBR,5,0,0,5,10
2020,Turkmenistan,TKM,United Kingdom of Great Britain and Northern Ireland,GBR,5,0,0,5,10
2020,Trinidad and Tobago,TTO,United Kingdom of Great Britain and Northern Ireland,GBR,10,0,20,5,35
2020,Tunisia,TUN,United Kingdom of Great Britain and Northern Ireland,GBR,0,0,14,0,14
2020,Turkey,TUR,United Kingdom of Great Britain and Northern Ireland,GBR,245,5,131,46,427
2020,United Arab Emirates,ARE,United Kingdom of Great Britain and Northern Ireland,GBR,5,0,0,0,5
2020,Uganda,UGA,United Kingdom of Great Britain and Northern Ireland,GBR,49,0,32,5,86
2020,Ukraine,UKR,United Kingdom of Great Britain and Northern Ireland,GBR,5,13,94,18,130
2020,United States of America,USA,United Kingdom of Great Britain and Northern Ireland,GBR,5,0,13,16,34
2020,Uzbekistan,UZB,United Kingdom of Great Britain and Northern Ireland,GBR,0,0,5,0,5
2020,Vanuatu,VUT,United Kingdom of Great Britain and Northern Ireland,GBR,0,0,11,0,11
2020,Saint Vincent and the Grenadines,VCT,United Kingdom of Great Britain and Northern Ireland,GBR,0,0,10,0,10
2020,Venezuela (Bolivarian Republic of),VEN,United Kingdom of Great Britain and Northern Ireland,GBR,12,0,5,0,17
2020,Yemen,YEM,United Kingdom of Great Britain and Northern Ireland,GBR,65,100,10,128,303
2020,Zambia,ZMB,United Kingdom of Great Britain and Northern Ireland,GBR,5,0,5,0,10
2020,Zimbabwe,ZWE,United Kingdom of Great Britain and Northern Ireland,GBR,16,5,67,10,98
2020,Stateless,XXA,United Kingdom of Great Britain and Northern Ireland,GBR,221,0,44,364,629
2020,Egypt,EGY,Georgia,GEO,5,0,0,15,20
2020,Azerbaijan,AZE,Georgia,GEO,0,0,0,5,5
2020,Bangladesh,BGD,Georgia,GEO,0,0,32,12,44
2020,China,CHN,Georgia,GEO,0,0,0,5,5
2020,Cameroon,CMR,Georgia,GEO,0,0,0,5,5
2020,Palestinian,PSE,Georgia,GEO,0,0,0,5,5
2020,India,IND,Georgia,GEO,0,0,42,43,85
2020,Iran (Islamic Rep. of),IRN,Georgia,GEO,5,0,111,114,230
2020,Iraq,IRQ,Georgia,GEO,0,5,5,33,43
2020,Jordan,JOR,Georgia,GEO,0,0,0,10,10
2020,Lebanon,LBN,Georgia,GEO,0,0,0,5,5
2020,Nigeria,NGA,Georgia,GEO,0,0,11,0,11
2020,Pakistan,PAK,Georgia,GEO,0,0,16,5,21
2020,South Africa,ZAF,Georgia,GEO,0,0,5,0,5
2020,Russian Federation,RUS,Georgia,GEO,0,0,33,10,43
2020,Somalia,SOM,Georgia,GEO,0,0,22,0,22
2020,Syrian Arab Rep.,SYR,Georgia,GEO,0,0,11,15,26
2020,Turkmenistan,TKM,Georgia,GEO,0,0,0,5,5
2020,Turkey,TUR,Georgia,GEO,0,0,38,10,48
2020,Ukraine,UKR,Georgia,GEO,0,0,0,5,5
2020,Uzbekistan,UZB,Georgia,GEO,0,0,0,5,5
2020,Yemen,YEM,Georgia,GEO,0,13,0,5,18
2020,Burundi,BDI,Ghana,GHA,5,0,0,0,5
2020,Benin,BEN,Ghana,GHA,5,0,0,0,5
2020,Central African Rep.,CAF,Ghana,GHA,50,0,0,12,62
2020,Chad,TCD,Ghana,GHA,0,0,0,5,5
2020,Cameroon,CMR,Ghana,GHA,203,0,5,80,288
2020,Congo,COG,Ghana,GHA,0,0,0,5,5
2020,Dem. Rep. of the Congo,COD,Ghana,GHA,14,0,0,0,14
2020,Eritrea,ERI,Ghana,GHA,39,0,0,11,50
2020,Palestinian,PSE,Ghana,GHA,5,0,0,0,5
2020,Cote d'Ivoire,CIV,Ghana,GHA,5,0,13,19,37
2020,Libya,LBY,Ghana,GHA,5,0,0,5,10
2020,Pakistan,PAK,Ghana,GHA,32,0,0,5,37
2020,Rwanda,RWA,Ghana,GHA,0,0,5,0,5
2020,Somalia,SOM,Ghana,GHA,5,0,0,0,5
2020,Sudan,SDN,Ghana,GHA,89,0,0,10,99
2020,Syrian Arab Rep.,SYR,Ghana,GHA,60,0,0,22,82
2020,Togo,TGO,Ghana,GHA,12,0,0,0,12
2020,Turkey,TUR,Ghana,GHA,42,0,0,5,47
2020,Uganda,UGA,Ghana,GHA,5,0,0,0,5
2020,Yemen,YEM,Ghana,GHA,5,0,0,5,10
2020,Afghanistan,AFG,Greece,GRC,4606,6164,5494,3647,19911
2020,Albania,ALB,Greece,GRC,5,0,1383,619,2007
2020,Algeria,DZA,Greece,GRC,13,0,319,150,482
2020,Angola,AGO,Greece,GRC,5,0,19,5,29
2020,Egypt,EGY,Greece,GRC,43,0,617,224,884
2020,Armenia,ARM,Greece,GRC,0,0,44,29,73
2020,Azerbaijan,AZE,Greece,GRC,0,0,0,5,5
2020,Burundi,BDI,Greece,GRC,27,0,5,5,37
2020,Benin,BEN,Greece,GRC,0,0,5,0,5
2020,Bangladesh,BGD,Greece,GRC,19,0,1110,325,1454
2020,Burkina Faso,BFA,Greece,GRC,5,5,12,11,33
2020,Brazil,BRA,Greece,GRC,0,0,5,0,5
2020,Bosnia and Herzegovina,BIH,Greece,GRC,0,0,5,0,5
2020,Central African Rep.,CAF,Greece,GRC,5,0,0,0,5
2020,Chad,TCD,Greece,GRC,0,0,5,0,5
2020,China,CHN,Greece,GRC,21,0,118,63,202
2020,Chile,CHL,Greece,GRC,0,0,0,5,5
2020,Cameroon,CMR,Greece,GRC,226,10,315,137,688
2020,Congo,COG,Greece,GRC,19,5,45,14,83
2020,Dem. Rep. of the Congo,COD,Greece,GRC,562,77,1413,384,2436
2020,Cuba,CUB,Greece,GRC,0,0,10,14,24
2020,Djibouti,DJI,Greece,GRC,10,0,0,0,10
2020,Dominican Rep.,DOM,Greece,GRC,0,0,10,5,15
2020,Eritrea,ERI,Greece,GRC,205,0,24,24,253
2020,Ethiopia,ETH,Greece,GRC,57,0,30,13,100
2020,Gabon,GAB,Greece,GRC,0,0,5,0,5
2020,Gambia,GMB,Greece,GRC,25,0,170,17,212
2020,Palestinian,PSE,Greece,GRC,1958,86,138,128,2310
2020,Georgia,GEO,Greece,GRC,5,0,676,356,1037
2020,Ghana,GHA,Greece,GRC,17,0,116,34,167
2020,Guinea,GIN,Greece,GRC,45,0,74,17,136
2020,Haiti,HTI,Greece,GRC,5,10,12,5,32
2020,Cote d'Ivoire,CIV,Greece,GRC,12,0,17,5,34
2020,India,IND,Greece,GRC,5,0,250,65,320
2020,Indonesia,IDN,Greece,GRC,0,0,50,17,67
2020,Iran (Islamic Rep. of),IRN,Greece,GRC,537,32,644,332,1545
2020,Iraq,IRQ,Greece,GRC,2202,538,1559,997,5296
2020,Jordan,JOR,Greece,GRC,14,0,5,5,24
2020,Kazakhstan,KAZ,Greece,GRC,0,0,0,5,5
2020,Kyrgyzstan,KGZ,Greece,GRC,0,0,5,0,5
2020,Kuwait,KWT,Greece,GRC,32,0,0,41,73
2020,Liberia,LBR,Greece,GRC,0,5,0,0,5
2020,Libya,LBY,Greece,GRC,10,13,17,5,45
2020,Lebanon,LBN,Greece,GRC,10,0,31,16,57
2020,Sri Lanka,LKA,Greece,GRC,5,0,22,13,40
2020,Mauritania,MRT,Greece,GRC,10,0,5,0,15
2020,Rep. of Moldova,MDA,Greece,GRC,0,0,27,11,38
2020,Mexico,MEX,Greece,GRC,0,0,5,5,10
2020,Mali,MLI,Greece,GRC,12,15,28,12,67
2020,Morocco,MAR,Greece,GRC,21,0,214,64,299
2020,Myanmar,MMR,Greece,GRC,25,0,5,5,35
2020,Nepal,NPL,Greece,GRC,5,0,103,15,123
2020,Niger,NER,Greece,GRC,5,0,12,0,17
2020,Nigeria,NGA,Greece,GRC,27,0,73,47,147
2020,Pakistan,PAK,Greece,GRC,99,10,4060,1344,5513
2020,Peru,PER,Greece,GRC,0,0,5,0,5
2020,Philippines,PHL,Greece,GRC,0,0,0,5,5
2020,Russian Federation,RUS,Greece,GRC,0,0,40,5,45
2020,Serbia and Kosovo: S/RES/1244 (1999),SRB,Greece,GRC,0,0,10,0,10
2020,Senegal,SEN,Greece,GRC,5,0,58,18,81
2020,Sierra Leone,SLE,Greece,GRC,64,5,57,12,138
2020,Somalia,SOM,Greece,GRC,1222,885,131,126,2364
2020,Sudan,SDN,Greece,GRC,44,10,35,11,100
2020,South Sudan,SSD,Greece,GRC,12,12,5,0,29
2020,Syrian Arab Rep.,SYR,Greece,GRC,13479,0,1232,4162,18873
2020,United Rep. of Tanzania,TZA,Greece,GRC,0,0,5,5,10
2020,Tajikistan,TJK,Greece,GRC,0,0,5,0,5
2020,Togo,TGO,Greece,GRC,24,0,51,20,95
2020,Tunisia,TUN,Greece,GRC,0,0,25,14,39
2020,Turkey,TUR,Greece,GRC,214,0,1692,711,2617
2020,Uganda,UGA,Greece,GRC,19,0,12,0,31
2020,Ukraine,UKR,Greece,GRC,0,5,61,22,88
2020,United States of America,USA,Greece,GRC,0,0,0,5,5
2020,Venezuela (Bolivarian Republic of),VEN,Greece,GRC,0,5,13,5,23
2020,Western Sahara,ESH,Greece,GRC,0,0,5,0,5
2020,Yemen,YEM,Greece,GRC,237,47,10,10,304
2020,Stateless,XXA,Greece,GRC,140,0,22,132,294
2020,Colombia,COL,Guatemala,GTM,0,0,10,0,10
2020,Cuba,CUB,Guatemala,GTM,0,0,0,5,5
2020,Honduras,HND,Guatemala,GTM,21,0,5,29,55
2020,Mexico,MEX,Guatemala,GTM,0,0,0,5,5
2020,Nicaragua,NIC,Guatemala,GTM,60,0,13,70,143
2020,El Salvador,SLV,Guatemala,GTM,45,0,30,18,93
2020,United States of America,USA,Guatemala,GTM,0,0,5,0,5
2020,Venezuela (Bolivarian Republic of),VEN,Guatemala,GTM,11,0,0,0,11
2020,Eritrea,ERI,Guinea,GIN,5,0,0,0,5
2020,Cote d'Ivoire,CIV,Guinea,GIN,108,0,5,0,113
2020,Liberia,LBR,Guinea,GIN,39,0,10,5,54
2020,Nigeria,NGA,Guinea,GIN,5,0,0,5,10
2020,Sierra Leone,SLE,Guinea,GIN,740,0,309,0,1049
2020,Syrian Arab Rep.,SYR,Guinea,GIN,5,0,0,0,5
2020,Cuba,CUB,Honduras,HND,0,0,0,5,5
2020,Haiti,HTI,Honduras,HND,0,0,0,5,5
2020,Cote d'Ivoire,CIV,Honduras,HND,0,0,0,5,5
2020,Nicaragua,NIC,Honduras,HND,12,0,0,11,23
2020,Afghanistan,AFG,Croatia,HRV,0,0,24,531,555
2020,Algeria,DZA,Croatia,HRV,0,0,15,5,20
2020,Egypt,EGY,Croatia,HRV,0,0,0,13,13
2020,Bangladesh,BGD,Croatia,HRV,0,0,5,5,10
2020,China,CHN,Croatia,HRV,0,0,0,5,5
2020,Dem. Rep. of the Congo,COD,Croatia,HRV,5,0,0,0,5
2020,Cuba,CUB,Croatia,HRV,0,0,5,0,5
2020,Eritrea,ERI,Croatia,HRV,0,0,0,5,5
2020,India,IND,Croatia,HRV,0,0,0,20,20
2020,Iran (Islamic Rep. of),IRN,Croatia,HRV,5,0,14,90,109
2020,Iraq,IRQ,Croatia,HRV,5,0,39,418,462
2020,Kazakhstan,KAZ,Croatia,HRV,0,0,5,0,5
2020,Libya,LBY,Croatia,HRV,0,0,0,5,5
2020,Morocco,MAR,Croatia,HRV,0,0,38,10,48
2020,Nepal,NPL,Croatia,HRV,0,0,0,10,10
2020,Nigeria,NGA,Croatia,HRV,0,0,5,0,5
2020,Pakistan,PAK,Croatia,HRV,0,0,5,18,23
2020,Sierra Leone,SLE,Croatia,HRV,0,0,5,0,5
2020,Viet Nam,VNM,Croatia,HRV,0,0,5,0,5
2020,Syrian Arab Rep.,SYR,Croatia,HRV,13,0,0,34,47
2020,Tajikistan,TJK,Croatia,HRV,0,0,0,5,5
2020,Tunisia,TUN,Croatia,HRV,0,0,12,0,12
2020,Turkey,TUR,Croatia,HRV,5,0,23,42,70
2020,Yemen,YEM,Croatia,HRV,0,0,0,5,5
2020,Stateless,XXA,Croatia,HRV,0,0,0,5,5
2020,Afghanistan,AFG,Hungary,HUN,5,26,155,24,210
2020,Burundi,BDI,Hungary,HUN,0,0,5,0,5
2020,Bangladesh,BGD,Hungary,HUN,5,0,0,0,5
2020,Palestinian,PSE,Hungary,HUN,5,0,0,0,5
2020,Iran (Islamic Rep. of),IRN,Hungary,HUN,14,0,0,0,14
2020,Iraq,IRQ,Hungary,HUN,12,5,145,5,167
2020,Nigeria,NGA,Hungary,HUN,0,0,5,0,5
2020,Pakistan,PAK,Hungary,HUN,42,0,0,5,47
2020,Russian Federation,RUS,Hungary,HUN,0,0,5,0,5
2020,Syrian Arab Rep.,SYR,Hungary,HUN,0,0,10,10,20
2020,Tunisia,TUN,Hungary,HUN,0,0,5,0,5
2020,Yemen,YEM,Hungary,HUN,0,0,5,0,5
2020,Afghanistan,AFG,Iceland,ISL,22,13,0,11,46
2020,Albania,ALB,Iceland,ISL,0,0,10,5,15
2020,Egypt,EGY,Iceland,ISL,0,5,0,0,5
2020,Azerbaijan,AZE,Iceland,ISL,0,0,5,0,5
2020,China,CHN,Iceland,ISL,5,0,0,0,5
2020,Dem. Rep. of the Congo,COD,Iceland,ISL,5,0,0,0,5
2020,Colombia,COL,Iceland,ISL,0,0,12,0,12
2020,Gambia,GMB,Iceland,ISL,0,0,5,0,5
2020,Palestinian,PSE,Iceland,ISL,5,34,0,31,70
2020,Georgia,GEO,Iceland,ISL,0,0,0,5,5
2020,Ghana,GHA,Iceland,ISL,0,0,11,0,11
2020,Honduras,HND,Iceland,ISL,5,5,0,0,10
2020,Iran (Islamic Rep. of),IRN,Iceland,ISL,30,0,0,5,35
2020,Iraq,IRQ,Iceland,ISL,18,83,5,63,169
2020,Kazakhstan,KAZ,Iceland,ISL,0,5,0,0,5
2020,Rep. of Moldova,MDA,Iceland,ISL,0,0,0,5,5
2020,Mozambique,MOZ,Iceland,ISL,0,5,0,0,5
2020,Nigeria,NGA,Iceland,ISL,5,41,36,14,96
2020,Pakistan,PAK,Iceland,ISL,0,0,12,0,12
2020,Russian Federation,RUS,Iceland,ISL,0,0,5,0,5
2020,Somalia,SOM,Iceland,ISL,22,16,10,10,58
2020,Syrian Arab Rep.,SYR,Iceland,ISL,0,58,0,15,73
2020,Tajikistan,TJK,Iceland,ISL,0,5,0,0,5
2020,Tunisia,TUN,Iceland,ISL,0,5,0,0,5
2020,Ukraine,UKR,Iceland,ISL,0,0,5,0,5
2020,United States of America,USA,Iceland,ISL,0,0,0,10,10
2020,Venezuela (Bolivarian Republic of),VEN,Iceland,ISL,5,128,0,0,133
2020,Yemen,YEM,Iceland,ISL,5,0,0,5,10
2020,Stateless,XXA,Iceland,ISL,0,5,0,0,5
2020,Afghanistan,AFG,Ireland,IRL,24,11,0,12,47
2020,Albania,ALB,Ireland,IRL,0,5,267,274,546
2020,Algeria,DZA,Ireland,IRL,5,0,60,5,70
2020,Angola,AGO,Ireland,IRL,0,0,5,0,5
2020,Egypt,EGY,Ireland,IRL,12,0,5,0,17
2020,Bangladesh,BGD,Ireland,IRL,10,0,54,5,69
2020,Bolivia (Plurinational State of),BOL,Ireland,IRL,11,0,0,5,16
2020,Botswana,BWA,Ireland,IRL,0,0,10,0,10
2020,Brazil,BRA,Ireland,IRL,5,0,45,13,63
2020,Belize,BLZ,Ireland,IRL,0,0,5,0,5
2020,China,CHN,Ireland,IRL,5,0,14,26,45
2020,Cameroon,CMR,Ireland,IRL,13,5,5,0,23
2020,Dem. Rep. of the Congo,COD,Ireland,IRL,14,5,37,0,56
2020,Dominican Rep.,DOM,Ireland,IRL,0,0,5,0,5
2020,Eritrea,ERI,Ireland,IRL,11,0,0,5,16
2020,Ethiopia,ETH,Ireland,IRL,5,0,5,0,10
2020,Gambia,GMB,Ireland,IRL,0,0,5,0,5
2020,Palestinian,PSE,Ireland,IRL,25,0,5,5,35
2020,Georgia,GEO,Ireland,IRL,14,5,223,40,282
2020,Ghana,GHA,Ireland,IRL,5,0,14,0,19
2020,Guatemala,GTM,Ireland,IRL,0,0,5,0,5
2020,India,IND,Ireland,IRL,0,0,32,5,37
2020,Iran (Islamic Rep. of),IRN,Ireland,IRL,13,0,0,23,36
2020,Iraq,IRQ,Ireland,IRL,12,5,5,13,35
2020,Jordan,JOR,Ireland,IRL,0,0,5,0,5
2020,Kenya,KEN,Ireland,IRL,5,0,0,0,5
2020,Dem. People's Rep. of Korea,PRK,Ireland,IRL,5,0,0,0,5
2020,Kuwait,KWT,Ireland,IRL,0,0,5,11,16
2020,Libya,LBY,Ireland,IRL,11,0,0,0,11
2020,Rep. of Moldova,MDA,Ireland,IRL,0,0,5,0,5
2020,Mexico,MEX,Ireland,IRL,5,0,0,0,5
2020,Malawi,MWI,Ireland,IRL,10,0,32,0,42
2020,Mongolia,MNG,Ireland,IRL,0,0,5,0,5
2020,Morocco,MAR,Ireland,IRL,0,0,16,10,26
2020,Mauritius,MUS,Ireland,IRL,0,0,5,5,10
2020,Myanmar,MMR,Ireland,IRL,0,0,5,0,5
2020,Nicaragua,NIC,Ireland,IRL,5,0,0,0,5
2020,Nigeria,NGA,Ireland,IRL,15,0,137,25,177
2020,Pakistan,PAK,Ireland,IRL,10,5,240,26,281
2020,South Africa,ZAF,Ireland,IRL,12,5,143,23,183
2020,El Salvador,SLV,Ireland,IRL,11,0,0,0,11
2020,Serbia and Kosovo: S/RES/1244 (1999),SRB,Ireland,IRL,5,0,0,5,10
2020,Sierra Leone,SLE,Ireland,IRL,5,0,11,0,16
2020,Somalia,SOM,Ireland,IRL,36,15,0,15,66
2020,Viet Nam,VNM,Ireland,IRL,0,0,0,14,14
2020,Sudan,SDN,Ireland,IRL,17,0,0,5,22
2020,Eswatini,SWZ,Ireland,IRL,5,0,5,0,10
2020,Syrian Arab Rep.,SYR,Ireland,IRL,24,5,0,26,55
2020,United Rep. of Tanzania,TZA,Ireland,IRL,0,0,5,0,5
2020,Togo,TGO,Ireland,IRL,0,0,5,0,5
2020,Turkey,TUR,Ireland,IRL,5,0,0,0,5
2020,Uganda,UGA,Ireland,IRL,0,0,5,0,5
2020,United States of America,USA,Ireland,IRL,0,0,5,5,10
2020,Venezuela (Bolivarian Republic of),VEN,Ireland,IRL,35,5,10,0,50
2020,Yemen,YEM,Ireland,IRL,5,0,0,0,5
2020,Zambia,ZMB,Ireland,IRL,0,0,5,0,5
2020,Zimbabwe,ZWE,Ireland,IRL,66,0,167,0,233
2020,Afghanistan,AFG,Italy,ITA,107,952,72,27,1158
2020,Albania,ALB,Italy,ITA,65,53,816,0,934
2020,Algeria,DZA,Italy,ITA,11,5,105,0,121
2020,Angola,AGO,Italy,ITA,0,0,10,0,10
2020,Egypt,EGY,Italy,ITA,33,29,524,0,586
2020,Argentina,ARG,Italy,ITA,0,0,17,0,17
2020,Armenia,ARM,Italy,ITA,0,28,31,0,59
2020,Azerbaijan,AZE,Italy,ITA,17,11,16,0,44
2020,Benin,BEN,Italy,ITA,0,5,41,0,46
2020,Bangladesh,BGD,Italy,ITA,70,350,2490,5,2915
2020,Burkina Faso,BFA,Italy,ITA,11,77,89,0,177
2020,Belarus,BLR,Italy,ITA,0,5,13,0,18
2020,Brazil,BRA,Italy,ITA,46,5,122,0,173
2020,Bosnia and Herzegovina,BIH,Italy,ITA,12,5,59,0,76
2020,Central African Rep.,CAF,Italy,ITA,0,5,5,0,10
2020,Chad,TCD,Italy,ITA,0,5,16,0,21
2020,China,CHN,Italy,ITA,48,5,352,0,405
2020,Chile,CHL,Italy,ITA,0,0,14,0,14
2020,Cameroon,CMR,Italy,ITA,56,49,272,0,377
2020,Congo,COG,Italy,ITA,5,12,5,0,22
2020,Dem. Rep. of the Congo,COD,Italy,ITA,14,20,31,0,65
2020,Comoros,COM,Italy,ITA,0,0,5,0,5
2020,Colombia,COL,Italy,ITA,71,86,438,0,595
2020,Costa Rica,CRI,Italy,ITA,0,0,5,0,5
2020,Cuba,CUB,Italy,ITA,12,5,67,0,84
2020,Dominican Rep.,DOM,Italy,ITA,0,0,13,0,13
2020,Ecuador,ECU,Italy,ITA,5,0,17,0,22
2020,Eritrea,ERI,Italy,ITA,74,46,78,0,198
2020,Ethiopia,ETH,Italy,ITA,10,16,109,0,135
2020,Gabon,GAB,Italy,ITA,0,0,5,0,5
2020,Gambia,GMB,Italy,ITA,47,106,926,0,1079
2020,Palestinian,PSE,Italy,ITA,28,5,10,0,43
2020,Georgia,GEO,Italy,ITA,62,56,558,0,676
2020,Ghana,GHA,Italy,ITA,37,84,752,0,873
2020,Guinea-Bissau,GNB,Italy,ITA,5,12,122,0,139
2020,Guatemala,GTM,Italy,ITA,5,5,10,0,20
2020,Guinea,GIN,Italy,ITA,43,63,700,0,806
2020,Honduras,HND,Italy,ITA,67,72,82,0,221
2020,Cote d'Ivoire,CIV,Italy,ITA,142,156,1025,5,1328
2020,India,IND,Italy,ITA,12,10,668,0,690
2020,Iran (Islamic Rep. of),IRN,Italy,ITA,89,15,99,0,203
2020,Iraq,IRQ,Italy,ITA,97,239,190,5,531
2020,Jamaica,JAM,Italy,ITA,0,0,5,0,5
2020,Jordan,JOR,Italy,ITA,5,0,0,0,5
2020,Kazakhstan,KAZ,Italy,ITA,0,0,5,0,5
2020,Kenya,KEN,Italy,ITA,13,0,0,0,13
2020,Kyrgyzstan,KGZ,Italy,ITA,5,0,58,0,63
2020,Liberia,LBR,Italy,ITA,0,21,39,5,65
2020,Libya,LBY,Italy,ITA,33,101,34,5,173
2020,Lebanon,LBN,Italy,ITA,5,5,10,0,20
2020,Liechtenstein,LIE,Italy,ITA,0,0,5,0,5
2020,Sri Lanka,LKA,Italy,ITA,13,34,284,0,331
2020,Mauritania,MRT,Italy,ITA,5,5,5,0,15
2020,North Macedonia,MKD,Italy,ITA,19,5,16,0,40
2020,Rep. of Moldova,MDA,Italy,ITA,5,5,32,0,42
2020,Mexico,MEX,Italy,ITA,0,0,14,0,14
2020,Mali,MLI,Italy,ITA,53,343,590,5,991
2020,Mongolia,MNG,Italy,ITA,0,5,0,0,5
2020,Morocco,MAR,Italy,ITA,89,71,969,0,1129
2020,Montenegro,MNE,Italy,ITA,0,0,5,0,5
2020,Mauritius,MUS,Italy,ITA,0,0,5,0,5
2020,Nepal,NPL,Italy,ITA,5,5,34,0,44
2020,Niger,NER,Italy,ITA,10,16,32,0,58
2020,Nicaragua,NIC,Italy,ITA,16,5,5,0,26
2020,Nigeria,NGA,Italy,ITA,1317,614,4573,11,6515
2020,Norway,NOR,Italy,ITA,0,0,5,0,5
2020,Pakistan,PAK,Italy,ITA,298,772,4996,36,6102
2020,Panama,PAN,Italy,ITA,0,5,0,0,5
2020,Paraguay,PRY,Italy,ITA,0,0,16,0,16
2020,Peru,PER,Italy,ITA,106,59,1131,0,1296
2020,Philippines,PHL,Italy,ITA,5,5,65,0,75
2020,Russian Federation,RUS,Italy,ITA,21,10,57,0,88
2020,Rwanda,RWA,Italy,ITA,5,0,0,0,5
2020,El Salvador,SLV,Italy,ITA,454,626,703,0,1783
2020,Serbia and Kosovo: S/RES/1244 (1999),SRB,Italy,ITA,23,86,507,0,616
2020,Senegal,SEN,Italy,ITA,68,121,1487,0,1676
2020,Seychelles,SYC,Italy,ITA,0,0,5,0,5
2020,Sierra Leone,SLE,Italy,ITA,10,12,100,0,122
2020,Somalia,SOM,Italy,ITA,130,241,93,10,474
2020,Viet Nam,VNM,Italy,ITA,0,0,5,0,5
2020,Sudan,SDN,Italy,ITA,31,21,90,5,147
2020,South Sudan,SSD,Italy,ITA,0,5,0,0,5
2020,Syrian Arab Rep.,SYR,Italy,ITA,64,24,33,0,121
2020,United Rep. of Tanzania,TZA,Italy,ITA,5,0,0,0,5
2020,Tajikistan,TJK,Italy,ITA,5,0,0,0,5
2020,Togo,TGO,Italy,ITA,10,37,93,0,140
2020,Tunisia,TUN,Italy,ITA,34,11,837,0,882
2020,Turkey,TUR,Italy,ITA,157,55,185,0,397
2020,Uganda,UGA,Italy,ITA,0,0,5,0,5
2020,Ukraine,UKR,Italy,ITA,71,279,870,0,1220
2020,Uruguay,URY,Italy,ITA,0,0,12,0,12
2020,United States of America,USA,Italy,ITA,0,0,5,0,5
2020,Venezuela (Bolivarian Republic of),VEN,Italy,ITA,167,716,75,0,958
2020,Yemen,YEM,Italy,ITA,5,5,0,0,10
2020,Zimbabwe,ZWE,Italy,ITA,5,0,0,0,5
2020,Stateless,XXA,Italy,ITA,0,5,0,0,5
2020,Afghanistan,AFG,Japan,JPN,5,0,0,0,0
2020,China,CHN,Japan,JPN,11,0,0,0,0
2020,Dem. Rep. of the Congo,COD,Japan,JPN,5,0,0,0,0
2020,Guinea,GIN,Japan,JPN,5,0,0,0,0
2020,Rwanda,RWA,Japan,JPN,5,0,0,0,0
2020,Syrian Arab Rep.,SYR,Japan,JPN,5,0,0,0,0
2020,Yemen,YEM,Japan,JPN,11,0,0,0,0
2020,Afghanistan,AFG,Kazakhstan,KAZ,0,0,66,12,78
2020,China,CHN,Kazakhstan,KAZ,5,0,0,0,5
2020,Egypt,EGY,Kenya,KEN,0,0,0,10,10
2020,Burundi,BDI,Kenya,KEN,887,0,0,215,1102
2020,Congo,COG,Kenya,KEN,5,0,0,5,10
2020,Dem. Rep. of the Congo,COD,Kenya,KEN,1158,0,0,62,1220
2020,Eritrea,ERI,Kenya,KEN,18,0,0,0,18
2020,Ethiopia,ETH,Kenya,KEN,555,0,0,44,599
2020,Nigeria,NGA,Kenya,KEN,0,0,0,5,5
2020,Rwanda,RWA,Kenya,KEN,12,0,0,10,22
2020,Somalia,SOM,Kenya,KEN,12,0,0,75,87
2020,Sudan,SDN,Kenya,KEN,381,0,0,111,492
2020,South Sudan,SSD,Kenya,KEN,0,0,0,57,57
2020,United Rep. of Tanzania,TZA,Kenya,KEN,11,0,0,0,11
2020,Turkey,TUR,Kenya,KEN,67,0,0,0,67
2020,Uganda,UGA,Kenya,KEN,0,0,0,38,38
2020,Yemen,YEM,Kenya,KEN,24,0,0,0,24
2020,Afghanistan,AFG,Kyrgyzstan,KGZ,5,0,89,15,109
2020,Palestinian,PSE,Kyrgyzstan,KGZ,0,0,5,0,5
2020,Iraq,IRQ,Kyrgyzstan,KGZ,0,0,0,5,5
2020,Syrian Arab Rep.,SYR,Kyrgyzstan,KGZ,5,0,0,0,5
2020,Turkey,TUR,Kyrgyzstan,KGZ,0,0,0,10,10
2020,Uzbekistan,UZB,Kyrgyzstan,KGZ,0,0,0,5,5
2020,Dem. Rep. of the Congo,COD,Liberia,LBR,5,0,0,0,5
2020,South Sudan,SSD,Liberia,LBR,5,0,0,0,5
2020,Turkey,TUR,Liberia,LBR,15,0,0,0,15
2020,Dem. Rep. of the Congo,COD,Lesotho,LSO,45,0,0,0,45
2020,Eritrea,ERI,Lesotho,LSO,13,0,0,0,13
2020,Ethiopia,ETH,Lesotho,LSO,10,0,0,0,10
2020,Albania,ALB,Liechtenstein,LIE,0,0,0,5,5
2020,China,CHN,Liechtenstein,LIE,11,0,0,0,11
2020,Serbia and Kosovo: S/RES/1244 (1999),SRB,Liechtenstein,LIE,0,0,5,0,5
2020,Somalia,SOM,Liechtenstein,LIE,0,0,0,5,5
2020,Ukraine,UKR,Liechtenstein,LIE,0,0,0,5,5
2020,Afghanistan,AFG,Lithuania,LTU,0,0,5,0,5
2020,Armenia,ARM,Lithuania,LTU,0,0,0,10,10
2020,Belarus,BLR,Lithuania,LTU,0,0,10,19,29
2020,India,IND,Lithuania,LTU,0,0,0,5,5
2020,Iran (Islamic Rep. of),IRN,Lithuania,LTU,5,0,0,0,5
2020,Iraq,IRQ,Lithuania,LTU,0,0,5,5,10
2020,Kyrgyzstan,KGZ,Lithuania,LTU,0,0,5,0,5
2020,Rep. of Moldova,MDA,Lithuania,LTU,0,0,5,0,5
2020,Russian Federation,RUS,Lithuania,LTU,24,0,102,156,282
2020,Syrian Arab Rep.,SYR,Lithuania,LTU,10,0,0,0,10
2020,Tajikistan,TJK,Lithuania,LTU,12,0,114,71,197
2020,Turkey,TUR,Lithuania,LTU,17,0,5,0,22
2020,Ukraine,UKR,Lithuania,LTU,0,0,5,0,5
2020,Uzbekistan,UZB,Lithuania,LTU,5,0,0,0,5
2020,Afghanistan,AFG,Luxembourg,LUX,41,5,72,0,118
2020,Albania,ALB,Luxembourg,LUX,0,26,0,0,26
2020,Algeria,DZA,Luxembourg,LUX,0,5,5,10,20
2020,Egypt,EGY,Luxembourg,LUX,0,5,0,0,5
2020,Benin,BEN,Luxembourg,LUX,0,0,5,0,5
2020,Belarus,BLR,Luxembourg,LUX,0,0,13,0,13
2020,Bosnia and Herzegovina,BIH,Luxembourg,LUX,0,5,0,0,5
2020,Chad,TCD,Luxembourg,LUX,0,0,5,0,5
2020,Cameroon,CMR,Luxembourg,LUX,5,0,21,0,26
2020,Dem. Rep. of the Congo,COD,Luxembourg,LUX,0,5,0,5,10
2020,Colombia,COL,Luxembourg,LUX,0,0,5,0,5
2020,Eritrea,ERI,Luxembourg,LUX,421,0,0,5,426
2020,Ethiopia,ETH,Luxembourg,LUX,13,0,5,0,18
2020,Georgia,GEO,Luxembourg,LUX,0,0,0,10,10
2020,Guinea,GIN,Luxembourg,LUX,0,13,5,5,23
2020,Cote d'Ivoire,CIV,Luxembourg,LUX,0,5,5,0,10
2020,Iran (Islamic Rep. of),IRN,Luxembourg,LUX,16,5,12,0,33
2020,Iraq,IRQ,Luxembourg,LUX,14,0,42,5,61
2020,Libya,LBY,Luxembourg,LUX,0,0,15,0,15
2020,Mauritania,MRT,Luxembourg,LUX,0,0,0,5,5
2020,Morocco,MAR,Luxembourg,LUX,0,5,0,14,19
2020,Montenegro,MNE,Luxembourg,LUX,0,5,0,0,5
2020,Nigeria,NGA,Luxembourg,LUX,0,0,11,5,16
2020,Rwanda,RWA,Luxembourg,LUX,0,0,5,0,5
2020,Senegal,SEN,Luxembourg,LUX,0,0,10,0,10
2020,Somalia,SOM,Luxembourg,LUX,5,0,11,0,16
2020,Sudan,SDN,Luxembourg,LUX,21,0,12,5,38
2020,Syrian Arab Rep.,SYR,Luxembourg,LUX,183,0,0,0,183
2020,Togo,TGO,Luxembourg,LUX,0,5,0,0,5
2020,Tunisia,TUN,Luxembourg,LUX,0,0,0,14,14
2020,Turkey,TUR,Luxembourg,LUX,19,0,13,0,32
2020,Ukraine,UKR,Luxembourg,LUX,0,0,15,0,15
2020,Venezuela (Bolivarian Republic of),VEN,Luxembourg,LUX,0,13,10,0,23
2020,Yemen,YEM,Luxembourg,LUX,5,0,0,0,5
2020,Zambia,ZMB,Luxembourg,LUX,0,0,5,0,5
2020,Stateless,XXA,Luxembourg,LUX,0,5,0,0,5
2020,Afghanistan,AFG,Latvia,LVA,0,0,0,5,5
2020,Egypt,EGY,Latvia,LVA,0,0,0,5,5
2020,Azerbaijan,AZE,Latvia,LVA,0,0,21,0,21
2020,Bangladesh,BGD,Latvia,LVA,0,0,0,5,5
2020,Belarus,BLR,Latvia,LVA,0,11,0,0,11
2020,Colombia,COL,Latvia,LVA,0,0,5,0,5
2020,Georgia,GEO,Latvia,LVA,0,0,5,0,5
2020,India,IND,Latvia,LVA,0,0,0,5,5
2020,Iran (Islamic Rep. of),IRN,Latvia,LVA,0,0,0,5,5
2020,Iraq,IRQ,Latvia,LVA,5,0,0,0,5
2020,Russian Federation,RUS,Latvia,LVA,0,0,14,0,14
2020,Syrian Arab Rep.,SYR,Latvia,LVA,0,5,0,5,10
2020,Tajikistan,TJK,Latvia,LVA,0,0,5,0,5
2020,Turkey,TUR,Latvia,LVA,5,0,0,0,5
2020,Uzbekistan,UZB,Latvia,LVA,0,0,5,0,5
2020,Armenia,ARM,Rep. of Moldova,MDA,0,0,5,0,5
2020,Iraq,IRQ,Rep. of Moldova,MDA,0,0,0,5,5
2020,Kyrgyzstan,KGZ,Rep. of Moldova,MDA,0,0,5,0,5
2020,Libya,LBY,Rep. of Moldova,MDA,0,5,0,0,5
2020,Romania,ROU,Rep. of Moldova,MDA,0,0,0,5,5
2020,Russian Federation,RUS,Rep. of Moldova,MDA,0,0,5,0,5
2020,Syrian Arab Rep.,SYR,Rep. of Moldova,MDA,0,5,0,0,5
2020,Tajikistan,TJK,Rep. of Moldova,MDA,0,0,5,0,5
2020,Turkey,TUR,Rep. of Moldova,MDA,35,0,12,10,57
2020,Ukraine,UKR,Rep. of Moldova,MDA,0,0,5,0,5
2020,Uzbekistan,UZB,Rep. of Moldova,MDA,5,0,5,0,10
2020,Angola,AGO,Mexico,MEX,5,0,0,13,18
2020,Argentina,ARG,Mexico,MEX,0,0,11,0,11
2020,Benin,BEN,Mexico,MEX,0,0,0,5,5
2020,Burkina Faso,BFA,Mexico,MEX,0,0,0,11,11
2020,Brazil,BRA,Mexico,MEX,14,44,56,44,158
2020,Belize,BLZ,Mexico,MEX,5,0,0,0,5
2020,Chile,CHL,Mexico,MEX,73,116,118,67,374
2020,Cameroon,CMR,Mexico,MEX,22,0,0,130,152
2020,Congo,COG,Mexico,MEX,0,0,0,5,5
2020,Dem. Rep. of the Congo,COD,Mexico,MEX,5,0,0,57,62
2020,Colombia,COL,Mexico,MEX,97,0,106,27,230
2020,Costa Rica,CRI,Mexico,MEX,0,0,11,0,11
2020,Cuba,CUB,Mexico,MEX,1497,133,1738,766,4134
2020,Dominican Rep.,DOM,Mexico,MEX,0,0,5,11,16
2020,Ecuador,ECU,Mexico,MEX,11,0,17,5,33
2020,Eritrea,ERI,Mexico,MEX,0,0,0,22,22
2020,Ethiopia,ETH,Mexico,MEX,0,0,0,5,5
2020,Gambia,GMB,Mexico,MEX,0,0,0,5,5
2020,Ghana,GHA,Mexico,MEX,5,5,0,25,35
2020,Guatemala,GTM,Mexico,MEX,669,22,555,272,1518
2020,Guinea,GIN,Mexico,MEX,0,0,0,11,11
2020,Guyana,GUY,Mexico,MEX,0,0,5,0,5
2020,Haiti,HTI,Mexico,MEX,475,647,1139,561,2822
2020,Honduras,HND,Mexico,MEX,6453,5,1064,1583,9105
2020,India,IND,Mexico,MEX,0,0,5,0,5
2020,Iran (Islamic Rep. of),IRN,Mexico,MEX,0,0,0,5,5
2020,Kyrgyzstan,KGZ,Mexico,MEX,0,5,0,0,5
2020,Sri Lanka,LKA,Mexico,MEX,0,0,0,5,5
2020,Nicaragua,NIC,Mexico,MEX,266,90,179,112,647
2020,Nigeria,NGA,Mexico,MEX,10,0,0,0,10
2020,Panama,PAN,Mexico,MEX,5,14,0,0,19
2020,Peru,PER,Mexico,MEX,14,0,0,0,14
2020,Portugal,PRT,Mexico,MEX,5,0,0,0,5
2020,Russian Federation,RUS,Mexico,MEX,5,0,0,0,5
2020,El Salvador,SLV,Mexico,MEX,1993,0,384,446,2823
2020,Sierra Leone,SLE,Mexico,MEX,0,0,0,5,5
2020,Spain,ESP,Mexico,MEX,0,0,5,0,5
2020,Togo,TGO,Mexico,MEX,5,0,0,0,5
2020,United States of America,USA,Mexico,MEX,12,0,0,0,12
2020,Venezuela (Bolivarian Republic of),VEN,Mexico,MEX,4232,12,81,219,4544
2020,Yemen,YEM,Mexico,MEX,0,0,0,5,5
2020,Burkina Faso,BFA,Mali,MLI,72,0,0,0,72
2020,Central African Rep.,CAF,Mali,MLI,5,0,0,0,5
2020,Burundi,BDI,Malawi,MWI,46,0,0,11,57
2020,Dem. Rep. of the Congo,COD,Malawi,MWI,238,0,0,57,295
2020,Rwanda,RWA,Malawi,MWI,68,0,0,12,80
2020,Somalia,SOM,Malawi,MWI,5,0,0,0,5
2020,Uganda,UGA,Malawi,MWI,5,0,0,0,5
2020,Algeria,DZA,Malta,MLT,0,0,0,11,11
2020,Egypt,EGY,Malta,MLT,0,0,10,11,21
2020,Bangladesh,BGD,Malta,MLT,0,0,124,51,175
2020,Burkina Faso,BFA,Malta,MLT,0,0,0,5,5
2020,Chad,TCD,Malta,MLT,0,0,5,11,16
2020,Cameroon,CMR,Malta,MLT,0,0,5,5,10
2020,Colombia,COL,Malta,MLT,0,0,0,11,11
2020,Eritrea,ERI,Malta,MLT,0,5,0,65,70
2020,Ethiopia,ETH,Malta,MLT,0,0,0,14,14
2020,Gambia,GMB,Malta,MLT,0,0,5,100,105
2020,Ghana,GHA,Malta,MLT,0,0,38,34,72
2020,Guinea-Bissau,GNB,Malta,MLT,0,0,0,5,5
2020,Guinea,GIN,Malta,MLT,0,0,5,40,45
2020,Cote d'Ivoire,CIV,Malta,MLT,0,0,14,74,88
2020,Iraq,IRQ,Malta,MLT,0,0,0,5,5
2020,Libya,LBY,Malta,MLT,0,71,0,50,121
2020,Sri Lanka,LKA,Malta,MLT,0,0,0,5,5
2020,Mali,MLI,Malta,MLT,0,0,10,36,46
2020,Morocco,MAR,Malta,MLT,0,0,72,31,103
2020,Niger,NER,Malta,MLT,0,0,5,0,5
2020,Nigeria,NGA,Malta,MLT,0,0,24,102,126
2020,Pakistan,PAK,Malta,MLT,0,0,5,14,19
2020,Peru,PER,Malta,MLT,0,0,0,5,5
2020,Russian Federation,RUS,Malta,MLT,0,0,0,5,5
2020,Senegal,SEN,Malta,MLT,0,0,5,36,41
2020,Sierra Leone,SLE,Malta,MLT,0,0,0,5,5
2020,Somalia,SOM,Malta,MLT,0,5,0,134,139
2020,Sudan,SDN,Malta,MLT,18,0,19,210,247
2020,South Sudan,SSD,Malta,MLT,0,0,0,5,5
2020,Syrian Arab Rep.,SYR,Malta,MLT,29,92,0,87,208
2020,Togo,TGO,Malta,MLT,0,0,5,0,5
2020,Tunisia,TUN,Malta,MLT,0,0,5,10,15
2020,Turkey,TUR,Malta,MLT,5,0,0,0,5
2020,Ukraine,UKR,Malta,MLT,0,0,10,11,21
2020,Venezuela (Bolivarian Republic of),VEN,Malta,MLT,0,0,12,12,24
2020,Yemen,YEM,Malta,MLT,5,0,0,0,5
2020,Burundi,BDI,Namibia,NAM,5,0,0,0,5
2020,Central African Rep.,CAF,Namibia,NAM,0,0,0,10,10
2020,Dem. Rep. of the Congo,COD,Namibia,NAM,174,0,0,82,256
2020,Afghanistan,AFG,Netherlands,NLD,120,99,71,53,343
2020,Albania,ALB,Netherlands,NLD,0,0,48,35,83
2020,Algeria,DZA,Netherlands,NLD,0,0,250,163,413
2020,Angola,AGO,Netherlands,NLD,0,0,5,0,5
2020,Egypt,EGY,Netherlands,NLD,34,5,35,11,85
2020,Argentina,ARG,Netherlands,NLD,5,0,0,0,5
2020,Armenia,ARM,Netherlands,NLD,5,0,22,14,41
2020,Azerbaijan,AZE,Netherlands,NLD,5,5,24,37,71
2020,Burundi,BDI,Netherlands,NLD,5,0,0,0,5
2020,Benin,BEN,Netherlands,NLD,0,0,5,0,5
2020,Bangladesh,BGD,Netherlands,NLD,0,0,10,0,10
2020,Belarus,BLR,Netherlands,NLD,0,0,5,15,20
2020,Brazil,BRA,Netherlands,NLD,0,0,14,5,19
2020,Bosnia and Herzegovina,BIH,Netherlands,NLD,0,0,16,0,16
2020,Chad,TCD,Netherlands,NLD,0,0,5,0,5
2020,China,CHN,Netherlands,NLD,69,14,12,5,100
2020,Cameroon,CMR,Netherlands,NLD,5,0,5,10,20
2020,Congo,COG,Netherlands,NLD,0,0,0,13,13
2020,Dem. Rep. of the Congo,COD,Netherlands,NLD,0,0,5,0,5
2020,Colombia,COL,Netherlands,NLD,26,5,35,25,91
2020,Cuba,CUB,Netherlands,NLD,0,0,0,5,5
2020,Dominican Rep.,DOM,Netherlands,NLD,0,0,5,0,5
2020,Eritrea,ERI,Netherlands,NLD,255,26,104,26,411
2020,Ethiopia,ETH,Netherlands,NLD,0,0,11,5,16
2020,Gambia,GMB,Netherlands,NLD,5,0,30,5,40
2020,Palestinian,PSE,Netherlands,NLD,5,0,0,0,5
2020,Georgia,GEO,Netherlands,NLD,5,0,130,40,175
2020,Ghana,GHA,Netherlands,NLD,0,0,13,5,18
2020,Guinea-Bissau,GNB,Netherlands,NLD,0,0,0,5,5
2020,Guinea,GIN,Netherlands,NLD,18,0,37,10,65
2020,Honduras,HND,Netherlands,NLD,0,0,5,0,5
2020,Cote d'Ivoire,CIV,Netherlands,NLD,0,0,0,13,13
2020,India,IND,Netherlands,NLD,0,0,14,0,14
2020,Iran (Islamic Rep. of),IRN,Netherlands,NLD,262,97,307,81,747
2020,Iraq,IRQ,Netherlands,NLD,179,14,140,54,387
2020,Jamaica,JAM,Netherlands,NLD,5,0,5,0,10
2020,Jordan,JOR,Netherlands,NLD,10,5,24,10,49
2020,Kazakhstan,KAZ,Netherlands,NLD,5,0,5,0,10
2020,Kenya,KEN,Netherlands,NLD,0,0,5,5,10
2020,Kyrgyzstan,KGZ,Netherlands,NLD,5,0,0,0,5
2020,Kuwait,KWT,Netherlands,NLD,0,0,0,5,5
2020,Liberia,LBR,Netherlands,NLD,0,0,5,5,10
2020,Libya,LBY,Netherlands,NLD,22,5,31,42,100
2020,Lebanon,LBN,Netherlands,NLD,11,5,10,10,36
2020,Sri Lanka,LKA,Netherlands,NLD,0,0,13,5,18
2020,Mauritania,MRT,Netherlands,NLD,0,0,0,5,5
2020,North Macedonia,MKD,Netherlands,NLD,0,0,75,5,80
2020,Rep. of Moldova,MDA,Netherlands,NLD,0,0,38,39,77
2020,Mexico,MEX,Netherlands,NLD,0,0,5,0,5
2020,Mali,MLI,Netherlands,NLD,0,0,5,0,5
2020,Malaysia,MYS,Netherlands,NLD,0,0,5,0,5
2020,Mongolia,MNG,Netherlands,NLD,0,0,5,0,5
2020,Morocco,MAR,Netherlands,NLD,5,5,228,222,460
2020,Montenegro,MNE,Netherlands,NLD,0,0,5,0,5
2020,Myanmar,MMR,Netherlands,NLD,0,0,11,0,11
2020,Nepal,NPL,Netherlands,NLD,0,0,0,5,5
2020,Niger,NER,Netherlands,NLD,0,0,5,0,5
2020,Nicaragua,NIC,Netherlands,NLD,11,5,0,5,21
2020,Nigeria,NGA,Netherlands,NLD,11,0,106,57,174
2020,Pakistan,PAK,Netherlands,NLD,150,16,38,21,225
2020,Peru,PER,Netherlands,NLD,0,0,5,0,5
2020,Philippines,PHL,Netherlands,NLD,0,0,5,0,5
2020,South Africa,ZAF,Netherlands,NLD,0,0,5,0,5
2020,Russian Federation,RUS,Netherlands,NLD,65,5,31,32,133
2020,Rwanda,RWA,Netherlands,NLD,0,0,5,5,10
2020,El Salvador,SLV,Netherlands,NLD,0,0,11,0,11
2020,Saudi Arabia,SAU,Netherlands,NLD,5,0,0,0,5
2020,Serbia and Kosovo: S/RES/1244 (1999),SRB,Netherlands,NLD,0,0,109,19,128
2020,Senegal,SEN,Netherlands,NLD,0,0,10,0,10
2020,Sierra Leone,SLE,Netherlands,NLD,5,0,15,5,25
2020,Somalia,SOM,Netherlands,NLD,38,0,37,19,94
2020,Viet Nam,VNM,Netherlands,NLD,0,0,14,0,14
2020,Sudan,SDN,Netherlands,NLD,23,5,22,10,60
2020,Suriname,SUR,Netherlands,NLD,0,0,5,0,5
2020,Syrian Arab Rep.,SYR,Netherlands,NLD,4061,51,328,81,4521
2020,United Rep. of Tanzania,TZA,Netherlands,NLD,0,0,5,0,5
2020,Tajikistan,TJK,Netherlands,NLD,5,0,0,19,24
2020,Turkmenistan,TKM,Netherlands,NLD,5,0,0,0,5
2020,Trinidad and Tobago,TTO,Netherlands,NLD,5,0,5,0,10
2020,Tunisia,TUN,Netherlands,NLD,5,0,37,40,82
2020,Turkey,TUR,Netherlands,NLD,1141,328,72,36,1577
2020,Uganda,UGA,Netherlands,NLD,12,0,71,5,88
2020,Ukraine,UKR,Netherlands,NLD,0,5,28,12,45
2020,United States of America,USA,Netherlands,NLD,12,5,0,0,17
2020,Uzbekistan,UZB,Netherlands,NLD,0,5,5,0,10
2020,Venezuela (Bolivarian Republic of),VEN,Netherlands,NLD,12,5,64,16,97
2020,Yemen,YEM,Netherlands,NLD,583,19,29,10,641
2020,Zimbabwe,ZWE,Netherlands,NLD,0,0,5,0,5
2020,Stateless,XXA,Netherlands,NLD,143,11,33,5,192
2020,Central African Rep.,CAF,Niger,NER,15,0,5,0,20
2020,Chad,TCD,Niger,NER,5,0,10,10,25
2020,Cameroon,CMR,Niger,NER,16,0,5,12,33
2020,Dem. Rep. of the Congo,COD,Niger,NER,0,0,0,14,14
2020,Eritrea,ERI,Niger,NER,0,0,0,5,5
2020,Ethiopia,ETH,Niger,NER,0,0,5,5,10
2020,Guinea,GIN,Niger,NER,0,0,5,5,10
2020,Cote d'Ivoire,CIV,Niger,NER,0,0,0,5,5
2020,Mali,MLI,Niger,NER,0,0,0,12,12
2020,Nigeria,NGA,Niger,NER,0,0,0,34689,34689
2020,Sudan,SDN,Niger,NER,788,0,16,76,880
2020,South Sudan,SSD,Niger,NER,5,0,0,0,5
2020,Syrian Arab Rep.,SYR,Niger,NER,5,0,0,0,5
2020,Central African Rep.,CAF,Nigeria,NGA,250,0,30,10,290
2020,Chad,TCD,Nigeria,NGA,0,0,0,10,10
2020,Cameroon,CMR,Nigeria,NGA,124,0,0,5,129
2020,Congo,COG,Nigeria,NGA,0,0,0,5,5
2020,Dem. Rep. of the Congo,COD,Nigeria,NGA,21,0,5,22,48
2020,Cote d'Ivoire,CIV,Nigeria,NGA,0,0,0,5,5
2020,Lebanon,LBN,Nigeria,NGA,0,0,0,5,5
2020,Mali,MLI,Nigeria,NGA,0,0,12,0,12
2020,Sudan,SDN,Nigeria,NGA,0,0,0,5,5
2020,Syrian Arab Rep.,SYR,Nigeria,NGA,43,0,0,10,53
2020,Togo,TGO,Nigeria,NGA,5,0,5,5,15
2020,Afghanistan,AFG,Norway,NOR,12,10,33,14,69
2020,Albania,ALB,Norway,NOR,0,0,19,5,24
2020,Algeria,DZA,Norway,NOR,0,0,0,5,5
2020,Angola,AGO,Norway,NOR,0,0,0,13,13
2020,Egypt,EGY,Norway,NOR,0,0,5,0,5
2020,Azerbaijan,AZE,Norway,NOR,5,0,0,0,5
2020,Belarus,BLR,Norway,NOR,0,0,0,5,5
2020,China,CHN,Norway,NOR,11,0,0,5,16
2020,Cameroon,CMR,Norway,NOR,0,0,0,5,5
2020,Colombia,COL,Norway,NOR,16,0,21,0,37
2020,Czechia,CZE,Norway,NOR,0,0,5,0,5
2020,Eritrea,ERI,Norway,NOR,117,5,10,25,157
2020,Ethiopia,ETH,Norway,NOR,5,0,16,5,26
2020,Gambia,GMB,Norway,NOR,0,0,0,5,5
2020,United Kingdom of Great Britain and Northern Ireland,GBR,Norway,NOR,0,0,5,0,5
2020,Georgia,GEO,Norway,NOR,0,0,13,0,13
2020,Cote d'Ivoire,CIV,Norway,NOR,0,0,0,10,10
2020,India,IND,Norway,NOR,0,0,0,5,5
2020,Iran (Islamic Rep. of),IRN,Norway,NOR,21,0,36,12,69
2020,Iraq,IRQ,Norway,NOR,12,5,14,26,57
2020,Libya,LBY,Norway,NOR,0,0,0,12,12
2020,Sri Lanka,LKA,Norway,NOR,0,0,5,5,10
2020,Morocco,MAR,Norway,NOR,0,0,5,14,19
2020,Nicaragua,NIC,Norway,NOR,0,0,14,0,14
2020,Nigeria,NGA,Norway,NOR,5,0,0,5,10
2020,Pakistan,PAK,Norway,NOR,5,0,5,13,23
2020,Peru,PER,Norway,NOR,0,0,5,0,5
2020,Russian Federation,RUS,Norway,NOR,10,0,15,13,38
2020,Rwanda,RWA,Norway,NOR,0,0,0,5,5
2020,El Salvador,SLV,Norway,NOR,0,0,0,5,5
2020,Serbia and Kosovo: S/RES/1244 (1999),SRB,Norway,NOR,0,0,12,5,17
2020,Senegal,SEN,Norway,NOR,0,0,0,5,5
2020,Somalia,SOM,Norway,NOR,10,0,12,5,27
2020,Sudan,SDN,Norway,NOR,5,0,13,5,23
2020,Syrian Arab Rep.,SYR,Norway,NOR,401,0,0,41,442
2020,United Rep. of Tanzania,TZA,Norway,NOR,5,0,0,0,5
2020,Turkey,TUR,Norway,NOR,288,0,28,5,321
2020,Uganda,UGA,Norway,NOR,0,0,5,0,5
2020,Ukraine,UKR,Norway,NOR,0,0,16,0,16
2020,Venezuela (Bolivarian Republic of),VEN,Norway,NOR,15,0,12,0,27
2020,Yemen,YEM,Norway,NOR,5,13,0,0,18
2020,Stateless,XXA,Norway,NOR,42,0,22,26,90
2020,Afghanistan,AFG,Nauru,NRU,5,0,0,0,5
2020,Bangladesh,BGD,Nauru,NRU,5,0,0,0,5
2020,India,IND,Nauru,NRU,10,0,0,0,10
2020,Iran (Islamic Rep. of),IRN,Nauru,NRU,202,0,0,0,202
2020,Iraq,IRQ,Nauru,NRU,13,0,0,0,13
2020,Sri Lanka,LKA,Nauru,NRU,33,0,0,0,33
2020,Malaysia,MYS,Nauru,NRU,5,0,0,0,5
2020,Myanmar,MMR,Nauru,NRU,12,0,0,0,12
2020,Nepal,NPL,Nauru,NRU,10,0,0,0,10
2020,Pakistan,PAK,Nauru,NRU,5,0,0,0,5
2020,Somalia,SOM,Nauru,NRU,5,0,0,0,5
2020,Stateless,XXA,Nauru,NRU,19,0,0,0,19
2020,Afghanistan,AFG,New Zealand,NZL,0,16,5,0,21
2020,Bangladesh,BGD,New Zealand,NZL,0,0,14,0,14
2020,Brazil,BRA,New Zealand,NZL,0,0,5,0,5
2020,China,CHN,New Zealand,NZL,0,25,17,10,52
2020,Chile,CHL,New Zealand,NZL,0,0,5,0,5
2020,Colombia,COL,New Zealand,NZL,0,0,5,0,5
2020,Czechia,CZE,New Zealand,NZL,0,0,0,5,5
2020,Ethiopia,ETH,New Zealand,NZL,0,5,0,0,5
2020,Fiji,FJI,New Zealand,NZL,0,0,5,0,5
2020,India,IND,New Zealand,NZL,0,0,25,0,25
2020,Indonesia,IDN,New Zealand,NZL,0,0,0,13,13
2020,Iran (Islamic Rep. of),IRN,New Zealand,NZL,0,19,10,0,29
2020,Sri Lanka,LKA,New Zealand,NZL,0,5,33,0,38
2020,Mexico,MEX,New Zealand,NZL,0,0,5,0,5
2020,Malaysia,MYS,New Zealand,NZL,0,0,14,5,19
2020,Mongolia,MNG,New Zealand,NZL,0,5,0,0,5
2020,Pakistan,PAK,New Zealand,NZL,0,5,0,0,5
2020,Philippines,PHL,New Zealand,NZL,0,0,5,0,5
2020,Papua New Guinea,PNG,New Zealand,NZL,0,0,0,5,5
2020,South Africa,ZAF,New Zealand,NZL,0,0,13,0,13
2020,Syrian Arab Rep.,SYR,New Zealand,NZL,0,5,0,0,5
2020,Tonga,TON,New Zealand,NZL,0,0,5,0,5
2020,Turkey,TUR,New Zealand,NZL,0,0,11,0,11
2020,United States of America,USA,New Zealand,NZL,0,0,0,5,5
2020,Bangladesh,BGD,Panama,PAN,0,0,0,5,5
2020,Colombia,COL,Panama,PAN,5,0,0,870,875
2020,Costa Rica,CRI,Panama,PAN,0,0,0,5,5
2020,Cuba,CUB,Panama,PAN,0,0,0,713,713
2020,Dominican Rep.,DOM,Panama,PAN,0,0,0,14,14
2020,Ecuador,ECU,Panama,PAN,0,0,0,10,10
2020,Ghana,GHA,Panama,PAN,0,0,0,5,5
2020,Guatemala,GTM,Panama,PAN,0,0,0,5,5
2020,Guinea,GIN,Panama,PAN,0,0,0,5,5
2020,Haiti,HTI,Panama,PAN,0,0,0,17,17
2020,Honduras,HND,Panama,PAN,5,0,0,23,28
2020,Jamaica,JAM,Panama,PAN,0,0,0,5,5
2020,Kenya,KEN,Panama,PAN,0,0,0,5,5
2020,Nicaragua,NIC,Panama,PAN,0,0,0,1991,1991
2020,Pakistan,PAK,Panama,PAN,0,0,0,12,12
2020,Peru,PER,Panama,PAN,0,0,0,5,5
2020,El Salvador,SLV,Panama,PAN,19,0,0,358,377
2020,Syrian Arab Rep.,SYR,Panama,PAN,0,0,0,12,12
2020,Venezuela (Bolivarian Republic of),VEN,Panama,PAN,5,0,0,1248,1253
2020,Cuba,CUB,Paraguay,PRY,171,0,0,0,171
2020,Venezuela (Bolivarian Republic of),VEN,Paraguay,PRY,501,0,0,0,501
2020,Colombia,COL,Peru,PER,0,0,5,5,10
2020,Cuba,CUB,Peru,PER,18,0,17,5,40
2020,Haiti,HTI,Peru,PER,0,0,5,0,5
2020,El Salvador,SLV,Peru,PER,5,0,0,0,5
2020,Venezuela (Bolivarian Republic of),VEN,Peru,PER,1398,0,114,470,1982
2020,Afghanistan,AFG,Papua New Guinea,PNG,0,0,0,5,5
2020,Iran (Islamic Rep. of),IRN,Papua New Guinea,PNG,0,0,0,24,24
2020,Afghanistan,AFG,Poland,POL,5,14,0,49,68
2020,Algeria,DZA,Poland,POL,0,0,5,5,10
2020,Egypt,EGY,Poland,POL,5,0,11,0,16
2020,Armenia,ARM,Poland,POL,0,0,15,17,32
2020,Azerbaijan,AZE,Poland,POL,0,0,26,5,31
2020,Bangladesh,BGD,Poland,POL,0,0,10,0,10
2020,Belarus,BLR,Poland,POL,10,73,20,27,130
2020,Bulgaria,BGR,Poland,POL,0,0,0,5,5
2020,China,CHN,Poland,POL,0,0,0,5,5
2020,Chile,CHL,Poland,POL,0,0,0,5,5
2020,Cameroon,CMR,Poland,POL,0,0,5,0,5
2020,Gambia,GMB,Poland,POL,0,0,0,5,5
2020,Palestinian,PSE,Poland,POL,0,0,0,5,5
2020,Georgia,GEO,Poland,POL,0,0,57,27,84
2020,Guinea,GIN,Poland,POL,0,5,5,0,10
2020,India,IND,Poland,POL,0,0,12,5,17
2020,Iran (Islamic Rep. of),IRN,Poland,POL,10,0,13,10,33
2020,Iraq,IRQ,Poland,POL,0,5,10,11,26
2020,Kazakhstan,KAZ,Poland,POL,0,5,21,5,31
2020,Kyrgyzstan,KGZ,Poland,POL,5,0,38,0,43
2020,Libya,LBY,Poland,POL,0,5,0,5,10
2020,Lebanon,LBN,Poland,POL,0,0,5,11,16
2020,Sri Lanka,LKA,Poland,POL,0,0,5,0,5
2020,Rep. of Moldova,MDA,Poland,POL,0,0,10,0,10
2020,Morocco,MAR,Poland,POL,0,0,0,10,10
2020,Nepal,NPL,Poland,POL,0,5,0,0,5
2020,Nigeria,NGA,Poland,POL,0,0,11,0,11
2020,Pakistan,PAK,Poland,POL,5,0,11,0,16
2020,Russian Federation,RUS,Poland,POL,15,51,1295,712,2073
2020,Serbia and Kosovo: S/RES/1244 (1999),SRB,Poland,POL,0,0,5,0,5
2020,Sierra Leone,SLE,Poland,POL,0,5,0,0,5
2020,Somalia,SOM,Poland,POL,0,5,0,0,5
2020,Viet Nam,VNM,Poland,POL,0,0,11,0,11
2020,Sudan,SDN,Poland,POL,0,0,5,0,5
2020,Syrian Arab Rep.,SYR,Poland,POL,14,0,0,10,24
2020,Tajikistan,TJK,Poland,POL,0,27,63,34,124
2020,Turkmenistan,TKM,Poland,POL,10,0,0,0,10
2020,Tunisia,TUN,Poland,POL,0,0,0,5,5
2020,Turkey,TUR,Poland,POL,85,0,25,12,122
2020,Ukraine,UKR,Poland,POL,5,18,313,37,373
2020,Uzbekistan,UZB,Poland,POL,0,0,12,0,12
2020,Yemen,YEM,Poland,POL,0,5,0,0,5
2020,Stateless,XXA,Poland,POL,0,0,0,13,13
2020,Afghanistan,AFG,Portugal,PRT,0,0,0,5,5
2020,Algeria,DZA,Portugal,PRT,0,0,0,5,0
2020,Angola,AGO,Portugal,PRT,0,0,5,105,108
2020,Bangladesh,BGD,Portugal,PRT,0,0,0,5,5
2020,Brazil,BRA,Portugal,PRT,0,0,0,12,12
2020,China,CHN,Portugal,PRT,0,0,11,0,11
2020,Cameroon,CMR,Portugal,PRT,0,0,0,5,5
2020,Dem. Rep. of the Congo,COD,Portugal,PRT,0,0,0,20,20
2020,Colombia,COL,Portugal,PRT,0,0,0,5,5
2020,Cuba,CUB,Portugal,PRT,0,0,0,5,0
2020,Ethiopia,ETH,Portugal,PRT,5,0,0,0,5
2020,Gambia,GMB,Portugal,PRT,0,0,11,146,19
2020,Palestinian,PSE,Portugal,PRT,0,0,0,5,0
2020,Ghana,GHA,Portugal,PRT,0,0,0,10,5
2020,Guinea-Bissau,GNB,Portugal,PRT,0,0,5,74,14
2020,Guinea,GIN,Portugal,PRT,0,0,0,68,14
2020,Haiti,HTI,Portugal,PRT,0,0,0,5,5
2020,Cote d'Ivoire,CIV,Portugal,PRT,0,0,0,5,0
2020,Iran (Islamic Rep. of),IRN,Portugal,PRT,5,0,0,0,5
2020,Iraq,IRQ,Portugal,PRT,5,0,0,5,5
2020,Mali,MLI,Portugal,PRT,0,0,0,10,5
2020,Morocco,MAR,Portugal,PRT,0,0,0,61,57
2020,Nigeria,NGA,Portugal,PRT,0,0,0,30,14
2020,Pakistan,PAK,Portugal,PRT,15,0,5,5,21
2020,Russian Federation,RUS,Portugal,PRT,5,0,0,0,5
2020,Senegal,SEN,Portugal,PRT,0,0,0,60,19
2020,Sierra Leone,SLE,Portugal,PRT,0,0,0,22,5
2020,Somalia,SOM,Portugal,PRT,0,0,0,5,0
2020,Sudan,SDN,Portugal,PRT,0,5,0,0,5
2020,Syrian Arab Rep.,SYR,Portugal,PRT,21,0,0,0,21
2020,Togo,TGO,Portugal,PRT,0,0,0,5,5
2020,Turkey,TUR,Portugal,PRT,17,0,0,0,17
2020,Ukraine,UKR,Portugal,PRT,0,5,18,21,45
2020,Venezuela (Bolivarian Republic of),VEN,Portugal,PRT,0,0,0,5,5
2020,Zimbabwe,ZWE,Portugal,PRT,5,0,0,0,5
2020,Afghanistan,AFG,Romania,ROU,10,21,426,430,887
2020,Albania,ALB,Romania,ROU,0,0,0,5,5
2020,Algeria,DZA,Romania,ROU,0,0,66,44,110
2020,Egypt,EGY,Romania,ROU,0,0,30,50,80
2020,Bangladesh,BGD,Romania,ROU,0,0,39,43,82
2020,China,CHN,Romania,ROU,5,0,0,5,10
2020,Cameroon,CMR,Romania,ROU,0,0,14,0,14
2020,Congo,COG,Romania,ROU,0,0,5,0,5
2020,Dem. Rep. of the Congo,COD,Romania,ROU,0,0,0,5,5
2020,Cuba,CUB,Romania,ROU,0,0,10,0,10
2020,Eritrea,ERI,Romania,ROU,5,5,0,16,26
2020,Ethiopia,ETH,Romania,ROU,0,0,5,0,5
2020,Palestinian,PSE,Romania,ROU,5,5,10,40,60
2020,Guinea,GIN,Romania,ROU,5,0,0,5,10
2020,India,IND,Romania,ROU,0,0,40,15,55
2020,Iran (Islamic Rep. of),IRN,Romania,ROU,23,0,16,44,83
2020,Iraq,IRQ,Romania,ROU,20,5,56,331,412
2020,Jordan,JOR,Romania,ROU,5,0,0,0,5
2020,Kazakhstan,KAZ,Romania,ROU,0,0,0,5,5
2020,Libya,LBY,Romania,ROU,0,5,18,41,64
2020,Lebanon,LBN,Romania,ROU,0,0,0,5,5
2020,Sri Lanka,LKA,Romania,ROU,0,0,16,26,42
2020,Rep. of Moldova,MDA,Romania,ROU,0,0,0,5,5
2020,Morocco,MAR,Romania,ROU,0,0,102,28,130
2020,Nepal,NPL,Romania,ROU,0,0,0,5,5
2020,Nigeria,NGA,Romania,ROU,0,0,5,5,10
2020,Pakistan,PAK,Romania,ROU,0,5,62,13,80
2020,South Africa,ZAF,Romania,ROU,0,0,0,5,5
2020,Rwanda,RWA,Romania,ROU,5,0,0,0,5
2020,Somalia,SOM,Romania,ROU,48,21,34,5,108
2020,Viet Nam,VNM,Romania,ROU,0,0,0,5,5
2020,Syrian Arab Rep.,SYR,Romania,ROU,105,337,101,791,1334
2020,Tajikistan,TJK,Romania,ROU,0,0,0,5,5
2020,Tunisia,TUN,Romania,ROU,0,0,43,36,79
2020,Turkey,TUR,Romania,ROU,17,0,82,199,298
2020,Ukraine,UKR,Romania,ROU,0,0,5,0,5
2020,Venezuela (Bolivarian Republic of),VEN,Romania,ROU,0,0,5,0,5
2020,Yemen,YEM,Romania,ROU,5,14,0,0,19
2020,Stateless,XXA,Romania,ROU,22,5,0,5,32
2020,Algeria,DZA,South Africa,ZAF,0,0,5,0,5
2020,Egypt,EGY,South Africa,ZAF,0,0,5,0,5
2020,Burundi,BDI,South Africa,ZAF,5,0,55,0,60
2020,Bangladesh,BGD,South Africa,ZAF,0,0,157,0,157
2020,Cameroon,CMR,South Africa,ZAF,5,0,26,0,31
2020,Congo,COG,South Africa,ZAF,14,0,78,0,92
2020,Dem. Rep. of the Congo,COD,South Africa,ZAF,74,0,352,0,426
2020,Eritrea,ERI,South Africa,ZAF,5,0,18,0,23
2020,Ethiopia,ETH,South Africa,ZAF,65,0,444,0,509
2020,Ghana,GHA,South Africa,ZAF,0,0,22,0,22
2020,India,IND,South Africa,ZAF,0,0,29,0,29
2020,Kenya,KEN,South Africa,ZAF,0,0,5,0,5
2020,Malawi,MWI,South Africa,ZAF,0,0,54,0,54
2020,Mozambique,MOZ,South Africa,ZAF,0,0,10,0,10
2020,Nepal,NPL,South Africa,ZAF,0,0,5,0,5
2020,Niger,NER,South Africa,ZAF,0,0,5,0,5
2020,Nigeria,NGA,South Africa,ZAF,0,0,106,0,106
2020,Pakistan,PAK,South Africa,ZAF,0,0,75,0,75
2020,Rwanda,RWA,South Africa,ZAF,5,0,24,0,29
2020,Senegal,SEN,South Africa,ZAF,0,0,12,0,12
2020,Somalia,SOM,South Africa,ZAF,127,0,110,0,237
2020,Eswatini,SWZ,South Africa,ZAF,0,0,5,0,5
2020,United Rep. of Tanzania,TZA,South Africa,ZAF,0,0,5,0,5
2020,Thailand,THA,South Africa,ZAF,0,0,5,0,5
2020,Uganda,UGA,South Africa,ZAF,0,0,46,0,46
2020,Zambia,ZMB,South Africa,ZAF,0,0,5,0,5
2020,Zimbabwe,ZWE,South Africa,ZAF,5,0,199,0,204
2020,Afghanistan,AFG,Russian Federation,RUS,10,0,0,100,110
2020,Egypt,EGY,Russian Federation,RUS,0,0,0,5,5
2020,Armenia,ARM,Russian Federation,RUS,5,0,0,0,5
2020,Azerbaijan,AZE,Russian Federation,RUS,0,0,0,5,5
2020,Belgium,BEL,Russian Federation,RUS,0,0,0,10,10
2020,Congo,COG,Russian Federation,RUS,0,0,0,5,5
2020,Germany,DEU,Russian Federation,RUS,5,0,0,0,5
2020,Kazakhstan,KAZ,Russian Federation,RUS,0,0,0,5,5
2020,Kyrgyzstan,KGZ,Russian Federation,RUS,0,0,0,5,5
2020,Dem. People's Rep. of Korea,PRK,Russian Federation,RUS,0,0,0,5,5
2020,Niger,NER,Russian Federation,RUS,0,0,0,5,5
2020,Sudan,SDN,Russian Federation,RUS,0,0,0,5,5
2020,Syrian Arab Rep.,SYR,Russian Federation,RUS,0,0,0,25,25
2020,Tajikistan,TJK,Russian Federation,RUS,0,0,0,10,10
2020,Ukraine,UKR,Russian Federation,RUS,10,0,0,27,37
2020,Uzbekistan,UZB,Russian Federation,RUS,0,0,0,5,5
2020,Yemen,YEM,Russian Federation,RUS,0,0,0,10,10
2020,Burundi,BDI,Rwanda,RWA,0,0,0,16,16
2020,Dem. Rep. of the Congo,COD,Rwanda,RWA,15,0,0,33,48
2020,Eritrea,ERI,Rwanda,RWA,29,0,0,104,133
2020,Ethiopia,ETH,Rwanda,RWA,5,0,0,0,5
2020,Somalia,SOM,Rwanda,RWA,16,0,0,5,21
2020,Sudan,SDN,Rwanda,RWA,5,0,0,0,5
2020,Honduras,HND,El Salvador,SLV,0,0,0,5,5
2020,Afghanistan,AFG,Serbia and Kosovo: S/RES/1244 (1999),SRB,5,0,5,63,73
2020,Algeria,DZA,Serbia and Kosovo: S/RES/1244 (1999),SRB,0,0,0,52,52
2020,Egypt,EGY,Serbia and Kosovo: S/RES/1244 (1999),SRB,0,0,0,23,23
2020,Burundi,BDI,Serbia and Kosovo: S/RES/1244 (1999),SRB,0,0,15,11,26
2020,Bangladesh,BGD,Serbia and Kosovo: S/RES/1244 (1999),SRB,0,0,0,10,10
2020,Palestinian,PSE,Serbia and Kosovo: S/RES/1244 (1999),SRB,0,0,0,109,109
2020,Ghana,GHA,Serbia and Kosovo: S/RES/1244 (1999),SRB,0,0,0,5,5
2020,Guinea,GIN,Serbia and Kosovo: S/RES/1244 (1999),SRB,0,0,0,5,5
2020,Iran (Islamic Rep. of),IRN,Serbia and Kosovo: S/RES/1244 (1999),SRB,5,0,27,49,81
2020,Iraq,IRQ,Serbia and Kosovo: S/RES/1244 (1999),SRB,0,0,5,120,125
2020,Libya,LBY,Serbia and Kosovo: S/RES/1244 (1999),SRB,0,0,0,65,65
2020,Lebanon,LBN,Serbia and Kosovo: S/RES/1244 (1999),SRB,0,0,0,10,10
2020,North Macedonia,MKD,Serbia and Kosovo: S/RES/1244 (1999),SRB,0,0,5,0,5
2020,Morocco,MAR,Serbia and Kosovo: S/RES/1244 (1999),SRB,0,0,0,176,176
2020,Nigeria,NGA,Serbia and Kosovo: S/RES/1244 (1999),SRB,0,0,0,5,5
2020,Pakistan,PAK,Serbia and Kosovo: S/RES/1244 (1999),SRB,0,0,5,0,5
2020,Russian Federation,RUS,Serbia and Kosovo: S/RES/1244 (1999),SRB,0,0,5,0,5
2020,Somalia,SOM,Serbia and Kosovo: S/RES/1244 (1999),SRB,0,0,0,5,5
2020,Syrian Arab Rep.,SYR,Serbia and Kosovo: S/RES/1244 (1999),SRB,5,5,0,645,655
2020,Tunisia,TUN,Serbia and Kosovo: S/RES/1244 (1999),SRB,0,0,0,17,17
2020,Turkey,TUR,Serbia and Kosovo: S/RES/1244 (1999),SRB,12,0,0,30,42
2020,Yemen,YEM,Serbia and Kosovo: S/RES/1244 (1999),SRB,0,0,0,17,17
2020,Afghanistan,AFG,Spain,ESP,10,85,32,0,127
2020,Albania,ALB,Spain,ESP,0,0,104,0,104
2020,Algeria,DZA,Spain,ESP,12,5,641,0,658
2020,Angola,AGO,Spain,ESP,22,0,11,0,33
2020,Egypt,EGY,Spain,ESP,32,0,55,0,87
2020,Argentina,ARG,Spain,ESP,14,0,258,0,272
2020,Armenia,ARM,Spain,ESP,0,5,127,0,132
2020,Azerbaijan,AZE,Spain,ESP,0,0,13,0,13
2020,Bangladesh,BGD,Spain,ESP,5,0,279,0,284
2020,Burkina Faso,BFA,Spain,ESP,0,0,56,0,56
2020,Belarus,BLR,Spain,ESP,5,0,24,0,29
2020,Bolivia (Plurinational State of),BOL,Spain,ESP,0,5,58,0,63
2020,Brazil,BRA,Spain,ESP,24,0,745,0,769
2020,Central African Rep.,CAF,Spain,ESP,5,18,5,0,28
2020,Chad,TCD,Spain,ESP,0,0,5,0,5
2020,China,CHN,Spain,ESP,10,0,35,0,45
2020,Chile,CHL,Spain,ESP,5,10,70,0,85
2020,Cameroon,CMR,Spain,ESP,15,0,72,0,87
2020,Congo,COG,Spain,ESP,5,0,17,0,22
2020,Dem. Rep. of the Congo,COD,Spain,ESP,30,5,103,0,138
2020,Colombia,COL,Spain,ESP,624,152,37907,0,38683
2020,Costa Rica,CRI,Spain,ESP,5,0,30,0,35
2020,Cuba,CUB,Spain,ESP,20,0,286,0,306
2020,Dominican Rep.,DOM,Spain,ESP,0,5,58,0,63
2020,Ecuador,ECU,Spain,ESP,5,0,91,0,96
2020,Equatorial Guinea,GNQ,Spain,ESP,5,0,18,0,23
2020,Eritrea,ERI,Spain,ESP,5,0,11,0,16
2020,France,FRA,Spain,ESP,0,0,5,0,5
2020,Gambia,GMB,Spain,ESP,11,0,138,0,149
2020,Palestinian,PSE,Spain,ESP,53,149,606,0,808
2020,Georgia,GEO,Spain,ESP,10,0,614,0,624
2020,Ghana,GHA,Spain,ESP,0,0,392,0,392
2020,Guinea-Bissau,GNB,Spain,ESP,0,0,5,0,5
2020,Guatemala,GTM,Spain,ESP,55,0,420,0,475
2020,Guinea,GIN,Spain,ESP,50,10,567,0,627
2020,Haiti,HTI,Spain,ESP,0,0,5,0,5
2020,Honduras,HND,Spain,ESP,687,15,5180,0,5882
2020,Cote d'Ivoire,CIV,Spain,ESP,174,5,635,0,814
2020,India,IND,Spain,ESP,0,0,72,0,72
2020,Iran (Islamic Rep. of),IRN,Spain,ESP,5,0,39,0,44
2020,Iraq,IRQ,Spain,ESP,5,5,62,0,72
2020,Jamaica,JAM,Spain,ESP,26,0,0,0,26
2020,Jordan,JOR,Spain,ESP,0,0,5,0,5
2020,Kazakhstan,KAZ,Spain,ESP,5,0,5,0,10
2020,Kenya,KEN,Spain,ESP,5,0,0,0,5
2020,Kyrgyzstan,KGZ,Spain,ESP,0,0,5,0,5
2020,Liberia,LBR,Spain,ESP,0,0,23,0,23
2020,Libya,LBY,Spain,ESP,33,49,14,0,96
2020,Lebanon,LBN,Spain,ESP,0,5,86,0,91
2020,Sri Lanka,LKA,Spain,ESP,0,5,14,0,19
2020,Mauritania,MRT,Spain,ESP,15,0,54,0,69
2020,Rep. of Moldova,MDA,Spain,ESP,0,0,13,0,13
2020,Mexico,MEX,Spain,ESP,0,5,34,0,39
2020,Mali,MLI,Spain,ESP,5,233,208,0,446
2020,Morocco,MAR,Spain,ESP,184,0,403,0,587
2020,Niger,NER,Spain,ESP,0,0,12,0,12
2020,Nicaragua,NIC,Spain,ESP,1117,5,3118,0,4240
2020,Nigeria,NGA,Spain,ESP,36,0,276,0,312
2020,Pakistan,PAK,Spain,ESP,38,0,884,0,922
2020,Panama,PAN,Spain,ESP,0,12,11,0,23
2020,Paraguay,PRY,Spain,ESP,48,0,125,0,173
2020,Peru,PER,Spain,ESP,96,17,3604,0,3717
2020,Philippines,PHL,Spain,ESP,0,0,5,0,5
2020,Qatar,QAT,Spain,ESP,0,0,5,0,5
2020,South Africa,ZAF,Spain,ESP,5,0,0,0,5
2020,Russian Federation,RUS,Spain,ESP,158,5,92,0,255
2020,El Salvador,SLV,Spain,ESP,408,16,3927,0,4351
2020,Senegal,SEN,Spain,ESP,19,0,366,0,385
2020,Sierra Leone,SLE,Spain,ESP,0,0,18,0,18
2020,Somalia,SOM,Spain,ESP,0,11,16,0,27
2020,Viet Nam,VNM,Spain,ESP,0,0,14,0,14
2020,Sudan,SDN,Spain,ESP,95,5,5,0,105
2020,Syrian Arab Rep.,SYR,Spain,ESP,5,525,948,0,1478
2020,Trinidad and Tobago,TTO,Spain,ESP,5,0,0,0,5
2020,Tunisia,TUN,Spain,ESP,21,0,192,0,213
2020,Turkey,TUR,Spain,ESP,78,0,83,0,161
2020,Ukraine,UKR,Spain,ESP,34,257,2768,0,3059
2020,Uruguay,URY,Spain,ESP,0,0,46,0,46
2020,United States of America,USA,Spain,ESP,0,10,27,0,37
2020,Venezuela (Bolivarian Republic of),VEN,Spain,ESP,5,40396,882,0,41283
2020,Western Sahara,ESH,Spain,ESP,5,0,14,0,19
2020,Yemen,YEM,Spain,ESP,22,88,252,0,362
2020,Dem. Rep. of the Congo,COD,Sudan,SDN,15,0,47,49,111
2020,Eritrea,ERI,Sudan,SDN,2844,0,24,2256,5124
2020,Ethiopia,ETH,Sudan,SDN,1023,0,2244,100,3367
2020,Somalia,SOM,Sudan,SDN,27,0,0,20,47
2020,Yemen,YEM,Sudan,SDN,0,0,0,61,61
2020,Burundi,BDI,South Sudan,SSD,52,0,0,5,57
2020,Eritrea,ERI,South Sudan,SSD,65,0,0,57,122
2020,Ethiopia,ETH,South Sudan,SSD,0,0,0,5,5
2020,Afghanistan,AFG,Slovakia,SVK,0,20,5,37,62
2020,Algeria,DZA,Slovakia,SVK,0,0,5,14,19
2020,Bangladesh,BGD,Slovakia,SVK,0,0,0,12,12
2020,China,CHN,Slovakia,SVK,0,0,0,5,5
2020,India,IND,Slovakia,SVK,0,0,0,12,12
2020,Iran (Islamic Rep. of),IRN,Slovakia,SVK,0,0,5,11,16
2020,Iraq,IRQ,Slovakia,SVK,0,0,0,5,5
2020,Libya,LBY,Slovakia,SVK,0,5,0,5,10
2020,Sri Lanka,LKA,Slovakia,SVK,0,0,0,11,11
2020,Morocco,MAR,Slovakia,SVK,0,0,5,26,31
2020,Pakistan,PAK,Slovakia,SVK,0,0,0,5,5
2020,Russian Federation,RUS,Slovakia,SVK,0,0,0,5,5
2020,Viet Nam,VNM,Slovakia,SVK,0,0,5,0,5
2020,Syrian Arab Rep.,SYR,Slovakia,SVK,0,10,0,23,33
2020,Tunisia,TUN,Slovakia,SVK,0,0,0,5,5
2020,Turkey,TUR,Slovakia,SVK,0,0,0,5,5
2020,Ukraine,UKR,Slovakia,SVK,0,0,0,5,5
2020,Afghanistan,AFG,Slovenia,SVN,5,0,109,508,622
2020,Algeria,DZA,Slovenia,SVN,0,0,72,277,349
2020,Egypt,EGY,Slovenia,SVN,0,0,0,146,146
2020,Azerbaijan,AZE,Slovenia,SVN,0,0,5,0,5
2020,Bangladesh,BGD,Slovenia,SVN,0,0,5,143,148
2020,Bosnia and Herzegovina,BIH,Slovenia,SVN,0,0,0,5,5
2020,Cameroon,CMR,Slovenia,SVN,0,0,0,5,5
2020,Cuba,CUB,Slovenia,SVN,0,0,0,5,5
2020,Eritrea,ERI,Slovenia,SVN,5,0,12,20,37
2020,Gambia,GMB,Slovenia,SVN,0,0,5,0,5
2020,Palestinian,PSE,Slovenia,SVN,13,0,5,5,23
2020,India,IND,Slovenia,SVN,0,0,10,12,22
2020,Iran (Islamic Rep. of),IRN,Slovenia,SVN,11,0,35,25,71
2020,Iraq,IRQ,Slovenia,SVN,10,0,53,37,100
2020,Libya,LBY,Slovenia,SVN,0,0,0,13,13
2020,Sri Lanka,LKA,Slovenia,SVN,0,0,24,0,24
2020,Morocco,MAR,Slovenia,SVN,0,0,193,1086,1279
2020,Nepal,NPL,Slovenia,SVN,0,0,0,10,10
2020,Nigeria,NGA,Slovenia,SVN,0,0,5,0,5
2020,Pakistan,PAK,Slovenia,SVN,0,0,57,447,504
2020,Russian Federation,RUS,Slovenia,SVN,0,0,5,5,10
2020,Serbia and Kosovo: S/RES/1244 (1999),SRB,Slovenia,SVN,0,0,10,16,26
2020,Sudan,SDN,Slovenia,SVN,0,0,0,11,11
2020,Syrian Arab Rep.,SYR,Slovenia,SVN,14,0,10,35,59
2020,Togo,TGO,Slovenia,SVN,0,0,0,5,5
2020,Tunisia,TUN,Slovenia,SVN,0,0,12,28,40
2020,Turkey,TUR,Slovenia,SVN,17,0,10,46,73
2020,Ukraine,UKR,Slovenia,SVN,0,0,5,0,5
2020,Yemen,YEM,Slovenia,SVN,0,0,10,0,10
2020,Dem. Rep. of the Congo,COD,Eswatini,SWZ,5,0,0,0,5
2020,Afghanistan,AFG,Sweden,SWE,239,55,334,107,735
2020,Albania,ALB,Sweden,SWE,0,0,242,39,281
2020,Algeria,DZA,Sweden,SWE,5,0,26,39,70
2020,Angola,AGO,Sweden,SWE,0,0,10,5,15
2020,Egypt,EGY,Sweden,SWE,15,0,305,35,355
2020,Argentina,ARG,Sweden,SWE,0,0,5,0,5
2020,Armenia,ARM,Sweden,SWE,0,0,41,13,54
2020,Azerbaijan,AZE,Sweden,SWE,30,5,186,30,251
2020,Burundi,BDI,Sweden,SWE,16,0,39,5,60
2020,Bangladesh,BGD,Sweden,SWE,14,0,209,17,240
2020,Belarus,BLR,Sweden,SWE,0,0,36,38,74
2020,Bolivia (Plurinational State of),BOL,Sweden,SWE,0,0,11,0,11
2020,Brazil,BRA,Sweden,SWE,0,0,14,0,14
2020,Bosnia and Herzegovina,BIH,Sweden,SWE,0,0,26,5,31
2020,Canada,CAN,Sweden,SWE,0,0,5,0,5
2020,China,CHN,Sweden,SWE,17,0,27,10,54
2020,Chile,CHL,Sweden,SWE,0,0,77,5,82
2020,Cameroon,CMR,Sweden,SWE,28,5,125,16,174
2020,Congo,COG,Sweden,SWE,0,0,14,5,19
2020,Dem. Rep. of the Congo,COD,Sweden,SWE,15,0,49,15,79
2020,Colombia,COL,Sweden,SWE,5,0,271,22,298
2020,Cuba,CUB,Sweden,SWE,0,0,12,10,22
2020,Denmark,DNK,Sweden,SWE,0,0,0,5,5
2020,Djibouti,DJI,Sweden,SWE,5,0,0,14,19
2020,Ecuador,ECU,Sweden,SWE,0,0,10,0,10
2020,Equatorial Guinea,GNQ,Sweden,SWE,0,0,5,0,5
2020,Eritrea,ERI,Sweden,SWE,344,38,147,101,630
2020,Ethiopia,ETH,Sweden,SWE,39,0,238,53,330
2020,Gambia,GMB,Sweden,SWE,5,0,71,41,117
2020,Palestinian,PSE,Sweden,SWE,64,16,360,71,511
2020,Georgia,GEO,Sweden,SWE,0,0,327,74,401
2020,Germany,DEU,Sweden,SWE,0,0,5,0,5
2020,Ghana,GHA,Sweden,SWE,10,0,44,19,73
2020,Greece,GRC,Sweden,SWE,0,0,0,5,5
2020,Guinea,GIN,Sweden,SWE,5,0,10,5,20
2020,Honduras,HND,Sweden,SWE,0,0,16,5,21
2020,Cote d'Ivoire,CIV,Sweden,SWE,0,0,5,0,5
2020,India,IND,Sweden,SWE,0,0,96,16,112
2020,Indonesia,IDN,Sweden,SWE,0,0,0,5,5
2020,Iran (Islamic Rep. of),IRN,Sweden,SWE,294,0,591,108,993
2020,Iraq,IRQ,Sweden,SWE,111,45,683,207,1046
2020,Jordan,JOR,Sweden,SWE,10,0,114,20,144
2020,Kazakhstan,KAZ,Sweden,SWE,5,0,181,51,237
2020,Kenya,KEN,Sweden,SWE,5,0,22,10,37
2020,Kyrgyzstan,KGZ,Sweden,SWE,5,0,111,23,139
2020,Rep. of Korea,KOR,Sweden,SWE,0,0,5,0,5
2020,Kuwait,KWT,Sweden,SWE,0,0,5,0,5
2020,Liberia,LBR,Sweden,SWE,0,0,10,0,10
2020,Libya,LBY,Sweden,SWE,5,0,18,14,37
2020,Lebanon,LBN,Sweden,SWE,5,5,88,36,134
2020,Sri Lanka,LKA,Sweden,SWE,5,0,32,10,47
2020,North Macedonia,MKD,Sweden,SWE,0,0,76,40,116
2020,Rep. of Moldova,MDA,Sweden,SWE,0,0,5,0,5
2020,Mali,MLI,Sweden,SWE,0,0,0,5,5
2020,Malaysia,MYS,Sweden,SWE,0,0,5,0,5
2020,Mongolia,MNG,Sweden,SWE,0,0,280,68,348
2020,Morocco,MAR,Sweden,SWE,10,0,96,109,215
2020,Mozambique,MOZ,Sweden,SWE,0,0,12,0,12
2020,Montenegro,MNE,Sweden,SWE,0,0,5,0,5
2020,Myanmar,MMR,Sweden,SWE,0,0,5,0,5
2020,Nepal,NPL,Sweden,SWE,0,0,17,5,22
2020,Netherlands,NLD,Sweden,SWE,0,0,5,5,10
2020,Nicaragua,NIC,Sweden,SWE,29,0,205,5,239
2020,Nigeria,NGA,Sweden,SWE,24,0,203,82,309
2020,Pakistan,PAK,Sweden,SWE,35,0,299,71,405
2020,Peru,PER,Sweden,SWE,0,0,112,13,125
2020,Philippines,PHL,Sweden,SWE,0,0,18,5,23
2020,Poland,POL,Sweden,SWE,0,0,5,0,5
2020,Romania,ROU,Sweden,SWE,0,0,0,5,5
2020,South Africa,ZAF,Sweden,SWE,0,0,12,0,12
2020,Russian Federation,RUS,Sweden,SWE,43,5,165,57,270
2020,Rwanda,RWA,Sweden,SWE,13,0,39,10,62
2020,El Salvador,SLV,Sweden,SWE,12,0,143,5,160
2020,Saudi Arabia,SAU,Sweden,SWE,0,11,0,0,11
2020,Serbia and Kosovo: S/RES/1244 (1999),SRB,Sweden,SWE,0,0,141,82,223
2020,Senegal,SEN,Sweden,SWE,0,0,21,10,31
2020,Sierra Leone,SLE,Sweden,SWE,0,0,0,13,13
2020,Somalia,SOM,Sweden,SWE,112,5,200,135,452
2020,Spain,ESP,Sweden,SWE,0,0,5,0,5
2020,Viet Nam,VNM,Sweden,SWE,0,0,26,10,36
2020,Sudan,SDN,Sweden,SWE,34,0,81,23,138
2020,Syrian Arab Rep.,SYR,Sweden,SWE,347,868,523,274,2012
2020,United Rep. of Tanzania,TZA,Sweden,SWE,10,0,31,10,51
2020,Thailand,THA,Sweden,SWE,0,0,15,0,15
2020,Tajikistan,TJK,Sweden,SWE,5,0,80,10,95
2020,Turkmenistan,TKM,Sweden,SWE,0,0,5,5,10
2020,Tunisia,TUN,Sweden,SWE,0,0,26,28,54
2020,Turkey,TUR,Sweden,SWE,382,0,300,55,737
2020,Uganda,UGA,Sweden,SWE,47,0,63,17,127
2020,Ukraine,UKR,Sweden,SWE,0,0,425,103,528
2020,United States of America,USA,Sweden,SWE,0,0,12,0,12
2020,Uzbekistan,UZB,Sweden,SWE,15,0,1034,167,1216
2020,Venezuela (Bolivarian Republic of),VEN,Sweden,SWE,10,5,133,13,161
2020,Yemen,YEM,Sweden,SWE,39,166,5,24,234
2020,Zambia,ZMB,Sweden,SWE,5,0,0,0,5
2020,Zimbabwe,ZWE,Sweden,SWE,0,0,5,0,5
2020,Stateless,XXA,Sweden,SWE,115,48,283,78,524
2020,Afghanistan,AFG,Switzerland,CHE,351,1433,90,248,2122
2020,Albania,ALB,Switzerland,CHE,0,10,46,28,84
2020,Algeria,DZA,Switzerland,CHE,5,10,176,506,697
2020,Angola,AGO,Switzerland,CHE,5,49,27,40,121
2020,Egypt,EGY,Switzerland,CHE,15,0,10,5,30
2020,Armenia,ARM,Switzerland,CHE,0,22,28,11,61
2020,Austria,AUT,Switzerland,CHE,0,0,0,5,5
2020,Azerbaijan,AZE,Switzerland,CHE,63,10,51,0,124
2020,Burundi,BDI,Switzerland,CHE,36,25,5,0,66
2020,Benin,BEN,Switzerland,CHE,0,0,0,11,11
2020,Bangladesh,BGD,Switzerland,CHE,0,0,11,0,11
2020,Burkina Faso,BFA,Switzerland,CHE,0,0,0,5,5
2020,Belarus,BLR,Switzerland,CHE,0,0,15,5,20
2020,Brazil,BRA,Switzerland,CHE,0,0,5,0,5
2020,Bosnia and Herzegovina,BIH,Switzerland,CHE,5,10,10,11,36
2020,Cambodia,KHM,Switzerland,CHE,0,0,5,0,5
2020,Central African Rep.,CAF,Switzerland,CHE,5,0,0,0,5
2020,Chad,TCD,Switzerland,CHE,0,5,0,5,10
2020,China,CHN,Switzerland,CHE,47,135,107,10,299
2020,Chile,CHL,Switzerland,CHE,0,0,5,0,5
2020,Cameroon,CMR,Switzerland,CHE,5,20,28,10,63
2020,Congo,COG,Switzerland,CHE,0,0,5,0,5
2020,Dem. Rep. of the Congo,COD,Switzerland,CHE,10,79,48,17,154
2020,Colombia,COL,Switzerland,CHE,24,11,54,5,94
2020,Djibouti,DJI,Switzerland,CHE,5,0,0,0,5
2020,Eritrea,ERI,Switzerland,CHE,1546,462,252,33,2293
2020,Ethiopia,ETH,Switzerland,CHE,68,104,102,23,297
2020,France,FRA,Switzerland,CHE,0,0,5,0,5
2020,Gambia,GMB,Switzerland,CHE,0,5,10,33,48
2020,United Kingdom of Great Britain and Northern Ireland,GBR,Switzerland,CHE,0,0,5,0,5
2020,Georgia,GEO,Switzerland,CHE,0,31,85,150,266
2020,Germany,DEU,Switzerland,CHE,0,5,0,0,5
2020,Ghana,GHA,Switzerland,CHE,0,0,5,13,18
2020,Guinea-Bissau,GNB,Switzerland,CHE,0,5,0,0,5
2020,Guinea,GIN,Switzerland,CHE,5,5,16,54,80
2020,Honduras,HND,Switzerland,CHE,0,5,0,0,5
2020,Cote d'Ivoire,CIV,Switzerland,CHE,5,17,10,18,50
2020,India,IND,Switzerland,CHE,0,0,14,0,14
2020,Indonesia,IDN,Switzerland,CHE,0,0,5,0,5
2020,Iran (Islamic Rep. of),IRN,Switzerland,CHE,213,168,407,38,826
2020,Iraq,IRQ,Switzerland,CHE,105,275,180,100,660
2020,Israel,ISR,Switzerland,CHE,0,0,0,5,5
2020,Italy,ITA,Switzerland,CHE,0,0,5,0,5
2020,Jamaica,JAM,Switzerland,CHE,5,0,0,5,10
2020,Jordan,JOR,Switzerland,CHE,0,0,5,0,5
2020,Kazakhstan,KAZ,Switzerland,CHE,0,0,5,0,5
2020,Kenya,KEN,Switzerland,CHE,0,5,0,0,5
2020,Kyrgyzstan,KGZ,Switzerland,CHE,0,0,5,0,5
2020,Liberia,LBR,Switzerland,CHE,0,0,0,5,5
2020,Libya,LBY,Switzerland,CHE,5,27,10,51,93
2020,Lebanon,LBN,Switzerland,CHE,0,5,11,10,26
2020,Sri Lanka,LKA,Switzerland,CHE,327,119,577,120,1143
2020,Mauritania,MRT,Switzerland,CHE,0,0,0,5,5
2020,North Macedonia,MKD,Switzerland,CHE,0,0,17,11,28
2020,Rep. of Moldova,MDA,Switzerland,CHE,0,0,45,28,73
2020,Mexico,MEX,Switzerland,CHE,0,0,5,0,5
2020,Mali,MLI,Switzerland,CHE,0,0,0,12,12
2020,Mongolia,MNG,Switzerland,CHE,5,0,10,5,20
2020,Morocco,MAR,Switzerland,CHE,5,11,59,220,295
2020,Montenegro,MNE,Switzerland,CHE,0,5,0,0,5
2020,Myanmar,MMR,Switzerland,CHE,5,0,0,5,10
2020,Nepal,NPL,Switzerland,CHE,5,0,5,0,10
2020,Niger,NER,Switzerland,CHE,0,0,0,5,5
2020,Nicaragua,NIC,Switzerland,CHE,0,0,5,0,5
2020,Nigeria,NGA,Switzerland,CHE,5,34,53,142,234
2020,Pakistan,PAK,Switzerland,CHE,26,29,71,21,147
2020,Russian Federation,RUS,Switzerland,CHE,51,24,41,47,163
2020,Rwanda,RWA,Switzerland,CHE,0,0,5,0,5
2020,El Salvador,SLV,Switzerland,CHE,0,0,20,0,20
2020,Saudi Arabia,SAU,Switzerland,CHE,5,5,0,0,10
2020,Serbia and Kosovo: S/RES/1244 (1999),SRB,Switzerland,CHE,5,40,56,36,137
2020,Senegal,SEN,Switzerland,CHE,0,5,5,13,23
2020,Sierra Leone,SLE,Switzerland,CHE,0,13,0,0,13
2020,Somalia,SOM,Switzerland,CHE,127,193,43,74,437
2020,Viet Nam,VNM,Switzerland,CHE,0,0,0,5,5
2020,Sudan,SDN,Switzerland,CHE,10,5,10,16,41
2020,South Sudan,SSD,Switzerland,CHE,0,11,0,0,11
2020,Syrian Arab Rep.,SYR,Switzerland,CHE,676,854,205,72,1807
2020,Togo,TGO,Switzerland,CHE,10,0,10,0,20
2020,Tunisia,TUN,Switzerland,CHE,5,0,30,88,123
2020,Turkey,TUR,Switzerland,CHE,1524,216,373,86,2199
2020,Uganda,UGA,Switzerland,CHE,0,12,11,0,23
2020,Ukraine,UKR,Switzerland,CHE,5,0,23,15,43
2020,Uzbekistan,UZB,Switzerland,CHE,0,5,0,0,5
2020,Venezuela (Bolivarian Republic of),VEN,Switzerland,CHE,5,15,11,0,31
2020,Western Sahara,ESH,Switzerland,CHE,0,0,0,5,5
2020,Yemen,YEM,Switzerland,CHE,20,12,0,0,32
2020,Zimbabwe,ZWE,Switzerland,CHE,0,0,5,0,5
2020,Stateless,XXA,Switzerland,CHE,5,0,0,0,5
2020,Burundi,BDI,United Rep. of Tanzania,TZA,30,0,0,1497,1527
2020,Dem. Rep. of the Congo,COD,United Rep. of Tanzania,TZA,20,0,0,0,20
2020,South Sudan,SSD,United Rep. of Tanzania,TZA,0,0,0,10,10
2020,Syrian Arab Rep.,SYR,United Rep. of Tanzania,TZA,0,0,0,5,5
2020,Myanmar,MMR,Thailand,THA,15,0,0,0,15
2020,Burkina Faso,BFA,Togo,TGO,0,0,0,5,5
2020,Central African Rep.,CAF,Togo,TGO,5,0,28,0,33
2020,Cameroon,CMR,Togo,TGO,0,0,0,5,5
2020,Congo,COG,Togo,TGO,5,0,5,0,10
2020,Dem. Rep. of the Congo,COD,Togo,TGO,5,0,0,0,5
2020,Cote d'Ivoire,CIV,Togo,TGO,10,0,18,152,180
2020,Lebanon,LBN,Togo,TGO,5,0,0,19,24
2020,Mali,MLI,Togo,TGO,0,0,13,0,13
2020,Nigeria,NGA,Togo,TGO,0,0,0,10,10
2020,Sudan,SDN,Togo,TGO,0,0,0,5,5
2020,Syrian Arab Rep.,SYR,Togo,TGO,11,0,0,0,11
2020,Turkey,TUR,Togo,TGO,10,0,5,0,15
2020,Afghanistan,AFG,Turkey,TUR,3249,0,5348,8432,17029
2020,Iran (Islamic Rep. of),IRN,Turkey,TUR,1231,0,791,3081,5103
2020,Iraq,IRQ,Turkey,TUR,3887,0,4196,12976,21059
2020,Egypt,EGY,Uganda,UGA,5,0,0,0,5
2020,Burundi,BDI,Uganda,UGA,3624,0,161,462,4247
2020,Dem. Rep. of the Congo,COD,Uganda,UGA,6999,0,288,913,8200
2020,Eritrea,ERI,Uganda,UGA,1838,0,152,189,2179
2020,Ethiopia,ETH,Uganda,UGA,151,0,16,55,222
2020,Pakistan,PAK,Uganda,UGA,0,0,0,19,19
2020,Rwanda,RWA,Uganda,UGA,282,0,126,13,421
2020,Somalia,SOM,Uganda,UGA,4250,0,5,347,4602
2020,Sudan,SDN,Uganda,UGA,58,0,0,0,58
2020,South Sudan,SSD,Uganda,UGA,68,0,0,147,215
2020,Syrian Arab Rep.,SYR,Uganda,UGA,10,0,0,0,10
2020,Turkey,TUR,Uganda,UGA,16,0,0,0,16
2020,Afghanistan,AFG,Ukraine,UKR,10,23,69,36,138
2020,Algeria,DZA,Ukraine,UKR,0,0,0,5,5
2020,Angola,AGO,Ukraine,UKR,0,0,0,5,5
2020,Egypt,EGY,Ukraine,UKR,0,0,0,5,5
2020,Azerbaijan,AZE,Ukraine,UKR,0,0,13,0,13
2020,Bangladesh,BGD,Ukraine,UKR,0,0,5,16,21
2020,Belarus,BLR,Ukraine,UKR,0,0,5,5,10
2020,China,CHN,Ukraine,UKR,0,0,5,0,5
2020,Cameroon,CMR,Ukraine,UKR,0,0,5,19,24
2020,Congo,COG,Ukraine,UKR,0,0,0,5,5
2020,Dem. Rep. of the Congo,COD,Ukraine,UKR,0,0,5,11,16
2020,Eritrea,ERI,Ukraine,UKR,0,0,0,5,5
2020,Gambia,GMB,Ukraine,UKR,0,0,0,5,5
2020,Georgia,GEO,Ukraine,UKR,0,0,5,0,5
2020,Ghana,GHA,Ukraine,UKR,0,0,5,12,17
2020,Guinea,GIN,Ukraine,UKR,0,0,0,11,11
2020,Cote d'Ivoire,CIV,Ukraine,UKR,0,0,0,11,11
2020,India,IND,Ukraine,UKR,0,0,5,5,10
2020,Iran (Islamic Rep. of),IRN,Ukraine,UKR,0,0,5,5,10
2020,Iraq,IRQ,Ukraine,UKR,0,0,13,5,18
2020,Jordan,JOR,Ukraine,UKR,0,0,5,0,5
2020,Kazakhstan,KAZ,Ukraine,UKR,5,0,5,0,10
2020,Kyrgyzstan,KGZ,Ukraine,UKR,5,0,0,0,5
2020,Libya,LBY,Ukraine,UKR,0,5,0,0,5
2020,Lebanon,LBN,Ukraine,UKR,0,0,5,5,10
2020,Sri Lanka,LKA,Ukraine,UKR,0,0,5,0,5
2020,Niger,NER,Ukraine,UKR,0,0,0,5,5
2020,Nigeria,NGA,Ukraine,UKR,0,0,27,55,82
2020,Pakistan,PAK,Ukraine,UKR,0,0,11,0,11
2020,Russian Federation,RUS,Ukraine,UKR,19,23,65,24,131
2020,Senegal,SEN,Ukraine,UKR,0,0,0,5,5
2020,Sierra Leone,SLE,Ukraine,UKR,0,0,0,5,5
2020,Somalia,SOM,Ukraine,UKR,0,5,10,12,27
2020,Sudan,SDN,Ukraine,UKR,0,0,0,11,11
2020,Syrian Arab Rep.,SYR,Ukraine,UKR,0,20,45,10,75
2020,Tajikistan,TJK,Ukraine,UKR,0,5,31,5,41
2020,Turkey,TUR,Ukraine,UKR,0,0,5,0,5
2020,Uzbekistan,UZB,Ukraine,UKR,0,0,5,11,16
2020,Yemen,YEM,Ukraine,UKR,0,0,5,10,15
2020,Stateless,XXA,Ukraine,UKR,0,5,10,0,15
2020,Egypt,EGY,Uruguay,URY,0,0,0,5,5
2020,Bangladesh,BGD,Uruguay,URY,0,0,0,24,24
2020,Brazil,BRA,Uruguay,URY,0,0,0,5,5
2020,Cameroon,CMR,Uruguay,URY,5,0,0,0,5
2020,Colombia,COL,Uruguay,URY,0,0,0,13,13
2020,Cuba,CUB,Uruguay,URY,0,0,17,5506,5523
2020,Dominican Rep.,DOM,Uruguay,URY,0,0,0,37,37
2020,Guinea,GIN,Uruguay,URY,0,0,0,5,5
2020,Haiti,HTI,Uruguay,URY,0,0,0,5,5
2020,Morocco,MAR,Uruguay,URY,0,0,0,12,12
2020,Nicaragua,NIC,Uruguay,URY,0,0,0,5,5
2020,Nigeria,NGA,Uruguay,URY,0,0,0,5,5
2020,Pakistan,PAK,Uruguay,URY,0,0,0,5,5
2020,Russian Federation,RUS,Uruguay,URY,0,0,0,5,5
2020,El Salvador,SLV,Uruguay,URY,5,0,0,0,5
2020,Senegal,SEN,Uruguay,URY,0,0,0,152,152
2020,Syrian Arab Rep.,SYR,Uruguay,URY,0,0,0,5,5
2020,Venezuela (Bolivarian Republic of),VEN,Uruguay,URY,153,0,0,84,237
2020,Yemen,YEM,Uruguay,URY,0,0,0,5,5
2020,Colombia,COL,Venezuela (Bolivarian Republic of),VEN,314,0,49,0,363
2020,Syrian Arab Rep.,SYR,Venezuela (Bolivarian Republic of),VEN,29,0,0,0,29
2020,Burundi,BDI,Zambia,ZMB,615,0,61,1261,1937
2020,Congo,COG,Zambia,ZMB,10,0,0,0,10
2020,Dem. Rep. of the Congo,COD,Zambia,ZMB,4664,0,209,1397,6270
2020,Eritrea,ERI,Zambia,ZMB,10,0,0,13,23
2020,Ethiopia,ETH,Zambia,ZMB,0,0,0,14,14
2020,Rwanda,RWA,Zambia,ZMB,5,0,0,39,44
2020,Sierra Leone,SLE,Zambia,ZMB,0,0,0,5,5
2020,Somalia,SOM,Zambia,ZMB,15,0,0,5,20
2020,South Sudan,SSD,Zambia,ZMB,0,0,0,5,5
2020,Syrian Arab Rep.,SYR,Zambia,ZMB,5,0,0,0,5
2020,Turkey,TUR,Zambia,ZMB,29,0,0,0,29
2020,Uganda,UGA,Zambia,ZMB,58,0,11,0,69
2020,Burundi,BDI,Zimbabwe,ZWE,5,0,0,5,10
2020,Dem. Rep. of the Congo,COD,Zimbabwe,ZWE,198,0,93,127,418
2020,Rwanda,RWA,Zimbabwe,ZWE,0,0,0,5,5
2021,Afghanistan,AFG,Albania,ALB,5,0,0,0,5
2021,Syrian Arab Rep.,SYR,Albania,ALB,5,0,0,0,5
2021,Turkey,TUR,Angola,AGO,0,0,0,5,5
2021,Algeria,DZA,Argentina,ARG,0,0,5,0,5
2021,Armenia,ARM,Argentina,ARG,0,0,11,0,11
2021,China,CHN,Argentina,ARG,0,0,10,0,10
2021,Cameroon,CMR,Argentina,ARG,5,0,0,0,5
2021,Colombia,COL,Argentina,ARG,5,0,0,5,10
2021,Cuba,CUB,Argentina,ARG,5,0,18,27,50
2021,Dominican Rep.,DOM,Argentina,ARG,5,0,40,14,59
2021,Ecuador,ECU,Argentina,ARG,0,0,5,0,5
2021,Ghana,GHA,Argentina,ARG,0,0,5,0,5
2021,Haiti,HTI,Argentina,ARG,0,0,17,20,37
2021,India,IND,Argentina,ARG,0,0,14,0,14
2021,Iran (Islamic Rep. of),IRN,Argentina,ARG,5,0,0,0,5
2021,Libya,LBY,Argentina,ARG,5,0,0,0,5
2021,Nicaragua,NIC,Argentina,ARG,5,0,0,0,5
2021,Nigeria,NGA,Argentina,ARG,0,0,5,0,5
2021,Paraguay,PRY,Argentina,ARG,10,0,0,0,10
2021,Peru,PER,Argentina,ARG,5,0,0,5,10
2021,South Africa,ZAF,Argentina,ARG,0,0,5,0,5
2021,Russian Federation,RUS,Argentina,ARG,5,0,5,0,10
2021,Senegal,SEN,Argentina,ARG,0,0,25,14,39
2021,Spain,ESP,Argentina,ARG,0,0,0,5,5
2021,Syrian Arab Rep.,SYR,Argentina,ARG,28,0,0,0,28
2021,Ukraine,UKR,Argentina,ARG,5,0,0,0,5
2021,Venezuela (Bolivarian Republic of),VEN,Argentina,ARG,5,0,0,146,151
2021,Afghanistan,AFG,Armenia,ARM,0,0,0,5,5
2021,Azerbaijan,AZE,Armenia,ARM,0,0,5,0,5
2021,Cuba,CUB,Armenia,ARM,0,0,5,5,10
2021,Georgia,GEO,Armenia,ARM,0,0,0,5,5
2021,India,IND,Armenia,ARM,0,0,5,5,10
2021,Iran (Islamic Rep. of),IRN,Armenia,ARM,40,0,42,35,117
2021,Iraq,IRQ,Armenia,ARM,13,0,0,0,13
2021,Jordan,JOR,Armenia,ARM,0,0,0,5,5
2021,Lebanon,LBN,Armenia,ARM,0,0,5,0,5
2021,Russian Federation,RUS,Armenia,ARM,0,0,5,0,5
2021,Syrian Arab Rep.,SYR,Armenia,ARM,22,0,0,0,22
2021,Turkey,TUR,Armenia,ARM,5,0,0,0,5
2021,Ukraine,UKR,Armenia,ARM,0,0,0,5,5
2021,Afghanistan,AFG,Australia,AUS,161,0,31,0,192
2021,Albania,ALB,Australia,AUS,0,0,10,0,10
2021,Algeria,DZA,Australia,AUS,5,0,0,0,5
2021,Egypt,EGY,Australia,AUS,47,0,18,0,65
2021,Bangladesh,BGD,Australia,AUS,0,0,83,0,83
2021,Cambodia,KHM,Australia,AUS,5,0,57,0,62
2021,China,CHN,Australia,AUS,102,0,3995,0,4097
2021,Congo,COG,Australia,AUS,15,0,13,0,28
2021,Eritrea,ERI,Australia,AUS,5,0,0,0,5
2021,Ethiopia,ETH,Australia,AUS,28,0,16,0,44
2021,Palestinian,PSE,Australia,AUS,10,0,0,0,10
2021,United Kingdom of Great Britain and Northern Ireland,GBR,Australia,AUS,0,0,17,0,17
2021,Ghana,GHA,Australia,AUS,5,0,0,0,5
2021,India,IND,Australia,AUS,17,0,1321,0,1338
2021,Indonesia,IDN,Australia,AUS,13,0,296,0,309
2021,Ireland,IRL,Australia,AUS,0,0,5,0,5
2021,Iran (Islamic Rep. of),IRN,Australia,AUS,1228,0,534,0,1762
2021,Iraq,IRQ,Australia,AUS,38,0,67,0,105
2021,Israel,ISR,Australia,AUS,0,0,5,0,5
2021,Jordan,JOR,Australia,AUS,5,0,14,0,19
2021,Japan,JPN,Australia,AUS,0,0,5,0,5
2021,Rep. of Korea,KOR,Australia,AUS,0,0,24,0,24
2021,Lebanon,LBN,Australia,AUS,5,0,5,0,10
2021,Sri Lanka,LKA,Australia,AUS,60,0,399,0,459
2021,Malaysia,MYS,Australia,AUS,60,0,3747,0,3807
2021,Myanmar,MMR,Australia,AUS,16,0,24,0,40
2021,Nepal,NPL,Australia,AUS,0,0,5,0,5
2021,Nigeria,NGA,Australia,AUS,42,0,44,0,86
2021,Pakistan,PAK,Australia,AUS,193,0,372,0,565
2021,Poland,POL,Australia,AUS,0,0,5,0,5
2021,Somalia,SOM,Australia,AUS,0,0,5,0,5
2021,Viet Nam,VNM,Australia,AUS,24,0,1298,0,1322
2021,Sudan,SDN,Australia,AUS,5,0,5,0,10
2021,South Sudan,SSD,Australia,AUS,5,0,5,0,10
2021,Syrian Arab Rep.,SYR,Australia,AUS,29,0,5,0,34
2021,Thailand,THA,Australia,AUS,5,0,208,0,213
2021,Timor-Leste,TLS,Australia,AUS,0,0,168,0,168
2021,United States of America,USA,Australia,AUS,0,0,5,0,5
2021,Yemen,YEM,Australia,AUS,20,0,0,0,20
2021,Stateless,XXA,Australia,AUS,100,0,138,0,238
2021,Iran (Islamic Rep. of),IRN,Azerbaijan,AZE,5,0,0,0,5
2021,Dem. Rep. of the Congo,COD,Burundi,BDI,930,0,396,384,1710
2021,Rwanda,RWA,Burundi,BDI,10,0,0,0,10
2021,Afghanistan,AFG,Belgium,BEL,815,355,1190,0,2360
2021,Albania,ALB,Belgium,BEL,15,5,465,0,485
2021,Algeria,DZA,Belgium,BEL,0,0,70,0,70
2021,Angola,AGO,Belgium,BEL,5,0,110,0,115
2021,Egypt,EGY,Belgium,BEL,0,0,40,0,40
2021,Armenia,ARM,Belgium,BEL,10,0,95,0,105
2021,Azerbaijan,AZE,Belgium,BEL,5,0,10,0,15
2021,Burundi,BDI,Belgium,BEL,635,0,25,0,660
2021,Belgium,BEL,Belgium,BEL,0,0,5,0,5
2021,Benin,BEN,Belgium,BEL,0,0,25,0,25
2021,Bangladesh,BGD,Belgium,BEL,0,0,15,0,15
2021,Burkina Faso,BFA,Belgium,BEL,10,0,45,0,55
2021,Belarus,BLR,Belgium,BEL,5,0,15,0,20
2021,Brazil,BRA,Belgium,BEL,5,0,220,0,225
2021,Bosnia and Herzegovina,BIH,Belgium,BEL,0,0,30,0,30
2021,Chad,TCD,Belgium,BEL,0,0,35,0,35
2021,China,CHN,Belgium,BEL,55,0,45,0,100
2021,Chile,CHL,Belgium,BEL,0,0,5,0,5
2021,Cameroon,CMR,Belgium,BEL,105,10,265,0,380
2021,Congo,COG,Belgium,BEL,0,0,15,0,15
2021,Dem. Rep. of the Congo,COD,Belgium,BEL,65,0,355,0,420
2021,Colombia,COL,Belgium,BEL,30,0,305,0,335
2021,Cuba,CUB,Belgium,BEL,0,0,10,0,10
2021,Djibouti,DJI,Belgium,BEL,10,0,15,0,25
2021,Equatorial Guinea,GNQ,Belgium,BEL,0,0,5,0,5
2021,Eritrea,ERI,Belgium,BEL,1210,0,180,0,1390
2021,Ethiopia,ETH,Belgium,BEL,0,0,25,0,25
2021,Gabon,GAB,Belgium,BEL,0,0,10,0,10
2021,Gambia,GMB,Belgium,BEL,5,0,70,0,75
2021,Palestinian,PSE,Belgium,BEL,1880,5,1215,0,3100
2021,Georgia,GEO,Belgium,BEL,20,0,190,0,210
2021,Ghana,GHA,Belgium,BEL,0,0,25,0,25
2021,Guinea-Bissau,GNB,Belgium,BEL,0,0,5,0,5
2021,Guatemala,GTM,Belgium,BEL,0,0,30,0,30
2021,Guinea,GIN,Belgium,BEL,210,0,530,0,740
2021,Honduras,HND,Belgium,BEL,0,0,10,0,10
2021,Cote d'Ivoire,CIV,Belgium,BEL,30,0,110,0,140
2021,India,IND,Belgium,BEL,0,0,10,0,10
2021,Iran (Islamic Rep. of),IRN,Belgium,BEL,195,0,375,0,570
2021,Iraq,IRQ,Belgium,BEL,130,10,785,0,925
2021,Jordan,JOR,Belgium,BEL,0,0,15,0,15
2021,Kazakhstan,KAZ,Belgium,BEL,0,0,25,0,25
2021,Kenya,KEN,Belgium,BEL,0,0,10,0,10
2021,Kyrgyzstan,KGZ,Belgium,BEL,5,0,20,0,25
2021,Liberia,LBR,Belgium,BEL,0,0,15,0,15
2021,Libya,LBY,Belgium,BEL,15,55,20,0,90
2021,Lebanon,LBN,Belgium,BEL,10,0,80,0,90
2021,Sri Lanka,LKA,Belgium,BEL,5,0,60,0,65
2021,Mauritania,MRT,Belgium,BEL,5,0,85,0,90
2021,North Macedonia,MKD,Belgium,BEL,5,0,85,0,90
2021,Rep. of Moldova,MDA,Belgium,BEL,0,0,5,0,5
2021,Mali,MLI,Belgium,BEL,0,0,55,0,55
2021,Mongolia,MNG,Belgium,BEL,0,0,5,0,5
2021,Morocco,MAR,Belgium,BEL,25,0,65,0,90
2021,Mozambique,MOZ,Belgium,BEL,0,0,5,0,5
2021,Montenegro,MNE,Belgium,BEL,0,0,5,0,5
2021,Niger,NER,Belgium,BEL,10,0,65,0,75
2021,Nicaragua,NIC,Belgium,BEL,10,0,15,0,25
2021,Nigeria,NGA,Belgium,BEL,0,0,140,0,140
2021,Pakistan,PAK,Belgium,BEL,45,0,150,0,195
2021,Peru,PER,Belgium,BEL,0,0,30,0,30
2021,Russian Federation,RUS,Belgium,BEL,105,0,205,0,310
2021,Rwanda,RWA,Belgium,BEL,45,0,250,0,295
2021,El Salvador,SLV,Belgium,BEL,50,50,1050,0,1150
2021,Serbia and Kosovo: S/RES/1244 (1999),SRB,Belgium,BEL,10,0,200,0,210
2021,Senegal,SEN,Belgium,BEL,25,0,140,0,165
2021,Sierra Leone,SLE,Belgium,BEL,0,0,20,0,20
2021,Somalia,SOM,Belgium,BEL,170,65,350,0,585
2021,Viet Nam,VNM,Belgium,BEL,0,0,30,0,30
2021,Sudan,SDN,Belgium,BEL,40,0,90,0,130
2021,Suriname,SUR,Belgium,BEL,0,0,60,0,60
2021,Syrian Arab Rep.,SYR,Belgium,BEL,1340,155,670,0,2165
2021,United Rep. of Tanzania,TZA,Belgium,BEL,0,0,10,0,10
2021,Tajikistan,TJK,Belgium,BEL,0,0,5,0,5
2021,Togo,TGO,Belgium,BEL,0,0,45,0,45
2021,Tunisia,TUN,Belgium,BEL,15,0,20,0,35
2021,Turkey,TUR,Belgium,BEL,385,0,200,0,585
2021,Uganda,UGA,Belgium,BEL,0,0,10,0,10
2021,Ukraine,UKR,Belgium,BEL,35,0,55,0,90
2021,United States of America,USA,Belgium,BEL,0,0,5,0,5
2021,Venezuela (Bolivarian Republic of),VEN,Belgium,BEL,70,10,260,0,340
2021,Yemen,YEM,Belgium,BEL,50,130,20,0,200
2021,Stateless,XXA,Belgium,BEL,15,0,0,0,15
2021,Burkina Faso,BFA,Benin,BEN,179,0,0,0,179
2021,Central African Rep.,CAF,Benin,BEN,22,0,0,0,22
2021,Cameroon,CMR,Benin,BEN,25,0,0,0,25
2021,Dem. Rep. of the Congo,COD,Benin,BEN,0,0,0,5,5
2021,Mali,MLI,Benin,BEN,5,0,0,0,5
2021,Syrian Arab Rep.,SYR,Benin,BEN,5,0,0,0,5
2021,Yemen,YEM,Benin,BEN,5,0,0,0,5
2021,Central African Rep.,CAF,Burkina Faso,BFA,5,0,0,0,5
2021,South Sudan,SSD,Burkina Faso,BFA,5,0,0,0,5
2021,Turkey,TUR,Burkina Faso,BFA,25,0,0,0,25
2021,Afghanistan,AFG,Belarus,BLR,0,5,0,17,22
2021,Armenia,ARM,Belarus,BLR,0,5,0,0,5
2021,Cameroon,CMR,Belarus,BLR,0,0,5,0,5
2021,Congo,COG,Belarus,BLR,0,0,0,5,5
2021,Dem. Rep. of the Congo,COD,Belarus,BLR,0,0,0,13,13
2021,Guinea,GIN,Belarus,BLR,0,0,5,5,10
2021,Iran (Islamic Rep. of),IRN,Belarus,BLR,0,0,0,5,5
2021,Iraq,IRQ,Belarus,BLR,0,0,5,32,37
2021,Lebanon,LBN,Belarus,BLR,5,0,0,0,5
2021,Sri Lanka,LKA,Belarus,BLR,0,0,5,0,5
2021,Lithuania,LTU,Belarus,BLR,0,0,0,5,5
2021,Rep. of Moldova,MDA,Belarus,BLR,0,0,0,5,5
2021,Nigeria,NGA,Belarus,BLR,0,0,13,5,18
2021,Russian Federation,RUS,Belarus,BLR,0,0,13,0,13
2021,Somalia,SOM,Belarus,BLR,0,0,0,13,13
2021,Syrian Arab Rep.,SYR,Belarus,BLR,0,14,0,0,14
2021,Turkmenistan,TKM,Belarus,BLR,0,0,5,0,5
2021,Turkey,TUR,Belarus,BLR,16,0,0,0,16
2021,Ukraine,UKR,Belarus,BLR,0,252,15,16,283
2021,United States of America,USA,Belarus,BLR,0,0,5,0,5
2021,Yemen,YEM,Belarus,BLR,0,5,0,14,19
2021,Colombia,COL,Bolivia (Plurinational State of),BOL,0,0,5,5,10
2021,Peru,PER,Bolivia (Plurinational State of),BOL,5,0,5,0,10
2021,Venezuela (Bolivarian Republic of),VEN,Bolivia (Plurinational State of),BOL,0,0,167,41,208
2021,Dem. Rep. of the Congo,COD,Botswana,BWA,13,0,13,0,26
2021,Zimbabwe,ZWE,Botswana,BWA,0,0,174,0,174
2021,Afghanistan,AFG,Brazil,BRA,10,0,0,0,10
2021,Angola,AGO,Brazil,BRA,10,0,118,0,128
2021,Egypt,EGY,Brazil,BRA,13,0,0,0,13
2021,Argentina,ARG,Brazil,BRA,0,0,5,0,5
2021,Benin,BEN,Brazil,BRA,0,0,5,0,5
2021,Bangladesh,BGD,Brazil,BRA,5,0,14,0,19
2021,Bolivia (Plurinational State of),BOL,Brazil,BRA,0,0,5,0,5
2021,China,CHN,Brazil,BRA,16,0,5,0,21
2021,Cameroon,CMR,Brazil,BRA,14,0,0,0,14
2021,Dem. Rep. of the Congo,COD,Brazil,BRA,29,0,22,5,56
2021,Colombia,COL,Brazil,BRA,5,0,5,0,10
2021,Cuba,CUB,Brazil,BRA,365,0,46,0,411
2021,Cabo Verde,CPV,Brazil,BRA,0,0,5,0,5
2021,Dominican Rep.,DOM,Brazil,BRA,0,0,10,0,10
2021,Gambia,GMB,Brazil,BRA,0,0,5,0,5
2021,Palestinian,PSE,Brazil,BRA,15,0,0,5,20
2021,Ghana,GHA,Brazil,BRA,5,0,13,0,18
2021,Guinea-Bissau,GNB,Brazil,BRA,0,0,58,0,58
2021,Guinea,GIN,Brazil,BRA,5,0,0,0,5
2021,Honduras,HND,Brazil,BRA,0,0,5,0,5
2021,India,IND,Brazil,BRA,5,0,0,0,5
2021,Iraq,IRQ,Brazil,BRA,46,0,0,0,46
2021,Jordan,JOR,Brazil,BRA,0,0,5,0,5
2021,Lebanon,LBN,Brazil,BRA,5,0,36,5,46
2021,Mauritania,MRT,Brazil,BRA,10,0,0,0,10
2021,Mexico,MEX,Brazil,BRA,5,0,0,0,5
2021,Mali,MLI,Brazil,BRA,5,0,0,0,5
2021,Morocco,MAR,Brazil,BRA,0,0,12,0,12
2021,Mozambique,MOZ,Brazil,BRA,0,0,12,0,12
2021,Nicaragua,NIC,Brazil,BRA,21,0,0,0,21
2021,Nigeria,NGA,Brazil,BRA,10,0,13,0,23
2021,Pakistan,PAK,Brazil,BRA,19,0,10,0,29
2021,Philippines,PHL,Brazil,BRA,0,0,10,0,10
2021,Portugal,PRT,Brazil,BRA,0,0,5,0,5
2021,Russian Federation,RUS,Brazil,BRA,5,0,0,0,5
2021,Senegal,SEN,Brazil,BRA,5,0,5,0,10
2021,Sierra Leone,SLE,Brazil,BRA,5,0,0,0,5
2021,Somalia,SOM,Brazil,BRA,5,0,0,0,5
2021,Sudan,SDN,Brazil,BRA,5,0,0,0,5
2021,Syrian Arab Rep.,SYR,Brazil,BRA,69,0,0,73,142
2021,Togo,TGO,Brazil,BRA,13,0,0,0,13
2021,Tunisia,TUN,Brazil,BRA,0,0,5,0,5
2021,Turkey,TUR,Brazil,BRA,0,0,11,0,11
2021,Venezuela (Bolivarian Republic of),VEN,Brazil,BRA,2385,0,0,7542,9927
2021,Yemen,YEM,Brazil,BRA,5,0,0,0,5
2021,Afghanistan,AFG,Bosnia and Herzegovina,BIH,0,0,5,29,34
2021,Algeria,DZA,Bosnia and Herzegovina,BIH,0,0,0,5,5
2021,Bangladesh,BGD,Bosnia and Herzegovina,BIH,0,0,0,5,5
2021,Cameroon,CMR,Bosnia and Herzegovina,BIH,0,0,0,5,5
2021,Palestinian,PSE,Bosnia and Herzegovina,BIH,0,0,0,5,5
2021,India,IND,Bosnia and Herzegovina,BIH,0,5,0,0,5
2021,Iran (Islamic Rep. of),IRN,Bosnia and Herzegovina,BIH,5,0,12,5,22
2021,Iraq,IRQ,Bosnia and Herzegovina,BIH,0,0,0,43,43
2021,Libya,LBY,Bosnia and Herzegovina,BIH,0,0,0,5,5
2021,North Macedonia,MKD,Bosnia and Herzegovina,BIH,0,0,5,0,5
2021,Morocco,MAR,Bosnia and Herzegovina,BIH,0,0,0,19,19
2021,Pakistan,PAK,Bosnia and Herzegovina,BIH,0,0,14,26,40
2021,Russian Federation,RUS,Bosnia and Herzegovina,BIH,0,0,0,5,5
2021,Somalia,SOM,Bosnia and Herzegovina,BIH,0,0,0,5,5
2021,Syrian Arab Rep.,SYR,Bosnia and Herzegovina,BIH,0,5,0,5,10
2021,Turkey,TUR,Bosnia and Herzegovina,BIH,0,20,5,22,47
2021,Yemen,YEM,Bosnia and Herzegovina,BIH,0,0,0,5,5
2021,Guatemala,GTM,Belize,BLZ,0,0,0,5,5
2021,Honduras,HND,Belize,BLZ,0,5,5,12,22
2021,Nicaragua,NIC,Belize,BLZ,0,5,0,0,5
2021,El Salvador,SLV,Belize,BLZ,0,46,10,78,134
2021,Pakistan,PAK,Cambodia,KHM,0,0,0,5,5
2021,Afghanistan,AFG,Canada,CAN,363,0,56,39,458
2021,Albania,ALB,Canada,CAN,82,0,37,5,124
2021,Algeria,DZA,Canada,CAN,289,0,124,53,466
2021,Angola,AGO,Canada,CAN,252,0,206,19,477
2021,Antigua and Barbuda,ATG,Canada,CAN,0,0,11,0,11
2021,Egypt,EGY,Canada,CAN,442,0,86,16,544
2021,Argentina,ARG,Canada,CAN,13,0,17,0,30
2021,Armenia,ARM,Canada,CAN,5,0,5,0,10
2021,Austria,AUT,Canada,CAN,5,0,0,0,5
2021,Azerbaijan,AZE,Canada,CAN,101,0,0,5,106
2021,Bahrain,BHR,Canada,CAN,12,0,0,0,12
2021,Barbados,BRB,Canada,CAN,55,0,11,10,76
2021,Burundi,BDI,Canada,CAN,161,0,11,22,194
2021,Benin,BEN,Canada,CAN,17,0,5,5,27
2021,Bangladesh,BGD,Canada,CAN,493,0,172,19,684
2021,Bahamas,BHS,Canada,CAN,209,0,58,29,296
2021,Bhutan,BTN,Canada,CAN,5,0,0,0,5
2021,Burkina Faso,BFA,Canada,CAN,38,0,15,15,68
2021,Belarus,BLR,Canada,CAN,14,0,0,0,14
2021,Bolivia (Plurinational State of),BOL,Canada,CAN,10,0,0,0,10
2021,Brazil,BRA,Canada,CAN,45,0,126,40,211
2021,Bosnia and Herzegovina,BIH,Canada,CAN,5,0,0,0,5
2021,Bulgaria,BGR,Canada,CAN,24,0,0,10,34
2021,Cambodia,KHM,Canada,CAN,13,0,0,0,13
2021,Central African Rep.,CAF,Canada,CAN,5,0,0,5,10
2021,Chad,TCD,Canada,CAN,208,0,16,5,229
2021,China,CHN,Canada,CAN,782,0,381,93,1256
2021,Chile,CHL,Canada,CAN,38,0,39,17,94
2021,Cameroon,CMR,Canada,CAN,282,0,54,52,388
2021,Congo,COG,Canada,CAN,52,0,20,11,83
2021,Dem. Rep. of the Congo,COD,Canada,CAN,489,0,261,117,867
2021,Colombia,COL,Canada,CAN,1778,0,389,123,2290
2021,Costa Rica,CRI,Canada,CAN,14,0,0,0,14
2021,Cuba,CUB,Canada,CAN,81,0,16,13,110
2021,Czechia,CZE,Canada,CAN,17,0,0,15,32
2021,Denmark,DNK,Canada,CAN,5,0,0,0,5
2021,Djibouti,DJI,Canada,CAN,52,0,10,5,67
2021,Dominica,DMA,Canada,CAN,0,0,5,0,5
2021,Dominican Rep.,DOM,Canada,CAN,32,0,17,10,59
2021,Ecuador,ECU,Canada,CAN,23,0,31,5,59
2021,Equatorial Guinea,GNQ,Canada,CAN,5,0,0,0,5
2021,Eritrea,ERI,Canada,CAN,163,0,27,12,202
2021,Ethiopia,ETH,Canada,CAN,431,0,46,11,488
2021,Finland,FIN,Canada,CAN,5,0,0,0,5
2021,France,FRA,Canada,CAN,0,0,13,0,13
2021,Gabon,GAB,Canada,CAN,13,0,0,0,13
2021,Gambia,GMB,Canada,CAN,27,0,14,5,46
2021,Palestinian,PSE,Canada,CAN,590,0,44,10,644
2021,United Kingdom of Great Britain and Northern Ireland,GBR,Canada,CAN,5,0,5,0,10
2021,Georgia,GEO,Canada,CAN,74,0,23,11,108
2021,Germany,DEU,Canada,CAN,0,0,5,5,10
2021,Ghana,GHA,Canada,CAN,77,0,50,20,147
2021,Greece,GRC,Canada,CAN,5,0,5,0,10
2021,Grenada,GRD,Canada,CAN,0,0,5,0,5
2021,Guatemala,GTM,Canada,CAN,66,0,38,24,128
2021,Guinea,GIN,Canada,CAN,128,0,18,27,173
2021,Guyana,GUY,Canada,CAN,19,0,10,5,34
2021,Haiti,HTI,Canada,CAN,1019,0,758,498,2275
2021,"China, Hong Kong SAR",HKG,Canada,CAN,17,0,11,0,28
2021,Honduras,HND,Canada,CAN,172,0,65,21,258
2021,Hungary,HUN,Canada,CAN,186,0,30,24,240
2021,Cote d'Ivoire,CIV,Canada,CAN,78,0,50,16,144
2021,India,IND,Canada,CAN,860,0,1424,237,2521
2021,Indonesia,IDN,Canada,CAN,23,0,25,0,48
2021,Ireland,IRL,Canada,CAN,0,0,11,10,21
2021,Iran (Islamic Rep. of),IRN,Canada,CAN,2315,0,110,37,2462
2021,Iraq,IRQ,Canada,CAN,236,0,51,11,298
2021,Israel,ISR,Canada,CAN,22,0,11,5,38
2021,Italy,ITA,Canada,CAN,5,0,33,5,43
2021,Jamaica,JAM,Canada,CAN,76,0,71,33,180
2021,Jordan,JOR,Canada,CAN,308,0,83,23,414
2021,Japan,JPN,Canada,CAN,0,0,5,0,5
2021,Kazakhstan,KAZ,Canada,CAN,33,0,11,0,44
2021,Kenya,KEN,Canada,CAN,171,0,106,58,335
2021,Kyrgyzstan,KGZ,Canada,CAN,11,0,0,0,11
2021,Rep. of Korea,KOR,Canada,CAN,0,0,0,12,12
2021,Dem. People's Rep. of Korea,PRK,Canada,CAN,0,0,0,5,5
2021,Kuwait,KWT,Canada,CAN,41,0,0,0,41
2021,Liberia,LBR,Canada,CAN,60,0,32,12,104
2021,Libya,LBY,Canada,CAN,159,0,17,10,186
2021,Saint Lucia,LCA,Canada,CAN,10,0,5,0,15
2021,Lebanon,LBN,Canada,CAN,297,0,92,22,411
2021,Lesotho,LSO,Canada,CAN,0,0,5,0,5
2021,Sri Lanka,LKA,Canada,CAN,604,0,93,21,718
2021,Latvia,LVA,Canada,CAN,5,0,0,0,5
2021,Mauritania,MRT,Canada,CAN,92,0,13,10,115
2021,North Macedonia,MKD,Canada,CAN,0,0,5,0,5
2021,Rep. of Moldova,MDA,Canada,CAN,5,0,0,0,5
2021,Mexico,MEX,Canada,CAN,1012,0,1448,411,2871
2021,Mali,MLI,Canada,CAN,45,0,11,5,61
2021,Malaysia,MYS,Canada,CAN,0,0,14,0,14
2021,Malawi,MWI,Canada,CAN,22,0,15,5,42
2021,Mongolia,MNG,Canada,CAN,31,0,0,0,31
2021,Morocco,MAR,Canada,CAN,36,0,15,16,67
2021,Malta,MLT,Canada,CAN,5,0,0,0,5
2021,Mauritius,MUS,Canada,CAN,0,0,5,5,10
2021,Myanmar,MMR,Canada,CAN,10,0,0,0,10
2021,Namibia,NAM,Canada,CAN,0,0,0,11,11
2021,Nepal,NPL,Canada,CAN,116,0,59,0,175
2021,Netherlands,NLD,Canada,CAN,0,0,5,0,5
2021,Niger,NER,Canada,CAN,16,0,10,5,31
2021,Nicaragua,NIC,Canada,CAN,356,0,23,5,384
2021,Nigeria,NGA,Canada,CAN,2057,0,1427,1701,5185
2021,Oman,OMN,Canada,CAN,5,0,0,0,5
2021,Pakistan,PAK,Canada,CAN,1250,0,635,52,1937
2021,Peru,PER,Canada,CAN,42,0,30,10,82
2021,Philippines,PHL,Canada,CAN,26,0,84,10,120
2021,Poland,POL,Canada,CAN,10,0,16,31,57
2021,Portugal,PRT,Canada,CAN,0,0,29,5,34
2021,Qatar,QAT,Canada,CAN,5,0,0,0,5
2021,Romania,ROU,Canada,CAN,73,0,41,210,324
2021,South Africa,ZAF,Canada,CAN,54,0,39,11,104
2021,Russian Federation,RUS,Canada,CAN,103,0,23,5,131
2021,Rwanda,RWA,Canada,CAN,282,0,47,49,378
2021,El Salvador,SLV,Canada,CAN,232,0,27,12,271
2021,Saudi Arabia,SAU,Canada,CAN,91,0,5,10,106
2021,Serbia and Kosovo: S/RES/1244 (1999),SRB,Canada,CAN,23,0,12,5,40
2021,Senegal,SEN,Canada,CAN,73,0,73,16,162
2021,Sierra Leone,SLE,Canada,CAN,15,0,10,5,30
2021,Somalia,SOM,Canada,CAN,64,0,68,39,171
2021,Spain,ESP,Canada,CAN,0,0,11,0,11
2021,Viet Nam,VNM,Canada,CAN,32,0,19,5,56
2021,Sudan,SDN,Canada,CAN,438,0,27,14,479
2021,Suriname,SUR,Canada,CAN,0,0,5,0,5
2021,South Sudan,SSD,Canada,CAN,10,0,0,0,10
2021,Slovakia,SVK,Canada,CAN,30,0,0,5,35
2021,Slovenia,SVN,Canada,CAN,0,0,5,0,5
2021,Eswatini,SWZ,Canada,CAN,5,0,0,0,5
2021,Syrian Arab Rep.,SYR,Canada,CAN,134,0,15,15,164
2021,United Rep. of Tanzania,TZA,Canada,CAN,53,0,19,10,82
2021,Thailand,THA,Canada,CAN,0,0,5,0,5
2021,Tajikistan,TJK,Canada,CAN,14,0,0,0,14
2021,Turkmenistan,TKM,Canada,CAN,5,0,0,0,5
2021,Togo,TGO,Canada,CAN,33,0,5,11,49
2021,Trinidad and Tobago,TTO,Canada,CAN,18,0,11,5,34
2021,Tunisia,TUN,Canada,CAN,25,0,27,13,65
2021,Turkey,TUR,Canada,CAN,863,0,30,21,914
2021,United Arab Emirates,ARE,Canada,CAN,0,0,5,0,5
2021,Uganda,UGA,Canada,CAN,354,0,42,59,455
2021,Ukraine,UKR,Canada,CAN,109,0,16,16,141
2021,Uruguay,URY,Canada,CAN,5,0,0,0,5
2021,United States of America,USA,Canada,CAN,30,0,818,259,1107
2021,Saint Vincent and the Grenadines,VCT,Canada,CAN,5,0,11,0,16
2021,Venezuela (Bolivarian Republic of),VEN,Canada,CAN,644,0,90,24,758
2021,Yemen,YEM,Canada,CAN,183,0,0,5,188
2021,Zambia,ZMB,Canada,CAN,12,0,0,5,17
2021,Zimbabwe,ZWE,Canada,CAN,164,0,32,31,227
2021,Stateless,XXA,Canada,CAN,154,0,5,0,159
2021,Cuba,CUB,Cayman Islands,CYM,11,0,0,0,11
2021,Colombia,COL,Chile,CHL,5,0,97,120,222
2021,Cuba,CUB,Chile,CHL,0,0,104,118,222
2021,Venezuela (Bolivarian Republic of),VEN,Chile,CHL,10,0,89,96,195
2021,Central African Rep.,CAF,Congo,COG,57,0,0,5,62
2021,Cameroon,CMR,Congo,COG,0,0,11,0,11
2021,Dem. Rep. of the Congo,COD,Congo,COG,5,0,103,0,108
2021,Mauritania,MRT,Congo,COG,0,0,26,0,26
2021,Rwanda,RWA,Congo,COG,0,0,27,0,27
2021,Sudan,SDN,Congo,COG,0,0,5,0,5
2021,Syrian Arab Rep.,SYR,Congo,COG,0,0,5,0,5
2021,Angola,AGO,Dem. Rep. of the Congo,COD,5,0,0,0,5
2021,Burundi,BDI,Dem. Rep. of the Congo,COD,215,0,12,0,227
2021,Central African Rep.,CAF,Dem. Rep. of the Congo,COD,43679,0,11,516,44206
2021,Cote d'Ivoire,CIV,Dem. Rep. of the Congo,COD,5,0,0,0,5
2021,Kenya,KEN,Dem. Rep. of the Congo,COD,0,0,0,5,5
2021,Rwanda,RWA,Dem. Rep. of the Congo,COD,0,0,0,59,59
2021,South Sudan,SSD,Dem. Rep. of the Congo,COD,636,0,0,0,636
2021,Syrian Arab Rep.,SYR,Dem. Rep. of the Congo,COD,5,0,0,0,5
2021,Cameroon,CMR,Colombia,COL,0,0,0,5,5
2021,Cuba,CUB,Colombia,COL,13,0,5,132,150
2021,Ecuador,ECU,Colombia,COL,0,0,0,5,5
2021,Palestinian,PSE,Colombia,COL,0,0,0,5,5
2021,Ghana,GHA,Colombia,COL,5,0,0,0,5
2021,Nigeria,NGA,Colombia,COL,0,0,0,5,5
2021,Syrian Arab Rep.,SYR,Colombia,COL,5,0,0,0,5
2021,Turkey,TUR,Colombia,COL,0,0,0,27,27
2021,Venezuela (Bolivarian Republic of),VEN,Colombia,COL,527,0,20,6066,6613
2021,Yemen,YEM,Colombia,COL,0,0,0,5,5
2021,Brazil,BRA,Costa Rica,CRI,0,0,11,28,39
2021,China,CHN,Costa Rica,CRI,0,0,0,10,10
2021,Chile,CHL,Costa Rica,CRI,0,0,0,5,5
2021,Dem. Rep. of the Congo,COD,Costa Rica,CRI,0,0,0,5,5
2021,Colombia,COL,Costa Rica,CRI,10,0,105,192,307
2021,Cuba,CUB,Costa Rica,CRI,48,0,568,157,773
2021,Dominican Rep.,DOM,Costa Rica,CRI,0,0,0,5,5
2021,Guatemala,GTM,Costa Rica,CRI,0,0,0,5,5
2021,Haiti,HTI,Costa Rica,CRI,0,0,41,158,199
2021,Honduras,HND,Costa Rica,CRI,0,0,23,43,66
2021,Jamaica,JAM,Costa Rica,CRI,0,0,10,0,10
2021,Nicaragua,NIC,Costa Rica,CRI,230,0,414,2886,3530
2021,Panama,PAN,Costa Rica,CRI,0,0,0,18,18
2021,El Salvador,SLV,Costa Rica,CRI,109,0,203,155,467
2021,Venezuela (Bolivarian Republic of),VEN,Costa Rica,CRI,227,0,431,445,1103
2021,Egypt,EGY,Cyprus,CYP,0,0,0,15,15
2021,Bangladesh,BGD,Cyprus,CYP,0,0,0,29,29
2021,Cameroon,CMR,Cyprus,CYP,0,0,0,5,5
2021,Congo,COG,Cyprus,CYP,0,0,0,5,5
2021,Palestinian,PSE,Cyprus,CYP,0,0,0,5,5
2021,Georgia,GEO,Cyprus,CYP,0,0,0,40,40
2021,India,IND,Cyprus,CYP,0,0,0,64,64
2021,Iran (Islamic Rep. of),IRN,Cyprus,CYP,0,0,0,10,10
2021,Nepal,NPL,Cyprus,CYP,0,0,0,5,5
2021,Pakistan,PAK,Cyprus,CYP,0,0,0,20,20
2021,Viet Nam,VNM,Cyprus,CYP,0,0,0,25,25
2021,Syrian Arab Rep.,SYR,Cyprus,CYP,0,0,0,23,23
2021,Afghanistan,AFG,Czechia,CZE,118,0,0,27,145
2021,Albania,ALB,Czechia,CZE,0,0,5,0,5
2021,Algeria,DZA,Czechia,CZE,0,0,17,5,22
2021,Egypt,EGY,Czechia,CZE,0,0,5,0,5
2021,Armenia,ARM,Czechia,CZE,0,0,18,25,43
2021,Azerbaijan,AZE,Czechia,CZE,5,0,21,11,37
2021,Bangladesh,BGD,Czechia,CZE,0,0,0,5,5
2021,Belarus,BLR,Czechia,CZE,41,5,10,19,75
2021,China,CHN,Czechia,CZE,0,42,0,32,74
2021,Cuba,CUB,Czechia,CZE,0,0,5,11,16
2021,Ethiopia,ETH,Czechia,CZE,0,0,0,5,5
2021,Georgia,GEO,Czechia,CZE,0,0,140,60,200
2021,Ghana,GHA,Czechia,CZE,0,5,0,0,5
2021,India,IND,Czechia,CZE,0,0,0,5,5
2021,Iran (Islamic Rep. of),IRN,Czechia,CZE,0,0,0,12,12
2021,Iraq,IRQ,Czechia,CZE,0,5,0,12,17
2021,Kazakhstan,KAZ,Czechia,CZE,0,0,17,27,44
2021,Kyrgyzstan,KGZ,Czechia,CZE,0,0,12,5,17
2021,Libya,LBY,Czechia,CZE,0,5,0,0,5
2021,Sri Lanka,LKA,Czechia,CZE,0,0,0,5,5
2021,Rep. of Moldova,MDA,Czechia,CZE,0,0,53,13,66
2021,Mongolia,MNG,Czechia,CZE,0,0,12,11,23
2021,Morocco,MAR,Czechia,CZE,0,0,0,5,5
2021,Myanmar,MMR,Czechia,CZE,5,0,0,0,5
2021,Nigeria,NGA,Czechia,CZE,0,0,11,5,16
2021,Pakistan,PAK,Czechia,CZE,0,0,5,5,10
2021,Russian Federation,RUS,Czechia,CZE,5,0,19,11,35
2021,Serbia and Kosovo: S/RES/1244 (1999),SRB,Czechia,CZE,0,0,5,0,5
2021,Somalia,SOM,Czechia,CZE,5,0,0,0,5
2021,Viet Nam,VNM,Czechia,CZE,0,0,47,21,68
2021,Syrian Arab Rep.,SYR,Czechia,CZE,0,35,0,11,46
2021,Tunisia,TUN,Czechia,CZE,0,0,0,14,14
2021,Turkey,TUR,Czechia,CZE,0,0,29,22,51
2021,Ukraine,UKR,Czechia,CZE,0,5,278,142,425
2021,Uzbekistan,UZB,Czechia,CZE,0,0,37,37,74
2021,Venezuela (Bolivarian Republic of),VEN,Czechia,CZE,0,0,11,0,11
2021,Yemen,YEM,Czechia,CZE,0,5,0,0,5
2021,Stateless,XXA,Czechia,CZE,0,0,13,0,13
2021,Afghanistan,AFG,Denmark,DNK,0,0,34,0,34
2021,Algeria,DZA,Denmark,DNK,0,0,14,0,14
2021,Egypt,EGY,Denmark,DNK,0,0,14,0,14
2021,Armenia,ARM,Denmark,DNK,0,0,10,0,10
2021,Bangladesh,BGD,Denmark,DNK,0,0,5,0,5
2021,Belarus,BLR,Denmark,DNK,0,0,10,0,10
2021,Bosnia and Herzegovina,BIH,Denmark,DNK,0,0,5,0,5
2021,Bulgaria,BGR,Denmark,DNK,0,0,5,0,5
2021,Dem. Rep. of the Congo,COD,Denmark,DNK,0,0,10,0,10
2021,Colombia,COL,Denmark,DNK,0,0,5,0,5
2021,Eritrea,ERI,Denmark,DNK,166,241,19,0,426
2021,Georgia,GEO,Denmark,DNK,0,0,33,0,33
2021,Ghana,GHA,Denmark,DNK,0,0,5,0,5
2021,Iran (Islamic Rep. of),IRN,Denmark,DNK,16,0,80,0,96
2021,Iraq,IRQ,Denmark,DNK,0,0,37,0,37
2021,Jordan,JOR,Denmark,DNK,0,0,10,0,10
2021,Kenya,KEN,Denmark,DNK,0,0,5,0,5
2021,Sri Lanka,LKA,Denmark,DNK,0,0,5,0,5
2021,Lithuania,LTU,Denmark,DNK,0,0,5,0,5
2021,Morocco,MAR,Denmark,DNK,0,0,38,0,38
2021,Nepal,NPL,Denmark,DNK,0,0,5,0,5
2021,Nigeria,NGA,Denmark,DNK,0,0,12,0,12
2021,Pakistan,PAK,Denmark,DNK,0,0,17,0,17
2021,Poland,POL,Denmark,DNK,0,0,5,0,5
2021,Russian Federation,RUS,Denmark,DNK,0,0,25,0,25
2021,Rwanda,RWA,Denmark,DNK,0,0,5,0,5
2021,Serbia and Kosovo: S/RES/1244 (1999),SRB,Denmark,DNK,0,0,10,0,10
2021,Somalia,SOM,Denmark,DNK,25,0,18,0,43
2021,Viet Nam,VNM,Denmark,DNK,0,0,5,0,5
2021,Syrian Arab Rep.,SYR,Denmark,DNK,112,160,56,0,328
2021,Tunisia,TUN,Denmark,DNK,0,0,5,0,5
2021,Turkey,TUR,Denmark,DNK,0,0,20,0,20
2021,Uganda,UGA,Denmark,DNK,0,0,10,0,10
2021,Ukraine,UKR,Denmark,DNK,0,0,13,0,13
2021,Uzbekistan,UZB,Denmark,DNK,0,0,5,0,5
2021,Venezuela (Bolivarian Republic of),VEN,Denmark,DNK,0,0,5,0,5
2021,Stateless,XXA,Denmark,DNK,30,5,27,0,62
2021,Eritrea,ERI,Djibouti,DJI,81,0,0,35,116
2021,Ethiopia,ETH,Djibouti,DJI,390,0,0,401,791
2021,Somalia,SOM,Djibouti,DJI,13,0,0,0,13
2021,Syrian Arab Rep.,SYR,Djibouti,DJI,5,0,0,0,5
2021,Bangladesh,BGD,Ecuador,ECU,0,0,5,0,5
2021,Colombia,COL,Ecuador,ECU,1610,0,495,99,2204
2021,Cuba,CUB,Ecuador,ECU,5,0,19,5,29
2021,Palestinian,PSE,Ecuador,ECU,5,0,0,0,5
2021,Haiti,HTI,Ecuador,ECU,0,0,5,0,5
2021,Iran (Islamic Rep. of),IRN,Ecuador,ECU,5,0,0,0,5
2021,Nigeria,NGA,Ecuador,ECU,5,0,0,0,5
2021,Russian Federation,RUS,Ecuador,ECU,5,0,0,0,5
2021,Syrian Arab Rep.,SYR,Ecuador,ECU,18,0,5,0,23
2021,United Arab Emirates,ARE,Ecuador,ECU,5,0,0,0,5
2021,Venezuela (Bolivarian Republic of),VEN,Ecuador,ECU,391,0,458,255,1104
2021,Yemen,YEM,Ecuador,ECU,20,0,0,0,20
2021,Afghanistan,AFG,Estonia,EST,15,0,0,0,15
2021,Egypt,EGY,Estonia,EST,0,0,5,0,5
2021,Armenia,ARM,Estonia,EST,0,0,5,0,5
2021,Belarus,BLR,Estonia,EST,5,0,0,0,5
2021,Iraq,IRQ,Estonia,EST,0,0,5,0,5
2021,Nigeria,NGA,Estonia,EST,0,0,5,0,5
2021,Russian Federation,RUS,Estonia,EST,11,0,5,5,21
2021,Syrian Arab Rep.,SYR,Estonia,EST,5,0,0,0,5
2021,Turkey,TUR,Estonia,EST,5,0,0,0,5
2021,Ukraine,UKR,Estonia,EST,0,0,5,0,5
2021,Bangladesh,BGD,Fiji,FJI,5,0,0,0,5
2021,Afghanistan,AFG,Finland,FIN,281,51,102,32,466
2021,Albania,ALB,Finland,FIN,0,0,5,0,5
2021,Algeria,DZA,Finland,FIN,0,0,0,14,14
2021,Egypt,EGY,Finland,FIN,14,0,5,0,19
2021,Azerbaijan,AZE,Finland,FIN,5,0,0,0,5
2021,Bangladesh,BGD,Finland,FIN,0,0,5,0,5
2021,Belarus,BLR,Finland,FIN,5,0,0,5,10
2021,China,CHN,Finland,FIN,13,0,5,0,18
2021,Cameroon,CMR,Finland,FIN,5,0,10,17,32
2021,Dem. Rep. of the Congo,COD,Finland,FIN,13,0,0,0,13
2021,Colombia,COL,Finland,FIN,0,0,5,0,5
2021,Cuba,CUB,Finland,FIN,0,0,19,0,19
2021,Eritrea,ERI,Finland,FIN,17,0,0,5,22
2021,Ethiopia,ETH,Finland,FIN,5,0,11,0,16
2021,Gambia,GMB,Finland,FIN,0,0,5,10,15
2021,Georgia,GEO,Finland,FIN,0,0,13,5,18
2021,Ghana,GHA,Finland,FIN,0,0,5,5,10
2021,Guinea,GIN,Finland,FIN,5,0,5,0,10
2021,Honduras,HND,Finland,FIN,0,0,5,0,5
2021,Iran (Islamic Rep. of),IRN,Finland,FIN,56,0,17,5,78
2021,Iraq,IRQ,Finland,FIN,354,22,174,65,615
2021,Jordan,JOR,Finland,FIN,5,0,0,0,5
2021,Rep. of Korea,KOR,Finland,FIN,0,0,5,0,5
2021,Liberia,LBR,Finland,FIN,5,0,0,0,5
2021,Libya,LBY,Finland,FIN,0,0,0,5,5
2021,Sri Lanka,LKA,Finland,FIN,5,0,0,0,5
2021,Rep. of Moldova,MDA,Finland,FIN,0,0,0,5,5
2021,Morocco,MAR,Finland,FIN,0,0,0,11,11
2021,Myanmar,MMR,Finland,FIN,0,0,5,0,5
2021,Nicaragua,NIC,Finland,FIN,12,0,0,0,12
2021,Nigeria,NGA,Finland,FIN,10,0,30,30,70
2021,Pakistan,PAK,Finland,FIN,5,0,5,5,15
2021,Romania,ROU,Finland,FIN,0,0,0,5,5
2021,Russian Federation,RUS,Finland,FIN,58,0,41,11,110
2021,Rwanda,RWA,Finland,FIN,5,0,0,5,10
2021,Senegal,SEN,Finland,FIN,0,0,0,5,5
2021,Somalia,SOM,Finland,FIN,167,15,30,24,236
2021,Viet Nam,VNM,Finland,FIN,5,0,0,0,5
2021,Sudan,SDN,Finland,FIN,5,0,0,0,5
2021,Syrian Arab Rep.,SYR,Finland,FIN,51,21,5,12,89
2021,Turkey,TUR,Finland,FIN,104,0,18,10,132
2021,Uganda,UGA,Finland,FIN,0,0,0,5,5
2021,Ukraine,UKR,Finland,FIN,0,0,11,0,11
2021,Venezuela (Bolivarian Republic of),VEN,Finland,FIN,0,0,5,0,5
2021,Yemen,YEM,Finland,FIN,5,14,0,0,19
2021,Stateless,XXA,Finland,FIN,5,0,0,5,10
2021,Afghanistan,AFG,France,FRA,4611,7625,4108,73,16417
2021,Albania,ALB,France,FRA,74,288,3141,81,3584
2021,Algeria,DZA,France,FRA,81,59,1850,19,2009
2021,Angola,AGO,France,FRA,90,66,1674,5,1835
2021,Egypt,EGY,France,FRA,75,5,583,12,675
2021,Argentina,ARG,France,FRA,0,0,14,0,14
2021,Armenia,ARM,France,FRA,17,24,1100,5,1146
2021,Azerbaijan,AZE,France,FRA,45,10,393,5,453
2021,Burundi,BDI,France,FRA,168,5,346,5,524
2021,Benin,BEN,France,FRA,14,5,101,5,125
2021,Bangladesh,BGD,France,FRA,325,101,7807,5,8238
2021,Bhutan,BTN,France,FRA,0,0,11,0,11
2021,Burkina Faso,BFA,France,FRA,53,16,211,5,285
2021,Belarus,BLR,France,FRA,37,5,174,22,238
2021,Bolivia (Plurinational State of),BOL,France,FRA,0,0,11,0,11
2021,Brazil,BRA,France,FRA,11,0,106,5,122
2021,Bosnia and Herzegovina,BIH,France,FRA,10,10,997,11,1028
2021,Cambodia,KHM,France,FRA,10,0,42,0,52
2021,Central African Rep.,CAF,France,FRA,284,52,303,10,649
2021,Chad,TCD,France,FRA,162,19,1262,31,1474
2021,China,CHN,France,FRA,624,0,118,5,747
2021,Chile,CHL,France,FRA,0,0,17,0,17
2021,Cameroon,CMR,France,FRA,142,61,705,25,933
2021,Congo,COG,France,FRA,128,17,762,17,924
2021,Dem. Rep. of the Congo,COD,France,FRA,1228,181,4473,16,5898
2021,Comoros,COM,France,FRA,169,30,3873,21,4093
2021,Colombia,COL,France,FRA,51,63,734,5,853
2021,Cuba,CUB,France,FRA,45,0,197,0,242
2021,Djibouti,DJI,France,FRA,47,5,84,10,146
2021,Dominica,DMA,France,FRA,0,0,5,0,5
2021,Dominican Rep.,DOM,France,FRA,5,17,106,0,128
2021,Eritrea,ERI,France,FRA,1781,0,764,5,2550
2021,Ethiopia,ETH,France,FRA,279,22,681,12,994
2021,Gabon,GAB,France,FRA,29,5,272,25,331
2021,Gambia,GMB,France,FRA,54,12,484,5,555
2021,Palestinian,PSE,France,FRA,76,5,81,0,162
2021,Georgia,GEO,France,FRA,93,73,2919,35,3120
2021,Ghana,GHA,France,FRA,5,10,142,0,157
2021,Guinea-Bissau,GNB,France,FRA,17,5,100,0,122
2021,Guinea,GIN,France,FRA,2189,144,5823,25,8181
2021,Guyana,GUY,France,FRA,0,0,11,0,11
2021,Haiti,HTI,France,FRA,351,358,3594,5,4308
2021,Honduras,HND,France,FRA,0,10,15,0,25
2021,Croatia,HRV,France,FRA,0,0,15,0,15
2021,Hungary,HUN,France,FRA,0,0,10,0,10
2021,Cote d'Ivoire,CIV,France,FRA,1762,158,5948,48,7916
2021,India,IND,France,FRA,5,5,390,5,405
2021,Iran (Islamic Rep. of),IRN,France,FRA,139,5,296,10,450
2021,Iraq,IRQ,France,FRA,279,133,582,11,1005
2021,Jamaica,JAM,France,FRA,14,0,10,0,24
2021,Jordan,JOR,France,FRA,5,0,14,0,19
2021,Kazakhstan,KAZ,France,FRA,18,5,127,0,150
2021,Kenya,KEN,France,FRA,10,5,22,0,37
2021,Kyrgyzstan,KGZ,France,FRA,5,5,94,0,104
2021,Kuwait,KWT,France,FRA,58,0,282,44,384
2021,Liberia,LBR,France,FRA,11,0,86,0,97
2021,Libya,LBY,France,FRA,104,86,225,10,425
2021,Saint Lucia,LCA,France,FRA,0,0,10,0,10
2021,Lebanon,LBN,France,FRA,28,17,183,16,244
2021,Sri Lanka,LKA,France,FRA,285,52,2556,10,2903
2021,Madagascar,MDG,France,FRA,18,11,302,0,331
2021,Mauritania,MRT,France,FRA,327,12,1625,5,1969
2021,North Macedonia,MKD,France,FRA,5,0,263,17,285
2021,Rep. of Moldova,MDA,France,FRA,5,10,2030,10,2055
2021,Mexico,MEX,France,FRA,0,5,11,0,16
2021,Mali,MLI,France,FRA,478,57,2270,26,2831
2021,Malaysia,MYS,France,FRA,5,0,0,0,5
2021,Mongolia,MNG,France,FRA,18,12,242,0,272
2021,Morocco,MAR,France,FRA,111,33,561,11,716
2021,Montenegro,MNE,France,FRA,0,0,77,0,77
2021,Mauritius,MUS,France,FRA,0,5,19,0,24
2021,Myanmar,MMR,France,FRA,0,0,37,0,37
2021,Nepal,NPL,France,FRA,5,5,109,0,119
2021,Niger,NER,France,FRA,5,5,113,0,123
2021,Nicaragua,NIC,France,FRA,18,0,37,0,55
2021,Nigeria,NGA,France,FRA,259,22,6870,31,7182
2021,Pakistan,PAK,France,FRA,171,55,4370,20,4616
2021,Paraguay,PRY,France,FRA,0,0,5,0,5
2021,Peru,PER,France,FRA,14,21,151,0,186
2021,Philippines,PHL,France,FRA,0,0,17,0,17
2021,Poland,POL,France,FRA,0,0,5,0,5
2021,South Africa,ZAF,France,FRA,47,0,26,0,73
2021,Russian Federation,RUS,France,FRA,450,71,2565,28,3114
2021,Rwanda,RWA,France,FRA,138,0,232,5,375
2021,El Salvador,SLV,France,FRA,5,5,13,0,23
2021,Saudi Arabia,SAU,France,FRA,0,0,5,0,5
2021,Serbia and Kosovo: S/RES/1244 (1999),SRB,France,FRA,73,95,2248,64,2480
2021,Senegal,SEN,France,FRA,245,22,1689,19,1975
2021,Sierra Leone,SLE,France,FRA,89,12,267,5,373
2021,Somalia,SOM,France,FRA,449,806,2582,10,3847
2021,Spain,ESP,France,FRA,0,0,10,0,10
2021,Viet Nam,VNM,France,FRA,5,0,40,0,45
2021,Sudan,SDN,France,FRA,968,155,1399,34,2556
2021,Suriname,SUR,France,FRA,0,5,18,0,23
2021,South Sudan,SSD,France,FRA,41,10,10,0,61
2021,Syrian Arab Rep.,SYR,France,FRA,1088,1864,697,11,3660
2021,United Rep. of Tanzania,TZA,France,FRA,10,0,15,0,25
2021,Tajikistan,TJK,France,FRA,5,0,58,0,63
2021,Turkmenistan,TKM,France,FRA,0,5,0,0,5
2021,Togo,TGO,France,FRA,18,5,127,5,155
2021,Tunisia,TUN,France,FRA,31,10,326,0,367
2021,Turkey,TUR,France,FRA,843,38,5479,27,6387
2021,Uganda,UGA,France,FRA,17,0,29,0,46
2021,Ukraine,UKR,France,FRA,63,57,3224,21,3365
2021,United States of America,USA,France,FRA,0,0,19,0,19
2021,Uzbekistan,UZB,France,FRA,5,0,35,0,40
2021,Venezuela (Bolivarian Republic of),VEN,France,FRA,191,57,509,10,767
2021,Western Sahara,ESH,France,FRA,37,5,492,0,534
2021,Yemen,YEM,France,FRA,50,101,95,0,246
2021,Zimbabwe,ZWE,France,FRA,5,0,5,0,10
2021,Stateless,XXA,France,FRA,120,0,371,0,491
2021,Afghanistan,AFG,United Kingdom of Great Britain and Northern Ireland,GBR,792,32,173,51,1048
2021,Albania,ALB,United Kingdom of Great Britain and Northern Ireland,GBR,418,27,337,406,1188
2021,Algeria,DZA,United Kingdom of Great Britain and Northern Ireland,GBR,15,0,70,17,102
2021,Angola,AGO,United Kingdom of Great Britain and Northern Ireland,GBR,5,0,20,0,25
2021,Antigua and Barbuda,ATG,United Kingdom of Great Britain and Northern Ireland,GBR,0,0,5,0,5
2021,Egypt,EGY,United Kingdom of Great Britain and Northern Ireland,GBR,92,5,84,10,191
2021,Argentina,ARG,United Kingdom of Great Britain and Northern Ireland,GBR,5,0,0,5,10
2021,Armenia,ARM,United Kingdom of Great Britain and Northern Ireland,GBR,0,0,0,5,5
2021,Azerbaijan,AZE,United Kingdom of Great Britain and Northern Ireland,GBR,5,0,5,0,10
2021,Bahrain,BHR,United Kingdom of Great Britain and Northern Ireland,GBR,5,0,0,0,5
2021,Barbados,BRB,United Kingdom of Great Britain and Northern Ireland,GBR,0,0,0,5,5
2021,Benin,BEN,United Kingdom of Great Britain and Northern Ireland,GBR,0,0,0,5,5
2021,Bangladesh,BGD,United Kingdom of Great Britain and Northern Ireland,GBR,111,17,286,52,466
2021,Belarus,BLR,United Kingdom of Great Britain and Northern Ireland,GBR,5,0,0,5,10
2021,Bolivia (Plurinational State of),BOL,United Kingdom of Great Britain and Northern Ireland,GBR,0,0,10,0,10
2021,Botswana,BWA,United Kingdom of Great Britain and Northern Ireland,GBR,5,0,11,0,16
2021,Brazil,BRA,United Kingdom of Great Britain and Northern Ireland,GBR,5,5,44,53,107
2021,Bosnia and Herzegovina,BIH,United Kingdom of Great Britain and Northern Ireland,GBR,5,0,0,0,5
2021,Bulgaria,BGR,United Kingdom of Great Britain and Northern Ireland,GBR,0,0,0,5,5
2021,Central African Rep.,CAF,United Kingdom of Great Britain and Northern Ireland,GBR,0,0,5,0,5
2021,Chad,TCD,United Kingdom of Great Britain and Northern Ireland,GBR,38,5,5,0,48
2021,China,CHN,United Kingdom of Great Britain and Northern Ireland,GBR,32,13,108,51,204
2021,Chile,CHL,United Kingdom of Great Britain and Northern Ireland,GBR,0,0,5,0,5
2021,Cameroon,CMR,United Kingdom of Great Britain and Northern Ireland,GBR,79,0,43,5,127
2021,Congo,COG,United Kingdom of Great Britain and Northern Ireland,GBR,5,0,5,0,10
2021,Dem. Rep. of the Congo,COD,United Kingdom of Great Britain and Northern Ireland,GBR,16,0,15,5,36
2021,Colombia,COL,United Kingdom of Great Britain and Northern Ireland,GBR,0,0,5,0,5
2021,Cuba,CUB,United Kingdom of Great Britain and Northern Ireland,GBR,5,0,0,0,5
2021,Czechia,CZE,United Kingdom of Great Britain and Northern Ireland,GBR,0,0,5,0,5
2021,Dominica,DMA,United Kingdom of Great Britain and Northern Ireland,GBR,0,0,5,0,5
2021,Eritrea,ERI,United Kingdom of Great Britain and Northern Ireland,GBR,1486,5,20,10,1521
2021,Ethiopia,ETH,United Kingdom of Great Britain and Northern Ireland,GBR,78,5,93,5,181
2021,Gabon,GAB,United Kingdom of Great Britain and Northern Ireland,GBR,5,0,0,0,5
2021,Gambia,GMB,United Kingdom of Great Britain and Northern Ireland,GBR,11,0,14,5,30
2021,United Kingdom of Great Britain and Northern Ireland,GBR,United Kingdom of Great Britain and Northern Ireland,GBR,11,10,0,5,26
2021,Georgia,GEO,United Kingdom of Great Britain and Northern Ireland,GBR,5,0,23,20,48
2021,Ghana,GHA,United Kingdom of Great Britain and Northern Ireland,GBR,19,5,48,18,90
2021,Grenada,GRD,United Kingdom of Great Britain and Northern Ireland,GBR,0,0,11,0,11
2021,Guinea,GIN,United Kingdom of Great Britain and Northern Ireland,GBR,17,0,10,0,27
2021,Guyana,GUY,United Kingdom of Great Britain and Northern Ireland,GBR,0,0,5,0,5
2021,"China, Hong Kong SAR",HKG,United Kingdom of Great Britain and Northern Ireland,GBR,12,0,26,35,73
2021,Honduras,HND,United Kingdom of Great Britain and Northern Ireland,GBR,5,35,30,30,100
2021,Hungary,HUN,United Kingdom of Great Britain and Northern Ireland,GBR,0,0,5,0,5
2021,Cote d'Ivoire,CIV,United Kingdom of Great Britain and Northern Ireland,GBR,14,0,5,0,19
2021,India,IND,United Kingdom of Great Britain and Northern Ireland,GBR,5,11,295,347,658
2021,Indonesia,IDN,United Kingdom of Great Britain and Northern Ireland,GBR,13,0,0,0,13
2021,Iran (Islamic Rep. of),IRN,United Kingdom of Great Britain and Northern Ireland,GBR,2462,10,285,61,2818
2021,Iraq,IRQ,United Kingdom of Great Britain and Northern Ireland,GBR,555,174,813,63,1605
2021,Israel,ISR,United Kingdom of Great Britain and Northern Ireland,GBR,102,5,18,0,125
2021,Italy,ITA,United Kingdom of Great Britain and Northern Ireland,GBR,5,0,0,0,5
2021,Jamaica,JAM,United Kingdom of Great Britain and Northern Ireland,GBR,5,5,30,14,54
2021,Jordan,JOR,United Kingdom of Great Britain and Northern Ireland,GBR,23,0,11,0,34
2021,Kazakhstan,KAZ,United Kingdom of Great Britain and Northern Ireland,GBR,14,0,0,5,19
2021,Kenya,KEN,United Kingdom of Great Britain and Northern Ireland,GBR,39,5,33,11,88
2021,Dem. People's Rep. of Korea,PRK,United Kingdom of Great Britain and Northern Ireland,GBR,0,0,5,0,5
2021,Kuwait,KWT,United Kingdom of Great Britain and Northern Ireland,GBR,64,0,11,40,115
2021,Liberia,LBR,United Kingdom of Great Britain and Northern Ireland,GBR,0,0,5,0,5
2021,Libya,LBY,United Kingdom of Great Britain and Northern Ireland,GBR,75,316,0,20,411
2021,Lebanon,LBN,United Kingdom of Great Britain and Northern Ireland,GBR,32,0,16,5,53
2021,Sri Lanka,LKA,United Kingdom of Great Britain and Northern Ireland,GBR,113,5,139,38,295
2021,Maldives,MDV,United Kingdom of Great Britain and Northern Ireland,GBR,5,0,0,0,5
2021,Mexico,MEX,United Kingdom of Great Britain and Northern Ireland,GBR,0,0,10,10,20
2021,Malaysia,MYS,United Kingdom of Great Britain and Northern Ireland,GBR,25,0,38,5,68
2021,Malawi,MWI,United Kingdom of Great Britain and Northern Ireland,GBR,5,0,11,0,16
2021,Mongolia,MNG,United Kingdom of Great Britain and Northern Ireland,GBR,0,5,5,0,10
2021,Morocco,MAR,United Kingdom of Great Britain and Northern Ireland,GBR,19,5,30,11,65
2021,Mauritius,MUS,United Kingdom of Great Britain and Northern Ireland,GBR,5,0,17,5,27
2021,Myanmar,MMR,United Kingdom of Great Britain and Northern Ireland,GBR,19,0,0,5,24
2021,Namibia,NAM,United Kingdom of Great Britain and Northern Ireland,GBR,26,12,86,10,134
2021,Nepal,NPL,United Kingdom of Great Britain and Northern Ireland,GBR,5,5,30,28,68
2021,Niger,NER,United Kingdom of Great Britain and Northern Ireland,GBR,5,0,0,0,5
2021,Nicaragua,NIC,United Kingdom of Great Britain and Northern Ireland,GBR,19,0,0,10,29
2021,Nigeria,NGA,United Kingdom of Great Britain and Northern Ireland,GBR,140,44,193,82,459
2021,Oman,OMN,United Kingdom of Great Britain and Northern Ireland,GBR,5,0,0,0,5
2021,Pakistan,PAK,United Kingdom of Great Britain and Northern Ireland,GBR,453,41,372,132,998
2021,Philippines,PHL,United Kingdom of Great Britain and Northern Ireland,GBR,5,5,45,5,60
2021,Poland,POL,United Kingdom of Great Britain and Northern Ireland,GBR,0,0,21,0,21
2021,Qatar,QAT,United Kingdom of Great Britain and Northern Ireland,GBR,10,0,0,0,10
2021,Romania,ROU,United Kingdom of Great Britain and Northern Ireland,GBR,0,0,11,0,11
2021,South Africa,ZAF,United Kingdom of Great Britain and Northern Ireland,GBR,0,5,27,5,37
2021,Russian Federation,RUS,United Kingdom of Great Britain and Northern Ireland,GBR,77,10,39,23,149
2021,El Salvador,SLV,United Kingdom of Great Britain and Northern Ireland,GBR,49,163,197,47,456
2021,Saudi Arabia,SAU,United Kingdom of Great Britain and Northern Ireland,GBR,36,0,5,10,51
2021,Serbia and Kosovo: S/RES/1244 (1999),SRB,United Kingdom of Great Britain and Northern Ireland,GBR,0,0,12,5,17
2021,Senegal,SEN,United Kingdom of Great Britain and Northern Ireland,GBR,5,0,5,0,10
2021,Seychelles,SYC,United Kingdom of Great Britain and Northern Ireland,GBR,5,0,0,0,5
2021,Sierra Leone,SLE,United Kingdom of Great Britain and Northern Ireland,GBR,30,5,35,0,70
2021,Somalia,SOM,United Kingdom of Great Britain and Northern Ireland,GBR,197,5,37,5,244
2021,Viet Nam,VNM,United Kingdom of Great Britain and Northern Ireland,GBR,530,13,224,66,833
2021,Sudan,SDN,United Kingdom of Great Britain and Northern Ireland,GBR,892,0,50,13,955
2021,South Sudan,SSD,United Kingdom of Great Britain and Northern Ireland,GBR,11,0,0,0,11
2021,Syrian Arab Rep.,SYR,United Kingdom of Great Britain and Northern Ireland,GBR,1230,5,5,10,1250
2021,United Rep. of Tanzania,TZA,United Kingdom of Great Britain and Northern Ireland,GBR,13,0,0,0,13
2021,Thailand,THA,United Kingdom of Great Britain and Northern Ireland,GBR,0,0,13,0,13
2021,Turkmenistan,TKM,United Kingdom of Great Britain and Northern Ireland,GBR,5,0,0,0,5
2021,Trinidad and Tobago,TTO,United Kingdom of Great Britain and Northern Ireland,GBR,5,0,11,0,16
2021,Tunisia,TUN,United Kingdom of Great Britain and Northern Ireland,GBR,0,0,13,0,13
2021,Turkey,TUR,United Kingdom of Great Britain and Northern Ireland,GBR,467,0,108,30,605
2021,United Arab Emirates,ARE,United Kingdom of Great Britain and Northern Ireland,GBR,0,0,0,5,5
2021,Uganda,UGA,United Kingdom of Great Britain and Northern Ireland,GBR,56,0,30,10,96
2021,Ukraine,UKR,United Kingdom of Great Britain and Northern Ireland,GBR,5,0,63,15,83
2021,United States of America,USA,United Kingdom of Great Britain and Northern Ireland,GBR,5,0,5,20,30
2021,Uzbekistan,UZB,United Kingdom of Great Britain and Northern Ireland,GBR,0,0,10,0,10
2021,Saint Vincent and the Grenadines,VCT,United Kingdom of Great Britain and Northern Ireland,GBR,5,0,0,0,5
2021,Venezuela (Bolivarian Republic of),VEN,United Kingdom of Great Britain and Northern Ireland,GBR,5,0,11,0,16
2021,Western Sahara,ESH,United Kingdom of Great Britain and Northern Ireland,GBR,5,0,0,0,5
2021,Yemen,YEM,United Kingdom of Great Britain and Northern Ireland,GBR,123,176,0,5,304
2021,Zambia,ZMB,United Kingdom of Great Britain and Northern Ireland,GBR,5,0,0,0,5
2021,Zimbabwe,ZWE,United Kingdom of Great Britain and Northern Ireland,GBR,25,5,33,5,68
2021,Stateless,XXA,United Kingdom of Great Britain and Northern Ireland,GBR,235,5,24,84,348
2021,Afghanistan,AFG,Georgia,GEO,0,14,0,0,14
2021,Egypt,EGY,Georgia,GEO,0,0,65,31,96
2021,Armenia,ARM,Georgia,GEO,0,0,5,0,5
2021,Azerbaijan,AZE,Georgia,GEO,0,0,5,5,10
2021,Bangladesh,BGD,Georgia,GEO,0,0,16,5,21
2021,Cameroon,CMR,Georgia,GEO,0,0,10,0,10
2021,Dem. Rep. of the Congo,COD,Georgia,GEO,0,0,5,0,5
2021,Eritrea,ERI,Georgia,GEO,0,14,0,0,14
2021,Palestinian,PSE,Georgia,GEO,0,0,5,5,10
2021,India,IND,Georgia,GEO,0,0,16,14,30
2021,Iran (Islamic Rep. of),IRN,Georgia,GEO,5,0,75,76,156
2021,Iraq,IRQ,Georgia,GEO,0,10,19,27,56
2021,Jordan,JOR,Georgia,GEO,0,0,20,20,40
2021,Kazakhstan,KAZ,Georgia,GEO,0,5,13,0,18
2021,Lebanon,LBN,Georgia,GEO,5,0,5,0,10
2021,Sri Lanka,LKA,Georgia,GEO,0,0,0,5,5
2021,Morocco,MAR,Georgia,GEO,0,0,0,5,5
2021,Nigeria,NGA,Georgia,GEO,0,0,27,10,37
2021,Pakistan,PAK,Georgia,GEO,0,0,26,5,31
2021,Philippines,PHL,Georgia,GEO,0,0,0,5,5
2021,South Africa,ZAF,Georgia,GEO,0,0,0,5,5
2021,Russian Federation,RUS,Georgia,GEO,0,0,34,12,46
2021,Somalia,SOM,Georgia,GEO,0,0,0,12,12
2021,Syrian Arab Rep.,SYR,Georgia,GEO,0,11,11,10,32
2021,Turkey,TUR,Georgia,GEO,0,0,43,34,77
2021,Ukraine,UKR,Georgia,GEO,0,12,0,5,17
2021,Yemen,YEM,Georgia,GEO,0,15,10,5,30
2021,Afghanistan,AFG,Germany,DEU,1409,2233,1413,3051,8106
2021,Albania,ALB,Germany,DEU,0,5,815,139,959
2021,Algeria,DZA,Germany,DEU,10,13,484,960,1467
2021,Angola,AGO,Germany,DEU,5,21,136,12,174
2021,Egypt,EGY,Germany,DEU,68,12,201,79,360
2021,Argentina,ARG,Germany,DEU,0,0,0,5,5
2021,Armenia,ARM,Germany,DEU,0,30,339,76,445
2021,Austria,AUT,Germany,DEU,0,0,5,0,5
2021,Azerbaijan,AZE,Germany,DEU,34,11,406,44,495
2021,Bahrain,BHR,Germany,DEU,0,0,5,0,5
2021,Burundi,BDI,Germany,DEU,12,5,10,0,27
2021,Belgium,BEL,Germany,DEU,0,0,5,0,5
2021,Benin,BEN,Germany,DEU,5,5,47,11,68
2021,Bangladesh,BGD,Germany,DEU,5,5,97,24,131
2021,Burkina Faso,BFA,Germany,DEU,5,5,35,13,58
2021,Belarus,BLR,Germany,DEU,0,5,43,143,191
2021,Brazil,BRA,Germany,DEU,0,0,11,0,11
2021,Bosnia and Herzegovina,BIH,Germany,DEU,0,0,417,59,476
2021,Cambodia,KHM,Germany,DEU,0,0,5,0,5
2021,Central African Rep.,CAF,Germany,DEU,0,5,0,0,5
2021,Chad,TCD,Germany,DEU,5,5,16,12,38
2021,China,CHN,Germany,DEU,60,0,161,48,269
2021,Chile,CHL,Germany,DEU,0,0,10,0,10
2021,Cameroon,CMR,Germany,DEU,26,14,296,120,456
2021,Congo,COG,Germany,DEU,5,0,15,0,20
2021,Dem. Rep. of the Congo,COD,Germany,DEU,13,21,100,22,156
2021,Colombia,COL,Germany,DEU,0,0,211,22,233
2021,Cuba,CUB,Germany,DEU,0,0,13,0,13
2021,Czechia,CZE,Germany,DEU,0,0,0,5,5
2021,Djibouti,DJI,Germany,DEU,0,0,13,0,13
2021,Equatorial Guinea,GNQ,Germany,DEU,0,0,5,0,5
2021,Eritrea,ERI,Germany,DEU,2042,545,198,180,2965
2021,Ethiopia,ETH,Germany,DEU,180,92,323,61,656
2021,France,FRA,Germany,DEU,0,0,5,0,5
2021,Gabon,GAB,Germany,DEU,0,0,11,0,11
2021,Gambia,GMB,Germany,DEU,52,28,376,213,669
2021,Palestinian,PSE,Germany,DEU,28,21,79,32,160
2021,United Kingdom of Great Britain and Northern Ireland,GBR,Germany,DEU,0,0,5,0,5
2021,Georgia,GEO,Germany,DEU,0,18,2309,473,2800
2021,Ghana,GHA,Germany,DEU,5,11,353,93,462
2021,Guinea-Bissau,GNB,Germany,DEU,0,5,28,25,58
2021,Greece,GRC,Germany,DEU,0,0,5,0,5
2021,Guinea,GIN,Germany,DEU,344,129,511,253,1237
2021,Haiti,HTI,Germany,DEU,0,0,5,0,5
2021,Honduras,HND,Germany,DEU,0,0,10,0,10
2021,Hungary,HUN,Germany,DEU,0,0,5,0,5
2021,Cote d'Ivoire,CIV,Germany,DEU,32,24,174,119,349
2021,India,IND,Germany,DEU,5,5,167,44,221
2021,Indonesia,IDN,Germany,DEU,0,0,5,0,5
2021,Iran (Islamic Rep. of),IRN,Germany,DEU,853,97,1729,494,3173
2021,Iraq,IRQ,Germany,DEU,2405,946,4234,1875,9460
2021,Israel,ISR,Germany,DEU,0,0,0,5,5
2021,Italy,ITA,Germany,DEU,0,0,5,0,5
2021,Jamaica,JAM,Germany,DEU,0,0,0,11,11
2021,Jordan,JOR,Germany,DEU,5,5,97,15,122
2021,Japan,JPN,Germany,DEU,0,0,5,0,5
2021,Kazakhstan,KAZ,Germany,DEU,0,0,52,13,65
2021,Kenya,KEN,Germany,DEU,0,5,98,14,117
2021,Kyrgyzstan,KGZ,Germany,DEU,5,5,27,5,42
2021,Liberia,LBR,Germany,DEU,5,0,51,38,94
2021,Libya,LBY,Germany,DEU,34,125,239,244,642
2021,Lebanon,LBN,Germany,DEU,13,20,391,170,594
2021,Sri Lanka,LKA,Germany,DEU,26,10,100,14,150
2021,Latvia,LVA,Germany,DEU,0,0,0,5,5
2021,Mauritania,MRT,Germany,DEU,5,0,11,10,26
2021,North Macedonia,MKD,Germany,DEU,0,0,1256,204,1460
2021,Rep. of Moldova,MDA,Germany,DEU,0,5,1740,455,2200
2021,Mexico,MEX,Germany,DEU,0,0,5,0,5
2021,Mali,MLI,Germany,DEU,10,10,63,50,133
2021,Malaysia,MYS,Germany,DEU,0,0,5,0,5
2021,Mongolia,MNG,Germany,DEU,0,10,69,12,91
2021,Morocco,MAR,Germany,DEU,10,14,494,486,1004
2021,Mozambique,MOZ,Germany,DEU,0,5,0,0,5
2021,Montenegro,MNE,Germany,DEU,0,0,98,5,103
2021,Myanmar,MMR,Germany,DEU,14,10,74,5,103
2021,Namibia,NAM,Germany,DEU,0,0,10,0,10
2021,Nepal,NPL,Germany,DEU,0,0,13,0,13
2021,Netherlands,NLD,Germany,DEU,0,0,0,5,5
2021,Niger,NER,Germany,DEU,0,5,17,5,27
2021,Nicaragua,NIC,Germany,DEU,0,0,32,5,37
2021,Nigeria,NGA,Germany,DEU,250,258,2690,896,4094
2021,Norway,NOR,Germany,DEU,0,0,0,5,5
2021,Pakistan,PAK,Germany,DEU,129,46,658,319,1152
2021,Peru,PER,Germany,DEU,0,0,10,5,15
2021,Philippines,PHL,Germany,DEU,0,0,5,0,5
2021,Poland,POL,Germany,DEU,0,0,5,0,5
2021,Romania,ROU,Germany,DEU,0,0,0,5,5
2021,South Africa,ZAF,Germany,DEU,0,0,11,0,11
2021,Russian Federation,RUS,Germany,DEU,90,53,1161,512,1816
2021,Rwanda,RWA,Germany,DEU,25,5,101,5,136
2021,El Salvador,SLV,Germany,DEU,0,15,13,5,33
2021,Saudi Arabia,SAU,Germany,DEU,0,0,0,11,11
2021,Serbia and Kosovo: S/RES/1244 (1999),SRB,Germany,DEU,5,10,757,148,920
2021,Senegal,SEN,Germany,DEU,0,5,71,57,133
2021,Sierra Leone,SLE,Germany,DEU,20,15,93,33,161
2021,Somalia,SOM,Germany,DEU,1692,412,459,438,3001
2021,Spain,ESP,Germany,DEU,0,0,10,0,10
2021,Viet Nam,VNM,Germany,DEU,0,5,740,188,933
2021,Sudan,SDN,Germany,DEU,80,26,120,92,318
2021,South Sudan,SSD,Germany,DEU,0,5,5,13,23
2021,Slovenia,SVN,Germany,DEU,0,0,0,5,5
2021,Sweden,SWE,Germany,DEU,0,0,5,0,5
2021,Syrian Arab Rep.,SYR,Germany,DEU,15859,19946,38,3005,38848
2021,United Rep. of Tanzania,TZA,Germany,DEU,10,5,56,18,89
2021,Thailand,THA,Germany,DEU,0,0,0,11,11
2021,Tajikistan,TJK,Germany,DEU,44,16,182,52,294
2021,Turkmenistan,TKM,Germany,DEU,0,0,14,0,14
2021,Togo,TGO,Germany,DEU,10,5,99,41,155
2021,Trinidad and Tobago,TTO,Germany,DEU,5,0,0,0,5
2021,Tunisia,TUN,Germany,DEU,0,10,284,361,655
2021,Turkey,TUR,Germany,DEU,2351,43,3099,414,5907
2021,Uganda,UGA,Germany,DEU,12,5,41,5,63
2021,Ukraine,UKR,Germany,DEU,5,24,382,77,488
2021,United States of America,USA,Germany,DEU,0,0,13,5,18
2021,Uzbekistan,UZB,Germany,DEU,5,0,19,0,24
2021,Venezuela (Bolivarian Republic of),VEN,Germany,DEU,28,91,130,27,276
2021,Yemen,YEM,Germany,DEU,37,208,75,41,361
2021,Zambia,ZMB,Germany,DEU,0,0,5,0,5
2021,Zimbabwe,ZWE,Germany,DEU,17,0,25,0,42
2021,Stateless,XXA,Germany,DEU,212,33,30,42,317
2021,Central African Rep.,CAF,Ghana,GHA,5,0,0,0,5
2021,Cameroon,CMR,Ghana,GHA,15,0,0,30,45
2021,Cote d'Ivoire,CIV,Ghana,GHA,96,0,0,218,314
2021,Sudan,SDN,Ghana,GHA,5,0,0,0,5
2021,Togo,TGO,Ghana,GHA,0,0,0,5,5
2021,Turkey,TUR,Ghana,GHA,5,0,0,0,5
2021,Yemen,YEM,Ghana,GHA,5,0,0,0,5
2021,Afghanistan,AFG,Greece,GRC,4235,2766,820,8165,15986
2021,Albania,ALB,Greece,GRC,10,0,1647,807,2464
2021,Algeria,DZA,Greece,GRC,15,0,105,203,323
2021,Angola,AGO,Greece,GRC,5,0,11,5,21
2021,Egypt,EGY,Greece,GRC,24,0,333,532,889
2021,Armenia,ARM,Greece,GRC,0,0,33,29,62
2021,Azerbaijan,AZE,Greece,GRC,0,0,5,0,5
2021,Burundi,BDI,Greece,GRC,10,0,10,0,20
2021,Benin,BEN,Greece,GRC,0,0,5,0,5
2021,Bangladesh,BGD,Greece,GRC,12,0,558,1863,2433
2021,Burkina Faso,BFA,Greece,GRC,5,10,32,10,57
2021,Brazil,BRA,Greece,GRC,0,0,5,5,10
2021,Central African Rep.,CAF,Greece,GRC,5,0,0,0,5
2021,Chad,TCD,Greece,GRC,5,0,0,0,5
2021,China,CHN,Greece,GRC,0,0,118,151,269
2021,Cameroon,CMR,Greece,GRC,178,18,176,234,606
2021,Congo,COG,Greece,GRC,16,0,22,27,65
2021,Dem. Rep. of the Congo,COD,Greece,GRC,427,85,766,847,2125
2021,Comoros,COM,Greece,GRC,0,0,0,11,11
2021,Cuba,CUB,Greece,GRC,5,0,19,25,49
2021,Djibouti,DJI,Greece,GRC,5,0,0,0,5
2021,Dominican Rep.,DOM,Greece,GRC,0,0,12,0,12
2021,Eritrea,ERI,Greece,GRC,117,0,0,68,185
2021,Ethiopia,ETH,Greece,GRC,18,0,5,18,41
2021,Gambia,GMB,Greece,GRC,32,5,42,74,153
2021,Palestinian,PSE,Greece,GRC,795,11,10,95,911
2021,Georgia,GEO,Greece,GRC,0,0,1075,473,1548
2021,Ghana,GHA,Greece,GRC,14,0,83,51,148
2021,Guinea,GIN,Greece,GRC,43,0,60,43,146
2021,Haiti,HTI,Greece,GRC,5,14,5,0,24
2021,Cote d'Ivoire,CIV,Greece,GRC,15,0,24,18,57
2021,India,IND,Greece,GRC,5,0,286,104,395
2021,Indonesia,IDN,Greece,GRC,0,0,36,16,52
2021,Iran (Islamic Rep. of),IRN,Greece,GRC,718,5,273,1029,2025
2021,Iraq,IRQ,Greece,GRC,1531,293,855,1431,4110
2021,Jordan,JOR,Greece,GRC,0,0,0,14,14
2021,Kenya,KEN,Greece,GRC,0,0,0,5,5
2021,Kuwait,KWT,Greece,GRC,22,0,5,0,27
2021,Libya,LBY,Greece,GRC,0,5,13,30,48
2021,Lebanon,LBN,Greece,GRC,5,12,28,18,63
2021,Sri Lanka,LKA,Greece,GRC,5,0,23,67,95
2021,Mauritania,MRT,Greece,GRC,11,0,0,0,11
2021,Rep. of Moldova,MDA,Greece,GRC,0,0,17,22,39
2021,Mexico,MEX,Greece,GRC,0,0,5,0,5
2021,Mali,MLI,Greece,GRC,16,29,37,18,100
2021,Morocco,MAR,Greece,GRC,29,0,95,119,243
2021,Myanmar,MMR,Greece,GRC,5,0,0,5,10
2021,Nepal,NPL,Greece,GRC,10,0,85,55,150
2021,Niger,NER,Greece,GRC,5,0,5,0,10
2021,Nigeria,NGA,Greece,GRC,35,0,58,57,150
2021,Pakistan,PAK,Greece,GRC,115,5,2486,4062,6668
2021,Peru,PER,Greece,GRC,0,0,5,0,5
2021,Philippines,PHL,Greece,GRC,0,0,10,5,15
2021,Russian Federation,RUS,Greece,GRC,0,0,24,22,46
2021,Serbia and Kosovo: S/RES/1244 (1999),SRB,Greece,GRC,0,0,14,0,14
2021,Senegal,SEN,Greece,GRC,5,0,17,25,47
2021,Sierra Leone,SLE,Greece,GRC,80,0,42,16,138
2021,Somalia,SOM,Greece,GRC,749,244,306,560,1859
2021,Viet Nam,VNM,Greece,GRC,0,0,0,11,11
2021,Sudan,SDN,Greece,GRC,38,5,18,21,82
2021,South Sudan,SSD,Greece,GRC,5,0,0,5,10
2021,Syrian Arab Rep.,SYR,Greece,GRC,3086,5,23,2904,6018
2021,Tajikistan,TJK,Greece,GRC,0,0,5,0,5
2021,Turkmenistan,TKM,Greece,GRC,0,0,0,5,5
2021,Togo,TGO,Greece,GRC,22,0,46,24,92
2021,Tunisia,TUN,Greece,GRC,5,0,19,14,38
2021,Turkey,TUR,Greece,GRC,364,0,99,2708,3171
2021,Uganda,UGA,Greece,GRC,28,0,13,5,46
2021,Ukraine,UKR,Greece,GRC,0,11,29,21,61
2021,Uzbekistan,UZB,Greece,GRC,0,0,5,0,5
2021,Venezuela (Bolivarian Republic of),VEN,Greece,GRC,0,0,13,5,18
2021,Western Sahara,ESH,Greece,GRC,0,0,0,5,5
2021,Yemen,YEM,Greece,GRC,79,0,0,5,84
2021,Zambia,ZMB,Greece,GRC,0,0,5,0,5
2021,Stateless,XXA,Greece,GRC,88,0,0,42,130
2021,Dem. Rep. of the Congo,COD,Guinea,GIN,21,0,0,10,31
2021,Eritrea,ERI,Guinea,GIN,5,0,0,0,5
2021,Cote d'Ivoire,CIV,Guinea,GIN,107,0,0,275,382
2021,Kenya,KEN,Guinea,GIN,0,0,0,5,5
2021,Liberia,LBR,Guinea,GIN,0,0,0,69,69
2021,Nigeria,NGA,Guinea,GIN,5,0,0,0,5
2021,Sierra Leone,SLE,Guinea,GIN,1119,0,61,1765,2945
2021,Syrian Arab Rep.,SYR,Guinea,GIN,0,0,0,12,12
2021,Cuba,CUB,Honduras,HND,0,0,0,10,10
2021,Nicaragua,NIC,Honduras,HND,63,0,0,34,97
2021,El Salvador,SLV,Honduras,HND,13,0,0,0,13
2021,Venezuela (Bolivarian Republic of),VEN,Honduras,HND,5,0,0,0,5
2021,Afghanistan,AFG,Croatia,HRV,40,0,5,1531,1576
2021,Albania,ALB,Croatia,HRV,0,0,5,0,5
2021,Algeria,DZA,Croatia,HRV,0,0,14,0,14
2021,Egypt,EGY,Croatia,HRV,0,0,5,10,15
2021,Bangladesh,BGD,Croatia,HRV,0,0,16,49,65
2021,Bosnia and Herzegovina,BIH,Croatia,HRV,0,0,5,0,5
2021,China,CHN,Croatia,HRV,0,0,0,5,5
2021,Cuba,CUB,Croatia,HRV,0,0,0,18,18
2021,Eritrea,ERI,Croatia,HRV,0,0,0,11,11
2021,Palestinian,PSE,Croatia,HRV,0,0,0,10,10
2021,India,IND,Croatia,HRV,0,0,0,5,5
2021,Iran (Islamic Rep. of),IRN,Croatia,HRV,5,0,29,121,155
2021,Iraq,IRQ,Croatia,HRV,5,0,24,191,220
2021,Libya,LBY,Croatia,HRV,0,0,5,0,5
2021,Morocco,MAR,Croatia,HRV,0,0,30,5,35
2021,Nepal,NPL,Croatia,HRV,0,0,0,5,5
2021,Pakistan,PAK,Croatia,HRV,5,0,14,73,92
2021,Russian Federation,RUS,Croatia,HRV,0,0,0,5,5
2021,Serbia and Kosovo: S/RES/1244 (1999),SRB,Croatia,HRV,5,0,0,0,5
2021,Somalia,SOM,Croatia,HRV,0,0,0,5,5
2021,Syrian Arab Rep.,SYR,Croatia,HRV,10,0,0,61,71
2021,Tunisia,TUN,Croatia,HRV,0,0,17,5,22
2021,Turkey,TUR,Croatia,HRV,0,0,36,39,75
2021,Stateless,XXA,Croatia,HRV,0,0,0,23,23
2021,Afghanistan,AFG,Hungary,HUN,0,5,0,14,19
2021,Ethiopia,ETH,Hungary,HUN,5,0,0,0,5
2021,Iran (Islamic Rep. of),IRN,Hungary,HUN,10,0,0,0,10
2021,Iraq,IRQ,Hungary,HUN,0,0,5,17,22
2021,Nigeria,NGA,Hungary,HUN,0,0,5,0,5
2021,Russian Federation,RUS,Hungary,HUN,0,0,5,0,5
2021,Syrian Arab Rep.,SYR,Hungary,HUN,0,0,5,0,5
2021,Afghanistan,AFG,Iceland,ISL,21,38,0,12,71
2021,Albania,ALB,Iceland,ISL,0,0,10,0,10
2021,Belarus,BLR,Iceland,ISL,0,0,0,5,5
2021,Colombia,COL,Iceland,ISL,0,0,11,0,11
2021,Ethiopia,ETH,Iceland,ISL,5,0,0,0,5
2021,Palestinian,PSE,Iceland,ISL,5,54,0,81,140
2021,Ghana,GHA,Iceland,ISL,0,0,5,0,5
2021,Iran (Islamic Rep. of),IRN,Iceland,ISL,5,0,0,15,20
2021,Iraq,IRQ,Iceland,ISL,5,0,32,63,100
2021,Libya,LBY,Iceland,ISL,0,5,0,5,10
2021,Nigeria,NGA,Iceland,ISL,5,0,13,42,60
2021,Pakistan,PAK,Iceland,ISL,0,0,0,5,5
2021,Russian Federation,RUS,Iceland,ISL,0,0,5,0,5
2021,Serbia and Kosovo: S/RES/1244 (1999),SRB,Iceland,ISL,0,0,0,5,5
2021,Somalia,SOM,Iceland,ISL,14,5,5,22,46
2021,Syrian Arab Rep.,SYR,Iceland,ISL,0,28,0,23,51
2021,Uganda,UGA,Iceland,ISL,5,0,0,0,5
2021,Venezuela (Bolivarian Republic of),VEN,Iceland,ISL,5,127,34,10,176
2021,Yemen,YEM,Iceland,ISL,0,5,0,0,5
2021,Stateless,XXA,Iceland,ISL,5,5,0,0,10
2021,Afghanistan,AFG,Ireland,IRL,165,5,20,27,217
2021,Albania,ALB,Ireland,IRL,5,0,138,80,223
2021,Algeria,DZA,Ireland,IRL,5,0,46,20,71
2021,Egypt,EGY,Ireland,IRL,10,0,17,10,37
2021,Armenia,ARM,Ireland,IRL,0,0,5,0,5
2021,Bahrain,BHR,Ireland,IRL,0,0,0,5,5
2021,Burundi,BDI,Ireland,IRL,5,0,0,0,5
2021,Bangladesh,BGD,Ireland,IRL,0,0,35,16,51
2021,Bolivia (Plurinational State of),BOL,Ireland,IRL,5,0,10,5,20
2021,Botswana,BWA,Ireland,IRL,0,0,14,0,14
2021,Brazil,BRA,Ireland,IRL,0,0,45,42,87
2021,China,CHN,Ireland,IRL,5,0,17,16,38
2021,Cameroon,CMR,Ireland,IRL,5,5,10,0,20
2021,Dem. Rep. of the Congo,COD,Ireland,IRL,14,10,38,5,67
2021,Eritrea,ERI,Ireland,IRL,19,0,0,5,24
2021,Ethiopia,ETH,Ireland,IRL,21,0,0,5,26
2021,Palestinian,PSE,Ireland,IRL,10,0,0,5,15
2021,Georgia,GEO,Ireland,IRL,10,0,172,28,210
2021,Ghana,GHA,Ireland,IRL,5,0,28,0,33
2021,Guatemala,GTM,Ireland,IRL,0,0,5,0,5
2021,Guinea,GIN,Ireland,IRL,5,0,0,0,5
2021,India,IND,Ireland,IRL,5,0,32,5,42
2021,Iran (Islamic Rep. of),IRN,Ireland,IRL,13,0,10,5,28
2021,Iraq,IRQ,Ireland,IRL,12,5,22,10,49
2021,Kenya,KEN,Ireland,IRL,0,0,12,0,12
2021,Kyrgyzstan,KGZ,Ireland,IRL,0,0,5,0,5
2021,Dem. People's Rep. of Korea,PRK,Ireland,IRL,0,0,5,0,5
2021,Kuwait,KWT,Ireland,IRL,0,0,5,0,5
2021,Libya,LBY,Ireland,IRL,13,5,0,5,23
2021,Rep. of Moldova,MDA,Ireland,IRL,0,0,0,5,5
2021,Malaysia,MYS,Ireland,IRL,0,0,13,0,13
2021,Malawi,MWI,Ireland,IRL,10,0,40,5,55
2021,Morocco,MAR,Ireland,IRL,0,0,14,5,19
2021,Mauritius,MUS,Ireland,IRL,0,0,5,5,10
2021,Nepal,NPL,Ireland,IRL,0,0,10,0,10
2021,Nicaragua,NIC,Ireland,IRL,5,0,0,0,5
2021,Nigeria,NGA,Ireland,IRL,41,0,179,32,252
2021,Pakistan,PAK,Ireland,IRL,20,5,115,76,216
2021,South Africa,ZAF,Ireland,IRL,10,5,23,11,49
2021,Russian Federation,RUS,Ireland,IRL,12,0,0,0,12
2021,El Salvador,SLV,Ireland,IRL,29,0,0,0,29
2021,Saudi Arabia,SAU,Ireland,IRL,5,0,0,0,5
2021,Serbia and Kosovo: S/RES/1244 (1999),SRB,Ireland,IRL,0,0,10,0,10
2021,Sierra Leone,SLE,Ireland,IRL,13,0,5,0,18
2021,Somalia,SOM,Ireland,IRL,218,18,5,17,258
2021,Viet Nam,VNM,Ireland,IRL,5,0,11,5,21
2021,Sudan,SDN,Ireland,IRL,41,0,5,5,51
2021,South Sudan,SSD,Ireland,IRL,5,0,0,0,5
2021,Eswatini,SWZ,Ireland,IRL,0,0,0,5,5
2021,Syrian Arab Rep.,SYR,Ireland,IRL,43,0,5,17,65
2021,United Rep. of Tanzania,TZA,Ireland,IRL,5,0,0,0,5
2021,Togo,TGO,Ireland,IRL,0,0,10,0,10
2021,Tunisia,TUN,Ireland,IRL,0,0,5,0,5
2021,Turkey,TUR,Ireland,IRL,5,0,0,0,5
2021,Uganda,UGA,Ireland,IRL,0,0,11,0,11
2021,Ukraine,UKR,Ireland,IRL,0,0,11,0,11
2021,United States of America,USA,Ireland,IRL,0,0,5,5,10
2021,Venezuela (Bolivarian Republic of),VEN,Ireland,IRL,33,11,5,5,54
2021,Yemen,YEM,Ireland,IRL,5,0,0,5,10
2021,Zambia,ZMB,Ireland,IRL,0,0,5,0,5
2021,Zimbabwe,ZWE,Ireland,IRL,39,0,174,10,223
2021,Afghanistan,AFG,Italy,ITA,2046,2130,104,0,4280
2021,Albania,ALB,Italy,ITA,67,181,269,0,517
2021,Algeria,DZA,Italy,ITA,16,15,63,0,94
2021,Angola,AGO,Italy,ITA,0,5,0,0,5
2021,Egypt,EGY,Italy,ITA,59,70,552,0,681
2021,Argentina,ARG,Italy,ITA,0,11,5,0,16
2021,Armenia,ARM,Italy,ITA,5,14,5,0,24
2021,Azerbaijan,AZE,Italy,ITA,18,5,14,0,37
2021,Burundi,BDI,Italy,ITA,5,0,0,0,5
2021,Benin,BEN,Italy,ITA,0,10,20,0,30
2021,Bangladesh,BGD,Italy,ITA,89,637,2956,0,3682
2021,Burkina Faso,BFA,Italy,ITA,5,131,37,0,173
2021,Belarus,BLR,Italy,ITA,26,20,10,0,56
2021,Bolivia (Plurinational State of),BOL,Italy,ITA,0,0,5,0,5
2021,Brazil,BRA,Italy,ITA,101,62,95,0,258
2021,Bosnia and Herzegovina,BIH,Italy,ITA,5,86,25,0,116
2021,Central African Rep.,CAF,Italy,ITA,0,5,0,0,5
2021,Chad,TCD,Italy,ITA,5,17,5,0,27
2021,Chile,CHL,Italy,ITA,0,13,5,0,18
2021,Cameroon,CMR,Italy,ITA,53,105,190,0,348
2021,Congo,COG,Italy,ITA,10,15,5,0,30
2021,Dem. Rep. of the Congo,COD,Italy,ITA,25,36,10,0,71
2021,Colombia,COL,Italy,ITA,109,185,246,0,540
2021,Cuba,CUB,Italy,ITA,17,39,49,0,105
2021,Cabo Verde,CPV,Italy,ITA,0,5,0,0,5
2021,Dominican Rep.,DOM,Italy,ITA,5,5,12,0,22
2021,Ecuador,ECU,Italy,ITA,5,5,17,0,27
2021,Eritrea,ERI,Italy,ITA,57,57,57,0,171
2021,Ethiopia,ETH,Italy,ITA,21,24,17,0,62
2021,Gabon,GAB,Italy,ITA,0,0,5,0,5
2021,Gambia,GMB,Italy,ITA,41,292,855,0,1188
2021,Palestinian,PSE,Italy,ITA,60,14,5,0,79
2021,Georgia,GEO,Italy,ITA,60,185,465,0,710
2021,Ghana,GHA,Italy,ITA,33,187,545,0,765
2021,Guinea-Bissau,GNB,Italy,ITA,0,27,74,0,101
2021,Guatemala,GTM,Italy,ITA,13,0,5,0,18
2021,Guinea,GIN,Italy,ITA,24,133,352,0,509
2021,"China, Hong Kong SAR",HKG,Italy,ITA,13,35,198,0,246
2021,Honduras,HND,Italy,ITA,79,96,46,0,221
2021,Cote d'Ivoire,CIV,Italy,ITA,98,235,653,5,991
2021,India,IND,Italy,ITA,13,33,187,0,233
2021,Iran (Islamic Rep. of),IRN,Italy,ITA,86,23,23,0,132
2021,Iraq,IRQ,Italy,ITA,153,393,84,0,630
2021,Jordan,JOR,Italy,ITA,0,0,11,0,11
2021,Kenya,KEN,Italy,ITA,10,14,5,0,29
2021,Kyrgyzstan,KGZ,Italy,ITA,5,0,18,0,23
2021,Liberia,LBR,Italy,ITA,5,21,18,0,44
2021,Libya,LBY,Italy,ITA,25,156,14,0,195
2021,Lebanon,LBN,Italy,ITA,0,20,19,0,39
2021,Liechtenstein,LIE,Italy,ITA,0,5,0,0,5
2021,Sri Lanka,LKA,Italy,ITA,5,34,113,0,152
2021,Mauritania,MRT,Italy,ITA,0,5,5,0,10
2021,North Macedonia,MKD,Italy,ITA,5,13,16,0,34
2021,Rep. of Moldova,MDA,Italy,ITA,10,33,44,0,87
2021,Mexico,MEX,Italy,ITA,5,0,5,0,10
2021,Mali,MLI,Italy,ITA,46,1288,249,5,1588
2021,Morocco,MAR,Italy,ITA,75,158,481,0,714
2021,Montenegro,MNE,Italy,ITA,0,12,5,0,17
2021,Mauritius,MUS,Italy,ITA,0,5,5,0,10
2021,Myanmar,MMR,Italy,ITA,5,0,0,0,5
2021,Nepal,NPL,Italy,ITA,11,5,17,0,33
2021,Niger,NER,Italy,ITA,5,27,20,0,52
2021,Nicaragua,NIC,Italy,ITA,5,0,14,0,19
2021,Nigeria,NGA,Italy,ITA,1086,1177,4353,5,6621
2021,New Zealand,NZL,Italy,ITA,0,0,5,0,5
2021,Pakistan,PAK,Italy,ITA,411,2075,4872,5,7363
2021,Paraguay,PRY,Italy,ITA,0,0,10,0,10
2021,Peru,PER,Italy,ITA,154,239,567,0,960
2021,Philippines,PHL,Italy,ITA,0,17,20,0,37
2021,South Africa,ZAF,Italy,ITA,0,0,5,0,5
2021,Russian Federation,RUS,Italy,ITA,30,17,18,0,65
2021,Rwanda,RWA,Italy,ITA,0,5,0,0,5
2021,El Salvador,SLV,Italy,ITA,309,589,337,0,1235
2021,Serbia and Kosovo: S/RES/1244 (1999),SRB,Italy,ITA,26,137,157,0,320
2021,Senegal,SEN,Italy,ITA,34,352,859,0,1245
2021,Sierra Leone,SLE,Italy,ITA,5,19,67,0,91
2021,Somalia,SOM,Italy,ITA,524,587,32,0,1143
2021,Viet Nam,VNM,Italy,ITA,0,0,5,0,5
2021,Sudan,SDN,Italy,ITA,57,62,49,5,173
2021,Syrian Arab Rep.,SYR,Italy,ITA,38,32,11,0,81
2021,United Rep. of Tanzania,TZA,Italy,ITA,0,0,5,0,5
2021,Turkmenistan,TKM,Italy,ITA,0,0,5,0,5
2021,Togo,TGO,Italy,ITA,5,57,63,0,125
2021,Tunisia,TUN,Italy,ITA,83,292,1548,0,1923
2021,Turkey,TUR,Italy,ITA,95,114,110,0,319
2021,Uganda,UGA,Italy,ITA,12,0,0,0,12
2021,Ukraine,UKR,Italy,ITA,34,425,252,0,711
2021,Uruguay,URY,Italy,ITA,0,5,5,0,10
2021,United States of America,USA,Italy,ITA,0,5,5,0,10
2021,Venezuela (Bolivarian Republic of),VEN,Italy,ITA,197,591,65,0,853
2021,Western Sahara,ESH,Italy,ITA,5,0,0,0,5
2021,Yemen,YEM,Italy,ITA,0,10,0,0,10
2021,Stateless,XXA,Italy,ITA,0,11,0,0,11
2021,Afghanistan,AFG,Kazakhstan,KAZ,0,0,11,0,11
2021,Afghanistan,AFG,Kenya,KEN,5,0,0,0,5
2021,Egypt,EGY,Kenya,KEN,0,0,0,5,5
2021,Burundi,BDI,Kenya,KEN,256,0,0,1526,1782
2021,Congo,COG,Kenya,KEN,0,0,0,11,11
2021,Dem. Rep. of the Congo,COD,Kenya,KEN,294,0,0,393,687
2021,Eritrea,ERI,Kenya,KEN,0,0,0,16,16
2021,Ethiopia,ETH,Kenya,KEN,186,0,0,319,505
2021,Nigeria,NGA,Kenya,KEN,0,0,0,5,5
2021,Rwanda,RWA,Kenya,KEN,5,0,0,113,118
2021,Somalia,SOM,Kenya,KEN,99,0,0,168,267
2021,Sudan,SDN,Kenya,KEN,237,0,0,497,734
2021,South Sudan,SSD,Kenya,KEN,0,0,0,24,24
2021,Turkey,TUR,Kenya,KEN,13,0,0,0,13
2021,Uganda,UGA,Kenya,KEN,10,0,0,190,200
2021,Yemen,YEM,Kenya,KEN,11,0,0,0,11
2021,Afghanistan,AFG,Kyrgyzstan,KGZ,0,0,30,10,40
2021,Syrian Arab Rep.,SYR,Kyrgyzstan,KGZ,10,0,0,0,10
2021,Turkey,TUR,Kyrgyzstan,KGZ,0,0,0,234,234
2021,Uzbekistan,UZB,Kyrgyzstan,KGZ,0,0,5,0,5
2021,Cote d'Ivoire,CIV,Liberia,LBR,0,0,0,864,864
2021,Dem. Rep. of the Congo,COD,Lesotho,LSO,13,0,0,0,13
2021,Eritrea,ERI,Lesotho,LSO,5,0,0,0,5
2021,Albania,ALB,Liechtenstein,LIE,0,0,0,5,5
2021,Algeria,DZA,Liechtenstein,LIE,0,0,0,5,5
2021,Belarus,BLR,Liechtenstein,LIE,0,0,0,5,5
2021,Rep. of Moldova,MDA,Liechtenstein,LIE,0,0,0,5,5
2021,Morocco,MAR,Liechtenstein,LIE,0,0,0,5,5
2021,Nigeria,NGA,Liechtenstein,LIE,0,0,5,0,5
2021,Somalia,SOM,Liechtenstein,LIE,0,0,0,5,5
2021,Sudan,SDN,Liechtenstein,LIE,0,0,0,5,5
2021,Ukraine,UKR,Liechtenstein,LIE,0,0,0,10,10
2021,Afghanistan,AFG,Lithuania,LTU,0,0,5,0,5
2021,Armenia,ARM,Lithuania,LTU,0,0,0,10,10
2021,Belarus,BLR,Lithuania,LTU,0,0,10,19,29
2021,India,IND,Lithuania,LTU,0,0,0,5,5
2021,Iran (Islamic Rep. of),IRN,Lithuania,LTU,5,0,0,0,5
2021,Iraq,IRQ,Lithuania,LTU,0,0,5,5,10
2021,Kyrgyzstan,KGZ,Lithuania,LTU,0,0,5,0,5
2021,Rep. of Moldova,MDA,Lithuania,LTU,0,0,5,0,5
2021,Russian Federation,RUS,Lithuania,LTU,24,0,102,156,282
2021,Syrian Arab Rep.,SYR,Lithuania,LTU,10,0,0,0,10
2021,Tajikistan,TJK,Lithuania,LTU,12,0,114,71,197
2021,Turkey,TUR,Lithuania,LTU,17,0,5,0,22
2021,Ukraine,UKR,Lithuania,LTU,0,0,5,0,5
2021,Uzbekistan,UZB,Lithuania,LTU,5,0,0,0,5
2021,Afghanistan,AFG,Luxembourg,LUX,80,30,35,0,145
2021,Albania,ALB,Luxembourg,LUX,0,0,15,0,15
2021,Algeria,DZA,Luxembourg,LUX,0,0,10,0,10
2021,Cameroon,CMR,Luxembourg,LUX,0,0,10,0,10
2021,Dem. Rep. of the Congo,COD,Luxembourg,LUX,0,0,10,0,10
2021,Colombia,COL,Luxembourg,LUX,0,0,5,0,5
2021,Eritrea,ERI,Luxembourg,LUX,285,0,5,0,290
2021,Ethiopia,ETH,Luxembourg,LUX,5,0,5,0,10
2021,Guinea,GIN,Luxembourg,LUX,0,0,5,0,5
2021,Cote d'Ivoire,CIV,Luxembourg,LUX,0,0,10,0,10
2021,Iran (Islamic Rep. of),IRN,Luxembourg,LUX,15,0,10,0,25
2021,Iraq,IRQ,Luxembourg,LUX,15,0,40,0,55
2021,Kuwait,KWT,Luxembourg,LUX,5,0,0,0,5
2021,Libya,LBY,Luxembourg,LUX,0,0,5,0,5
2021,Lebanon,LBN,Luxembourg,LUX,0,0,5,0,5
2021,Morocco,MAR,Luxembourg,LUX,0,0,5,0,5
2021,Serbia and Kosovo: S/RES/1244 (1999),SRB,Luxembourg,LUX,0,0,10,0,10
2021,Somalia,SOM,Luxembourg,LUX,10,0,15,0,25
2021,Sudan,SDN,Luxembourg,LUX,10,0,15,0,25
2021,Syrian Arab Rep.,SYR,Luxembourg,LUX,245,95,20,0,360
2021,Tajikistan,TJK,Luxembourg,LUX,0,0,5,0,5
2021,Tunisia,TUN,Luxembourg,LUX,0,0,10,0,10
2021,Turkey,TUR,Luxembourg,LUX,35,0,5,0,40
2021,Venezuela (Bolivarian Republic of),VEN,Luxembourg,LUX,0,5,20,0,25
2021,Yemen,YEM,Luxembourg,LUX,10,0,5,0,15
2021,Afghanistan,AFG,Latvia,LVA,22,5,0,0,27
2021,Azerbaijan,AZE,Latvia,LVA,0,0,11,5,16
2021,Bangladesh,BGD,Latvia,LVA,0,0,5,0,5
2021,Belarus,BLR,Latvia,LVA,34,17,0,5,56
2021,China,CHN,Latvia,LVA,5,0,0,0,5
2021,Cameroon,CMR,Latvia,LVA,0,0,5,0,5
2021,Dem. Rep. of the Congo,COD,Latvia,LVA,0,0,5,0,5
2021,Georgia,GEO,Latvia,LVA,0,0,5,0,5
2021,India,IND,Latvia,LVA,0,0,0,5,5
2021,Iran (Islamic Rep. of),IRN,Latvia,LVA,0,0,5,0,5
2021,Iraq,IRQ,Latvia,LVA,0,0,32,220,252
2021,Sri Lanka,LKA,Latvia,LVA,0,0,0,5,5
2021,Pakistan,PAK,Latvia,LVA,0,0,5,0,5
2021,Russian Federation,RUS,Latvia,LVA,0,0,10,14,24
2021,Syrian Arab Rep.,SYR,Latvia,LVA,0,0,0,5,5
2021,Turkey,TUR,Latvia,LVA,5,0,0,0,5
2021,Ukraine,UKR,Latvia,LVA,0,0,5,0,5
2021,Uzbekistan,UZB,Latvia,LVA,0,0,5,0,5
2021,Armenia,ARM,Rep. of Moldova,MDA,0,0,5,0,5
2021,Iraq,IRQ,Rep. of Moldova,MDA,0,0,0,5,5
2021,Russian Federation,RUS,Rep. of Moldova,MDA,0,0,5,0,5
2021,Syrian Arab Rep.,SYR,Rep. of Moldova,MDA,0,5,0,0,5
2021,Turkey,TUR,Rep. of Moldova,MDA,10,0,5,5,20
2021,Ukraine,UKR,Rep. of Moldova,MDA,0,0,5,0,5
2021,Angola,AGO,Mexico,MEX,0,0,0,58,58
2021,Argentina,ARG,Mexico,MEX,0,0,64,10,74
2021,Benin,BEN,Mexico,MEX,5,0,0,0,5
2021,Bangladesh,BGD,Mexico,MEX,5,0,0,5,10
2021,Burkina Faso,BFA,Mexico,MEX,10,0,12,10,32
2021,Bolivia (Plurinational State of),BOL,Mexico,MEX,0,0,5,0,5
2021,Brazil,BRA,Mexico,MEX,65,36,97,155,353
2021,Belize,BLZ,Mexico,MEX,15,0,11,0,26
2021,China,CHN,Mexico,MEX,0,0,13,0,13
2021,Chile,CHL,Mexico,MEX,116,74,177,332,699
2021,Cameroon,CMR,Mexico,MEX,5,0,5,19,29
2021,Congo,COG,Mexico,MEX,0,0,0,11,11
2021,Dem. Rep. of the Congo,COD,Mexico,MEX,5,0,0,35,40
2021,Colombia,COL,Mexico,MEX,82,0,226,101,409
2021,Costa Rica,CRI,Mexico,MEX,25,5,16,12,58
2021,Cuba,CUB,Mexico,MEX,1766,0,780,4306,6852
2021,Dominican Rep.,DOM,Mexico,MEX,14,0,27,17,58
2021,Ecuador,ECU,Mexico,MEX,20,5,27,27,79
2021,Equatorial Guinea,GNQ,Mexico,MEX,0,0,5,0,5
2021,French Guiana,GUF,Mexico,MEX,0,0,0,5,5
2021,Ghana,GHA,Mexico,MEX,21,0,33,28,82
2021,Guatemala,GTM,Mexico,MEX,1167,17,827,1133,3144
2021,Guinea,GIN,Mexico,MEX,29,5,5,5,44
2021,Haiti,HTI,Mexico,MEX,1285,667,3585,2594,8131
2021,Honduras,HND,Mexico,MEX,15135,5,2684,8327,26151
2021,Cote d'Ivoire,CIV,Mexico,MEX,0,0,13,5,18
2021,India,IND,Mexico,MEX,0,0,0,10,10
2021,Iran (Islamic Rep. of),IRN,Mexico,MEX,0,0,0,5,5
2021,Italy,ITA,Mexico,MEX,0,0,5,0,5
2021,Kyrgyzstan,KGZ,Mexico,MEX,5,0,0,5,10
2021,Sri Lanka,LKA,Mexico,MEX,0,0,0,16,16
2021,Mauritania,MRT,Mexico,MEX,13,0,0,0,13
2021,Mali,MLI,Mexico,MEX,0,0,11,0,11
2021,Morocco,MAR,Mexico,MEX,5,0,0,0,5
2021,Nepal,NPL,Mexico,MEX,0,0,0,10,10
2021,Nicaragua,NIC,Mexico,MEX,698,20,409,362,1489
2021,Nigeria,NGA,Mexico,MEX,0,0,11,0,11
2021,Pakistan,PAK,Mexico,MEX,0,0,5,0,5
2021,Panama,PAN,Mexico,MEX,20,15,26,5,66
2021,Peru,PER,Mexico,MEX,10,0,13,5,28
2021,Portugal,PRT,Mexico,MEX,0,0,0,5,5
2021,Russian Federation,RUS,Mexico,MEX,5,0,0,5,10
2021,El Salvador,SLV,Mexico,MEX,3037,0,535,1815,5387
2021,Senegal,SEN,Mexico,MEX,0,0,0,10,10
2021,Sierra Leone,SLE,Mexico,MEX,13,0,0,5,18
2021,Spain,ESP,Mexico,MEX,5,0,5,0,10
2021,Syrian Arab Rep.,SYR,Mexico,MEX,5,0,0,0,5
2021,Tajikistan,TJK,Mexico,MEX,0,0,0,5,5
2021,Togo,TGO,Mexico,MEX,18,0,0,10,28
2021,Trinidad and Tobago,TTO,Mexico,MEX,5,0,0,0,5
2021,Uganda,UGA,Mexico,MEX,0,0,0,38,38
2021,Uruguay,URY,Mexico,MEX,13,0,10,16,39
2021,United States of America,USA,Mexico,MEX,11,0,5,12,28
2021,Uzbekistan,UZB,Mexico,MEX,0,0,0,10,10
2021,Venezuela (Bolivarian Republic of),VEN,Mexico,MEX,3571,0,104,698,4373
2021,Yemen,YEM,Mexico,MEX,12,0,0,5,17
2021,Burundi,BDI,Mali,MLI,5,0,0,0,5
2021,Central African Rep.,CAF,Mali,MLI,116,0,0,11,127
2021,Cameroon,CMR,Mali,MLI,5,0,0,0,5
2021,Congo,COG,Mali,MLI,5,0,0,0,5
2021,Dem. Rep. of the Congo,COD,Mali,MLI,15,0,0,0,15
2021,Cote d'Ivoire,CIV,Mali,MLI,0,0,0,12,12
2021,Rwanda,RWA,Mali,MLI,5,0,0,0,5
2021,Syrian Arab Rep.,SYR,Mali,MLI,0,0,0,5,5
2021,Togo,TGO,Mali,MLI,5,0,0,0,5
2021,Turkey,TUR,Mali,MLI,13,0,0,5,18
2021,Burundi,BDI,Malawi,MWI,1221,0,0,47,1268
2021,Dem. Rep. of the Congo,COD,Malawi,MWI,5088,0,0,93,5181
2021,Rwanda,RWA,Malawi,MWI,246,0,0,22,268
2021,Somalia,SOM,Malawi,MWI,10,0,0,0,10
2021,Turkey,TUR,Malawi,MWI,33,0,0,0,33
2021,Algeria,DZA,Malta,MLT,0,0,10,5,15
2021,Egypt,EGY,Malta,MLT,0,0,87,26,113
2021,Benin,BEN,Malta,MLT,0,0,0,5,5
2021,Bangladesh,BGD,Malta,MLT,0,0,129,38,167
2021,Burkina Faso,BFA,Malta,MLT,0,0,5,5,10
2021,Brazil,BRA,Malta,MLT,0,0,0,5,5
2021,Central African Rep.,CAF,Malta,MLT,0,0,0,5,5
2021,Chad,TCD,Malta,MLT,0,0,10,29,39
2021,Cameroon,CMR,Malta,MLT,0,0,10,22,32
2021,Dem. Rep. of the Congo,COD,Malta,MLT,0,0,0,5,5
2021,Colombia,COL,Malta,MLT,0,0,0,12,12
2021,Eritrea,ERI,Malta,MLT,0,58,5,142,205
2021,Ethiopia,ETH,Malta,MLT,0,0,5,13,18
2021,Gambia,GMB,Malta,MLT,0,0,0,39,39
2021,Palestinian,PSE,Malta,MLT,0,5,0,5,10
2021,Ghana,GHA,Malta,MLT,0,0,15,17,32
2021,Guinea,GIN,Malta,MLT,0,0,5,50,55
2021,Cote d'Ivoire,CIV,Malta,MLT,0,0,30,87,117
2021,Iraq,IRQ,Malta,MLT,0,0,0,5,5
2021,Libya,LBY,Malta,MLT,5,32,16,94,147
2021,Mali,MLI,Malta,MLT,0,0,5,56,61
2021,Morocco,MAR,Malta,MLT,0,0,60,31,91
2021,Nepal,NPL,Malta,MLT,0,0,12,0,12
2021,Niger,NER,Malta,MLT,0,0,0,5,5
2021,Nigeria,NGA,Malta,MLT,0,0,30,60,90
2021,Pakistan,PAK,Malta,MLT,0,0,5,33,38
2021,Russian Federation,RUS,Malta,MLT,0,0,0,5,5
2021,Senegal,SEN,Malta,MLT,0,0,13,16,29
2021,Sierra Leone,SLE,Malta,MLT,0,0,5,10,15
2021,Somalia,SOM,Malta,MLT,0,5,0,84,89
2021,Sudan,SDN,Malta,MLT,5,0,0,581,586
2021,South Sudan,SSD,Malta,MLT,0,0,5,54,59
2021,Syrian Arab Rep.,SYR,Malta,MLT,0,48,0,110,158
2021,Togo,TGO,Malta,MLT,0,0,0,5,5
2021,Tunisia,TUN,Malta,MLT,0,0,5,10,15
2021,Turkey,TUR,Malta,MLT,0,0,0,10,10
2021,Ukraine,UKR,Malta,MLT,0,0,5,31,36
2021,Venezuela (Bolivarian Republic of),VEN,Malta,MLT,0,19,5,15,39
2021,Yemen,YEM,Malta,MLT,0,0,0,5,5
2021,Angola,AGO,Namibia,NAM,5,0,0,0,5
2021,Burundi,BDI,Namibia,NAM,15,0,0,15,30
2021,Cameroon,CMR,Namibia,NAM,0,0,0,5,5
2021,Congo,COG,Namibia,NAM,0,0,0,5,5
2021,Dem. Rep. of the Congo,COD,Namibia,NAM,199,0,0,31,230
2021,Rwanda,RWA,Namibia,NAM,5,0,0,5,10
2021,Zimbabwe,ZWE,Namibia,NAM,0,0,0,16,16
2021,Afghanistan,AFG,Netherlands,NLD,2344,313,82,118,2857
2021,Albania,ALB,Netherlands,NLD,0,0,21,35,56
2021,Algeria,DZA,Netherlands,NLD,5,0,99,830,934
2021,Angola,AGO,Netherlands,NLD,0,0,16,0,16
2021,Egypt,EGY,Netherlands,NLD,83,32,67,26,208
2021,Argentina,ARG,Netherlands,NLD,0,5,0,0,5
2021,Armenia,ARM,Netherlands,NLD,10,0,16,10,36
2021,Australia,AUS,Netherlands,NLD,0,0,5,0,5
2021,Azerbaijan,AZE,Netherlands,NLD,14,16,12,38,80
2021,Burundi,BDI,Netherlands,NLD,0,0,5,0,5
2021,Bangladesh,BGD,Netherlands,NLD,5,5,14,5,29
2021,Burkina Faso,BFA,Netherlands,NLD,0,0,5,5,10
2021,Belarus,BLR,Netherlands,NLD,11,5,13,58,87
2021,Brazil,BRA,Netherlands,NLD,0,0,5,5,10
2021,Bosnia and Herzegovina,BIH,Netherlands,NLD,0,0,0,5,5
2021,Canada,CAN,Netherlands,NLD,0,0,0,5,5
2021,Chad,TCD,Netherlands,NLD,0,0,0,5,5
2021,China,CHN,Netherlands,NLD,102,14,29,13,158
2021,Chile,CHL,Netherlands,NLD,0,0,5,0,5
2021,Cameroon,CMR,Netherlands,NLD,11,0,19,15,45
2021,Congo,COG,Netherlands,NLD,12,0,5,5,22
2021,Dem. Rep. of the Congo,COD,Netherlands,NLD,0,0,12,0,12
2021,Comoros,COM,Netherlands,NLD,0,0,0,5,5
2021,Colombia,COL,Netherlands,NLD,66,14,96,16,192
2021,Cuba,CUB,Netherlands,NLD,13,0,0,0,13
2021,Djibouti,DJI,Netherlands,NLD,0,0,0,5,5
2021,Dominican Rep.,DOM,Netherlands,NLD,5,0,0,0,5
2021,Eritrea,ERI,Netherlands,NLD,312,61,73,154,600
2021,Ethiopia,ETH,Netherlands,NLD,29,10,33,20,92
2021,Gambia,GMB,Netherlands,NLD,19,0,63,112,194
2021,Palestinian,PSE,Netherlands,NLD,0,0,0,5,5
2021,Georgia,GEO,Netherlands,NLD,0,0,69,28,97
2021,Ghana,GHA,Netherlands,NLD,0,0,16,26,42
2021,Guinea-Bissau,GNB,Netherlands,NLD,0,0,0,11,11
2021,Guinea,GIN,Netherlands,NLD,25,0,54,57,136
2021,Guyana,GUY,Netherlands,NLD,5,0,0,0,5
2021,Haiti,HTI,Netherlands,NLD,0,0,5,0,5
2021,Honduras,HND,Netherlands,NLD,0,0,11,0,11
2021,Cote d'Ivoire,CIV,Netherlands,NLD,0,0,12,5,17
2021,India,IND,Netherlands,NLD,0,0,43,38,81
2021,Indonesia,IDN,Netherlands,NLD,5,5,11,0,21
2021,Iran (Islamic Rep. of),IRN,Netherlands,NLD,926,303,599,66,1894
2021,Iraq,IRQ,Netherlands,NLD,149,29,150,116,444
2021,Jamaica,JAM,Netherlands,NLD,0,0,0,11,11
2021,Jordan,JOR,Netherlands,NLD,30,10,68,5,113
2021,Kazakhstan,KAZ,Netherlands,NLD,13,5,0,5,23
2021,Kenya,KEN,Netherlands,NLD,5,0,5,0,10
2021,Kyrgyzstan,KGZ,Netherlands,NLD,0,0,0,5,5
2021,Rep. of Korea,KOR,Netherlands,NLD,0,0,0,5,5
2021,Kuwait,KWT,Netherlands,NLD,0,0,0,5,5
2021,Liberia,LBR,Netherlands,NLD,0,0,0,12,12
2021,Libya,LBY,Netherlands,NLD,21,12,45,84,162
2021,Lebanon,LBN,Netherlands,NLD,43,11,55,11,120
2021,Sri Lanka,LKA,Netherlands,NLD,14,5,23,5,47
2021,Mauritania,MRT,Netherlands,NLD,0,0,0,5,5
2021,North Macedonia,MKD,Netherlands,NLD,0,0,5,12,17
2021,Rep. of Moldova,MDA,Netherlands,NLD,0,0,33,5,38
2021,Mexico,MEX,Netherlands,NLD,5,0,13,0,18
2021,Mali,MLI,Netherlands,NLD,0,0,10,12,22
2021,Malaysia,MYS,Netherlands,NLD,5,5,0,0,10
2021,Mongolia,MNG,Netherlands,NLD,0,0,0,5,5
2021,Morocco,MAR,Netherlands,NLD,16,0,206,625,847
2021,Myanmar,MMR,Netherlands,NLD,14,0,11,0,25
2021,Nepal,NPL,Netherlands,NLD,0,0,5,0,5
2021,Niger,NER,Netherlands,NLD,0,0,5,13,18
2021,Nicaragua,NIC,Netherlands,NLD,18,10,5,0,33
2021,Nigeria,NGA,Netherlands,NLD,57,5,295,306,663
2021,Pakistan,PAK,Netherlands,NLD,161,43,88,132,424
2021,Peru,PER,Netherlands,NLD,0,0,13,0,13
2021,Philippines,PHL,Netherlands,NLD,0,0,5,0,5
2021,South Africa,ZAF,Netherlands,NLD,0,0,5,0,5
2021,Russian Federation,RUS,Netherlands,NLD,116,19,51,44,230
2021,Rwanda,RWA,Netherlands,NLD,0,0,5,0,5
2021,El Salvador,SLV,Netherlands,NLD,23,11,17,0,51
2021,Saudi Arabia,SAU,Netherlands,NLD,12,0,0,5,17
2021,Serbia and Kosovo: S/RES/1244 (1999),SRB,Netherlands,NLD,0,0,42,26,68
2021,Senegal,SEN,Netherlands,NLD,0,0,14,33,47
2021,Sierra Leone,SLE,Netherlands,NLD,15,0,32,32,79
2021,Somalia,SOM,Netherlands,NLD,143,25,88,68,324
2021,Viet Nam,VNM,Netherlands,NLD,0,0,10,10,20
2021,Sudan,SDN,Netherlands,NLD,33,5,33,79,150
2021,Suriname,SUR,Netherlands,NLD,0,5,11,0,16
2021,South Sudan,SSD,Netherlands,NLD,0,0,5,13,18
2021,Syrian Arab Rep.,SYR,Netherlands,NLD,3501,39,282,450,4272
2021,United Rep. of Tanzania,TZA,Netherlands,NLD,5,5,17,0,27
2021,Thailand,THA,Netherlands,NLD,0,0,5,0,5
2021,Tajikistan,TJK,Netherlands,NLD,0,0,5,13,18
2021,Turkmenistan,TKM,Netherlands,NLD,12,0,0,0,12
2021,Timor-Leste,TLS,Netherlands,NLD,0,0,5,0,5
2021,Togo,TGO,Netherlands,NLD,0,0,0,5,5
2021,Trinidad and Tobago,TTO,Netherlands,NLD,5,0,0,0,5
2021,Tunisia,TUN,Netherlands,NLD,5,0,23,218,246
2021,Turkey,TUR,Netherlands,NLD,1017,205,74,44,1340
2021,Uganda,UGA,Netherlands,NLD,66,5,120,12,203
2021,Ukraine,UKR,Netherlands,NLD,10,5,34,17,66
2021,United States of America,USA,Netherlands,NLD,0,0,5,5,10
2021,Uzbekistan,UZB,Netherlands,NLD,0,0,19,5,24
2021,Venezuela (Bolivarian Republic of),VEN,Netherlands,NLD,54,11,137,12,214
2021,Yemen,YEM,Netherlands,NLD,393,5,20,23,441
2021,Zimbabwe,ZWE,Netherlands,NLD,12,0,15,0,27
2021,Stateless,XXA,Netherlands,NLD,138,18,34,5,195
2021,Central African Rep.,CAF,Niger,NER,15,0,0,5,20
2021,Cameroon,CMR,Niger,NER,15,0,5,18,38
2021,Congo,COG,Niger,NER,0,0,0,5,5
2021,Dem. Rep. of the Congo,COD,Niger,NER,5,0,0,0,5
2021,Eritrea,ERI,Niger,NER,0,0,0,5,5
2021,Ethiopia,ETH,Niger,NER,5,0,0,0,5
2021,Guinea,GIN,Niger,NER,0,0,0,5,5
2021,Cote d'Ivoire,CIV,Niger,NER,5,0,0,0,5
2021,Libya,LBY,Niger,NER,0,0,0,5,5
2021,Mali,MLI,Niger,NER,0,0,0,5,5
2021,Nigeria,NGA,Niger,NER,0,0,0,10,10
2021,Pakistan,PAK,Niger,NER,0,0,0,5,5
2021,Somalia,SOM,Niger,NER,0,0,0,11,11
2021,Sudan,SDN,Niger,NER,106,0,60,290,456
2021,Togo,TGO,Niger,NER,0,0,5,0,5
2021,Central African Rep.,CAF,Nigeria,NGA,100,0,0,181,281
2021,Chad,TCD,Nigeria,NGA,0,0,0,10,10
2021,Cameroon,CMR,Nigeria,NGA,153,0,0,199,352
2021,Dem. Rep. of the Congo,COD,Nigeria,NGA,5,0,0,17,22
2021,Eritrea,ERI,Nigeria,NGA,5,0,0,0,5
2021,Ethiopia,ETH,Nigeria,NGA,5,0,0,0,5
2021,Palestinian,PSE,Nigeria,NGA,5,0,0,0,5
2021,Iran (Islamic Rep. of),IRN,Nigeria,NGA,5,0,0,0,5
2021,Lebanon,LBN,Nigeria,NGA,5,0,0,0,5
2021,Niger,NER,Nigeria,NGA,0,0,0,1430,1430
2021,Syrian Arab Rep.,SYR,Nigeria,NGA,108,0,0,33,141
2021,Turkey,TUR,Nigeria,NGA,42,0,0,5,47
2021,Afghanistan,AFG,Norway,NOR,32,108,17,20,177
2021,Albania,ALB,Norway,NOR,0,0,13,5,18
2021,Algeria,DZA,Norway,NOR,0,0,0,5,5
2021,Bosnia and Herzegovina,BIH,Norway,NOR,0,0,0,5,5
2021,Cameroon,CMR,Norway,NOR,0,0,5,0,5
2021,Dem. Rep. of the Congo,COD,Norway,NOR,10,0,0,0,10
2021,Colombia,COL,Norway,NOR,0,0,12,0,12
2021,Eritrea,ERI,Norway,NOR,156,5,5,15,181
2021,Ethiopia,ETH,Norway,NOR,0,0,14,5,19
2021,Georgia,GEO,Norway,NOR,0,0,5,0,5
2021,Ghana,GHA,Norway,NOR,0,0,5,0,5
2021,Hungary,HUN,Norway,NOR,0,0,5,0,5
2021,Iran (Islamic Rep. of),IRN,Norway,NOR,10,0,21,5,36
2021,Iraq,IRQ,Norway,NOR,5,0,11,11,27
2021,Lebanon,LBN,Norway,NOR,0,0,0,5,5
2021,Rep. of Moldova,MDA,Norway,NOR,0,0,5,0,5
2021,Morocco,MAR,Norway,NOR,0,0,0,5,5
2021,Montenegro,MNE,Norway,NOR,0,0,5,0,5
2021,Nigeria,NGA,Norway,NOR,0,0,11,0,11
2021,Pakistan,PAK,Norway,NOR,0,0,12,0,12
2021,Russian Federation,RUS,Norway,NOR,0,0,0,10,10
2021,Serbia and Kosovo: S/RES/1244 (1999),SRB,Norway,NOR,0,0,0,5,5
2021,Somalia,SOM,Norway,NOR,13,0,5,5,23
2021,Sudan,SDN,Norway,NOR,5,0,0,5,10
2021,South Sudan,SSD,Norway,NOR,0,0,0,5,5
2021,Syrian Arab Rep.,SYR,Norway,NOR,553,0,5,59,617
2021,Tajikistan,TJK,Norway,NOR,0,0,0,5,5
2021,Tunisia,TUN,Norway,NOR,0,0,0,5,5
2021,Turkey,TUR,Norway,NOR,80,0,0,10,90
2021,Ukraine,UKR,Norway,NOR,0,0,5,0,5
2021,Uzbekistan,UZB,Norway,NOR,5,0,0,0,5
2021,Venezuela (Bolivarian Republic of),VEN,Norway,NOR,0,0,5,0,5
2021,Yemen,YEM,Norway,NOR,0,18,0,0,18
2021,Stateless,XXA,Norway,NOR,26,0,5,12,43
2021,Sri Lanka,LKA,Nauru,NRU,0,0,0,5,5
2021,Pakistan,PAK,Nauru,NRU,5,0,0,0,5
2021,Afghanistan,AFG,New Zealand,NZL,18,0,0,0,18
2021,Bangladesh,BGD,New Zealand,NZL,0,0,11,0,11
2021,China,CHN,New Zealand,NZL,32,0,21,10,63
2021,Chile,CHL,New Zealand,NZL,0,0,0,5,5
2021,Cameroon,CMR,New Zealand,NZL,0,0,5,0,5
2021,Colombia,COL,New Zealand,NZL,0,0,0,13,13
2021,Ethiopia,ETH,New Zealand,NZL,5,0,5,0,10
2021,Fiji,FJI,New Zealand,NZL,5,0,0,0,5
2021,Palestinian,PSE,New Zealand,NZL,0,0,0,5,5
2021,India,IND,New Zealand,NZL,0,0,35,14,49
2021,Indonesia,IDN,New Zealand,NZL,0,0,43,24,67
2021,Iran (Islamic Rep. of),IRN,New Zealand,NZL,5,0,5,0,10
2021,Sri Lanka,LKA,New Zealand,NZL,5,0,12,0,17
2021,Malaysia,MYS,New Zealand,NZL,5,0,23,5,33
2021,Mongolia,MNG,New Zealand,NZL,0,0,5,0,5
2021,Nepal,NPL,New Zealand,NZL,0,0,5,0,5
2021,Nigeria,NGA,New Zealand,NZL,0,0,0,5,5
2021,Pakistan,PAK,New Zealand,NZL,0,0,5,0,5
2021,Philippines,PHL,New Zealand,NZL,0,0,11,0,11
2021,Portugal,PRT,New Zealand,NZL,0,0,5,0,5
2021,South Africa,ZAF,New Zealand,NZL,0,0,0,5,5
2021,Russian Federation,RUS,New Zealand,NZL,5,0,11,0,16
2021,Saudi Arabia,SAU,New Zealand,NZL,5,0,0,0,5
2021,Viet Nam,VNM,New Zealand,NZL,0,0,5,0,5
2021,Turkey,TUR,New Zealand,NZL,5,0,0,0,5
2021,Samoa,WSM,New Zealand,NZL,0,0,0,5,5
2021,Colombia,COL,Panama,PAN,0,0,106,83,189
2021,Cuba,CUB,Panama,PAN,0,0,99,530,629
2021,Ecuador,ECU,Panama,PAN,0,0,5,5,10
2021,Honduras,HND,Panama,PAN,0,0,0,5,5
2021,Nicaragua,NIC,Panama,PAN,0,0,118,344,462
2021,El Salvador,SLV,Panama,PAN,0,0,5,33,38
2021,Venezuela (Bolivarian Republic of),VEN,Panama,PAN,0,0,95,151,246
2021,Cuba,CUB,Paraguay,PRY,653,0,0,0,653
2021,Venezuela (Bolivarian Republic of),VEN,Paraguay,PRY,2148,0,0,0,2148
2021,Colombia,COL,Peru,PER,5,0,0,0,5
2021,Cuba,CUB,Peru,PER,25,0,14,5,44
2021,Haiti,HTI,Peru,PER,5,0,0,0,5
2021,Syrian Arab Rep.,SYR,Peru,PER,5,0,0,0,5
2021,Turkey,TUR,Peru,PER,5,0,0,0,5
2021,Venezuela (Bolivarian Republic of),VEN,Peru,PER,1470,0,63,406,1939
2021,Iran (Islamic Rep. of),IRN,Papua New Guinea,PNG,0,0,0,11,11
2021,Afghanistan,AFG,Poland,POL,751,5,52,530,1338
2021,Algeria,DZA,Poland,POL,0,0,5,5,10
2021,Angola,AGO,Poland,POL,0,0,5,0,5
2021,Egypt,EGY,Poland,POL,0,0,21,5,26
2021,Armenia,ARM,Poland,POL,0,0,41,10,51
2021,Azerbaijan,AZE,Poland,POL,0,0,36,0,36
2021,Bangladesh,BGD,Poland,POL,0,0,10,0,10
2021,Belarus,BLR,Poland,POL,140,1007,17,53,1217
2021,Bulgaria,BGR,Poland,POL,0,0,0,10,10
2021,Congo,COG,Poland,POL,0,0,5,0,5
2021,Dem. Rep. of the Congo,COD,Poland,POL,0,0,0,5,5
2021,Cuba,CUB,Poland,POL,0,0,22,0,22
2021,Ethiopia,ETH,Poland,POL,0,0,0,5,5
2021,Palestinian,PSE,Poland,POL,5,0,0,0,5
2021,Georgia,GEO,Poland,POL,0,0,92,23,115
2021,Guinea,GIN,Poland,POL,0,0,5,0,5
2021,India,IND,Poland,POL,0,0,5,5,10
2021,Iran (Islamic Rep. of),IRN,Poland,POL,0,0,38,10,48
2021,Iraq,IRQ,Poland,POL,0,0,274,43,317
2021,Kazakhstan,KAZ,Poland,POL,0,0,28,5,33
2021,Kyrgyzstan,KGZ,Poland,POL,5,0,61,0,66
2021,Libya,LBY,Poland,POL,0,5,0,0,5
2021,Lebanon,LBN,Poland,POL,0,5,5,0,10
2021,Sri Lanka,LKA,Poland,POL,0,0,22,5,27
2021,Rep. of Moldova,MDA,Poland,POL,0,0,5,5,10
2021,Morocco,MAR,Poland,POL,0,0,17,0,17
2021,Netherlands,NLD,Poland,POL,0,0,0,5,5
2021,Nigeria,NGA,Poland,POL,0,0,15,5,20
2021,Pakistan,PAK,Poland,POL,0,0,23,28,51
2021,Russian Federation,RUS,Poland,POL,17,74,1634,236,1961
2021,Somalia,SOM,Poland,POL,0,5,0,0,5
2021,Viet Nam,VNM,Poland,POL,0,0,10,0,10
2021,Sudan,SDN,Poland,POL,0,0,5,0,5
2021,Syrian Arab Rep.,SYR,Poland,POL,12,5,0,32,49
2021,Tajikistan,TJK,Poland,POL,0,23,94,22,139
2021,Tunisia,TUN,Poland,POL,0,0,5,0,5
2021,Turkey,TUR,Poland,POL,76,0,20,25,121
2021,Ukraine,UKR,Poland,POL,0,5,472,43,520
2021,Uzbekistan,UZB,Poland,POL,0,0,0,10,10
2021,Venezuela (Bolivarian Republic of),VEN,Poland,POL,0,16,0,0,16
2021,Yemen,YEM,Poland,POL,5,5,0,0,10
2021,Stateless,XXA,Poland,POL,5,0,5,5,15
2021,Afghanistan,AFG,Portugal,PRT,67,34,0,0,101
2021,Algeria,DZA,Portugal,PRT,0,0,0,5,5
2021,Angola,AGO,Portugal,PRT,0,0,18,30,48
2021,Egypt,EGY,Portugal,PRT,5,0,0,0,5
2021,Brazil,BRA,Portugal,PRT,0,0,0,5,5
2021,China,CHN,Portugal,PRT,5,0,0,0,5
2021,Congo,COG,Portugal,PRT,5,0,0,0,5
2021,Dem. Rep. of the Congo,COD,Portugal,PRT,0,0,0,5,5
2021,Colombia,COL,Portugal,PRT,0,5,0,0,5
2021,Eritrea,ERI,Portugal,PRT,10,0,0,0,10
2021,Gambia,GMB,Portugal,PRT,5,0,10,10,25
2021,Ghana,GHA,Portugal,PRT,0,0,5,5,10
2021,Guinea-Bissau,GNB,Portugal,PRT,0,0,5,29,34
2021,Guinea,GIN,Portugal,PRT,0,0,0,12,12
2021,Cote d'Ivoire,CIV,Portugal,PRT,0,0,5,0,5
2021,India,IND,Portugal,PRT,0,0,0,17,17
2021,Iran (Islamic Rep. of),IRN,Portugal,PRT,10,0,0,0,10
2021,Iraq,IRQ,Portugal,PRT,17,0,0,0,17
2021,Liberia,LBR,Portugal,PRT,5,0,0,0,5
2021,Sri Lanka,LKA,Portugal,PRT,5,0,0,0,5
2021,Morocco,MAR,Portugal,PRT,0,0,0,44,44
2021,Nigeria,NGA,Portugal,PRT,12,0,0,0,12
2021,Pakistan,PAK,Portugal,PRT,5,0,0,0,5
2021,Russian Federation,RUS,Portugal,PRT,5,0,0,0,5
2021,Senegal,SEN,Portugal,PRT,0,0,5,12,17
2021,Sierra Leone,SLE,Portugal,PRT,0,0,5,0,5
2021,Somalia,SOM,Portugal,PRT,0,27,0,0,27
2021,Sudan,SDN,Portugal,PRT,0,10,0,0,10
2021,Syrian Arab Rep.,SYR,Portugal,PRT,73,0,0,0,73
2021,Turkey,TUR,Portugal,PRT,12,0,0,0,12
2021,Ukraine,UKR,Portugal,PRT,5,0,25,0,30
2021,Venezuela (Bolivarian Republic of),VEN,Portugal,PRT,0,0,14,0,14
2021,Afghanistan,AFG,Romania,ROU,164,15,804,3250,4233
2021,Albania,ALB,Romania,ROU,0,0,0,5,5
2021,Algeria,DZA,Romania,ROU,0,0,59,20,79
2021,Egypt,EGY,Romania,ROU,0,0,27,40,67
2021,Bangladesh,BGD,Romania,ROU,5,0,387,396,788
2021,Cameroon,CMR,Romania,ROU,5,0,5,18,28
2021,Dem. Rep. of the Congo,COD,Romania,ROU,0,0,5,0,5
2021,Cuba,CUB,Romania,ROU,5,0,0,0,5
2021,Eritrea,ERI,Romania,ROU,15,30,11,44,100
2021,Ethiopia,ETH,Romania,ROU,0,0,0,10,10
2021,Palestinian,PSE,Romania,ROU,5,5,5,11,26
2021,Ghana,GHA,Romania,ROU,0,0,0,5,5
2021,Guinea,GIN,Romania,ROU,0,0,0,5,5
2021,India,IND,Romania,ROU,0,0,285,146,431
2021,Iran (Islamic Rep. of),IRN,Romania,ROU,12,5,10,26,53
2021,Iraq,IRQ,Romania,ROU,50,31,54,306,441
2021,Kuwait,KWT,Romania,ROU,5,0,0,0,5
2021,Libya,LBY,Romania,ROU,0,0,11,14,25
2021,Lebanon,LBN,Romania,ROU,0,10,0,0,10
2021,Sri Lanka,LKA,Romania,ROU,0,0,20,41,61
2021,Rep. of Moldova,MDA,Romania,ROU,0,0,0,5,5
2021,Mali,MLI,Romania,ROU,0,5,0,0,5
2021,Morocco,MAR,Romania,ROU,0,0,68,22,90
2021,Myanmar,MMR,Romania,ROU,0,0,0,5,5
2021,Nepal,NPL,Romania,ROU,0,0,0,10,10
2021,Nigeria,NGA,Romania,ROU,0,0,0,5,5
2021,Pakistan,PAK,Romania,ROU,0,0,218,98,316
2021,Serbia and Kosovo: S/RES/1244 (1999),SRB,Romania,ROU,0,0,5,0,5
2021,Senegal,SEN,Romania,ROU,0,0,5,0,5
2021,Somalia,SOM,Romania,ROU,117,28,29,37,211
2021,Viet Nam,VNM,Romania,ROU,0,0,0,13,13
2021,Sudan,SDN,Romania,ROU,0,13,0,0,13
2021,Syrian Arab Rep.,SYR,Romania,ROU,88,448,47,634,1217
2021,Tunisia,TUN,Romania,ROU,0,0,65,42,107
2021,Turkey,TUR,Romania,ROU,5,0,28,289,322
2021,Yemen,YEM,Romania,ROU,5,30,0,0,35
2021,Stateless,XXA,Romania,ROU,25,20,5,0,50
2021,Afghanistan,AFG,Russian Federation,RUS,5,0,0,41,46
2021,Armenia,ARM,Russian Federation,RUS,0,0,0,5,5
2021,Belgium,BEL,Russian Federation,RUS,0,0,0,5,5
2021,Cuba,CUB,Russian Federation,RUS,0,0,0,5,5
2021,Kyrgyzstan,KGZ,Russian Federation,RUS,5,0,0,0,5
2021,Dem. People's Rep. of Korea,PRK,Russian Federation,RUS,0,0,0,5,5
2021,Syrian Arab Rep.,SYR,Russian Federation,RUS,0,0,0,24,24
2021,Tajikistan,TJK,Russian Federation,RUS,0,0,0,11,11
2021,Ukraine,UKR,Russian Federation,RUS,0,0,0,12,12
2021,Yemen,YEM,Russian Federation,RUS,0,0,0,5,5
2021,Burundi,BDI,Rwanda,RWA,23,0,0,0,23
2021,Dem. Rep. of the Congo,COD,Rwanda,RWA,87,0,0,43,130
2021,Eritrea,ERI,Rwanda,RWA,172,0,0,0,172
2021,Ethiopia,ETH,Rwanda,RWA,5,0,0,0,5
2021,Nigeria,NGA,Rwanda,RWA,0,0,0,5,5
2021,Somalia,SOM,Rwanda,RWA,14,0,0,5,19
2021,Sudan,SDN,Rwanda,RWA,133,0,0,0,133
2021,Colombia,COL,El Salvador,SLV,5,0,0,0,5
2021,Cuba,CUB,El Salvador,SLV,5,0,0,5,10
2021,Guatemala,GTM,El Salvador,SLV,0,0,0,5,5
2021,Haiti,HTI,El Salvador,SLV,0,0,0,5,5
2021,Honduras,HND,El Salvador,SLV,11,0,0,0,11
2021,Nicaragua,NIC,El Salvador,SLV,5,0,0,5,10
2021,Venezuela (Bolivarian Republic of),VEN,El Salvador,SLV,10,0,0,14,24
2021,Afghanistan,AFG,Serbia and Kosovo: S/RES/1244 (1999),SRB,0,0,0,45,45
2021,Algeria,DZA,Serbia and Kosovo: S/RES/1244 (1999),SRB,0,0,0,77,77
2021,Egypt,EGY,Serbia and Kosovo: S/RES/1244 (1999),SRB,0,0,0,5,5
2021,Burundi,BDI,Serbia and Kosovo: S/RES/1244 (1999),SRB,0,0,11,0,11
2021,Bangladesh,BGD,Serbia and Kosovo: S/RES/1244 (1999),SRB,0,0,0,12,12
2021,China,CHN,Serbia and Kosovo: S/RES/1244 (1999),SRB,0,0,0,5,5
2021,Cuba,CUB,Serbia and Kosovo: S/RES/1244 (1999),SRB,0,0,5,5,10
2021,Palestinian,PSE,Serbia and Kosovo: S/RES/1244 (1999),SRB,5,0,0,33,38
2021,Ghana,GHA,Serbia and Kosovo: S/RES/1244 (1999),SRB,0,0,0,5,5
2021,India,IND,Serbia and Kosovo: S/RES/1244 (1999),SRB,0,0,0,10,10
2021,Iran (Islamic Rep. of),IRN,Serbia and Kosovo: S/RES/1244 (1999),SRB,0,0,12,19,31
2021,Iraq,IRQ,Serbia and Kosovo: S/RES/1244 (1999),SRB,5,0,0,42,47
2021,Jordan,JOR,Serbia and Kosovo: S/RES/1244 (1999),SRB,0,0,13,0,13
2021,Libya,LBY,Serbia and Kosovo: S/RES/1244 (1999),SRB,0,0,0,67,67
2021,Lebanon,LBN,Serbia and Kosovo: S/RES/1244 (1999),SRB,0,0,0,5,5
2021,Morocco,MAR,Serbia and Kosovo: S/RES/1244 (1999),SRB,0,0,10,143,153
2021,Nigeria,NGA,Serbia and Kosovo: S/RES/1244 (1999),SRB,0,0,5,0,5
2021,Pakistan,PAK,Serbia and Kosovo: S/RES/1244 (1999),SRB,0,0,0,10,10
2021,Somalia,SOM,Serbia and Kosovo: S/RES/1244 (1999),SRB,0,0,0,5,5
2021,Sudan,SDN,Serbia and Kosovo: S/RES/1244 (1999),SRB,0,0,0,5,5
2021,Syrian Arab Rep.,SYR,Serbia and Kosovo: S/RES/1244 (1999),SRB,12,5,0,208,225
2021,Togo,TGO,Serbia and Kosovo: S/RES/1244 (1999),SRB,0,0,0,5,5
2021,Tunisia,TUN,Serbia and Kosovo: S/RES/1244 (1999),SRB,0,0,0,16,16
2021,Turkey,TUR,Serbia and Kosovo: S/RES/1244 (1999),SRB,15,0,5,16,36
2021,Yemen,YEM,Serbia and Kosovo: S/RES/1244 (1999),SRB,0,0,0,5,5
2021,Stateless,XXA,Serbia and Kosovo: S/RES/1244 (1999),SRB,0,0,0,5,5
2021,Afghanistan,AFG,Spain,ESP,703,39,0,0,742
2021,Albania,ALB,Spain,ESP,5,0,111,0,116
2021,Algeria,DZA,Spain,ESP,43,5,556,0,604
2021,Angola,AGO,Spain,ESP,14,0,44,0,58
2021,Egypt,EGY,Spain,ESP,24,0,61,0,85
2021,Argentina,ARG,Spain,ESP,0,0,85,0,85
2021,Armenia,ARM,Spain,ESP,5,5,137,0,147
2021,Azerbaijan,AZE,Spain,ESP,0,0,13,0,13
2021,Benin,BEN,Spain,ESP,0,0,14,0,14
2021,Bangladesh,BGD,Spain,ESP,5,0,252,0,257
2021,Burkina Faso,BFA,Spain,ESP,0,0,15,0,15
2021,Belarus,BLR,Spain,ESP,0,0,30,0,30
2021,Bolivia (Plurinational State of),BOL,Spain,ESP,0,0,29,0,29
2021,Brazil,BRA,Spain,ESP,10,0,175,0,185
2021,Central African Rep.,CAF,Spain,ESP,5,21,0,0,26
2021,Chad,TCD,Spain,ESP,18,5,5,0,28
2021,China,CHN,Spain,ESP,5,0,28,0,33
2021,Chile,CHL,Spain,ESP,5,0,49,0,54
2021,Cameroon,CMR,Spain,ESP,18,0,96,0,114
2021,Congo,COG,Spain,ESP,20,0,10,0,30
2021,Dem. Rep. of the Congo,COD,Spain,ESP,20,0,40,0,60
2021,Colombia,COL,Spain,ESP,1169,53,18619,0,19841
2021,Costa Rica,CRI,Spain,ESP,0,0,10,0,10
2021,Cuba,CUB,Spain,ESP,24,0,836,0,860
2021,Dominican Rep.,DOM,Spain,ESP,0,0,20,0,20
2021,Ecuador,ECU,Spain,ESP,5,5,139,0,149
2021,Equatorial Guinea,GNQ,Spain,ESP,5,0,14,0,19
2021,Eritrea,ERI,Spain,ESP,18,0,5,0,23
2021,Ethiopia,ETH,Spain,ESP,0,5,0,0,5
2021,Gabon,GAB,Spain,ESP,5,0,0,0,5
2021,Gambia,GMB,Spain,ESP,5,0,544,0,549
2021,Palestinian,PSE,Spain,ESP,31,122,114,0,267
2021,United Kingdom of Great Britain and Northern Ireland,GBR,Spain,ESP,0,0,5,0,5
2021,Georgia,GEO,Spain,ESP,14,0,1298,0,1312
2021,Ghana,GHA,Spain,ESP,10,0,393,0,403
2021,Guinea-Bissau,GNB,Spain,ESP,0,0,86,0,86
2021,Guatemala,GTM,Spain,ESP,23,5,238,0,266
2021,Guinea,GIN,Spain,ESP,102,5,658,0,765
2021,Haiti,HTI,Spain,ESP,0,0,5,0,5
2021,Honduras,HND,Spain,ESP,554,12,4124,0,4690
2021,Cote d'Ivoire,CIV,Spain,ESP,43,11,182,0,236
2021,India,IND,Spain,ESP,5,0,54,0,59
2021,Iran (Islamic Rep. of),IRN,Spain,ESP,12,0,34,0,46
2021,Iraq,IRQ,Spain,ESP,5,5,42,0,52
2021,Jamaica,JAM,Spain,ESP,5,0,0,0,5
2021,Kazakhstan,KAZ,Spain,ESP,5,0,11,0,16
2021,Kenya,KEN,Spain,ESP,11,0,5,0,16
2021,Kyrgyzstan,KGZ,Spain,ESP,0,0,5,0,5
2021,Liberia,LBR,Spain,ESP,0,0,10,0,10
2021,Libya,LBY,Spain,ESP,11,23,0,0,34
2021,Lebanon,LBN,Spain,ESP,0,0,5,0,5
2021,Sri Lanka,LKA,Spain,ESP,0,5,0,0,5
2021,Mauritania,MRT,Spain,ESP,0,0,52,0,52
2021,North Macedonia,MKD,Spain,ESP,0,0,5,0,5
2021,Rep. of Moldova,MDA,Spain,ESP,0,0,28,0,28
2021,Mexico,MEX,Spain,ESP,24,0,190,0,214
2021,Mali,MLI,Spain,ESP,10,1114,230,0,1354
2021,Mongolia,MNG,Spain,ESP,0,0,5,0,5
2021,Morocco,MAR,Spain,ESP,179,0,1756,0,1935
2021,Niger,NER,Spain,ESP,13,5,10,0,28
2021,Nicaragua,NIC,Spain,ESP,498,0,1938,0,2436
2021,Nigeria,NGA,Spain,ESP,39,0,274,0,313
2021,Pakistan,PAK,Spain,ESP,59,5,2119,0,2183
2021,Panama,PAN,Spain,ESP,0,5,23,0,28
2021,Paraguay,PRY,Spain,ESP,5,0,22,0,27
2021,Peru,PER,Spain,ESP,123,23,4330,0,4476
2021,Russian Federation,RUS,Spain,ESP,102,5,224,0,331
2021,Rwanda,RWA,Spain,ESP,5,0,0,0,5
2021,El Salvador,SLV,Spain,ESP,147,15,2331,0,2493
2021,Serbia and Kosovo: S/RES/1244 (1999),SRB,Spain,ESP,0,0,10,0,10
2021,Senegal,SEN,Spain,ESP,11,5,1342,0,1358
2021,Sierra Leone,SLE,Spain,ESP,20,0,95,0,115
2021,Somalia,SOM,Spain,ESP,5,37,5,0,47
2021,Viet Nam,VNM,Spain,ESP,5,0,28,0,33
2021,Sudan,SDN,Spain,ESP,119,43,16,0,178
2021,Syrian Arab Rep.,SYR,Spain,ESP,63,264,133,0,460
2021,Tajikistan,TJK,Spain,ESP,0,0,5,0,5
2021,Togo,TGO,Spain,ESP,0,0,5,0,5
2021,Tunisia,TUN,Spain,ESP,36,0,341,0,377
2021,Turkey,TUR,Spain,ESP,58,0,63,0,121
2021,Ukraine,UKR,Spain,ESP,331,262,1802,0,2395
2021,Uruguay,URY,Spain,ESP,5,0,13,0,18
2021,United States of America,USA,Spain,ESP,5,5,25,0,35
2021,Uzbekistan,UZB,Spain,ESP,5,0,10,0,15
2021,Venezuela (Bolivarian Republic of),VEN,Spain,ESP,10,12855,2808,0,15673
2021,Yemen,YEM,Spain,ESP,16,60,89,0,165
2021,Stateless,XXA,Spain,ESP,0,0,5,0,5
2021,Burundi,BDI,Sudan,SDN,0,0,0,5,5
2021,Central African Rep.,CAF,Sudan,SDN,5,0,0,0,5
2021,Congo,COG,Sudan,SDN,5,0,0,0,5
2021,Dem. Rep. of the Congo,COD,Sudan,SDN,102,0,0,0,102
2021,Eritrea,ERI,Sudan,SDN,1234,0,0,0,1234
2021,Ethiopia,ETH,Sudan,SDN,452,0,44,0,496
2021,Somalia,SOM,Sudan,SDN,11,0,0,0,11
2021,Burundi,BDI,South Sudan,SSD,65,0,0,34,99
2021,Eritrea,ERI,South Sudan,SSD,96,0,0,15,111
2021,Ethiopia,ETH,South Sudan,SSD,75,0,0,0,75
2021,Afghanistan,AFG,Slovakia,SVK,16,5,5,48,74
2021,Algeria,DZA,Slovakia,SVK,0,0,14,20,34
2021,Egypt,EGY,Slovakia,SVK,0,0,0,5,5
2021,Bangladesh,BGD,Slovakia,SVK,0,0,13,0,13
2021,Cameroon,CMR,Slovakia,SVK,0,0,0,5,5
2021,Ghana,GHA,Slovakia,SVK,0,0,5,0,5
2021,India,IND,Slovakia,SVK,0,0,10,10,20
2021,Iran (Islamic Rep. of),IRN,Slovakia,SVK,10,0,0,0,10
2021,Libya,LBY,Slovakia,SVK,0,0,5,11,16
2021,Morocco,MAR,Slovakia,SVK,0,0,42,63,105
2021,Pakistan,PAK,Slovakia,SVK,0,0,12,0,12
2021,Somalia,SOM,Slovakia,SVK,0,5,0,0,5
2021,Syrian Arab Rep.,SYR,Slovakia,SVK,0,5,5,16,26
2021,Tunisia,TUN,Slovakia,SVK,0,0,0,11,11
2021,Turkey,TUR,Slovakia,SVK,0,0,5,23,28
2021,Yemen,YEM,Slovakia,SVK,5,0,0,0,5
2021,Afghanistan,AFG,Slovenia,SVN,5,0,10,2368,2383
2021,Albania,ALB,Slovenia,SVN,0,0,0,11,11
2021,Algeria,DZA,Slovenia,SVN,0,0,5,92,97
2021,Egypt,EGY,Slovenia,SVN,0,0,0,106,106
2021,Azerbaijan,AZE,Slovenia,SVN,0,0,5,0,5
2021,Bangladesh,BGD,Slovenia,SVN,0,0,0,216,216
2021,Burkina Faso,BFA,Slovenia,SVN,0,0,0,14,14
2021,Bolivia (Plurinational State of),BOL,Slovenia,SVN,0,0,0,5,5
2021,Central African Rep.,CAF,Slovenia,SVN,0,0,0,5,5
2021,China,CHN,Slovenia,SVN,0,0,0,5,5
2021,Cameroon,CMR,Slovenia,SVN,0,0,0,16,16
2021,Dem. Rep. of the Congo,COD,Slovenia,SVN,0,0,0,11,11
2021,Cuba,CUB,Slovenia,SVN,0,0,0,15,15
2021,Eritrea,ERI,Slovenia,SVN,0,0,0,5,5
2021,Gambia,GMB,Slovenia,SVN,0,0,0,43,43
2021,Palestinian,PSE,Slovenia,SVN,0,0,0,24,24
2021,Ghana,GHA,Slovenia,SVN,0,0,0,25,25
2021,Guinea,GIN,Slovenia,SVN,0,0,0,20,20
2021,Cote d'Ivoire,CIV,Slovenia,SVN,0,0,0,5,5
2021,India,IND,Slovenia,SVN,0,0,0,26,26
2021,Iran (Islamic Rep. of),IRN,Slovenia,SVN,5,0,5,333,343
2021,Iraq,IRQ,Slovenia,SVN,0,0,0,238,238
2021,Kazakhstan,KAZ,Slovenia,SVN,0,0,0,5,5
2021,Kuwait,KWT,Slovenia,SVN,0,0,0,12,12
2021,Libya,LBY,Slovenia,SVN,0,0,0,12,12
2021,Sri Lanka,LKA,Slovenia,SVN,0,0,0,5,5
2021,Mali,MLI,Slovenia,SVN,0,0,0,17,17
2021,Morocco,MAR,Slovenia,SVN,0,0,5,168,173
2021,Nepal,NPL,Slovenia,SVN,0,0,0,44,44
2021,Niger,NER,Slovenia,SVN,0,0,0,5,5
2021,Nigeria,NGA,Slovenia,SVN,0,0,0,5,5
2021,Pakistan,PAK,Slovenia,SVN,0,0,12,475,487
2021,Russian Federation,RUS,Slovenia,SVN,0,0,0,11,11
2021,Serbia and Kosovo: S/RES/1244 (1999),SRB,Slovenia,SVN,0,0,5,64,69
2021,Senegal,SEN,Slovenia,SVN,0,0,0,10,10
2021,Somalia,SOM,Slovenia,SVN,0,0,0,28,28
2021,Sudan,SDN,Slovenia,SVN,0,0,0,5,5
2021,Syrian Arab Rep.,SYR,Slovenia,SVN,5,0,0,91,96
2021,Togo,TGO,Slovenia,SVN,0,0,0,11,11
2021,Tunisia,TUN,Slovenia,SVN,0,0,0,51,51
2021,Turkey,TUR,Slovenia,SVN,0,0,0,256,256
2021,Burundi,BDI,Eswatini,SWZ,0,0,0,75,75
2021,Cameroon,CMR,Eswatini,SWZ,0,0,0,5,5
2021,Congo,COG,Eswatini,SWZ,0,0,0,119,119
2021,Dem. Rep. of the Congo,COD,Eswatini,SWZ,63,0,0,74,137
2021,Eritrea,ERI,Eswatini,SWZ,0,0,0,5,5
2021,Ethiopia,ETH,Eswatini,SWZ,0,0,0,66,66
2021,Rwanda,RWA,Eswatini,SWZ,0,0,0,36,36
2021,Somalia,SOM,Eswatini,SWZ,13,0,0,247,260
2021,Uganda,UGA,Eswatini,SWZ,0,0,0,5,5
2021,Zimbabwe,ZWE,Eswatini,SWZ,10,0,0,0,10
2021,Afghanistan,AFG,Sweden,SWE,186,38,141,185,550
2021,Albania,ALB,Sweden,SWE,0,0,140,20,160
2021,Algeria,DZA,Sweden,SWE,0,0,12,35,47
2021,Angola,AGO,Sweden,SWE,0,0,15,0,15
2021,Egypt,EGY,Sweden,SWE,21,0,78,15,114
2021,Argentina,ARG,Sweden,SWE,0,0,5,0,5
2021,Armenia,ARM,Sweden,SWE,0,0,34,5,39
2021,Azerbaijan,AZE,Sweden,SWE,5,0,54,20,79
2021,Burundi,BDI,Sweden,SWE,12,0,23,0,35
2021,Bangladesh,BGD,Sweden,SWE,20,0,124,10,154
2021,Belarus,BLR,Sweden,SWE,5,0,37,66,108
2021,Bolivia (Plurinational State of),BOL,Sweden,SWE,0,0,5,0,5
2021,Brazil,BRA,Sweden,SWE,0,0,12,0,12
2021,Bosnia and Herzegovina,BIH,Sweden,SWE,0,0,19,5,24
2021,Bulgaria,BGR,Sweden,SWE,0,0,5,0,5
2021,Canada,CAN,Sweden,SWE,0,0,0,5,5
2021,Chad,TCD,Sweden,SWE,0,0,0,5,5
2021,China,CHN,Sweden,SWE,15,0,10,5,30
2021,Chile,CHL,Sweden,SWE,0,0,12,5,17
2021,Cameroon,CMR,Sweden,SWE,26,5,68,18,117
2021,Congo,COG,Sweden,SWE,0,0,0,11,11
2021,Dem. Rep. of the Congo,COD,Sweden,SWE,10,5,22,5,42
2021,Colombia,COL,Sweden,SWE,0,0,41,5,46
2021,Cuba,CUB,Sweden,SWE,0,0,12,0,12
2021,Djibouti,DJI,Sweden,SWE,0,0,5,0,5
2021,Eritrea,ERI,Sweden,SWE,184,11,101,87,383
2021,Ethiopia,ETH,Sweden,SWE,31,0,149,31,211
2021,France,FRA,Sweden,SWE,0,0,5,0,5
2021,Gambia,GMB,Sweden,SWE,5,0,43,39,87
2021,Palestinian,PSE,Sweden,SWE,36,5,101,44,186
2021,United Kingdom of Great Britain and Northern Ireland,GBR,Sweden,SWE,0,0,5,0,5
2021,Georgia,GEO,Sweden,SWE,0,0,264,71,335
2021,Ghana,GHA,Sweden,SWE,0,0,16,11,27
2021,Guinea,GIN,Sweden,SWE,0,0,11,0,11
2021,Honduras,HND,Sweden,SWE,0,0,5,0,5
2021,Hungary,HUN,Sweden,SWE,0,0,5,0,5
2021,Cote d'Ivoire,CIV,Sweden,SWE,0,0,5,0,5
2021,India,IND,Sweden,SWE,0,0,26,5,31
2021,Iran (Islamic Rep. of),IRN,Sweden,SWE,211,0,412,55,678
2021,Iraq,IRQ,Sweden,SWE,50,17,251,148,466
2021,Italy,ITA,Sweden,SWE,0,0,5,0,5
2021,Jordan,JOR,Sweden,SWE,5,0,34,5,44
2021,Kazakhstan,KAZ,Sweden,SWE,0,0,56,18,74
2021,Kenya,KEN,Sweden,SWE,10,0,15,10,35
2021,Kyrgyzstan,KGZ,Sweden,SWE,5,0,64,19,88
2021,Liberia,LBR,Sweden,SWE,0,0,0,5,5
2021,Libya,LBY,Sweden,SWE,5,0,5,16,26
2021,Lebanon,LBN,Sweden,SWE,0,0,59,17,76
2021,Sri Lanka,LKA,Sweden,SWE,0,0,13,5,18
2021,North Macedonia,MKD,Sweden,SWE,0,0,22,5,27
2021,Mali,MLI,Sweden,SWE,0,0,0,5,5
2021,Mongolia,MNG,Sweden,SWE,0,0,221,19,240
2021,Morocco,MAR,Sweden,SWE,5,0,43,74,122
2021,Myanmar,MMR,Sweden,SWE,0,0,0,5,5
2021,Nepal,NPL,Sweden,SWE,0,0,5,0,5
2021,Nicaragua,NIC,Sweden,SWE,0,0,28,0,28
2021,Nigeria,NGA,Sweden,SWE,27,0,142,52,221
2021,Pakistan,PAK,Sweden,SWE,18,0,117,19,154
2021,Peru,PER,Sweden,SWE,0,0,24,0,24
2021,Philippines,PHL,Sweden,SWE,0,0,5,5,10
2021,Russian Federation,RUS,Sweden,SWE,10,0,97,44,151
2021,Rwanda,RWA,Sweden,SWE,5,0,23,5,33
2021,El Salvador,SLV,Sweden,SWE,0,0,23,5,28
2021,Saudi Arabia,SAU,Sweden,SWE,0,0,0,5,5
2021,Serbia and Kosovo: S/RES/1244 (1999),SRB,Sweden,SWE,0,0,75,12,87
2021,Senegal,SEN,Sweden,SWE,0,0,0,14,14
2021,Sierra Leone,SLE,Sweden,SWE,5,0,0,0,5
2021,Somalia,SOM,Sweden,SWE,61,5,119,92,277
2021,Spain,ESP,Sweden,SWE,0,0,5,0,5
2021,Viet Nam,VNM,Sweden,SWE,0,0,17,5,22
2021,Sudan,SDN,Sweden,SWE,10,0,53,5,68
2021,Syrian Arab Rep.,SYR,Sweden,SWE,346,318,184,224,1072
2021,United Rep. of Tanzania,TZA,Sweden,SWE,10,0,5,5,20
2021,Thailand,THA,Sweden,SWE,0,0,11,0,11
2021,Tajikistan,TJK,Sweden,SWE,5,0,42,5,52
2021,Togo,TGO,Sweden,SWE,0,0,0,5,5
2021,Tunisia,TUN,Sweden,SWE,0,0,31,18,49
2021,Turkey,TUR,Sweden,SWE,282,0,144,29,455
2021,Uganda,UGA,Sweden,SWE,26,0,35,10,71
2021,Ukraine,UKR,Sweden,SWE,0,5,430,91,526
2021,United States of America,USA,Sweden,SWE,0,0,13,5,18
2021,Uzbekistan,UZB,Sweden,SWE,12,0,640,57,709
2021,Venezuela (Bolivarian Republic of),VEN,Sweden,SWE,10,0,25,10,45
2021,Yemen,YEM,Sweden,SWE,5,42,0,13,60
2021,Zambia,ZMB,Sweden,SWE,0,0,5,0,5
2021,Zimbabwe,ZWE,Sweden,SWE,0,0,5,0,5
2021,Stateless,XXA,Sweden,SWE,43,21,76,52,192
2021,Afghanistan,AFG,Switzerland,CHE,446,1524,51,734,2755
2021,Albania,ALB,Switzerland,CHE,0,10,37,10,57
2021,Algeria,DZA,Switzerland,CHE,5,10,156,885,1056
2021,Angola,AGO,Switzerland,CHE,0,34,25,5,64
2021,Egypt,EGY,Switzerland,CHE,13,5,5,15,38
2021,Armenia,ARM,Switzerland,CHE,0,10,5,10,25
2021,Azerbaijan,AZE,Switzerland,CHE,12,10,24,5,51
2021,Belgium,BEL,Switzerland,CHE,0,0,0,11,11
2021,Benin,BEN,Switzerland,CHE,0,0,5,0,5
2021,Bangladesh,BGD,Switzerland,CHE,0,0,0,11,11
2021,Burkina Faso,BFA,Switzerland,CHE,0,5,0,0,5
2021,Belarus,BLR,Switzerland,CHE,5,0,20,24,49
2021,Brazil,BRA,Switzerland,CHE,5,0,0,0,5
2021,Bosnia and Herzegovina,BIH,Switzerland,CHE,0,0,13,5,18
2021,Central African Rep.,CAF,Switzerland,CHE,0,5,0,0,5
2021,Chad,TCD,Switzerland,CHE,0,0,0,13,13
2021,China,CHN,Switzerland,CHE,31,81,71,5,188
2021,Cameroon,CMR,Switzerland,CHE,10,10,19,23,62
2021,Congo,COG,Switzerland,CHE,0,5,0,0,5
2021,Dem. Rep. of the Congo,COD,Switzerland,CHE,17,48,30,16,111
2021,Colombia,COL,Switzerland,CHE,18,0,52,5,75
2021,Cuba,CUB,Switzerland,CHE,12,0,0,0,12
2021,Eritrea,ERI,Switzerland,CHE,1444,432,175,87,2138
2021,Ethiopia,ETH,Switzerland,CHE,44,61,32,33,170
2021,Gambia,GMB,Switzerland,CHE,0,0,5,33,38
2021,Georgia,GEO,Switzerland,CHE,0,19,82,202,303
2021,Germany,DEU,Switzerland,CHE,5,0,5,0,10
2021,Ghana,GHA,Switzerland,CHE,0,5,10,14,29
2021,Guinea-Bissau,GNB,Switzerland,CHE,0,0,5,5,10
2021,Guinea,GIN,Switzerland,CHE,5,10,10,71,96
2021,Hungary,HUN,Switzerland,CHE,0,0,0,5,5
2021,Cote d'Ivoire,CIV,Switzerland,CHE,10,11,5,21,47
2021,India,IND,Switzerland,CHE,0,5,11,0,16
2021,Iran (Islamic Rep. of),IRN,Switzerland,CHE,96,104,205,74,479
2021,Iraq,IRQ,Switzerland,CHE,93,99,190,138,520
2021,Italy,ITA,Switzerland,CHE,0,0,0,13,13
2021,Jordan,JOR,Switzerland,CHE,0,0,0,5,5
2021,Kazakhstan,KAZ,Switzerland,CHE,11,0,5,5,21
2021,Kenya,KEN,Switzerland,CHE,0,5,0,0,5
2021,Liberia,LBR,Switzerland,CHE,0,0,0,5,5
2021,Libya,LBY,Switzerland,CHE,10,13,16,137,176
2021,Lebanon,LBN,Switzerland,CHE,0,0,17,18,35
2021,Sri Lanka,LKA,Switzerland,CHE,244,62,295,119,720
2021,Mauritania,MRT,Switzerland,CHE,0,0,0,5,5
2021,North Macedonia,MKD,Switzerland,CHE,0,5,24,16,45
2021,Rep. of Moldova,MDA,Switzerland,CHE,0,0,0,11,11
2021,Mali,MLI,Switzerland,CHE,0,0,0,13,13
2021,Mongolia,MNG,Switzerland,CHE,0,5,5,10,20
2021,Morocco,MAR,Switzerland,CHE,0,5,84,490,579
2021,Montenegro,MNE,Switzerland,CHE,0,0,12,0,12
2021,Myanmar,MMR,Switzerland,CHE,13,0,0,0,13
2021,Nepal,NPL,Switzerland,CHE,0,5,0,0,5
2021,Netherlands,NLD,Switzerland,CHE,0,0,5,0,5
2021,Niger,NER,Switzerland,CHE,0,0,0,5,5
2021,Nicaragua,NIC,Switzerland,CHE,5,0,0,0,5
2021,Nigeria,NGA,Switzerland,CHE,0,17,40,140,197
2021,Pakistan,PAK,Switzerland,CHE,10,17,31,41,99
2021,Poland,POL,Switzerland,CHE,0,0,0,5,5
2021,Romania,ROU,Switzerland,CHE,0,0,0,5,5
2021,Russian Federation,RUS,Switzerland,CHE,22,5,37,31,95
2021,Rwanda,RWA,Switzerland,CHE,0,0,5,0,5
2021,Saudi Arabia,SAU,Switzerland,CHE,5,0,0,0,5
2021,Serbia and Kosovo: S/RES/1244 (1999),SRB,Switzerland,CHE,5,32,66,32,135
2021,Senegal,SEN,Switzerland,CHE,5,0,10,19,34
2021,Sierra Leone,SLE,Switzerland,CHE,0,0,5,11,16
2021,Somalia,SOM,Switzerland,CHE,101,158,11,146,416
2021,Sudan,SDN,Switzerland,CHE,14,5,5,19,43
2021,Syrian Arab Rep.,SYR,Switzerland,CHE,600,378,77,98,1153
2021,United Rep. of Tanzania,TZA,Switzerland,CHE,0,0,0,5,5
2021,Tajikistan,TJK,Switzerland,CHE,0,0,12,0,12
2021,Togo,TGO,Switzerland,CHE,13,5,5,5,28
2021,Tunisia,TUN,Switzerland,CHE,0,5,35,182,222
2021,Turkey,TUR,Switzerland,CHE,1964,136,224,94,2418
2021,Uganda,UGA,Switzerland,CHE,0,5,13,0,18
2021,Ukraine,UKR,Switzerland,CHE,0,5,17,32,54
2021,United States of America,USA,Switzerland,CHE,0,0,5,5,10
2021,Venezuela (Bolivarian Republic of),VEN,Switzerland,CHE,11,5,5,5,26
2021,Western Sahara,ESH,Switzerland,CHE,0,5,0,5,10
2021,Yemen,YEM,Switzerland,CHE,17,0,0,5,22
2021,Zimbabwe,ZWE,Switzerland,CHE,0,0,5,0,5
2021,Stateless,XXA,Switzerland,CHE,0,5,0,5,10
2021,Burundi,BDI,United Rep. of Tanzania,TZA,0,0,0,1646,1646
2021,Rwanda,RWA,United Rep. of Tanzania,TZA,0,0,0,5,5
2021,Benin,BEN,Togo,TGO,21,0,0,0,21
2021,Central African Rep.,CAF,Togo,TGO,10,0,26,0,36
2021,Cameroon,CMR,Togo,TGO,0,0,5,0,5
2021,Congo,COG,Togo,TGO,0,0,5,0,5
2021,Dem. Rep. of the Congo,COD,Togo,TGO,0,0,5,0,5
2021,Cote d'Ivoire,CIV,Togo,TGO,5,0,13,0,18
2021,Lebanon,LBN,Togo,TGO,5,0,0,0,5
2021,Niger,NER,Togo,TGO,10,0,0,0,10
2021,Afghanistan,AFG,Turkey,TUR,4340,0,2828,6800,13968
2021,Iran (Islamic Rep. of),IRN,Turkey,TUR,2535,0,1759,2105,6399
2021,Iraq,IRQ,Turkey,TUR,5213,0,5934,12198,23345
2021,Burundi,BDI,Uganda,UGA,517,0,125,0,642
2021,Cameroon,CMR,Uganda,UGA,0,0,5,0,5
2021,Dem. Rep. of the Congo,COD,Uganda,UGA,7159,0,873,5,8037
2021,Eritrea,ERI,Uganda,UGA,1060,0,28,15,1103
2021,Ethiopia,ETH,Uganda,UGA,148,0,18,0,166
2021,Pakistan,PAK,Uganda,UGA,5,0,0,11,16
2021,Rwanda,RWA,Uganda,UGA,1171,0,3331,0,4502
2021,Somalia,SOM,Uganda,UGA,7587,0,0,0,7587
2021,Sudan,SDN,Uganda,UGA,41,0,10,0,51
2021,South Sudan,SSD,Uganda,UGA,1608,0,0,0,1608
2021,Syrian Arab Rep.,SYR,Uganda,UGA,5,0,0,0,5
2021,Afghanistan,AFG,Ukraine,UKR,43,16,59,80,198
2021,Algeria,DZA,Ukraine,UKR,0,0,0,5,5
2021,Egypt,EGY,Ukraine,UKR,0,0,0,5,5
2021,Armenia,ARM,Ukraine,UKR,12,0,0,5,17
2021,Azerbaijan,AZE,Ukraine,UKR,0,0,0,5,5
2021,Bangladesh,BGD,Ukraine,UKR,0,0,0,20,20
2021,Belarus,BLR,Ukraine,UKR,11,5,10,66,92
2021,Cameroon,CMR,Ukraine,UKR,0,0,5,19,24
2021,Congo,COG,Ukraine,UKR,0,0,0,5,5
2021,Dem. Rep. of the Congo,COD,Ukraine,UKR,0,0,0,11,11
2021,Eritrea,ERI,Ukraine,UKR,0,0,0,5,5
2021,Ethiopia,ETH,Ukraine,UKR,0,0,0,5,5
2021,Gambia,GMB,Ukraine,UKR,0,0,0,5,5
2021,Palestinian,PSE,Ukraine,UKR,0,0,0,5,5
2021,Georgia,GEO,Ukraine,UKR,0,0,0,5,5
2021,Ghana,GHA,Ukraine,UKR,0,0,0,15,15
2021,Guinea,GIN,Ukraine,UKR,0,0,0,10,10
2021,Cote d'Ivoire,CIV,Ukraine,UKR,0,0,0,5,5
2021,India,IND,Ukraine,UKR,0,0,0,10,10
2021,Iran (Islamic Rep. of),IRN,Ukraine,UKR,5,0,18,5,28
2021,Iraq,IRQ,Ukraine,UKR,0,0,12,5,17
2021,Kazakhstan,KAZ,Ukraine,UKR,0,0,14,5,19
2021,Kyrgyzstan,KGZ,Ukraine,UKR,0,0,0,5,5
2021,Libya,LBY,Ukraine,UKR,0,0,5,0,5
2021,Sri Lanka,LKA,Ukraine,UKR,0,0,0,5,5
2021,Morocco,MAR,Ukraine,UKR,0,0,0,5,5
2021,Nigeria,NGA,Ukraine,UKR,0,0,10,62,72
2021,Pakistan,PAK,Ukraine,UKR,0,0,5,10,15
2021,Poland,POL,Ukraine,UKR,0,0,0,5,5
2021,Russian Federation,RUS,Ukraine,UKR,11,10,44,28,93
2021,Senegal,SEN,Ukraine,UKR,0,0,0,5,5
2021,Sierra Leone,SLE,Ukraine,UKR,0,0,0,5,5
2021,Somalia,SOM,Ukraine,UKR,0,5,0,0,5
2021,Sudan,SDN,Ukraine,UKR,0,0,0,10,10
2021,Syrian Arab Rep.,SYR,Ukraine,UKR,0,24,36,10,70
2021,Tajikistan,TJK,Ukraine,UKR,0,0,32,0,32
2021,Turkmenistan,TKM,Ukraine,UKR,0,0,5,0,5
2021,Turkey,TUR,Ukraine,UKR,0,0,0,12,12
2021,Uzbekistan,UZB,Ukraine,UKR,5,5,10,5,25
2021,Yemen,YEM,Ukraine,UKR,0,0,5,0,5
2021,Zambia,ZMB,Ukraine,UKR,0,0,0,5,5
2021,Zimbabwe,ZWE,Ukraine,UKR,0,0,0,5,5
2021,Stateless,XXA,Ukraine,UKR,0,0,5,5,10
2021,Afghanistan,AFG,Uruguay,URY,5,0,0,0,5
2021,Cuba,CUB,Uruguay,URY,0,0,0,518,518
2021,Dominican Rep.,DOM,Uruguay,URY,0,0,0,5,5
2021,Haiti,HTI,Uruguay,URY,5,0,0,0,5
2021,Pakistan,PAK,Uruguay,URY,5,0,0,0,5
2021,El Salvador,SLV,Uruguay,URY,5,0,0,0,5
2021,Syrian Arab Rep.,SYR,Uruguay,URY,5,0,0,0,5
2021,Venezuela (Bolivarian Republic of),VEN,Uruguay,URY,189,0,0,114,303
2021,Colombia,COL,Venezuela (Bolivarian Republic of),VEN,45,0,0,5,50
2021,Haiti,HTI,Venezuela (Bolivarian Republic of),VEN,5,0,0,0,5
2021,Burundi,BDI,Zambia,ZMB,1276,0,113,142,1531
2021,Central African Rep.,CAF,Zambia,ZMB,0,0,0,5,5
2021,Cameroon,CMR,Zambia,ZMB,13,0,0,10,23
2021,Congo,COG,Zambia,ZMB,18,0,0,0,18
2021,Dem. Rep. of the Congo,COD,Zambia,ZMB,5556,0,313,418,6287
2021,Eritrea,ERI,Zambia,ZMB,48,0,0,5,53
2021,Ethiopia,ETH,Zambia,ZMB,10,0,0,5,15
2021,Guinea,GIN,Zambia,ZMB,0,0,0,5,5
2021,Rwanda,RWA,Zambia,ZMB,16,0,13,0,29
2021,Somalia,SOM,Zambia,ZMB,109,0,21,40,170
2021,South Sudan,SSD,Zambia,ZMB,0,0,0,5,5
2021,Syrian Arab Rep.,SYR,Zambia,ZMB,13,0,0,0,13
2021,Turkey,TUR,Zambia,ZMB,29,0,0,0,29
2021,Uganda,UGA,Zambia,ZMB,100,0,23,5,128
2021,Burundi,BDI,Zimbabwe,ZWE,0,0,0,5,5
2021,Dem. Rep. of the Congo,COD,Zimbabwe,ZWE,0,0,0,73,73
2021,Rwanda,RWA,Zimbabwe,ZWE,0,0,0,14,14
2001,Afghanistan,AFG,United States of America,USA,212,0,43,19,274
2001,Albania,ALB,United States of America,USA,330,0,899,76,1305
2001,Algeria,DZA,United States of America,USA,30,0,25,10,65
2001,Angola,AGO,United States of America,USA,32,0,32,5,69
2001,Egypt,EGY,United States of America,USA,274,0,261,24,559
2001,Argentina,ARG,United States of America,USA,0,0,15,10,25
2001,Armenia,ARM,United States of America,USA,991,0,1072,115,2178
2001,Azerbaijan,AZE,United States of America,USA,267,0,130,61,458
2001,Burundi,BDI,United States of America,USA,44,0,46,5,95
2001,Belgium,BEL,United States of America,USA,5,0,0,0,5
2001,Benin,BEN,United States of America,USA,0,0,5,0,5
2001,Bangladesh,BGD,United States of America,USA,44,0,66,98,208
2001,Bahamas,BHS,United States of America,USA,0,0,5,0,5
2001,Bhutan,BTN,United States of America,USA,15,0,5,0,20
2001,Burkina Faso,BFA,United States of America,USA,5,0,5,0,10
2001,Belarus,BLR,United States of America,USA,59,0,57,11,127
2001,Bolivia (Plurinational State of),BOL,United States of America,USA,0,0,14,0,14
2001,Brazil,BRA,United States of America,USA,26,0,41,65,132
2001,Bosnia and Herzegovina,BIH,United States of America,USA,25,0,29,10,64
2001,Bulgaria,BGR,United States of America,USA,49,0,43,24,116
2001,Belize,BLZ,United States of America,USA,0,0,5,5,10
2001,Cambodia,KHM,United States of America,USA,11,0,36,5,52
2001,Canada,CAN,United States of America,USA,0,0,5,0,5
2001,Chad,TCD,United States of America,USA,12,0,12,0,24
2001,China,CHN,United States of America,USA,4092,0,3359,939,8390
2001,Chile,CHL,United States of America,USA,5,0,0,5,10
2001,Cameroon,CMR,United States of America,USA,290,0,187,24,501
2001,Congo,COG,United States of America,USA,186,0,160,33,379
2001,Dem. Rep. of the Congo,COD,United States of America,USA,118,0,114,15,247
2001,Colombia,COL,United States of America,USA,2625,0,2054,194,4873
2001,Costa Rica,CRI,United States of America,USA,0,0,5,5,10
2001,Cuba,CUB,United States of America,USA,63,0,39,57,159
2001,Dominican Rep.,DOM,United States of America,USA,5,0,0,0,5
2001,Ecuador,ECU,United States of America,USA,5,0,20,56,81
2001,Eritrea,ERI,United States of America,USA,124,0,86,5,215
2001,Estonia,EST,United States of America,USA,5,0,10,5,20
2001,Ethiopia,ETH,United States of America,USA,942,0,430,73,1445
2001,Fiji,FJI,United States of America,USA,170,0,262,27,459
2001,France,FRA,United States of America,USA,0,0,5,5,10
2001,Gabon,GAB,United States of America,USA,5,0,0,0,5
2001,Gambia,GMB,United States of America,USA,19,0,18,18,55
2001,United Kingdom of Great Britain and Northern Ireland,GBR,United States of America,USA,0,0,0,5,5
2001,Georgia,GEO,United States of America,USA,81,0,115,17,213
2001,Germany,DEU,United States of America,USA,0,0,0,5,5
2001,Ghana,GHA,United States of America,USA,5,0,16,33,54
2001,Guinea-Bissau,GNB,United States of America,USA,0,0,5,0,5
2001,Greece,GRC,United States of America,USA,0,0,5,0,5
2001,Guatemala,GTM,United States of America,USA,123,0,767,3286,4176
2001,Guinea,GIN,United States of America,USA,144,0,323,66,533
2001,Guyana,GUY,United States of America,USA,0,0,5,37,42
2001,Haiti,HTI,United States of America,USA,899,0,1847,329,3075
2001,"China, Hong Kong SAR",HKG,United States of America,USA,0,0,5,0,5
2001,Honduras,HND,United States of America,USA,10,0,69,68,147
2001,Croatia,HRV,United States of America,USA,11,0,10,0,21
2001,Cote d'Ivoire,CIV,United States of America,USA,36,0,35,20,91
2001,India,IND,United States of America,USA,778,0,707,287,1772
2001,Indonesia,IDN,United States of America,USA,415,0,1021,75,1511
2001,Ireland,IRL,United States of America,USA,0,0,0,5,5
2001,Iran (Islamic Rep. of),IRN,United States of America,USA,622,0,258,65,945
2001,Iraq,IRQ,United States of America,USA,396,0,95,16,507
2001,Israel,ISR,United States of America,USA,10,0,16,5,31
2001,Jamaica,JAM,United States of America,USA,0,0,5,26,31
2001,Jordan,JOR,United States of America,USA,27,0,21,10,58
2001,Kazakhstan,KAZ,United States of America,USA,19,0,33,0,52
2001,Kenya,KEN,United States of America,USA,63,0,38,5,106
2001,Kyrgyzstan,KGZ,United States of America,USA,12,0,39,5,56
2001,Rep. of Korea,KOR,United States of America,USA,0,0,0,5,5
2001,Kuwait,KWT,United States of America,USA,5,0,0,5,10
2001,Lao People's Dem. Rep.,LAO,United States of America,USA,5,0,20,27,52
2001,Liberia,LBR,United States of America,USA,647,0,460,97,1204
2001,Libya,LBY,United States of America,USA,5,0,0,0,5
2001,Lebanon,LBN,United States of America,USA,27,0,33,15,75
2001,Sri Lanka,LKA,United States of America,USA,65,0,57,10,132
2001,Lithuania,LTU,United States of America,USA,5,0,13,0,18
2001,Latvia,LVA,United States of America,USA,5,0,32,5,42
2001,Mauritania,MRT,United States of America,USA,91,0,489,119,699
2001,North Macedonia,MKD,United States of America,USA,22,0,34,12,68
2001,Rep. of Moldova,MDA,United States of America,USA,16,0,15,0,31
2001,Mexico,MEX,United States of America,USA,30,0,6721,1695,8446
2001,Mali,MLI,United States of America,USA,0,0,5,16,21
2001,Malaysia,MYS,United States of America,USA,15,0,10,5,30
2001,Malawi,MWI,United States of America,USA,0,0,5,0,5
2001,Mongolia,MNG,United States of America,USA,5,0,11,0,16
2001,Morocco,MAR,United States of America,USA,5,0,5,0,10
2001,Mauritius,MUS,United States of America,USA,0,0,0,5,5
2001,Myanmar,MMR,United States of America,USA,1238,0,189,66,1493
2001,Nepal,NPL,United States of America,USA,16,0,20,5,41
2001,Niger,NER,United States of America,USA,23,0,19,10,52
2001,Nicaragua,NIC,United States of America,USA,16,0,5,44,65
2001,Nigeria,NGA,United States of America,USA,24,0,36,43,103
2001,Pakistan,PAK,United States of America,USA,235,0,145,114,494
2001,Panama,PAN,United States of America,USA,0,0,0,5,5
2001,Paraguay,PRY,United States of America,USA,5,0,0,0,5
2001,Peru,PER,United States of America,USA,56,0,110,52,218
2001,Philippines,PHL,United States of America,USA,0,0,45,163,208
2001,Poland,POL,United States of America,USA,0,0,18,47,65
2001,Portugal,PRT,United States of America,USA,0,0,0,5,5
2001,Qatar,QAT,United States of America,USA,5,0,0,0,5
2001,Romania,ROU,United States of America,USA,71,0,57,55,183
2001,South Africa,ZAF,United States of America,USA,5,0,11,0,16
2001,Russian Federation,RUS,United States of America,USA,351,0,334,126,811
2001,Rwanda,RWA,United States of America,USA,44,0,26,5,75
2001,El Salvador,SLV,United States of America,USA,104,0,808,11787,12699
2001,Saudi Arabia,SAU,United States of America,USA,5,0,5,0,10
2001,Senegal,SEN,United States of America,USA,15,0,18,11,44
2001,Singapore,SGP,United States of America,USA,5,0,0,0,5
2001,Sierra Leone,SLE,United States of America,USA,249,0,425,86,760
2001,Somalia,SOM,United States of America,USA,1010,0,443,239,1692
2001,Viet Nam,VNM,United States of America,USA,0,0,13,0,13
2001,Sudan,SDN,United States of America,USA,410,0,160,30,600
2001,Suriname,SUR,United States of America,USA,0,0,0,13,13
2001,Slovakia,SVK,United States of America,USA,0,0,14,0,14
2001,Syrian Arab Rep.,SYR,United States of America,USA,17,0,19,11,47
2001,United Rep. of Tanzania,TZA,United States of America,USA,11,0,14,0,25
2001,Thailand,THA,United States of America,USA,0,0,0,21,21
2001,Tajikistan,TJK,United States of America,USA,5,0,0,0,5
2001,Turkmenistan,TKM,United States of America,USA,10,0,12,0,22
2001,Togo,TGO,United States of America,USA,76,0,56,10,142
2001,Trinidad and Tobago,TTO,United States of America,USA,5,0,0,22,27
2001,Tunisia,TUN,United States of America,USA,5,0,0,0,5
2001,Turkey,TUR,United States of America,USA,60,0,38,19,117
2001,Uganda,UGA,United States of America,USA,110,0,104,10,224
2001,Ukraine,UKR,United States of America,USA,87,0,104,52,243
2001,Uruguay,URY,United States of America,USA,0,0,0,5,5
2001,Uzbekistan,UZB,United States of America,USA,88,0,99,10,197
2001,Venezuela (Bolivarian Republic of),VEN,United States of America,USA,34,0,35,5,74
2001,Yemen,YEM,United States of America,USA,29,0,34,16,79
2001,Zambia,ZMB,United States of America,USA,5,0,0,0,5
2001,Zimbabwe,ZWE,United States of America,USA,23,0,19,5,47
2001,Stateless,XXA,United States of America,USA,79,0,84,25,188
2002,Afghanistan,AFG,United States of America,USA,123,0,72,23,218
2002,Albania,ALB,United States of America,USA,257,0,898,116,1271
2002,Algeria,DZA,United States of America,USA,17,0,33,24,74
2002,Angola,AGO,United States of America,USA,25,0,20,5,50
2002,Egypt,EGY,United States of America,USA,248,0,351,20,619
2002,Argentina,ARG,United States of America,USA,5,0,40,52,97
2002,Armenia,ARM,United States of America,USA,695,0,959,122,1776
2002,Azerbaijan,AZE,United States of America,USA,198,0,119,105,422
2002,Burundi,BDI,United States of America,USA,53,0,34,5,92
2002,Benin,BEN,United States of America,USA,5,0,5,0,10
2002,Bangladesh,BGD,United States of America,USA,60,0,86,322,468
2002,Bhutan,BTN,United States of America,USA,12,0,0,0,12
2002,Burkina Faso,BFA,United States of America,USA,5,0,12,0,17
2002,Belarus,BLR,United States of America,USA,54,0,95,12,161
2002,Bolivia (Plurinational State of),BOL,United States of America,USA,0,0,14,5,19
2002,Brazil,BRA,United States of America,USA,29,0,67,135,231
2002,Bosnia and Herzegovina,BIH,United States of America,USA,21,0,29,5,55
2002,Bulgaria,BGR,United States of America,USA,49,0,41,25,115
2002,Belize,BLZ,United States of America,USA,0,0,5,0,5
2002,Cambodia,KHM,United States of America,USA,37,0,151,13,201
2002,Canada,CAN,United States of America,USA,0,0,5,0,5
2002,Central African Rep.,CAF,United States of America,USA,22,0,27,5,54
2002,Chad,TCD,United States of America,USA,14,0,5,0,19
2002,China,CHN,United States of America,USA,5045,0,4652,1167,10864
2002,Chile,CHL,United States of America,USA,5,0,14,5,24
2002,Cameroon,CMR,United States of America,USA,668,0,415,47,1130
2002,Congo,COG,United States of America,USA,193,0,215,37,445
2002,Dem. Rep. of the Congo,COD,United States of America,USA,175,0,196,25,396
2002,Colombia,COL,United States of America,USA,2532,0,4246,459,7237
2002,Costa Rica,CRI,United States of America,USA,0,0,0,5,5
2002,Cuba,CUB,United States of America,USA,47,0,27,684,758
2002,Czechia,CZE,United States of America,USA,0,0,5,0,5
2002,Dominican Rep.,DOM,United States of America,USA,0,0,5,15,20
2002,Ecuador,ECU,United States of America,USA,10,0,30,149,189
2002,Eritrea,ERI,United States of America,USA,142,0,97,12,251
2002,Estonia,EST,United States of America,USA,10,0,25,0,35
2002,Ethiopia,ETH,United States of America,USA,927,0,430,91,1448
2002,Fiji,FJI,United States of America,USA,102,0,153,49,304
2002,France,FRA,United States of America,USA,0,0,0,11,11
2002,Gabon,GAB,United States of America,USA,5,0,0,0,5
2002,Gambia,GMB,United States of America,USA,16,0,19,11,46
2002,United Kingdom of Great Britain and Northern Ireland,GBR,United States of America,USA,0,0,5,0,5
2002,Georgia,GEO,United States of America,USA,53,0,97,18,168
2002,Germany,DEU,United States of America,USA,0,0,5,0,5
2002,Ghana,GHA,United States of America,USA,5,0,12,26,43
2002,Guinea-Bissau,GNB,United States of America,USA,5,0,5,0,10
2002,Greece,GRC,United States of America,USA,0,0,5,0,5
2002,Guatemala,GTM,United States of America,USA,132,0,682,4414,5228
2002,Guinea,GIN,United States of America,USA,158,0,502,95,755
2002,Guyana,GUY,United States of America,USA,0,0,10,51,61
2002,Haiti,HTI,United States of America,USA,703,0,1863,1621,4187
2002,"China, Hong Kong SAR",HKG,United States of America,USA,0,0,5,0,5
2002,Honduras,HND,United States of America,USA,15,0,67,98,180
2002,Croatia,HRV,United States of America,USA,5,0,13,0,18
2002,Hungary,HUN,United States of America,USA,0,0,5,12,17
2002,Cote d'Ivoire,CIV,United States of America,USA,19,0,40,14,73
2002,India,IND,United States of America,USA,942,0,988,504,2434
2002,Indonesia,IDN,United States of America,USA,341,0,1126,95,1562
2002,Iran (Islamic Rep. of),IRN,United States of America,USA,537,0,335,130,1002
2002,Iraq,IRQ,United States of America,USA,344,0,157,142,643
2002,Israel,ISR,United States of America,USA,5,0,16,16,37
2002,Italy,ITA,United States of America,USA,0,0,0,5,5
2002,Jamaica,JAM,United States of America,USA,0,0,11,27,38
2002,Jordan,JOR,United States of America,USA,32,0,58,22,112
2002,Kazakhstan,KAZ,United States of America,USA,20,0,26,0,46
2002,Kenya,KEN,United States of America,USA,153,0,121,15,289
2002,Kyrgyzstan,KGZ,United States of America,USA,16,0,38,5,59
2002,Rep. of Korea,KOR,United States of America,USA,0,0,5,0,5
2002,Kuwait,KWT,United States of America,USA,11,0,0,0,11
2002,Lao People's Dem. Rep.,LAO,United States of America,USA,5,0,20,33,58
2002,Liberia,LBR,United States of America,USA,523,0,431,72,1026
2002,Libya,LBY,United States of America,USA,5,0,0,0,5
2002,Lebanon,LBN,United States of America,USA,28,0,46,22,96
2002,Sri Lanka,LKA,United States of America,USA,48,0,99,16,163
2002,Lithuania,LTU,United States of America,USA,10,0,51,5,66
2002,Latvia,LVA,United States of America,USA,5,0,23,10,38
2002,Mauritania,MRT,United States of America,USA,87,0,489,85,661
2002,North Macedonia,MKD,United States of America,USA,18,0,69,24,111
2002,Rep. of Moldova,MDA,United States of America,USA,10,0,25,5,40
2002,Mexico,MEX,United States of America,USA,31,0,8041,1413,9485
2002,Mali,MLI,United States of America,USA,10,0,11,20,41
2002,Malaysia,MYS,United States of America,USA,25,0,10,5,40
2002,Malawi,MWI,United States of America,USA,0,0,5,0,5
2002,Mongolia,MNG,United States of America,USA,0,0,11,0,11
2002,Morocco,MAR,United States of America,USA,10,0,10,0,20
2002,Mauritius,MUS,United States of America,USA,0,0,5,5,10
2002,Myanmar,MMR,United States of America,USA,310,0,218,91,619
2002,Nepal,NPL,United States of America,USA,56,0,68,13,137
2002,Niger,NER,United States of America,USA,18,0,36,12,66
2002,Nicaragua,NIC,United States of America,USA,10,0,15,3399,3424
2002,Nigeria,NGA,United States of America,USA,20,0,43,50,113
2002,Pakistan,PAK,United States of America,USA,291,0,234,234,759
2002,Panama,PAN,United States of America,USA,0,0,5,0,5
2002,Paraguay,PRY,United States of America,USA,5,0,5,0,10
2002,Peru,PER,United States of America,USA,52,0,139,57,248
2002,Philippines,PHL,United States of America,USA,15,0,54,123,192
2002,Poland,POL,United States of America,USA,0,0,12,64,76
2002,Romania,ROU,United States of America,USA,112,0,124,76,312
2002,South Africa,ZAF,United States of America,USA,5,0,28,5,38
2002,Russian Federation,RUS,United States of America,USA,294,0,411,114,819
2002,Rwanda,RWA,United States of America,USA,39,0,33,0,72
2002,El Salvador,SLV,United States of America,USA,66,0,674,13110,13850
2002,Saudi Arabia,SAU,United States of America,USA,5,0,0,0,5
2002,Senegal,SEN,United States of America,USA,15,0,28,21,64
2002,Singapore,SGP,United States of America,USA,0,0,0,5,5
2002,Sierra Leone,SLE,United States of America,USA,157,0,364,60,581
2002,Somalia,SOM,United States of America,USA,369,0,369,199,937
2002,Viet Nam,VNM,United States of America,USA,11,0,12,5,28
2002,Sudan,SDN,United States of America,USA,360,0,208,23,591
2002,Suriname,SUR,United States of America,USA,0,0,0,11,11
2002,Slovakia,SVK,United States of America,USA,0,0,10,0,10
2002,Syrian Arab Rep.,SYR,United States of America,USA,20,0,28,10,58
2002,United Rep. of Tanzania,TZA,United States of America,USA,13,0,18,0,31
2002,Thailand,THA,United States of America,USA,0,0,5,15,20
2002,Tajikistan,TJK,United States of America,USA,5,0,11,0,16
2002,Turkmenistan,TKM,United States of America,USA,11,0,5,0,16
2002,Togo,TGO,United States of America,USA,182,0,132,5,319
2002,Tonga,TON,United States of America,USA,0,0,5,0,5
2002,Trinidad and Tobago,TTO,United States of America,USA,0,0,5,38,43
2002,Tunisia,TUN,United States of America,USA,5,0,5,0,10
2002,Turkey,TUR,United States of America,USA,58,0,46,22,126
2002,Uganda,UGA,United States of America,USA,136,0,143,16,295
2002,Ukraine,UKR,United States of America,USA,78,0,150,43,271
2002,Uruguay,URY,United States of America,USA,0,0,0,5,5
2002,Uzbekistan,UZB,United States of America,USA,94,0,152,14,260
2002,Venezuela (Bolivarian Republic of),VEN,United States of America,USA,48,0,99,10,157
2002,Yemen,YEM,United States of America,USA,22,0,31,16,69
2002,Zambia,ZMB,United States of America,USA,5,0,20,5,30
2002,Zimbabwe,ZWE,United States of America,USA,53,0,82,5,140
2002,Stateless,XXA,United States of America,USA,102,0,129,36,267
2003,Afghanistan,AFG,United States of America,USA,18,0,29,42,89
2003,Albania,ALB,United States of America,USA,177,0,672,99,948
2003,Algeria,DZA,United States of America,USA,15,0,21,27,63
2003,Angola,AGO,United States of America,USA,10,0,25,5,40
2003,Egypt,EGY,United States of America,USA,152,0,274,27,453
2003,Argentina,ARG,United States of America,USA,10,0,111,233,354
2003,Armenia,ARM,United States of America,USA,374,0,570,100,1044
2003,Australia,AUS,United States of America,USA,0,0,0,5,5
2003,Azerbaijan,AZE,United States of America,USA,64,0,73,74,211
2003,Burundi,BDI,United States of America,USA,27,0,39,0,66
2003,Benin,BEN,United States of America,USA,0,0,5,0,5
2003,Bangladesh,BGD,United States of America,USA,43,0,124,129,296
2003,Bhutan,BTN,United States of America,USA,5,0,5,0,10
2003,Burkina Faso,BFA,United States of America,USA,5,0,21,5,31
2003,Belarus,BLR,United States of America,USA,95,0,134,16,245
2003,Bolivia (Plurinational State of),BOL,United States of America,USA,10,0,12,0,22
2003,Brazil,BRA,United States of America,USA,24,0,76,48,148
2003,Bosnia and Herzegovina,BIH,United States of America,USA,10,0,24,5,39
2003,Bulgaria,BGR,United States of America,USA,39,0,43,79,161
2003,Belize,BLZ,United States of America,USA,0,0,5,0,5
2003,Cambodia,KHM,United States of America,USA,20,0,104,24,148
2003,Canada,CAN,United States of America,USA,0,0,0,5,5
2003,Central African Rep.,CAF,United States of America,USA,23,0,55,12,90
2003,Chad,TCD,United States of America,USA,25,0,18,0,43
2003,China,CHN,United States of America,USA,2037,0,3600,767,6404
2003,Chile,CHL,United States of America,USA,5,0,5,5,15
2003,Cameroon,CMR,United States of America,USA,778,0,780,57,1615
2003,Congo,COG,United States of America,USA,103,0,167,29,299
2003,Dem. Rep. of the Congo,COD,United States of America,USA,73,0,159,22,254
2003,Colombia,COL,United States of America,USA,1661,0,2935,278,4874
2003,Costa Rica,CRI,United States of America,USA,0,0,5,0,5
2003,Cuba,CUB,United States of America,USA,33,0,30,425,488
2003,Czechia,CZE,United States of America,USA,0,0,5,0,5
2003,Dominican Rep.,DOM,United States of America,USA,0,0,5,5,10
2003,Ecuador,ECU,United States of America,USA,0,0,24,44,68
2003,Eritrea,ERI,United States of America,USA,113,0,91,12,216
2003,Estonia,EST,United States of America,USA,5,0,40,11,56
2003,Ethiopia,ETH,United States of America,USA,515,0,361,143,1019
2003,Fiji,FJI,United States of America,USA,28,0,143,277,448
2003,France,FRA,United States of America,USA,0,0,14,19,33
2003,Gabon,GAB,United States of America,USA,0,0,11,0,11
2003,Gambia,GMB,United States of America,USA,27,0,47,23,97
2003,United Kingdom of Great Britain and Northern Ireland,GBR,United States of America,USA,0,0,0,5,5
2003,Georgia,GEO,United States of America,USA,39,0,107,26,172
2003,Germany,DEU,United States of America,USA,5,0,5,0,10
2003,Ghana,GHA,United States of America,USA,0,0,18,24,42
2003,Guinea-Bissau,GNB,United States of America,USA,0,0,5,5,10
2003,Greece,GRC,United States of America,USA,5,0,0,0,5
2003,Guatemala,GTM,United States of America,USA,120,0,1258,9120,10498
2003,Guinea,GIN,United States of America,USA,109,0,527,63,699
2003,Guyana,GUY,United States of America,USA,5,0,12,18,35
2003,Haiti,HTI,United States of America,USA,897,0,1874,4675,7446
2003,Honduras,HND,United States of America,USA,10,0,72,103,185
2003,Croatia,HRV,United States of America,USA,0,0,14,0,14
2003,Hungary,HUN,United States of America,USA,0,0,5,28,33
2003,Cote d'Ivoire,CIV,United States of America,USA,106,0,228,40,374
2003,India,IND,United States of America,USA,283,0,541,787,1611
2003,Indonesia,IDN,United States of America,USA,150,0,2079,250,2479
2003,Iran (Islamic Rep. of),IRN,United States of America,USA,251,0,272,216,739
2003,Iraq,IRQ,United States of America,USA,201,0,180,40,421
2003,Israel,ISR,United States of America,USA,5,0,18,14,37
2003,Italy,ITA,United States of America,USA,0,0,0,5,5
2003,Jamaica,JAM,United States of America,USA,0,0,10,10,20
2003,Jordan,JOR,United States of America,USA,16,0,65,59,140
2003,Japan,JPN,United States of America,USA,0,0,5,0,5
2003,Kazakhstan,KAZ,United States of America,USA,15,0,34,5,54
2003,Kenya,KEN,United States of America,USA,178,0,185,23,386
2003,Kyrgyzstan,KGZ,United States of America,USA,16,0,30,0,46
2003,Rep. of Korea,KOR,United States of America,USA,0,0,5,5,10
2003,Kuwait,KWT,United States of America,USA,5,0,5,16,26
2003,Lao People's Dem. Rep.,LAO,United States of America,USA,14,0,50,421,485
2003,Liberia,LBR,United States of America,USA,299,0,247,117,663
2003,Libya,LBY,United States of America,USA,0,0,0,5,5
2003,Lebanon,LBN,United States of America,USA,25,0,49,56,130
2003,Sri Lanka,LKA,United States of America,USA,11,0,51,15,77
2003,Lithuania,LTU,United States of America,USA,5,0,35,5,45
2003,Latvia,LVA,United States of America,USA,10,0,28,10,48
2003,Madagascar,MDG,United States of America,USA,0,0,5,0,5
2003,Mauritania,MRT,United States of America,USA,58,0,856,414,1328
2003,North Macedonia,MKD,United States of America,USA,5,0,42,11,58
2003,Rep. of Moldova,MDA,United States of America,USA,13,0,23,5,41
2003,Mexico,MEX,United States of America,USA,30,0,3422,786,4238
2003,Mali,MLI,United States of America,USA,10,0,23,15,48
2003,Malaysia,MYS,United States of America,USA,16,0,10,5,31
2003,Mongolia,MNG,United States of America,USA,14,0,22,0,36
2003,Morocco,MAR,United States of America,USA,0,0,5,11,16
2003,Mauritius,MUS,United States of America,USA,0,0,0,5,5
2003,Myanmar,MMR,United States of America,USA,184,0,166,84,434
2003,Nepal,NPL,United States of America,USA,111,0,162,16,289
2003,Niger,NER,United States of America,USA,25,0,49,19,93
2003,Nicaragua,NIC,United States of America,USA,10,0,24,3088,3122
2003,Nigeria,NGA,United States of America,USA,25,0,69,37,131
2003,Pakistan,PAK,United States of America,USA,169,0,286,187,642
2003,Panama,PAN,United States of America,USA,0,0,0,5,5
2003,Paraguay,PRY,United States of America,USA,0,0,5,0,5
2003,Peru,PER,United States of America,USA,49,0,157,83,289
2003,Philippines,PHL,United States of America,USA,10,0,146,380,536
2003,Poland,POL,United States of America,USA,0,0,34,68,102
2003,Portugal,PRT,United States of America,USA,0,0,0,5,5
2003,Romania,ROU,United States of America,USA,89,0,76,265,430
2003,South Africa,ZAF,United States of America,USA,5,0,38,13,56
2003,Russian Federation,RUS,United States of America,USA,224,0,447,230,901
2003,Rwanda,RWA,United States of America,USA,33,0,35,5,73
2003,El Salvador,SLV,United States of America,USA,63,0,749,22953,23765
2003,Saudi Arabia,SAU,United States of America,USA,5,0,0,0,5
2003,Senegal,SEN,United States of America,USA,13,0,67,12,92
2003,Singapore,SGP,United States of America,USA,0,0,0,5,5
2003,Sierra Leone,SLE,United States of America,USA,47,0,198,51,296
2003,Somalia,SOM,United States of America,USA,106,0,128,117,351
2003,Spain,ESP,United States of America,USA,0,0,5,0,5
2003,Viet Nam,VNM,United States of America,USA,0,0,5,12,17
2003,Sudan,SDN,United States of America,USA,94,0,91,25,210
2003,Suriname,SUR,United States of America,USA,0,0,0,10,10
2003,Slovakia,SVK,United States of America,USA,5,0,5,0,10
2003,Syrian Arab Rep.,SYR,United States of America,USA,10,0,34,15,59
2003,United Rep. of Tanzania,TZA,United States of America,USA,5,0,33,0,38
2003,Thailand,THA,United States of America,USA,0,0,5,33,38
2003,Tajikistan,TJK,United States of America,USA,0,0,12,0,12
2003,Turkmenistan,TKM,United States of America,USA,13,0,12,0,25
2003,Togo,TGO,United States of America,USA,278,0,263,17,558
2003,Trinidad and Tobago,TTO,United States of America,USA,0,0,5,11,16
2003,Tunisia,TUN,United States of America,USA,0,0,5,0,5
2003,Turkey,TUR,United States of America,USA,24,0,21,17,62
2003,United Arab Emirates,ARE,United States of America,USA,0,0,5,0,5
2003,Uganda,UGA,United States of America,USA,67,0,96,10,173
2003,Ukraine,UKR,United States of America,USA,52,0,128,73,253
2003,Uruguay,URY,United States of America,USA,0,0,14,30,44
2003,Uzbekistan,UZB,United States of America,USA,64,0,189,28,281
2003,Venezuela (Bolivarian Republic of),VEN,United States of America,USA,168,0,327,30,525
2003,Yemen,YEM,United States of America,USA,5,0,24,18,47
2003,Zambia,ZMB,United States of America,USA,5,0,19,0,24
2003,Zimbabwe,ZWE,United States of America,USA,115,0,159,10,284
2003,Stateless,XXA,United States of America,USA,56,0,98,21,175
2004,Afghanistan,AFG,United States of America,USA,26,0,21,11,58
2004,Albania,ALB,United States of America,USA,129,0,418,88,635
2004,Algeria,DZA,United States of America,USA,14,0,19,5,38
2004,Angola,AGO,United States of America,USA,5,0,14,5,24
2004,Egypt,EGY,United States of America,USA,101,0,143,27,271
2004,Argentina,ARG,United States of America,USA,5,0,27,366,398
2004,Armenia,ARM,United States of America,USA,203,0,471,75,749
2004,Azerbaijan,AZE,United States of America,USA,60,0,54,27,141
2004,Burundi,BDI,United States of America,USA,20,0,39,12,71
2004,Belgium,BEL,United States of America,USA,0,0,5,0,5
2004,Benin,BEN,United States of America,USA,5,0,0,0,5
2004,Bangladesh,BGD,United States of America,USA,31,0,63,66,160
2004,Bhutan,BTN,United States of America,USA,5,0,0,0,5
2004,Burkina Faso,BFA,United States of America,USA,5,0,11,0,16
2004,Belarus,BLR,United States of America,USA,123,0,268,17,408
2004,Bolivia (Plurinational State of),BOL,United States of America,USA,5,0,0,5,10
2004,Brazil,BRA,United States of America,USA,23,0,50,778,851
2004,Bosnia and Herzegovina,BIH,United States of America,USA,10,0,12,5,27
2004,Bulgaria,BGR,United States of America,USA,32,0,73,37,142
2004,Belize,BLZ,United States of America,USA,0,0,0,5,5
2004,Cambodia,KHM,United States of America,USA,36,0,91,11,138
2004,Canada,CAN,United States of America,USA,0,0,0,5,5
2004,Central African Rep.,CAF,United States of America,USA,10,0,25,5,40
2004,Chad,TCD,United States of America,USA,19,0,30,0,49
2004,China,CHN,United States of America,USA,748,0,2203,563,3514
2004,Chile,CHL,United States of America,USA,13,0,5,0,18
2004,Cameroon,CMR,United States of America,USA,558,0,764,51,1373
2004,Congo,COG,United States of America,USA,75,0,116,33,224
2004,Dem. Rep. of the Congo,COD,United States of America,USA,61,0,95,28,184
2004,Colombia,COL,United States of America,USA,1555,0,1934,524,4013
2004,Costa Rica,CRI,United States of America,USA,0,0,0,5,5
2004,Cuba,CUB,United States of America,USA,28,0,23,139,190
2004,Czechia,CZE,United States of America,USA,0,0,0,5,5
2004,Dominican Rep.,DOM,United States of America,USA,0,0,0,14,14
2004,Ecuador,ECU,United States of America,USA,5,0,32,38,75
2004,Eritrea,ERI,United States of America,USA,108,0,73,5,186
2004,Estonia,EST,United States of America,USA,5,0,32,10,47
2004,Ethiopia,ETH,United States of America,USA,657,0,449,89,1195
2004,Fiji,FJI,United States of America,USA,27,0,44,73,144
2004,France,FRA,United States of America,USA,5,0,5,17,27
2004,Gabon,GAB,United States of America,USA,5,0,5,0,10
2004,Gambia,GMB,United States of America,USA,25,0,98,27,150
2004,United Kingdom of Great Britain and Northern Ireland,GBR,United States of America,USA,0,0,5,5,10
2004,Georgia,GEO,United States of America,USA,49,0,102,23,174
2004,Germany,DEU,United States of America,USA,0,0,0,5,5
2004,Ghana,GHA,United States of America,USA,11,0,22,11,44
2004,Guinea-Bissau,GNB,United States of America,USA,5,0,14,5,24
2004,Guatemala,GTM,United States of America,USA,171,0,1363,29990,31524
2004,Guinea,GIN,United States of America,USA,136,0,515,64,715
2004,Guyana,GUY,United States of America,USA,0,0,14,19,33
2004,Haiti,HTI,United States of America,USA,1414,0,2663,2681,6758
2004,Honduras,HND,United States of America,USA,5,0,53,96,154
2004,Croatia,HRV,United States of America,USA,0,0,12,0,12
2004,Hungary,HUN,United States of America,USA,0,0,5,19,24
2004,Cote d'Ivoire,CIV,United States of America,USA,77,0,266,39,382
2004,India,IND,United States of America,USA,132,0,303,409,844
2004,Indonesia,IDN,United States of America,USA,64,0,602,146,812
2004,Iran (Islamic Rep. of),IRN,United States of America,USA,141,0,118,95,354
2004,Iraq,IRQ,United States of America,USA,102,0,92,10,204
2004,Israel,ISR,United States of America,USA,0,0,25,5,30
2004,Italy,ITA,United States of America,USA,0,0,0,13,13
2004,Jamaica,JAM,United States of America,USA,0,0,86,18,104
2004,Jordan,JOR,United States of America,USA,14,0,38,22,74
2004,Kazakhstan,KAZ,United States of America,USA,18,0,37,5,60
2004,Kenya,KEN,United States of America,USA,126,0,180,46,352
2004,Kyrgyzstan,KGZ,United States of America,USA,15,0,25,5,45
2004,Rep. of Korea,KOR,United States of America,USA,0,0,0,5,5
2004,Kuwait,KWT,United States of America,USA,0,0,0,12,12
2004,Lao People's Dem. Rep.,LAO,United States of America,USA,20,0,21,142,183
2004,Liberia,LBR,United States of America,USA,256,0,294,85,635
2004,Libya,LBY,United States of America,USA,5,0,0,5,10
2004,Saint Lucia,LCA,United States of America,USA,0,0,5,0,5
2004,Lebanon,LBN,United States of America,USA,20,0,43,29,92
2004,Sri Lanka,LKA,United States of America,USA,13,0,60,14,87
2004,Lithuania,LTU,United States of America,USA,5,0,24,5,34
2004,Latvia,LVA,United States of America,USA,10,0,20,5,35
2004,Mauritania,MRT,United States of America,USA,60,0,461,159,680
2004,North Macedonia,MKD,United States of America,USA,5,0,29,5,39
2004,Rep. of Moldova,MDA,United States of America,USA,10,0,17,5,32
2004,Mexico,MEX,United States of America,USA,36,0,1239,699,1974
2004,Mali,MLI,United States of America,USA,13,0,30,15,58
2004,Malaysia,MYS,United States of America,USA,10,0,13,5,28
2004,Malawi,MWI,United States of America,USA,0,0,5,0,5
2004,Mongolia,MNG,United States of America,USA,27,0,37,0,64
2004,Morocco,MAR,United States of America,USA,0,0,10,0,10
2004,Myanmar,MMR,United States of America,USA,156,0,116,57,329
2004,Nepal,NPL,United States of America,USA,115,0,159,10,284
2004,Netherlands,NLD,United States of America,USA,0,0,0,5,5
2004,Niger,NER,United States of America,USA,19,0,42,15,76
2004,Nicaragua,NIC,United States of America,USA,5,0,22,596,623
2004,Nigeria,NGA,United States of America,USA,26,0,71,27,124
2004,Pakistan,PAK,United States of America,USA,124,0,122,88,334
2004,Panama,PAN,United States of America,USA,0,0,0,10,10
2004,Peru,PER,United States of America,USA,62,0,125,44,231
2004,Philippines,PHL,United States of America,USA,12,0,56,95,163
2004,Poland,POL,United States of America,USA,0,0,66,41,107
2004,Portugal,PRT,United States of America,USA,0,0,0,5,5
2004,Romania,ROU,United States of America,USA,47,0,75,76,198
2004,South Africa,ZAF,United States of America,USA,5,0,18,10,33
2004,Russian Federation,RUS,United States of America,USA,201,0,454,147,802
2004,Rwanda,RWA,United States of America,USA,27,0,28,5,60
2004,El Salvador,SLV,United States of America,USA,93,0,934,37086,38113
2004,Saudi Arabia,SAU,United States of America,USA,0,0,5,0,5
2004,Serbia and Kosovo: S/RES/1244 (1999),SRB,United States of America,USA,5,0,20,0,25
2004,Senegal,SEN,United States of America,USA,15,0,57,15,87
2004,Singapore,SGP,United States of America,USA,5,0,0,0,5
2004,Sierra Leone,SLE,United States of America,USA,51,0,154,89,294
2004,Somalia,SOM,United States of America,USA,119,0,126,106,351
2004,Viet Nam,VNM,United States of America,USA,5,0,15,0,20
2004,Sudan,SDN,United States of America,USA,64,0,57,10,131
2004,Suriname,SUR,United States of America,USA,0,0,5,5,10
2004,Slovakia,SVK,United States of America,USA,5,0,5,0,10
2004,Slovenia,SVN,United States of America,USA,0,0,0,5,5
2004,Syrian Arab Rep.,SYR,United States of America,USA,12,0,22,5,39
2004,United Rep. of Tanzania,TZA,United States of America,USA,10,0,35,5,50
2004,Thailand,THA,United States of America,USA,0,0,5,16,21
2004,Tajikistan,TJK,United States of America,USA,5,0,10,0,15
2004,Turkmenistan,TKM,United States of America,USA,20,0,26,0,46
2004,Togo,TGO,United States of America,USA,304,0,310,20,634
2004,Tonga,TON,United States of America,USA,0,0,0,5,5
2004,Trinidad and Tobago,TTO,United States of America,USA,5,0,5,13,23
2004,Tunisia,TUN,United States of America,USA,0,0,0,5,5
2004,Turkey,TUR,United States of America,USA,20,0,23,10,53
2004,United Arab Emirates,ARE,United States of America,USA,0,0,5,0,5
2004,Uganda,UGA,United States of America,USA,59,0,70,15,144
2004,Ukraine,UKR,United States of America,USA,36,0,119,45,200
2004,Uruguay,URY,United States of America,USA,0,0,5,31,36
2004,Uzbekistan,UZB,United States of America,USA,91,0,180,18,289
2004,Venezuela (Bolivarian Republic of),VEN,United States of America,USA,611,0,740,55,1406
2004,Yemen,YEM,United States of America,USA,0,0,5,14,19
2004,Zambia,ZMB,United States of America,USA,5,0,28,5,38
2004,Zimbabwe,ZWE,United States of America,USA,140,0,219,13,372
2004,Stateless,XXA,United States of America,USA,48,0,83,20,151
2005,Afghanistan,AFG,United States of America,USA,11,0,5,12,28
2005,Albania,ALB,United States of America,USA,51,0,261,81,393
2005,Algeria,DZA,United States of America,USA,5,0,10,10,25
2005,Angola,AGO,United States of America,USA,5,0,14,0,19
2005,Egypt,EGY,United States of America,USA,85,0,180,26,291
2005,Argentina,ARG,United States of America,USA,0,0,5,53,58
2005,Armenia,ARM,United States of America,USA,127,0,357,34,518
2005,Azerbaijan,AZE,United States of America,USA,29,0,31,25,85
2005,Burundi,BDI,United States of America,USA,16,0,20,0,36
2005,Belgium,BEL,United States of America,USA,0,0,5,0,5
2005,Benin,BEN,United States of America,USA,0,0,5,0,5
2005,Bangladesh,BGD,United States of America,USA,23,0,46,62,131
2005,Bahamas,BHS,United States of America,USA,0,0,5,0,5
2005,Burkina Faso,BFA,United States of America,USA,10,0,43,0,53
2005,Belarus,BLR,United States of America,USA,98,0,228,15,341
2005,Bolivia (Plurinational State of),BOL,United States of America,USA,5,0,5,0,10
2005,Brazil,BRA,United States of America,USA,21,0,37,32,90
2005,Bosnia and Herzegovina,BIH,United States of America,USA,16,0,15,0,31
2005,Bulgaria,BGR,United States of America,USA,32,0,54,33,119
2005,Belize,BLZ,United States of America,USA,0,0,5,0,5
2005,Cambodia,KHM,United States of America,USA,24,0,60,5,89
2005,Canada,CAN,United States of America,USA,0,0,5,0,5
2005,Central African Rep.,CAF,United States of America,USA,11,0,26,5,42
2005,Chad,TCD,United States of America,USA,10,0,30,5,45
2005,China,CHN,United States of America,USA,1751,0,2540,439,4730
2005,Chile,CHL,United States of America,USA,12,0,0,0,12
2005,Cameroon,CMR,United States of America,USA,344,0,391,38,773
2005,Congo,COG,United States of America,USA,44,0,95,40,179
2005,Dem. Rep. of the Congo,COD,United States of America,USA,46,0,71,10,127
2005,Colombia,COL,United States of America,USA,1122,0,1337,479,2938
2005,Costa Rica,CRI,United States of America,USA,0,0,0,5,5
2005,Cuba,CUB,United States of America,USA,69,0,21,510,600
2005,Cabo Verde,CPV,United States of America,USA,0,0,0,5,5
2005,Czechia,CZE,United States of America,USA,0,0,13,11,24
2005,Dominica,DMA,United States of America,USA,0,0,0,5,5
2005,Dominican Rep.,DOM,United States of America,USA,0,0,5,0,5
2005,Ecuador,ECU,United States of America,USA,5,0,17,41,63
2005,Eritrea,ERI,United States of America,USA,116,0,61,5,182
2005,Estonia,EST,United States of America,USA,5,0,26,5,36
2005,Ethiopia,ETH,United States of America,USA,398,0,291,70,759
2005,Fiji,FJI,United States of America,USA,12,0,19,21,52
2005,France,FRA,United States of America,USA,0,0,0,5,5
2005,Gabon,GAB,United States of America,USA,5,0,5,0,10
2005,Gambia,GMB,United States of America,USA,27,0,165,22,214
2005,United Kingdom of Great Britain and Northern Ireland,GBR,United States of America,USA,0,0,5,0,5
2005,Georgia,GEO,United States of America,USA,28,0,80,12,120
2005,Germany,DEU,United States of America,USA,0,0,13,0,13
2005,Ghana,GHA,United States of America,USA,5,0,23,12,40
2005,Guinea-Bissau,GNB,United States of America,USA,0,0,5,0,5
2005,Guatemala,GTM,United States of America,USA,182,0,1455,26713,28350
2005,Guinea,GIN,United States of America,USA,118,0,513,65,696
2005,Guyana,GUY,United States of America,USA,0,0,12,19,31
2005,Haiti,HTI,United States of America,USA,1740,0,2386,2924,7050
2005,Honduras,HND,United States of America,USA,14,0,36,61,111
2005,Croatia,HRV,United States of America,USA,13,0,0,0,13
2005,Hungary,HUN,United States of America,USA,0,0,0,11,11
2005,Cote d'Ivoire,CIV,United States of America,USA,75,0,274,35,384
2005,India,IND,United States of America,USA,76,0,839,217,1132
2005,Indonesia,IDN,United States of America,USA,64,0,351,96,511
2005,Iran (Islamic Rep. of),IRN,United States of America,USA,98,0,104,44,246
2005,Iraq,IRQ,United States of America,USA,120,0,99,10,229
2005,Israel,ISR,United States of America,USA,5,0,16,5,26
2005,Italy,ITA,United States of America,USA,5,0,0,0,5
2005,Jamaica,JAM,United States of America,USA,5,0,23,16,44
2005,Jordan,JOR,United States of America,USA,15,0,39,12,66
2005,Kazakhstan,KAZ,United States of America,USA,10,0,47,5,62
2005,Kenya,KEN,United States of America,USA,89,0,159,52,300
2005,Kyrgyzstan,KGZ,United States of America,USA,10,0,24,5,39
2005,Rep. of Korea,KOR,United States of America,USA,0,0,5,0,5
2005,Dem. People's Rep. of Korea,PRK,United States of America,USA,5,0,0,0,5
2005,Kuwait,KWT,United States of America,USA,0,0,0,12,12
2005,Lao People's Dem. Rep.,LAO,United States of America,USA,10,0,22,37,69
2005,Liberia,LBR,United States of America,USA,109,0,189,42,340
2005,Libya,LBY,United States of America,USA,0,0,0,5,5
2005,Lebanon,LBN,United States of America,USA,18,0,35,26,79
2005,Sri Lanka,LKA,United States of America,USA,10,0,57,11,78
2005,Lithuania,LTU,United States of America,USA,5,0,21,15,41
2005,Latvia,LVA,United States of America,USA,5,0,12,13,30
2005,Mauritania,MRT,United States of America,USA,43,0,357,241,641
2005,North Macedonia,MKD,United States of America,USA,0,0,20,14,34
2005,Rep. of Moldova,MDA,United States of America,USA,10,0,19,5,34
2005,Mexico,MEX,United States of America,USA,55,0,946,675,1676
2005,Mali,MLI,United States of America,USA,17,0,127,12,156
2005,Malaysia,MYS,United States of America,USA,5,0,12,0,17
2005,Malawi,MWI,United States of America,USA,5,0,0,0,5
2005,Mongolia,MNG,United States of America,USA,30,0,52,5,87
2005,Morocco,MAR,United States of America,USA,5,0,10,0,15
2005,Myanmar,MMR,United States of America,USA,81,0,91,30,202
2005,Nepal,NPL,United States of America,USA,170,0,203,10,383
2005,Niger,NER,United States of America,USA,10,0,40,11,61
2005,Nicaragua,NIC,United States of America,USA,13,0,74,2183,2270
2005,Nigeria,NGA,United States of America,USA,24,0,52,21,97
2005,Pakistan,PAK,United States of America,USA,65,0,100,84,249
2005,Panama,PAN,United States of America,USA,0,0,5,0,5
2005,Paraguay,PRY,United States of America,USA,5,0,0,0,5
2005,Peru,PER,United States of America,USA,44,0,83,32,159
2005,Philippines,PHL,United States of America,USA,5,0,34,51,90
2005,Poland,POL,United States of America,USA,0,0,91,26,117
2005,Portugal,PRT,United States of America,USA,0,0,0,5,5
2005,Romania,ROU,United States of America,USA,15,0,18,57,90
2005,South Africa,ZAF,United States of America,USA,5,0,13,5,23
2005,Russian Federation,RUS,United States of America,USA,187,0,382,131,700
2005,Rwanda,RWA,United States of America,USA,46,0,46,5,97
2005,El Salvador,SLV,United States of America,USA,143,0,1741,46540,48424
2005,Saudi Arabia,SAU,United States of America,USA,0,0,5,0,5
2005,Serbia and Kosovo: S/RES/1244 (1999),SRB,United States of America,USA,26,0,114,44,184
2005,Senegal,SEN,United States of America,USA,10,0,58,18,86
2005,Sierra Leone,SLE,United States of America,USA,34,0,106,111,251
2005,Somalia,SOM,United States of America,USA,66,0,94,143,303
2005,Spain,ESP,United States of America,USA,0,0,5,0,5
2005,Viet Nam,VNM,United States of America,USA,10,0,10,0,20
2005,Sudan,SDN,United States of America,USA,48,0,32,5,85
2005,Suriname,SUR,United States of America,USA,0,0,5,0,5
2005,Slovakia,SVK,United States of America,USA,0,0,5,5,10
2005,Syrian Arab Rep.,SYR,United States of America,USA,5,0,19,5,29
2005,United Rep. of Tanzania,TZA,United States of America,USA,12,0,22,5,39
2005,Thailand,THA,United States of America,USA,0,0,0,5,5
2005,Tajikistan,TJK,United States of America,USA,0,0,5,0,5
2005,Turkmenistan,TKM,United States of America,USA,20,0,28,5,53
2005,Togo,TGO,United States of America,USA,184,0,255,27,466
2005,Tonga,TON,United States of America,USA,0,0,0,5,5
2005,Trinidad and Tobago,TTO,United States of America,USA,0,0,13,19,32
2005,Tunisia,TUN,United States of America,USA,0,0,5,0,5
2005,Turkey,TUR,United States of America,USA,10,0,21,10,41
2005,Uganda,UGA,United States of America,USA,48,0,58,10,116
2005,Ukraine,UKR,United States of America,USA,43,0,117,35,195
2005,Uruguay,URY,United States of America,USA,0,0,0,11,11
2005,Uzbekistan,UZB,United States of America,USA,49,0,190,25,264
2005,Venezuela (Bolivarian Republic of),VEN,United States of America,USA,508,0,636,67,1211
2005,Yemen,YEM,United States of America,USA,0,0,14,14,28
2005,Zambia,ZMB,United States of America,USA,5,0,11,5,21
2005,Zimbabwe,ZWE,United States of America,USA,113,0,153,17,283
2005,Stateless,XXA,United States of America,USA,31,0,62,10,103
2006,Afghanistan,AFG,United States of America,USA,23,0,12,5,40
2006,Albania,ALB,United States of America,USA,49,0,203,73,325
2006,Algeria,DZA,United States of America,USA,11,0,0,5,16
2006,Angola,AGO,United States of America,USA,0,0,0,14,14
2006,Egypt,EGY,United States of America,USA,111,0,190,12,313
2006,Argentina,ARG,United States of America,USA,5,0,5,34,44
2006,Armenia,ARM,United States of America,USA,144,0,275,36,455
2006,Azerbaijan,AZE,United States of America,USA,30,0,16,5,51
2006,Burundi,BDI,United States of America,USA,24,0,22,5,51
2006,Benin,BEN,United States of America,USA,0,0,5,0,5
2006,Bangladesh,BGD,United States of America,USA,37,0,52,65,154
2006,Bahamas,BHS,United States of America,USA,0,0,5,0,5
2006,Bhutan,BTN,United States of America,USA,10,0,0,0,10
2006,Burkina Faso,BFA,United States of America,USA,12,0,34,0,46
2006,Belarus,BLR,United States of America,USA,95,0,164,28,287
2006,Bolivia (Plurinational State of),BOL,United States of America,USA,0,0,5,12,17
2006,Brazil,BRA,United States of America,USA,24,0,100,62,186
2006,Bosnia and Herzegovina,BIH,United States of America,USA,18,0,16,5,39
2006,Bulgaria,BGR,United States of America,USA,36,0,88,99,223
2006,Cambodia,KHM,United States of America,USA,13,0,19,5,37
2006,Canada,CAN,United States of America,USA,0,0,5,5,10
2006,Central African Rep.,CAF,United States of America,USA,5,0,5,13,23
2006,Chad,TCD,United States of America,USA,21,0,46,0,67
2006,China,CHN,United States of America,USA,1517,0,3121,490,5128
2006,Chile,CHL,United States of America,USA,0,0,0,11,11
2006,Cameroon,CMR,United States of America,USA,228,0,286,26,540
2006,Congo,COG,United States of America,USA,42,0,56,24,122
2006,Dem. Rep. of the Congo,COD,United States of America,USA,37,0,40,11,88
2006,Colombia,COL,United States of America,USA,1143,0,638,213,1994
2006,Costa Rica,CRI,United States of America,USA,0,0,0,5,5
2006,Cuba,CUB,United States of America,USA,45,0,35,443,523
2006,Cabo Verde,CPV,United States of America,USA,0,0,5,0,5
2006,Czechia,CZE,United States of America,USA,0,0,13,23,36
2006,Djibouti,DJI,United States of America,USA,0,0,0,5,5
2006,Dominica,DMA,United States of America,USA,5,0,0,5,10
2006,Ecuador,ECU,United States of America,USA,5,0,15,31,51
2006,Eritrea,ERI,United States of America,USA,104,0,66,10,180
2006,Estonia,EST,United States of America,USA,0,0,19,12,31
2006,Ethiopia,ETH,United States of America,USA,423,0,349,73,845
2006,Fiji,FJI,United States of America,USA,19,0,16,18,53
2006,France,FRA,United States of America,USA,0,0,5,5,10
2006,Gabon,GAB,United States of America,USA,0,0,5,0,5
2006,Gambia,GMB,United States of America,USA,31,0,174,32,237
2006,United Kingdom of Great Britain and Northern Ireland,GBR,United States of America,USA,0,0,0,5,5
2006,Georgia,GEO,United States of America,USA,13,0,38,12,63
2006,Germany,DEU,United States of America,USA,5,0,0,0,5
2006,Ghana,GHA,United States of America,USA,5,0,17,26,48
2006,Guinea-Bissau,GNB,United States of America,USA,0,0,5,0,5
2006,Greece,GRC,United States of America,USA,0,0,5,0,5
2006,Guatemala,GTM,United States of America,USA,389,0,3251,13002,16642
2006,Guinea,GIN,United States of America,USA,91,0,335,51,477
2006,Guyana,GUY,United States of America,USA,0,0,5,14,19
2006,Haiti,HTI,United States of America,USA,1874,0,2984,2753,7611
2006,Honduras,HND,United States of America,USA,26,0,130,121,277
2006,Croatia,HRV,United States of America,USA,5,0,0,11,16
2006,Hungary,HUN,United States of America,USA,0,0,5,29,34
2006,Cote d'Ivoire,CIV,United States of America,USA,59,0,174,38,271
2006,India,IND,United States of America,USA,159,0,316,207,682
2006,Indonesia,IDN,United States of America,USA,282,0,321,106,709
2006,Iran (Islamic Rep. of),IRN,United States of America,USA,116,0,95,41,252
2006,Iraq,IRQ,United States of America,USA,137,0,68,13,218
2006,Israel,ISR,United States of America,USA,0,0,15,10,25
2006,Jamaica,JAM,United States of America,USA,5,0,5,17,27
2006,Jordan,JOR,United States of America,USA,10,0,24,14,48
2006,Kazakhstan,KAZ,United States of America,USA,10,0,27,10,47
2006,Kenya,KEN,United States of America,USA,67,0,107,52,226
2006,Kyrgyzstan,KGZ,United States of America,USA,11,0,16,0,27
2006,Rep. of Korea,KOR,United States of America,USA,0,0,12,5,17
2006,Dem. People's Rep. of Korea,PRK,United States of America,USA,0,0,5,0,5
2006,Kuwait,KWT,United States of America,USA,0,0,0,5,5
2006,Lao People's Dem. Rep.,LAO,United States of America,USA,11,0,40,37,88
2006,Liberia,LBR,United States of America,USA,87,0,90,60,237
2006,Libya,LBY,United States of America,USA,5,0,0,0,5
2006,Lebanon,LBN,United States of America,USA,10,0,30,25,65
2006,Sri Lanka,LKA,United States of America,USA,17,0,38,5,60
2006,Lithuania,LTU,United States of America,USA,0,0,42,34,76
2006,Latvia,LVA,United States of America,USA,5,0,18,11,34
2006,Mauritania,MRT,United States of America,USA,14,0,106,115,235
2006,North Macedonia,MKD,United States of America,USA,5,0,13,10,28
2006,Rep. of Moldova,MDA,United States of America,USA,12,0,34,5,51
2006,Mexico,MEX,United States of America,USA,61,0,839,510,1410
2006,Mali,MLI,United States of America,USA,20,0,166,25,211
2006,Malaysia,MYS,United States of America,USA,5,0,12,0,17
2006,Malawi,MWI,United States of America,USA,0,0,5,0,5
2006,Mongolia,MNG,United States of America,USA,27,0,48,5,80
2006,Morocco,MAR,United States of America,USA,0,0,11,0,11
2006,Myanmar,MMR,United States of America,USA,94,0,62,42,198
2006,Nepal,NPL,United States of America,USA,159,0,200,24,383
2006,Netherlands,NLD,United States of America,USA,0,0,0,5,5
2006,Niger,NER,United States of America,USA,12,0,21,10,43
2006,Nicaragua,NIC,United States of America,USA,34,0,199,2756,2989
2006,Nigeria,NGA,United States of America,USA,25,0,45,41,111
2006,Pakistan,PAK,United States of America,USA,93,0,110,79,282
2006,Panama,PAN,United States of America,USA,0,0,0,5,5
2006,Paraguay,PRY,United States of America,USA,0,0,0,5,5
2006,Peru,PER,United States of America,USA,51,0,84,64,199
2006,Philippines,PHL,United States of America,USA,16,0,44,56,116
2006,Poland,POL,United States of America,USA,0,0,72,216,288
2006,Portugal,PRT,United States of America,USA,0,0,0,5,5
2006,Romania,ROU,United States of America,USA,18,0,82,264,364
2006,South Africa,ZAF,United States of America,USA,0,0,14,5,19
2006,Russian Federation,RUS,United States of America,USA,220,0,388,505,1113
2006,Rwanda,RWA,United States of America,USA,53,0,38,0,91
2006,El Salvador,SLV,United States of America,USA,389,0,4085,19810,24284
2006,Saudi Arabia,SAU,United States of America,USA,5,0,0,0,5
2006,Serbia and Kosovo: S/RES/1244 (1999),SRB,United States of America,USA,51,0,112,123,286
2006,Senegal,SEN,United States of America,USA,5,0,37,12,54
2006,Singapore,SGP,United States of America,USA,0,0,5,0,5
2006,Sierra Leone,SLE,United States of America,USA,25,0,99,97,221
2006,Somalia,SOM,United States of America,USA,45,0,74,70,189
2006,Spain,ESP,United States of America,USA,0,0,0,5,5
2006,Viet Nam,VNM,United States of America,USA,10,0,11,5,26
2006,Sudan,SDN,United States of America,USA,36,0,39,11,86
2006,Suriname,SUR,United States of America,USA,0,0,5,5,10
2006,Slovakia,SVK,United States of America,USA,0,0,17,12,29
2006,Syrian Arab Rep.,SYR,United States of America,USA,10,0,13,13,36
2006,United Rep. of Tanzania,TZA,United States of America,USA,5,0,14,0,19
2006,Thailand,THA,United States of America,USA,0,0,10,10,20
2006,Tajikistan,TJK,United States of America,USA,0,0,5,0,5
2006,Turkmenistan,TKM,United States of America,USA,25,0,27,5,57
2006,Togo,TGO,United States of America,USA,71,0,89,10,170
2006,Tonga,TON,United States of America,USA,0,0,5,0,5
2006,Trinidad and Tobago,TTO,United States of America,USA,0,0,5,15,20
2006,Tunisia,TUN,United States of America,USA,0,0,0,5,5
2006,Turkey,TUR,United States of America,USA,10,0,5,5,20
2006,Uganda,UGA,United States of America,USA,30,0,31,10,71
2006,Ukraine,UKR,United States of America,USA,44,0,143,119,306
2006,Uruguay,URY,United States of America,USA,0,0,5,10,15
2006,Uzbekistan,UZB,United States of America,USA,78,0,163,31,272
2006,Venezuela (Bolivarian Republic of),VEN,United States of America,USA,497,0,480,44,1021
2006,Yemen,YEM,United States of America,USA,5,0,14,5,24
2006,Zambia,ZMB,United States of America,USA,0,0,12,5,17
2006,Zimbabwe,ZWE,United States of America,USA,84,0,110,13,207
2006,Stateless,XXA,United States of America,USA,33,0,48,21,102
2007,Afghanistan,AFG,United States of America,USA,52,0,16,5,73
2007,Albania,ALB,United States of America,USA,53,0,137,40,230
2007,Algeria,DZA,United States of America,USA,5,0,10,17,32
2007,Angola,AGO,United States of America,USA,5,0,12,0,17
2007,Egypt,EGY,United States of America,USA,118,0,199,29,346
2007,Argentina,ARG,United States of America,USA,0,0,0,75,75
2007,Armenia,ARM,United States of America,USA,198,0,238,29,465
2007,Azerbaijan,AZE,United States of America,USA,15,0,13,5,33
2007,Burundi,BDI,United States of America,USA,26,0,33,5,64
2007,Benin,BEN,United States of America,USA,0,0,12,0,12
2007,Bangladesh,BGD,United States of America,USA,30,0,44,73,147
2007,Bhutan,BTN,United States of America,USA,5,0,0,0,5
2007,Burkina Faso,BFA,United States of America,USA,26,0,77,5,108
2007,Belarus,BLR,United States of America,USA,87,0,153,26,266
2007,Bolivia (Plurinational State of),BOL,United States of America,USA,0,0,14,0,14
2007,Brazil,BRA,United States of America,USA,34,0,47,231,312
2007,Bosnia and Herzegovina,BIH,United States of America,USA,13,0,30,5,48
2007,Bulgaria,BGR,United States of America,USA,36,0,65,74,175
2007,Belize,BLZ,United States of America,USA,0,0,5,0,5
2007,Cambodia,KHM,United States of America,USA,22,0,13,5,40
2007,Canada,CAN,United States of America,USA,0,0,5,0,5
2007,Central African Rep.,CAF,United States of America,USA,5,0,14,0,19
2007,Chad,TCD,United States of America,USA,31,0,39,5,75
2007,China,CHN,United States of America,USA,1804,0,4650,472,6926
2007,Chile,CHL,United States of America,USA,0,0,0,12,12
2007,Cameroon,CMR,United States of America,USA,270,0,281,33,584
2007,Congo,COG,United States of America,USA,60,0,45,19,124
2007,Dem. Rep. of the Congo,COD,United States of America,USA,39,0,29,14,82
2007,Colombia,COL,United States of America,USA,798,0,625,227,1650
2007,Costa Rica,CRI,United States of America,USA,5,0,0,14,19
2007,Cuba,CUB,United States of America,USA,49,0,41,158,248
2007,Czechia,CZE,United States of America,USA,0,0,5,24,29
2007,Djibouti,DJI,United States of America,USA,0,0,5,0,5
2007,Dominican Rep.,DOM,United States of America,USA,5,0,0,10,15
2007,Ecuador,ECU,United States of America,USA,5,0,16,49,70
2007,Equatorial Guinea,GNQ,United States of America,USA,0,0,5,0,5
2007,Eritrea,ERI,United States of America,USA,141,0,71,5,217
2007,Estonia,EST,United States of America,USA,0,0,13,0,13
2007,Ethiopia,ETH,United States of America,USA,503,0,442,59,1004
2007,Fiji,FJI,United States of America,USA,20,0,25,18,63
2007,France,FRA,United States of America,USA,0,0,0,10,10
2007,Gabon,GAB,United States of America,USA,5,0,0,0,5
2007,Gambia,GMB,United States of America,USA,36,0,224,20,280
2007,United Kingdom of Great Britain and Northern Ireland,GBR,United States of America,USA,0,0,0,5,5
2007,Georgia,GEO,United States of America,USA,15,0,26,10,51
2007,Germany,DEU,United States of America,USA,0,0,0,14,14
2007,Ghana,GHA,United States of America,USA,21,0,11,23,55
2007,Grenada,GRD,United States of America,USA,5,0,0,0,5
2007,Guatemala,GTM,United States of America,USA,430,0,4547,6551,11528
2007,Guinea,GIN,United States of America,USA,111,0,411,34,556
2007,Guyana,GUY,United States of America,USA,5,0,5,13,23
2007,Haiti,HTI,United States of America,USA,879,0,1728,1078,3685
2007,Honduras,HND,United States of America,USA,18,0,87,212,317
2007,Croatia,HRV,United States of America,USA,11,0,5,0,16
2007,Hungary,HUN,United States of America,USA,0,0,5,26,31
2007,Cote d'Ivoire,CIV,United States of America,USA,46,0,226,24,296
2007,India,IND,United States of America,USA,124,0,413,162,699
2007,Indonesia,IDN,United States of America,USA,409,0,657,59,1125
2007,Iran (Islamic Rep. of),IRN,United States of America,USA,146,0,86,32,264
2007,Iraq,IRQ,United States of America,USA,326,0,74,21,421
2007,Israel,ISR,United States of America,USA,5,0,24,10,39
2007,Italy,ITA,United States of America,USA,0,0,0,10,10
2007,Jamaica,JAM,United States of America,USA,12,0,10,10,32
2007,Jordan,JOR,United States of America,USA,18,0,41,16,75
2007,Japan,JPN,United States of America,USA,0,0,0,5,5
2007,Kazakhstan,KAZ,United States of America,USA,28,0,42,5,75
2007,Kenya,KEN,United States of America,USA,152,0,134,49,335
2007,Kyrgyzstan,KGZ,United States of America,USA,13,0,25,0,38
2007,Rep. of Korea,KOR,United States of America,USA,0,0,12,0,12
2007,Kuwait,KWT,United States of America,USA,5,0,0,0,5
2007,Lao People's Dem. Rep.,LAO,United States of America,USA,33,0,33,18,84
2007,Liberia,LBR,United States of America,USA,90,0,94,53,237
2007,Lebanon,LBN,United States of America,USA,30,0,60,30,120
2007,Sri Lanka,LKA,United States of America,USA,28,0,100,23,151
2007,Lithuania,LTU,United States of America,USA,0,0,13,16,29
2007,Latvia,LVA,United States of America,USA,11,0,5,0,16
2007,Mauritania,MRT,United States of America,USA,17,0,54,52,123
2007,North Macedonia,MKD,United States of America,USA,5,0,11,5,21
2007,Rep. of Moldova,MDA,United States of America,USA,29,0,58,24,111
2007,Mexico,MEX,United States of America,USA,88,0,828,1449,2365
2007,Mali,MLI,United States of America,USA,36,0,248,19,303
2007,Malaysia,MYS,United States of America,USA,5,0,0,5,10
2007,Malawi,MWI,United States of America,USA,0,0,5,0,5
2007,Mongolia,MNG,United States of America,USA,56,0,59,5,120
2007,Morocco,MAR,United States of America,USA,5,0,5,0,10
2007,Montenegro,MNE,United States of America,USA,0,0,5,0,5
2007,Mauritius,MUS,United States of America,USA,5,0,0,0,5
2007,Myanmar,MMR,United States of America,USA,112,0,72,29,213
2007,Nepal,NPL,United States of America,USA,229,0,283,20,532
2007,Netherlands,NLD,United States of America,USA,0,0,0,5,5
2007,Niger,NER,United States of America,USA,10,0,18,5,33
2007,Nicaragua,NIC,United States of America,USA,26,0,97,573,696
2007,Nigeria,NGA,United States of America,USA,28,0,37,28,93
2007,Pakistan,PAK,United States of America,USA,109,0,82,66,257
2007,Panama,PAN,United States of America,USA,0,0,0,5,5
2007,Peru,PER,United States of America,USA,50,0,60,74,184
2007,Philippines,PHL,United States of America,USA,14,0,48,37,99
2007,Poland,POL,United States of America,USA,0,0,23,77,100
2007,Romania,ROU,United States of America,USA,18,0,37,175,230
2007,South Africa,ZAF,United States of America,USA,0,0,16,5,21
2007,Russian Federation,RUS,United States of America,USA,253,0,381,201,835
2007,Rwanda,RWA,United States of America,USA,60,0,40,5,105
2007,El Salvador,SLV,United States of America,USA,355,0,6191,8853,15399
2007,Serbia and Kosovo: S/RES/1244 (1999),SRB,United States of America,USA,78,0,140,63,281
2007,Senegal,SEN,United States of America,USA,13,0,64,13,90
2007,Sierra Leone,SLE,United States of America,USA,26,0,60,50,136
2007,Somalia,SOM,United States of America,USA,109,0,45,51,205
2007,Viet Nam,VNM,United States of America,USA,14,0,11,5,30
2007,Sudan,SDN,United States of America,USA,74,0,49,5,128
2007,Suriname,SUR,United States of America,USA,0,0,0,5,5
2007,Slovenia,SVN,United States of America,USA,0,0,5,0,5
2007,Sweden,SWE,United States of America,USA,0,0,5,0,5
2007,Syrian Arab Rep.,SYR,United States of America,USA,11,0,21,0,32
2007,United Rep. of Tanzania,TZA,United States of America,USA,5,0,17,5,27
2007,Thailand,THA,United States of America,USA,0,0,13,0,13
2007,Tajikistan,TJK,United States of America,USA,0,0,11,0,11
2007,Turkmenistan,TKM,United States of America,USA,14,0,19,0,33
2007,Togo,TGO,United States of America,USA,59,0,55,5,119
2007,Tonga,TON,United States of America,USA,0,0,5,0,5
2007,Trinidad and Tobago,TTO,United States of America,USA,5,0,5,20,30
2007,Tunisia,TUN,United States of America,USA,5,0,0,0,5
2007,Turkey,TUR,United States of America,USA,16,0,19,14,49
2007,Uganda,UGA,United States of America,USA,71,0,33,13,117
2007,Ukraine,UKR,United States of America,USA,66,0,127,69,262
2007,Uruguay,URY,United States of America,USA,0,0,5,26,31
2007,Uzbekistan,UZB,United States of America,USA,91,0,147,22,260
2007,Venezuela (Bolivarian Republic of),VEN,United States of America,USA,384,0,346,50,780
2007,Yemen,YEM,United States of America,USA,24,0,12,10,46
2007,Zambia,ZMB,United States of America,USA,5,0,12,0,17
2007,Zimbabwe,ZWE,United States of America,USA,105,0,110,11,226
2007,Stateless,XXA,United States of America,USA,40,0,83,20,143
2008,Afghanistan,AFG,United States of America,USA,66,0,10,5,81
2008,Albania,ALB,United States of America,USA,32,0,79,25,136
2008,Algeria,DZA,United States of America,USA,10,0,13,5,28
2008,Angola,AGO,United States of America,USA,0,0,12,0,12
2008,Egypt,EGY,United States of America,USA,166,0,202,21,389
2008,Argentina,ARG,United States of America,USA,0,0,5,27,32
2008,Armenia,ARM,United States of America,USA,96,0,127,22,245
2008,Azerbaijan,AZE,United States of America,USA,13,0,24,0,37
2008,Burundi,BDI,United States of America,USA,28,0,15,0,43
2008,Benin,BEN,United States of America,USA,5,0,11,0,16
2008,Bangladesh,BGD,United States of America,USA,24,0,78,26,128
2008,Bhutan,BTN,United States of America,USA,5,0,5,0,10
2008,Burkina Faso,BFA,United States of America,USA,14,0,67,10,91
2008,Belarus,BLR,United States of America,USA,62,0,102,17,181
2008,Bolivia (Plurinational State of),BOL,United States of America,USA,5,0,0,14,19
2008,Brazil,BRA,United States of America,USA,36,0,54,35,125
2008,Bosnia and Herzegovina,BIH,United States of America,USA,10,0,18,5,33
2008,Bulgaria,BGR,United States of America,USA,39,0,47,49,135
2008,Belize,BLZ,United States of America,USA,0,0,0,5,5
2008,Cambodia,KHM,United States of America,USA,5,0,0,13,18
2008,Canada,CAN,United States of America,USA,0,0,0,5,5
2008,Central African Rep.,CAF,United States of America,USA,13,0,17,0,30
2008,Chad,TCD,United States of America,USA,38,0,70,5,113
2008,China,CHN,United States of America,USA,1902,0,5714,422,8038
2008,Cameroon,CMR,United States of America,USA,259,0,280,38,577
2008,Congo,COG,United States of America,USA,45,0,44,15,104
2008,Dem. Rep. of the Congo,COD,United States of America,USA,39,0,44,13,96
2008,Colombia,COL,United States of America,USA,594,0,330,116,1040
2008,Costa Rica,CRI,United States of America,USA,0,0,0,14,14
2008,Cuba,CUB,United States of America,USA,63,0,42,77,182
2008,Czechia,CZE,United States of America,USA,0,0,0,12,12
2008,Djibouti,DJI,United States of America,USA,0,0,5,0,5
2008,Dominican Rep.,DOM,United States of America,USA,0,0,5,5,10
2008,Ecuador,ECU,United States of America,USA,5,0,22,78,105
2008,Eritrea,ERI,United States of America,USA,173,0,108,10,291
2008,Estonia,EST,United States of America,USA,0,0,0,5,5
2008,Ethiopia,ETH,United States of America,USA,582,0,520,45,1147
2008,Fiji,FJI,United States of America,USA,23,0,16,10,49
2008,France,FRA,United States of America,USA,0,0,5,5,10
2008,Gabon,GAB,United States of America,USA,5,0,0,0,5
2008,Gambia,GMB,United States of America,USA,38,0,116,12,166
2008,United Kingdom of Great Britain and Northern Ireland,GBR,United States of America,USA,0,0,5,5,10
2008,Georgia,GEO,United States of America,USA,22,0,26,10,58
2008,Germany,DEU,United States of America,USA,0,0,5,13,18
2008,Ghana,GHA,United States of America,USA,12,0,5,10,27
2008,Guinea-Bissau,GNB,United States of America,USA,0,0,5,0,5
2008,Guatemala,GTM,United States of America,USA,286,0,2219,3706,6211
2008,Guinea,GIN,United States of America,USA,101,0,296,33,430
2008,Guyana,GUY,United States of America,USA,5,0,0,5,10
2008,Haiti,HTI,United States of America,USA,587,0,1067,515,2169
2008,Honduras,HND,United States of America,USA,21,0,56,103,180
2008,Croatia,HRV,United States of America,USA,5,0,0,0,5
2008,Hungary,HUN,United States of America,USA,0,0,5,5,10
2008,Cote d'Ivoire,CIV,United States of America,USA,40,0,185,17,242
2008,India,IND,United States of America,USA,137,0,442,98,677
2008,Indonesia,IDN,United States of America,USA,277,0,544,122,943
2008,Iran (Islamic Rep. of),IRN,United States of America,USA,249,0,87,30,366
2008,Iraq,IRQ,United States of America,USA,420,0,93,21,534
2008,Israel,ISR,United States of America,USA,10,0,27,5,42
2008,Italy,ITA,United States of America,USA,5,0,0,0,5
2008,Jamaica,JAM,United States of America,USA,19,0,11,13,43
2008,Jordan,JOR,United States of America,USA,19,0,32,5,56
2008,Kazakhstan,KAZ,United States of America,USA,18,0,28,5,51
2008,Kenya,KEN,United States of America,USA,184,0,195,50,429
2008,Kyrgyzstan,KGZ,United States of America,USA,20,0,25,5,50
2008,Rep. of Korea,KOR,United States of America,USA,0,0,0,5,5
2008,Lao People's Dem. Rep.,LAO,United States of America,USA,12,0,18,10,40
2008,Liberia,LBR,United States of America,USA,87,0,80,32,199
2008,Libya,LBY,United States of America,USA,5,0,0,0,5
2008,Lebanon,LBN,United States of America,USA,23,0,45,13,81
2008,Sri Lanka,LKA,United States of America,USA,30,0,143,14,187
2008,Lithuania,LTU,United States of America,USA,0,0,5,12,17
2008,Latvia,LVA,United States of America,USA,0,0,5,0,5
2008,Mauritania,MRT,United States of America,USA,10,0,28,19,57
2008,North Macedonia,MKD,United States of America,USA,0,0,14,0,14
2008,Rep. of Moldova,MDA,United States of America,USA,41,0,94,34,169
2008,Mexico,MEX,United States of America,USA,123,0,829,1543,2495
2008,Mali,MLI,United States of America,USA,32,0,187,13,232
2008,Malaysia,MYS,United States of America,USA,10,0,14,0,24
2008,Malawi,MWI,United States of America,USA,0,0,5,0,5
2008,Mongolia,MNG,United States of America,USA,46,0,76,5,127
2008,Morocco,MAR,United States of America,USA,0,0,0,11,11
2008,Montenegro,MNE,United States of America,USA,0,0,5,0,5
2008,Myanmar,MMR,United States of America,USA,142,0,76,22,240
2008,Nepal,NPL,United States of America,USA,295,0,307,29,631
2008,Netherlands,NLD,United States of America,USA,0,0,5,0,5
2008,Niger,NER,United States of America,USA,13,0,19,10,42
2008,Nicaragua,NIC,United States of America,USA,22,0,83,177,282
2008,Nigeria,NGA,United States of America,USA,38,0,43,21,102
2008,Pakistan,PAK,United States of America,USA,118,0,129,60,307
2008,Panama,PAN,United States of America,USA,0,0,5,0,5
2008,Peru,PER,United States of America,USA,39,0,32,37,108
2008,Philippines,PHL,United States of America,USA,10,0,46,34,90
2008,Poland,POL,United States of America,USA,0,0,5,43,48
2008,Romania,ROU,United States of America,USA,12,0,23,58,93
2008,South Africa,ZAF,United States of America,USA,0,0,10,0,10
2008,Russian Federation,RUS,United States of America,USA,304,0,322,180,806
2008,Rwanda,RWA,United States of America,USA,63,0,42,5,110
2008,El Salvador,SLV,United States of America,USA,260,0,3934,5176,9370
2008,Saudi Arabia,SAU,United States of America,USA,5,0,5,0,10
2008,Serbia and Kosovo: S/RES/1244 (1999),SRB,United States of America,USA,63,0,136,46,245
2008,Senegal,SEN,United States of America,USA,10,0,71,15,96
2008,Sierra Leone,SLE,United States of America,USA,29,0,42,31,102
2008,Somalia,SOM,United States of America,USA,111,0,27,37,175
2008,Spain,ESP,United States of America,USA,0,0,0,5,5
2008,Viet Nam,VNM,United States of America,USA,19,0,17,0,36
2008,Sudan,SDN,United States of America,USA,92,0,62,10,164
2008,Suriname,SUR,United States of America,USA,0,0,5,0,5
2008,Slovakia,SVK,United States of America,USA,0,0,5,0,5
2008,Sweden,SWE,United States of America,USA,0,0,0,5,5
2008,Switzerland,CHE,United States of America,USA,0,0,0,5,5
2008,Syrian Arab Rep.,SYR,United States of America,USA,18,0,22,5,45
2008,United Rep. of Tanzania,TZA,United States of America,USA,10,0,5,0,15
2008,Thailand,THA,United States of America,USA,0,0,5,5,10
2008,Tajikistan,TJK,United States of America,USA,5,0,14,0,19
2008,Turkmenistan,TKM,United States of America,USA,10,0,16,0,26
2008,Togo,TGO,United States of America,USA,42,0,58,10,110
2008,Tonga,TON,United States of America,USA,0,0,5,0,5
2008,Trinidad and Tobago,TTO,United States of America,USA,5,0,12,5,22
2008,Tunisia,TUN,United States of America,USA,5,0,0,0,5
2008,Turkey,TUR,United States of America,USA,29,0,20,10,59
2008,Uganda,UGA,United States of America,USA,58,0,32,10,100
2008,Ukraine,UKR,United States of America,USA,59,0,95,42,196
2008,Uruguay,URY,United States of America,USA,0,0,0,11,11
2008,Uzbekistan,UZB,United States of America,USA,78,0,116,16,210
2008,Venezuela (Bolivarian Republic of),VEN,United States of America,USA,348,0,307,36,691
2008,Yemen,YEM,United States of America,USA,23,0,10,0,33
2008,Zambia,ZMB,United States of America,USA,0,0,12,0,12
2008,Zimbabwe,ZWE,United States of America,USA,136,0,93,18,247
2008,Stateless,XXA,United States of America,USA,61,0,80,12,153
2009,Afghanistan,AFG,United States of America,USA,65,0,0,16,81
2009,Albania,ALB,United States of America,USA,33,0,10,99,142
2009,Algeria,DZA,United States of America,USA,5,0,0,11,16
2009,Angola,AGO,United States of America,USA,0,0,0,13,13
2009,Egypt,EGY,United States of America,USA,185,0,5,196,386
2009,Argentina,ARG,United States of America,USA,0,0,0,12,12
2009,Armenia,ARM,United States of America,USA,89,0,5,117,211
2009,Australia,AUS,United States of America,USA,0,0,0,5,5
2009,Azerbaijan,AZE,United States of America,USA,19,0,0,20,39
2009,Barbados,BRB,United States of America,USA,0,0,0,5,5
2009,Burundi,BDI,United States of America,USA,18,0,5,14,37
2009,Benin,BEN,United States of America,USA,5,0,0,14,19
2009,Bangladesh,BGD,United States of America,USA,22,0,0,103,125
2009,Bahamas,BHS,United States of America,USA,0,0,0,5,5
2009,Burkina Faso,BFA,United States of America,USA,18,0,5,53,76
2009,Belarus,BLR,United States of America,USA,97,0,5,140,242
2009,Bolivia (Plurinational State of),BOL,United States of America,USA,5,0,0,14,19
2009,Brazil,BRA,United States of America,USA,45,0,0,69,114
2009,Bosnia and Herzegovina,BIH,United States of America,USA,5,0,0,11,16
2009,Bulgaria,BGR,United States of America,USA,18,0,0,35,53
2009,Belize,BLZ,United States of America,USA,0,0,0,5,5
2009,Cambodia,KHM,United States of America,USA,0,0,0,5,5
2009,Canada,CAN,United States of America,USA,0,0,0,5,5
2009,Central African Rep.,CAF,United States of America,USA,12,0,0,5,17
2009,Chad,TCD,United States of America,USA,21,0,5,26,52
2009,China,CHN,United States of America,USA,2433,0,171,6292,8896
2009,Chile,CHL,United States of America,USA,0,0,0,5,5
2009,Cameroon,CMR,United States of America,USA,214,0,36,213,463
2009,Congo,COG,United States of America,USA,44,0,0,49,93
2009,Dem. Rep. of the Congo,COD,United States of America,USA,37,0,10,30,77
2009,Colombia,COL,United States of America,USA,336,0,10,289,635
2009,Cuba,CUB,United States of America,USA,30,0,0,47,77
2009,Czechia,CZE,United States of America,USA,0,0,0,5,5
2009,Djibouti,DJI,United States of America,USA,5,0,0,11,16
2009,Dominican Rep.,DOM,United States of America,USA,0,0,0,10,10
2009,Ecuador,ECU,United States of America,USA,10,0,0,78,88
2009,Equatorial Guinea,GNQ,United States of America,USA,5,0,0,0,5
2009,Eritrea,ERI,United States of America,USA,223,0,5,99,327
2009,Estonia,EST,United States of America,USA,0,0,0,11,11
2009,Ethiopia,ETH,United States of America,USA,617,0,77,425,1119
2009,Fiji,FJI,United States of America,USA,13,0,0,11,24
2009,Gabon,GAB,United States of America,USA,5,0,0,5,10
2009,Gambia,GMB,United States of America,USA,42,0,5,132,179
2009,United Kingdom of Great Britain and Northern Ireland,GBR,United States of America,USA,0,0,0,5,5
2009,Georgia,GEO,United States of America,USA,22,0,0,52,74
2009,Germany,DEU,United States of America,USA,0,0,0,10,10
2009,Ghana,GHA,United States of America,USA,15,0,0,24,39
2009,Guinea-Bissau,GNB,United States of America,USA,0,0,0,5,5
2009,Grenada,GRD,United States of America,USA,5,0,0,0,5
2009,Guatemala,GTM,United States of America,USA,265,0,399,1852,2516
2009,Guinea,GIN,United States of America,USA,118,0,10,302,430
2009,Guyana,GUY,United States of America,USA,0,0,0,23,23
2009,Haiti,HTI,United States of America,USA,458,0,48,916,1422
2009,Honduras,HND,United States of America,USA,25,0,5,93,123
2009,Croatia,HRV,United States of America,USA,0,0,0,5,5
2009,Hungary,HUN,United States of America,USA,0,0,0,5,5
2009,Cote d'Ivoire,CIV,United States of America,USA,38,0,10,156,204
2009,India,IND,United States of America,USA,143,0,10,444,597
2009,Indonesia,IDN,United States of America,USA,110,0,14,273,397
2009,Iran (Islamic Rep. of),IRN,United States of America,USA,211,0,5,81,297
2009,Iraq,IRQ,United States of America,USA,384,0,14,72,470
2009,Israel,ISR,United States of America,USA,10,0,0,12,22
2009,Jamaica,JAM,United States of America,USA,37,0,0,22,59
2009,Jordan,JOR,United States of America,USA,16,0,0,24,40
2009,Japan,JPN,United States of America,USA,0,0,0,5,5
2009,Kazakhstan,KAZ,United States of America,USA,20,0,0,66,86
2009,Kenya,KEN,United States of America,USA,182,0,25,175,382
2009,Kyrgyzstan,KGZ,United States of America,USA,28,0,0,43,71
2009,Rep. of Korea,KOR,United States of America,USA,0,0,0,24,24
2009,Dem. People's Rep. of Korea,PRK,United States of America,USA,0,0,0,5,5
2009,Kuwait,KWT,United States of America,USA,5,0,0,0,5
2009,Lao People's Dem. Rep.,LAO,United States of America,USA,10,0,0,19,29
2009,Liberia,LBR,United States of America,USA,85,0,5,67,157
2009,Libya,LBY,United States of America,USA,5,0,0,0,5
2009,Saint Lucia,LCA,United States of America,USA,0,0,0,5,5
2009,Lebanon,LBN,United States of America,USA,32,0,0,31,63
2009,Sri Lanka,LKA,United States of America,USA,70,0,5,176,251
2009,Lithuania,LTU,United States of America,USA,5,0,0,0,5
2009,Latvia,LVA,United States of America,USA,5,0,0,5,10
2009,Mauritania,MRT,United States of America,USA,20,0,0,35,55
2009,North Macedonia,MKD,United States of America,USA,5,0,0,22,27
2009,Rep. of Moldova,MDA,United States of America,USA,85,0,0,222,307
2009,Mexico,MEX,United States of America,USA,151,0,5,1585,1741
2009,Mali,MLI,United States of America,USA,43,0,5,146,194
2009,Malaysia,MYS,United States of America,USA,12,0,0,0,12
2009,Malawi,MWI,United States of America,USA,5,0,0,5,10
2009,Mongolia,MNG,United States of America,USA,29,0,10,94,133
2009,Morocco,MAR,United States of America,USA,0,0,0,13,13
2009,Montenegro,MNE,United States of America,USA,0,0,0,10,10
2009,Myanmar,MMR,United States of America,USA,165,0,11,88,264
2009,Nepal,NPL,United States of America,USA,398,0,57,551,1006
2009,Netherlands,NLD,United States of America,USA,0,0,0,5,5
2009,Niger,NER,United States of America,USA,5,0,5,22,32
2009,Nicaragua,NIC,United States of America,USA,19,0,5,81,105
2009,Nigeria,NGA,United States of America,USA,16,0,5,32,53
2009,Pakistan,PAK,United States of America,USA,124,0,12,171,307
2009,Paraguay,PRY,United States of America,USA,5,0,0,0,5
2009,Peru,PER,United States of America,USA,20,0,0,33,53
2009,Philippines,PHL,United States of America,USA,11,0,5,45,61
2009,Poland,POL,United States of America,USA,0,0,0,10,10
2009,Romania,ROU,United States of America,USA,10,0,0,18,28
2009,South Africa,ZAF,United States of America,USA,0,0,0,14,14
2009,Russian Federation,RUS,United States of America,USA,264,0,22,460,746
2009,Rwanda,RWA,United States of America,USA,49,0,12,43,104
2009,El Salvador,SLV,United States of America,USA,178,0,830,2043,3051
2009,Saudi Arabia,SAU,United States of America,USA,5,0,0,5,10
2009,Serbia and Kosovo: S/RES/1244 (1999),SRB,United States of America,USA,40,0,0,113,153
2009,Senegal,SEN,United States of America,USA,20,0,0,94,114
2009,Sierra Leone,SLE,United States of America,USA,39,0,0,35,74
2009,Somalia,SOM,United States of America,USA,149,0,5,34,188
2009,Viet Nam,VNM,United States of America,USA,28,0,5,12,45
2009,Sudan,SDN,United States of America,USA,61,0,5,37,103
2009,Suriname,SUR,United States of America,USA,0,0,0,5,5
2009,Slovakia,SVK,United States of America,USA,0,0,0,5,5
2009,Syrian Arab Rep.,SYR,United States of America,USA,11,0,0,14,25
2009,United Rep. of Tanzania,TZA,United States of America,USA,0,0,0,14,14
2009,Thailand,THA,United States of America,USA,0,0,0,5,5
2009,Tajikistan,TJK,United States of America,USA,11,0,0,36,47
2009,Turkmenistan,TKM,United States of America,USA,10,0,0,13,23
2009,Togo,TGO,United States of America,USA,38,0,5,47,90
2009,Trinidad and Tobago,TTO,United States of America,USA,0,0,0,19,19
2009,Tunisia,TUN,United States of America,USA,0,0,0,5,5
2009,Turkey,TUR,United States of America,USA,22,0,5,29,56
2009,Uganda,UGA,United States of America,USA,56,0,5,33,94
2009,Ukraine,UKR,United States of America,USA,66,0,5,160,231
2009,Uruguay,URY,United States of America,USA,0,0,0,5,5
2009,Uzbekistan,UZB,United States of America,USA,61,0,10,102,173
2009,Venezuela (Bolivarian Republic of),VEN,United States of America,USA,187,0,22,207,416
2009,Yemen,YEM,United States of America,USA,20,0,0,16,36
2009,Zambia,ZMB,United States of America,USA,0,0,0,5,5
2009,Zimbabwe,ZWE,United States of America,USA,114,0,28,105,247
2009,Stateless,XXA,United States of America,USA,83,0,0,62,145
2010,Afghanistan,AFG,United States of America,USA,80,0,5,18,103
2010,Albania,ALB,United States of America,USA,26,0,0,75,101
2010,Algeria,DZA,United States of America,USA,5,0,0,12,17
2010,Angola,AGO,United States of America,USA,5,0,0,10,15
2010,Egypt,EGY,United States of America,USA,179,0,5,190,374
2010,Argentina,ARG,United States of America,USA,0,0,0,10,10
2010,Armenia,ARM,United States of America,USA,65,0,5,98,168
2010,Azerbaijan,AZE,United States of America,USA,17,0,0,13,30
2010,Burundi,BDI,United States of America,USA,16,0,0,5,21
2010,Benin,BEN,United States of America,USA,10,0,0,5,15
2010,Bangladesh,BGD,United States of America,USA,24,0,0,80,104
2010,Bahamas,BHS,United States of America,USA,0,0,0,5,5
2010,Bhutan,BTN,United States of America,USA,0,0,0,10,10
2010,Burkina Faso,BFA,United States of America,USA,37,0,5,74,116
2010,Belarus,BLR,United States of America,USA,57,0,5,136,198
2010,Bolivia (Plurinational State of),BOL,United States of America,USA,12,0,0,5,17
2010,Brazil,BRA,United States of America,USA,42,0,0,77,119
2010,Bosnia and Herzegovina,BIH,United States of America,USA,0,0,0,14,14
2010,Bulgaria,BGR,United States of America,USA,17,0,0,15,32
2010,Belize,BLZ,United States of America,USA,5,0,0,0,5
2010,Cambodia,KHM,United States of America,USA,12,0,0,0,12
2010,Central African Rep.,CAF,United States of America,USA,13,0,5,10,28
2010,Chad,TCD,United States of America,USA,17,0,0,10,27
2010,China,CHN,United States of America,USA,2650,0,204,7716,10570
2010,Chile,CHL,United States of America,USA,0,0,0,5,5
2010,Cameroon,CMR,United States of America,USA,165,0,22,147,334
2010,Congo,COG,United States of America,USA,61,0,0,38,99
2010,Dem. Rep. of the Congo,COD,United States of America,USA,32,0,5,37,74
2010,Colombia,COL,United States of America,USA,187,0,17,200,404
2010,Costa Rica,CRI,United States of America,USA,0,0,0,5,5
2010,Cuba,CUB,United States of America,USA,18,0,5,29,52
2010,Czechia,CZE,United States of America,USA,0,0,0,5,5
2010,Djibouti,DJI,United States of America,USA,12,0,0,5,17
2010,Dominican Rep.,DOM,United States of America,USA,0,0,0,10,10
2010,Ecuador,ECU,United States of America,USA,5,0,0,202,207
2010,Eritrea,ERI,United States of America,USA,172,0,10,82,264
2010,Estonia,EST,United States of America,USA,0,0,0,5,5
2010,Ethiopia,ETH,United States of America,USA,619,0,69,337,1025
2010,Fiji,FJI,United States of America,USA,12,0,0,13,25
2010,Gabon,GAB,United States of America,USA,0,0,0,12,12
2010,Gambia,GMB,United States of America,USA,48,0,5,128,181
2010,United Kingdom of Great Britain and Northern Ireland,GBR,United States of America,USA,0,0,0,5,5
2010,Georgia,GEO,United States of America,USA,15,0,0,21,36
2010,Germany,DEU,United States of America,USA,0,0,0,13,13
2010,Ghana,GHA,United States of America,USA,5,0,5,11,21
2010,Guinea-Bissau,GNB,United States of America,USA,0,0,0,5,5
2010,Grenada,GRD,United States of America,USA,0,0,0,14,14
2010,Guatemala,GTM,United States of America,USA,233,0,68,922,1223
2010,Guinea,GIN,United States of America,USA,119,0,10,288,417
2010,Guyana,GUY,United States of America,USA,5,0,0,13,18
2010,Haiti,HTI,United States of America,USA,522,0,73,423,1018
2010,Honduras,HND,United States of America,USA,48,0,5,168,221
2010,Hungary,HUN,United States of America,USA,5,0,0,18,23
2010,Cote d'Ivoire,CIV,United States of America,USA,37,0,5,158,200
2010,India,IND,United States of America,USA,87,0,14,457,558
2010,Indonesia,IDN,United States of America,USA,60,0,5,172,237
2010,Iran (Islamic Rep. of),IRN,United States of America,USA,309,0,10,68,387
2010,Iraq,IRQ,United States of America,USA,210,0,12,42,264
2010,Israel,ISR,United States of America,USA,5,0,0,13,18
2010,Italy,ITA,United States of America,USA,0,0,0,5,5
2010,Jamaica,JAM,United States of America,USA,49,0,0,39,88
2010,Jordan,JOR,United States of America,USA,10,0,0,23,33
2010,Japan,JPN,United States of America,USA,0,0,0,5,5
2010,Kazakhstan,KAZ,United States of America,USA,25,0,0,54,79
2010,Kenya,KEN,United States of America,USA,159,0,14,204,377
2010,Kyrgyzstan,KGZ,United States of America,USA,42,0,0,55,97
2010,Rep. of Korea,KOR,United States of America,USA,0,0,0,10,10
2010,Kuwait,KWT,United States of America,USA,0,0,0,5,5
2010,Lao People's Dem. Rep.,LAO,United States of America,USA,14,0,0,18,32
2010,Liberia,LBR,United States of America,USA,69,0,5,30,104
2010,Libya,LBY,United States of America,USA,5,0,0,0,5
2010,Saint Lucia,LCA,United States of America,USA,5,0,0,0,5
2010,Lebanon,LBN,United States of America,USA,15,0,0,11,26
2010,Sri Lanka,LKA,United States of America,USA,71,0,5,104,180
2010,Lithuania,LTU,United States of America,USA,0,0,0,5,5
2010,Latvia,LVA,United States of America,USA,0,0,0,5,5
2010,Madagascar,MDG,United States of America,USA,5,0,0,0,5
2010,Mauritania,MRT,United States of America,USA,35,0,5,95,135
2010,North Macedonia,MKD,United States of America,USA,0,0,0,12,12
2010,Rep. of Moldova,MDA,United States of America,USA,55,0,5,228,288
2010,Mexico,MEX,United States of America,USA,114,0,5,1948,2067
2010,Mali,MLI,United States of America,USA,62,0,15,172,249
2010,Malaysia,MYS,United States of America,USA,0,0,0,11,11
2010,Malawi,MWI,United States of America,USA,0,0,0,5,5
2010,Mongolia,MNG,United States of America,USA,64,0,5,109,178
2010,Morocco,MAR,United States of America,USA,0,0,0,12,12
2010,Montenegro,MNE,United States of America,USA,0,0,0,5,5
2010,Mauritius,MUS,United States of America,USA,0,0,0,13,13
2010,Myanmar,MMR,United States of America,USA,138,0,12,59,209
2010,Nepal,NPL,United States of America,USA,346,0,69,529,944
2010,Netherlands,NLD,United States of America,USA,0,0,0,5,5
2010,Niger,NER,United States of America,USA,10,0,0,16,26
2010,Nicaragua,NIC,United States of America,USA,17,0,5,31,53
2010,Nigeria,NGA,United States of America,USA,21,0,5,38,64
2010,Pakistan,PAK,United States of America,USA,119,0,12,195,326
2010,Paraguay,PRY,United States of America,USA,5,0,0,0,5
2010,Peru,PER,United States of America,USA,22,0,0,35,57
2010,Philippines,PHL,United States of America,USA,5,0,0,31,36
2010,Poland,POL,United States of America,USA,0,0,0,5,5
2010,Romania,ROU,United States of America,USA,0,0,0,58,58
2010,South Africa,ZAF,United States of America,USA,0,0,0,10,10
2010,Russian Federation,RUS,United States of America,USA,288,0,12,449,749
2010,Rwanda,RWA,United States of America,USA,78,0,5,26,109
2010,El Salvador,SLV,United States of America,USA,131,0,123,893,1147
2010,Saudi Arabia,SAU,United States of America,USA,10,0,0,0,10
2010,Serbia and Kosovo: S/RES/1244 (1999),SRB,United States of America,USA,35,0,0,87,122
2010,Senegal,SEN,United States of America,USA,10,0,0,140,150
2010,Sierra Leone,SLE,United States of America,USA,27,0,0,35,62
2010,Somalia,SOM,United States of America,USA,93,0,5,25,123
2010,Spain,ESP,United States of America,USA,0,0,0,5,5
2010,Viet Nam,VNM,United States of America,USA,20,0,0,13,33
2010,Saint Kitts and Nevis,KNA,United States of America,USA,5,0,0,0,5
2010,Sudan,SDN,United States of America,USA,56,0,5,42,103
2010,Suriname,SUR,United States of America,USA,0,0,0,5,5
2010,Syrian Arab Rep.,SYR,United States of America,USA,15,0,0,20,35
2010,United Rep. of Tanzania,TZA,United States of America,USA,5,0,0,14,19
2010,Thailand,THA,United States of America,USA,0,0,0,10,10
2010,Tajikistan,TJK,United States of America,USA,17,0,5,29,51
2010,Turkmenistan,TKM,United States of America,USA,10,0,0,11,21
2010,Togo,TGO,United States of America,USA,17,0,0,14,31
2010,Trinidad and Tobago,TTO,United States of America,USA,5,0,0,17,22
2010,Tunisia,TUN,United States of America,USA,0,0,0,5,5
2010,Turkey,TUR,United States of America,USA,36,0,0,26,62
2010,Uganda,UGA,United States of America,USA,75,0,0,40,115
2010,Ukraine,UKR,United States of America,USA,55,0,5,131,191
2010,Uruguay,URY,United States of America,USA,0,0,0,10,10
2010,Uzbekistan,UZB,United States of America,USA,59,0,5,84,148
2010,Saint Vincent and the Grenadines,VCT,United States of America,USA,5,0,0,0,5
2010,Venezuela (Bolivarian Republic of),VEN,United States of America,USA,233,0,31,153,417
2010,Yemen,YEM,United States of America,USA,24,0,0,14,38
2010,Zambia,ZMB,United States of America,USA,0,0,0,5,5
2010,Zimbabwe,ZWE,United States of America,USA,50,0,11,58,119
2010,Stateless,XXA,United States of America,USA,36,0,5,46,87
2011,Afghanistan,AFG,United States of America,USA,105,0,0,20,125
2011,Albania,ALB,United States of America,USA,16,0,0,94,110
2011,Algeria,DZA,United States of America,USA,14,0,0,5,19
2011,Angola,AGO,United States of America,USA,10,0,0,0,10
2011,Egypt,EGY,United States of America,USA,576,0,20,238,834
2011,Argentina,ARG,United States of America,USA,5,0,0,22,27
2011,Armenia,ARM,United States of America,USA,31,0,5,55,91
2011,Azerbaijan,AZE,United States of America,USA,15,0,5,27,47
2011,Bahrain,BHR,United States of America,USA,11,0,0,0,11
2011,Burundi,BDI,United States of America,USA,20,0,5,45,70
2011,Benin,BEN,United States of America,USA,5,0,0,19,24
2011,Bangladesh,BGD,United States of America,USA,21,0,0,109,130
2011,Bahamas,BHS,United States of America,USA,0,0,0,5,5
2011,Bhutan,BTN,United States of America,USA,5,0,0,5,10
2011,Burkina Faso,BFA,United States of America,USA,46,0,17,99,162
2011,Belarus,BLR,United States of America,USA,117,0,5,177,299
2011,Bolivia (Plurinational State of),BOL,United States of America,USA,12,0,0,29,41
2011,Brazil,BRA,United States of America,USA,41,0,0,137,178
2011,Bosnia and Herzegovina,BIH,United States of America,USA,0,0,0,12,12
2011,Bulgaria,BGR,United States of America,USA,16,0,0,15,31
2011,Belize,BLZ,United States of America,USA,0,0,0,12,12
2011,Cambodia,KHM,United States of America,USA,5,0,0,5,10
2011,Canada,CAN,United States of America,USA,0,0,0,5,5
2011,Central African Rep.,CAF,United States of America,USA,5,0,0,15,20
2011,Chad,TCD,United States of America,USA,13,0,0,0,13
2011,China,CHN,United States of America,USA,3614,0,277,8235,12126
2011,Chile,CHL,United States of America,USA,0,0,0,11,11
2011,Cameroon,CMR,United States of America,USA,228,0,31,178,437
2011,Congo,COG,United States of America,USA,76,0,10,66,152
2011,Dem. Rep. of the Congo,COD,United States of America,USA,62,0,0,33,95
2011,Colombia,COL,United States of America,USA,184,0,10,185,379
2011,Costa Rica,CRI,United States of America,USA,0,0,0,10,10
2011,Cuba,CUB,United States of America,USA,16,0,0,23,39
2011,Czechia,CZE,United States of America,USA,0,0,0,5,5
2011,Djibouti,DJI,United States of America,USA,21,0,0,20,41
2011,Dominica,DMA,United States of America,USA,0,0,0,5,5
2011,Dominican Rep.,DOM,United States of America,USA,0,0,0,17,17
2011,Ecuador,ECU,United States of America,USA,10,0,0,408,418
2011,Eritrea,ERI,United States of America,USA,159,0,5,33,197
2011,Estonia,EST,United States of America,USA,0,0,0,5,5
2011,Ethiopia,ETH,United States of America,USA,516,0,66,268,850
2011,Fiji,FJI,United States of America,USA,11,0,0,0,11
2011,France,FRA,United States of America,USA,0,0,0,5,5
2011,Gabon,GAB,United States of America,USA,0,0,0,5,5
2011,Gambia,GMB,United States of America,USA,71,0,5,178,254
2011,United Kingdom of Great Britain and Northern Ireland,GBR,United States of America,USA,0,0,0,5,5
2011,Georgia,GEO,United States of America,USA,10,0,0,23,33
2011,Germany,DEU,United States of America,USA,0,0,0,10,10
2011,Ghana,GHA,United States of America,USA,5,0,0,35,40
2011,Guinea-Bissau,GNB,United States of America,USA,0,0,0,5,5
2011,Grenada,GRD,United States of America,USA,0,0,0,16,16
2011,Guatemala,GTM,United States of America,USA,315,0,42,1236,1593
2011,Guinea,GIN,United States of America,USA,74,0,5,170,249
2011,Guyana,GUY,United States of America,USA,0,0,0,5,5
2011,Haiti,HTI,United States of America,USA,541,0,59,268,868
2011,Honduras,HND,United States of America,USA,66,0,19,265,350
2011,Croatia,HRV,United States of America,USA,0,0,0,5,5
2011,Hungary,HUN,United States of America,USA,0,0,0,18,18
2011,Cote d'Ivoire,CIV,United States of America,USA,129,0,28,202,359
2011,India,IND,United States of America,USA,81,0,5,402,488
2011,Indonesia,IDN,United States of America,USA,71,0,5,206,282
2011,Iran (Islamic Rep. of),IRN,United States of America,USA,336,0,15,65,416
2011,Iraq,IRQ,United States of America,USA,230,0,27,60,317
2011,Israel,ISR,United States of America,USA,5,0,0,11,16
2011,Italy,ITA,United States of America,USA,0,0,0,5,5
2011,Jamaica,JAM,United States of America,USA,43,0,0,62,105
2011,Jordan,JOR,United States of America,USA,14,0,0,14,28
2011,Kazakhstan,KAZ,United States of America,USA,47,0,5,60,112
2011,Kenya,KEN,United States of America,USA,91,0,23,140,254
2011,Kyrgyzstan,KGZ,United States of America,USA,107,0,29,155,291
2011,Rep. of Korea,KOR,United States of America,USA,0,0,0,5,5
2011,Dem. People's Rep. of Korea,PRK,United States of America,USA,0,0,0,5,5
2011,Kuwait,KWT,United States of America,USA,5,0,0,5,10
2011,Lao People's Dem. Rep.,LAO,United States of America,USA,5,0,0,5,10
2011,Liberia,LBR,United States of America,USA,52,0,0,32,84
2011,Libya,LBY,United States of America,USA,52,0,30,50,132
2011,Lebanon,LBN,United States of America,USA,13,0,0,20,33
2011,Sri Lanka,LKA,United States of America,USA,32,0,0,101,133
2011,Lithuania,LTU,United States of America,USA,0,0,0,11,11
2011,Latvia,LVA,United States of America,USA,0,0,0,10,10
2011,Madagascar,MDG,United States of America,USA,0,0,0,5,5
2011,Mauritania,MRT,United States of America,USA,27,0,5,92,124
2011,North Macedonia,MKD,United States of America,USA,5,0,0,17,22
2011,Rep. of Moldova,MDA,United States of America,USA,101,0,0,147,248
2011,Mexico,MEX,United States of America,USA,231,0,5,3904,4140
2011,Mali,MLI,United States of America,USA,52,0,17,209,278
2011,Malaysia,MYS,United States of America,USA,5,0,0,23,28
2011,Mongolia,MNG,United States of America,USA,71,0,5,104,180
2011,Morocco,MAR,United States of America,USA,12,0,0,5,17
2011,Montenegro,MNE,United States of America,USA,0,0,0,5,5
2011,Mauritius,MUS,United States of America,USA,0,0,0,13,13
2011,Myanmar,MMR,United States of America,USA,139,0,13,61,213
2011,Namibia,NAM,United States of America,USA,25,0,13,58,96
2011,Nepal,NPL,United States of America,USA,351,0,98,491,940
2011,Niger,NER,United States of America,USA,5,0,5,31,41
2011,Nicaragua,NIC,United States of America,USA,17,0,0,39,56
2011,Nigeria,NGA,United States of America,USA,30,0,5,54,89
2011,Pakistan,PAK,United States of America,USA,170,0,5,195,370
2011,Panama,PAN,United States of America,USA,5,0,0,0,5
2011,Peru,PER,United States of America,USA,27,0,0,85,112
2011,Philippines,PHL,United States of America,USA,0,0,0,133,133
2011,Poland,POL,United States of America,USA,0,0,0,5,5
2011,Romania,ROU,United States of America,USA,10,0,0,17,27
2011,South Africa,ZAF,United States of America,USA,0,0,0,5,5
2011,Russian Federation,RUS,United States of America,USA,337,0,23,371,731
2011,Rwanda,RWA,United States of America,USA,67,0,10,58,135
2011,El Salvador,SLV,United States of America,USA,113,0,108,863,1084
2011,Saudi Arabia,SAU,United States of America,USA,12,0,0,0,12
2011,Serbia and Kosovo: S/RES/1244 (1999),SRB,United States of America,USA,21,0,0,64,85
2011,Senegal,SEN,United States of America,USA,11,0,0,137,148
2011,Sierra Leone,SLE,United States of America,USA,17,0,0,22,39
2011,Somalia,SOM,United States of America,USA,51,0,0,22,73
2011,Spain,ESP,United States of America,USA,0,0,0,5,5
2011,Viet Nam,VNM,United States of America,USA,18,0,0,5,23
2011,Sudan,SDN,United States of America,USA,92,0,12,42,146
2011,Suriname,SUR,United States of America,USA,0,0,0,5,5
2011,Slovakia,SVK,United States of America,USA,0,0,0,5,5
2011,Syrian Arab Rep.,SYR,United States of America,USA,61,0,10,52,123
2011,United Rep. of Tanzania,TZA,United States of America,USA,10,0,0,14,24
2011,Thailand,THA,United States of America,USA,0,0,0,5,5
2011,Tajikistan,TJK,United States of America,USA,25,0,0,37,62
2011,Turkmenistan,TKM,United States of America,USA,12,0,0,10,22
2011,Togo,TGO,United States of America,USA,19,0,0,32,51
2011,Trinidad and Tobago,TTO,United States of America,USA,5,0,0,32,37
2011,Tunisia,TUN,United States of America,USA,5,0,0,5,10
2011,Turkey,TUR,United States of America,USA,26,0,5,28,59
2011,United Arab Emirates,ARE,United States of America,USA,5,0,0,0,5
2011,Uganda,UGA,United States of America,USA,103,0,0,61,164
2011,Ukraine,UKR,United States of America,USA,99,0,5,137,241
2011,Uzbekistan,UZB,United States of America,USA,78,0,5,110,193
2011,Venezuela (Bolivarian Republic of),VEN,United States of America,USA,437,0,33,198,668
2011,Yemen,YEM,United States of America,USA,25,0,0,43,68
2011,Zambia,ZMB,United States of America,USA,5,0,0,0,5
2011,Zimbabwe,ZWE,United States of America,USA,59,0,11,40,110
2012,Afghanistan,AFG,United States of America,USA,118,0,5,24,147
2012,Albania,ALB,United States of America,USA,16,0,5,90,111
2012,Algeria,DZA,United States of America,USA,14,0,0,5,19
2012,Angola,AGO,United States of America,USA,13,0,0,5,18
2012,Antigua and Barbuda,ATG,United States of America,USA,0,0,0,5,5
2012,Egypt,EGY,United States of America,USA,1475,0,30,247,1752
2012,Argentina,ARG,United States of America,USA,0,0,0,28,28
2012,Armenia,ARM,United States of America,USA,41,0,0,39,80
2012,Azerbaijan,AZE,United States of America,USA,15,0,0,12,27
2012,Bahrain,BHR,United States of America,USA,17,0,0,0,17
2012,Burundi,BDI,United States of America,USA,19,0,5,32,56
2012,Benin,BEN,United States of America,USA,5,0,0,10,15
2012,Bangladesh,BGD,United States of America,USA,23,0,0,107,130
2012,Bahamas,BHS,United States of America,USA,5,0,0,5,10
2012,Bhutan,BTN,United States of America,USA,0,0,0,10,10
2012,Burkina Faso,BFA,United States of America,USA,54,0,14,126,194
2012,Belarus,BLR,United States of America,USA,168,0,10,135,313
2012,Bolivia (Plurinational State of),BOL,United States of America,USA,13,0,0,30,43
2012,Brazil,BRA,United States of America,USA,37,0,0,160,197
2012,Bosnia and Herzegovina,BIH,United States of America,USA,5,0,0,0,5
2012,Bulgaria,BGR,United States of America,USA,16,0,0,14,30
2012,Belize,BLZ,United States of America,USA,0,0,0,10,10
2012,Cambodia,KHM,United States of America,USA,5,0,0,0,5
2012,Canada,CAN,United States of America,USA,0,0,0,5,5
2012,Central African Rep.,CAF,United States of America,USA,10,0,0,11,21
2012,Chad,TCD,United States of America,USA,5,0,0,12,17
2012,China,CHN,United States of America,USA,4523,0,302,7811,12636
2012,Chile,CHL,United States of America,USA,5,0,0,13,18
2012,Cameroon,CMR,United States of America,USA,244,0,42,190,476
2012,Congo,COG,United States of America,USA,81,0,21,57,159
2012,Dem. Rep. of the Congo,COD,United States of America,USA,73,0,5,30,108
2012,Colombia,COL,United States of America,USA,183,0,5,173,361
2012,Costa Rica,CRI,United States of America,USA,0,0,0,10,10
2012,Cuba,CUB,United States of America,USA,26,0,5,24,55
2012,Djibouti,DJI,United States of America,USA,10,0,0,11,21
2012,Dominica,DMA,United States of America,USA,0,0,0,10,10
2012,Dominican Rep.,DOM,United States of America,USA,5,0,0,58,63
2012,Ecuador,ECU,United States of America,USA,15,0,0,681,696
2012,Eritrea,ERI,United States of America,USA,115,0,5,11,131
2012,Estonia,EST,United States of America,USA,225,0,23,112,360
2012,Ethiopia,ETH,United States of America,USA,420,0,37,171,628
2012,Fiji,FJI,United States of America,USA,15,0,0,5,20
2012,France,FRA,United States of America,USA,0,0,0,10,10
2012,Gabon,GAB,United States of America,USA,0,0,0,12,12
2012,Gambia,GMB,United States of America,USA,118,0,10,161,289
2012,United Kingdom of Great Britain and Northern Ireland,GBR,United States of America,USA,0,0,0,10,10
2012,Georgia,GEO,United States of America,USA,13,0,0,14,27
2012,Germany,DEU,United States of America,USA,0,0,0,11,11
2012,Ghana,GHA,United States of America,USA,10,0,0,22,32
2012,Grenada,GRD,United States of America,USA,0,0,0,15,15
2012,Guatemala,GTM,United States of America,USA,286,0,10,1118,1414
2012,Guinea,GIN,United States of America,USA,41,0,5,112,158
2012,Guyana,GUY,United States of America,USA,5,0,0,20,25
2012,Haiti,HTI,United States of America,USA,546,0,52,259,857
2012,"China, Hong Kong SAR",HKG,United States of America,USA,0,0,0,5,5
2012,Honduras,HND,United States of America,USA,95,0,5,300,400
2012,Croatia,HRV,United States of America,USA,5,0,0,0,5
2012,Hungary,HUN,United States of America,USA,0,0,0,5,5
2012,Cote d'Ivoire,CIV,United States of America,USA,98,0,12,110,220
2012,India,IND,United States of America,USA,84,0,10,448,542
2012,Indonesia,IDN,United States of America,USA,62,0,5,116,183
2012,Iran (Islamic Rep. of),IRN,United States of America,USA,478,0,11,74,563
2012,Iraq,IRQ,United States of America,USA,258,0,28,64,350
2012,Israel,ISR,United States of America,USA,5,0,0,22,27
2012,Italy,ITA,United States of America,USA,5,0,0,0,5
2012,Jamaica,JAM,United States of America,USA,49,0,0,48,97
2012,Jordan,JOR,United States of America,USA,25,0,0,19,44
2012,Japan,JPN,United States of America,USA,0,0,0,11,11
2012,Kazakhstan,KAZ,United States of America,USA,64,0,5,81,150
2012,Kenya,KEN,United States of America,USA,120,0,16,103,239
2012,Kyrgyzstan,KGZ,United States of America,USA,118,0,5,125,248
2012,Rep. of Korea,KOR,United States of America,USA,0,0,0,13,13
2012,Kuwait,KWT,United States of America,USA,5,0,0,0,5
2012,Lao People's Dem. Rep.,LAO,United States of America,USA,5,0,0,0,5
2012,Liberia,LBR,United States of America,USA,49,0,5,47,101
2012,Libya,LBY,United States of America,USA,20,0,19,15,54
2012,Lebanon,LBN,United States of America,USA,16,0,0,18,34
2012,Sri Lanka,LKA,United States of America,USA,35,0,5,64,104
2012,Latvia,LVA,United States of America,USA,0,0,0,10,10
2012,Madagascar,MDG,United States of America,USA,0,0,0,5,5
2012,Mauritania,MRT,United States of America,USA,37,0,0,27,64
2012,North Macedonia,MKD,United States of America,USA,5,0,0,16,21
2012,Rep. of Moldova,MDA,United States of America,USA,121,0,5,137,263
2012,Mexico,MEX,United States of America,USA,413,0,5,5138,5556
2012,Mali,MLI,United States of America,USA,69,0,12,124,205
2012,Malaysia,MYS,United States of America,USA,10,0,0,17,27
2012,Malawi,MWI,United States of America,USA,5,0,0,0,5
2012,Mongolia,MNG,United States of America,USA,46,0,5,61,112
2012,Morocco,MAR,United States of America,USA,11,0,0,5,16
2012,Montenegro,MNE,United States of America,USA,5,0,0,0,5
2012,Mauritius,MUS,United States of America,USA,0,0,0,10,10
2012,Myanmar,MMR,United States of America,USA,73,0,5,50,128
2012,Nepal,NPL,United States of America,USA,534,0,133,491,1158
2012,Netherlands,NLD,United States of America,USA,0,0,0,5,5
2012,Niger,NER,United States of America,USA,0,0,0,23,23
2012,Nicaragua,NIC,United States of America,USA,24,0,0,37,61
2012,Nigeria,NGA,United States of America,USA,60,0,5,77,142
2012,Pakistan,PAK,United States of America,USA,149,0,5,151,305
2012,Panama,PAN,United States of America,USA,0,0,0,5,5
2012,Peru,PER,United States of America,USA,24,0,0,104,128
2012,Philippines,PHL,United States of America,USA,5,0,0,118,123
2012,Poland,POL,United States of America,USA,0,0,0,12,12
2012,Romania,ROU,United States of America,USA,5,0,0,14,19
2012,South Africa,ZAF,United States of America,USA,12,0,0,5,17
2012,Russian Federation,RUS,United States of America,USA,357,0,16,274,647
2012,Rwanda,RWA,United States of America,USA,74,0,5,49,128
2012,El Salvador,SLV,United States of America,USA,144,0,67,795,1006
2012,Saudi Arabia,SAU,United States of America,USA,33,0,5,5,43
2012,Serbia and Kosovo: S/RES/1244 (1999),SRB,United States of America,USA,46,0,0,83,129
2012,Senegal,SEN,United States of America,USA,19,0,0,98,117
2012,Sierra Leone,SLE,United States of America,USA,13,0,0,25,38
2012,Somalia,SOM,United States of America,USA,48,0,0,10,58
2012,Viet Nam,VNM,United States of America,USA,14,0,0,0,14
2012,Saint Kitts and Nevis,KNA,United States of America,USA,0,0,0,5,5
2012,Sudan,SDN,United States of America,USA,99,0,10,32,141
2012,Slovakia,SVK,United States of America,USA,5,0,0,0,5
2012,Syrian Arab Rep.,SYR,United States of America,USA,316,0,21,89,426
2012,United Rep. of Tanzania,TZA,United States of America,USA,12,0,0,5,17
2012,Thailand,THA,United States of America,USA,5,0,0,5,10
2012,Tajikistan,TJK,United States of America,USA,21,0,0,29,50
2012,Turkmenistan,TKM,United States of America,USA,5,0,0,13,18
2012,Togo,TGO,United States of America,USA,27,0,5,26,58
2012,Trinidad and Tobago,TTO,United States of America,USA,5,0,0,25,30
2012,Tunisia,TUN,United States of America,USA,5,0,0,5,10
2012,Turkey,TUR,United States of America,USA,36,0,0,24,60
2012,United Arab Emirates,ARE,United States of America,USA,5,0,0,0,5
2012,Uganda,UGA,United States of America,USA,80,0,11,35,126
2012,Ukraine,UKR,United States of America,USA,106,0,5,135,246
2012,Uruguay,URY,United States of America,USA,0,0,0,5,5
2012,Uzbekistan,UZB,United States of America,USA,65,0,5,57,127
2012,Venezuela (Bolivarian Republic of),VEN,United States of America,USA,492,0,33,153,678
2012,Yemen,YEM,United States of America,USA,31,0,5,29,65
2012,Zimbabwe,ZWE,United States of America,USA,45,0,12,36,93
2013,Afghanistan,AFG,United States of America,USA,97,0,5,30,132
2013,Albania,ALB,United States of America,USA,11,0,0,87,98
2013,Algeria,DZA,United States of America,USA,12,0,0,0,12
2013,Angola,AGO,United States of America,USA,5,0,0,16,21
2013,Egypt,EGY,United States of America,USA,1756,0,18,183,1957
2013,Argentina,ARG,United States of America,USA,0,0,0,13,13
2013,Armenia,ARM,United States of America,USA,62,0,5,41,108
2013,Azerbaijan,AZE,United States of America,USA,14,0,0,15,29
2013,Bahrain,BHR,United States of America,USA,5,0,0,0,5
2013,Barbados,BRB,United States of America,USA,0,0,0,5,5
2013,Burundi,BDI,United States of America,USA,28,0,0,29,57
2013,Benin,BEN,United States of America,USA,0,0,0,23,23
2013,Bangladesh,BGD,United States of America,USA,36,0,5,100,141
2013,Bahamas,BHS,United States of America,USA,5,0,0,0,5
2013,Bhutan,BTN,United States of America,USA,0,0,0,10,10
2013,Burkina Faso,BFA,United States of America,USA,61,0,14,163,238
2013,Belarus,BLR,United States of America,USA,79,0,5,89,173
2013,Bolivia (Plurinational State of),BOL,United States of America,USA,5,0,0,14,19
2013,Brazil,BRA,United States of America,USA,26,0,0,78,104
2013,Bosnia and Herzegovina,BIH,United States of America,USA,0,0,0,5,5
2013,Bulgaria,BGR,United States of America,USA,11,0,0,5,16
2013,Belize,BLZ,United States of America,USA,0,0,0,5,5
2013,Central African Rep.,CAF,United States of America,USA,12,0,0,11,23
2013,Chad,TCD,United States of America,USA,11,0,0,0,11
2013,China,CHN,United States of America,USA,3348,0,227,4717,8292
2013,Chile,CHL,United States of America,USA,5,0,0,5,10
2013,Cameroon,CMR,United States of America,USA,160,0,21,100,281
2013,Congo,COG,United States of America,USA,82,0,5,63,150
2013,Dem. Rep. of the Congo,COD,United States of America,USA,51,0,5,36,92
2013,Costa Rica,CRI,United States of America,USA,120,0,5,130,255
2013,Cuba,CUB,United States of America,USA,0,0,0,14,14
2013,Czechia,CZE,United States of America,USA,0,0,0,5,5
2013,Djibouti,DJI,United States of America,USA,22,0,0,5,27
2013,Dominican Rep.,DOM,United States of America,USA,5,0,0,24,29
2013,Ecuador,ECU,United States of America,USA,10,0,0,719,729
2013,Eritrea,ERI,United States of America,USA,78,0,0,24,102
2013,Ethiopia,ETH,United States of America,USA,402,0,28,237,667
2013,Fiji,FJI,United States of America,USA,11,0,0,0,11
2013,France,FRA,United States of America,USA,0,0,0,5,5
2013,Gambia,GMB,United States of America,USA,53,0,0,48,101
2013,Georgia,GEO,United States of America,USA,14,0,0,11,25
2013,Germany,DEU,United States of America,USA,5,0,0,5,10
2013,Ghana,GHA,United States of America,USA,10,0,0,15,25
2013,Guinea-Bissau,GNB,United States of America,USA,5,0,0,0,5
2013,Greece,GRC,United States of America,USA,0,0,0,5,5
2013,Grenada,GRD,United States of America,USA,0,0,0,10,10
2013,Guatemala,GTM,United States of America,USA,209,0,5,723,937
2013,Guinea,GIN,United States of America,USA,26,0,0,43,69
2013,Guyana,GUY,United States of America,USA,5,0,0,5,10
2013,Haiti,HTI,United States of America,USA,324,0,41,240,605
2013,Honduras,HND,United States of America,USA,73,0,10,247,330
2013,Hungary,HUN,United States of America,USA,0,0,0,10,10
2013,Cote d'Ivoire,CIV,United States of America,USA,50,0,10,64,124
2013,India,IND,United States of America,USA,80,0,5,259,344
2013,Indonesia,IDN,United States of America,USA,41,0,0,64,105
2013,Iran (Islamic Rep. of),IRN,United States of America,USA,498,0,5,59,562
2013,Iraq,IRQ,United States of America,USA,390,0,20,71,481
2013,Israel,ISR,United States of America,USA,5,0,0,11,16
2013,Jamaica,JAM,United States of America,USA,35,0,0,18,53
2013,Jordan,JOR,United States of America,USA,15,0,5,23,43
2013,Kazakhstan,KAZ,United States of America,USA,34,0,5,70,109
2013,Kenya,KEN,United States of America,USA,78,0,0,46,124
2013,Kyrgyzstan,KGZ,United States of America,USA,63,0,5,141,209
2013,Rep. of Korea,KOR,United States of America,USA,0,0,0,10,10
2013,Kuwait,KWT,United States of America,USA,5,0,0,0,5
2013,Lao People's Dem. Rep.,LAO,United States of America,USA,5,0,0,0,5
2013,Liberia,LBR,United States of America,USA,69,0,0,21,90
2013,Libya,LBY,United States of America,USA,14,0,11,10,35
2013,Lebanon,LBN,United States of America,USA,13,0,0,21,34
2013,Sri Lanka,LKA,United States of America,USA,27,0,0,69,96
2013,Lithuania,LTU,United States of America,USA,0,0,0,5,5
2013,Mauritania,MRT,United States of America,USA,31,0,0,34,65
2013,North Macedonia,MKD,United States of America,USA,13,0,0,11,24
2013,Rep. of Moldova,MDA,United States of America,USA,65,0,0,93,158
2013,Mexico,MEX,United States of America,USA,285,0,5,3686,3976
2013,Marshall Islands,MHL,United States of America,USA,0,0,0,5,5
2013,Mali,MLI,United States of America,USA,47,0,18,90,155
2013,Malaysia,MYS,United States of America,USA,10,0,0,12,22
2013,Mongolia,MNG,United States of America,USA,27,0,0,21,48
2013,Morocco,MAR,United States of America,USA,5,0,0,5,10
2013,Montenegro,MNE,United States of America,USA,5,0,0,5,10
2013,Myanmar,MMR,United States of America,USA,54,0,0,28,82
2013,Nepal,NPL,United States of America,USA,366,0,55,353,774
2013,Niger,NER,United States of America,USA,5,0,0,14,19
2013,Nicaragua,NIC,United States of America,USA,5,0,0,16,21
2013,Nigeria,NGA,United States of America,USA,50,0,5,33,88
2013,Pakistan,PAK,United States of America,USA,191,0,5,140,336
2013,Panama,PAN,United States of America,USA,0,0,0,5,5
2013,Peru,PER,United States of America,USA,14,0,0,58,72
2013,Philippines,PHL,United States of America,USA,5,0,0,53,58
2013,Poland,POL,United States of America,USA,0,0,0,14,14
2013,Portugal,PRT,United States of America,USA,0,0,0,5,5
2013,Romania,ROU,United States of America,USA,0,0,0,11,11
2013,South Africa,ZAF,United States of America,USA,0,0,0,10,10
2013,Russian Federation,RUS,United States of America,USA,214,0,10,171,395
2013,Rwanda,RWA,United States of America,USA,40,0,5,64,109
2013,El Salvador,SLV,United States of America,USA,76,0,29,596,701
2013,Saudi Arabia,SAU,United States of America,USA,24,0,0,5,29
2013,Serbia and Kosovo: S/RES/1244 (1999),SRB,United States of America,USA,31,0,5,74,110
2013,Senegal,SEN,United States of America,USA,5,0,0,41,46
2013,Sierra Leone,SLE,United States of America,USA,14,0,0,5,19
2013,Somalia,SOM,United States of America,USA,44,0,0,10,54
2013,Viet Nam,VNM,United States of America,USA,11,0,0,0,11
2013,Sudan,SDN,United States of America,USA,66,0,5,31,102
2013,Syrian Arab Rep.,SYR,United States of America,USA,576,0,55,137,768
2013,United Rep. of Tanzania,TZA,United States of America,USA,14,0,0,0,14
2013,Tajikistan,TJK,United States of America,USA,13,0,0,40,53
2013,Turkmenistan,TKM,United States of America,USA,5,0,0,13,18
2013,Togo,TGO,United States of America,USA,33,0,0,14,47
2013,Trinidad and Tobago,TTO,United States of America,USA,0,0,0,13,13
2013,Tunisia,TUN,United States of America,USA,5,0,0,5,10
2013,Turkey,TUR,United States of America,USA,14,0,0,15,29
2013,Uganda,UGA,United States of America,USA,55,0,0,24,79
2013,Ukraine,UKR,United States of America,USA,68,0,5,83,156
2013,Uzbekistan,UZB,United States of America,USA,38,0,5,76,119
2013,Venezuela (Bolivarian Republic of),VEN,United States of America,USA,255,0,18,94,367
2013,Yemen,YEM,United States of America,USA,25,0,5,20,50
2013,Zimbabwe,ZWE,United States of America,USA,31,0,5,19,55
2013,Curacao ,CUW,United States of America,USA,27,0,0,14,41
2014,Afghanistan,AFG,United States of America,USA,154,0,5,29,188
2014,Albania,ALB,United States of America,USA,25,0,5,110,140
2014,Algeria,DZA,United States of America,USA,13,0,0,5,18
2014,Angola,AGO,United States of America,USA,10,0,0,19,29
2014,Egypt,EGY,United States of America,USA,1207,0,36,179,1422
2014,Argentina,ARG,United States of America,USA,5,0,5,12,22
2014,Armenia,ARM,United States of America,USA,69,0,15,56,140
2014,Azerbaijan,AZE,United States of America,USA,19,0,0,14,33
2014,Bahrain,BHR,United States of America,USA,5,0,0,0,5
2014,Burundi,BDI,United States of America,USA,84,0,0,45,129
2014,Benin,BEN,United States of America,USA,5,0,5,5,15
2014,Bangladesh,BGD,United States of America,USA,103,0,55,220,378
2014,Bhutan,BTN,United States of America,USA,5,0,0,5,10
2014,Burkina Faso,BFA,United States of America,USA,66,0,18,167,251
2014,Belarus,BLR,United States of America,USA,55,0,11,39,105
2014,Bolivia (Plurinational State of),BOL,United States of America,USA,5,0,10,19,34
2014,Brazil,BRA,United States of America,USA,28,0,54,52,134
2014,Bosnia and Herzegovina,BIH,United States of America,USA,10,0,5,0,15
2014,Bulgaria,BGR,United States of America,USA,12,0,5,10,27
2014,Belize,BLZ,United States of America,USA,0,0,5,5,10
2014,Cambodia,KHM,United States of America,USA,5,0,0,0,5
2014,Canada,CAN,United States of America,USA,0,0,5,0,5
2014,Central African Rep.,CAF,United States of America,USA,13,0,5,10,28
2014,Chad,TCD,United States of America,USA,12,0,5,5,22
2014,China,CHN,United States of America,USA,2927,0,1136,4103,8166
2014,Chile,CHL,United States of America,USA,0,0,0,5,5
2014,Cameroon,CMR,United States of America,USA,170,0,37,111,318
2014,Congo,COG,United States of America,USA,57,0,18,58,133
2014,Dem. Rep. of the Congo,COD,United States of America,USA,58,0,10,42,110
2014,Colombia,COL,United States of America,USA,138,0,37,111,286
2014,Costa Rica,CRI,United States of America,USA,0,0,13,5,18
2014,Cuba,CUB,United States of America,USA,12,0,5,17,34
2014,Djibouti,DJI,United States of America,USA,23,0,0,10,33
2014,Dominican Rep.,DOM,United States of America,USA,10,0,14,16,40
2014,Ecuador,ECU,United States of America,USA,55,0,538,625,1218
2014,Eritrea,ERI,United States of America,USA,195,0,5,27,227
2014,Ethiopia,ETH,United States of America,USA,530,0,58,341,929
2014,Fiji,FJI,United States of America,USA,14,0,0,5,19
2014,Gabon,GAB,United States of America,USA,0,0,0,5,5
2014,Gambia,GMB,United States of America,USA,71,0,29,31,131
2014,United Kingdom of Great Britain and Northern Ireland,GBR,United States of America,USA,0,0,0,5,5
2014,Georgia,GEO,United States of America,USA,10,0,0,18,28
2014,Germany,DEU,United States of America,USA,5,0,0,5,10
2014,Ghana,GHA,United States of America,USA,13,0,5,10,28
2014,Guinea-Bissau,GNB,United States of America,USA,5,0,0,0,5
2014,Grenada,GRD,United States of America,USA,0,0,0,11,11
2014,Guatemala,GTM,United States of America,USA,619,0,298,1028,1945
2014,Guinea,GIN,United States of America,USA,41,0,26,26,93
2014,Guyana,GUY,United States of America,USA,5,0,5,10,20
2014,Haiti,HTI,United States of America,USA,482,0,43,439,964
2014,Honduras,HND,United States of America,USA,267,0,114,503,884
2014,Hungary,HUN,United States of America,USA,0,0,0,5,5
2014,Cote d'Ivoire,CIV,United States of America,USA,31,0,13,31,75
2014,India,IND,United States of America,USA,132,0,162,247,541
2014,Indonesia,IDN,United States of America,USA,25,0,25,25,75
2014,Iran (Islamic Rep. of),IRN,United States of America,USA,483,0,19,106,608
2014,Iraq,IRQ,United States of America,USA,422,0,10,101,533
2014,Israel,ISR,United States of America,USA,0,0,14,0,14
2014,Italy,ITA,United States of America,USA,0,0,0,5,5
2014,Jamaica,JAM,United States of America,USA,35,0,10,10,55
2014,Jordan,JOR,United States of America,USA,26,0,5,19,50
2014,Japan,JPN,United States of America,USA,0,0,0,5,5
2014,Kazakhstan,KAZ,United States of America,USA,47,0,10,53,110
2014,Kenya,KEN,United States of America,USA,85,0,18,44,147
2014,Kyrgyzstan,KGZ,United States of America,USA,85,0,15,153,253
2014,Rep. of Korea,KOR,United States of America,USA,0,0,0,5,5
2014,Kuwait,KWT,United States of America,USA,14,0,0,0,14
2014,Lao People's Dem. Rep.,LAO,United States of America,USA,5,0,5,0,10
2014,Liberia,LBR,United States of America,USA,76,0,5,22,103
2014,Libya,LBY,United States of America,USA,16,0,5,10,31
2014,Lebanon,LBN,United States of America,USA,15,0,5,19,39
2014,Sri Lanka,LKA,United States of America,USA,19,0,13,51,83
2014,Latvia,LVA,United States of America,USA,0,0,0,5,5
2014,Madagascar,MDG,United States of America,USA,5,0,0,0,5
2014,Mauritania,MRT,United States of America,USA,43,0,5,62,110
2014,North Macedonia,MKD,United States of America,USA,13,0,0,0,13
2014,Rep. of Moldova,MDA,United States of America,USA,52,0,0,79,131
2014,Mexico,MEX,United States of America,USA,564,0,1714,2600,4878
2014,Mali,MLI,United States of America,USA,46,0,23,40,109
2014,Malaysia,MYS,United States of America,USA,10,0,15,5,30
2014,Malawi,MWI,United States of America,USA,0,0,0,5,5
2014,Mongolia,MNG,United States of America,USA,29,0,14,17,60
2014,Morocco,MAR,United States of America,USA,5,0,0,5,10
2014,Myanmar,MMR,United States of America,USA,39,0,5,36,80
2014,Nepal,NPL,United States of America,USA,229,0,125,252,606
2014,Niger,NER,United States of America,USA,14,0,0,0,14
2014,Nicaragua,NIC,United States of America,USA,19,0,5,17,41
2014,Nigeria,NGA,United States of America,USA,62,0,15,41,118
2014,Pakistan,PAK,United States of America,USA,161,0,26,105,292
2014,Paraguay,PRY,United States of America,USA,0,0,0,5,5
2014,Peru,PER,United States of America,USA,11,0,30,51,92
2014,Philippines,PHL,United States of America,USA,0,0,15,10,25
2014,Poland,POL,United States of America,USA,0,0,21,0,21
2014,Romania,ROU,United States of America,USA,10,0,5,18,33
2014,Russian Federation,RUS,United States of America,USA,177,0,32,150,359
2014,Rwanda,RWA,United States of America,USA,59,0,5,25,89
2014,El Salvador,SLV,United States of America,USA,567,0,203,1018,1788
2014,Saudi Arabia,SAU,United States of America,USA,21,0,0,16,37
2014,Serbia and Kosovo: S/RES/1244 (1999),SRB,United States of America,USA,65,0,18,78,161
2014,Senegal,SEN,United States of America,USA,15,0,19,12,46
2014,Sierra Leone,SLE,United States of America,USA,16,0,5,5,26
2014,Somalia,SOM,United States of America,USA,47,0,0,10,57
2014,Viet Nam,VNM,United States of America,USA,14,0,0,5,19
2014,Sudan,SDN,United States of America,USA,76,0,5,34,115
2014,Syrian Arab Rep.,SYR,United States of America,USA,652,0,38,130,820
2014,United Rep. of Tanzania,TZA,United States of America,USA,14,0,0,0,14
2014,Tajikistan,TJK,United States of America,USA,13,0,5,13,31
2014,Turkmenistan,TKM,United States of America,USA,10,0,0,5,15
2014,Togo,TGO,United States of America,USA,31,0,0,5,36
2014,Trinidad and Tobago,TTO,United States of America,USA,0,0,11,5,16
2014,Tunisia,TUN,United States of America,USA,10,0,0,5,15
2014,Turkey,TUR,United States of America,USA,12,0,5,5,22
2014,Uganda,UGA,United States of America,USA,72,0,5,18,95
2014,Ukraine,UKR,United States of America,USA,94,0,44,141,279
2014,Uzbekistan,UZB,United States of America,USA,40,0,11,72,123
2014,Saint Vincent and the Grenadines,VCT,United States of America,USA,0,0,5,0,5
2014,Venezuela (Bolivarian Republic of),VEN,United States of America,USA,226,0,36,125,387
2014,Yemen,YEM,United States of America,USA,35,0,5,16,56
2014,Zambia,ZMB,United States of America,USA,0,0,5,0,5
2014,Zimbabwe,ZWE,United States of America,USA,28,0,5,18,51
2015,Afghanistan,AFG,United States of America,USA,132,0,0,39,171
2015,Albania,ALB,United States of America,USA,29,0,0,55,84
2015,Algeria,DZA,United States of America,USA,5,0,0,5,10
2015,Angola,AGO,United States of America,USA,18,0,0,40,58
2015,Egypt,EGY,United States of America,USA,696,0,10,239,945
2015,Argentina,ARG,United States of America,USA,0,0,0,5,5
2015,Armenia,ARM,United States of America,USA,30,0,5,36,71
2015,Azerbaijan,AZE,United States of America,USA,10,0,0,14,24
2015,Bahrain,BHR,United States of America,USA,5,0,0,5,10
2015,Burundi,BDI,United States of America,USA,70,0,0,55,125
2015,Benin,BEN,United States of America,USA,0,0,0,14,14
2015,Bangladesh,BGD,United States of America,USA,61,0,5,169,235
2015,Bhutan,BTN,United States of America,USA,5,0,0,5,10
2015,Burkina Faso,BFA,United States of America,USA,43,0,5,84,132
2015,Belarus,BLR,United States of America,USA,54,0,0,44,98
2015,Bolivia (Plurinational State of),BOL,United States of America,USA,0,0,0,22,22
2015,Brazil,BRA,United States of America,USA,17,0,0,130,147
2015,Bosnia and Herzegovina,BIH,United States of America,USA,0,0,0,12,12
2015,Bulgaria,BGR,United States of America,USA,11,0,0,11,22
2015,Belize,BLZ,United States of America,USA,0,0,0,5,5
2015,Cambodia,KHM,United States of America,USA,0,0,0,5,5
2015,Central African Rep.,CAF,United States of America,USA,22,0,0,5,27
2015,Chad,TCD,United States of America,USA,12,0,0,5,17
2015,China,CHN,United States of America,USA,1916,0,80,3448,5444
2015,Chile,CHL,United States of America,USA,0,0,0,10,10
2015,Cameroon,CMR,United States of America,USA,120,0,10,76,206
2015,Congo,COG,United States of America,USA,80,0,10,68,158
2015,Dem. Rep. of the Congo,COD,United States of America,USA,82,0,0,56,138
2015,Colombia,COL,United States of America,USA,116,0,5,123,244
2015,Costa Rica,CRI,United States of America,USA,0,0,0,16,16
2015,Cuba,CUB,United States of America,USA,5,0,0,23,28
2015,Djibouti,DJI,United States of America,USA,39,0,0,19,58
2015,Dominica,DMA,United States of America,USA,0,0,0,5,5
2015,Dominican Rep.,DOM,United States of America,USA,5,0,0,20,25
2015,Ecuador,ECU,United States of America,USA,158,0,0,966,1124
2015,Eritrea,ERI,United States of America,USA,225,0,0,34,259
2015,Ethiopia,ETH,United States of America,USA,541,0,12,206,759
2015,Fiji,FJI,United States of America,USA,13,0,0,5,18
2015,Gabon,GAB,United States of America,USA,5,0,0,0,5
2015,Gambia,GMB,United States of America,USA,83,0,0,64,147
2015,United Kingdom of Great Britain and Northern Ireland,GBR,United States of America,USA,0,0,0,5,5
2015,Georgia,GEO,United States of America,USA,16,0,0,18,34
2015,Germany,DEU,United States of America,USA,0,0,0,10,10
2015,Ghana,GHA,United States of America,USA,12,0,0,10,22
2015,Greece,GRC,United States of America,USA,0,0,0,5,5
2015,Grenada,GRD,United States of America,USA,0,0,0,5,5
2015,Guatemala,GTM,United States of America,USA,1937,0,10,3500,5447
2015,Guinea,GIN,United States of America,USA,74,0,0,47,121
2015,Guyana,GUY,United States of America,USA,0,0,0,13,13
2015,Haiti,HTI,United States of America,USA,276,0,5,342,623
2015,Honduras,HND,United States of America,USA,1304,0,5,2482,3791
2015,Hungary,HUN,United States of America,USA,0,0,0,10,10
2015,Cote d'Ivoire,CIV,United States of America,USA,39,0,5,48,92
2015,India,IND,United States of America,USA,159,0,0,442,601
2015,Indonesia,IDN,United States of America,USA,20,0,0,71,91
2015,Iran (Islamic Rep. of),IRN,United States of America,USA,433,0,5,140,578
2015,Iraq,IRQ,United States of America,USA,484,0,10,174,668
2015,Israel,ISR,United States of America,USA,5,0,0,14,19
2015,Italy,ITA,United States of America,USA,0,0,0,5,5
2015,Jamaica,JAM,United States of America,USA,45,0,0,20,65
2015,Jordan,JOR,United States of America,USA,35,0,0,32,67
2015,Japan,JPN,United States of America,USA,0,0,0,5,5
2015,Kazakhstan,KAZ,United States of America,USA,34,0,0,79,113
2015,Kenya,KEN,United States of America,USA,79,0,5,71,155
2015,Kyrgyzstan,KGZ,United States of America,USA,96,0,0,172,268
2015,Rep. of Korea,KOR,United States of America,USA,0,0,0,5,5
2015,Kuwait,KWT,United States of America,USA,11,0,0,0,11
2015,Lao People's Dem. Rep.,LAO,United States of America,USA,5,0,0,5,10
2015,Liberia,LBR,United States of America,USA,91,0,0,19,110
2015,Libya,LBY,United States of America,USA,22,0,5,15,42
2015,Lebanon,LBN,United States of America,USA,13,0,0,24,37
2015,Sri Lanka,LKA,United States of America,USA,25,0,0,94,119
2015,Lithuania,LTU,United States of America,USA,0,0,0,5,5
2015,Latvia,LVA,United States of America,USA,0,0,0,5,5
2015,Mauritania,MRT,United States of America,USA,61,0,0,53,114
2015,North Macedonia,MKD,United States of America,USA,0,0,0,10,10
2015,Rep. of Moldova,MDA,United States of America,USA,59,0,0,133,192
2015,Mexico,MEX,United States of America,USA,611,0,0,2717,3328
2015,Mali,MLI,United States of America,USA,59,0,0,75,134
2015,Malaysia,MYS,United States of America,USA,0,0,0,20,20
2015,Mongolia,MNG,United States of America,USA,24,0,0,33,57
2015,Morocco,MAR,United States of America,USA,5,0,0,5,10
2015,Montenegro,MNE,United States of America,USA,5,0,0,13,18
2015,Mauritius,MUS,United States of America,USA,5,0,0,0,5
2015,Myanmar,MMR,United States of America,USA,38,0,5,16,59
2015,Nepal,NPL,United States of America,USA,350,0,29,614,993
2015,Niger,NER,United States of America,USA,0,0,0,14,14
2015,Nicaragua,NIC,United States of America,USA,35,0,0,49,84
2015,Nigeria,NGA,United States of America,USA,71,0,0,68,139
2015,Pakistan,PAK,United States of America,USA,195,0,5,199,399
2015,Peru,PER,United States of America,USA,19,0,0,76,95
2015,Philippines,PHL,United States of America,USA,5,0,0,38,43
2015,Poland,POL,United States of America,USA,0,0,0,30,30
2015,Romania,ROU,United States of America,USA,5,0,0,32,37
2015,South Africa,ZAF,United States of America,USA,5,0,0,0,5
2015,Russian Federation,RUS,United States of America,USA,228,0,0,247,475
2015,Rwanda,RWA,United States of America,USA,68,0,0,53,121
2015,El Salvador,SLV,United States of America,USA,2070,0,22,3842,5934
2015,Saudi Arabia,SAU,United States of America,USA,32,0,0,5,37
2015,Serbia and Kosovo: S/RES/1244 (1999),SRB,United States of America,USA,32,0,0,60,92
2015,Senegal,SEN,United States of America,USA,16,0,0,33,49
2015,Sierra Leone,SLE,United States of America,USA,35,0,0,11,46
2015,Somalia,SOM,United States of America,USA,39,0,0,11,50
2015,Viet Nam,VNM,United States of America,USA,10,0,0,10,20
2015,Sudan,SDN,United States of America,USA,86,0,0,24,110
2015,Suriname,SUR,United States of America,USA,0,0,0,5,5
2015,Slovakia,SVK,United States of America,USA,0,0,0,5,5
2015,Syrian Arab Rep.,SYR,United States of America,USA,581,0,27,169,777
2015,United Rep. of Tanzania,TZA,United States of America,USA,5,0,0,14,19
2015,Thailand,THA,United States of America,USA,0,0,0,5,5
2015,Tajikistan,TJK,United States of America,USA,20,0,0,34,54
2015,Turkmenistan,TKM,United States of America,USA,10,0,0,5,15
2015,Togo,TGO,United States of America,USA,22,0,0,16,38
2015,Trinidad and Tobago,TTO,United States of America,USA,5,0,0,13,18
2015,Tunisia,TUN,United States of America,USA,0,0,0,11,11
2015,Turkey,TUR,United States of America,USA,13,0,0,28,41
2015,United Arab Emirates,ARE,United States of America,USA,5,0,0,0,5
2015,Uganda,UGA,United States of America,USA,117,0,0,52,169
2015,Ukraine,UKR,United States of America,USA,111,0,5,217,333
2015,Uruguay,URY,United States of America,USA,0,0,0,5,5
2015,Uzbekistan,UZB,United States of America,USA,58,0,0,95,153
2015,Venezuela (Bolivarian Republic of),VEN,United States of America,USA,244,0,5,98,347
2015,Yemen,YEM,United States of America,USA,39,0,0,20,59
2015,Zambia,ZMB,United States of America,USA,0,0,0,5,5
2015,Zimbabwe,ZWE,United States of America,USA,29,0,0,22,51
2016,Afghanistan,AFG,United States of America,USA,92,0,0,38,130
2016,Albania,ALB,United States of America,USA,10,0,0,56,66
2016,Algeria,DZA,United States of America,USA,11,0,0,0,11
2016,Angola,AGO,United States of America,USA,11,0,0,23,34
2016,Egypt,EGY,United States of America,USA,419,0,0,164,583
2016,Argentina,ARG,United States of America,USA,0,0,0,5,5
2016,Armenia,ARM,United States of America,USA,13,0,0,22,35
2016,Azerbaijan,AZE,United States of America,USA,11,0,0,5,16
2016,Burundi,BDI,United States of America,USA,50,0,0,32,82
2016,Benin,BEN,United States of America,USA,5,0,0,5,10
2016,Bangladesh,BGD,United States of America,USA,23,0,0,129,152
2016,Bhutan,BTN,United States of America,USA,0,0,0,5,5
2016,Burkina Faso,BFA,United States of America,USA,24,0,0,67,91
2016,Belarus,BLR,United States of America,USA,17,0,0,16,33
2016,Bolivia (Plurinational State of),BOL,United States of America,USA,5,0,0,11,16
2016,Brazil,BRA,United States of America,USA,19,0,0,114,133
2016,Bosnia and Herzegovina,BIH,United States of America,USA,5,0,0,0,5
2016,Bulgaria,BGR,United States of America,USA,5,0,0,5,10
2016,Belize,BLZ,United States of America,USA,0,0,0,11,11
2016,Cambodia,KHM,United States of America,USA,5,0,0,0,5
2016,Central African Rep.,CAF,United States of America,USA,0,0,0,5,5
2016,Chad,TCD,United States of America,USA,14,0,0,0,14
2016,China,CHN,United States of America,USA,1040,0,16,2113,3169
2016,Cameroon,CMR,United States of America,USA,66,0,0,52,118
2016,Congo,COG,United States of America,USA,50,0,0,37,87
2016,Dem. Rep. of the Congo,COD,United States of America,USA,53,0,0,47,100
2016,Colombia,COL,United States of America,USA,67,0,0,102,169
2016,Costa Rica,CRI,United States of America,USA,0,0,0,13,13
2016,Cuba,CUB,United States of America,USA,0,0,0,19,19
2016,Djibouti,DJI,United States of America,USA,18,0,0,5,23
2016,Dominica,DMA,United States of America,USA,0,0,0,5,5
2016,Dominican Rep.,DOM,United States of America,USA,0,0,0,20,20
2016,Ecuador,ECU,United States of America,USA,88,0,0,1038,1126
2016,Eritrea,ERI,United States of America,USA,307,0,0,30,337
2016,Ethiopia,ETH,United States of America,USA,276,0,0,144,420
2016,Fiji,FJI,United States of America,USA,11,0,0,0,11
2016,France,FRA,United States of America,USA,0,0,0,5,5
2016,Gabon,GAB,United States of America,USA,0,0,0,5,5
2016,Gambia,GMB,United States of America,USA,70,0,0,34,104
2016,Georgia,GEO,United States of America,USA,14,0,0,26,40
2016,Ghana,GHA,United States of America,USA,17,0,0,24,41
2016,Greece,GRC,United States of America,USA,0,0,0,5,5
2016,Grenada,GRD,United States of America,USA,0,0,0,5,5
2016,Guatemala,GTM,United States of America,USA,1630,0,5,3363,4998
2016,Guinea,GIN,United States of America,USA,35,0,0,40,75
2016,Guyana,GUY,United States of America,USA,0,0,0,21,21
2016,Haiti,HTI,United States of America,USA,91,0,10,254,355
2016,Honduras,HND,United States of America,USA,993,0,0,2125,3118
2016,Croatia,HRV,United States of America,USA,0,0,0,5,5
2016,Hungary,HUN,United States of America,USA,0,0,0,5,5
2016,Cote d'Ivoire,CIV,United States of America,USA,30,0,0,39,69
2016,India,IND,United States of America,USA,184,0,0,471,655
2016,Indonesia,IDN,United States of America,USA,24,0,0,26,50
2016,Ireland,IRL,United States of America,USA,0,0,0,5,5
2016,Iran (Islamic Rep. of),IRN,United States of America,USA,278,0,5,91,374
2016,Iraq,IRQ,United States of America,USA,462,0,5,171,638
2016,Israel,ISR,United States of America,USA,5,0,0,21,26
2016,Jamaica,JAM,United States of America,USA,22,0,0,18,40
2016,Jordan,JOR,United States of America,USA,32,0,0,23,55
2016,Kazakhstan,KAZ,United States of America,USA,31,0,0,44,75
2016,Kenya,KEN,United States of America,USA,55,0,0,53,108
2016,Kyrgyzstan,KGZ,United States of America,USA,61,0,0,126,187
2016,Rep. of Korea,KOR,United States of America,USA,0,0,0,5,5
2016,Kuwait,KWT,United States of America,USA,5,0,0,11,16
2016,Lao People's Dem. Rep.,LAO,United States of America,USA,5,0,0,5,10
2016,Liberia,LBR,United States of America,USA,54,0,0,19,73
2016,Libya,LBY,United States of America,USA,21,0,0,25,46
2016,Saint Lucia,LCA,United States of America,USA,0,0,0,5,5
2016,Lebanon,LBN,United States of America,USA,19,0,0,30,49
2016,Sri Lanka,LKA,United States of America,USA,19,0,0,75,94
2016,Latvia,LVA,United States of America,USA,0,0,0,5,5
2016,Mauritania,MRT,United States of America,USA,30,0,0,34,64
2016,Rep. of Moldova,MDA,United States of America,USA,54,0,0,76,130
2016,Mexico,MEX,United States of America,USA,487,0,0,3346,3833
2016,Mali,MLI,United States of America,USA,27,0,0,39,66
2016,Malaysia,MYS,United States of America,USA,5,0,0,22,27
2016,Malawi,MWI,United States of America,USA,5,0,0,0,5
2016,Mongolia,MNG,United States of America,USA,22,0,0,28,50
2016,Morocco,MAR,United States of America,USA,5,0,0,0,5
2016,Montenegro,MNE,United States of America,USA,0,0,0,5,5
2016,Myanmar,MMR,United States of America,USA,13,0,0,11,24
2016,Nepal,NPL,United States of America,USA,205,0,15,333,553
2016,Netherlands,NLD,United States of America,USA,5,0,0,0,5
2016,Niger,NER,United States of America,USA,0,0,0,12,12
2016,Nicaragua,NIC,United States of America,USA,26,0,0,43,69
2016,Nigeria,NGA,United States of America,USA,53,0,0,56,109
2016,Pakistan,PAK,United States of America,USA,152,0,0,138,290
2016,Paraguay,PRY,United States of America,USA,0,0,0,10,10
2016,Peru,PER,United States of America,USA,17,0,0,102,119
2016,Philippines,PHL,United States of America,USA,5,0,0,53,58
2016,Poland,POL,United States of America,USA,0,0,0,43,43
2016,Portugal,PRT,United States of America,USA,0,0,0,5,5
2016,Romania,ROU,United States of America,USA,5,0,0,31,36
2016,South Africa,ZAF,United States of America,USA,0,0,0,10,10
2016,Russian Federation,RUS,United States of America,USA,156,0,0,144,300
2016,Rwanda,RWA,United States of America,USA,59,0,0,42,101
2016,El Salvador,SLV,United States of America,USA,1767,0,18,3467,5252
2016,Saudi Arabia,SAU,United States of America,USA,26,0,0,13,39
2016,Serbia and Kosovo: S/RES/1244 (1999),SRB,United States of America,USA,16,0,0,37,53
2016,Senegal,SEN,United States of America,USA,11,0,0,17,28
2016,Singapore,SGP,United States of America,USA,0,0,0,5,5
2016,Sierra Leone,SLE,United States of America,USA,17,0,0,5,22
2016,Somalia,SOM,United States of America,USA,32,0,0,16,48
2016,Viet Nam,VNM,United States of America,USA,13,0,0,5,18
2016,Sudan,SDN,United States of America,USA,55,0,0,17,72
2016,Slovakia,SVK,United States of America,USA,0,0,0,5,5
2016,Syrian Arab Rep.,SYR,United States of America,USA,501,0,15,150,666
2016,United Rep. of Tanzania,TZA,United States of America,USA,5,0,0,5,10
2016,Tajikistan,TJK,United States of America,USA,10,0,0,18,28
2016,Turkmenistan,TKM,United States of America,USA,5,0,0,10,15
2016,Togo,TGO,United States of America,USA,35,0,0,5,40
2016,Trinidad and Tobago,TTO,United States of America,USA,0,0,0,19,19
2016,Turkey,TUR,United States of America,USA,12,0,0,19,31
2016,United Arab Emirates,ARE,United States of America,USA,0,0,0,5,5
2016,Uganda,UGA,United States of America,USA,68,0,0,50,118
2016,Ukraine,UKR,United States of America,USA,93,0,0,207,300
2016,Uzbekistan,UZB,United States of America,USA,32,0,0,84,116
2016,Venezuela (Bolivarian Republic of),VEN,United States of America,USA,176,0,0,151,327
2016,Yemen,YEM,United States of America,USA,45,0,0,34,79
2016,Zambia,ZMB,United States of America,USA,5,0,0,0,5
2016,Zimbabwe,ZWE,United States of America,USA,17,0,0,11,28
2017,Afghanistan,AFG,United States of America,USA,101,0,35,32,168
2017,Albania,ALB,United States of America,USA,13,0,56,64,133
2017,Algeria,DZA,United States of America,USA,13,0,5,0,18
2017,Angola,AGO,United States of America,USA,14,0,50,16,80
2017,Egypt,EGY,United States of America,USA,604,0,130,164,898
2017,Argentina,ARG,United States of America,USA,0,0,0,17,17
2017,Armenia,ARM,United States of America,USA,40,0,33,22,95
2017,Azerbaijan,AZE,United States of America,USA,18,0,28,12,58
2017,Burundi,BDI,United States of America,USA,43,0,45,13,101
2017,Benin,BEN,United States of America,USA,10,0,10,5,25
2017,Bangladesh,BGD,United States of America,USA,71,0,270,124,465
2017,Bhutan,BTN,United States of America,USA,0,0,15,13,28
2017,Burkina Faso,BFA,United States of America,USA,96,0,323,49,468
2017,Belarus,BLR,United States of America,USA,35,0,32,18,85
2017,Bolivia (Plurinational State of),BOL,United States of America,USA,5,0,0,11,16
2017,Brazil,BRA,United States of America,USA,34,0,25,322,381
2017,Bosnia and Herzegovina,BIH,United States of America,USA,0,0,5,5,10
2017,Bulgaria,BGR,United States of America,USA,0,0,14,5,19
2017,Belize,BLZ,United States of America,USA,0,0,5,10,15
2017,Cambodia,KHM,United States of America,USA,5,0,0,0,5
2017,Central African Rep.,CAF,United States of America,USA,10,0,5,0,15
2017,Chad,TCD,United States of America,USA,14,0,16,5,35
2017,China,CHN,United States of America,USA,2780,0,3339,2141,8260
2017,Chile,CHL,United States of America,USA,0,0,0,14,14
2017,Cameroon,CMR,United States of America,USA,135,0,40,35,210
2017,Congo,COG,United States of America,USA,86,0,63,15,164
2017,Dem. Rep. of the Congo,COD,United States of America,USA,89,0,84,22,195
2017,Colombia,COL,United States of America,USA,67,0,66,151,284
2017,Costa Rica,CRI,United States of America,USA,0,0,5,48,53
2017,Cuba,CUB,United States of America,USA,0,0,0,19,19
2017,Djibouti,DJI,United States of America,USA,15,0,10,5,30
2017,Dominican Rep.,DOM,United States of America,USA,5,0,0,46,51
2017,Ecuador,ECU,United States of America,USA,79,0,106,2194,2379
2017,Eritrea,ERI,United States of America,USA,328,0,85,23,436
2017,Estonia,EST,United States of America,USA,0,0,0,5,5
2017,Ethiopia,ETH,United States of America,USA,333,0,150,58,541
2017,Fiji,FJI,United States of America,USA,0,0,5,5,10
2017,France,FRA,United States of America,USA,0,0,0,14,14
2017,Gabon,GAB,United States of America,USA,0,0,12,0,12
2017,Gambia,GMB,United States of America,USA,95,0,63,80,238
2017,Georgia,GEO,United States of America,USA,28,0,61,25,114
2017,Germany,DEU,United States of America,USA,0,0,14,0,14
2017,Ghana,GHA,United States of America,USA,10,0,5,17,32
2017,Greece,GRC,United States of America,USA,0,0,0,5,5
2017,Grenada,GRD,United States of America,USA,0,0,0,5,5
2017,Guatemala,GTM,United States of America,USA,2148,0,3625,2884,8657
2017,Guinea,GIN,United States of America,USA,79,0,62,45,186
2017,Guyana,GUY,United States of America,USA,5,0,0,26,31
2017,Haiti,HTI,United States of America,USA,72,0,67,294,433
2017,Honduras,HND,United States of America,USA,1197,0,2149,1216,4562
2017,Croatia,HRV,United States of America,USA,0,0,0,5,5
2017,Hungary,HUN,United States of America,USA,0,0,0,22,22
2017,Cote d'Ivoire,CIV,United States of America,USA,26,0,40,32,98
2017,India,IND,United States of America,USA,166,0,634,468,1268
2017,Indonesia,IDN,United States of America,USA,35,0,56,99,190
2017,Iran (Islamic Rep. of),IRN,United States of America,USA,238,0,89,117,444
2017,Iraq,IRQ,United States of America,USA,334,0,201,130,665
2017,Israel,ISR,United States of America,USA,13,0,10,19,42
2017,Italy,ITA,United States of America,USA,0,0,0,11,11
2017,Jamaica,JAM,United States of America,USA,48,0,5,25,78
2017,Jordan,JOR,United States of America,USA,42,0,55,48,145
2017,Japan,JPN,United States of America,USA,0,0,5,12,17
2017,Kazakhstan,KAZ,United States of America,USA,57,0,58,30,145
2017,Kenya,KEN,United States of America,USA,89,0,58,38,185
2017,Kyrgyzstan,KGZ,United States of America,USA,110,0,176,77,363
2017,Rep. of Korea,KOR,United States of America,USA,0,0,0,17,17
2017,Kuwait,KWT,United States of America,USA,14,0,0,5,19
2017,Lao People's Dem. Rep.,LAO,United States of America,USA,5,0,11,0,16
2017,Liberia,LBR,United States of America,USA,107,0,38,24,169
2017,Libya,LBY,United States of America,USA,27,0,34,26,87
2017,Saint Lucia,LCA,United States of America,USA,0,0,5,0,5
2017,Lebanon,LBN,United States of America,USA,17,0,30,36,83
2017,Sri Lanka,LKA,United States of America,USA,33,0,80,36,149
2017,Lithuania,LTU,United States of America,USA,0,0,0,10,10
2017,Latvia,LVA,United States of America,USA,0,0,0,5,5
2017,Mauritania,MRT,United States of America,USA,78,0,72,29,179
2017,North Macedonia,MKD,United States of America,USA,0,0,5,12,17
2017,Rep. of Moldova,MDA,United States of America,USA,59,0,75,32,166
2017,Mexico,MEX,United States of America,USA,574,0,363,7686,8623
2017,Mali,MLI,United States of America,USA,28,0,32,43,103
2017,Malaysia,MYS,United States of America,USA,5,0,0,36,41
2017,Malawi,MWI,United States of America,USA,5,0,0,5,10
2017,Mongolia,MNG,United States of America,USA,27,0,23,43,93
2017,Morocco,MAR,United States of America,USA,5,0,0,11,16
2017,Mozambique,MOZ,United States of America,USA,0,0,5,0,5
2017,Montenegro,MNE,United States of America,USA,5,0,0,13,18
2017,Mauritius,MUS,United States of America,USA,0,0,5,0,5
2017,Myanmar,MMR,United States of America,USA,35,0,24,20,79
2017,Nepal,NPL,United States of America,USA,144,0,313,172,629
2017,Niger,NER,United States of America,USA,15,0,5,18,38
2017,Nicaragua,NIC,United States of America,USA,37,0,33,52,122
2017,Nigeria,NGA,United States of America,USA,97,0,91,68,256
2017,Pakistan,PAK,United States of America,USA,211,0,170,116,497
2017,Panama,PAN,United States of America,USA,0,0,0,12,12
2017,Paraguay,PRY,United States of America,USA,0,0,0,11,11
2017,Peru,PER,United States of America,USA,17,0,16,241,274
2017,Philippines,PHL,United States of America,USA,10,0,13,247,270
2017,Poland,POL,United States of America,USA,0,0,0,80,80
2017,Portugal,PRT,United States of America,USA,0,0,0,10,10
2017,Qatar,QAT,United States of America,USA,5,0,0,0,5
2017,Romania,ROU,United States of America,USA,14,0,5,58,77
2017,South Africa,ZAF,United States of America,USA,0,0,5,12,17
2017,Russian Federation,RUS,United States of America,USA,293,0,252,205,750
2017,Rwanda,RWA,United States of America,USA,61,0,43,10,114
2017,El Salvador,SLV,United States of America,USA,2166,0,4183,1900,8249
2017,Saudi Arabia,SAU,United States of America,USA,47,0,10,22,79
2017,Serbia and Kosovo: S/RES/1244 (1999),SRB,United States of America,USA,29,0,75,15,119
2017,Senegal,SEN,United States of America,USA,29,0,11,56,96
2017,Singapore,SGP,United States of America,USA,0,0,5,0,5
2017,Sierra Leone,SLE,United States of America,USA,25,0,18,5,48
2017,Somalia,SOM,United States of America,USA,47,0,5,14,66
2017,Viet Nam,VNM,United States of America,USA,11,0,5,14,30
2017,Sudan,SDN,United States of America,USA,53,0,41,44,138
2017,Slovakia,SVK,United States of America,USA,0,0,0,10,10
2017,Syrian Arab Rep.,SYR,United States of America,USA,466,0,96,113,675
2017,United Rep. of Tanzania,TZA,United States of America,USA,14,0,0,0,14
2017,Thailand,THA,United States of America,USA,5,0,14,5,24
2017,Tajikistan,TJK,United States of America,USA,15,0,12,13,40
2017,Turkmenistan,TKM,United States of America,USA,10,0,5,5,20
2017,Togo,TGO,United States of America,USA,28,0,17,12,57
2017,Trinidad and Tobago,TTO,United States of America,USA,5,0,0,16,21
2017,Tunisia,TUN,United States of America,USA,0,0,5,12,17
2017,Turkey,TUR,United States of America,USA,40,0,18,26,84
2017,United Arab Emirates,ARE,United States of America,USA,5,0,0,0,5
2017,Uganda,UGA,United States of America,USA,97,0,49,27,173
2017,Ukraine,UKR,United States of America,USA,189,0,391,226,806
2017,Uruguay,URY,United States of America,USA,0,0,0,10,10
2017,Uzbekistan,UZB,United States of America,USA,46,0,80,46,172
2017,Venezuela (Bolivarian Republic of),VEN,United States of America,USA,411,0,139,226,776
2017,Yemen,YEM,United States of America,USA,48,0,39,28,115
2017,Zambia,ZMB,United States of America,USA,5,0,0,0,5
2017,Zimbabwe,ZWE,United States of America,USA,51,0,12,20,83
2018,Afghanistan,AFG,United States of America,USA,70,0,26,17,113
2018,Albania,ALB,United States of America,USA,31,0,179,84,294
2018,Algeria,DZA,United States of America,USA,21,0,40,19,80
2018,Angola,AGO,United States of America,USA,18,0,113,20,151
2018,Egypt,EGY,United States of America,USA,980,0,274,137,1391
2018,Argentina,ARG,United States of America,USA,0,0,21,44,65
2018,Armenia,ARM,United States of America,USA,87,0,119,42,248
2018,Australia,AUS,United States of America,USA,0,0,0,5,5
2018,Azerbaijan,AZE,United States of America,USA,63,0,70,22,155
2018,Bahrain,BHR,United States of America,USA,0,0,5,0,5
2018,Burundi,BDI,United States of America,USA,37,0,46,16,99
2018,Belgium,BEL,United States of America,USA,0,0,5,5,10
2018,Benin,BEN,United States of America,USA,0,0,13,5,18
2018,Bangladesh,BGD,United States of America,USA,80,0,341,198,619
2018,Bahamas,BHS,United States of America,USA,5,0,0,5,10
2018,Bhutan,BTN,United States of America,USA,0,0,30,18,48
2018,Burkina Faso,BFA,United States of America,USA,69,0,328,71,468
2018,Belarus,BLR,United States of America,USA,131,0,221,48,400
2018,Bolivia (Plurinational State of),BOL,United States of America,USA,5,0,15,18,38
2018,Brazil,BRA,United States of America,USA,108,0,181,503,792
2018,Bosnia and Herzegovina,BIH,United States of America,USA,11,0,11,5,27
2018,Bulgaria,BGR,United States of America,USA,5,0,14,14,33
2018,Belize,BLZ,United States of America,USA,0,0,0,13,13
2018,Cambodia,KHM,United States of America,USA,19,0,5,0,24
2018,Canada,CAN,United States of America,USA,0,0,5,5,10
2018,Central African Rep.,CAF,United States of America,USA,15,0,5,0,20
2018,Chad,TCD,United States of America,USA,23,0,20,5,48
2018,China,CHN,United States of America,USA,3041,0,4125,2267,9433
2018,Chile,CHL,United States of America,USA,0,0,10,16,26
2018,Cameroon,CMR,United States of America,USA,260,0,198,72,530
2018,Dem. Rep. of the Congo,COD,United States of America,USA,196,0,229,72,497
2018,Colombia,COL,United States of America,USA,192,0,732,296,1220
2018,Costa Rica,CRI,United States of America,USA,0,0,16,79,95
2018,Cuba,CUB,United States of America,USA,5,0,5,29,39
2018,Czechia,CZE,United States of America,USA,0,0,5,0,5
2018,Djibouti,DJI,United States of America,USA,13,0,5,5,23
2018,Dominica,DMA,United States of America,USA,0,0,0,10,10
2018,Dominican Rep.,DOM,United States of America,USA,12,0,19,64,95
2018,Ecuador,ECU,United States of America,USA,43,0,478,1478,1999
2018,Equatorial Guinea,GNQ,United States of America,USA,0,0,5,0,5
2018,Eritrea,ERI,United States of America,USA,300,0,76,23,399
2018,Estonia,EST,United States of America,USA,0,0,0,5,5
2018,Ethiopia,ETH,United States of America,USA,346,0,212,69,627
2018,Fiji,FJI,United States of America,USA,0,0,24,28,52
2018,France,FRA,United States of America,USA,0,0,0,5,5
2018,Gabon,GAB,United States of America,USA,10,0,15,5,30
2018,Gambia,GMB,United States of America,USA,59,0,36,41,136
2018,United Kingdom of Great Britain and Northern Ireland,GBR,United States of America,USA,0,0,0,10,10
2018,Georgia,GEO,United States of America,USA,39,0,126,66,231
2018,Germany,DEU,United States of America,USA,0,0,5,12,17
2018,Ghana,GHA,United States of America,USA,12,0,18,30,60
2018,Guinea-Bissau,GNB,United States of America,USA,0,0,5,0,5
2018,Greece,GRC,United States of America,USA,0,0,5,12,17
2018,Guatemala,GTM,United States of America,USA,1309,0,2981,3780,8070
2018,Guinea,GIN,United States of America,USA,74,0,82,40,196
2018,Guyana,GUY,United States of America,USA,19,0,19,41,79
2018,Haiti,HTI,United States of America,USA,185,0,593,568,1346
2018,Honduras,HND,United States of America,USA,791,0,1737,2363,4891
2018,Croatia,HRV,United States of America,USA,0,0,5,0,5
2018,Hungary,HUN,United States of America,USA,0,0,5,42,47
2018,Cote d'Ivoire,CIV,United States of America,USA,53,0,97,38,188
2018,India,IND,United States of America,USA,273,0,1280,887,2440
2018,Indonesia,IDN,United States of America,USA,57,0,201,133,391
2018,Ireland,IRL,United States of America,USA,0,0,0,5,5
2018,Iran (Islamic Rep. of),IRN,United States of America,USA,287,0,131,107,525
2018,Iraq,IRQ,United States of America,USA,268,0,307,143,718
2018,Israel,ISR,United States of America,USA,17,0,18,32,67
2018,Italy,ITA,United States of America,USA,0,0,11,16,27
2018,Jamaica,JAM,United States of America,USA,94,0,26,56,176
2018,Jordan,JOR,United States of America,USA,97,0,162,113,372
2018,Japan,JPN,United States of America,USA,0,0,0,15,15
2018,Kazakhstan,KAZ,United States of America,USA,92,0,171,56,319
2018,Kenya,KEN,United States of America,USA,121,0,219,88,428
2018,Kyrgyzstan,KGZ,United States of America,USA,74,0,96,69,239
2018,Rep. of Korea,KOR,United States of America,USA,5,0,5,33,43
2018,Dem. People's Rep. of Korea,PRK,United States of America,USA,0,0,0,11,11
2018,Kuwait,KWT,United States of America,USA,12,0,5,5,22
2018,Lao People's Dem. Rep.,LAO,United States of America,USA,10,0,5,19,34
2018,Liberia,LBR,United States of America,USA,140,0,81,68,289
2018,Libya,LBY,United States of America,USA,50,0,53,45,148
2018,Saint Lucia,LCA,United States of America,USA,0,0,0,5,5
2018,Lebanon,LBN,United States of America,USA,31,0,62,45,138
2018,Sri Lanka,LKA,United States of America,USA,29,0,153,45,227
2018,Lithuania,LTU,United States of America,USA,0,0,0,11,11
2018,Latvia,LVA,United States of America,USA,0,0,0,14,14
2018,Mauritania,MRT,United States of America,USA,74,0,78,45,197
2018,North Macedonia,MKD,United States of America,USA,16,0,10,12,38
2018,Rep. of Moldova,MDA,United States of America,USA,74,0,130,65,269
2018,Mexico,MEX,United States of America,USA,669,0,2593,8468,11730
2018,Mali,MLI,United States of America,USA,24,0,30,24,78
2018,Malaysia,MYS,United States of America,USA,10,0,10,22,42
2018,Malawi,MWI,United States of America,USA,0,0,11,5,16
2018,Mongolia,MNG,United States of America,USA,43,0,89,71,203
2018,Morocco,MAR,United States of America,USA,10,0,5,10,25
2018,Mozambique,MOZ,United States of America,USA,0,0,5,0,5
2018,Montenegro,MNE,United States of America,USA,5,0,38,23,66
2018,Mauritius,MUS,United States of America,USA,5,0,0,5,10
2018,Myanmar,MMR,United States of America,USA,93,0,117,35,245
2018,Nepal,NPL,United States of America,USA,82,0,447,122,651
2018,Netherlands,NLD,United States of America,USA,0,0,0,5,5
2018,Niger,NER,United States of America,USA,15,0,25,11,51
2018,Nicaragua,NIC,United States of America,USA,49,0,84,142,275
2018,Nigeria,NGA,United States of America,USA,362,0,1221,295,1878
2018,Pakistan,PAK,United States of America,USA,310,0,303,155,768
2018,Panama,PAN,United States of America,USA,0,0,0,13,13
2018,Paraguay,PRY,United States of America,USA,0,0,5,5,10
2018,Peru,PER,United States of America,USA,21,0,85,294,400
2018,Philippines,PHL,United States of America,USA,15,0,88,179,282
2018,Poland,POL,United States of America,USA,0,0,29,111,140
2018,Portugal,PRT,United States of America,USA,0,0,5,45,50
2018,Romania,ROU,United States of America,USA,15,0,72,157,244
2018,South Africa,ZAF,United States of America,USA,5,0,58,10,73
2018,Russian Federation,RUS,United States of America,USA,629,0,649,245,1523
2018,Rwanda,RWA,United States of America,USA,87,0,85,10,182
2018,El Salvador,SLV,United States of America,USA,1141,0,2712,2855,6708
2018,Saudi Arabia,SAU,United States of America,USA,62,0,35,39,136
2018,Serbia and Kosovo: S/RES/1244 (1999),SRB,United States of America,USA,28,0,120,27,175
2018,Senegal,SEN,United States of America,USA,22,0,32,49,103
2018,Singapore,SGP,United States of America,USA,0,0,0,5,5
2018,Sierra Leone,SLE,United States of America,USA,25,0,20,5,50
2018,Somalia,SOM,United States of America,USA,45,0,10,12,67
2018,Spain,ESP,United States of America,USA,5,0,5,5,15
2018,Viet Nam,VNM,United States of America,USA,29,0,49,39,117
2018,Sudan,SDN,United States of America,USA,91,0,40,38,169
2018,Suriname,SUR,United States of America,USA,5,0,0,0,5
2018,South Sudan,SSD,United States of America,USA,10,0,5,5,20
2018,Slovakia,SVK,United States of America,USA,0,0,0,5,5
2018,Slovenia,SVN,United States of America,USA,0,0,5,0,5
2018,Syrian Arab Rep.,SYR,United States of America,USA,395,0,179,133,707
2018,United Rep. of Tanzania,TZA,United States of America,USA,10,0,11,5,26
2018,Thailand,THA,United States of America,USA,5,0,10,31,46
2018,Tajikistan,TJK,United States of America,USA,17,0,34,19,70
2018,Turkmenistan,TKM,United States of America,USA,26,0,29,5,60
2018,Togo,TGO,United States of America,USA,49,0,65,15,129
2018,Trinidad and Tobago,TTO,United States of America,USA,0,0,12,26,38
2018,Tunisia,TUN,United States of America,USA,17,0,27,13,57
2018,Turkey,TUR,United States of America,USA,478,0,157,80,715
2018,United Arab Emirates,ARE,United States of America,USA,11,0,5,0,16
2018,Uganda,UGA,United States of America,USA,213,0,267,31,511
2018,Ukraine,UKR,United States of America,USA,304,0,567,275,1146
2018,Uruguay,URY,United States of America,USA,0,0,5,14,19
2018,Uzbekistan,UZB,United States of America,USA,92,0,146,90,328
2018,Venezuela (Bolivarian Republic of),VEN,United States of America,USA,4290,0,5507,974,10771
2018,Yemen,YEM,United States of America,USA,53,0,58,57,168
2018,Zambia,ZMB,United States of America,USA,0,0,5,13,18
2018,Zimbabwe,ZWE,United States of America,USA,62,0,30,27,119
2019,Afghanistan,AFG,United States of America,USA,71,0,43,12,126
2019,Albania,ALB,United States of America,USA,38,0,209,45,292
2019,Algeria,DZA,United States of America,USA,22,0,34,10,66
2019,Angola,AGO,United States of America,USA,25,0,143,20,188
2019,Antigua and Barbuda,ATG,United States of America,USA,5,0,0,0,5
2019,Egypt,EGY,United States of America,USA,1292,0,321,94,1707
2019,Argentina,ARG,United States of America,USA,0,0,18,34,52
2019,Armenia,ARM,United States of America,USA,112,0,188,48,348
2019,Australia,AUS,United States of America,USA,0,0,5,5,10
2019,Azerbaijan,AZE,United States of America,USA,86,0,92,21,199
2019,Burundi,BDI,United States of America,USA,42,0,49,13,104
2019,Belgium,BEL,United States of America,USA,0,0,0,5,5
2019,Benin,BEN,United States of America,USA,5,0,24,5,34
2019,Bangladesh,BGD,United States of America,USA,56,0,387,96,539
2019,Bahamas,BHS,United States of America,USA,0,0,11,0,11
2019,Bhutan,BTN,United States of America,USA,0,0,16,5,21
2019,Burkina Faso,BFA,United States of America,USA,69,0,205,30,304
2019,Belarus,BLR,United States of America,USA,121,0,227,46,394
2019,Bolivia (Plurinational State of),BOL,United States of America,USA,5,0,36,5,46
2019,Brazil,BRA,United States of America,USA,205,0,492,354,1051
2019,Bosnia and Herzegovina,BIH,United States of America,USA,11,0,12,10,33
2019,Bulgaria,BGR,United States of America,USA,10,0,12,5,27
2019,Belize,BLZ,United States of America,USA,0,0,12,5,17
2019,Cambodia,KHM,United States of America,USA,11,0,0,0,11
2019,Canada,CAN,United States of America,USA,0,0,0,5,5
2019,Central African Rep.,CAF,United States of America,USA,11,0,5,0,16
2019,Chad,TCD,United States of America,USA,14,0,14,0,28
2019,China,CHN,United States of America,USA,3310,0,3685,1161,8156
2019,Chile,CHL,United States of America,USA,5,0,25,12,42
2019,Cameroon,CMR,United States of America,USA,316,0,256,42,614
2019,Dem. Rep. of the Congo,COD,United States of America,USA,197,0,362,58,617
2019,Comoros,COM,United States of America,USA,0,0,5,0,5
2019,Colombia,COL,United States of America,USA,268,0,1282,213,1763
2019,Costa Rica,CRI,United States of America,USA,0,0,80,17,97
2019,Cuba,CUB,United States of America,USA,5,0,34,55,94
2019,Cabo Verde,CPV,United States of America,USA,0,0,5,0,5
2019,Cyprus,CYP,United States of America,USA,0,0,5,0,5
2019,Djibouti,DJI,United States of America,USA,50,0,13,16,79
2019,Dominica,DMA,United States of America,USA,5,0,0,0,5
2019,Dominican Rep.,DOM,United States of America,USA,16,0,68,38,122
2019,Ecuador,ECU,United States of America,USA,42,0,2026,357,2425
2019,Equatorial Guinea,GNQ,United States of America,USA,11,0,0,0,11
2019,Eritrea,ERI,United States of America,USA,270,0,64,10,344
2019,Ethiopia,ETH,United States of America,USA,295,0,204,65,564
2019,Fiji,FJI,United States of America,USA,5,0,31,0,36
2019,France,FRA,United States of America,USA,0,0,0,13,13
2019,Gabon,GAB,United States of America,USA,5,0,36,5,46
2019,Gambia,GMB,United States of America,USA,52,0,57,10,119
2019,United Kingdom of Great Britain and Northern Ireland,GBR,United States of America,USA,0,0,13,0,13
2019,Georgia,GEO,United States of America,USA,60,0,185,36,281
2019,Germany,DEU,United States of America,USA,0,0,11,0,11
2019,Ghana,GHA,United States of America,USA,13,0,42,12,67
2019,Guinea-Bissau,GNB,United States of America,USA,0,0,0,5,5
2019,Greece,GRC,United States of America,USA,0,0,5,11,16
2019,Grenada,GRD,United States of America,USA,5,0,0,0,5
2019,Guatemala,GTM,United States of America,USA,1358,0,4877,2202,8437
2019,Guinea,GIN,United States of America,USA,73,0,122,10,205
2019,Guyana,GUY,United States of America,USA,18,0,70,18,106
2019,Haiti,HTI,United States of America,USA,234,0,1021,270,1525
2019,"China, Hong Kong SAR",HKG,United States of America,USA,0,0,11,5,16
2019,Honduras,HND,United States of America,USA,625,0,2553,1274,4452
2019,Hungary,HUN,United States of America,USA,0,0,34,31,65
2019,Cote d'Ivoire,CIV,United States of America,USA,29,0,125,29,183
2019,India,IND,United States of America,USA,329,0,2244,454,3027
2019,Indonesia,IDN,United States of America,USA,75,0,415,52,542
2019,Iran (Islamic Rep. of),IRN,United States of America,USA,352,0,121,115,588
2019,Iraq,IRQ,United States of America,USA,288,0,300,128,716
2019,Israel,ISR,United States of America,USA,16,0,22,19,57
2019,Italy,ITA,United States of America,USA,0,0,36,25,61
2019,Jamaica,JAM,United States of America,USA,105,0,63,26,194
2019,Jordan,JOR,United States of America,USA,81,0,243,89,413
2019,Japan,JPN,United States of America,USA,0,0,14,0,14
2019,Kazakhstan,KAZ,United States of America,USA,183,0,242,57,482
2019,Kenya,KEN,United States of America,USA,163,0,206,32,401
2019,Kyrgyzstan,KGZ,United States of America,USA,97,0,146,29,272
2019,Rep. of Korea,KOR,United States of America,USA,0,0,27,26,53
2019,Dem. People's Rep. of Korea,PRK,United States of America,USA,0,0,5,5,10
2019,Kuwait,KWT,United States of America,USA,13,0,5,0,18
2019,Lao People's Dem. Rep.,LAO,United States of America,USA,0,0,13,5,18
2019,Liberia,LBR,United States of America,USA,126,0,163,21,310
2019,Libya,LBY,United States of America,USA,41,0,59,33,133
2019,Saint Lucia,LCA,United States of America,USA,0,0,5,0,5
2019,Lebanon,LBN,United States of America,USA,32,0,125,29,186
2019,Sri Lanka,LKA,United States of America,USA,37,0,163,32,232
2019,Lithuania,LTU,United States of America,USA,0,0,5,5,10
2019,Latvia,LVA,United States of America,USA,0,0,5,0,5
2019,Mauritania,MRT,United States of America,USA,94,0,124,22,240
2019,North Macedonia,MKD,United States of America,USA,16,0,18,5,39
2019,Rep. of Moldova,MDA,United States of America,USA,59,0,139,40,238
2019,Mexico,MEX,United States of America,USA,1114,0,9107,2915,13136
2019,Mali,MLI,United States of America,USA,20,0,54,10,84
2019,Malaysia,MYS,United States of America,USA,10,0,41,5,56
2019,Malawi,MWI,United States of America,USA,10,0,15,0,25
2019,Mongolia,MNG,United States of America,USA,74,0,140,27,241
2019,Morocco,MAR,United States of America,USA,22,0,20,13,55
2019,Mozambique,MOZ,United States of America,USA,18,0,14,14,46
2019,Montenegro,MNE,United States of America,USA,22,0,69,11,102
2019,Mauritius,MUS,United States of America,USA,5,0,0,0,5
2019,Myanmar,MMR,United States of America,USA,124,0,191,20,335
2019,Nepal,NPL,United States of America,USA,51,0,423,77,551
2019,Niger,NER,United States of America,USA,5,0,29,5,39
2019,Nicaragua,NIC,United States of America,USA,273,0,372,140,785
2019,Nigeria,NGA,United States of America,USA,434,0,1426,125,1985
2019,Oman,OMN,United States of America,USA,5,0,0,5,10
2019,Pakistan,PAK,United States of America,USA,279,0,420,110,809
2019,Panama,PAN,United States of America,USA,0,0,11,5,16
2019,Paraguay,PRY,United States of America,USA,5,0,13,0,18
2019,Peru,PER,United States of America,USA,26,0,349,79,454
2019,Philippines,PHL,United States of America,USA,15,0,258,56,329
2019,Poland,POL,United States of America,USA,0,0,142,23,165
2019,Portugal,PRT,United States of America,USA,0,0,14,39,53
2019,Romania,ROU,United States of America,USA,25,0,129,135,289
2019,South Africa,ZAF,United States of America,USA,10,0,131,5,146
2019,Russian Federation,RUS,United States of America,USA,1018,0,799,281,2098
2019,Rwanda,RWA,United States of America,USA,140,0,126,19,285
2019,El Salvador,SLV,United States of America,USA,1121,0,3549,1299,5969
2019,Saudi Arabia,SAU,United States of America,USA,84,0,38,21,143
2019,Serbia and Kosovo: S/RES/1244 (1999),SRB,United States of America,USA,36,0,80,10,126
2019,Senegal,SEN,United States of America,USA,21,0,69,11,101
2019,Sierra Leone,SLE,United States of America,USA,17,0,22,5,44
2019,Somalia,SOM,United States of America,USA,24,0,5,10,39
2019,Spain,ESP,United States of America,USA,0,0,21,12,33
2019,Viet Nam,VNM,United States of America,USA,33,0,71,18,122
2019,Sudan,SDN,United States of America,USA,94,0,70,28,192
2019,South Sudan,SSD,United States of America,USA,21,0,15,0,36
2019,Slovakia,SVK,United States of America,USA,0,0,5,0,5
2019,Syrian Arab Rep.,SYR,United States of America,USA,344,0,210,100,654
2019,United Rep. of Tanzania,TZA,United States of America,USA,10,0,13,5,28
2019,Thailand,THA,United States of America,USA,5,0,14,47,66
2019,Tajikistan,TJK,United States of America,USA,14,0,42,10,66
2019,Turkmenistan,TKM,United States of America,USA,32,0,10,5,47
2019,Togo,TGO,United States of America,USA,42,0,71,10,123
2019,Trinidad and Tobago,TTO,United States of America,USA,0,0,27,10,37
2019,Tunisia,TUN,United States of America,USA,5,0,39,5,49
2019,Turkey,TUR,United States of America,USA,1309,0,199,73,1581
2019,United Arab Emirates,ARE,United States of America,USA,5,0,0,5,10
2019,Uganda,UGA,United States of America,USA,211,0,329,20,560
2019,Ukraine,UKR,United States of America,USA,250,0,529,204,983
2019,Uruguay,URY,United States of America,USA,0,0,19,12,31
2019,Uzbekistan,UZB,United States of America,USA,73,0,175,68,316
2019,Saint Vincent and the Grenadines,VCT,United States of America,USA,0,0,5,0,5
2019,Venezuela (Bolivarian Republic of),VEN,United States of America,USA,3824,0,7316,1015,12155
2019,Yemen,YEM,United States of America,USA,89,0,63,24,176
2019,Zambia,ZMB,United States of America,USA,10,0,10,5,25
2019,Zimbabwe,ZWE,United States of America,USA,81,0,64,11,156
2020,Afghanistan,AFG,United States of America,USA,34,0,26,28,88
2020,Albania,ALB,United States of America,USA,5,0,62,24,91
2020,Algeria,DZA,United States of America,USA,5,0,5,14,24
2020,Angola,AGO,United States of America,USA,10,0,63,31,104
2020,Egypt,EGY,United States of America,USA,404,0,165,121,690
2020,Argentina,ARG,United States of America,USA,0,0,5,11,16
2020,Armenia,ARM,United States of America,USA,31,0,68,28,127
2020,Azerbaijan,AZE,United States of America,USA,27,0,22,33,82
2020,Bahrain,BHR,United States of America,USA,0,0,0,5,5
2020,Burundi,BDI,United States of America,USA,16,0,30,14,60
2020,Benin,BEN,United States of America,USA,5,0,14,0,19
2020,Bangladesh,BGD,United States of America,USA,14,0,163,95,272
2020,Bhutan,BTN,United States of America,USA,0,0,12,15,27
2020,Burkina Faso,BFA,United States of America,USA,25,0,55,61,141
2020,Belarus,BLR,United States of America,USA,30,0,74,46,150
2020,Bolivia (Plurinational State of),BOL,United States of America,USA,0,0,16,5,21
2020,Botswana,BWA,United States of America,USA,0,0,5,0,5
2020,Brazil,BRA,United States of America,USA,76,0,227,278,581
2020,Bosnia and Herzegovina,BIH,United States of America,USA,0,0,14,0,14
2020,Bulgaria,BGR,United States of America,USA,5,0,15,5,25
2020,Belize,BLZ,United States of America,USA,0,0,11,0,11
2020,Cambodia,KHM,United States of America,USA,0,0,0,5,5
2020,Central African Rep.,CAF,United States of America,USA,5,0,5,0,10
2020,Chad,TCD,United States of America,USA,12,0,12,0,24
2020,China,CHN,United States of America,USA,1501,0,1807,1470,4778
2020,Chile,CHL,United States of America,USA,0,0,15,12,27
2020,Cameroon,CMR,United States of America,USA,114,0,142,115,371
2020,Congo,COG,United States of America,USA,34,0,55,57,146
2020,Dem. Rep. of the Congo,COD,United States of America,USA,36,0,112,50,198
2020,Colombia,COL,United States of America,USA,101,0,534,133,768
2020,Costa Rica,CRI,United States of America,USA,0,0,45,10,55
2020,Cuba,CUB,United States of America,USA,10,0,36,675,721
2020,Czechia,CZE,United States of America,USA,0,0,5,0,5
2020,Djibouti,DJI,United States of America,USA,22,0,11,5,38
2020,Dominican Rep.,DOM,United States of America,USA,5,0,35,14,54
2020,Ecuador,ECU,United States of America,USA,16,0,852,272,1140
2020,Equatorial Guinea,GNQ,United States of America,USA,0,0,5,0,5
2020,Eritrea,ERI,United States of America,USA,89,0,20,33,142
2020,Ethiopia,ETH,United States of America,USA,136,0,118,132,386
2020,Fiji,FJI,United States of America,USA,0,0,11,5,16
2020,Gabon,GAB,United States of America,USA,5,0,17,0,22
2020,Gambia,GMB,United States of America,USA,21,0,26,25,72
2020,Georgia,GEO,United States of America,USA,19,0,38,48,105
2020,Germany,DEU,United States of America,USA,0,0,5,5,10
2020,Ghana,GHA,United States of America,USA,5,0,24,15,44
2020,Greece,GRC,United States of America,USA,0,0,0,5,5
2020,Guatemala,GTM,United States of America,USA,424,0,2220,2054,4698
2020,Guinea,GIN,United States of America,USA,34,0,32,18,84
2020,Guyana,GUY,United States of America,USA,0,0,33,12,45
2020,Haiti,HTI,United States of America,USA,78,0,553,810,1441
2020,"China, Hong Kong SAR",HKG,United States of America,USA,0,0,5,0,5
2020,Honduras,HND,United States of America,USA,232,0,1391,1867,3490
2020,Hungary,HUN,United States of America,USA,0,0,10,29,39
2020,Cote d'Ivoire,CIV,United States of America,USA,20,0,47,28,95
2020,India,IND,United States of America,USA,64,0,834,451,1349
2020,Indonesia,IDN,United States of America,USA,18,0,82,65,165
2020,Ireland,IRL,United States of America,USA,0,0,0,5,5
2020,Iran (Islamic Rep. of),IRN,United States of America,USA,117,0,53,148,318
2020,Iraq,IRQ,United States of America,USA,98,0,236,177,511
2020,Israel,ISR,United States of America,USA,0,0,13,19,32
2020,Italy,ITA,United States of America,USA,0,0,16,16,32
2020,Jamaica,JAM,United States of America,USA,25,0,30,19,74
2020,Jordan,JOR,United States of America,USA,25,0,105,88,218
2020,Japan,JPN,United States of America,USA,0,0,0,5,5
2020,Kazakhstan,KAZ,United States of America,USA,53,0,79,47,179
2020,Kenya,KEN,United States of America,USA,41,0,86,82,209
2020,Kyrgyzstan,KGZ,United States of America,USA,42,0,76,19,137
2020,Rep. of Korea,KOR,United States of America,USA,0,0,11,29,40
2020,Dem. People's Rep. of Korea,PRK,United States of America,USA,0,0,0,5,5
2020,Kuwait,KWT,United States of America,USA,0,0,5,5,10
2020,Lao People's Dem. Rep.,LAO,United States of America,USA,5,0,11,10,26
2020,Liberia,LBR,United States of America,USA,44,0,63,45,152
2020,Libya,LBY,United States of America,USA,17,0,39,53,109
2020,Lebanon,LBN,United States of America,USA,11,0,37,23,71
2020,Sri Lanka,LKA,United States of America,USA,5,0,58,38,101
2020,Lithuania,LTU,United States of America,USA,0,0,0,5,5
2020,Latvia,LVA,United States of America,USA,0,0,5,0,5
2020,Madagascar,MDG,United States of America,USA,0,0,5,0,5
2020,Mauritania,MRT,United States of America,USA,44,0,78,17,139
2020,North Macedonia,MKD,United States of America,USA,0,0,10,5,15
2020,Rep. of Moldova,MDA,United States of America,USA,17,0,71,52,140
2020,Mexico,MEX,United States of America,USA,350,0,3851,1184,5385
2020,Mali,MLI,United States of America,USA,11,0,28,10,49
2020,Malaysia,MYS,United States of America,USA,5,0,21,5,31
2020,Malawi,MWI,United States of America,USA,5,0,10,0,15
2020,Mongolia,MNG,United States of America,USA,32,0,55,27,114
2020,Morocco,MAR,United States of America,USA,0,0,14,0,14
2020,Mozambique,MOZ,United States of America,USA,5,0,0,0,5
2020,Montenegro,MNE,United States of America,USA,5,0,23,5,33
2020,Myanmar,MMR,United States of America,USA,51,0,102,21,174
2020,Nepal,NPL,United States of America,USA,10,0,166,97,273
2020,Netherlands,NLD,United States of America,USA,0,0,0,5,5
2020,Niger,NER,United States of America,USA,0,0,0,12,12
2020,Nicaragua,NIC,United States of America,USA,81,0,122,195,398
2020,Nigeria,NGA,United States of America,USA,151,0,665,156,972
2020,Oman,OMN,United States of America,USA,0,0,5,0,5
2020,Pakistan,PAK,United States of America,USA,96,0,137,135,368
2020,Paraguay,PRY,United States of America,USA,0,0,5,5,10
2020,Peru,PER,United States of America,USA,5,0,153,60,218
2020,Philippines,PHL,United States of America,USA,5,0,37,35,77
2020,Poland,POL,United States of America,USA,0,0,45,15,60
2020,Portugal,PRT,United States of America,USA,0,0,5,21,26
2020,Romania,ROU,United States of America,USA,5,0,37,158,200
2020,South Africa,ZAF,United States of America,USA,0,0,51,10,61
2020,Russian Federation,RUS,United States of America,USA,310,0,319,273,902
2020,Rwanda,RWA,United States of America,USA,51,0,68,14,133
2020,El Salvador,SLV,United States of America,USA,250,0,1880,1533,3663
2020,Saudi Arabia,SAU,United States of America,USA,24,0,18,33,75
2020,Serbia and Kosovo: S/RES/1244 (1999),SRB,United States of America,USA,5,0,53,44,102
2020,Senegal,SEN,United States of America,USA,12,0,29,10,51
2020,Sierra Leone,SLE,United States of America,USA,10,0,11,10,31
2020,Somalia,SOM,United States of America,USA,15,0,10,10,35
2020,Spain,ESP,United States of America,USA,0,0,0,12,12
2020,Viet Nam,VNM,United States of America,USA,12,0,34,33,79
2020,Sudan,SDN,United States of America,USA,51,0,31,39,121
2020,Suriname,SUR,United States of America,USA,0,0,5,0,5
2020,Slovakia,SVK,United States of America,USA,0,0,0,5,5
2020,Sweden,SWE,United States of America,USA,0,0,0,5,5
2020,Syrian Arab Rep.,SYR,United States of America,USA,137,0,111,136,384
2020,United Rep. of Tanzania,TZA,United States of America,USA,5,0,0,12,17
2020,Thailand,THA,United States of America,USA,0,0,5,39,44
2020,Tajikistan,TJK,United States of America,USA,10,0,25,12,47
2020,Turkmenistan,TKM,United States of America,USA,15,0,12,5,32
2020,Togo,TGO,United States of America,USA,20,0,31,10,61
2020,Trinidad and Tobago,TTO,United States of America,USA,0,0,21,5,26
2020,Tunisia,TUN,United States of America,USA,10,0,10,10,30
2020,Turkey,TUR,United States of America,USA,581,0,94,117,792
2020,United Arab Emirates,ARE,United States of America,USA,0,0,0,10,10
2020,Uganda,UGA,United States of America,USA,84,0,130,47,261
2020,Ukraine,UKR,United States of America,USA,62,0,214,248,524
2020,Uruguay,URY,United States of America,USA,0,0,14,0,14
2020,Uzbekistan,UZB,United States of America,USA,22,0,67,48,137
2020,Saint Vincent and the Grenadines,VCT,United States of America,USA,0,0,5,0,5
2020,Venezuela (Bolivarian Republic of),VEN,United States of America,USA,1356,0,3118,1157,5631
2020,Yemen,YEM,United States of America,USA,23,0,42,42,107
2020,Zambia,ZMB,United States of America,USA,5,0,5,0,10
2020,Zimbabwe,ZWE,United States of America,USA,27,0,35,23,85
2021,Afghanistan,AFG,United States of America,USA,156,0,33,63,252
2021,Albania,ALB,United States of America,USA,31,0,168,25,224
2021,Algeria,DZA,United States of America,USA,5,0,23,14,42
2021,Angola,AGO,United States of America,USA,14,0,37,49,100
2021,Egypt,EGY,United States of America,USA,680,0,257,153,1090
2021,Argentina,ARG,United States of America,USA,0,0,28,5,33
2021,Armenia,ARM,United States of America,USA,39,0,108,65,212
2021,Azerbaijan,AZE,United States of America,USA,45,0,36,46,127
2021,Burundi,BDI,United States of America,USA,11,0,28,5,44
2021,Benin,BEN,United States of America,USA,5,0,10,5,20
2021,Bangladesh,BGD,United States of America,USA,27,0,312,116,455
2021,Bahamas,BHS,United States of America,USA,5,0,5,0,10
2021,Bhutan,BTN,United States of America,USA,0,0,15,5,20
2021,Burkina Faso,BFA,United States of America,USA,49,0,90,63,202
2021,Belarus,BLR,United States of America,USA,80,0,94,63,237
2021,Bolivia (Plurinational State of),BOL,United States of America,USA,5,0,51,10,66
2021,Brazil,BRA,United States of America,USA,72,0,405,423,900
2021,Bosnia and Herzegovina,BIH,United States of America,USA,0,0,10,11,21
2021,Bulgaria,BGR,United States of America,USA,5,0,64,10,79
2021,Belize,BLZ,United States of America,USA,0,0,5,0,5
2021,Cambodia,KHM,United States of America,USA,5,0,0,0,5
2021,Canada,CAN,United States of America,USA,0,0,5,5,10
2021,Central African Rep.,CAF,United States of America,USA,0,0,0,13,13
2021,Chad,TCD,United States of America,USA,5,0,14,0,19
2021,China,CHN,United States of America,USA,1284,0,2033,2942,6259
2021,Chile,CHL,United States of America,USA,5,0,25,28,58
2021,Cameroon,CMR,United States of America,USA,149,0,113,92,354
2021,Congo,COG,United States of America,USA,20,0,64,45,129
2021,Dem. Rep. of the Congo,COD,United States of America,USA,26,0,78,45,149
2021,Colombia,COL,United States of America,USA,228,0,1863,234,2325
2021,Costa Rica,CRI,United States of America,USA,5,0,32,5,42
2021,Cuba,CUB,United States of America,USA,47,0,193,814,1054
2021,Cabo Verde,CPV,United States of America,USA,0,0,5,0,5
2021,Czechia,CZE,United States of America,USA,0,0,5,0,5
2021,Djibouti,DJI,United States of America,USA,18,0,17,5,40
2021,Dominica,DMA,United States of America,USA,0,0,5,0,5
2021,Dominican Rep.,DOM,United States of America,USA,0,0,40,17,57
2021,Ecuador,ECU,United States of America,USA,26,0,1104,370,1500
2021,Equatorial Guinea,GNQ,United States of America,USA,0,0,12,0,12
2021,Eritrea,ERI,United States of America,USA,70,0,30,23,123
2021,Estonia,EST,United States of America,USA,0,0,5,0,5
2021,Ethiopia,ETH,United States of America,USA,368,0,183,98,649
2021,Fiji,FJI,United States of America,USA,5,0,22,5,32
2021,Gabon,GAB,United States of America,USA,0,0,13,0,13
2021,Gambia,GMB,United States of America,USA,29,0,57,11,97
2021,United Kingdom of Great Britain and Northern Ireland,GBR,United States of America,USA,0,0,0,5,5
2021,Georgia,GEO,United States of America,USA,19,0,62,62,143
2021,Germany,DEU,United States of America,USA,0,0,0,5,5
2021,Ghana,GHA,United States of America,USA,5,0,31,29,65
2021,Guinea-Bissau,GNB,United States of America,USA,0,0,5,0,5
2021,Greece,GRC,United States of America,USA,0,0,12,0,12
2021,Grenada,GRD,United States of America,USA,0,0,5,0,5
2021,Guatemala,GTM,United States of America,USA,381,0,2015,2303,4699
2021,Guinea,GIN,United States of America,USA,42,0,49,18,109
2021,Guyana,GUY,United States of America,USA,11,0,14,5,30
2021,Haiti,HTI,United States of America,USA,130,0,1215,1359,2704
2021,"China, Hong Kong SAR",HKG,United States of America,USA,13,0,5,0,18
2021,Honduras,HND,United States of America,USA,394,0,1275,2542,4211
2021,Croatia,HRV,United States of America,USA,0,0,5,0,5
2021,Hungary,HUN,United States of America,USA,0,0,20,27,47
2021,Cote d'Ivoire,CIV,United States of America,USA,11,0,71,13,95
2021,India,IND,United States of America,USA,81,0,1114,472,1667
2021,Indonesia,IDN,United States of America,USA,14,0,78,34,126
2021,Ireland,IRL,United States of America,USA,0,0,0,5,5
2021,Iran (Islamic Rep. of),IRN,United States of America,USA,156,0,99,140,395
2021,Iraq,IRQ,United States of America,USA,146,0,313,236,695
2021,Israel,ISR,United States of America,USA,5,0,17,10,32
2021,Italy,ITA,United States of America,USA,0,0,32,30,62
2021,Jamaica,JAM,United States of America,USA,27,0,37,27,91
2021,Jordan,JOR,United States of America,USA,67,0,199,78,344
2021,Japan,JPN,United States of America,USA,5,0,0,0,5
2021,Kazakhstan,KAZ,United States of America,USA,66,0,154,54,274
2021,Kenya,KEN,United States of America,USA,36,0,67,94,197
2021,Kyrgyzstan,KGZ,United States of America,USA,68,0,103,46,217
2021,Rep. of Korea,KOR,United States of America,USA,0,0,10,10,20
2021,Dem. People's Rep. of Korea,PRK,United States of America,USA,0,0,0,10,10
2021,Kuwait,KWT,United States of America,USA,0,0,5,0,5
2021,Lao People's Dem. Rep.,LAO,United States of America,USA,0,0,32,5,37
2021,Liberia,LBR,United States of America,USA,33,0,83,41,157
2021,Libya,LBY,United States of America,USA,17,0,64,37,118
2021,Lebanon,LBN,United States of America,USA,27,0,136,26,189
2021,Sri Lanka,LKA,United States of America,USA,11,0,74,36,121
2021,Lithuania,LTU,United States of America,USA,0,0,5,0,5
2021,Latvia,LVA,United States of America,USA,0,0,17,5,22
2021,Madagascar,MDG,United States of America,USA,0,0,5,0,5
2021,Mauritania,MRT,United States of America,USA,32,0,79,17,128
2021,North Macedonia,MKD,United States of America,USA,0,0,14,5,19
2021,Rep. of Moldova,MDA,United States of America,USA,17,0,67,64,148
2021,Mexico,MEX,United States of America,USA,305,0,3226,1525,5056
2021,Mali,MLI,United States of America,USA,12,0,42,5,59
2021,Malaysia,MYS,United States of America,USA,5,0,24,0,29
2021,Malawi,MWI,United States of America,USA,0,0,16,0,16
2021,Mongolia,MNG,United States of America,USA,17,0,94,33,144
2021,Morocco,MAR,United States of America,USA,10,0,14,10,34
2021,Mozambique,MOZ,United States of America,USA,5,0,0,0,5
2021,Montenegro,MNE,United States of America,USA,5,0,35,12,52
2021,Myanmar,MMR,United States of America,USA,131,0,100,12,243
2021,Nepal,NPL,United States of America,USA,18,0,227,86,331
2021,Niger,NER,United States of America,USA,5,0,12,5,22
2021,Nicaragua,NIC,United States of America,USA,99,0,167,304,570
2021,Nigeria,NGA,United States of America,USA,312,0,1055,157,1524
2021,Oman,OMN,United States of America,USA,5,0,0,0,5
2021,Pakistan,PAK,United States of America,USA,185,0,318,116,619
2021,Panama,PAN,United States of America,USA,5,0,11,0,16
2021,Paraguay,PRY,United States of America,USA,0,0,5,0,5
2021,Peru,PER,United States of America,USA,15,0,179,38,232
2021,Philippines,PHL,United States of America,USA,5,0,39,34,78
2021,Poland,POL,United States of America,USA,5,0,94,19,118
2021,Portugal,PRT,United States of America,USA,0,0,19,15,34
2021,Qatar,QAT,United States of America,USA,5,0,0,0,5
2021,Romania,ROU,United States of America,USA,13,0,97,141,251
2021,South Africa,ZAF,United States of America,USA,5,0,70,16,91
2021,Russian Federation,RUS,United States of America,USA,445,0,821,463,1729
2021,Rwanda,RWA,United States of America,USA,67,0,84,10,161
2021,El Salvador,SLV,United States of America,USA,291,0,1652,1930,3873
2021,Saudi Arabia,SAU,United States of America,USA,42,0,15,30,87
2021,Serbia and Kosovo: S/RES/1244 (1999),SRB,United States of America,USA,18,0,127,41,186
2021,Senegal,SEN,United States of America,USA,11,0,45,11,67
2021,Sierra Leone,SLE,United States of America,USA,14,0,54,5,73
2021,Somalia,SOM,United States of America,USA,21,0,140,5,166
2021,Spain,ESP,United States of America,USA,0,0,28,26,54
2021,Viet Nam,VNM,United States of America,USA,10,0,26,92,128
2021,Sudan,SDN,United States of America,USA,70,0,66,21,157
2021,South Sudan,SSD,United States of America,USA,5,0,5,0,10
2021,Slovakia,SVK,United States of America,USA,0,0,5,0,5
2021,Sweden,SWE,United States of America,USA,0,0,5,5,10
2021,Syrian Arab Rep.,SYR,United States of America,USA,208,0,144,116,468
2021,United Rep. of Tanzania,TZA,United States of America,USA,0,0,12,5,17
2021,Thailand,THA,United States of America,USA,5,0,18,21,44
2021,Tajikistan,TJK,United States of America,USA,10,0,27,16,53
2021,Turkmenistan,TKM,United States of America,USA,19,0,10,10,39
2021,Togo,TGO,United States of America,USA,23,0,33,5,61
2021,Trinidad and Tobago,TTO,United States of America,USA,0,0,24,11,35
2021,Tunisia,TUN,United States of America,USA,10,0,10,5,25
2021,Turkey,TUR,United States of America,USA,1092,0,145,144,1381
2021,United Arab Emirates,ARE,United States of America,USA,0,0,11,0,11
2021,Uganda,UGA,United States of America,USA,97,0,122,29,248
2021,Ukraine,UKR,United States of America,USA,79,0,314,273,666
2021,Uruguay,URY,United States of America,USA,0,0,11,0,11
2021,Uzbekistan,UZB,United States of America,USA,26,0,68,120,214
2021,Venezuela (Bolivarian Republic of),VEN,United States of America,USA,1507,0,3716,1945,7168
2021,Yemen,YEM,United States of America,USA,27,0,46,28,101
2021,Zambia,ZMB,United States of America,USA,0,0,13,5,18
2021,Zimbabwe,ZWE,United States of America,USA,38,0,32,13,83
2006,Afghanistan,AFG,Azerbaijan,AZE,0,0,15,0,15
2006,Iran (Islamic Rep. of),IRN,Azerbaijan,AZE,0,0,5,0,5
2006,Iran (Islamic Rep. of),IRN,Japan,JPN,0,0,0,0,5
2006,Turkey,TUR,Japan,JPN,0,0,0,0,5
2007,Afghanistan,AFG,Azerbaijan,AZE,0,0,5,0,5
2007,Iran (Islamic Rep. of),IRN,Azerbaijan,AZE,0,0,5,0,5
2008,Afghanistan,AFG,Azerbaijan,AZE,0,0,5,0,5
2009,Afghanistan,AFG,Azerbaijan,AZE,0,0,5,0,5
2009,Albania,ALB,Luxembourg,LUX,0,0,5,0,5
2009,Bosnia and Herzegovina,BIH,Luxembourg,LUX,0,0,14,0,14
2009,Cameroon,CMR,Luxembourg,LUX,0,0,5,0,5
2009,Rep. of Moldova,MDA,Luxembourg,LUX,0,0,5,0,5
2009,Montenegro,MNE,Luxembourg,LUX,0,0,5,0,5
2009,Russian Federation,RUS,Luxembourg,LUX,0,0,5,0,5
2009,Serbia and Kosovo: S/RES/1244 (1999),SRB,Luxembourg,LUX,12,0,0,0,12
2013,Afghanistan,AFG,Belgium,BEL,10,5,769,47,831
2013,Albania,ALB,Belgium,BEL,5,0,91,38,134
2013,Algeria,DZA,Belgium,BEL,0,0,37,14,51
2013,Angola,AGO,Belgium,BEL,0,0,86,17,103
2013,Egypt,EGY,Belgium,BEL,0,0,10,5,15
2013,Armenia,ARM,Belgium,BEL,0,5,122,24,151
2013,Azerbaijan,AZE,Belgium,BEL,0,0,63,10,73
2013,Burundi,BDI,Belgium,BEL,18,0,92,30,140
2013,Belgium,BEL,Belgium,BEL,0,0,5,0,5
2013,Benin,BEN,Belgium,BEL,5,0,64,10,79
2013,Bangladesh,BGD,Belgium,BEL,0,0,118,51,169
2013,Bhutan,BTN,Belgium,BEL,0,0,5,0,5
2013,Burkina Faso,BFA,Belgium,BEL,0,0,54,18,72
2013,Belarus,BLR,Belgium,BEL,0,0,15,10,25
2013,Bulgaria,BGR,Belgium,BEL,0,0,0,5,5
2013,Chad,TCD,Belgium,BEL,0,0,5,5,10
2013,China,CHN,Belgium,BEL,0,0,11,0,11
2013,Cameroon,CMR,Belgium,BEL,15,0,218,44,277
2013,Congo,COG,Belgium,BEL,0,0,11,0,11
2013,Dem. Rep. of the Congo,COD,Belgium,BEL,15,5,1153,292,1465
2013,Comoros,COM,Belgium,BEL,0,0,150,31,181
2013,Cuba,CUB,Belgium,BEL,0,0,5,0,5
2013,Djibouti,DJI,Belgium,BEL,5,0,15,10,30
2013,Eritrea,ERI,Belgium,BEL,0,0,10,0,10
2013,Ethiopia,ETH,Belgium,BEL,0,0,10,0,10
2013,Gabon,GAB,Belgium,BEL,0,0,5,0,5
2013,Gambia,GMB,Belgium,BEL,0,0,29,0,29
2013,Palestinian,PSE,Belgium,BEL,0,0,5,5,10
2013,Georgia,GEO,Belgium,BEL,0,0,132,24,156
2013,Ghana,GHA,Belgium,BEL,0,0,42,5,47
2013,Guinea,GIN,Belgium,BEL,99,10,1051,173,1333
2013,Cote d'Ivoire,CIV,Belgium,BEL,5,0,0,0,5
2013,India,IND,Belgium,BEL,0,0,5,5,10
2013,Iran (Islamic Rep. of),IRN,Belgium,BEL,0,0,111,13,124
2013,Iraq,IRQ,Belgium,BEL,10,0,240,56,306
2013,Jordan,JOR,Belgium,BEL,0,0,5,0,5
2013,Kazakhstan,KAZ,Belgium,BEL,0,0,72,12,84
2013,Kenya,KEN,Belgium,BEL,0,0,19,5,24
2013,Kyrgyzstan,KGZ,Belgium,BEL,0,0,66,12,78
2013,Dem. People's Rep. of Korea,PRK,Belgium,BEL,0,0,12,0,12
2013,Liberia,LBR,Belgium,BEL,0,0,11,0,11
2013,Lebanon,LBN,Belgium,BEL,0,0,22,5,27
2013,Sri Lanka,LKA,Belgium,BEL,0,0,28,0,28
2013,Mauritania,MRT,Belgium,BEL,16,0,151,47,214
2013,North Macedonia,MKD,Belgium,BEL,0,0,10,0,10
2013,Mali,MLI,Belgium,BEL,0,0,5,0,5
2013,Mongolia,MNG,Belgium,BEL,0,0,13,0,13
2013,Morocco,MAR,Belgium,BEL,5,0,32,10,47
2013,Montenegro,MNE,Belgium,BEL,0,0,5,5,10
2013,Nepal,NPL,Belgium,BEL,0,0,200,66,266
2013,Niger,NER,Belgium,BEL,5,0,48,5,58
2013,Nigeria,NGA,Belgium,BEL,0,0,69,24,93
2013,Pakistan,PAK,Belgium,BEL,5,0,342,95,442
2013,Russian Federation,RUS,Belgium,BEL,5,0,329,59,393
2013,Rwanda,RWA,Belgium,BEL,27,0,182,69,278
2013,El Salvador,SLV,Belgium,BEL,0,0,5,0,5
2013,Serbia and Kosovo: S/RES/1244 (1999),SRB,Belgium,BEL,5,0,40,20,65
2013,Senegal,SEN,Belgium,BEL,33,5,228,21,287
2013,Sierra Leone,SLE,Belgium,BEL,0,0,39,0,39
2013,Somalia,SOM,Belgium,BEL,5,0,66,10,81
2013,Viet Nam,VNM,Belgium,BEL,0,0,5,0,5
2013,Sudan,SDN,Belgium,BEL,0,0,10,5,15
2013,Syrian Arab Rep.,SYR,Belgium,BEL,0,10,12,12,34
2013,United Rep. of Tanzania,TZA,Belgium,BEL,0,0,33,5,38
2013,Togo,TGO,Belgium,BEL,10,0,215,63,288
2013,Tunisia,TUN,Belgium,BEL,0,0,11,0,11
2013,Turkey,TUR,Belgium,BEL,10,0,87,23,120
2013,Uganda,UGA,Belgium,BEL,0,0,5,0,5
2013,Ukraine,UKR,Belgium,BEL,0,0,25,5,30
2013,Uzbekistan,UZB,Belgium,BEL,0,0,0,11,11
2013,Stateless,XXA,Belgium,BEL,0,0,5,0,5
2013,Myanmar,MMR,Rep. of Korea,KOR,5,0,0,0,5
2013,Albania,ALB,Luxembourg,LUX,10,0,0,0,10
2013,Iraq,IRQ,Luxembourg,LUX,5,0,0,0,5
2013,Mexico,MEX,Luxembourg,LUX,5,0,0,0,5
2013,Serbia and Kosovo: S/RES/1244 (1999),SRB,Luxembourg,LUX,10,0,0,0,10
2014,Afghanistan,AFG,Belgium,BEL,5,0,347,21,373
2014,Albania,ALB,Belgium,BEL,12,0,73,5,90
2014,Algeria,DZA,Belgium,BEL,0,0,40,0,40
2014,Angola,AGO,Belgium,BEL,0,0,95,5,100
2014,Egypt,EGY,Belgium,BEL,0,0,51,0,51
2014,Armenia,ARM,Belgium,BEL,0,0,73,5,78
2014,Azerbaijan,AZE,Belgium,BEL,0,0,24,0,24
2014,Burundi,BDI,Belgium,BEL,0,0,49,5,54
2014,Benin,BEN,Belgium,BEL,5,0,48,0,53
2014,Bangladesh,BGD,Belgium,BEL,0,0,248,11,259
2014,Bhutan,BTN,Belgium,BEL,0,0,5,0,5
2014,Burkina Faso,BFA,Belgium,BEL,5,0,49,5,59
2014,Belarus,BLR,Belgium,BEL,0,0,17,0,17
2014,Bosnia and Herzegovina,BIH,Belgium,BEL,0,0,5,0,5
2014,Bulgaria,BGR,Belgium,BEL,0,0,0,5,5
2014,Chad,TCD,Belgium,BEL,0,0,5,0,5
2014,China,CHN,Belgium,BEL,0,0,147,5,152
2014,Cameroon,CMR,Belgium,BEL,13,0,145,14,172
2014,Congo,COG,Belgium,BEL,0,0,10,0,10
2014,Dem. Rep. of the Congo,COD,Belgium,BEL,19,5,702,30,756
2014,Colombia,COL,Belgium,BEL,0,0,5,0,5
2014,Djibouti,DJI,Belgium,BEL,5,0,20,5,30
2014,Eritrea,ERI,Belgium,BEL,0,0,12,0,12
2014,Ethiopia,ETH,Belgium,BEL,0,0,13,0,13
2014,Gambia,GMB,Belgium,BEL,0,0,25,0,25
2014,Palestinian,PSE,Belgium,BEL,0,0,17,0,17
2014,Georgia,GEO,Belgium,BEL,0,0,68,5,73
2014,Ghana,GHA,Belgium,BEL,0,0,17,5,22
2014,Guinea-Bissau,GNB,Belgium,BEL,0,0,10,0,10
2014,Guinea,GIN,Belgium,BEL,89,5,579,30,703
2014,Cote d'Ivoire,CIV,Belgium,BEL,10,0,109,5,124
2014,India,IND,Belgium,BEL,0,0,16,0,16
2014,Iran (Islamic Rep. of),IRN,Belgium,BEL,0,0,131,12,143
2014,Iraq,IRQ,Belgium,BEL,0,0,74,10,84
2014,Jordan,JOR,Belgium,BEL,0,0,15,0,15
2014,Kazakhstan,KAZ,Belgium,BEL,0,0,24,0,24
2014,Kenya,KEN,Belgium,BEL,0,0,14,0,14
2014,Kyrgyzstan,KGZ,Belgium,BEL,0,0,25,0,25
2014,Liberia,LBR,Belgium,BEL,0,0,10,0,10
2014,Libya,LBY,Belgium,BEL,0,0,5,0,5
2014,Lebanon,LBN,Belgium,BEL,0,0,26,5,31
2014,Sri Lanka,LKA,Belgium,BEL,0,0,18,5,23
2014,Mauritania,MRT,Belgium,BEL,19,0,87,5,111
2014,North Macedonia,MKD,Belgium,BEL,0,0,16,5,21
2014,Rep. of Moldova,MDA,Belgium,BEL,0,0,5,0,5
2014,Mali,MLI,Belgium,BEL,0,0,73,5,78
2014,Mongolia,MNG,Belgium,BEL,0,0,10,0,10
2014,Morocco,MAR,Belgium,BEL,0,0,47,10,57
2014,Myanmar,MMR,Belgium,BEL,0,0,11,0,11
2014,Nepal,NPL,Belgium,BEL,0,0,101,5,106
2014,Niger,NER,Belgium,BEL,5,0,59,5,69
2014,Nigeria,NGA,Belgium,BEL,0,0,53,5,58
2014,Pakistan,PAK,Belgium,BEL,0,0,251,15,266
2014,South Africa,ZAF,Belgium,BEL,0,0,5,0,5
2014,Russian Federation,RUS,Belgium,BEL,12,0,176,11,199
2014,Rwanda,RWA,Belgium,BEL,24,0,152,5,181
2014,El Salvador,SLV,Belgium,BEL,0,0,14,0,14
2014,Serbia and Kosovo: S/RES/1244 (1999),SRB,Belgium,BEL,5,0,66,5,76
2014,Senegal,SEN,Belgium,BEL,38,0,161,5,204
2014,Sierra Leone,SLE,Belgium,BEL,0,0,41,5,46
2014,Somalia,SOM,Belgium,BEL,0,0,33,0,33
2014,Sudan,SDN,Belgium,BEL,0,0,17,0,17
2014,Syrian Arab Rep.,SYR,Belgium,BEL,5,5,22,0,32
2014,United Rep. of Tanzania,TZA,Belgium,BEL,5,0,14,0,19
2014,Togo,TGO,Belgium,BEL,10,0,168,5,183
2014,Tunisia,TUN,Belgium,BEL,0,0,20,0,20
2014,Turkey,TUR,Belgium,BEL,21,0,117,10,148
2014,Uganda,UGA,Belgium,BEL,0,0,15,0,15
2014,Ukraine,UKR,Belgium,BEL,0,0,18,0,18
2014,Uzbekistan,UZB,Belgium,BEL,0,0,5,0,5
2014,Venezuela (Bolivarian Republic of),VEN,Belgium,BEL,0,0,5,0,5
2014,Yemen,YEM,Belgium,BEL,0,0,5,0,5
2014,Stateless,XXA,Belgium,BEL,0,0,5,0,5
2015,Afghanistan,AFG,Belgium,BEL,0,5,196,24,225
2015,Albania,ALB,Belgium,BEL,11,0,174,76,261
2015,Algeria,DZA,Belgium,BEL,0,0,16,5,21
2015,Angola,AGO,Belgium,BEL,0,0,58,13,71
2015,Egypt,EGY,Belgium,BEL,0,0,41,10,51
2015,Armenia,ARM,Belgium,BEL,5,0,70,21,96
2015,Azerbaijan,AZE,Belgium,BEL,0,0,19,5,24
2015,Burundi,BDI,Belgium,BEL,0,0,27,17,44
2015,Benin,BEN,Belgium,BEL,0,0,31,10,41
2015,Bangladesh,BGD,Belgium,BEL,0,0,57,22,79
2015,Burkina Faso,BFA,Belgium,BEL,0,0,28,5,33
2015,Belarus,BLR,Belgium,BEL,0,0,5,0,5
2015,Bosnia and Herzegovina,BIH,Belgium,BEL,0,0,5,0,5
2015,Central African Rep.,CAF,Belgium,BEL,5,0,0,0,5
2015,Chad,TCD,Belgium,BEL,0,0,5,0,5
2015,China,CHN,Belgium,BEL,0,0,173,10,183
2015,Cameroon,CMR,Belgium,BEL,13,0,129,19,161
2015,Congo,COG,Belgium,BEL,0,0,5,5,10
2015,Dem. Rep. of the Congo,COD,Belgium,BEL,11,5,297,65,378
2015,Djibouti,DJI,Belgium,BEL,5,0,43,10,58
2015,Equatorial Guinea,GNQ,Belgium,BEL,0,0,5,0,5
2015,Eritrea,ERI,Belgium,BEL,0,0,24,5,29
2015,Ethiopia,ETH,Belgium,BEL,0,0,25,0,25
2015,Gambia,GMB,Belgium,BEL,0,0,23,5,28
2015,Palestinian,PSE,Belgium,BEL,5,0,32,10,47
2015,Georgia,GEO,Belgium,BEL,0,0,74,16,90
2015,Ghana,GHA,Belgium,BEL,0,0,14,0,14
2015,Guinea,GIN,Belgium,BEL,73,0,251,63,387
2015,Haiti,HTI,Belgium,BEL,0,0,11,0,11
2015,Cote d'Ivoire,CIV,Belgium,BEL,5,0,53,20,78
2015,India,IND,Belgium,BEL,0,0,0,5,5
2015,Indonesia,IDN,Belgium,BEL,0,0,19,0,19
2015,Iran (Islamic Rep. of),IRN,Belgium,BEL,0,0,84,26,110
2015,Iraq,IRQ,Belgium,BEL,5,5,81,24,115
2015,Jordan,JOR,Belgium,BEL,0,0,12,0,12
2015,Kazakhstan,KAZ,Belgium,BEL,0,0,10,5,15
2015,Kenya,KEN,Belgium,BEL,0,0,11,0,11
2015,Kyrgyzstan,KGZ,Belgium,BEL,0,0,5,0,5
2015,Liberia,LBR,Belgium,BEL,0,0,12,0,12
2015,Libya,LBY,Belgium,BEL,0,0,5,0,5
2015,Lebanon,LBN,Belgium,BEL,5,0,60,5,70
2015,Sri Lanka,LKA,Belgium,BEL,0,0,10,5,15
2015,Mauritania,MRT,Belgium,BEL,5,0,47,15,67
2015,North Macedonia,MKD,Belgium,BEL,0,0,45,31,76
2015,Mali,MLI,Belgium,BEL,5,0,28,0,33
2015,Mongolia,MNG,Belgium,BEL,0,0,5,0,5
2015,Morocco,MAR,Belgium,BEL,0,0,36,5,41
2015,Montenegro,MNE,Belgium,BEL,0,0,5,0,5
2015,Myanmar,MMR,Belgium,BEL,0,0,15,5,20
2015,Nepal,NPL,Belgium,BEL,0,0,15,5,20
2015,Niger,NER,Belgium,BEL,5,0,32,10,47
2015,Nigeria,NGA,Belgium,BEL,0,5,49,0,54
2015,Pakistan,PAK,Belgium,BEL,0,0,109,25,134
2015,Poland,POL,Belgium,BEL,0,0,0,5,5
2015,Russian Federation,RUS,Belgium,BEL,5,0,216,52,273
2015,Rwanda,RWA,Belgium,BEL,15,0,118,27,160
2015,Serbia and Kosovo: S/RES/1244 (1999),SRB,Belgium,BEL,14,0,126,62,202
2015,Senegal,SEN,Belgium,BEL,37,0,112,14,163
2015,Sierra Leone,SLE,Belgium,BEL,0,0,11,0,11
2015,Somalia,SOM,Belgium,BEL,0,0,39,10,49
2015,Sudan,SDN,Belgium,BEL,0,0,27,10,37
2015,Syrian Arab Rep.,SYR,Belgium,BEL,0,0,16,5,21
2015,United Rep. of Tanzania,TZA,Belgium,BEL,0,0,0,14,14
2015,Togo,TGO,Belgium,BEL,10,0,66,22,98
2015,Tunisia,TUN,Belgium,BEL,0,0,14,0,14
2015,Turkey,TUR,Belgium,BEL,5,0,65,33,103
2015,United Arab Emirates,ARE,Belgium,BEL,0,0,5,0,5
2015,Uganda,UGA,Belgium,BEL,0,0,13,0,13
2015,Ukraine,UKR,Belgium,BEL,0,0,108,11,119
2015,Uzbekistan,UZB,Belgium,BEL,0,0,0,5,5
2015,Stateless,XXA,Belgium,BEL,0,0,5,0,5
2016,Afghanistan,AFG,Belgium,BEL,5,0,346,10,361
2016,Albania,ALB,Belgium,BEL,19,0,242,5,266
2016,Algeria,DZA,Belgium,BEL,0,0,21,0,21
2016,Angola,AGO,Belgium,BEL,0,0,26,0,26
2016,Egypt,EGY,Belgium,BEL,0,0,24,0,24
2016,Armenia,ARM,Belgium,BEL,0,0,64,5,69
2016,Azerbaijan,AZE,Belgium,BEL,0,0,15,0,15
2016,Burundi,BDI,Belgium,BEL,0,0,34,29,63
2016,Benin,BEN,Belgium,BEL,0,0,5,0,5
2016,Bangladesh,BGD,Belgium,BEL,0,0,57,0,57
2016,Burkina Faso,BFA,Belgium,BEL,0,0,13,0,13
2016,Belarus,BLR,Belgium,BEL,0,0,5,0,5
2016,Bosnia and Herzegovina,BIH,Belgium,BEL,0,0,12,0,12
2016,Chad,TCD,Belgium,BEL,0,0,5,0,5
2016,China,CHN,Belgium,BEL,0,0,28,5,33
2016,Cameroon,CMR,Belgium,BEL,10,0,99,5,114
2016,Congo,COG,Belgium,BEL,0,0,5,0,5
2016,Dem. Rep. of the Congo,COD,Belgium,BEL,23,0,318,14,355
2016,Djibouti,DJI,Belgium,BEL,0,0,26,5,31
2016,Dominican Rep.,DOM,Belgium,BEL,0,0,5,0,5
2016,Eritrea,ERI,Belgium,BEL,0,0,31,0,31
2016,Ethiopia,ETH,Belgium,BEL,0,0,48,0,48
2016,Gabon,GAB,Belgium,BEL,0,0,5,0,5
2016,Gambia,GMB,Belgium,BEL,0,0,16,0,16
2016,Palestinian,PSE,Belgium,BEL,0,0,14,0,14
2016,Georgia,GEO,Belgium,BEL,0,0,63,0,63
2016,Ghana,GHA,Belgium,BEL,0,0,18,0,18
2016,Guinea,GIN,Belgium,BEL,32,0,211,11,254
2016,Cote d'Ivoire,CIV,Belgium,BEL,0,0,45,5,50
2016,India,IND,Belgium,BEL,0,0,23,0,23
2016,Iran (Islamic Rep. of),IRN,Belgium,BEL,0,0,40,0,40
2016,Iraq,IRQ,Belgium,BEL,38,10,578,18,644
2016,Jordan,JOR,Belgium,BEL,0,0,5,0,5
2016,Kazakhstan,KAZ,Belgium,BEL,5,0,5,0,10
2016,Kenya,KEN,Belgium,BEL,0,0,11,0,11
2016,Kyrgyzstan,KGZ,Belgium,BEL,0,0,5,0,5
2016,Liberia,LBR,Belgium,BEL,0,5,0,0,5
2016,Lebanon,LBN,Belgium,BEL,0,0,24,0,24
2016,Sri Lanka,LKA,Belgium,BEL,0,0,14,0,14
2016,Mauritania,MRT,Belgium,BEL,5,0,30,5,40
2016,North Macedonia,MKD,Belgium,BEL,5,0,46,0,51
2016,Rep. of Moldova,MDA,Belgium,BEL,0,0,5,0,5
2016,Mexico,MEX,Belgium,BEL,0,0,5,0,5
2016,Mali,MLI,Belgium,BEL,0,0,14,0,14
2016,Morocco,MAR,Belgium,BEL,0,0,43,5,48
2016,Montenegro,MNE,Belgium,BEL,0,0,10,0,10
2016,Nepal,NPL,Belgium,BEL,0,0,23,0,23
2016,Niger,NER,Belgium,BEL,0,0,30,0,30
2016,Nigeria,NGA,Belgium,BEL,0,0,47,0,47
2016,Pakistan,PAK,Belgium,BEL,0,0,148,10,158
2016,Russian Federation,RUS,Belgium,BEL,10,0,188,10,208
2016,Rwanda,RWA,Belgium,BEL,10,0,115,16,141
2016,Serbia and Kosovo: S/RES/1244 (1999),SRB,Belgium,BEL,10,0,137,10,157
2016,Senegal,SEN,Belgium,BEL,13,0,80,5,98
2016,Sierra Leone,SLE,Belgium,BEL,0,0,5,0,5
2016,Somalia,SOM,Belgium,BEL,5,0,240,0,245
2016,Sudan,SDN,Belgium,BEL,0,0,19,0,19
2016,Syrian Arab Rep.,SYR,Belgium,BEL,5,0,27,0,32
2016,United Rep. of Tanzania,TZA,Belgium,BEL,0,0,5,0,5
2016,Tajikistan,TJK,Belgium,BEL,0,0,5,0,5
2016,Togo,TGO,Belgium,BEL,10,0,75,0,85
2016,Tunisia,TUN,Belgium,BEL,0,0,17,0,17
2016,Turkey,TUR,Belgium,BEL,10,0,34,10,54
2016,Ukraine,UKR,Belgium,BEL,5,0,72,0,77
2016,Uzbekistan,UZB,Belgium,BEL,0,0,5,0,5
2016,Zimbabwe,ZWE,Belgium,BEL,0,0,10,0,10
2003,Algeria,DZA,Spain,ESP,0,5,12,0,17
2003,Angola,AGO,Spain,ESP,0,0,5,0,5
2003,Armenia,ARM,Spain,ESP,0,11,36,0,47
2003,Dem. Rep. of the Congo,COD,Spain,ESP,0,0,12,0,12
2003,Colombia,COL,Spain,ESP,5,0,24,0,29
2003,Cuba,CUB,Spain,ESP,0,0,13,0,13
2003,Equatorial Guinea,GNQ,Spain,ESP,5,0,5,0,10
2003,Georgia,GEO,Spain,ESP,0,0,12,0,12
2003,Iran (Islamic Rep. of),IRN,Spain,ESP,0,0,5,0,5
2003,Nigeria,NGA,Spain,ESP,0,0,5,0,5
2003,Russian Federation,RUS,Spain,ESP,5,0,10,0,15
2003,Serbia and Kosovo: S/RES/1244 (1999),SRB,Spain,ESP,0,0,5,0,5
2003,Tajikistan,TJK,Spain,ESP,0,0,5,0,5
2003,Turkey,TUR,Spain,ESP,0,0,5,0,5
2003,Ukraine,UKR,Spain,ESP,0,0,5,0,5
2003,Afghanistan,AFG,Ukraine,UKR,0,41,50,0,91
2003,Angola,AGO,Ukraine,UKR,0,35,10,0,45
2003,Armenia,ARM,Ukraine,UKR,0,0,14,0,14
2003,Bangladesh,BGD,Ukraine,UKR,0,0,5,0,5
2003,Chad,TCD,Ukraine,UKR,0,5,0,0,5
2003,China,CHN,Ukraine,UKR,0,0,5,0,5
2003,Ethiopia,ETH,Ukraine,UKR,0,14,0,0,14
2003,Palestinian,PSE,Ukraine,UKR,0,0,5,0,5
2003,Georgia,GEO,Ukraine,UKR,0,0,5,0,5
2003,Guinea,GIN,Ukraine,UKR,0,5,0,0,5
2003,India,IND,Ukraine,UKR,0,0,5,0,5
2003,Iran (Islamic Rep. of),IRN,Ukraine,UKR,0,20,10,0,30
2003,Iraq,IRQ,Ukraine,UKR,0,27,41,0,68
2003,Lebanon,LBN,Ukraine,UKR,0,0,5,0,5
2003,Sri Lanka,LKA,Ukraine,UKR,0,17,18,0,35
2003,Nigeria,NGA,Ukraine,UKR,0,0,10,0,10
2003,Russian Federation,RUS,Ukraine,UKR,0,5,22,0,27
2003,Somalia,SOM,Ukraine,UKR,0,27,11,0,38
2003,Syrian Arab Rep.,SYR,Ukraine,UKR,0,5,0,0,5
2004,Afghanistan,AFG,Azerbaijan,AZE,0,0,5,0,5
2004,Afghanistan,AFG,Japan,JPN,0,0,0,15,15
2004,Myanmar,MMR,Japan,JPN,0,0,0,13,13
2004,Colombia,COL,Spain,ESP,14,10,0,0,24
2004,Equatorial Guinea,GNQ,Spain,ESP,5,0,0,0,5
2004,Ethiopia,ETH,Spain,ESP,5,0,0,0,5
2004,Iraq,IRQ,Spain,ESP,0,5,0,0,5
2004,Russian Federation,RUS,Spain,ESP,5,5,0,0,10
2005,Afghanistan,AFG,Azerbaijan,AZE,0,0,65,5,70
2005,Pakistan,PAK,Azerbaijan,AZE,0,0,10,0,10
2005,Iran (Islamic Rep. of),IRN,Japan,JPN,0,0,0,5,5
2005,Myanmar,MMR,Japan,JPN,0,0,0,15,15
2005,Afghanistan,AFG,Ukraine,UKR,0,0,31,50,81
2005,Angola,AGO,Ukraine,UKR,0,0,11,5,16
2005,Armenia,ARM,Ukraine,UKR,0,0,0,11,11
2005,Azerbaijan,AZE,Ukraine,UKR,0,0,5,5,10
2005,Bangladesh,BGD,Ukraine,UKR,0,0,30,11,41
2005,Chad,TCD,Ukraine,UKR,0,0,5,14,19
2005,China,CHN,Ukraine,UKR,0,0,26,0,26
2005,Congo,COG,Ukraine,UKR,0,0,0,10,10
2005,Dem. Rep. of the Congo,COD,Ukraine,UKR,0,0,14,0,14
2005,Ethiopia,ETH,Ukraine,UKR,0,0,0,11,11
2005,Palestinian,PSE,Ukraine,UKR,0,0,22,11,33
2005,Georgia,GEO,Ukraine,UKR,0,0,0,5,5
2005,Guinea-Bissau,GNB,Ukraine,UKR,0,0,0,5,5
2005,India,IND,Ukraine,UKR,0,0,131,5,136
2005,Iran (Islamic Rep. of),IRN,Ukraine,UKR,0,0,5,30,35
2005,Iraq,IRQ,Ukraine,UKR,5,0,14,17,36
2005,Jordan,JOR,Ukraine,UKR,0,0,5,0,5
2005,Kenya,KEN,Ukraine,UKR,0,0,0,10,10
2005,Sri Lanka,LKA,Ukraine,UKR,0,0,5,13,18
2005,Nigeria,NGA,Ukraine,UKR,0,0,25,0,25
2005,Pakistan,PAK,Ukraine,UKR,0,0,45,17,62
2005,Russian Federation,RUS,Ukraine,UKR,0,0,10,16,26
2005,Sierra Leone,SLE,Ukraine,UKR,0,0,5,0,5
2005,Somalia,SOM,Ukraine,UKR,0,0,5,5,10
2005,Viet Nam,VNM,Ukraine,UKR,0,0,13,0,13
2005,Sudan,SDN,Ukraine,UKR,0,0,0,5,5
2005,Syrian Arab Rep.,SYR,Ukraine,UKR,0,0,0,12,12
2010,Afghanistan,AFG,Netherlands,NLD,5,83,86,0,174
2010,Angola,AGO,Netherlands,NLD,0,5,5,0,10
2010,Armenia,ARM,Netherlands,NLD,5,29,32,0,66
2010,Azerbaijan,AZE,Netherlands,NLD,0,5,11,0,16
2010,Burundi,BDI,Netherlands,NLD,0,11,5,0,16
2010,Benin,BEN,Netherlands,NLD,0,5,0,0,5
2010,Bangladesh,BGD,Netherlands,NLD,0,0,5,0,5
2010,China,CHN,Netherlands,NLD,0,11,13,0,24
2010,Congo,COG,Netherlands,NLD,0,12,12,0,24
2010,Colombia,COL,Netherlands,NLD,0,5,5,0,10
2010,Eritrea,ERI,Netherlands,NLD,0,11,13,0,24
2010,Georgia,GEO,Netherlands,NLD,0,5,0,0,5
2010,Guinea,GIN,Netherlands,NLD,0,11,11,0,22
2010,Cote d'Ivoire,CIV,Netherlands,NLD,0,5,0,0,5
2010,Iran (Islamic Rep. of),IRN,Netherlands,NLD,14,14,28,0,56
2010,Iraq,IRQ,Netherlands,NLD,39,182,221,0,442
2010,Kenya,KEN,Netherlands,NLD,0,14,0,0,14
2010,Libya,LBY,Netherlands,NLD,0,5,5,0,10
2010,Sri Lanka,LKA,Netherlands,NLD,5,22,25,0,52
2010,Myanmar,MMR,Netherlands,NLD,0,0,5,0,5
2010,Nepal,NPL,Netherlands,NLD,5,0,0,0,5
2010,Nigeria,NGA,Netherlands,NLD,0,0,5,0,5
2010,Russian Federation,RUS,Netherlands,NLD,0,5,5,0,10
2010,Serbia and Kosovo: S/RES/1244 (1999),SRB,Netherlands,NLD,0,5,0,0,5
2010,Sierra Leone,SLE,Netherlands,NLD,0,13,5,0,18
2010,Somalia,SOM,Netherlands,NLD,0,94,96,0,190
2010,Sudan,SDN,Netherlands,NLD,0,5,5,0,10
2010,Syrian Arab Rep.,SYR,Netherlands,NLD,0,5,11,0,16
2010,Turkey,TUR,Netherlands,NLD,0,0,12,0,12
2010,Uganda,UGA,Netherlands,NLD,0,0,5,0,5
2010,Uzbekistan,UZB,Netherlands,NLD,0,0,5,0,5
2010,Stateless,XXA,Netherlands,NLD,0,5,5,0,10
2010,Afghanistan,AFG,Sweden,SWE,36,71,413,76,596
2010,Albania,ALB,Sweden,SWE,0,10,69,5,84
2010,Algeria,DZA,Sweden,SWE,0,0,79,14,93
2010,Angola,AGO,Sweden,SWE,0,0,14,0,14
2010,Egypt,EGY,Sweden,SWE,5,0,81,38,124
2010,Armenia,ARM,Sweden,SWE,0,16,215,30,261
2010,Azerbaijan,AZE,Sweden,SWE,0,10,255,77,342
2010,Burundi,BDI,Sweden,SWE,5,5,67,5,82
2010,Bangladesh,BGD,Sweden,SWE,0,5,97,22,124
2010,Bhutan,BTN,Sweden,SWE,0,0,10,0,10
2010,Burkina Faso,BFA,Sweden,SWE,0,0,5,0,5
2010,Belarus,BLR,Sweden,SWE,0,0,142,50,192
2010,Bolivia (Plurinational State of),BOL,Sweden,SWE,0,0,38,11,49
2010,Brazil,BRA,Sweden,SWE,0,0,5,0,5
2010,Bosnia and Herzegovina,BIH,Sweden,SWE,0,5,72,5,82
2010,Chad,TCD,Sweden,SWE,0,0,5,0,5
2010,China,CHN,Sweden,SWE,15,0,34,5,54
2010,Chile,CHL,Sweden,SWE,0,0,11,0,11
2010,Cameroon,CMR,Sweden,SWE,0,0,21,5,26
2010,Dem. Rep. of the Congo,COD,Sweden,SWE,0,5,65,5,75
2010,Colombia,COL,Sweden,SWE,0,0,11,0,11
2010,Cuba,CUB,Sweden,SWE,0,0,26,5,31
2010,Eritrea,ERI,Sweden,SWE,14,21,153,32,220
2010,Ethiopia,ETH,Sweden,SWE,16,5,163,10,194
2010,Gambia,GMB,Sweden,SWE,0,0,20,5,25
2010,Georgia,GEO,Sweden,SWE,0,5,145,34,184
2010,Ghana,GHA,Sweden,SWE,0,0,28,5,33
2010,Guinea-Bissau,GNB,Sweden,SWE,0,0,5,0,5
2010,Guinea,GIN,Sweden,SWE,0,0,35,0,35
2010,Cote d'Ivoire,CIV,Sweden,SWE,0,0,25,5,30
2010,India,IND,Sweden,SWE,0,5,33,5,43
2010,Indonesia,IDN,Sweden,SWE,0,0,12,0,12
2010,Iran (Islamic Rep. of),IRN,Sweden,SWE,65,55,558,98,776
2010,Iraq,IRQ,Sweden,SWE,60,147,3498,343,4048
2010,Israel,ISR,Sweden,SWE,0,0,10,5,15
2010,Jordan,JOR,Sweden,SWE,0,5,108,44,157
2010,Kazakhstan,KAZ,Sweden,SWE,0,5,184,33,222
2010,Kenya,KEN,Sweden,SWE,0,0,59,23,82
2010,Kyrgyzstan,KGZ,Sweden,SWE,0,0,112,17,129
2010,Dem. People's Rep. of Korea,PRK,Sweden,SWE,0,0,5,0,5
2010,Liberia,LBR,Sweden,SWE,0,0,18,0,18
2010,Libya,LBY,Sweden,SWE,5,0,379,58,442
2010,Lebanon,LBN,Sweden,SWE,5,5,175,29,214
2010,Sri Lanka,LKA,Sweden,SWE,0,0,38,5,43
2010,North Macedonia,MKD,Sweden,SWE,0,0,115,32,147
2010,Rep. of Moldova,MDA,Sweden,SWE,0,0,10,0,10
2010,Mexico,MEX,Sweden,SWE,0,0,5,0,5
2010,Mongolia,MNG,Sweden,SWE,0,5,484,87,576
2010,Morocco,MAR,Sweden,SWE,0,0,24,5,29
2010,Montenegro,MNE,Sweden,SWE,0,0,28,0,28
2010,Nepal,NPL,Sweden,SWE,0,0,53,5,58
2010,Nicaragua,NIC,Sweden,SWE,0,5,17,5,27
2010,Nigeria,NGA,Sweden,SWE,5,10,166,27,208
2010,Pakistan,PAK,Sweden,SWE,0,10,44,12,66
2010,Peru,PER,Sweden,SWE,0,0,14,10,24
2010,Philippines,PHL,Sweden,SWE,0,0,5,0,5
2010,Russian Federation,RUS,Sweden,SWE,5,18,504,82,609
2010,Rwanda,RWA,Sweden,SWE,0,0,10,0,10
2010,El Salvador,SLV,Sweden,SWE,0,0,48,5,53
2010,Serbia and Kosovo: S/RES/1244 (1999),SRB,Sweden,SWE,0,54,2319,361,2734
2010,Senegal,SEN,Sweden,SWE,0,0,5,0,5
2010,Sierra Leone,SLE,Sweden,SWE,0,0,19,0,19
2010,Somalia,SOM,Sweden,SWE,5,377,690,65,1137
2010,Viet Nam,VNM,Sweden,SWE,0,5,103,5,113
2010,Sudan,SDN,Sweden,SWE,5,5,40,5,55
2010,Syrian Arab Rep.,SYR,Sweden,SWE,5,14,481,68,568
2010,United Rep. of Tanzania,TZA,Sweden,SWE,0,0,21,15,36
2010,Thailand,THA,Sweden,SWE,0,0,12,0,12
2010,Tajikistan,TJK,Sweden,SWE,0,0,16,0,16
2010,Turkmenistan,TKM,Sweden,SWE,0,0,10,0,10
2010,Tunisia,TUN,Sweden,SWE,0,0,37,12,49
2010,Turkey,TUR,Sweden,SWE,0,5,133,50,188
2010,Uganda,UGA,Sweden,SWE,0,0,46,0,46
2010,Ukraine,UKR,Sweden,SWE,0,0,62,10,72
2010,Uzbekistan,UZB,Sweden,SWE,10,11,398,45,464
2010,Venezuela (Bolivarian Republic of),VEN,Sweden,SWE,0,0,10,0,10
2010,Yemen,YEM,Sweden,SWE,12,5,96,13,126
2010,Stateless,XXA,Sweden,SWE,10,63,586,58,717
2011,Iran (Islamic Rep. of),IRN,Armenia,ARM,0,0,0,5,5
2011,Afghanistan,AFG,France,FRA,65,109,118,0,292
2011,Albania,ALB,France,FRA,19,59,268,0,346
2011,Algeria,DZA,France,FRA,29,23,579,0,631
2011,Angola,AGO,France,FRA,46,5,407,0,458
2011,Egypt,EGY,France,FRA,42,0,19,0,61
2011,Armenia,ARM,France,FRA,170,62,2133,0,2365
2011,Azerbaijan,AZE,France,FRA,126,11,427,0,564
2011,Burundi,BDI,France,FRA,0,0,12,0,12
2011,Benin,BEN,France,FRA,0,0,5,0,5
2011,Bangladesh,BGD,France,FRA,333,10,2086,0,2429
2011,Bhutan,BTN,France,FRA,14,0,0,0,14
2011,Burkina Faso,BFA,France,FRA,5,0,21,0,26
2011,Belarus,BLR,France,FRA,16,0,30,0,46
2011,Bolivia (Plurinational State of),BOL,France,FRA,0,0,5,0,5
2011,Brazil,BRA,France,FRA,0,0,5,0,5
2011,Bosnia and Herzegovina,BIH,France,FRA,19,5,230,0,254
2011,Cambodia,KHM,France,FRA,0,0,10,0,10
2011,Central African Rep.,CAF,France,FRA,10,0,75,0,85
2011,Chad,TCD,France,FRA,52,0,124,0,176
2011,China,CHN,France,FRA,20,5,824,0,849
2011,Cameroon,CMR,France,FRA,19,5,110,0,134
2011,Congo,COG,France,FRA,46,13,510,0,569
2011,Dem. Rep. of the Congo,COD,France,FRA,276,33,1723,0,2032
2011,Comoros,COM,France,FRA,5,0,205,0,210
2011,Colombia,COL,France,FRA,14,5,46,0,65
2011,Djibouti,DJI,France,FRA,0,0,5,0,5
2011,Dominican Rep.,DOM,France,FRA,0,0,31,0,31
2011,Ecuador,ECU,France,FRA,0,0,5,0,5
2011,Eritrea,ERI,France,FRA,58,15,79,0,152
2011,Ethiopia,ETH,France,FRA,14,0,25,0,39
2011,Gabon,GAB,France,FRA,0,0,12,0,12
2011,Gambia,GMB,France,FRA,0,5,37,0,42
2011,Palestinian,PSE,France,FRA,10,0,27,0,37
2011,Georgia,GEO,France,FRA,75,5,426,0,506
2011,Ghana,GHA,France,FRA,0,0,14,0,14
2011,Guinea-Bissau,GNB,France,FRA,5,0,94,0,99
2011,Guinea,GIN,France,FRA,207,61,1243,0,1511
2011,Haiti,HTI,France,FRA,30,64,1093,0,1187
2011,Cote d'Ivoire,CIV,France,FRA,26,28,283,0,337
2011,India,IND,France,FRA,0,0,35,0,35
2011,Iran (Islamic Rep. of),IRN,France,FRA,45,0,39,0,84
2011,Iraq,IRQ,France,FRA,20,5,49,0,74
2011,Israel,ISR,France,FRA,0,0,5,0,5
2011,Kazakhstan,KAZ,France,FRA,5,10,74,0,89
2011,Kenya,KEN,France,FRA,0,0,14,0,14
2011,Kyrgyzstan,KGZ,France,FRA,20,5,33,0,58
2011,Dem. People's Rep. of Korea,PRK,France,FRA,0,0,19,0,19
2011,Liberia,LBR,France,FRA,0,0,18,0,18
2011,Lebanon,LBN,France,FRA,0,0,21,0,21
2011,Sri Lanka,LKA,France,FRA,843,47,2254,0,3144
2011,Madagascar,MDG,France,FRA,11,0,77,0,88
2011,Mauritania,MRT,France,FRA,92,23,1066,0,1181
2011,North Macedonia,MKD,France,FRA,15,0,252,0,267
2011,Rep. of Moldova,MDA,France,FRA,5,5,120,0,130
2011,Mexico,MEX,France,FRA,0,0,5,0,5
2011,Mali,MLI,France,FRA,5,79,123,0,207
2011,Mongolia,MNG,France,FRA,10,10,113,0,133
2011,Morocco,MAR,France,FRA,0,0,31,0,31
2011,Montenegro,MNE,France,FRA,10,0,45,0,55
2011,Myanmar,MMR,France,FRA,5,0,17,0,22
2011,Nepal,NPL,France,FRA,5,0,30,0,35
2011,Niger,NER,France,FRA,5,0,10,0,15
2011,Nigeria,NGA,France,FRA,19,26,486,0,531
2011,Pakistan,PAK,France,FRA,48,5,474,0,527
2011,Peru,PER,France,FRA,5,5,98,0,108
2011,Philippines,PHL,France,FRA,0,0,5,0,5
2011,South Africa,ZAF,France,FRA,0,0,5,0,5
2011,Russian Federation,RUS,France,FRA,791,100,1219,0,2110
2011,Rwanda,RWA,France,FRA,32,0,41,0,73
2011,Serbia and Kosovo: S/RES/1244 (1999),SRB,France,FRA,591,232,3108,0,3931
2011,Senegal,SEN,France,FRA,15,14,64,0,93
2011,Sierra Leone,SLE,France,FRA,5,5,92,0,102
2011,Somalia,SOM,France,FRA,10,15,29,0,54
2011,Viet Nam,VNM,France,FRA,0,0,13,0,13
2011,Sudan,SDN,France,FRA,186,43,366,0,595
2011,Suriname,SUR,France,FRA,0,0,5,0,5
2011,Syrian Arab Rep.,SYR,France,FRA,42,5,5,0,52
2011,Thailand,THA,France,FRA,0,0,14,0,14
2011,Tajikistan,TJK,France,FRA,0,0,11,0,11
2011,Togo,TGO,France,FRA,10,0,112,0,122
2011,Tunisia,TUN,France,FRA,0,0,17,0,17
2011,Turkey,TUR,France,FRA,202,12,1467,0,1681
2011,Uganda,UGA,France,FRA,5,0,5,0,10
2011,Ukraine,UKR,France,FRA,5,0,46,0,51
2011,Uzbekistan,UZB,France,FRA,0,5,13,0,18
2011,Western Sahara,ESH,France,FRA,0,0,5,0,5
2011,Zimbabwe,ZWE,France,FRA,0,0,5,0,5
2011,Serbia and Kosovo: S/RES/1244 (1999),SRB,Luxembourg,LUX,0,0,0,14,14
2011,Afghanistan,AFG,Netherlands,NLD,18,299,278,0,595
2011,Angola,AGO,Netherlands,NLD,0,0,5,0,5
2011,Egypt,EGY,Netherlands,NLD,0,0,5,0,5
2011,Armenia,ARM,Netherlands,NLD,5,12,28,0,45
2011,Azerbaijan,AZE,Netherlands,NLD,0,0,11,0,11
2011,Burundi,BDI,Netherlands,NLD,0,0,10,0,10
2011,Bangladesh,BGD,Netherlands,NLD,0,0,5,0,5
2011,Burkina Faso,BFA,Netherlands,NLD,0,0,5,0,5
2011,Bosnia and Herzegovina,BIH,Netherlands,NLD,0,0,5,0,5
2011,China,CHN,Netherlands,NLD,14,33,12,0,59
2011,Cameroon,CMR,Netherlands,NLD,0,0,5,0,5
2011,Congo,COG,Netherlands,NLD,0,0,13,0,13
2011,Dem. Rep. of the Congo,COD,Netherlands,NLD,0,0,5,0,5
2011,Eritrea,ERI,Netherlands,NLD,5,47,15,0,67
2011,Ethiopia,ETH,Netherlands,NLD,0,11,10,0,21
2011,Palestinian,PSE,Netherlands,NLD,0,0,5,0,5
2011,Georgia,GEO,Netherlands,NLD,0,0,19,0,19
2011,Guinea,GIN,Netherlands,NLD,0,16,24,0,40
2011,Cote d'Ivoire,CIV,Netherlands,NLD,0,0,5,0,5
2011,Iran (Islamic Rep. of),IRN,Netherlands,NLD,22,50,44,0,116
2011,Iraq,IRQ,Netherlands,NLD,15,142,179,0,336
2011,Kenya,KEN,Netherlands,NLD,0,0,5,0,5
2011,Liberia,LBR,Netherlands,NLD,0,0,5,0,5
2011,Libya,LBY,Netherlands,NLD,0,0,5,0,5
2011,Sri Lanka,LKA,Netherlands,NLD,5,22,25,0,52
2011,North Macedonia,MKD,Netherlands,NLD,0,0,10,0,10
2011,Mongolia,MNG,Netherlands,NLD,0,0,16,0,16
2011,Myanmar,MMR,Netherlands,NLD,0,5,0,0,5
2011,Nepal,NPL,Netherlands,NLD,0,0,11,0,11
2011,Nigeria,NGA,Netherlands,NLD,0,0,11,0,11
2011,Pakistan,PAK,Netherlands,NLD,0,14,0,0,14
2011,Russian Federation,RUS,Netherlands,NLD,0,5,23,0,28
2011,Rwanda,RWA,Netherlands,NLD,0,0,5,0,5
2011,Serbia and Kosovo: S/RES/1244 (1999),SRB,Netherlands,NLD,0,0,10,0,10
2011,Sierra Leone,SLE,Netherlands,NLD,0,10,10,0,20
2011,Somalia,SOM,Netherlands,NLD,10,675,310,0,995
2011,Sudan,SDN,Netherlands,NLD,10,5,23,0,38
2011,Syrian Arab Rep.,SYR,Netherlands,NLD,0,0,5,0,5
2011,Tajikistan,TJK,Netherlands,NLD,0,5,0,0,5
2011,Turkey,TUR,Netherlands,NLD,0,0,10,0,10
2011,Uganda,UGA,Netherlands,NLD,5,0,5,0,10
2011,Ukraine,UKR,Netherlands,NLD,0,0,5,0,5
2011,Stateless,XXA,Netherlands,NLD,0,0,13,0,13
2011,Afghanistan,AFG,Ukraine,UKR,5,5,38,59,107
2011,Belarus,BLR,Ukraine,UKR,0,0,5,0,5
2011,Cameroon,CMR,Ukraine,UKR,0,0,5,10,15
2011,Congo,COG,Ukraine,UKR,0,0,0,5,5
2011,Dem. Rep. of the Congo,COD,Ukraine,UKR,0,0,5,13,18
2011,Eritrea,ERI,Ukraine,UKR,0,0,0,5,5
2011,Palestinian,PSE,Ukraine,UKR,0,0,0,11,11
2011,Guinea,GIN,Ukraine,UKR,0,0,11,5,16
2011,India,IND,Ukraine,UKR,0,0,5,5,10
2011,Iran (Islamic Rep. of),IRN,Ukraine,UKR,0,0,0,5,5
2011,Iraq,IRQ,Ukraine,UKR,0,0,11,0,11
2011,Kyrgyzstan,KGZ,Ukraine,UKR,0,0,44,26,70
2011,Nepal,NPL,Ukraine,UKR,0,0,5,0,5
2011,Pakistan,PAK,Ukraine,UKR,0,0,0,10,10
2011,Russian Federation,RUS,Ukraine,UKR,0,0,0,12,12
2011,Somalia,SOM,Ukraine,UKR,0,0,5,45,50
2011,Syrian Arab Rep.,SYR,Ukraine,UKR,0,0,10,5,15
2011,Uzbekistan,UZB,Ukraine,UKR,0,0,0,14,14
2012,Iran (Islamic Rep. of),IRN,Armenia,ARM,0,0,0,5,5
2012,Turkey,TUR,Armenia,ARM,0,0,5,0,5
2012,Afghanistan,AFG,Belarus,BLR,0,0,23,0,23
2012,Afghanistan,AFG,Croatia,HRV,0,0,5,0,5
2012,Algeria,DZA,Croatia,HRV,0,0,5,0,5
2012,Morocco,MAR,Croatia,HRV,0,0,5,0,5
2012,Russian Federation,RUS,Croatia,HRV,0,0,5,0,5
2012,Somalia,SOM,Croatia,HRV,0,0,5,0,5
2012,Armenia,ARM,Rep. of Moldova,MDA,0,0,10,0,10
2012,Burundi,BDI,Mozambique,MOZ,0,0,0,25,25
2012,Dem. Rep. of the Congo,COD,Mozambique,MOZ,0,0,0,52,52
2012,Cote d'Ivoire,CIV,Mozambique,MOZ,0,0,0,5,5
2012,Afghanistan,AFG,Netherlands,NLD,5,51,97,0,153
2012,Egypt,EGY,Netherlands,NLD,0,5,0,0,5
2012,Armenia,ARM,Netherlands,NLD,0,10,24,0,34
2012,Azerbaijan,AZE,Netherlands,NLD,0,0,10,0,10
2012,Burundi,BDI,Netherlands,NLD,0,0,10,0,10
2012,Bangladesh,BGD,Netherlands,NLD,0,0,5,0,5
2012,China,CHN,Netherlands,NLD,0,12,0,0,12
2012,Congo,COG,Netherlands,NLD,0,0,5,0,5
2012,Dem. Rep. of the Congo,COD,Netherlands,NLD,0,0,5,0,5
2012,Eritrea,ERI,Netherlands,NLD,0,5,16,0,21
2012,Ethiopia,ETH,Netherlands,NLD,0,5,0,0,5
2012,Gambia,GMB,Netherlands,NLD,0,0,5,0,5
2012,Palestinian,PSE,Netherlands,NLD,0,0,5,0,5
2012,Georgia,GEO,Netherlands,NLD,0,0,13,0,13
2012,Guinea,GIN,Netherlands,NLD,0,5,15,0,20
2012,Cote d'Ivoire,CIV,Netherlands,NLD,0,5,5,0,10
2012,Iran (Islamic Rep. of),IRN,Netherlands,NLD,32,35,56,0,123
2012,Iraq,IRQ,Netherlands,NLD,12,44,66,0,122
2012,Jamaica,JAM,Netherlands,NLD,0,0,5,0,5
2012,Kenya,KEN,Netherlands,NLD,0,5,0,0,5
2012,Kyrgyzstan,KGZ,Netherlands,NLD,0,5,0,0,5
2012,Libya,LBY,Netherlands,NLD,0,0,34,0,34
2012,Sri Lanka,LKA,Netherlands,NLD,5,5,11,0,21
2012,Mongolia,MNG,Netherlands,NLD,0,0,5,0,5
2012,Nepal,NPL,Netherlands,NLD,0,0,5,0,5
2012,Nigeria,NGA,Netherlands,NLD,0,5,10,0,15
2012,Pakistan,PAK,Netherlands,NLD,0,5,5,0,10
2012,Russian Federation,RUS,Netherlands,NLD,0,5,17,0,22
2012,Rwanda,RWA,Netherlands,NLD,5,0,0,0,5
2012,Sierra Leone,SLE,Netherlands,NLD,0,0,11,0,11
2012,Somalia,SOM,Netherlands,NLD,0,107,127,0,234
2012,Sudan,SDN,Netherlands,NLD,0,5,14,0,19
2012,Syrian Arab Rep.,SYR,Netherlands,NLD,0,28,0,0,28
2012,Turkey,TUR,Netherlands,NLD,0,0,5,0,5
2012,Uganda,UGA,Netherlands,NLD,5,0,5,0,10
2012,Uzbekistan,UZB,Netherlands,NLD,0,5,0,0,5
2012,Stateless,XXA,Netherlands,NLD,0,0,13,0,13
2013,Afghanistan,AFG,Belarus,BLR,0,0,18,5,23
2013,Georgia,GEO,Belarus,BLR,0,0,11,0,11
2013,Afghanistan,AFG,Croatia,HRV,0,0,5,0,5
2013,Algeria,DZA,Croatia,HRV,0,0,35,0,35
2013,Morocco,MAR,Croatia,HRV,0,0,11,0,11
2013,Russian Federation,RUS,Croatia,HRV,0,0,5,0,5
2013,Somalia,SOM,Croatia,HRV,0,0,5,5,10
2013,Tunisia,TUN,Croatia,HRV,0,0,10,0,10
2013,Myanmar,MMR,Japan,JPN,0,0,5,0,5
2013,Armenia,ARM,Rep. of Moldova,MDA,0,0,5,0,5
2013,Afghanistan,AFG,Netherlands,NLD,88,137,178,0,403
2013,Algeria,DZA,Netherlands,NLD,0,0,5,0,5
2013,Egypt,EGY,Netherlands,NLD,0,17,22,0,39
2013,Armenia,ARM,Netherlands,NLD,5,0,47,0,52
2013,Azerbaijan,AZE,Netherlands,NLD,5,5,10,0,20
2013,Bangladesh,BGD,Netherlands,NLD,0,5,0,0,5
2013,Belarus,BLR,Netherlands,NLD,0,0,12,0,12
2013,Bosnia and Herzegovina,BIH,Netherlands,NLD,0,0,10,0,10
2013,China,CHN,Netherlands,NLD,21,28,10,0,59
2013,Cameroon,CMR,Netherlands,NLD,0,0,5,0,5
2013,Congo,COG,Netherlands,NLD,5,0,12,0,17
2013,Dem. Rep. of the Congo,COD,Netherlands,NLD,0,5,0,0,5
2013,Colombia,COL,Netherlands,NLD,0,0,5,0,5
2013,Eritrea,ERI,Netherlands,NLD,0,19,10,0,29
2013,Ethiopia,ETH,Netherlands,NLD,0,11,0,0,11
2013,Palestinian,PSE,Netherlands,NLD,0,0,5,0,5
2013,Georgia,GEO,Netherlands,NLD,0,0,14,0,14
2013,Ghana,GHA,Netherlands,NLD,0,0,5,0,5
2013,Guinea,GIN,Netherlands,NLD,0,13,0,0,13
2013,Cote d'Ivoire,CIV,Netherlands,NLD,0,0,14,0,14
2013,Iran (Islamic Rep. of),IRN,Netherlands,NLD,214,86,51,0,351
2013,Iraq,IRQ,Netherlands,NLD,57,82,80,0,219
2013,Jamaica,JAM,Netherlands,NLD,0,0,5,0,5
2013,Kenya,KEN,Netherlands,NLD,0,0,5,0,5
2013,Libya,LBY,Netherlands,NLD,0,5,18,0,23
2013,Sri Lanka,LKA,Netherlands,NLD,5,14,18,0,37
2013,Mongolia,MNG,Netherlands,NLD,0,0,5,0,5
2013,Morocco,MAR,Netherlands,NLD,0,0,5,0,5
2013,Myanmar,MMR,Netherlands,NLD,0,5,0,0,5
2013,Nepal,NPL,Netherlands,NLD,5,0,10,0,15
2013,Nigeria,NGA,Netherlands,NLD,0,5,12,0,17
2013,Pakistan,PAK,Netherlands,NLD,12,0,12,0,24
2013,Russian Federation,RUS,Netherlands,NLD,0,10,49,0,59
2013,Saudi Arabia,SAU,Netherlands,NLD,0,5,0,0,5
2013,Serbia and Kosovo: S/RES/1244 (1999),SRB,Netherlands,NLD,0,0,12,0,12
2013,Sierra Leone,SLE,Netherlands,NLD,0,0,11,0,11
2013,Somalia,SOM,Netherlands,NLD,0,50,93,0,143
2013,Sudan,SDN,Netherlands,NLD,0,13,10,0,23
2013,Syrian Arab Rep.,SYR,Netherlands,NLD,0,33,10,0,43
2013,Turkey,TUR,Netherlands,NLD,0,5,5,0,10
2013,Uganda,UGA,Netherlands,NLD,5,5,0,0,10
2013,Ukraine,UKR,Netherlands,NLD,5,0,0,0,5
2013,Yemen,YEM,Netherlands,NLD,0,11,0,0,11
2013,Stateless,XXA,Netherlands,NLD,5,10,5,0,20
2014,Cote d'Ivoire,CIV,Armenia,ARM,0,0,5,0,5
2014,Iran (Islamic Rep. of),IRN,Armenia,ARM,0,0,5,0,5
2014,Afghanistan,AFG,Belarus,BLR,5,0,24,0,29
2014,Egypt,EGY,Belarus,BLR,0,0,5,0,5
2014,Georgia,GEO,Belarus,BLR,0,0,5,0,5
2014,Dem. People's Rep. of Korea,PRK,Belarus,BLR,0,0,5,0,5
2014,Syrian Arab Rep.,SYR,Bosnia and Herzegovina,BIH,0,0,5,0,5
2014,Egypt,EGY,Georgia,GEO,0,0,5,0,5
2014,Iraq,IRQ,Georgia,GEO,0,11,12,36,59
2014,Sri Lanka,LKA,Georgia,GEO,0,0,5,0,5
2014,Russian Federation,RUS,Georgia,GEO,0,0,5,0,5
2014,Syrian Arab Rep.,SYR,Georgia,GEO,0,0,0,5,5
2014,Algeria,DZA,Croatia,HRV,0,0,26,0,26
2014,Egypt,EGY,Croatia,HRV,0,0,5,0,5
2014,Bosnia and Herzegovina,BIH,Croatia,HRV,0,0,5,0,5
2014,Morocco,MAR,Croatia,HRV,0,0,13,0,13
2014,Nigeria,NGA,Croatia,HRV,0,0,5,0,5
2014,Russian Federation,RUS,Croatia,HRV,0,0,5,0,5
2014,Somalia,SOM,Croatia,HRV,0,0,5,0,5
2014,Syrian Arab Rep.,SYR,Croatia,HRV,0,0,5,0,5
2014,Tunisia,TUN,Croatia,HRV,0,0,11,0,11
2014,Albania,ALB,Luxembourg,LUX,0,0,72,0,72
2014,Bosnia and Herzegovina,BIH,Luxembourg,LUX,5,0,42,0,47
2014,Iraq,IRQ,Luxembourg,LUX,0,0,0,5,5
2014,Kyrgyzstan,KGZ,Luxembourg,LUX,0,0,5,0,5
2014,North Macedonia,MKD,Luxembourg,LUX,0,0,16,0,16
2014,Montenegro,MNE,Luxembourg,LUX,0,0,20,0,20
2014,Nigeria,NGA,Luxembourg,LUX,0,0,10,0,10
2014,Serbia and Kosovo: S/RES/1244 (1999),SRB,Luxembourg,LUX,10,0,221,0,231
2014,Somalia,SOM,Luxembourg,LUX,5,0,0,0,5
2014,Tunisia,TUN,Luxembourg,LUX,0,0,5,0,5
2014,Turkey,TUR,Luxembourg,LUX,0,0,5,0,5
2014,Afghanistan,AFG,Netherlands,NLD,33,41,63,0,137
2014,Albania,ALB,Netherlands,NLD,5,0,5,0,10
2014,Algeria,DZA,Netherlands,NLD,0,0,5,0,5
2014,Angola,AGO,Netherlands,NLD,0,0,5,0,5
2014,Egypt,EGY,Netherlands,NLD,5,0,15,0,20
2014,Armenia,ARM,Netherlands,NLD,0,10,36,0,46
2014,Azerbaijan,AZE,Netherlands,NLD,0,0,11,0,11
2014,Burundi,BDI,Netherlands,NLD,0,0,5,0,5
2014,Bangladesh,BGD,Netherlands,NLD,5,0,0,0,5
2014,Belarus,BLR,Netherlands,NLD,0,0,14,0,14
2014,Bosnia and Herzegovina,BIH,Netherlands,NLD,0,0,19,0,19
2014,China,CHN,Netherlands,NLD,5,16,10,0,31
2014,Cameroon,CMR,Netherlands,NLD,5,0,0,0,5
2014,Congo,COG,Netherlands,NLD,0,5,17,0,22
2014,Eritrea,ERI,Netherlands,NLD,0,71,20,0,91
2014,Ethiopia,ETH,Netherlands,NLD,5,0,12,0,17
2014,Gambia,GMB,Netherlands,NLD,5,0,5,0,10
2014,Georgia,GEO,Netherlands,NLD,0,0,21,0,21
2014,Guinea,GIN,Netherlands,NLD,0,13,0,0,13
2014,Cote d'Ivoire,CIV,Netherlands,NLD,0,5,5,0,10
2014,India,IND,Netherlands,NLD,0,0,5,0,5
2014,Iran (Islamic Rep. of),IRN,Netherlands,NLD,50,17,35,0,102
2014,Iraq,IRQ,Netherlands,NLD,18,46,56,0,120
2014,Jamaica,JAM,Netherlands,NLD,13,0,0,0,13
2014,Kazakhstan,KAZ,Netherlands,NLD,5,0,0,0,5
2014,Dem. People's Rep. of Korea,PRK,Netherlands,NLD,0,0,22,0,22
2014,Liberia,LBR,Netherlands,NLD,0,0,5,0,5
2014,Libya,LBY,Netherlands,NLD,0,0,21,0,21
2014,Lebanon,LBN,Netherlands,NLD,5,0,0,0,5
2014,Sri Lanka,LKA,Netherlands,NLD,5,5,12,0,22
2014,North Macedonia,MKD,Netherlands,NLD,0,0,18,0,18
2014,Mongolia,MNG,Netherlands,NLD,0,5,15,0,20
2014,Morocco,MAR,Netherlands,NLD,0,0,10,0,10
2014,Nepal,NPL,Netherlands,NLD,0,0,11,0,11
2014,Nigeria,NGA,Netherlands,NLD,11,5,14,0,30
2014,Pakistan,PAK,Netherlands,NLD,0,11,12,0,23
2014,Russian Federation,RUS,Netherlands,NLD,0,19,46,0,65
2014,Serbia and Kosovo: S/RES/1244 (1999),SRB,Netherlands,NLD,0,0,34,0,34
2014,Senegal,SEN,Netherlands,NLD,5,0,0,0,5
2014,Sierra Leone,SLE,Netherlands,NLD,5,11,10,0,26
2014,Somalia,SOM,Netherlands,NLD,0,44,43,0,87
2014,Sudan,SDN,Netherlands,NLD,0,5,11,0,16
2014,Syrian Arab Rep.,SYR,Netherlands,NLD,0,44,14,0,58
2014,Tunisia,TUN,Netherlands,NLD,5,0,0,0,5
2014,Turkey,TUR,Netherlands,NLD,0,11,0,0,11
2014,Uganda,UGA,Netherlands,NLD,41,5,5,0,51
2014,Ukraine,UKR,Netherlands,NLD,0,0,10,0,10
2014,Zimbabwe,ZWE,Netherlands,NLD,5,0,0,0,5
2014,Stateless,XXA,Netherlands,NLD,12,12,16,0,40
2014,Afghanistan,AFG,Romania,ROU,0,10,17,0,27
2014,Egypt,EGY,Romania,ROU,0,0,5,5,10
2014,Bangladesh,BGD,Romania,ROU,0,0,10,0,10
2014,China,CHN,Romania,ROU,0,0,14,10,24
2014,Gambia,GMB,Romania,ROU,0,0,5,0,5
2014,Palestinian,PSE,Romania,ROU,0,0,5,0,5
2014,Iran (Islamic Rep. of),IRN,Romania,ROU,0,0,5,5,10
2014,Iraq,IRQ,Romania,ROU,0,0,5,5,10
2014,Kazakhstan,KAZ,Romania,ROU,0,0,0,5,5
2014,Rep. of Moldova,MDA,Romania,ROU,0,0,5,0,5
2014,Morocco,MAR,Romania,ROU,0,0,10,0,10
2014,Nepal,NPL,Romania,ROU,0,0,5,0,5
2014,Pakistan,PAK,Romania,ROU,5,0,22,0,27
2014,Philippines,PHL,Romania,ROU,0,0,5,0,5
2014,Somalia,SOM,Romania,ROU,0,5,5,0,10
2014,Syrian Arab Rep.,SYR,Romania,ROU,0,5,5,0,10
2014,Turkey,TUR,Romania,ROU,0,0,5,5,10
2014,Stateless,XXA,Romania,ROU,0,5,0,0,5
2014,Afghanistan,AFG,Ukraine,UKR,10,0,24,14,48
2014,Cameroon,CMR,Ukraine,UKR,5,0,0,0,5
2014,Dem. Rep. of the Congo,COD,Ukraine,UKR,5,0,5,0,10
2014,Eritrea,ERI,Ukraine,UKR,5,0,0,0,5
2014,Palestinian,PSE,Ukraine,UKR,5,0,0,5,10
2014,Georgia,GEO,Ukraine,UKR,0,0,5,0,5
2014,Iran (Islamic Rep. of),IRN,Ukraine,UKR,5,0,22,11,38
2014,Iraq,IRQ,Ukraine,UKR,0,0,5,5,10
2014,Sri Lanka,LKA,Ukraine,UKR,0,0,5,0,5
2014,Pakistan,PAK,Ukraine,UKR,5,0,0,0,5
2014,Russian Federation,RUS,Ukraine,UKR,5,0,0,5,10
2014,Senegal,SEN,Ukraine,UKR,5,0,5,0,10
2014,Somalia,SOM,Ukraine,UKR,14,0,0,0,14
2014,Sudan,SDN,Ukraine,UKR,5,0,0,5,10
2014,Syrian Arab Rep.,SYR,Ukraine,UKR,34,0,21,11,66
2014,Turkmenistan,TKM,Ukraine,UKR,5,0,0,0,5
2014,Uzbekistan,UZB,Ukraine,UKR,10,0,14,10,34
2014,Stateless,XXA,Ukraine,UKR,0,0,5,0,5
2015,Iran (Islamic Rep. of),IRN,Armenia,ARM,0,0,0,5,5
2015,Afghanistan,AFG,Belarus,BLR,0,0,23,0,23
2015,Bangladesh,BGD,Belarus,BLR,0,0,5,0,5
2015,Syrian Arab Rep.,SYR,Belarus,BLR,0,0,0,5,5
2015,Ukraine,UKR,Belarus,BLR,0,0,11,0,11
2015,Iran (Islamic Rep. of),IRN,Georgia,GEO,5,0,0,0,5
2015,Iraq,IRQ,Georgia,GEO,0,0,0,10,10
2015,Syrian Arab Rep.,SYR,Georgia,GEO,0,0,5,0,5
2015,Ukraine,UKR,Georgia,GEO,0,0,0,5,5
2015,Afghanistan,AFG,Germany,DEU,237,404,295,1555,2491
2015,Albania,ALB,Germany,DEU,0,38,2383,4079,6500
2015,Algeria,DZA,Germany,DEU,5,0,40,228,273
2015,Angola,AGO,Germany,DEU,5,0,5,13,23
2015,Egypt,EGY,Germany,DEU,10,0,14,152,176
2015,Armenia,ARM,Germany,DEU,15,27,145,266,453
2015,Azerbaijan,AZE,Germany,DEU,11,20,153,114,298
2015,Burundi,BDI,Germany,DEU,5,0,0,5,10
2015,Benin,BEN,Germany,DEU,0,0,10,37,47
2015,Bangladesh,BGD,Germany,DEU,5,5,186,117,313
2015,Burkina Faso,BFA,Germany,DEU,0,0,19,113,132
2015,Belarus,BLR,Germany,DEU,0,0,11,16,27
2015,Bosnia and Herzegovina,BIH,Germany,DEU,0,46,905,1591,2542
2015,Bulgaria,BGR,Germany,DEU,0,0,5,12,17
2015,Cambodia,KHM,Germany,DEU,0,0,5,5,10
2015,Central African Rep.,CAF,Germany,DEU,0,0,0,5,5
2015,Chad,TCD,Germany,DEU,0,0,5,49,54
2015,China,CHN,Germany,DEU,10,0,18,21,49
2015,Cameroon,CMR,Germany,DEU,0,5,40,241,286
2015,Congo,COG,Germany,DEU,0,0,0,14,14
2015,Dem. Rep. of the Congo,COD,Germany,DEU,5,0,20,17,42
2015,Colombia,COL,Germany,DEU,0,0,0,5,5
2015,Cuba,CUB,Germany,DEU,0,0,5,5,10
2015,Djibouti,DJI,Germany,DEU,0,0,0,5,5
2015,Eritrea,ERI,Germany,DEU,50,0,20,596,666
2015,Ethiopia,ETH,Germany,DEU,56,24,76,168,324
2015,Gabon,GAB,Germany,DEU,0,0,0,5,5
2015,Gambia,GMB,Germany,DEU,5,5,29,292,331
2015,Georgia,GEO,Germany,DEU,5,25,258,774,1062
2015,Ghana,GHA,Germany,DEU,0,5,62,253,320
2015,Guinea-Bissau,GNB,Germany,DEU,0,0,10,62,72
2015,Guatemala,GTM,Germany,DEU,0,0,0,10,10
2015,Guinea,GIN,Germany,DEU,5,0,32,223,260
2015,Honduras,HND,Germany,DEU,0,5,0,0,5
2015,Hungary,HUN,Germany,DEU,0,0,0,5,5
2015,Cote d'Ivoire,CIV,Germany,DEU,0,0,24,191,215
2015,India,IND,Germany,DEU,0,5,58,43,106
2015,Iran (Islamic Rep. of),IRN,Germany,DEU,296,12,164,726,1198
2015,Iraq,IRQ,Germany,DEU,28,15,39,798,880
2015,Jamaica,JAM,Germany,DEU,0,0,0,5,5
2015,Jordan,JOR,Germany,DEU,0,0,0,14,14
2015,Kazakhstan,KAZ,Germany,DEU,0,0,0,42,42
2015,Kenya,KEN,Germany,DEU,0,5,20,38,63
2015,Kyrgyzstan,KGZ,Germany,DEU,5,5,5,38,53
2015,Liberia,LBR,Germany,DEU,0,0,0,32,32
2015,Libya,LBY,Germany,DEU,0,0,16,122,138
2015,Lebanon,LBN,Germany,DEU,0,5,53,174,232
2015,Sri Lanka,LKA,Germany,DEU,17,10,65,46,138
2015,Mauritania,MRT,Germany,DEU,0,0,0,44,44
2015,North Macedonia,MKD,Germany,DEU,5,47,1996,3182,5230
2015,Rep. of Moldova,MDA,Germany,DEU,0,0,0,5,5
2015,Mexico,MEX,Germany,DEU,0,0,0,5,5
2015,Mali,MLI,Germany,DEU,0,0,33,117,150
2015,Mongolia,MNG,Germany,DEU,0,0,12,40,52
2015,Morocco,MAR,Germany,DEU,0,0,35,198,233
2015,Mozambique,MOZ,Germany,DEU,0,0,0,5,5
2015,Montenegro,MNE,Germany,DEU,0,13,285,440,738
2015,Myanmar,MMR,Germany,DEU,0,0,0,5,5
2015,Nepal,NPL,Germany,DEU,0,0,5,5,10
2015,Niger,NER,Germany,DEU,0,0,5,40,45
2015,Nigeria,NGA,Germany,DEU,5,20,75,416,516
2015,Pakistan,PAK,Germany,DEU,321,24,469,593,1407
2015,Romania,ROU,Germany,DEU,0,0,0,5,5
2015,South Africa,ZAF,Germany,DEU,0,0,0,5,5
2015,Russian Federation,RUS,Germany,DEU,41,54,511,2115,2721
2015,Rwanda,RWA,Germany,DEU,10,0,0,5,15
2015,Serbia and Kosovo: S/RES/1244 (1999),SRB,Germany,DEU,0,114,9013,14789,23916
2015,Senegal,SEN,Germany,DEU,0,0,25,43,68
2015,Sierra Leone,SLE,Germany,DEU,0,5,5,17,27
2015,Somalia,SOM,Germany,DEU,49,108,109,869,1135
2015,Spain,ESP,Germany,DEU,0,0,5,0,5
2015,Viet Nam,VNM,Germany,DEU,0,0,15,35,50
2015,Sudan,SDN,Germany,DEU,10,0,51,149,210
2015,South Sudan,SSD,Germany,DEU,0,0,0,13,13
2015,Syrian Arab Rep.,SYR,Germany,DEU,227,15,50,3546,3838
2015,United Rep. of Tanzania,TZA,Germany,DEU,0,0,0,5,5
2015,Tajikistan,TJK,Germany,DEU,5,5,20,54,84
2015,Turkmenistan,TKM,Germany,DEU,0,0,0,10,10
2015,Togo,TGO,Germany,DEU,0,0,10,41,51
2015,Tunisia,TUN,Germany,DEU,5,0,79,145,229
2015,Turkey,TUR,Germany,DEU,26,10,166,236,438
2015,Uganda,UGA,Germany,DEU,5,0,0,5,10
2015,Ukraine,UKR,Germany,DEU,0,0,18,307,325
2015,Uzbekistan,UZB,Germany,DEU,0,0,0,13,13
2015,Venezuela (Bolivarian Republic of),VEN,Germany,DEU,0,0,0,5,5
2015,Yemen,YEM,Germany,DEU,0,0,0,11,11
2015,Zimbabwe,ZWE,Germany,DEU,5,0,0,5,10
2015,Stateless,XXA,Germany,DEU,5,5,5,144,159
2015,Algeria,DZA,Croatia,HRV,0,0,21,0,21
2015,Bosnia and Herzegovina,BIH,Croatia,HRV,0,0,5,0,5
2015,Morocco,MAR,Croatia,HRV,0,0,5,0,5
2015,Nigeria,NGA,Croatia,HRV,0,0,11,0,11
2015,Russian Federation,RUS,Croatia,HRV,0,0,10,0,10
2015,Serbia and Kosovo: S/RES/1244 (1999),SRB,Croatia,HRV,0,0,5,0,5
2015,Ukraine,UKR,Croatia,HRV,0,0,5,0,5
2015,Afghanistan,AFG,Luxembourg,LUX,0,0,5,0,5
2015,Albania,ALB,Luxembourg,LUX,0,10,15,0,25
2015,Bosnia and Herzegovina,BIH,Luxembourg,LUX,0,0,16,0,16
2015,Dem. Rep. of the Congo,COD,Luxembourg,LUX,0,0,5,0,5
2015,Iran (Islamic Rep. of),IRN,Luxembourg,LUX,5,0,0,0,5
2015,North Macedonia,MKD,Luxembourg,LUX,0,0,11,0,11
2015,Montenegro,MNE,Luxembourg,LUX,0,0,14,0,14
2015,Nigeria,NGA,Luxembourg,LUX,0,0,5,0,5
2015,Serbia and Kosovo: S/RES/1244 (1999),SRB,Luxembourg,LUX,0,0,30,0,30
2015,Turkey,TUR,Luxembourg,LUX,10,0,10,0,20
2015,Ukraine,UKR,Rep. of Moldova,MDA,0,0,5,0,5
2015,Afghanistan,AFG,Romania,ROU,0,15,16,0,31
2015,Egypt,EGY,Romania,ROU,0,0,5,0,5
2015,Bangladesh,BGD,Romania,ROU,0,0,10,0,10
2015,China,CHN,Romania,ROU,0,0,10,0,10
2015,Cameroon,CMR,Romania,ROU,0,0,5,0,5
2015,Palestinian,PSE,Romania,ROU,0,5,0,0,5
2015,Iran (Islamic Rep. of),IRN,Romania,ROU,0,0,12,0,12
2015,Iraq,IRQ,Romania,ROU,0,5,0,0,5
2015,Jordan,JOR,Romania,ROU,5,0,0,0,5
2015,Lebanon,LBN,Romania,ROU,0,0,5,0,5
2015,Rep. of Moldova,MDA,Romania,ROU,0,0,5,0,5
2015,Nigeria,NGA,Romania,ROU,0,0,5,0,5
2015,Pakistan,PAK,Romania,ROU,0,11,0,0,11
2015,Philippines,PHL,Romania,ROU,0,0,10,0,10
2015,Russian Federation,RUS,Romania,ROU,0,5,0,0,5
2015,Syrian Arab Rep.,SYR,Romania,ROU,0,0,5,0,5
2015,Turkey,TUR,Romania,ROU,0,0,5,0,5
2015,Stateless,XXA,Romania,ROU,0,5,0,0,5
2015,Afghanistan,AFG,Ukraine,UKR,30,0,36,14,80
2015,Armenia,ARM,Ukraine,UKR,5,0,0,0,5
2015,Bangladesh,BGD,Ukraine,UKR,0,0,0,5,5
2015,Cameroon,CMR,Ukraine,UKR,0,0,5,0,5
2015,Congo,COG,Ukraine,UKR,5,0,0,0,5
2015,Dem. Rep. of the Congo,COD,Ukraine,UKR,14,0,0,0,14
2015,Eritrea,ERI,Ukraine,UKR,0,0,0,5,5
2015,Palestinian,PSE,Ukraine,UKR,11,0,5,5,21
2015,Georgia,GEO,Ukraine,UKR,0,0,5,0,5
2015,Guinea,GIN,Ukraine,UKR,0,0,5,0,5
2015,Cote d'Ivoire,CIV,Ukraine,UKR,0,0,0,5,5
2015,Iran (Islamic Rep. of),IRN,Ukraine,UKR,0,0,19,11,30
2015,Iraq,IRQ,Ukraine,UKR,5,0,24,12,41
2015,Kyrgyzstan,KGZ,Ukraine,UKR,0,0,0,5,5
2015,Lebanon,LBN,Ukraine,UKR,0,0,0,5,5
2015,Sri Lanka,LKA,Ukraine,UKR,0,0,0,14,14
2015,Pakistan,PAK,Ukraine,UKR,5,0,11,10,26
2015,Russian Federation,RUS,Ukraine,UKR,16,0,17,13,46
2015,Somalia,SOM,Ukraine,UKR,5,0,25,33,63
2015,Sudan,SDN,Ukraine,UKR,5,0,10,0,15
2015,Syrian Arab Rep.,SYR,Ukraine,UKR,91,0,20,0,111
2015,Uzbekistan,UZB,Ukraine,UKR,5,0,16,13,34
2015,Stateless,XXA,Ukraine,UKR,5,0,5,0,10
2016,Guinea,GIN,Armenia,ARM,0,0,0,5,5
2016,Iran (Islamic Rep. of),IRN,Armenia,ARM,0,0,5,5,10
2016,Iran (Islamic Rep. of),IRN,Belarus,BLR,0,0,5,0,5
2016,Iraq,IRQ,Belarus,BLR,0,0,10,0,10
2016,Syrian Arab Rep.,SYR,Belarus,BLR,0,0,5,0,5
2016,Ukraine,UKR,Belarus,BLR,0,0,0,5,5
2016,Afghanistan,AFG,Germany,DEU,268,594,702,2291,3855
2016,Albania,ALB,Germany,DEU,0,126,5350,7027,12503
2016,Algeria,DZA,Germany,DEU,0,5,294,323,622
2016,Angola,AGO,Germany,DEU,0,0,5,10,15
2016,Egypt,EGY,Germany,DEU,75,5,88,89,257
2016,Armenia,ARM,Germany,DEU,10,12,134,225,381
2016,Azerbaijan,AZE,Germany,DEU,12,22,135,123,292
2016,Burundi,BDI,Germany,DEU,5,0,0,0,5
2016,Benin,BEN,Germany,DEU,0,0,30,29,59
2016,Bangladesh,BGD,Germany,DEU,5,10,162,76,253
2016,Burkina Faso,BFA,Germany,DEU,0,0,33,52,85
2016,Belarus,BLR,Germany,DEU,0,0,0,14,14
2016,Bosnia and Herzegovina,BIH,Germany,DEU,0,20,576,987,1583
2016,Cambodia,KHM,Germany,DEU,0,0,5,0,5
2016,Chad,TCD,Germany,DEU,0,0,10,42,52
2016,China,CHN,Germany,DEU,16,5,14,27,62
2016,Cameroon,CMR,Germany,DEU,5,0,50,153,208
2016,Congo,COG,Germany,DEU,0,0,0,10,10
2016,Dem. Rep. of the Congo,COD,Germany,DEU,0,5,46,34,85
2016,Colombia,COL,Germany,DEU,0,0,0,5,5
2016,Cuba,CUB,Germany,DEU,0,0,0,10,10
2016,Djibouti,DJI,Germany,DEU,0,5,0,0,5
2016,Eritrea,ERI,Germany,DEU,73,11,72,499,655
2016,Ethiopia,ETH,Germany,DEU,31,15,122,170,338
2016,Gabon,GAB,Germany,DEU,0,0,0,5,5
2016,Gambia,GMB,Germany,DEU,5,5,48,258,316
2016,Georgia,GEO,Germany,DEU,5,10,395,683,1093
2016,Ghana,GHA,Germany,DEU,0,0,102,242,344
2016,Guinea-Bissau,GNB,Germany,DEU,0,0,40,75,115
2016,Greece,GRC,Germany,DEU,0,0,0,5,5
2016,Guinea,GIN,Germany,DEU,0,5,30,54,89
2016,Haiti,HTI,Germany,DEU,0,0,5,0,5
2016,Honduras,HND,Germany,DEU,0,0,0,5,5
2016,Cote d'Ivoire,CIV,Germany,DEU,5,0,36,218,259
2016,India,IND,Germany,DEU,0,0,105,120,225
2016,Iran (Islamic Rep. of),IRN,Germany,DEU,272,14,186,523,995
2016,Iraq,IRQ,Germany,DEU,25,24,413,1443,1905
2016,Israel,ISR,Germany,DEU,0,0,0,5,5
2016,Italy,ITA,Germany,DEU,0,0,5,0,5
2016,Jamaica,JAM,Germany,DEU,0,0,0,5,5
2016,Jordan,JOR,Germany,DEU,0,0,5,11,16
2016,Kazakhstan,KAZ,Germany,DEU,0,5,0,12,17
2016,Kenya,KEN,Germany,DEU,0,5,53,59,117
2016,Kyrgyzstan,KGZ,Germany,DEU,0,0,11,12,23
2016,Liberia,LBR,Germany,DEU,0,0,5,29,34
2016,Libya,LBY,Germany,DEU,5,5,23,92,125
2016,Lebanon,LBN,Germany,DEU,0,13,68,131,212
2016,Sri Lanka,LKA,Germany,DEU,19,5,61,31,116
2016,Mauritania,MRT,Germany,DEU,0,0,5,21,26
2016,North Macedonia,MKD,Germany,DEU,5,41,1725,2785,4556
2016,Rep. of Moldova,MDA,Germany,DEU,0,0,0,34,34
2016,Mali,MLI,Germany,DEU,0,5,55,96,156
2016,Mongolia,MNG,Germany,DEU,0,0,13,31,44
2016,Morocco,MAR,Germany,DEU,10,5,213,274,502
2016,Montenegro,MNE,Germany,DEU,0,5,405,940,1350
2016,Myanmar,MMR,Germany,DEU,0,0,0,5,5
2016,Nepal,NPL,Germany,DEU,0,0,0,5,5
2016,Niger,NER,Germany,DEU,0,0,14,46,60
2016,Nigeria,NGA,Germany,DEU,10,16,144,347,517
2016,Pakistan,PAK,Germany,DEU,279,34,743,584,1640
2016,Philippines,PHL,Germany,DEU,0,0,5,5,10
2016,Russian Federation,RUS,Germany,DEU,46,47,592,2497,3182
2016,Rwanda,RWA,Germany,DEU,13,5,0,5,23
2016,El Salvador,SLV,Germany,DEU,0,0,0,5,5
2016,Serbia and Kosovo: S/RES/1244 (1999),SRB,Germany,DEU,5,173,7083,9254,16515
2016,Senegal,SEN,Germany,DEU,0,0,219,119,338
2016,Sierra Leone,SLE,Germany,DEU,0,0,10,17,27
2016,Somalia,SOM,Germany,DEU,71,180,122,945,1318
2016,Viet Nam,VNM,Germany,DEU,0,0,10,20,30
2016,Sudan,SDN,Germany,DEU,20,0,30,172,222
2016,South Sudan,SSD,Germany,DEU,0,0,0,12,12
2016,Slovakia,SVK,Germany,DEU,0,0,0,5,5
2016,Syrian Arab Rep.,SYR,Germany,DEU,5799,299,843,2931,9872
2016,Tajikistan,TJK,Germany,DEU,0,0,14,38,52
2016,Turkmenistan,TKM,Germany,DEU,0,5,0,10,15
2016,Togo,TGO,Germany,DEU,0,0,13,34,47
2016,Tunisia,TUN,Germany,DEU,5,0,129,193,327
2016,Turkey,TUR,Germany,DEU,21,11,88,153,273
2016,Uganda,UGA,Germany,DEU,0,0,0,12,12
2016,Ukraine,UKR,Germany,DEU,0,0,180,629,809
2016,Venezuela (Bolivarian Republic of),VEN,Germany,DEU,0,5,0,0,5
2016,Yemen,YEM,Germany,DEU,0,0,0,19,19
2016,Zimbabwe,ZWE,Germany,DEU,0,0,5,5,10
2016,Stateless,XXA,Germany,DEU,146,5,21,144,316
2016,Afghanistan,AFG,Croatia,HRV,0,0,5,0,5
2016,Algeria,DZA,Croatia,HRV,0,0,10,0,10
2016,Cameroon,CMR,Croatia,HRV,0,0,5,0,5
2016,Iraq,IRQ,Croatia,HRV,0,0,5,0,5
2016,Lebanon,LBN,Croatia,HRV,0,0,5,0,5
2016,Morocco,MAR,Croatia,HRV,0,0,10,0,10
2016,Nigeria,NGA,Croatia,HRV,0,0,10,0,10
2016,Russian Federation,RUS,Croatia,HRV,0,0,5,0,5
2016,Serbia and Kosovo: S/RES/1244 (1999),SRB,Croatia,HRV,0,0,10,0,10
2016,Somalia,SOM,Croatia,HRV,0,0,5,0,5
2016,Syrian Arab Rep.,SYR,Croatia,HRV,0,0,5,0,5
2016,Ukraine,UKR,Croatia,HRV,0,0,10,0,10
2016,Albania,ALB,Luxembourg,LUX,0,0,12,0,12
2016,Azerbaijan,AZE,Luxembourg,LUX,0,0,15,0,15
2016,Gambia,GMB,Luxembourg,LUX,0,0,5,0,5
2016,Montenegro,MNE,Luxembourg,LUX,0,0,11,0,11
2016,Nigeria,NGA,Luxembourg,LUX,0,0,5,0,5
2016,Serbia and Kosovo: S/RES/1244 (1999),SRB,Luxembourg,LUX,0,0,21,0,21
2016,Kyrgyzstan,KGZ,Rep. of Moldova,MDA,5,0,0,0,5
2016,Sri Lanka,LKA,Rep. of Moldova,MDA,0,0,10,0,10
2016,Turkey,TUR,Rep. of Moldova,MDA,0,0,5,0,5
2016,Ukraine,UKR,Rep. of Moldova,MDA,0,0,20,0,20
2016,Afghanistan,AFG,Romania,ROU,0,0,14,0,14
2016,Egypt,EGY,Romania,ROU,0,0,5,0,5
2016,Bangladesh,BGD,Romania,ROU,0,0,5,0,5
2016,China,CHN,Romania,ROU,0,0,15,0,15
2016,Palestinian,PSE,Romania,ROU,0,0,5,0,5
2016,Iran (Islamic Rep. of),IRN,Romania,ROU,0,0,5,0,5
2016,Iraq,IRQ,Romania,ROU,0,5,13,0,18
2016,Pakistan,PAK,Romania,ROU,0,0,10,0,10
2016,Syrian Arab Rep.,SYR,Romania,ROU,0,0,5,0,5
2016,Turkey,TUR,Romania,ROU,0,0,5,0,5
2016,Ukraine,UKR,Romania,ROU,0,0,5,0,5
2016,Afghanistan,AFG,Ukraine,UKR,0,0,34,29,63
2016,Azerbaijan,AZE,Ukraine,UKR,0,0,5,5,10
2016,Bangladesh,BGD,Ukraine,UKR,0,0,0,5,5
2016,Belarus,BLR,Ukraine,UKR,0,0,0,5,5
2016,Ethiopia,ETH,Ukraine,UKR,0,0,0,5,5
2016,Palestinian,PSE,Ukraine,UKR,0,0,5,12,17
2016,Georgia,GEO,Ukraine,UKR,0,0,0,5,5
2016,Guinea,GIN,Ukraine,UKR,0,0,5,5,10
2016,Iran (Islamic Rep. of),IRN,Ukraine,UKR,0,0,12,5,17
2016,Iraq,IRQ,Ukraine,UKR,0,0,15,11,26
2016,Kyrgyzstan,KGZ,Ukraine,UKR,0,0,10,14,24
2016,Sri Lanka,LKA,Ukraine,UKR,0,0,12,0,12
2016,Mali,MLI,Ukraine,UKR,0,0,5,0,5
2016,Nigeria,NGA,Ukraine,UKR,0,0,5,5,10
2016,Pakistan,PAK,Ukraine,UKR,0,0,13,0,13
2016,Russian Federation,RUS,Ukraine,UKR,0,0,10,10,20
2016,Somalia,SOM,Ukraine,UKR,0,0,24,26,50
2016,Syrian Arab Rep.,SYR,Ukraine,UKR,5,0,26,5,36
2016,Uzbekistan,UZB,Ukraine,UKR,0,0,13,5,18
2016,Yemen,YEM,Ukraine,UKR,0,0,5,0,5
2017,Iraq,IRQ,Armenia,ARM,0,0,0,14,14
2017,Afghanistan,AFG,Belarus,BLR,0,0,10,0,10
2017,Iraq,IRQ,Belarus,BLR,0,0,5,0,5
2017,Pakistan,PAK,Belarus,BLR,0,0,5,0,5
2017,Russian Federation,RUS,Belarus,BLR,0,0,0,12,12
2017,Ukraine,UKR,Belarus,BLR,0,0,5,0,5
2017,Serbia and Kosovo: S/RES/1244 (1999),SRB,Bosnia and Herzegovina,BIH,0,0,5,0,5
2017,Afghanistan,AFG,Germany,DEU,1018,6220,4589,7599,19426
2017,Albania,ALB,Germany,DEU,0,110,2289,3483,5882
2017,Algeria,DZA,Germany,DEU,5,14,524,512,1055
2017,Angola,AGO,Germany,DEU,0,5,10,27,42
2017,Egypt,EGY,Germany,DEU,155,5,233,324,717
2017,Armenia,ARM,Germany,DEU,5,55,704,1237,2001
2017,Azerbaijan,AZE,Germany,DEU,27,40,620,1066,1753
2017,Burundi,BDI,Germany,DEU,0,0,0,11,11
2017,Benin,BEN,Germany,DEU,0,0,123,67,190
2017,Bangladesh,BGD,Germany,DEU,5,10,351,257,623
2017,Burkina Faso,BFA,Germany,DEU,0,0,97,72,169
2017,Belarus,BLR,Germany,DEU,0,0,28,130,158
2017,Botswana,BWA,Germany,DEU,0,0,5,0,5
2017,Brazil,BRA,Germany,DEU,0,0,0,5,5
2017,Bosnia and Herzegovina,BIH,Germany,DEU,0,17,341,724,1082
2017,Bulgaria,BGR,Germany,DEU,0,0,0,5,5
2017,Central African Rep.,CAF,Germany,DEU,0,0,5,5,10
2017,Chad,TCD,Germany,DEU,0,0,29,67,96
2017,China,CHN,Germany,DEU,13,0,72,137,222
2017,Cameroon,CMR,Germany,DEU,0,0,145,314,459
2017,Congo,COG,Germany,DEU,0,0,5,14,19
2017,Dem. Rep. of the Congo,COD,Germany,DEU,5,5,42,67,119
2017,Colombia,COL,Germany,DEU,0,5,11,0,16
2017,Cuba,CUB,Germany,DEU,0,0,26,21,47
2017,Djibouti,DJI,Germany,DEU,0,0,0,5,5
2017,Equatorial Guinea,GNQ,Germany,DEU,0,0,0,5,5
2017,Eritrea,ERI,Germany,DEU,250,44,514,2353,3161
2017,Ethiopia,ETH,Germany,DEU,176,29,224,747,1176
2017,Gabon,GAB,Germany,DEU,0,0,5,0,5
2017,Gambia,GMB,Germany,DEU,5,5,319,589,918
2017,Georgia,GEO,Germany,DEU,5,33,880,1162,2080
2017,Ghana,GHA,Germany,DEU,5,0,444,453,902
2017,Guinea-Bissau,GNB,Germany,DEU,0,0,65,80,145
2017,Guinea,GIN,Germany,DEU,0,5,275,717,997
2017,Haiti,HTI,Germany,DEU,0,0,5,0,5
2017,Honduras,HND,Germany,DEU,0,0,0,5,5
2017,Croatia,HRV,Germany,DEU,0,0,0,5,5
2017,Cote d'Ivoire,CIV,Germany,DEU,0,12,125,483,620
2017,India,IND,Germany,DEU,0,12,791,621,1424
2017,Iran (Islamic Rep. of),IRN,Germany,DEU,754,39,841,1488,3122
2017,Iraq,IRQ,Germany,DEU,499,431,4701,4422,10053
2017,Israel,ISR,Germany,DEU,0,0,0,5,5
2017,Italy,ITA,Germany,DEU,0,0,0,5,5
2017,Jamaica,JAM,Germany,DEU,5,0,12,5,22
2017,Jordan,JOR,Germany,DEU,0,0,13,31,44
2017,Kazakhstan,KAZ,Germany,DEU,0,0,36,36,72
2017,Kenya,KEN,Germany,DEU,0,0,12,54,66
2017,Kyrgyzstan,KGZ,Germany,DEU,0,0,5,17,22
2017,Liberia,LBR,Germany,DEU,0,0,10,46,56
2017,Libya,LBY,Germany,DEU,34,46,91,251,422
2017,Lebanon,LBN,Germany,DEU,0,12,734,480,1226
2017,Sri Lanka,LKA,Germany,DEU,13,5,72,70,160
2017,Madagascar,MDG,Germany,DEU,0,0,0,5,5
2017,Mauritania,MRT,Germany,DEU,0,0,28,32,60
2017,North Macedonia,MKD,Germany,DEU,5,35,1347,2220,3607
2017,Rep. of Moldova,MDA,Germany,DEU,0,0,357,1447,1804
2017,Mali,MLI,Germany,DEU,0,11,188,219,418
2017,Mongolia,MNG,Germany,DEU,0,0,29,76,105
2017,Morocco,MAR,Germany,DEU,5,5,366,577,953
2017,Mozambique,MOZ,Germany,DEU,0,0,0,5,5
2017,Montenegro,MNE,Germany,DEU,0,12,165,358,535
2017,Myanmar,MMR,Germany,DEU,11,0,5,12,28
2017,Nepal,NPL,Germany,DEU,0,0,5,17,22
2017,Niger,NER,Germany,DEU,0,0,28,48,76
2017,Nigeria,NGA,Germany,DEU,27,77,1152,1625,2881
2017,Pakistan,PAK,Germany,DEU,589,63,2828,2906,6386
2017,Peru,PER,Germany,DEU,0,0,0,5,5
2017,Philippines,PHL,Germany,DEU,0,0,5,5,10
2017,Romania,ROU,Germany,DEU,0,0,0,5,5
2017,Russian Federation,RUS,Germany,DEU,70,132,1457,5403,7062
2017,Rwanda,RWA,Germany,DEU,0,0,0,5,5
2017,Saudi Arabia,SAU,Germany,DEU,0,0,0,5,5
2017,Serbia and Kosovo: S/RES/1244 (1999),SRB,Germany,DEU,10,167,3555,5143,8875
2017,Senegal,SEN,Germany,DEU,5,15,302,289,611
2017,Sierra Leone,SLE,Germany,DEU,0,5,64,218,287
2017,Somalia,SOM,Germany,DEU,73,392,282,1444,2191
2017,Spain,ESP,Germany,DEU,0,0,5,0,5
2017,Viet Nam,VNM,Germany,DEU,0,0,57,70,127
2017,Sudan,SDN,Germany,DEU,55,13,55,340,463
2017,South Sudan,SSD,Germany,DEU,0,5,0,16,21
2017,Syrian Arab Rep.,SYR,Germany,DEU,18594,476,11688,9414,40172
2017,United Rep. of Tanzania,TZA,Germany,DEU,0,0,0,26,26
2017,Thailand,THA,Germany,DEU,0,0,0,5,5
2017,Tajikistan,TJK,Germany,DEU,0,5,27,299,331
2017,Turkmenistan,TKM,Germany,DEU,0,5,12,12,29
2017,Togo,TGO,Germany,DEU,0,0,18,33,51
2017,Tunisia,TUN,Germany,DEU,10,10,141,242,403
2017,Turkey,TUR,Germany,DEU,47,23,180,698,948
2017,Uganda,UGA,Germany,DEU,0,0,10,17,27
2017,Ukraine,UKR,Germany,DEU,5,15,1191,996,2207
2017,United States of America,USA,Germany,DEU,0,0,0,5,5
2017,Uzbekistan,UZB,Germany,DEU,0,0,0,13,13
2017,Venezuela (Bolivarian Republic of),VEN,Germany,DEU,0,0,5,13,18
2017,Yemen,YEM,Germany,DEU,0,0,5,81,86
2017,Zimbabwe,ZWE,Germany,DEU,11,0,12,30,53
2017,Stateless,XXA,Germany,DEU,503,12,230,332,1077
2017,Afghanistan,AFG,Croatia,HRV,0,0,19,12,31
2017,Algeria,DZA,Croatia,HRV,0,0,0,5,5
2017,Iran (Islamic Rep. of),IRN,Croatia,HRV,5,0,5,13,23
2017,Iraq,IRQ,Croatia,HRV,10,0,5,26,41
2017,Morocco,MAR,Croatia,HRV,0,0,5,5,10
2017,Nigeria,NGA,Croatia,HRV,0,0,5,0,5
2017,Pakistan,PAK,Croatia,HRV,0,0,0,5,5
2017,Serbia and Kosovo: S/RES/1244 (1999),SRB,Croatia,HRV,0,0,5,0,5
2017,Syrian Arab Rep.,SYR,Croatia,HRV,5,0,5,13,23
2017,Lebanon,LBN,Rep. of Moldova,MDA,0,0,5,0,5
2017,Sri Lanka,LKA,Rep. of Moldova,MDA,0,0,5,0,5
2017,Ukraine,UKR,Rep. of Moldova,MDA,0,0,10,0,10
2017,Afghanistan,AFG,Romania,ROU,0,10,5,0,15
2017,Bangladesh,BGD,Romania,ROU,0,0,5,0,5
2017,Cameroon,CMR,Romania,ROU,0,0,5,0,5
2017,Dem. Rep. of the Congo,COD,Romania,ROU,0,5,0,0,5
2017,Iran (Islamic Rep. of),IRN,Romania,ROU,0,0,5,0,5
2017,Iraq,IRQ,Romania,ROU,0,27,38,0,65
2017,Pakistan,PAK,Romania,ROU,0,0,11,0,11
2017,Sudan,SDN,Romania,ROU,0,0,5,0,5
2017,Syrian Arab Rep.,SYR,Romania,ROU,0,23,0,0,23
2017,Turkey,TUR,Romania,ROU,12,0,0,0,12
2017,Stateless,XXA,Romania,ROU,0,12,0,0,12
2017,Afghanistan,AFG,Ukraine,UKR,0,0,97,21,118
2017,Bangladesh,BGD,Ukraine,UKR,0,0,5,0,5
2017,Cameroon,CMR,Ukraine,UKR,0,0,5,20,25
2017,Dem. Rep. of the Congo,COD,Ukraine,UKR,0,0,5,35,40
2017,Palestinian,PSE,Ukraine,UKR,0,0,5,0,5
2017,Georgia,GEO,Ukraine,UKR,0,0,0,25,25
2017,Guinea,GIN,Ukraine,UKR,0,0,5,0,5
2017,India,IND,Ukraine,UKR,0,0,0,16,16
2017,Iran (Islamic Rep. of),IRN,Ukraine,UKR,0,0,5,0,5
2017,Iraq,IRQ,Ukraine,UKR,5,0,5,0,10
2017,Kyrgyzstan,KGZ,Ukraine,UKR,0,0,5,0,5
2017,Liberia,LBR,Ukraine,UKR,0,0,5,0,5
2017,Lebanon,LBN,Ukraine,UKR,0,0,5,0,5
2017,Nigeria,NGA,Ukraine,UKR,0,0,0,17,17
2017,Pakistan,PAK,Ukraine,UKR,0,0,5,0,5
2017,Russian Federation,RUS,Ukraine,UKR,11,0,0,0,11
2017,Somalia,SOM,Ukraine,UKR,0,0,26,31,57
2017,Sudan,SDN,Ukraine,UKR,0,0,0,12,12
2017,Syrian Arab Rep.,SYR,Ukraine,UKR,21,0,19,0,40
2017,Togo,TGO,Ukraine,UKR,0,0,0,18,18
2017,Uganda,UGA,Ukraine,UKR,0,0,0,5,5
2017,Uzbekistan,UZB,Ukraine,UKR,0,0,18,0,18
2017,Stateless,XXA,Ukraine,UKR,0,0,5,22,27
2018,Iran (Islamic Rep. of),IRN,Armenia,ARM,0,0,5,0,5
2018,Bangladesh,BGD,Belarus,BLR,0,0,5,0,5
2018,Russian Federation,RUS,Belarus,BLR,0,0,5,0,5
2018,Ukraine,UKR,Belarus,BLR,0,0,0,5,5
2018,Algeria,DZA,Bosnia and Herzegovina,BIH,0,0,5,0,5
2018,Pakistan,PAK,Bosnia and Herzegovina,BIH,0,0,5,0,5
2018,Russian Federation,RUS,Bosnia and Herzegovina,BIH,0,0,10,0,10
2018,Turkey,TUR,Bosnia and Herzegovina,BIH,0,5,0,0,5
2018,Afghanistan,AFG,Germany,DEU,1663,9598,8274,8715,28250
2018,Albania,ALB,Germany,DEU,5,90,698,1661,2454
2018,Algeria,DZA,Germany,DEU,5,11,334,658,1008
2018,Angola,AGO,Germany,DEU,5,5,25,126,161
2018,Egypt,EGY,Germany,DEU,134,21,397,519,1071
2018,Armenia,ARM,Germany,DEU,5,153,1562,2004,3724
2018,Azerbaijan,AZE,Germany,DEU,24,48,948,1736,2756
2018,Bahrain,BHR,Germany,DEU,0,0,5,5,10
2018,Burundi,BDI,Germany,DEU,0,0,5,0,5
2018,Benin,BEN,Germany,DEU,0,0,80,50,130
2018,Bangladesh,BGD,Germany,DEU,15,31,858,405,1309
2018,Burkina Faso,BFA,Germany,DEU,0,5,55,74,134
2018,Belarus,BLR,Germany,DEU,5,0,42,186,233
2018,Brazil,BRA,Germany,DEU,0,0,0,5,5
2018,Bosnia and Herzegovina,BIH,Germany,DEU,0,27,178,340,545
2018,Central African Rep.,CAF,Germany,DEU,0,0,18,15,33
2018,Chad,TCD,Germany,DEU,0,0,5,80,85
2018,China,CHN,Germany,DEU,42,5,181,261,489
2018,Chile,CHL,Germany,DEU,0,0,0,5,5
2018,Cameroon,CMR,Germany,DEU,0,11,117,619,747
2018,Congo,COG,Germany,DEU,0,5,10,16,31
2018,Dem. Rep. of the Congo,COD,Germany,DEU,0,23,100,157,280
2018,Colombia,COL,Germany,DEU,0,0,16,15,31
2018,Cuba,CUB,Germany,DEU,0,0,72,37,109
2018,Djibouti,DJI,Germany,DEU,0,0,0,10,10
2018,Equatorial Guinea,GNQ,Germany,DEU,0,0,5,5,10
2018,Eritrea,ERI,Germany,DEU,207,132,673,1954,2966
2018,Ethiopia,ETH,Germany,DEU,151,56,731,921,1859
2018,Gabon,GAB,Germany,DEU,0,0,0,14,14
2018,Gambia,GMB,Germany,DEU,10,14,1057,1900,2981
2018,United Kingdom of Great Britain and Northern Ireland,GBR,Germany,DEU,0,5,0,5,10
2018,Georgia,GEO,Germany,DEU,5,24,1248,1787,3064
2018,Ghana,GHA,Germany,DEU,5,13,466,643,1127
2018,Guinea-Bissau,GNB,Germany,DEU,5,0,43,65,113
2018,Greece,GRC,Germany,DEU,0,0,5,0,5
2018,Guinea,GIN,Germany,DEU,25,18,601,1642,2286
2018,Honduras,HND,Germany,DEU,0,10,0,0,10
2018,Cote d'Ivoire,CIV,Germany,DEU,0,15,271,826,1112
2018,India,IND,Germany,DEU,0,15,596,412,1023
2018,Indonesia,IDN,Germany,DEU,0,0,0,5,5
2018,Iran (Islamic Rep. of),IRN,Germany,DEU,1261,94,1651,2873,5879
2018,Iraq,IRQ,Germany,DEU,644,1078,7587,6865,16174
2018,Israel,ISR,Germany,DEU,0,0,0,5,5
2018,Italy,ITA,Germany,DEU,0,0,0,5,5
2018,Jamaica,JAM,Germany,DEU,5,0,24,11,40
2018,Jordan,JOR,Germany,DEU,5,10,61,87,163
2018,Kazakhstan,KAZ,Germany,DEU,5,0,23,58,86
2018,Kenya,KEN,Germany,DEU,0,0,28,110,138
2018,Kyrgyzstan,KGZ,Germany,DEU,0,0,14,44,58
2018,Rep. of Korea,KOR,Germany,DEU,0,0,5,0,5
2018,Dem. People's Rep. of Korea,PRK,Germany,DEU,0,0,0,10,10
2018,Kuwait,KWT,Germany,DEU,0,0,5,14,19
2018,Liberia,LBR,Germany,DEU,0,5,26,127,158
2018,Libya,LBY,Germany,DEU,23,129,243,551,946
2018,Lebanon,LBN,Germany,DEU,14,49,1332,651,2046
2018,Sri Lanka,LKA,Germany,DEU,20,13,181,224,438
2018,Latvia,LVA,Germany,DEU,0,0,0,5,5
2018,Mauritania,MRT,Germany,DEU,0,0,22,17,39
2018,North Macedonia,MKD,Germany,DEU,0,38,529,1188,1755
2018,Rep. of Moldova,MDA,Germany,DEU,0,0,422,554,976
2018,Mexico,MEX,Germany,DEU,0,5,0,0,5
2018,Mali,MLI,Germany,DEU,0,10,308,359,677
2018,Malaysia,MYS,Germany,DEU,0,0,5,0,5
2018,Mongolia,MNG,Germany,DEU,0,0,246,220,466
2018,Morocco,MAR,Germany,DEU,16,18,373,590,997
2018,Mozambique,MOZ,Germany,DEU,0,0,0,5,5
2018,Montenegro,MNE,Germany,DEU,0,5,85,189,279
2018,Mauritius,MUS,Germany,DEU,0,0,0,5,5
2018,Myanmar,MMR,Germany,DEU,0,0,0,14,14
2018,Nepal,NPL,Germany,DEU,0,0,5,30,35
2018,Niger,NER,Germany,DEU,0,0,33,58,91
2018,Nigeria,NGA,Germany,DEU,62,248,2935,4777,8022
2018,Pakistan,PAK,Germany,DEU,561,109,4157,3080,7907
2018,Philippines,PHL,Germany,DEU,0,0,0,14,14
2018,Poland,POL,Germany,DEU,0,0,0,5,5
2018,South Africa,ZAF,Germany,DEU,0,0,0,10,10
2018,Russian Federation,RUS,Germany,DEU,145,191,2113,4688,7137
2018,Rwanda,RWA,Germany,DEU,20,0,0,10,30
2018,El Salvador,SLV,Germany,DEU,0,0,0,37,37
2018,Saudi Arabia,SAU,Germany,DEU,5,0,13,5,23
2018,Serbia and Kosovo: S/RES/1244 (1999),SRB,Germany,DEU,0,116,1033,2535,3684
2018,Senegal,SEN,Germany,DEU,0,16,165,207,388
2018,Sierra Leone,SLE,Germany,DEU,0,5,143,511,659
2018,Somalia,SOM,Germany,DEU,120,416,543,2664,3743
2018,Spain,ESP,Germany,DEU,0,0,0,22,22
2018,Viet Nam,VNM,Germany,DEU,0,0,44,90,134
2018,Sudan,SDN,Germany,DEU,106,16,149,745,1016
2018,South Sudan,SSD,Germany,DEU,0,0,12,27,39
2018,Syrian Arab Rep.,SYR,Germany,DEU,8877,1087,16075,8815,34854
2018,United Rep. of Tanzania,TZA,Germany,DEU,0,0,5,31,36
2018,Thailand,THA,Germany,DEU,0,0,0,5,5
2018,Tajikistan,TJK,Germany,DEU,5,15,438,693,1151
2018,Turkmenistan,TKM,Germany,DEU,0,0,5,41,46
2018,Togo,TGO,Germany,DEU,0,0,15,151,166
2018,Tunisia,TUN,Germany,DEU,11,0,112,260,383
2018,Turkey,TUR,Germany,DEU,120,35,859,1808,2822
2018,Uganda,UGA,Germany,DEU,0,0,19,46,65
2018,Ukraine,UKR,Germany,DEU,5,10,1140,826,1981
2018,United States of America,USA,Germany,DEU,0,0,0,5,5
2018,Uzbekistan,UZB,Germany,DEU,0,0,5,11,16
2018,Venezuela (Bolivarian Republic of),VEN,Germany,DEU,0,5,19,25,49
2018,Yemen,YEM,Germany,DEU,19,0,124,203,346
2018,Zimbabwe,ZWE,Germany,DEU,19,0,26,34,79
2018,Stateless,XXA,Germany,DEU,342,29,289,419,1079
2018,Afghanistan,AFG,Croatia,HRV,0,0,50,0,50
2018,Algeria,DZA,Croatia,HRV,0,0,10,0,10
2018,Egypt,EGY,Croatia,HRV,0,0,5,0,5
2018,Bangladesh,BGD,Croatia,HRV,5,0,0,0,5
2018,Iran (Islamic Rep. of),IRN,Croatia,HRV,5,0,14,0,19
2018,Iraq,IRQ,Croatia,HRV,5,0,10,0,15
2018,Morocco,MAR,Croatia,HRV,0,0,5,0,5
2018,Pakistan,PAK,Croatia,HRV,0,0,5,0,5
2018,Syrian Arab Rep.,SYR,Croatia,HRV,0,5,14,0,19
2018,Tunisia,TUN,Croatia,HRV,0,0,12,0,12
2018,Georgia,GEO,Rep. of Moldova,MDA,0,0,0,5,5
2018,Syrian Arab Rep.,SYR,Rep. of Moldova,MDA,0,0,0,5,5
2018,Turkey,TUR,Rep. of Moldova,MDA,0,0,0,5,5
2018,Ukraine,UKR,Rep. of Moldova,MDA,0,0,0,10,10
2018,Afghanistan,AFG,Romania,ROU,0,5,17,0,22
2018,Bangladesh,BGD,Romania,ROU,0,0,5,0,5
2018,Cuba,CUB,Romania,ROU,0,0,5,0,5
2018,Palestinian,PSE,Romania,ROU,0,0,5,0,5
2018,India,IND,Romania,ROU,0,0,5,0,5
2018,Iran (Islamic Rep. of),IRN,Romania,ROU,5,12,10,0,27
2018,Iraq,IRQ,Romania,ROU,0,24,73,0,97
2018,Pakistan,PAK,Romania,ROU,0,0,10,0,10
2018,Somalia,SOM,Romania,ROU,0,0,5,0,5
2018,Syrian Arab Rep.,SYR,Romania,ROU,0,11,0,0,11
2018,Turkey,TUR,Romania,ROU,11,0,0,0,11
2018,Stateless,XXA,Romania,ROU,0,5,0,0,5
2018,Afghanistan,AFG,Sweden,SWE,367,280,8909,1154,10710
2018,Albania,ALB,Sweden,SWE,0,0,350,24,374
2018,Algeria,DZA,Sweden,SWE,0,0,55,10,65
2018,Angola,AGO,Sweden,SWE,0,0,19,0,19
2018,Egypt,EGY,Sweden,SWE,0,0,87,35,122
2018,Armenia,ARM,Sweden,SWE,5,0,149,11,165
2018,Azerbaijan,AZE,Sweden,SWE,0,0,142,22,164
2018,Burundi,BDI,Sweden,SWE,5,0,19,0,24
2018,Bangladesh,BGD,Sweden,SWE,5,0,77,21,103
2018,Burkina Faso,BFA,Sweden,SWE,0,0,5,0,5
2018,Belarus,BLR,Sweden,SWE,0,0,50,12,62
2018,Bolivia (Plurinational State of),BOL,Sweden,SWE,0,0,15,5,20
2018,Brazil,BRA,Sweden,SWE,0,0,10,0,10
2018,Bosnia and Herzegovina,BIH,Sweden,SWE,0,0,58,12,70
2018,Canada,CAN,Sweden,SWE,0,0,0,5,5
2018,Central African Rep.,CAF,Sweden,SWE,0,0,5,0,5
2018,Chad,TCD,Sweden,SWE,0,0,5,0,5
2018,China,CHN,Sweden,SWE,0,0,11,5,16
2018,Chile,CHL,Sweden,SWE,0,0,22,5,27
2018,Cameroon,CMR,Sweden,SWE,0,0,20,0,20
2018,Congo,COG,Sweden,SWE,0,0,12,0,12
2018,Dem. Rep. of the Congo,COD,Sweden,SWE,0,0,20,5,25
2018,Colombia,COL,Sweden,SWE,0,0,124,14,138
2018,Cuba,CUB,Sweden,SWE,0,0,21,0,21
2018,Ecuador,ECU,Sweden,SWE,0,0,12,0,12
2018,Eritrea,ERI,Sweden,SWE,13,5,65,24,107
2018,Ethiopia,ETH,Sweden,SWE,22,0,297,75,394
2018,Gambia,GMB,Sweden,SWE,5,0,58,5,68
2018,Palestinian,PSE,Sweden,SWE,5,0,80,30,115
2018,Georgia,GEO,Sweden,SWE,0,0,533,54,587
2018,Ghana,GHA,Sweden,SWE,0,0,23,0,23
2018,Guinea-Bissau,GNB,Sweden,SWE,0,0,5,0,5
2018,Guinea,GIN,Sweden,SWE,0,0,16,0,16
2018,Honduras,HND,Sweden,SWE,0,0,10,0,10
2018,Cote d'Ivoire,CIV,Sweden,SWE,0,0,14,0,14
2018,India,IND,Sweden,SWE,0,0,39,5,44
2018,Iran (Islamic Rep. of),IRN,Sweden,SWE,88,0,454,87,629
2018,Iraq,IRQ,Sweden,SWE,170,97,2545,667,3479
2018,Italy,ITA,Sweden,SWE,0,0,5,0,5
2018,Jordan,JOR,Sweden,SWE,5,0,89,12,106
2018,Kazakhstan,KAZ,Sweden,SWE,0,0,107,11,118
2018,Kenya,KEN,Sweden,SWE,0,0,20,0,20
2018,Kyrgyzstan,KGZ,Sweden,SWE,0,5,89,13,107
2018,Dem. People's Rep. of Korea,PRK,Sweden,SWE,0,0,5,0,5
2018,Kuwait,KWT,Sweden,SWE,5,0,20,0,25
2018,Libya,LBY,Sweden,SWE,0,0,53,10,63
2018,Lebanon,LBN,Sweden,SWE,5,0,196,25,226
2018,Sri Lanka,LKA,Sweden,SWE,0,0,18,0,18
2018,Mauritania,MRT,Sweden,SWE,0,0,5,0,5
2018,North Macedonia,MKD,Sweden,SWE,0,0,62,11,73
2018,Rep. of Moldova,MDA,Sweden,SWE,0,0,10,0,10
2018,Mexico,MEX,Sweden,SWE,0,0,0,5,5
2018,Mali,MLI,Sweden,SWE,0,0,5,0,5
2018,Mongolia,MNG,Sweden,SWE,0,0,316,47,363
2018,Morocco,MAR,Sweden,SWE,0,0,180,26,206
2018,Montenegro,MNE,Sweden,SWE,0,0,14,0,14
2018,Nepal,NPL,Sweden,SWE,0,0,5,5,10
2018,Niger,NER,Sweden,SWE,0,0,5,0,5
2018,Nicaragua,NIC,Sweden,SWE,0,0,51,5,56
2018,Nigeria,NGA,Sweden,SWE,10,0,140,24,174
2018,Pakistan,PAK,Sweden,SWE,5,0,123,31,159
2018,Peru,PER,Sweden,SWE,0,0,35,10,45
2018,Philippines,PHL,Sweden,SWE,0,0,12,0,12
2018,South Africa,ZAF,Sweden,SWE,0,0,10,0,10
2018,Russian Federation,RUS,Sweden,SWE,5,0,132,46,183
2018,Rwanda,RWA,Sweden,SWE,0,0,10,0,10
2018,El Salvador,SLV,Sweden,SWE,5,0,110,10,125
2018,Saudi Arabia,SAU,Sweden,SWE,0,0,11,0,11
2018,Serbia and Kosovo: S/RES/1244 (1999),SRB,Sweden,SWE,0,0,219,42,261
2018,Senegal,SEN,Sweden,SWE,0,0,12,5,17
2018,Sierra Leone,SLE,Sweden,SWE,0,0,11,0,11
2018,Somalia,SOM,Sweden,SWE,43,15,600,106,764
2018,Viet Nam,VNM,Sweden,SWE,0,0,23,0,23
2018,Sudan,SDN,Sweden,SWE,10,0,59,18,87
2018,Syrian Arab Rep.,SYR,Sweden,SWE,5,12,246,341,604
2018,United Rep. of Tanzania,TZA,Sweden,SWE,0,0,5,0,5
2018,Thailand,THA,Sweden,SWE,0,0,11,0,11
2018,Tajikistan,TJK,Sweden,SWE,0,0,19,10,29
2018,Togo,TGO,Sweden,SWE,0,0,5,0,5
2018,Tunisia,TUN,Sweden,SWE,0,0,49,10,59
2018,Turkey,TUR,Sweden,SWE,11,5,91,68,175
2018,Uganda,UGA,Sweden,SWE,5,0,15,0,20
2018,Ukraine,UKR,Sweden,SWE,5,0,289,64,358
2018,United States of America,USA,Sweden,SWE,0,0,5,0,5
2018,Uzbekistan,UZB,Sweden,SWE,0,0,134,34,168
2018,Venezuela (Bolivarian Republic of),VEN,Sweden,SWE,0,0,37,5,42
2018,Yemen,YEM,Sweden,SWE,0,0,17,17,34
2018,Stateless,XXA,Sweden,SWE,50,5,408,77,540
2018,Afghanistan,AFG,Ukraine,UKR,0,0,52,0,52
2018,Azerbaijan,AZE,Ukraine,UKR,0,0,5,0,5
2018,Bangladesh,BGD,Ukraine,UKR,0,0,14,0,14
2018,Cameroon,CMR,Ukraine,UKR,0,0,5,0,5
2018,Dem. Rep. of the Congo,COD,Ukraine,UKR,0,0,10,0,10
2018,Eritrea,ERI,Ukraine,UKR,0,0,5,0,5
2018,Palestinian,PSE,Ukraine,UKR,0,0,11,0,11
2018,Iran (Islamic Rep. of),IRN,Ukraine,UKR,0,0,10,0,10
2018,Iraq,IRQ,Ukraine,UKR,0,0,13,0,13
2018,Nigeria,NGA,Ukraine,UKR,0,0,5,0,5
2018,Pakistan,PAK,Ukraine,UKR,0,0,5,0,5
2018,Russian Federation,RUS,Ukraine,UKR,5,0,29,5,39
2018,Somalia,SOM,Ukraine,UKR,0,0,37,0,37
2018,Sudan,SDN,Ukraine,UKR,0,0,5,0,5
2018,Syrian Arab Rep.,SYR,Ukraine,UKR,5,0,19,0,24
2018,Tajikistan,TJK,Ukraine,UKR,0,0,5,0,5
2018,Uzbekistan,UZB,Ukraine,UKR,0,0,5,5,10
2018,Yemen,YEM,Ukraine,UKR,0,0,0,5,5
2019,Afghanistan,AFG,Belarus,BLR,0,0,19,0,19
2019,Russian Federation,RUS,Belarus,BLR,0,0,5,0,5
2019,Afghanistan,AFG,Bosnia and Herzegovina,BIH,0,0,10,0,10
2019,Pakistan,PAK,Bosnia and Herzegovina,BIH,0,0,5,0,5
2019,Russian Federation,RUS,Bosnia and Herzegovina,BIH,0,0,5,0,5
2019,Afghanistan,AFG,Germany,DEU,1606,7043,9103,7627,25379
2019,Albania,ALB,Germany,DEU,0,47,415,1211,1673
2019,Algeria,DZA,Germany,DEU,5,13,253,560,831
2019,Angola,AGO,Germany,DEU,0,27,38,157,222
2019,Egypt,EGY,Germany,DEU,62,42,470,428,1002
2019,Argentina,ARG,Germany,DEU,0,0,0,5,5
2019,Armenia,ARM,Germany,DEU,11,149,1721,1654,3535
2019,Azerbaijan,AZE,Germany,DEU,39,81,1480,1289,2889
2019,Bahrain,BHR,Germany,DEU,0,0,11,0,11
2019,Burundi,BDI,Germany,DEU,0,0,0,13,13
2019,Benin,BEN,Germany,DEU,0,0,56,68,124
2019,Bangladesh,BGD,Germany,DEU,17,20,422,244,703
2019,Burkina Faso,BFA,Germany,DEU,0,5,37,53,95
2019,Belarus,BLR,Germany,DEU,5,5,15,168,193
2019,Brazil,BRA,Germany,DEU,0,0,0,5,5
2019,Bosnia and Herzegovina,BIH,Germany,DEU,0,12,52,224,288
2019,Bulgaria,BGR,Germany,DEU,0,0,0,10,10
2019,Cambodia,KHM,Germany,DEU,0,0,5,0,5
2019,Central African Rep.,CAF,Germany,DEU,0,5,25,12,42
2019,Chad,TCD,Germany,DEU,0,5,15,53,73
2019,China,CHN,Germany,DEU,84,15,178,308,585
2019,Cameroon,CMR,Germany,DEU,16,30,475,570,1091
2019,Congo,COG,Germany,DEU,0,5,19,35,59
2019,Dem. Rep. of the Congo,COD,Germany,DEU,0,18,85,110,213
2019,Colombia,COL,Germany,DEU,0,0,18,26,44
2019,Cuba,CUB,Germany,DEU,0,0,21,24,45
2019,Cabo Verde,CPV,Germany,DEU,0,0,0,5,5
2019,Djibouti,DJI,Germany,DEU,0,0,0,19,19
2019,Dominican Rep.,DOM,Germany,DEU,0,0,0,5,5
2019,Eritrea,ERI,Germany,DEU,158,165,478,1514,2315
2019,Ethiopia,ETH,Germany,DEU,33,129,1370,753,2285
2019,Gabon,GAB,Germany,DEU,0,0,5,10,15
2019,Gambia,GMB,Germany,DEU,5,62,1927,1641,3635
2019,Georgia,GEO,Germany,DEU,5,24,1511,1603,3143
2019,Ghana,GHA,Germany,DEU,0,26,329,692,1047
2019,Guinea-Bissau,GNB,Germany,DEU,0,5,63,105,173
2019,Guinea,GIN,Germany,DEU,20,54,1250,1603,2927
2019,Haiti,HTI,Germany,DEU,0,0,0,5,5
2019,Honduras,HND,Germany,DEU,0,0,5,0,5
2019,Croatia,HRV,Germany,DEU,0,0,0,5,5
2019,Cote d'Ivoire,CIV,Germany,DEU,10,34,614,480,1138
2019,India,IND,Germany,DEU,0,22,315,442,779
2019,Indonesia,IDN,Germany,DEU,0,0,5,5,10
2019,Iran (Islamic Rep. of),IRN,Germany,DEU,1413,132,2522,3223,7290
2019,Iraq,IRQ,Germany,DEU,653,1742,8182,6212,16789
2019,Israel,ISR,Germany,DEU,0,0,5,0,5
2019,Italy,ITA,Germany,DEU,0,0,5,5,10
2019,Jamaica,JAM,Germany,DEU,0,0,5,13,18
2019,Jordan,JOR,Germany,DEU,10,0,65,100,175
2019,Kazakhstan,KAZ,Germany,DEU,0,5,64,73,142
2019,Kenya,KEN,Germany,DEU,0,0,56,137,193
2019,Kyrgyzstan,KGZ,Germany,DEU,5,10,38,64,117
2019,Dem. People's Rep. of Korea,PRK,Germany,DEU,0,0,0,5,5
2019,Kuwait,KWT,Germany,DEU,0,5,0,25,30
2019,Liberia,LBR,Germany,DEU,0,0,46,99,145
2019,Libya,LBY,Germany,DEU,19,79,213,334,645
2019,Lebanon,LBN,Germany,DEU,5,40,660,526,1231
2019,Sri Lanka,LKA,Germany,DEU,28,26,194,216,464
2019,Madagascar,MDG,Germany,DEU,0,0,5,0,5
2019,Mauritania,MRT,Germany,DEU,5,0,17,14,36
2019,North Macedonia,MKD,Germany,DEU,0,24,260,1012,1296
2019,Rep. of Moldova,MDA,Germany,DEU,0,5,406,923,1334
2019,Mali,MLI,Germany,DEU,5,12,196,233,446
2019,Malaysia,MYS,Germany,DEU,0,0,0,10,10
2019,Malawi,MWI,Germany,DEU,0,0,0,5,5
2019,Mongolia,MNG,Germany,DEU,0,36,235,178,449
2019,Morocco,MAR,Germany,DEU,14,14,245,490,763
2019,Mozambique,MOZ,Germany,DEU,0,0,0,10,10
2019,Montenegro,MNE,Germany,DEU,0,0,24,157,181
2019,Mauritius,MUS,Germany,DEU,0,0,0,5,5
2019,Myanmar,MMR,Germany,DEU,0,0,5,26,31
2019,Namibia,NAM,Germany,DEU,0,0,0,5,5
2019,Nepal,NPL,Germany,DEU,0,5,19,31,55
2019,Netherlands,NLD,Germany,DEU,0,0,0,5,5
2019,Niger,NER,Germany,DEU,0,5,31,57,93
2019,Nigeria,NGA,Germany,DEU,78,459,3532,6636,10705
2019,Pakistan,PAK,Germany,DEU,698,98,3350,2263,6409
2019,Peru,PER,Germany,DEU,0,0,0,5,5
2019,Philippines,PHL,Germany,DEU,0,0,5,10,15
2019,South Africa,ZAF,Germany,DEU,0,0,0,10,10
2019,Russian Federation,RUS,Germany,DEU,221,223,2915,3568,6927
2019,Rwanda,RWA,Germany,DEU,20,0,0,17,37
2019,Saudi Arabia,SAU,Germany,DEU,0,0,0,11,11
2019,Serbia and Kosovo: S/RES/1244 (1999),SRB,Germany,DEU,5,65,578,1690,2338
2019,Senegal,SEN,Germany,DEU,0,5,112,240,357
2019,Sierra Leone,SLE,Germany,DEU,0,18,373,260,651
2019,Somalia,SOM,Germany,DEU,144,492,795,2455,3886
2019,Spain,ESP,Germany,DEU,0,0,0,5,5
2019,Viet Nam,VNM,Germany,DEU,0,0,48,76,124
2019,Sudan,SDN,Germany,DEU,38,15,142,397,592
2019,South Sudan,SSD,Germany,DEU,0,10,0,16,26
2019,Syrian Arab Rep.,SYR,Germany,DEU,2651,1282,8345,7054,19332
2019,United Rep. of Tanzania,TZA,Germany,DEU,0,0,23,40,63
2019,Thailand,THA,Germany,DEU,0,0,0,5,5
2019,Tajikistan,TJK,Germany,DEU,74,41,597,378,1090
2019,Turkmenistan,TKM,Germany,DEU,0,0,5,15,20
2019,Togo,TGO,Germany,DEU,10,0,199,148,357
2019,Tunisia,TUN,Germany,DEU,10,5,84,248,347
2019,Turkey,TUR,Germany,DEU,361,45,1783,1957,4146
2019,United Arab Emirates,ARE,Germany,DEU,0,5,0,0,5
2019,Uganda,UGA,Germany,DEU,0,0,16,39,55
2019,Ukraine,UKR,Germany,DEU,14,32,1213,618,1877
2019,United States of America,USA,Germany,DEU,0,0,5,10,15
2019,Uzbekistan,UZB,Germany,DEU,0,5,5,18,28
2019,Venezuela (Bolivarian Republic of),VEN,Germany,DEU,16,70,36,49,171
2019,Yemen,YEM,Germany,DEU,17,5,117,199,338
2019,Zimbabwe,ZWE,Germany,DEU,23,0,59,40,122
2019,Stateless,XXA,Germany,DEU,123,33,198,306,660
2019,Afghanistan,AFG,Croatia,HRV,0,0,10,0,10
2019,Algeria,DZA,Croatia,HRV,0,0,15,0,15
2019,Iran (Islamic Rep. of),IRN,Croatia,HRV,0,0,5,11,16
2019,Iraq,IRQ,Croatia,HRV,5,0,5,0,10
2019,Pakistan,PAK,Croatia,HRV,0,0,5,0,5
2019,Russian Federation,RUS,Croatia,HRV,0,0,5,0,5
2019,Serbia and Kosovo: S/RES/1244 (1999),SRB,Croatia,HRV,0,0,0,5,5
2019,Syrian Arab Rep.,SYR,Croatia,HRV,0,0,0,14,14
2019,Afghanistan,AFG,Rep. of Moldova,MDA,0,0,5,0,5
2019,Bangladesh,BGD,Rep. of Moldova,MDA,0,0,5,0,5
2019,Kyrgyzstan,KGZ,Rep. of Moldova,MDA,0,0,5,0,5
2019,Turkey,TUR,Rep. of Moldova,MDA,0,0,10,0,10
2019,Afghanistan,AFG,Romania,ROU,0,0,5,0,5
2019,Egypt,EGY,Romania,ROU,0,0,16,0,16
2019,Cameroon,CMR,Romania,ROU,0,0,10,0,10
2019,Dem. Rep. of the Congo,COD,Romania,ROU,0,5,0,0,5
2019,Palestinian,PSE,Romania,ROU,5,0,5,0,10
2019,Guinea,GIN,Romania,ROU,0,0,5,0,5
2019,India,IND,Romania,ROU,0,0,5,0,5
2019,Iran (Islamic Rep. of),IRN,Romania,ROU,11,5,12,0,28
2019,Iraq,IRQ,Romania,ROU,0,10,63,0,73
2019,Nigeria,NGA,Romania,ROU,0,0,5,0,5
2019,Pakistan,PAK,Romania,ROU,0,0,5,0,5
2019,Turkey,TUR,Romania,ROU,10,0,17,0,27
2019,Afghanistan,AFG,Ukraine,UKR,0,0,78,1329,1407
2019,Angola,AGO,Ukraine,UKR,0,0,0,12,12
2019,Egypt,EGY,Ukraine,UKR,0,0,0,5,5
2019,Armenia,ARM,Ukraine,UKR,0,0,0,11,11
2019,Azerbaijan,AZE,Ukraine,UKR,0,0,5,26,31
2019,Burundi,BDI,Ukraine,UKR,0,0,0,5,5
2019,Bangladesh,BGD,Ukraine,UKR,0,0,32,24,56
2019,Belarus,BLR,Ukraine,UKR,0,0,0,24,24
2019,Cambodia,KHM,Ukraine,UKR,0,0,0,5,5
2019,China,CHN,Ukraine,UKR,0,0,0,5,5
2019,Cameroon,CMR,Ukraine,UKR,0,0,11,59,70
2019,Congo,COG,Ukraine,UKR,0,0,5,19,24
2019,Dem. Rep. of the Congo,COD,Ukraine,UKR,0,0,14,85,99
2019,Eritrea,ERI,Ukraine,UKR,0,0,0,12,12
2019,Ethiopia,ETH,Ukraine,UKR,0,0,5,23,28
2019,Gambia,GMB,Ukraine,UKR,0,0,0,5,5
2019,Palestinian,PSE,Ukraine,UKR,0,0,5,83,88
2019,Georgia,GEO,Ukraine,UKR,0,0,0,59,59
2019,Guinea,GIN,Ukraine,UKR,0,0,13,71,84
2019,Cote d'Ivoire,CIV,Ukraine,UKR,0,0,5,12,17
2019,India,IND,Ukraine,UKR,0,0,5,13,18
2019,Iran (Islamic Rep. of),IRN,Ukraine,UKR,0,0,10,36,46
2019,Iraq,IRQ,Ukraine,UKR,0,0,13,120,133
2019,Jordan,JOR,Ukraine,UKR,0,0,5,12,17
2019,Kenya,KEN,Ukraine,UKR,0,0,0,5,5
2019,Kyrgyzstan,KGZ,Ukraine,UKR,0,0,0,122,122
2019,Liberia,LBR,Ukraine,UKR,0,0,0,11,11
2019,Lebanon,LBN,Ukraine,UKR,0,0,10,0,10
2019,Sri Lanka,LKA,Ukraine,UKR,0,0,0,41,41
2019,Nepal,NPL,Ukraine,UKR,0,0,0,15,15
2019,Nigeria,NGA,Ukraine,UKR,0,0,10,31,41
2019,Pakistan,PAK,Ukraine,UKR,0,0,14,52,66
2019,Russian Federation,RUS,Ukraine,UKR,0,0,29,0,29
2019,Senegal,SEN,Ukraine,UKR,0,0,5,0,5
2019,Sierra Leone,SLE,Ukraine,UKR,0,0,0,5,5
2019,Somalia,SOM,Ukraine,UKR,0,0,18,82,100
2019,Viet Nam,VNM,Ukraine,UKR,0,0,0,5,5
2019,Sudan,SDN,Ukraine,UKR,0,0,0,64,64
2019,Syrian Arab Rep.,SYR,Ukraine,UKR,0,10,32,214,256
2019,Tajikistan,TJK,Ukraine,UKR,5,0,13,15,33
2019,Turkey,TUR,Ukraine,UKR,0,0,5,18,23
2019,Uganda,UGA,Ukraine,UKR,0,0,0,5,5
2019,Uzbekistan,UZB,Ukraine,UKR,0,0,26,0,26
2019,Western Sahara,ESH,Ukraine,UKR,0,0,0,5,5
2019,Yemen,YEM,Ukraine,UKR,0,5,10,0,15
2019,Stateless,XXA,Ukraine,UKR,0,0,5,0,5
2020,Russian Federation,RUS,Belarus,BLR,0,0,10,0,10
2020,Ukraine,UKR,Belarus,BLR,0,0,5,0,5
2020,Afghanistan,AFG,Bosnia and Herzegovina,BIH,0,0,5,0,5
2020,Pakistan,PAK,Bosnia and Herzegovina,BIH,0,0,5,0,5
2020,Yemen,YEM,Bosnia and Herzegovina,BIH,0,5,0,0,5
2020,Afghanistan,AFG,Germany,DEU,1201,7086,5518,7363,21168
2020,Albania,ALB,Germany,DEU,0,43,340,789,1172
2020,Algeria,DZA,Germany,DEU,5,10,168,369,552
2020,Angola,AGO,Germany,DEU,0,13,55,151,219
2020,Egypt,EGY,Germany,DEU,110,53,428,389,980
2020,Armenia,ARM,Germany,DEU,0,154,1245,1148,2547
2020,Azerbaijan,AZE,Germany,DEU,24,43,1119,976,2162
2020,Bahrain,BHR,Germany,DEU,0,0,5,0,5
2020,Burundi,BDI,Germany,DEU,0,0,0,5,5
2020,Benin,BEN,Germany,DEU,0,0,56,54,110
2020,Bangladesh,BGD,Germany,DEU,10,5,203,161,379
2020,Bhutan,BTN,Germany,DEU,0,0,5,0,5
2020,Burkina Faso,BFA,Germany,DEU,0,5,23,41,69
2020,Belarus,BLR,Germany,DEU,0,0,43,109,152
2020,Botswana,BWA,Germany,DEU,0,5,0,0,5
2020,Brazil,BRA,Germany,DEU,0,0,5,0,5
2020,Bosnia and Herzegovina,BIH,Germany,DEU,0,5,39,203,247
2020,Cambodia,KHM,Germany,DEU,0,0,0,5,5
2020,Central African Rep.,CAF,Germany,DEU,0,0,5,5,10
2020,Chad,TCD,Germany,DEU,5,0,10,39,54
2020,China,CHN,Germany,DEU,60,5,125,260,450
2020,Cameroon,CMR,Germany,DEU,29,60,446,470,1005
2020,Congo,COG,Germany,DEU,0,0,15,5,20
2020,Dem. Rep. of the Congo,COD,Germany,DEU,0,22,90,115,227
2020,Colombia,COL,Germany,DEU,0,0,61,37,98
2020,Cuba,CUB,Germany,DEU,0,0,19,26,45
2020,Djibouti,DJI,Germany,DEU,0,0,5,5,10
2020,Ecuador,ECU,Germany,DEU,0,0,0,5,5
2020,Equatorial Guinea,GNQ,Germany,DEU,0,0,0,5,5
2020,Eritrea,ERI,Germany,DEU,116,190,422,1094,1822
2020,Ethiopia,ETH,Germany,DEU,85,950,760,628,2423
2020,Gabon,GAB,Germany,DEU,0,0,0,5,5
2020,Gambia,GMB,Germany,DEU,20,125,1782,1301,3228
2020,Palestinian,PSE,Germany,DEU,0,25,55,73,153
2020,Georgia,GEO,Germany,DEU,11,49,1219,1271,2550
2020,Ghana,GHA,Germany,DEU,5,30,191,416,642
2020,Guinea-Bissau,GNB,Germany,DEU,0,10,26,61,97
2020,Guinea,GIN,Germany,DEU,27,78,1040,1107,2252
2020,Cote d'Ivoire,CIV,Germany,DEU,0,47,426,281,754
2020,India,IND,Germany,DEU,0,18,185,240,443
2020,Indonesia,IDN,Germany,DEU,0,0,0,5,5
2020,Iran (Islamic Rep. of),IRN,Germany,DEU,1553,132,2559,2785,7029
2020,Iraq,IRQ,Germany,DEU,572,1869,6287,5932,14660
2020,Israel,ISR,Germany,DEU,0,0,5,11,16
2020,Italy,ITA,Germany,DEU,0,0,5,0,5
2020,Jamaica,JAM,Germany,DEU,0,0,10,10,20
2020,Jordan,JOR,Germany,DEU,5,5,48,106,164
2020,Kazakhstan,KAZ,Germany,DEU,0,0,35,26,61
2020,Kenya,KEN,Germany,DEU,0,0,64,227,291
2020,Kyrgyzstan,KGZ,Germany,DEU,5,17,84,50,156
2020,Rep. of Korea,KOR,Germany,DEU,0,0,5,5,10
2020,Dem. People's Rep. of Korea,PRK,Germany,DEU,10,0,15,5,30
2020,Kuwait,KWT,Germany,DEU,0,0,0,14,14
2020,Liberia,LBR,Germany,DEU,0,5,44,78,127
2020,Libya,LBY,Germany,DEU,0,122,84,342,548
2020,Lebanon,LBN,Germany,DEU,5,62,395,461,923
2020,Sri Lanka,LKA,Germany,DEU,48,40,450,236,774
2020,Mauritania,MRT,Germany,DEU,0,0,5,5,10
2020,North Macedonia,MKD,Germany,DEU,0,17,150,477,644
2020,Rep. of Moldova,MDA,Germany,DEU,0,0,330,565,895
2020,Mexico,MEX,Germany,DEU,0,0,0,5,5
2020,Mali,MLI,Germany,DEU,5,12,152,163,332
2020,Malaysia,MYS,Germany,DEU,5,0,0,0,5
2020,Mongolia,MNG,Germany,DEU,0,12,124,92,228
2020,Morocco,MAR,Germany,DEU,17,17,153,371,558
2020,Mozambique,MOZ,Germany,DEU,0,0,0,10,10
2020,Montenegro,MNE,Germany,DEU,0,0,11,92,103
2020,Mauritius,MUS,Germany,DEU,0,0,0,5,5
2020,Myanmar,MMR,Germany,DEU,20,0,22,25,67
2020,Nepal,NPL,Germany,DEU,5,0,33,14,52
2020,Niger,NER,Germany,DEU,0,5,27,25,57
2020,Nigeria,NGA,Germany,DEU,73,625,4161,5823,10682
2020,Pakistan,PAK,Germany,DEU,523,162,2353,1961,4999
2020,Philippines,PHL,Germany,DEU,0,0,0,12,12
2020,Portugal,PRT,Germany,DEU,0,0,0,5,5
2020,South Africa,ZAF,Germany,DEU,0,0,5,13,18
2020,Russian Federation,RUS,Germany,DEU,243,190,1989,2592,5014
2020,Rwanda,RWA,Germany,DEU,5,0,5,25,35
2020,El Salvador,SLV,Germany,DEU,0,5,0,5,10
2020,Saudi Arabia,SAU,Germany,DEU,5,0,5,12,22
2020,Serbia and Kosovo: S/RES/1244 (1999),SRB,Germany,DEU,0,38,302,898,1238
2020,Senegal,SEN,Germany,DEU,0,5,78,136,219
2020,Sierra Leone,SLE,Germany,DEU,0,19,246,210,475
2020,Somalia,SOM,Germany,DEU,110,445,711,2081,3347
2020,Spain,ESP,Germany,DEU,0,0,5,5,10
2020,Viet Nam,VNM,Germany,DEU,0,0,58,84,142
2020,Sudan,SDN,Germany,DEU,28,185,240,416,869
2020,South Sudan,SSD,Germany,DEU,0,12,0,14,26
2020,Syrian Arab Rep.,SYR,Germany,DEU,873,854,5398,8361,15486
2020,United Rep. of Tanzania,TZA,Germany,DEU,0,5,19,88,112
2020,Tajikistan,TJK,Germany,DEU,30,10,197,197,434
2020,Turkmenistan,TKM,Germany,DEU,0,0,0,5,5
2020,Togo,TGO,Germany,DEU,10,22,289,225,546
2020,Tunisia,TUN,Germany,DEU,10,0,72,192,274
2020,Turkey,TUR,Germany,DEU,550,88,1830,1796,4264
2020,Uganda,UGA,Germany,DEU,0,0,32,48,80
2020,Ukraine,UKR,Germany,DEU,5,35,547,492,1079
2020,United States of America,USA,Germany,DEU,0,0,0,10,10
2020,Uzbekistan,UZB,Germany,DEU,5,5,19,32,61
2020,Venezuela (Bolivarian Republic of),VEN,Germany,DEU,27,122,54,58,261
2020,Yemen,YEM,Germany,DEU,11,18,70,126,225
2020,Zambia,ZMB,Germany,DEU,0,0,10,0,10
2020,Zimbabwe,ZWE,Germany,DEU,23,0,31,37,91
2020,Stateless,XXA,Germany,DEU,54,45,130,221,450
2020,Afghanistan,AFG,Croatia,HRV,0,0,5,0,5
2020,Algeria,DZA,Croatia,HRV,0,0,22,0,22
2020,Iran (Islamic Rep. of),IRN,Croatia,HRV,0,0,13,0,13
2020,Iraq,IRQ,Croatia,HRV,0,0,5,0,5
2020,Morocco,MAR,Croatia,HRV,0,0,12,0,12
2020,Tunisia,TUN,Croatia,HRV,0,0,5,0,5
2020,Turkey,TUR,Croatia,HRV,0,0,10,0,10
2020,Azerbaijan,AZE,Rep. of Moldova,MDA,0,0,5,0,5
2020,Bangladesh,BGD,Rep. of Moldova,MDA,0,0,14,0,14
2020,Turkey,TUR,Rep. of Moldova,MDA,0,0,5,0,5
2020,Afghanistan,AFG,Romania,ROU,0,11,26,0,37
2020,Angola,AGO,Romania,ROU,5,0,0,0,5
2020,Bangladesh,BGD,Romania,ROU,0,0,10,0,10
2020,Cameroon,CMR,Romania,ROU,0,0,10,0,10
2020,Dem. Rep. of the Congo,COD,Romania,ROU,0,0,5,0,5
2020,Comoros,COM,Romania,ROU,0,0,5,0,5
2020,Palestinian,PSE,Romania,ROU,0,0,5,0,5
2020,Cote d'Ivoire,CIV,Romania,ROU,0,0,5,0,5
2020,India,IND,Romania,ROU,5,0,0,0,5
2020,Iran (Islamic Rep. of),IRN,Romania,ROU,5,5,19,0,29
2020,Iraq,IRQ,Romania,ROU,10,16,52,0,78
2020,Nigeria,NGA,Romania,ROU,0,0,5,0,5
2020,Pakistan,PAK,Romania,ROU,0,0,5,0,5
2020,South Africa,ZAF,Romania,ROU,0,0,5,0,5
2020,Somalia,SOM,Romania,ROU,0,0,11,0,11
2020,Syrian Arab Rep.,SYR,Romania,ROU,0,11,0,0,11
2020,Turkey,TUR,Romania,ROU,0,0,5,0,5
2020,Stateless,XXA,Romania,ROU,0,0,5,0,5
2020,Afghanistan,AFG,Ukraine,UKR,0,0,40,5,45
2020,Bangladesh,BGD,Ukraine,UKR,0,0,12,0,12
2020,Cameroon,CMR,Ukraine,UKR,0,0,5,0,5
2020,Dem. Rep. of the Congo,COD,Ukraine,UKR,0,0,5,5,10
2020,Eritrea,ERI,Ukraine,UKR,0,0,5,0,5
2020,Guinea,GIN,Ukraine,UKR,0,0,5,0,5
2020,Iran (Islamic Rep. of),IRN,Ukraine,UKR,0,0,5,0,5
2020,Iraq,IRQ,Ukraine,UKR,0,0,11,0,11
2020,Morocco,MAR,Ukraine,UKR,0,0,5,0,5
2020,Pakistan,PAK,Ukraine,UKR,0,0,5,0,5
2020,Russian Federation,RUS,Ukraine,UKR,0,10,18,0,28
2020,Somalia,SOM,Ukraine,UKR,0,0,12,5,17
2020,Syrian Arab Rep.,SYR,Ukraine,UKR,0,12,5,0,17
2020,Tajikistan,TJK,Ukraine,UKR,0,0,11,0,11
2020,Uzbekistan,UZB,Ukraine,UKR,0,0,5,0,5
2021,Senegal,SEN,Argentina,ARG,0,0,12,0,12
2021,Iraq,IRQ,Belarus,BLR,0,0,5,0,5
2021,Russian Federation,RUS,Belarus,BLR,0,0,5,5,10
2021,Ukraine,UKR,Belarus,BLR,0,0,5,0,5
2021,Afghanistan,AFG,Bosnia and Herzegovina,BIH,0,0,10,0,10
2021,Iran (Islamic Rep. of),IRN,Bosnia and Herzegovina,BIH,0,0,12,0,12
2021,Pakistan,PAK,Bosnia and Herzegovina,BIH,0,0,5,0,5
2021,Turkey,TUR,Bosnia and Herzegovina,BIH,0,0,5,0,5
2021,Stateless,XXA,Bosnia and Herzegovina,BIH,0,0,5,0,5
2021,Albania,ALB,Canada,CAN,0,0,5,0,5
2021,Egypt,EGY,Canada,CAN,5,0,0,0,5
2021,Colombia,COL,Canada,CAN,21,0,0,0,21
2021,Dominican Rep.,DOM,Canada,CAN,0,0,0,5,5
2021,Ethiopia,ETH,Canada,CAN,5,0,0,0,5
2021,Palestinian,PSE,Canada,CAN,5,0,0,0,5
2021,Haiti,HTI,Canada,CAN,5,0,0,0,5
2021,Jordan,JOR,Canada,CAN,5,0,0,0,5
2021,Kazakhstan,KAZ,Canada,CAN,5,0,0,0,5
2021,Sri Lanka,LKA,Canada,CAN,5,0,0,0,5
2021,Nigeria,NGA,Canada,CAN,0,0,0,14,14
2021,Pakistan,PAK,Canada,CAN,5,0,0,0,5
2021,El Salvador,SLV,Canada,CAN,5,0,0,0,5
2021,Uganda,UGA,Canada,CAN,5,0,0,0,5
2021,Venezuela (Bolivarian Republic of),VEN,Canada,CAN,10,0,0,0,10
2021,Stateless,XXA,Canada,CAN,5,0,0,0,5
2021,Egypt,EGY,Cyprus,CYP,0,0,119,0,119
2021,Bangladesh,BGD,Cyprus,CYP,0,0,502,5,507
2021,Cameroon,CMR,Cyprus,CYP,0,0,26,5,31
2021,Dem. Rep. of the Congo,COD,Cyprus,CYP,0,0,26,5,31
2021,Palestinian,PSE,Cyprus,CYP,5,0,0,0,5
2021,Georgia,GEO,Cyprus,CYP,0,0,111,55,166
2021,Guinea,GIN,Cyprus,CYP,0,0,0,5,5
2021,India,IND,Cyprus,CYP,0,0,653,57,710
2021,Iraq,IRQ,Cyprus,CYP,5,0,0,0,5
2021,Jordan,JOR,Cyprus,CYP,0,0,5,0,5
2021,Sri Lanka,LKA,Cyprus,CYP,0,0,95,0,95
2021,Nepal,NPL,Cyprus,CYP,0,0,83,0,83
2021,Nigeria,NGA,Cyprus,CYP,0,0,65,22,87
2021,Pakistan,PAK,Cyprus,CYP,0,0,603,83,686
2021,Philippines,PHL,Cyprus,CYP,0,0,24,0,24
2021,Sierra Leone,SLE,Cyprus,CYP,0,0,5,0,5
2021,Somalia,SOM,Cyprus,CYP,0,0,0,10,10
2021,Viet Nam,VNM,Cyprus,CYP,0,0,62,23,85
2021,Afghanistan,AFG,Germany,DEU,979,6870,1724,6701,16274
2021,Albania,ALB,Germany,DEU,0,22,183,446,651
2021,Algeria,DZA,Germany,DEU,10,13,207,492,722
2021,Angola,AGO,Germany,DEU,0,30,67,84,181
2021,Egypt,EGY,Germany,DEU,39,36,309,254,638
2021,Argentina,ARG,Germany,DEU,0,0,5,0,5
2021,Armenia,ARM,Germany,DEU,5,69,698,794,1566
2021,Azerbaijan,AZE,Germany,DEU,46,45,777,783,1651
2021,Bahrain,BHR,Germany,DEU,5,0,0,0,5
2021,Burundi,BDI,Germany,DEU,5,0,0,13,18
2021,Belgium,BEL,Germany,DEU,0,0,0,5,5
2021,Benin,BEN,Germany,DEU,0,5,27,39,71
2021,Bangladesh,BGD,Germany,DEU,5,24,159,141,329
2021,Burkina Faso,BFA,Germany,DEU,0,0,15,23,38
2021,Belarus,BLR,Germany,DEU,0,5,26,155,186
2021,Brazil,BRA,Germany,DEU,0,0,13,0,13
2021,Bosnia and Herzegovina,BIH,Germany,DEU,0,5,38,99,142
2021,Cambodia,KHM,Germany,DEU,0,0,5,5,10
2021,Central African Rep.,CAF,Germany,DEU,0,0,0,5,5
2021,Chad,TCD,Germany,DEU,0,0,32,62,94
2021,China,CHN,Germany,DEU,36,5,84,127,252
2021,Chile,CHL,Germany,DEU,0,0,5,0,5
2021,Cameroon,CMR,Germany,DEU,41,63,589,530,1223
2021,Congo,COG,Germany,DEU,0,0,12,12,24
2021,Dem. Rep. of the Congo,COD,Germany,DEU,0,16,100,88,204
2021,Colombia,COL,Germany,DEU,10,10,169,80,269
2021,Costa Rica,CRI,Germany,DEU,0,0,0,5,5
2021,Cuba,CUB,Germany,DEU,5,0,13,13,31
2021,Djibouti,DJI,Germany,DEU,0,0,0,5,5
2021,Dominican Rep.,DOM,Germany,DEU,0,0,0,5,5
2021,Equatorial Guinea,GNQ,Germany,DEU,0,0,0,5,5
2021,Eritrea,ERI,Germany,DEU,64,218,359,724,1365
2021,Ethiopia,ETH,Germany,DEU,30,449,376,573,1428
2021,France,FRA,Germany,DEU,0,0,0,5,5
2021,Gabon,GAB,Germany,DEU,0,0,10,13,23
2021,Gambia,GMB,Germany,DEU,19,105,750,912,1786
2021,Palestinian,PSE,Germany,DEU,12,26,48,105,191
2021,Georgia,GEO,Germany,DEU,10,61,970,1209,2250
2021,Ghana,GHA,Germany,DEU,5,23,183,324,535
2021,Guinea-Bissau,GNB,Germany,DEU,0,0,33,40,73
2021,Guinea,GIN,Germany,DEU,43,97,984,976,2100
2021,Haiti,HTI,Germany,DEU,0,0,0,10,10
2021,Honduras,HND,Germany,DEU,0,0,11,0,11
2021,Cote d'Ivoire,CIV,Germany,DEU,10,28,267,215,520
2021,India,IND,Germany,DEU,5,13,158,179,355
2021,Iran (Islamic Rep. of),IRN,Germany,DEU,1696,168,2887,2496,7247
2021,Iraq,IRQ,Germany,DEU,456,1540,4618,5184,11798
2021,Israel,ISR,Germany,DEU,0,0,5,5,10
2021,Italy,ITA,Germany,DEU,0,0,0,5,5
2021,Jamaica,JAM,Germany,DEU,0,0,11,0,11
2021,Jordan,JOR,Germany,DEU,5,5,54,81,145
2021,Kazakhstan,KAZ,Germany,DEU,0,5,21,43,69
2021,Kenya,KEN,Germany,DEU,0,0,106,129,235
2021,Kyrgyzstan,KGZ,Germany,DEU,5,10,34,42,91
2021,Rep. of Korea,KOR,Germany,DEU,0,5,5,0,10
2021,Dem. People's Rep. of Korea,PRK,Germany,DEU,0,0,5,0,5
2021,Kuwait,KWT,Germany,DEU,0,0,0,10,10
2021,Liberia,LBR,Germany,DEU,0,16,65,67,148
2021,Libya,LBY,Germany,DEU,5,27,94,261,387
2021,Lebanon,LBN,Germany,DEU,25,181,238,393,837
2021,Sri Lanka,LKA,Germany,DEU,31,27,278,154,490
2021,Madagascar,MDG,Germany,DEU,0,0,0,5,5
2021,Mauritania,MRT,Germany,DEU,0,5,0,21,26
2021,North Macedonia,MKD,Germany,DEU,0,10,118,394,522
2021,Rep. of Moldova,MDA,Germany,DEU,0,0,324,740,1064
2021,Mexico,MEX,Germany,DEU,0,5,11,0,16
2021,Mali,MLI,Germany,DEU,0,14,94,114,222
2021,Malawi,MWI,Germany,DEU,0,0,0,5,5
2021,Mongolia,MNG,Germany,DEU,0,5,67,64,136
2021,Morocco,MAR,Germany,DEU,10,17,135,404,566
2021,Mozambique,MOZ,Germany,DEU,0,0,0,5,5
2021,Montenegro,MNE,Germany,DEU,0,0,21,82,103
2021,Myanmar,MMR,Germany,DEU,15,0,0,32,47
2021,Namibia,NAM,Germany,DEU,0,0,0,14,14
2021,Nepal,NPL,Germany,DEU,0,0,11,5,16
2021,Niger,NER,Germany,DEU,0,0,25,29,54
2021,Nicaragua,NIC,Germany,DEU,0,5,0,16,21
2021,Nigeria,NGA,Germany,DEU,75,655,3818,4435,8983
2021,Pakistan,PAK,Germany,DEU,453,141,1545,1526,3665
2021,Peru,PER,Germany,DEU,0,0,0,5,5
2021,Philippines,PHL,Germany,DEU,0,0,0,12,12
2021,South Africa,ZAF,Germany,DEU,0,0,15,5,20
2021,Russian Federation,RUS,Germany,DEU,167,200,2070,2701,5138
2021,Rwanda,RWA,Germany,DEU,10,0,0,31,41
2021,El Salvador,SLV,Germany,DEU,0,24,0,0,24
2021,Saudi Arabia,SAU,Germany,DEU,5,0,0,5,10
2021,Serbia and Kosovo: S/RES/1244 (1999),SRB,Germany,DEU,0,21,150,595,766
2021,Senegal,SEN,Germany,DEU,5,12,62,128,207
2021,Sierra Leone,SLE,Germany,DEU,0,26,215,205,446
2021,Somalia,SOM,Germany,DEU,95,419,605,1892,3011
2021,Spain,ESP,Germany,DEU,0,0,0,5,5
2021,Viet Nam,VNM,Germany,DEU,0,5,48,93,146
2021,Sudan,SDN,Germany,DEU,14,209,94,231,548
2021,South Sudan,SSD,Germany,DEU,0,17,0,17,34
2021,Syrian Arab Rep.,SYR,Germany,DEU,1329,319,3975,7979,13602
2021,United Rep. of Tanzania,TZA,Germany,DEU,0,0,29,72,101
2021,Thailand,THA,Germany,DEU,0,0,0,10,10
2021,Tajikistan,TJK,Germany,DEU,28,23,300,357,708
2021,Turkmenistan,TKM,Germany,DEU,0,0,12,26,38
2021,Togo,TGO,Germany,DEU,10,23,264,192,489
2021,Tunisia,TUN,Germany,DEU,5,5,81,266,357
2021,Turkey,TUR,Germany,DEU,716,91,2402,1936,5145
2021,Uganda,UGA,Germany,DEU,5,0,23,40,68
2021,Ukraine,UKR,Germany,DEU,12,23,413,354,802
2021,United States of America,USA,Germany,DEU,0,0,0,14,14
2021,Uzbekistan,UZB,Germany,DEU,5,0,12,16,33
2021,Venezuela (Bolivarian Republic of),VEN,Germany,DEU,19,153,66,69,307
2021,Yemen,YEM,Germany,DEU,5,24,70,96,195
2021,Zimbabwe,ZWE,Germany,DEU,0,5,28,50,83
2021,Stateless,XXA,Germany,DEU,59,34,70,183,346
2021,Afghanistan,AFG,Croatia,HRV,0,0,5,0,5
2021,Algeria,DZA,Croatia,HRV,0,0,0,5,5
2021,Cuba,CUB,Croatia,HRV,0,0,5,0,5
2021,Iraq,IRQ,Croatia,HRV,0,0,13,5,18
2021,Morocco,MAR,Croatia,HRV,0,0,5,0,5
2021,Pakistan,PAK,Croatia,HRV,0,0,5,0,5
2021,Serbia and Kosovo: S/RES/1244 (1999),SRB,Croatia,HRV,0,0,5,0,5
2021,Syrian Arab Rep.,SYR,Croatia,HRV,0,0,5,0,5
2021,Tunisia,TUN,Croatia,HRV,0,0,5,0,5
2021,Turkey,TUR,Croatia,HRV,0,0,10,0,10
2021,Uzbekistan,UZB,Croatia,HRV,0,0,5,0,5
2021,Armenia,ARM,Rep. of Moldova,MDA,0,0,10,0,10
2021,Bangladesh,BGD,Rep. of Moldova,MDA,0,0,5,0,5
2021,Turkey,TUR,Rep. of Moldova,MDA,0,0,5,0,5
2021,Uzbekistan,UZB,Rep. of Moldova,MDA,0,0,5,0,5
2021,Afghanistan,AFG,Romania,ROU,0,30,115,0,145
2021,Bangladesh,BGD,Romania,ROU,0,0,10,0,10
2021,Cameroon,CMR,Romania,ROU,0,0,13,0,13
2021,Eritrea,ERI,Romania,ROU,0,0,5,0,5
2021,Ethiopia,ETH,Romania,ROU,0,5,0,0,5
2021,Palestinian,PSE,Romania,ROU,0,5,0,0,5
2021,Iran (Islamic Rep. of),IRN,Romania,ROU,5,0,0,0,5
2021,Iraq,IRQ,Romania,ROU,0,14,33,0,47
2021,Morocco,MAR,Romania,ROU,0,5,0,0,5
2021,Nigeria,NGA,Romania,ROU,0,0,5,0,5
2021,Pakistan,PAK,Romania,ROU,0,0,14,0,14
2021,Somalia,SOM,Romania,ROU,0,0,5,0,5
2021,Sudan,SDN,Romania,ROU,0,0,5,0,5
2021,Syrian Arab Rep.,SYR,Romania,ROU,5,0,14,0,19
2021,Ukraine,UKR,Romania,ROU,0,0,5,0,5
2021,Stateless,XXA,Romania,ROU,0,0,5,0,5
2021,Afghanistan,AFG,Ukraine,UKR,0,5,23,5,33
2021,Bangladesh,BGD,Ukraine,UKR,0,0,5,0,5
2021,Dem. Rep. of the Congo,COD,Ukraine,UKR,0,0,5,0,5
2021,Guinea,GIN,Ukraine,UKR,0,0,0,5,5
2021,India,IND,Ukraine,UKR,0,0,0,5,5
2021,Kyrgyzstan,KGZ,Ukraine,UKR,0,5,0,0,5
2021,Pakistan,PAK,Ukraine,UKR,5,0,0,0,5
2021,Russian Federation,RUS,Ukraine,UKR,0,0,5,0,5
2021,Somalia,SOM,Ukraine,UKR,0,0,5,0,5
2021,Sudan,SDN,Ukraine,UKR,0,0,5,0,5
2021,Syrian Arab Rep.,SYR,Ukraine,UKR,12,5,0,0,17
2021,Tajikistan,TJK,Ukraine,UKR,0,0,5,0,5
2021,Uzbekistan,UZB,Ukraine,UKR,0,0,0,5,5
2021,Stateless,XXA,Ukraine,UKR,0,0,5,0,5
2001,Afghanistan,AFG,Germany,DEU,2656,1519,972,168,5315
2001,Albania,ALB,Germany,DEU,0,0,293,68,361
2001,Algeria,DZA,Germany,DEU,25,12,1517,140,1694
2001,Angola,AGO,Germany,DEU,15,64,171,17,267
2001,Egypt,EGY,Germany,DEU,0,0,55,13,68
2001,Armenia,ARM,Germany,DEU,14,12,813,56,895
2001,Azerbaijan,AZE,Germany,DEU,274,34,1053,48,1409
2001,Burundi,BDI,Germany,DEU,11,0,33,0,44
2001,Benin,BEN,Germany,DEU,0,0,110,5,115
2001,Bangladesh,BGD,Germany,DEU,5,0,136,5,146
2001,Bhutan,BTN,Germany,DEU,0,0,19,0,19
2001,Burkina Faso,BFA,Germany,DEU,0,5,470,5,480
2001,Belarus,BLR,Germany,DEU,19,5,371,89,484
2001,Bosnia and Herzegovina,BIH,Germany,DEU,10,21,1615,447,2093
2001,Bulgaria,BGR,Germany,DEU,0,0,43,62,105
2001,Cambodia,KHM,Germany,DEU,0,0,10,0,10
2001,Central African Rep.,CAF,Germany,DEU,0,5,0,0,5
2001,Chad,TCD,Germany,DEU,0,0,0,5,5
2001,China,CHN,Germany,DEU,91,5,1192,34,1322
2001,Cameroon,CMR,Germany,DEU,27,10,599,17,653
2001,Congo,COG,Germany,DEU,5,0,18,13,36
2001,Dem. Rep. of the Congo,COD,Germany,DEU,78,45,336,38,497
2001,Colombia,COL,Germany,DEU,15,5,93,5,118
2001,Cuba,CUB,Germany,DEU,10,0,54,14,78
2001,Czechia,CZE,Germany,DEU,0,0,43,25,68
2001,Ecuador,ECU,Germany,DEU,0,0,28,5,33
2001,Eritrea,ERI,Germany,DEU,17,34,178,5,234
2001,Estonia,EST,Germany,DEU,0,0,24,0,24
2001,Ethiopia,ETH,Germany,DEU,28,88,230,11,357
2001,Gabon,GAB,Germany,DEU,0,0,19,0,19
2001,Gambia,GMB,Germany,DEU,0,0,35,0,35
2001,Georgia,GEO,Germany,DEU,5,5,963,45,1018
2001,Ghana,GHA,Germany,DEU,0,5,267,15,287
2001,Guinea-Bissau,GNB,Germany,DEU,0,0,5,0,5
2001,Guinea,GIN,Germany,DEU,0,5,407,13,425
2001,Croatia,HRV,Germany,DEU,0,0,105,11,116
2001,Hungary,HUN,Germany,DEU,0,0,0,32,32
2001,Cote d'Ivoire,CIV,Germany,DEU,0,5,190,0,195
2001,India,IND,Germany,DEU,5,0,2380,101,2486
2001,Indonesia,IDN,Germany,DEU,0,0,5,0,5
2001,Iran (Islamic Rep. of),IRN,Germany,DEU,740,18,2872,306,3936
2001,Iraq,IRQ,Germany,DEU,10086,38,5334,426,15884
2001,Israel,ISR,Germany,DEU,0,0,36,20,56
2001,Jamaica,JAM,Germany,DEU,0,0,5,0,5
2001,Jordan,JOR,Germany,DEU,0,0,71,11,82
2001,Kazakhstan,KAZ,Germany,DEU,0,5,152,21,178
2001,Kenya,KEN,Germany,DEU,0,5,25,0,30
2001,Kyrgyzstan,KGZ,Germany,DEU,5,0,40,16,61
2001,Dem. People's Rep. of Korea,PRK,Germany,DEU,53,0,33,0,86
2001,Liberia,LBR,Germany,DEU,0,0,45,20,65
2001,Libya,LBY,Germany,DEU,16,0,63,13,92
2001,Lebanon,LBN,Germany,DEU,28,0,502,37,567
2001,Sri Lanka,LKA,Germany,DEU,75,19,642,49,785
2001,Lithuania,LTU,Germany,DEU,0,0,93,29,122
2001,Latvia,LVA,Germany,DEU,0,0,27,0,27
2001,Mauritania,MRT,Germany,DEU,0,0,0,12,12
2001,North Macedonia,MKD,Germany,DEU,0,0,803,63,866
2001,Rep. of Moldova,MDA,Germany,DEU,0,0,265,50,315
2001,Mali,MLI,Germany,DEU,0,0,77,5,82
2001,Malaysia,MYS,Germany,DEU,0,0,5,0,5
2001,Mongolia,MNG,Germany,DEU,0,0,183,16,199
2001,Morocco,MAR,Germany,DEU,0,0,205,30,235
2001,Myanmar,MMR,Germany,DEU,127,5,13,0,145
2001,Nepal,NPL,Germany,DEU,5,0,114,5,124
2001,Niger,NER,Germany,DEU,5,0,92,5,102
2001,Nigeria,NGA,Germany,DEU,10,5,462,31,508
2001,Pakistan,PAK,Germany,DEU,55,5,1128,40,1228
2001,Peru,PER,Germany,DEU,0,0,5,0,5
2001,Poland,POL,Germany,DEU,0,0,132,24,156
2001,Romania,ROU,Germany,DEU,0,0,139,224,363
2001,South Africa,ZAF,Germany,DEU,0,0,5,0,5
2001,Russian Federation,RUS,Germany,DEU,645,79,3194,301,4219
2001,Rwanda,RWA,Germany,DEU,37,0,19,5,61
2001,Saudi Arabia,SAU,Germany,DEU,0,0,5,0,5
2001,Serbia and Kosovo: S/RES/1244 (1999),SRB,Germany,DEU,51,120,3453,1091,4715
2001,Senegal,SEN,Germany,DEU,0,0,22,0,22
2001,Sierra Leone,SLE,Germany,DEU,5,21,1226,38,1290
2001,Somalia,SOM,Germany,DEU,0,101,192,16,309
2001,Viet Nam,VNM,Germany,DEU,5,5,3453,102,3565
2001,Sudan,SDN,Germany,DEU,5,5,109,10,129
2001,Slovakia,SVK,Germany,DEU,0,0,66,33,99
2001,Slovenia,SVN,Germany,DEU,0,0,5,0,5
2001,Syrian Arab Rep.,SYR,Germany,DEU,258,5,1900,98,2261
2001,United Rep. of Tanzania,TZA,Germany,DEU,0,0,5,0,5
2001,Thailand,THA,Germany,DEU,0,0,5,0,5
2001,Tajikistan,TJK,Germany,DEU,10,0,25,0,35
2001,Turkmenistan,TKM,Germany,DEU,0,0,5,0,5
2001,Togo,TGO,Germany,DEU,111,5,858,29,1003
2001,Tunisia,TUN,Germany,DEU,5,0,148,21,174
2001,Turkey,TUR,Germany,DEU,1728,31,7395,569,9723
2001,Uganda,UGA,Germany,DEU,5,0,43,5,53
2001,Ukraine,UKR,Germany,DEU,12,5,491,92,600
2001,Uzbekistan,UZB,Germany,DEU,0,0,22,10,32
2001,Yemen,YEM,Germany,DEU,10,0,54,5,69
2001,Zimbabwe,ZWE,Germany,DEU,0,0,5,0,5
2001,Stateless,XXA,Germany,DEU,21,5,139,5,170
2002,Afghanistan,AFG,Germany,DEU,22,43,5,341,411
2002,Albania,ALB,Germany,DEU,5,5,307,52,369
2002,Algeria,DZA,Germany,DEU,5,5,1719,192,1921
2002,Angola,AGO,Germany,DEU,22,64,412,35,533
2002,Egypt,EGY,Germany,DEU,0,0,69,15,84
2002,Armenia,ARM,Germany,DEU,0,5,931,61,997
2002,Azerbaijan,AZE,Germany,DEU,58,10,1595,42,1705
2002,Burundi,BDI,Germany,DEU,10,0,42,0,52
2002,Benin,BEN,Germany,DEU,0,0,140,5,145
2002,Bangladesh,BGD,Germany,DEU,0,0,168,10,178
2002,Bhutan,BTN,Germany,DEU,5,0,37,0,42
2002,Burkina Faso,BFA,Germany,DEU,0,5,139,0,144
2002,Belarus,BLR,Germany,DEU,21,10,491,82,604
2002,Bosnia and Herzegovina,BIH,Germany,DEU,0,37,1171,214,1422
2002,Bulgaria,BGR,Germany,DEU,0,0,620,213,833
2002,Cambodia,KHM,Germany,DEU,0,0,14,0,14
2002,Central African Rep.,CAF,Germany,DEU,0,0,5,0,5
2002,Chad,TCD,Germany,DEU,0,0,13,0,13
2002,China,CHN,Germany,DEU,28,5,1434,52,1519
2002,Cameroon,CMR,Germany,DEU,12,10,1042,21,1085
2002,Congo,COG,Germany,DEU,12,5,19,5,41
2002,Dem. Rep. of the Congo,COD,Germany,DEU,41,79,648,72,840
2002,Colombia,COL,Germany,DEU,5,0,79,27,111
2002,Cuba,CUB,Germany,DEU,5,0,66,10,81
2002,Czechia,CZE,Germany,DEU,0,0,32,5,37
2002,Ecuador,ECU,Germany,DEU,0,0,16,10,26
2002,Eritrea,ERI,Germany,DEU,18,55,265,12,350
2002,Estonia,EST,Germany,DEU,0,0,14,0,14
2002,Ethiopia,ETH,Germany,DEU,29,75,351,10,465
2002,Fiji,FJI,Germany,DEU,0,0,10,0,10
2002,Gabon,GAB,Germany,DEU,0,0,10,0,10
2002,Gambia,GMB,Germany,DEU,0,0,40,5,45
2002,Georgia,GEO,Germany,DEU,10,5,1393,70,1478
2002,Ghana,GHA,Germany,DEU,0,0,269,26,295
2002,Guinea-Bissau,GNB,Germany,DEU,0,0,20,5,25
2002,Guinea,GIN,Germany,DEU,11,5,356,10,382
2002,Haiti,HTI,Germany,DEU,0,0,5,0,5
2002,Croatia,HRV,Germany,DEU,0,5,57,5,67
2002,Hungary,HUN,Germany,DEU,0,0,5,5,10
2002,Cote d'Ivoire,CIV,Germany,DEU,0,5,128,10,143
2002,India,IND,Germany,DEU,5,0,2168,83,2256
2002,Iran (Islamic Rep. of),IRN,Germany,DEU,459,24,2110,230,2823
2002,Iraq,IRQ,Germany,DEU,2868,71,8301,746,11986
2002,Israel,ISR,Germany,DEU,0,0,42,12,54
2002,Jordan,JOR,Germany,DEU,0,0,61,14,75
2002,Kazakhstan,KAZ,Germany,DEU,5,0,131,22,158
2002,Kenya,KEN,Germany,DEU,0,5,64,5,74
2002,Kyrgyzstan,KGZ,Germany,DEU,12,0,61,14,87
2002,Dem. People's Rep. of Korea,PRK,Germany,DEU,49,0,17,0,66
2002,Lao People's Dem. Rep.,LAO,Germany,DEU,0,0,5,0,5
2002,Liberia,LBR,Germany,DEU,0,5,154,11,170
2002,Libya,LBY,Germany,DEU,13,0,64,10,87
2002,Lebanon,LBN,Germany,DEU,15,0,736,44,795
2002,Sri Lanka,LKA,Germany,DEU,36,5,533,46,620
2002,Lithuania,LTU,Germany,DEU,0,0,64,10,74
2002,Latvia,LVA,Germany,DEU,0,0,24,10,34
2002,Mauritania,MRT,Germany,DEU,0,0,29,5,34
2002,North Macedonia,MKD,Germany,DEU,0,5,614,98,717
2002,Rep. of Moldova,MDA,Germany,DEU,0,0,220,35,255
2002,Mali,MLI,Germany,DEU,0,0,74,0,74
2002,Mongolia,MNG,Germany,DEU,0,0,164,23,187
2002,Morocco,MAR,Germany,DEU,0,0,249,45,294
2002,Mozambique,MOZ,Germany,DEU,0,0,5,0,5
2002,Myanmar,MMR,Germany,DEU,25,0,16,5,46
2002,Nepal,NPL,Germany,DEU,5,0,257,5,267
2002,Niger,NER,Germany,DEU,0,0,151,5,156
2002,Nigeria,NGA,Germany,DEU,5,5,862,43,915
2002,Pakistan,PAK,Germany,DEU,64,5,980,60,1109
2002,Peru,PER,Germany,DEU,0,0,5,0,5
2002,Poland,POL,Germany,DEU,0,0,37,15,52
2002,Romania,ROU,Germany,DEU,0,0,93,352,445
2002,Russian Federation,RUS,Germany,DEU,382,56,3334,388,4160
2002,Rwanda,RWA,Germany,DEU,18,0,25,0,43
2002,Serbia and Kosovo: S/RES/1244 (1999),SRB,Germany,DEU,31,221,24092,1729,26073
2002,Senegal,SEN,Germany,DEU,0,0,23,5,28
2002,Sierra Leone,SLE,Germany,DEU,0,10,460,34,504
2002,Somalia,SOM,Germany,DEU,0,69,96,10,175
2002,Viet Nam,VNM,Germany,DEU,5,5,2292,89,2391
2002,Sudan,SDN,Germany,DEU,16,0,173,10,199
2002,Slovakia,SVK,Germany,DEU,0,0,415,223,638
2002,Slovenia,SVN,Germany,DEU,0,0,5,0,5
2002,Syrian Arab Rep.,SYR,Germany,DEU,158,5,1514,102,1779
2002,United Rep. of Tanzania,TZA,Germany,DEU,0,0,12,0,12
2002,Tajikistan,TJK,Germany,DEU,5,0,35,0,40
2002,Turkmenistan,TKM,Germany,DEU,0,0,12,5,17
2002,Togo,TGO,Germany,DEU,67,15,965,34,1081
2002,Tunisia,TUN,Germany,DEU,13,0,156,25,194
2002,Turkey,TUR,Germany,DEU,1348,45,7987,772,10152
2002,Uganda,UGA,Germany,DEU,10,0,85,5,100
2002,Ukraine,UKR,Germany,DEU,10,5,471,108,594
2002,Uzbekistan,UZB,Germany,DEU,10,5,48,11,74
2002,Venezuela (Bolivarian Republic of),VEN,Germany,DEU,0,0,5,0,5
2002,Yemen,YEM,Germany,DEU,0,0,84,5,89
2002,Zimbabwe,ZWE,Germany,DEU,0,0,17,0,17
2002,Stateless,XXA,Germany,DEU,16,0,97,11,124
2003,Afghanistan,AFG,Germany,DEU,46,237,6686,386,7355
2003,Albania,ALB,Germany,DEU,0,0,290,30,320
2003,Algeria,DZA,Germany,DEU,0,0,1284,101,1385
2003,Angola,AGO,Germany,DEU,10,109,536,15,670
2003,Egypt,EGY,Germany,DEU,0,0,78,12,90
2003,Armenia,ARM,Germany,DEU,0,5,677,80,762
2003,Azerbaijan,AZE,Germany,DEU,22,13,1527,53,1615
2003,Burundi,BDI,Germany,DEU,17,0,50,5,72
2003,Benin,BEN,Germany,DEU,0,0,44,0,44
2003,Bangladesh,BGD,Germany,DEU,0,0,153,5,158
2003,Bhutan,BTN,Germany,DEU,0,0,26,0,26
2003,Burkina Faso,BFA,Germany,DEU,0,0,75,5,80
2003,Belarus,BLR,Germany,DEU,5,0,560,62,627
2003,Brazil,BRA,Germany,DEU,0,0,5,0,5
2003,Bosnia and Herzegovina,BIH,Germany,DEU,5,27,706,85,823
2003,Bulgaria,BGR,Germany,DEU,0,5,481,117,603
2003,Cambodia,KHM,Germany,DEU,0,0,30,0,30
2003,Central African Rep.,CAF,Germany,DEU,0,0,5,0,5
2003,Chad,TCD,Germany,DEU,0,0,5,0,5
2003,China,CHN,Germany,DEU,66,0,2809,55,2930
2003,Cameroon,CMR,Germany,DEU,5,17,1290,14,1326
2003,Congo,COG,Germany,DEU,0,10,101,10,121
2003,Dem. Rep. of the Congo,COD,Germany,DEU,41,82,1096,47,1266
2003,Colombia,COL,Germany,DEU,0,11,76,5,92
2003,Cuba,CUB,Germany,DEU,0,0,49,5,54
2003,Czechia,CZE,Germany,DEU,0,0,31,11,42
2003,Djibouti,DJI,Germany,DEU,0,0,5,0,5
2003,Ecuador,ECU,Germany,DEU,0,0,25,5,30
2003,Eritrea,ERI,Germany,DEU,11,25,488,12,536
2003,Estonia,EST,Germany,DEU,0,0,13,0,13
2003,Ethiopia,ETH,Germany,DEU,21,47,564,17,649
2003,Fiji,FJI,Germany,DEU,0,0,5,0,5
2003,Gabon,GAB,Germany,DEU,0,0,5,0,5
2003,Gambia,GMB,Germany,DEU,0,0,47,0,47
2003,Palestinian,PSE,Germany,DEU,5,0,54,10,69
2003,Georgia,GEO,Germany,DEU,13,5,1171,97,1286
2003,Ghana,GHA,Germany,DEU,0,0,357,13,370
2003,Guinea-Bissau,GNB,Germany,DEU,0,0,36,0,36
2003,Guinea,GIN,Germany,DEU,10,5,424,10,449
2003,Croatia,HRV,Germany,DEU,0,0,70,10,80
2003,Hungary,HUN,Germany,DEU,0,0,10,12,22
2003,Cote d'Ivoire,CIV,Germany,DEU,5,0,277,10,292
2003,India,IND,Germany,DEU,5,0,1987,72,2064
2003,Indonesia,IDN,Germany,DEU,0,0,11,0,11
2003,Iran (Islamic Rep. of),IRN,Germany,DEU,305,22,2588,159,3074
2003,Iraq,IRQ,Germany,DEU,540,20,4694,461,5715
2003,Israel,ISR,Germany,DEU,0,0,100,5,105
2003,Jordan,JOR,Germany,DEU,0,0,60,15,75
2003,Kazakhstan,KAZ,Germany,DEU,0,0,94,17,111
2003,Kenya,KEN,Germany,DEU,0,0,62,0,62
2003,Rep. of Korea,KOR,Germany,DEU,5,0,0,0,5
2003,Dem. People's Rep. of Korea,PRK,Germany,DEU,26,0,15,0,41
2003,Kuwait,KWT,Germany,DEU,0,0,5,0,5
2003,Liberia,LBR,Germany,DEU,0,0,146,12,158
2003,Libya,LBY,Germany,DEU,5,0,114,5,124
2003,Lebanon,LBN,Germany,DEU,12,0,731,44,787
2003,Sri Lanka,LKA,Germany,DEU,17,5,422,34,478
2003,Lithuania,LTU,Germany,DEU,0,0,44,11,55
2003,Latvia,LVA,Germany,DEU,0,0,16,18,34
2003,Mauritania,MRT,Germany,DEU,0,0,23,5,28
2003,North Macedonia,MKD,Germany,DEU,0,0,355,36,391
2003,Rep. of Moldova,MDA,Germany,DEU,0,0,174,5,179
2003,Mali,MLI,Germany,DEU,0,0,46,0,46
2003,Mongolia,MNG,Germany,DEU,0,0,62,13,75
2003,Morocco,MAR,Germany,DEU,0,0,300,19,319
2003,Mozambique,MOZ,Germany,DEU,0,0,5,0,5
2003,Myanmar,MMR,Germany,DEU,18,5,60,0,83
2003,Nepal,NPL,Germany,DEU,5,0,243,10,258
2003,Niger,NER,Germany,DEU,0,0,108,5,113
2003,Nigeria,NGA,Germany,DEU,0,5,1231,39,1275
2003,Pakistan,PAK,Germany,DEU,37,5,1188,43,1273
2003,Peru,PER,Germany,DEU,0,0,13,0,13
2003,Philippines,PHL,Germany,DEU,0,0,5,0,5
2003,Poland,POL,Germany,DEU,0,0,30,5,35
2003,Romania,ROU,Germany,DEU,0,0,94,96,190
2003,South Africa,ZAF,Germany,DEU,0,0,5,0,5
2003,Russian Federation,RUS,Germany,DEU,354,129,2521,353,3357
2003,Rwanda,RWA,Germany,DEU,23,0,19,5,47
2003,Serbia and Kosovo: S/RES/1244 (1999),SRB,Germany,DEU,13,134,5829,406,6382
2003,Senegal,SEN,Germany,DEU,0,0,24,5,29
2003,Sierra Leone,SLE,Germany,DEU,0,16,237,12,265
2003,Somalia,SOM,Germany,DEU,0,105,127,10,242
2003,Viet Nam,VNM,Germany,DEU,5,5,2222,53,2285
2003,Sudan,SDN,Germany,DEU,5,0,301,24,330
2003,Slovakia,SVK,Germany,DEU,0,0,428,195,623
2003,Slovenia,SVN,Germany,DEU,0,0,5,0,5
2003,Syrian Arab Rep.,SYR,Germany,DEU,117,10,1584,87,1798
2003,United Rep. of Tanzania,TZA,Germany,DEU,0,0,31,0,31
2003,Thailand,THA,Germany,DEU,0,0,5,0,5
2003,Tajikistan,TJK,Germany,DEU,0,0,20,0,20
2003,Turkmenistan,TKM,Germany,DEU,5,0,18,0,23
2003,Togo,TGO,Germany,DEU,55,11,1065,21,1152
2003,Tunisia,TUN,Germany,DEU,0,0,174,15,189
2003,Turkey,TUR,Germany,DEU,979,64,7119,550,8712
2003,Uganda,UGA,Germany,DEU,0,0,114,0,114
2003,Ukraine,UKR,Germany,DEU,5,0,375,76,456
2003,United States of America,USA,Germany,DEU,0,0,5,0,5
2003,Uzbekistan,UZB,Germany,DEU,0,0,49,16,65
2003,Venezuela (Bolivarian Republic of),VEN,Germany,DEU,0,0,5,0,5
2003,Yemen,YEM,Germany,DEU,10,0,44,5,59
2003,Zimbabwe,ZWE,Germany,DEU,0,0,45,0,45
2003,Stateless,XXA,Germany,DEU,5,0,82,0,87
2004,Afghanistan,AFG,Germany,DEU,46,232,1883,174,2335
2004,Albania,ALB,Germany,DEU,0,5,183,22,210
2004,Algeria,DZA,Germany,DEU,0,0,792,90,882
2004,Angola,AGO,Germany,DEU,0,29,212,13,254
2004,Egypt,EGY,Germany,DEU,5,0,50,5,60
2004,Armenia,ARM,Germany,DEU,5,0,568,182,755
2004,Azerbaijan,AZE,Germany,DEU,43,13,1310,114,1480
2004,Burundi,BDI,Germany,DEU,5,0,29,5,39
2004,Benin,BEN,Germany,DEU,0,0,46,5,51
2004,Bangladesh,BGD,Germany,DEU,0,5,98,26,129
2004,Bhutan,BTN,Germany,DEU,0,0,12,0,12
2004,Burkina Faso,BFA,Germany,DEU,0,0,49,0,49
2004,Belarus,BLR,Germany,DEU,5,0,311,71,387
2004,Bosnia and Herzegovina,BIH,Germany,DEU,0,10,386,123,519
2004,Bulgaria,BGR,Germany,DEU,0,0,334,148,482
2004,Cambodia,KHM,Germany,DEU,0,0,45,0,45
2004,Chad,TCD,Germany,DEU,0,0,14,0,14
2004,China,CHN,Germany,DEU,40,0,1350,61,1451
2004,Cameroon,CMR,Germany,DEU,0,14,585,15,614
2004,Congo,COG,Germany,DEU,0,0,32,5,37
2004,Dem. Rep. of the Congo,COD,Germany,DEU,15,26,489,18,548
2004,Colombia,COL,Germany,DEU,5,0,33,0,38
2004,Cuba,CUB,Germany,DEU,0,0,40,5,45
2004,Czechia,CZE,Germany,DEU,0,0,18,5,23
2004,Ecuador,ECU,Germany,DEU,0,0,18,5,23
2004,Eritrea,ERI,Germany,DEU,18,22,451,82,573
2004,Estonia,EST,Germany,DEU,0,0,10,0,10
2004,Ethiopia,ETH,Germany,DEU,10,13,278,11,312
2004,Gabon,GAB,Germany,DEU,0,0,5,0,5
2004,Gambia,GMB,Germany,DEU,0,0,58,10,68
2004,Georgia,GEO,Germany,DEU,5,0,614,352,971
2004,Ghana,GHA,Germany,DEU,0,0,405,20,425
2004,Guinea-Bissau,GNB,Germany,DEU,0,0,21,5,26
2004,Guinea,GIN,Germany,DEU,13,0,354,25,392
2004,Haiti,HTI,Germany,DEU,0,5,5,0,10
2004,Croatia,HRV,Germany,DEU,0,0,15,5,20
2004,Hungary,HUN,Germany,DEU,0,0,5,11,16
2004,Cote d'Ivoire,CIV,Germany,DEU,0,0,190,10,200
2004,India,IND,Germany,DEU,0,0,1116,164,1280
2004,Indonesia,IDN,Germany,DEU,0,0,10,0,10
2004,Iran (Islamic Rep. of),IRN,Germany,DEU,213,19,1639,180,2051
2004,Iraq,IRQ,Germany,DEU,38,46,3319,373,3776
2004,Israel,ISR,Germany,DEU,0,0,38,5,43
2004,Jamaica,JAM,Germany,DEU,0,0,5,0,5
2004,Jordan,JOR,Germany,DEU,0,0,37,10,47
2004,Kazakhstan,KAZ,Germany,DEU,0,0,57,21,78
2004,Kenya,KEN,Germany,DEU,0,0,41,5,46
2004,Kyrgyzstan,KGZ,Germany,DEU,0,0,24,5,29
2004,Dem. People's Rep. of Korea,PRK,Germany,DEU,0,0,10,0,10
2004,Kuwait,KWT,Germany,DEU,0,0,10,0,10
2004,Lao People's Dem. Rep.,LAO,Germany,DEU,0,0,5,0,5
2004,Liberia,LBR,Germany,DEU,0,0,341,31,372
2004,Libya,LBY,Germany,DEU,5,0,74,11,90
2004,Lebanon,LBN,Germany,DEU,5,0,367,67,439
2004,Sri Lanka,LKA,Germany,DEU,5,5,220,26,256
2004,Lithuania,LTU,Germany,DEU,0,5,25,0,30
2004,Latvia,LVA,Germany,DEU,0,0,14,5,19
2004,Mauritania,MRT,Germany,DEU,5,0,24,0,29
2004,North Macedonia,MKD,Germany,DEU,0,0,179,63,242
2004,Rep. of Moldova,MDA,Germany,DEU,0,0,114,24,138
2004,Mexico,MEX,Germany,DEU,0,0,5,0,5
2004,Mali,MLI,Germany,DEU,0,0,43,14,57
2004,Mongolia,MNG,Germany,DEU,0,0,53,10,63
2004,Morocco,MAR,Germany,DEU,0,0,250,27,277
2004,Mozambique,MOZ,Germany,DEU,0,0,5,0,5
2004,Myanmar,MMR,Germany,DEU,11,0,66,5,82
2004,Nepal,NPL,Germany,DEU,5,0,127,13,145
2004,Netherlands,NLD,Germany,DEU,0,0,5,0,5
2004,Niger,NER,Germany,DEU,0,0,76,5,81
2004,Nigeria,NGA,Germany,DEU,0,10,1323,53,1386
2004,Pakistan,PAK,Germany,DEU,43,0,1147,95,1285
2004,Peru,PER,Germany,DEU,0,0,5,5,10
2004,Philippines,PHL,Germany,DEU,0,0,5,0,5
2004,Poland,POL,Germany,DEU,0,0,24,5,29
2004,Romania,ROU,Germany,DEU,0,0,47,14,61
2004,Russian Federation,RUS,Germany,DEU,524,107,1753,839,3223
2004,Rwanda,RWA,Germany,DEU,13,0,20,5,38
2004,Serbia and Kosovo: S/RES/1244 (1999),SRB,Germany,DEU,5,51,3777,506,4339
2004,Senegal,SEN,Germany,DEU,0,0,18,0,18
2004,Sierra Leone,SLE,Germany,DEU,0,5,182,23,210
2004,Somalia,SOM,Germany,DEU,0,53,119,74,246
2004,Spain,ESP,Germany,DEU,0,0,5,0,5
2004,Viet Nam,VNM,Germany,DEU,0,30,1738,69,1837
2004,Sudan,SDN,Germany,DEU,5,5,264,30,304
2004,Slovakia,SVK,Germany,DEU,0,0,224,139,363
2004,Syrian Arab Rep.,SYR,Germany,DEU,79,10,829,136,1054
2004,United Rep. of Tanzania,TZA,Germany,DEU,0,0,28,0,28
2004,Thailand,THA,Germany,DEU,0,0,5,0,5
2004,Tajikistan,TJK,Germany,DEU,0,0,19,5,24
2004,Turkmenistan,TKM,Germany,DEU,0,5,17,0,22
2004,Togo,TGO,Germany,DEU,41,0,421,12,474
2004,Tunisia,TUN,Germany,DEU,5,0,102,13,120
2004,Turkey,TUR,Germany,DEU,499,32,4129,434,5094
2004,Uganda,UGA,Germany,DEU,0,5,100,5,110
2004,Ukraine,UKR,Germany,DEU,0,0,171,59,230
2004,Uzbekistan,UZB,Germany,DEU,0,0,31,12,43
2004,Yemen,YEM,Germany,DEU,0,0,35,5,40
2004,Zimbabwe,ZWE,Germany,DEU,0,0,53,5,58
2004,Stateless,XXA,Germany,DEU,0,0,37,10,47
2005,Afghanistan,AFG,Germany,DEU,29,71,680,66,846
2005,Albania,ALB,Germany,DEU,0,0,114,21,135
2005,Algeria,DZA,Germany,DEU,5,0,437,50,492
2005,Angola,AGO,Germany,DEU,5,18,123,10,156
2005,Egypt,EGY,Germany,DEU,5,0,47,10,62
2005,Armenia,ARM,Germany,DEU,5,10,527,60,602
2005,Azerbaijan,AZE,Germany,DEU,54,13,861,83,1011
2005,Burundi,BDI,Germany,DEU,0,0,26,0,26
2005,Benin,BEN,Germany,DEU,0,0,30,0,30
2005,Bangladesh,BGD,Germany,DEU,0,0,69,14,83
2005,Burkina Faso,BFA,Germany,DEU,0,0,34,5,39
2005,Belarus,BLR,Germany,DEU,5,0,144,35,184
2005,Brazil,BRA,Germany,DEU,0,0,5,0,5
2005,Bosnia and Herzegovina,BIH,Germany,DEU,0,11,308,55,374
2005,Bulgaria,BGR,Germany,DEU,0,0,266,47,313
2005,Cambodia,KHM,Germany,DEU,0,0,20,0,20
2005,Canada,CAN,Germany,DEU,0,0,5,0,5
2005,China,CHN,Germany,DEU,18,0,605,47,670
2005,Cameroon,CMR,Germany,DEU,5,5,382,14,406
2005,Congo,COG,Germany,DEU,5,0,32,11,48
2005,Dem. Rep. of the Congo,COD,Germany,DEU,17,22,347,31,417
2005,Colombia,COL,Germany,DEU,5,0,21,0,26
2005,Cuba,CUB,Germany,DEU,5,0,20,5,30
2005,Czechia,CZE,Germany,DEU,0,0,16,0,16
2005,Dominican Rep.,DOM,Germany,DEU,0,0,5,0,5
2005,Ecuador,ECU,Germany,DEU,0,0,10,5,15
2005,Eritrea,ERI,Germany,DEU,31,11,308,30,380
2005,Ethiopia,ETH,Germany,DEU,20,10,163,13,206
2005,Gabon,GAB,Germany,DEU,0,0,5,0,5
2005,Gambia,GMB,Germany,DEU,0,5,95,5,105
2005,Georgia,GEO,Germany,DEU,0,0,343,176,519
2005,Ghana,GHA,Germany,DEU,0,0,430,22,452
2005,Guinea-Bissau,GNB,Germany,DEU,0,5,12,5,22
2005,Guinea,GIN,Germany,DEU,5,0,220,25,250
2005,Haiti,HTI,Germany,DEU,0,0,12,0,12
2005,Croatia,HRV,Germany,DEU,0,0,32,5,37
2005,Hungary,HUN,Germany,DEU,0,0,5,0,5
2005,Cote d'Ivoire,CIV,Germany,DEU,0,0,128,10,138
2005,India,IND,Germany,DEU,0,0,551,75,626
2005,Indonesia,IDN,Germany,DEU,0,0,5,0,5
2005,Iran (Islamic Rep. of),IRN,Germany,DEU,168,5,871,89,1133
2005,Iraq,IRQ,Germany,DEU,54,12,1591,191,1848
2005,Israel,ISR,Germany,DEU,0,0,23,11,34
2005,Italy,ITA,Germany,DEU,0,0,5,0,5
2005,Jordan,JOR,Germany,DEU,0,0,36,11,47
2005,Kazakhstan,KAZ,Germany,DEU,0,0,31,15,46
2005,Kenya,KEN,Germany,DEU,0,0,38,5,43
2005,Kyrgyzstan,KGZ,Germany,DEU,0,0,27,5,32
2005,Dem. People's Rep. of Korea,PRK,Germany,DEU,0,0,18,0,18
2005,Liberia,LBR,Germany,DEU,0,0,98,14,112
2005,Libya,LBY,Germany,DEU,5,0,55,5,65
2005,Lebanon,LBN,Germany,DEU,5,0,437,73,515
2005,Sri Lanka,LKA,Germany,DEU,10,0,188,28,226
2005,Lithuania,LTU,Germany,DEU,0,0,10,0,10
2005,Latvia,LVA,Germany,DEU,0,0,0,5,5
2005,Mauritania,MRT,Germany,DEU,0,0,5,0,5
2005,North Macedonia,MKD,Germany,DEU,0,0,160,38,198
2005,Rep. of Moldova,MDA,Germany,DEU,0,0,73,22,95
2005,Mali,MLI,Germany,DEU,0,0,20,10,30
2005,Malaysia,MYS,Germany,DEU,0,0,5,0,5
2005,Mongolia,MNG,Germany,DEU,0,0,46,15,61
2005,Morocco,MAR,Germany,DEU,0,0,157,29,186
2005,Mozambique,MOZ,Germany,DEU,0,0,5,0,5
2005,Myanmar,MMR,Germany,DEU,12,0,18,0,30
2005,Nepal,NPL,Germany,DEU,5,0,66,10,81
2005,Netherlands,NLD,Germany,DEU,0,0,0,5,5
2005,Niger,NER,Germany,DEU,0,5,35,5,45
2005,Nigeria,NGA,Germany,DEU,0,5,855,55,915
2005,Pakistan,PAK,Germany,DEU,27,0,575,66,668
2005,Peru,PER,Germany,DEU,0,0,5,0,5
2005,Poland,POL,Germany,DEU,0,0,16,0,16
2005,Romania,ROU,Germany,DEU,0,0,54,10,64
2005,Russian Federation,RUS,Germany,DEU,274,80,2018,773,3145
2005,Rwanda,RWA,Germany,DEU,5,0,26,5,36
2005,Serbia and Kosovo: S/RES/1244 (1999),SRB,Germany,DEU,11,46,4634,784,5475
2005,Senegal,SEN,Germany,DEU,0,0,10,0,10
2005,Sierra Leone,SLE,Germany,DEU,5,0,120,10,135
2005,Somalia,SOM,Germany,DEU,5,48,97,33,183
2005,Viet Nam,VNM,Germany,DEU,10,5,1164,120,1299
2005,Sudan,SDN,Germany,DEU,10,0,246,22,278
2005,Suriname,SUR,Germany,DEU,0,0,0,5,5
2005,Slovakia,SVK,Germany,DEU,0,0,60,5,65
2005,Syrian Arab Rep.,SYR,Germany,DEU,78,0,751,122,951
2005,United Rep. of Tanzania,TZA,Germany,DEU,0,0,5,0,5
2005,Tajikistan,TJK,Germany,DEU,0,0,5,0,5
2005,Turkmenistan,TKM,Germany,DEU,0,0,13,0,13
2005,Togo,TGO,Germany,DEU,40,5,263,49,357
2005,Tunisia,TUN,Germany,DEU,5,0,94,11,110
2005,Turkey,TUR,Germany,DEU,328,17,2806,341,3492
2005,Uganda,UGA,Germany,DEU,0,0,54,5,59
2005,Ukraine,UKR,Germany,DEU,0,5,125,45,175
2005,United States of America,USA,Germany,DEU,0,0,5,0,5
2005,Uzbekistan,UZB,Germany,DEU,0,0,21,17,38
2005,Yemen,YEM,Germany,DEU,12,0,39,5,56
2005,Zimbabwe,ZWE,Germany,DEU,0,5,54,0,59
2005,Stateless,XXA,Germany,DEU,5,0,52,17,74
2006,Afghanistan,AFG,Germany,DEU,43,69,379,45,536
2006,Albania,ALB,Germany,DEU,0,0,86,16,102
2006,Algeria,DZA,Germany,DEU,0,0,305,57,362
2006,Angola,AGO,Germany,DEU,0,11,88,18,117
2006,Egypt,EGY,Germany,DEU,5,0,54,5,64
2006,Armenia,ARM,Germany,DEU,0,0,341,49,390
2006,Azerbaijan,AZE,Germany,DEU,19,5,455,52,531
2006,Burundi,BDI,Germany,DEU,5,0,11,0,16
2006,Benin,BEN,Germany,DEU,0,0,24,0,24
2006,Bangladesh,BGD,Germany,DEU,5,0,77,10,92
2006,Bhutan,BTN,Germany,DEU,0,0,10,0,10
2006,Burkina Faso,BFA,Germany,DEU,0,0,18,0,18
2006,Belarus,BLR,Germany,DEU,5,0,86,19,110
2006,Bosnia and Herzegovina,BIH,Germany,DEU,0,0,182,42,224
2006,Bulgaria,BGR,Germany,DEU,0,0,110,43,153
2006,Cambodia,KHM,Germany,DEU,0,0,10,0,10
2006,Chad,TCD,Germany,DEU,5,0,0,0,5
2006,China,CHN,Germany,DEU,17,5,380,29,431
2006,Cameroon,CMR,Germany,DEU,5,10,225,17,257
2006,Congo,COG,Germany,DEU,0,5,15,0,20
2006,Dem. Rep. of the Congo,COD,Germany,DEU,10,16,197,44,267
2006,Colombia,COL,Germany,DEU,0,0,69,5,74
2006,Cuba,CUB,Germany,DEU,5,0,68,10,83
2006,Czechia,CZE,Germany,DEU,0,0,13,0,13
2006,Ecuador,ECU,Germany,DEU,0,0,5,0,5
2006,Eritrea,ERI,Germany,DEU,79,25,190,19,313
2006,Ethiopia,ETH,Germany,DEU,10,0,111,17,138
2006,Gabon,GAB,Germany,DEU,0,0,5,0,5
2006,Gambia,GMB,Germany,DEU,0,0,48,5,53
2006,Georgia,GEO,Germany,DEU,0,0,215,83,298
2006,Ghana,GHA,Germany,DEU,0,0,389,24,413
2006,Guinea-Bissau,GNB,Germany,DEU,0,0,14,0,14
2006,Guinea,GIN,Germany,DEU,11,0,83,5,99
2006,Croatia,HRV,Germany,DEU,0,0,12,10,22
2006,Hungary,HUN,Germany,DEU,0,0,0,5,5
2006,Cote d'Ivoire,CIV,Germany,DEU,5,5,62,5,77
2006,India,IND,Germany,DEU,0,0,477,58,535
2006,Indonesia,IDN,Germany,DEU,0,0,0,5,5
2006,Iran (Islamic Rep. of),IRN,Germany,DEU,82,5,462,71,620
2006,Iraq,IRQ,Germany,DEU,123,17,1528,263,1931
2006,Israel,ISR,Germany,DEU,0,0,24,15,39
2006,Jordan,JOR,Germany,DEU,0,0,20,14,34
2006,Kazakhstan,KAZ,Germany,DEU,0,0,11,12,23
2006,Kenya,KEN,Germany,DEU,0,0,43,5,48
2006,Kyrgyzstan,KGZ,Germany,DEU,0,0,12,5,17
2006,Dem. People's Rep. of Korea,PRK,Germany,DEU,0,0,5,0,5
2006,Kuwait,KWT,Germany,DEU,0,0,5,0,5
2006,Liberia,LBR,Germany,DEU,0,0,26,5,31
2006,Libya,LBY,Germany,DEU,5,0,18,5,28
2006,Lebanon,LBN,Germany,DEU,0,0,467,82,549
2006,Sri Lanka,LKA,Germany,DEU,5,0,132,26,163
2006,Lithuania,LTU,Germany,DEU,0,0,5,0,5
2006,Latvia,LVA,Germany,DEU,0,0,5,0,5
2006,Mauritania,MRT,Germany,DEU,0,0,5,0,5
2006,North Macedonia,MKD,Germany,DEU,0,0,117,25,142
2006,Rep. of Moldova,MDA,Germany,DEU,0,0,35,20,55
2006,Mali,MLI,Germany,DEU,0,0,22,0,22
2006,Mongolia,MNG,Germany,DEU,0,0,27,18,45
2006,Morocco,MAR,Germany,DEU,0,0,151,33,184
2006,Montenegro,MNE,Germany,DEU,0,0,33,5,38
2006,Myanmar,MMR,Germany,DEU,133,0,0,0,133
2006,Nepal,NPL,Germany,DEU,0,0,47,5,52
2006,Niger,NER,Germany,DEU,0,0,22,5,27
2006,Nigeria,NGA,Germany,DEU,0,5,445,49,499
2006,Pakistan,PAK,Germany,DEU,14,5,368,47,434
2006,Peru,PER,Germany,DEU,0,0,5,0,5
2006,Philippines,PHL,Germany,DEU,0,0,5,0,5
2006,Romania,ROU,Germany,DEU,0,0,36,25,61
2006,Russian Federation,RUS,Germany,DEU,115,19,705,282,1121
2006,Rwanda,RWA,Germany,DEU,5,0,22,0,27
2006,Serbia and Kosovo: S/RES/1244 (1999),SRB,Germany,DEU,5,51,2841,589,3486
2006,Senegal,SEN,Germany,DEU,0,0,10,0,10
2006,Sierra Leone,SLE,Germany,DEU,5,5,81,5,96
2006,Somalia,SOM,Germany,DEU,21,14,83,28,146
2006,Viet Nam,VNM,Germany,DEU,0,0,955,73,1028
2006,Sudan,SDN,Germany,DEU,5,0,50,5,60
2006,Slovakia,SVK,Germany,DEU,0,0,148,33,181
2006,Syrian Arab Rep.,SYR,Germany,DEU,69,5,567,109,750
2006,United Rep. of Tanzania,TZA,Germany,DEU,0,5,5,0,10
2006,Tajikistan,TJK,Germany,DEU,0,0,5,0,5
2006,Turkmenistan,TKM,Germany,DEU,0,0,5,0,5
2006,Togo,TGO,Germany,DEU,22,5,117,27,171
2006,Tunisia,TUN,Germany,DEU,0,0,87,17,104
2006,Turkey,TUR,Germany,DEU,103,5,1703,257,2068
2006,Uganda,UGA,Germany,DEU,5,0,14,0,19
2006,Ukraine,UKR,Germany,DEU,0,0,72,32,104
2006,Uzbekistan,UZB,Germany,DEU,5,0,18,10,33
2006,Yemen,YEM,Germany,DEU,0,0,52,12,64
2006,Zimbabwe,ZWE,Germany,DEU,0,0,18,0,18
2006,Stateless,XXA,Germany,DEU,0,0,21,5,26
2007,Afghanistan,AFG,Germany,DEU,34,69,222,52,377
2007,Albania,ALB,Germany,DEU,0,5,67,20,92
2007,Algeria,DZA,Germany,DEU,5,0,307,39,351
2007,Angola,AGO,Germany,DEU,0,18,52,19,89
2007,Egypt,EGY,Germany,DEU,0,0,44,10,54
2007,Armenia,ARM,Germany,DEU,0,0,182,48,230
2007,Azerbaijan,AZE,Germany,DEU,22,5,233,36,296
2007,Burundi,BDI,Germany,DEU,0,0,10,0,10
2007,Benin,BEN,Germany,DEU,0,0,18,0,18
2007,Bangladesh,BGD,Germany,DEU,0,5,81,0,86
2007,Burkina Faso,BFA,Germany,DEU,0,0,26,0,26
2007,Belarus,BLR,Germany,DEU,10,0,38,13,61
2007,Brazil,BRA,Germany,DEU,0,0,0,5,5
2007,Bosnia and Herzegovina,BIH,Germany,DEU,0,0,91,29,120
2007,Bulgaria,BGR,Germany,DEU,0,0,18,5,23
2007,Cambodia,KHM,Germany,DEU,0,5,5,0,10
2007,China,CHN,Germany,DEU,34,0,261,30,325
2007,Chile,CHL,Germany,DEU,0,0,5,0,5
2007,Cameroon,CMR,Germany,DEU,5,5,126,18,154
2007,Congo,COG,Germany,DEU,0,0,12,0,12
2007,Dem. Rep. of the Congo,COD,Germany,DEU,5,12,94,38,149
2007,Colombia,COL,Germany,DEU,0,0,166,13,179
2007,Cuba,CUB,Germany,DEU,5,0,45,5,55
2007,Czechia,CZE,Germany,DEU,0,0,21,0,21
2007,Ecuador,ECU,Germany,DEU,0,0,10,0,10
2007,Eritrea,ERI,Germany,DEU,109,29,127,33,298
2007,Ethiopia,ETH,Germany,DEU,27,5,132,16,180
2007,Gambia,GMB,Germany,DEU,0,0,58,10,68
2007,Georgia,GEO,Germany,DEU,0,0,190,54,244
2007,Ghana,GHA,Germany,DEU,0,0,220,18,238
2007,Guinea-Bissau,GNB,Germany,DEU,0,0,14,0,14
2007,Guinea,GIN,Germany,DEU,11,0,117,12,140
2007,Croatia,HRV,Germany,DEU,0,0,11,10,21
2007,Hungary,HUN,Germany,DEU,0,0,0,5,5
2007,Cote d'Ivoire,CIV,Germany,DEU,0,5,53,5,63
2007,India,IND,Germany,DEU,0,0,403,26,429
2007,Indonesia,IDN,Germany,DEU,0,0,5,0,5
2007,Iran (Islamic Rep. of),IRN,Germany,DEU,133,10,384,80,607
2007,Iraq,IRQ,Germany,DEU,1766,22,996,349,3133
2007,Israel,ISR,Germany,DEU,0,0,31,5,36
2007,Jordan,JOR,Germany,DEU,0,0,20,14,34
2007,Kazakhstan,KAZ,Germany,DEU,0,0,10,0,10
2007,Kenya,KEN,Germany,DEU,5,0,58,5,68
2007,Kyrgyzstan,KGZ,Germany,DEU,0,0,13,0,13
2007,Liberia,LBR,Germany,DEU,0,0,14,0,14
2007,Libya,LBY,Germany,DEU,5,0,14,5,24
2007,Lebanon,LBN,Germany,DEU,5,0,501,84,590
2007,Sri Lanka,LKA,Germany,DEU,39,26,73,28,166
2007,Lithuania,LTU,Germany,DEU,0,0,5,0,5
2007,Latvia,LVA,Germany,DEU,0,0,0,5,5
2007,North Macedonia,MKD,Germany,DEU,0,0,82,22,104
2007,Rep. of Moldova,MDA,Germany,DEU,0,0,29,5,34
2007,Mali,MLI,Germany,DEU,0,0,13,5,18
2007,Mongolia,MNG,Germany,DEU,0,0,22,20,42
2007,Morocco,MAR,Germany,DEU,5,0,149,31,185
2007,Montenegro,MNE,Germany,DEU,0,0,53,21,74
2007,Myanmar,MMR,Germany,DEU,98,0,35,0,133
2007,Nepal,NPL,Germany,DEU,0,0,21,0,21
2007,Niger,NER,Germany,DEU,0,0,16,0,16
2007,Nigeria,NGA,Germany,DEU,10,5,439,68,522
2007,Pakistan,PAK,Germany,DEU,12,0,255,35,302
2007,Philippines,PHL,Germany,DEU,0,0,5,0,5
2007,Poland,POL,Germany,DEU,0,0,5,0,5
2007,Romania,ROU,Germany,DEU,0,0,12,0,12
2007,Russian Federation,RUS,Germany,DEU,113,20,560,178,871
2007,Rwanda,RWA,Germany,DEU,0,0,14,0,14
2007,Serbia and Kosovo: S/RES/1244 (1999),SRB,Germany,DEU,10,21,1530,453,2014
2007,Senegal,SEN,Germany,DEU,0,0,12,5,17
2007,Sierra Leone,SLE,Germany,DEU,10,0,57,11,78
2007,Somalia,SOM,Germany,DEU,51,34,34,14,133
2007,Viet Nam,VNM,Germany,DEU,0,5,844,61,910
2007,Sudan,SDN,Germany,DEU,13,0,35,10,58
2007,Slovakia,SVK,Germany,DEU,0,0,176,43,219
2007,Syrian Arab Rep.,SYR,Germany,DEU,64,0,409,90,563
2007,United Rep. of Tanzania,TZA,Germany,DEU,0,0,5,0,5
2007,Tajikistan,TJK,Germany,DEU,0,0,5,0,5
2007,Turkmenistan,TKM,Germany,DEU,5,0,0,0,5
2007,Togo,TGO,Germany,DEU,10,0,64,20,94
2007,Tunisia,TUN,Germany,DEU,0,0,76,24,100
2007,Turkey,TUR,Germany,DEU,73,10,1183,224,1490
2007,Uganda,UGA,Germany,DEU,0,0,15,5,20
2007,Ukraine,UKR,Germany,DEU,0,0,50,19,69
2007,Uzbekistan,UZB,Germany,DEU,0,0,13,0,13
2007,Venezuela (Bolivarian Republic of),VEN,Germany,DEU,0,0,5,0,5
2007,Yemen,YEM,Germany,DEU,5,0,15,0,20
2007,Zimbabwe,ZWE,Germany,DEU,0,0,22,0,22
2007,Stateless,XXA,Germany,DEU,0,5,13,10,28
2008,Afghanistan,AFG,Germany,DEU,46,51,64,73,234
2008,Albania,ALB,Germany,DEU,0,5,28,20,53
2008,Algeria,DZA,Germany,DEU,0,0,261,91,352
2008,Angola,AGO,Germany,DEU,5,10,12,5,32
2008,Egypt,EGY,Germany,DEU,0,0,21,14,35
2008,Argentina,ARG,Germany,DEU,0,0,5,0,5
2008,Armenia,ARM,Germany,DEU,5,13,100,33,151
2008,Azerbaijan,AZE,Germany,DEU,28,0,87,26,141
2008,Burundi,BDI,Germany,DEU,5,0,5,0,10
2008,Benin,BEN,Germany,DEU,0,0,31,0,31
2008,Bangladesh,BGD,Germany,DEU,0,0,31,5,36
2008,Bhutan,BTN,Germany,DEU,0,0,5,0,5
2008,Burkina Faso,BFA,Germany,DEU,0,0,14,0,14
2008,Belarus,BLR,Germany,DEU,5,0,22,12,39
2008,Bosnia and Herzegovina,BIH,Germany,DEU,0,5,46,24,75
2008,Bulgaria,BGR,Germany,DEU,0,0,10,0,10
2008,Chad,TCD,Germany,DEU,0,0,0,5,5
2008,China,CHN,Germany,DEU,28,5,93,22,148
2008,Cameroon,CMR,Germany,DEU,10,0,47,27,84
2008,Dem. Rep. of the Congo,COD,Germany,DEU,5,14,31,34,84
2008,Colombia,COL,Germany,DEU,0,0,5,5,10
2008,Cuba,CUB,Germany,DEU,0,0,5,11,16
2008,Dominican Rep.,DOM,Germany,DEU,0,0,5,0,5
2008,Eritrea,ERI,Germany,DEU,150,15,41,39,245
2008,Ethiopia,ETH,Germany,DEU,33,0,98,17,148
2008,Gambia,GMB,Germany,DEU,10,0,42,5,57
2008,Georgia,GEO,Germany,DEU,0,0,86,54,140
2008,Ghana,GHA,Germany,DEU,0,0,122,28,150
2008,Guinea-Bissau,GNB,Germany,DEU,0,0,5,5,10
2008,Guinea,GIN,Germany,DEU,5,5,72,16,98
2008,Croatia,HRV,Germany,DEU,0,0,10,0,10
2008,Cote d'Ivoire,CIV,Germany,DEU,5,0,29,10,44
2008,India,IND,Germany,DEU,0,0,242,42,284
2008,Iran (Islamic Rep. of),IRN,Germany,DEU,95,5,240,84,424
2008,Iraq,IRQ,Germany,DEU,4875,20,460,550,5905
2008,Israel,ISR,Germany,DEU,0,0,11,0,11
2008,Jamaica,JAM,Germany,DEU,0,0,5,0,5
2008,Jordan,JOR,Germany,DEU,0,0,11,5,16
2008,Kazakhstan,KAZ,Germany,DEU,0,0,5,0,5
2008,Kenya,KEN,Germany,DEU,0,5,21,10,36
2008,Kyrgyzstan,KGZ,Germany,DEU,0,0,5,0,5
2008,Liberia,LBR,Germany,DEU,0,0,5,0,5
2008,Libya,LBY,Germany,DEU,0,0,14,0,14
2008,Lebanon,LBN,Germany,DEU,10,0,260,70,340
2008,Sri Lanka,LKA,Germany,DEU,92,88,106,70,356
2008,Mauritania,MRT,Germany,DEU,0,0,5,0,5
2008,North Macedonia,MKD,Germany,DEU,0,0,31,18,49
2008,Rep. of Moldova,MDA,Germany,DEU,0,0,11,10,21
2008,Mali,MLI,Germany,DEU,0,0,5,5,10
2008,Mongolia,MNG,Germany,DEU,0,0,5,12,17
2008,Morocco,MAR,Germany,DEU,0,0,83,40,123
2008,Mozambique,MOZ,Germany,DEU,0,5,0,0,5
2008,Montenegro,MNE,Germany,DEU,0,0,21,5,26
2008,Myanmar,MMR,Germany,DEU,70,0,5,0,75
2008,Nepal,NPL,Germany,DEU,0,0,10,0,10
2008,Niger,NER,Germany,DEU,0,0,5,0,5
2008,Nigeria,NGA,Germany,DEU,10,0,229,67,306
2008,Pakistan,PAK,Germany,DEU,12,0,139,44,195
2008,Peru,PER,Germany,DEU,0,0,0,5,5
2008,Russian Federation,RUS,Germany,DEU,105,5,250,251,611
2008,Rwanda,RWA,Germany,DEU,0,0,5,5,10
2008,Saudi Arabia,SAU,Germany,DEU,0,0,0,5,5
2008,Serbia and Kosovo: S/RES/1244 (1999),SRB,Germany,DEU,5,16,672,429,1122
2008,Senegal,SEN,Germany,DEU,0,5,5,0,10
2008,Sierra Leone,SLE,Germany,DEU,5,5,32,10,52
2008,Somalia,SOM,Germany,DEU,68,28,13,16,125
2008,Viet Nam,VNM,Germany,DEU,5,0,820,81,906
2008,Sudan,SDN,Germany,DEU,5,0,13,5,23
2008,Slovakia,SVK,Germany,DEU,0,0,19,0,19
2008,Syrian Arab Rep.,SYR,Germany,DEU,69,5,280,122,476
2008,Thailand,THA,Germany,DEU,0,0,5,0,5
2008,Tajikistan,TJK,Germany,DEU,0,0,5,0,5
2008,Togo,TGO,Germany,DEU,10,5,23,20,58
2008,Tunisia,TUN,Germany,DEU,0,5,35,25,65
2008,Turkey,TUR,Germany,DEU,76,5,637,222,940
2008,Uganda,UGA,Germany,DEU,0,0,17,5,22
2008,Ukraine,UKR,Germany,DEU,5,0,17,15,37
2008,United States of America,USA,Germany,DEU,0,0,0,5,5
2008,Uzbekistan,UZB,Germany,DEU,0,0,0,5,5
2008,Yemen,YEM,Germany,DEU,10,0,0,0,10
2008,Zimbabwe,ZWE,Germany,DEU,0,0,5,0,5
2008,Stateless,XXA,Germany,DEU,0,0,13,0,13
2009,Afghanistan,AFG,Germany,DEU,256,608,417,163,1444
2009,Albania,ALB,Germany,DEU,5,5,33,11,54
2009,Algeria,DZA,Germany,DEU,0,0,344,115,459
2009,Angola,AGO,Germany,DEU,0,10,36,13,59
2009,Egypt,EGY,Germany,DEU,10,5,33,18,66
2009,Armenia,ARM,Germany,DEU,5,10,114,50,179
2009,Azerbaijan,AZE,Germany,DEU,16,10,205,71,302
2009,Burundi,BDI,Germany,DEU,5,0,5,0,10
2009,Benin,BEN,Germany,DEU,0,0,59,0,59
2009,Bangladesh,BGD,Germany,DEU,0,5,30,5,40
2009,Burkina Faso,BFA,Germany,DEU,0,0,30,5,35
2009,Belarus,BLR,Germany,DEU,0,0,27,13,40
2009,Bosnia and Herzegovina,BIH,Germany,DEU,0,10,99,43,152
2009,Bulgaria,BGR,Germany,DEU,0,0,5,0,5
2009,Cambodia,KHM,Germany,DEU,0,0,13,0,13
2009,Chad,TCD,Germany,DEU,5,0,5,0,10
2009,China,CHN,Germany,DEU,31,5,201,17,254
2009,Cameroon,CMR,Germany,DEU,5,10,60,29,104
2009,Congo,COG,Germany,DEU,0,0,0,5,5
2009,Dem. Rep. of the Congo,COD,Germany,DEU,12,31,63,22,128
2009,Colombia,COL,Germany,DEU,5,0,20,0,25
2009,Cuba,CUB,Germany,DEU,5,0,13,11,29
2009,Ecuador,ECU,Germany,DEU,0,0,5,0,5
2009,Eritrea,ERI,Germany,DEU,325,52,19,21,417
2009,Ethiopia,ETH,Germany,DEU,62,13,71,15,161
2009,Gabon,GAB,Germany,DEU,0,0,5,0,5
2009,Gambia,GMB,Germany,DEU,5,0,56,23,84
2009,Georgia,GEO,Germany,DEU,10,0,206,155,371
2009,Ghana,GHA,Germany,DEU,0,0,136,31,167
2009,Guinea-Bissau,GNB,Germany,DEU,0,0,15,5,20
2009,Guinea,GIN,Germany,DEU,16,5,139,14,174
2009,Croatia,HRV,Germany,DEU,0,0,11,5,16
2009,Hungary,HUN,Germany,DEU,0,0,5,0,5
2009,Cote d'Ivoire,CIV,Germany,DEU,11,5,36,5,57
2009,India,IND,Germany,DEU,0,5,514,44,563
2009,Iran (Islamic Rep. of),IRN,Germany,DEU,320,10,306,119,755
2009,Iraq,IRQ,Germany,DEU,5087,101,1593,502,7283
2009,Israel,ISR,Germany,DEU,0,0,13,0,13
2009,Jamaica,JAM,Germany,DEU,0,0,5,0,5
2009,Jordan,JOR,Germany,DEU,0,0,14,10,24
2009,Kazakhstan,KAZ,Germany,DEU,0,0,5,0,5
2009,Kenya,KEN,Germany,DEU,0,5,36,15,56
2009,Liberia,LBR,Germany,DEU,0,0,5,5,10
2009,Libya,LBY,Germany,DEU,5,0,17,10,32
2009,Lebanon,LBN,Germany,DEU,11,0,425,109,545
2009,Sri Lanka,LKA,Germany,DEU,247,165,71,43,526
2009,Lithuania,LTU,Germany,DEU,0,0,5,0,5
2009,Latvia,LVA,Germany,DEU,0,0,12,0,12
2009,Mauritania,MRT,Germany,DEU,0,0,5,0,5
2009,North Macedonia,MKD,Germany,DEU,5,0,34,33,72
2009,Rep. of Moldova,MDA,Germany,DEU,0,0,13,0,13
2009,Mexico,MEX,Germany,DEU,0,0,0,5,5
2009,Mali,MLI,Germany,DEU,0,0,5,0,5
2009,Mongolia,MNG,Germany,DEU,0,0,5,11,16
2009,Morocco,MAR,Germany,DEU,5,0,166,57,228
2009,Montenegro,MNE,Germany,DEU,0,0,39,17,56
2009,Myanmar,MMR,Germany,DEU,46,0,12,5,63
2009,Nepal,NPL,Germany,DEU,0,0,16,5,21
2009,Netherlands,NLD,Germany,DEU,0,0,5,0,5
2009,Niger,NER,Germany,DEU,0,0,10,5,15
2009,Nigeria,NGA,Germany,DEU,5,10,361,128,504
2009,Pakistan,PAK,Germany,DEU,31,5,191,45,272
2009,Peru,PER,Germany,DEU,0,5,0,0,5
2009,Russian Federation,RUS,Germany,DEU,114,12,318,200,644
2009,Rwanda,RWA,Germany,DEU,10,0,15,0,25
2009,Serbia and Kosovo: S/RES/1244 (1999),SRB,Germany,DEU,10,46,1116,551,1723
2009,Senegal,SEN,Germany,DEU,0,0,12,0,12
2009,Sierra Leone,SLE,Germany,DEU,5,12,43,10,70
2009,Somalia,SOM,Germany,DEU,121,41,12,29,203
2009,Viet Nam,VNM,Germany,DEU,5,5,1087,86,1183
2009,Sudan,SDN,Germany,DEU,10,5,12,10,37
2009,Slovakia,SVK,Germany,DEU,0,0,5,5,10
2009,Syrian Arab Rep.,SYR,Germany,DEU,97,10,428,109,644
2009,United Rep. of Tanzania,TZA,Germany,DEU,0,0,0,5,5
2009,Tajikistan,TJK,Germany,DEU,0,0,19,5,24
2009,Turkmenistan,TKM,Germany,DEU,0,0,5,0,5
2009,Togo,TGO,Germany,DEU,10,0,28,13,51
2009,Tunisia,TUN,Germany,DEU,0,0,85,43,128
2009,Turkey,TUR,Germany,DEU,147,12,997,349,1505
2009,Uganda,UGA,Germany,DEU,0,0,10,0,10
2009,Ukraine,UKR,Germany,DEU,5,0,27,18,50
2009,United States of America,USA,Germany,DEU,0,0,0,5,5
2009,Uzbekistan,UZB,Germany,DEU,0,0,0,13,13
2009,Venezuela (Bolivarian Republic of),VEN,Germany,DEU,0,0,5,0,5
2009,Yemen,YEM,Germany,DEU,5,0,5,0,10
2009,Zimbabwe,ZWE,Germany,DEU,0,5,16,5,26
2009,Stateless,XXA,Germany,DEU,10,0,30,10,50
2010,Afghanistan,AFG,Germany,DEU,525,1597,2374,351,4847
2010,Albania,ALB,Germany,DEU,0,0,24,12,36
2010,Algeria,DZA,Germany,DEU,5,0,464,101,570
2010,Angola,AGO,Germany,DEU,0,22,68,12,102
2010,Egypt,EGY,Germany,DEU,27,0,106,15,148
2010,Armenia,ARM,Germany,DEU,5,13,337,69,424
2010,Azerbaijan,AZE,Germany,DEU,37,21,638,101,797
2010,Burundi,BDI,Germany,DEU,0,0,11,0,11
2010,Benin,BEN,Germany,DEU,0,0,93,5,98
2010,Bangladesh,BGD,Germany,DEU,0,0,80,5,85
2010,Burkina Faso,BFA,Germany,DEU,0,0,43,5,48
2010,Belarus,BLR,Germany,DEU,0,0,45,17,62
2010,Brazil,BRA,Germany,DEU,0,0,0,5,5
2010,Bosnia and Herzegovina,BIH,Germany,DEU,0,5,228,35,268
2010,Bulgaria,BGR,Germany,DEU,0,0,21,0,21
2010,Cambodia,KHM,Germany,DEU,0,0,13,0,13
2010,Chad,TCD,Germany,DEU,5,0,0,0,5
2010,China,CHN,Germany,DEU,62,5,391,24,482
2010,Cameroon,CMR,Germany,DEU,22,16,270,35,343
2010,Congo,COG,Germany,DEU,0,0,17,0,17
2010,Dem. Rep. of the Congo,COD,Germany,DEU,31,33,175,20,259
2010,Colombia,COL,Germany,DEU,0,0,0,5,5
2010,Cuba,CUB,Germany,DEU,0,0,25,5,30
2010,Equatorial Guinea,GNQ,Germany,DEU,0,0,5,0,5
2010,Eritrea,ERI,Germany,DEU,266,46,10,49,371
2010,Ethiopia,ETH,Germany,DEU,74,15,239,17,345
2010,Gambia,GMB,Germany,DEU,12,0,170,28,210
2010,Georgia,GEO,Germany,DEU,5,5,361,472,843
2010,Ghana,GHA,Germany,DEU,0,11,201,57,269
2010,Guinea-Bissau,GNB,Germany,DEU,0,0,13,0,13
2010,Guinea,GIN,Germany,DEU,33,11,242,34,320
2010,Croatia,HRV,Germany,DEU,0,0,5,13,18
2010,Hungary,HUN,Germany,DEU,0,0,0,5,5
2010,Cote d'Ivoire,CIV,Germany,DEU,5,0,59,10,74
2010,India,IND,Germany,DEU,10,0,934,38,982
2010,Indonesia,IDN,Germany,DEU,0,0,5,0,5
2010,Iran (Islamic Rep. of),IRN,Germany,DEU,969,26,828,176,1999
2010,Iraq,IRQ,Germany,DEU,3151,90,2458,336,6035
2010,Israel,ISR,Germany,DEU,0,0,14,5,19
2010,Italy,ITA,Germany,DEU,0,0,0,5,5
2010,Jamaica,JAM,Germany,DEU,0,0,5,0,5
2010,Jordan,JOR,Germany,DEU,0,0,34,14,48
2010,Kazakhstan,KAZ,Germany,DEU,0,0,11,0,11
2010,Kenya,KEN,Germany,DEU,10,17,285,16,328
2010,Kyrgyzstan,KGZ,Germany,DEU,5,0,29,5,39
2010,Liberia,LBR,Germany,DEU,0,0,12,5,17
2010,Libya,LBY,Germany,DEU,0,0,5,5,10
2010,Lebanon,LBN,Germany,DEU,0,5,470,82,557
2010,Sri Lanka,LKA,Germany,DEU,262,36,196,32,526
2010,Lithuania,LTU,Germany,DEU,0,0,12,0,12
2010,Latvia,LVA,Germany,DEU,0,0,5,0,5
2010,Mauritania,MRT,Germany,DEU,0,0,5,0,5
2010,North Macedonia,MKD,Germany,DEU,0,0,1793,330,2123
2010,Rep. of Moldova,MDA,Germany,DEU,0,0,54,5,59
2010,Mali,MLI,Germany,DEU,0,0,17,5,22
2010,Mongolia,MNG,Germany,DEU,0,0,40,30,70
2010,Morocco,MAR,Germany,DEU,5,5,183,40,233
2010,Montenegro,MNE,Germany,DEU,0,0,60,12,72
2010,Myanmar,MMR,Germany,DEU,51,0,5,0,56
2010,Nepal,NPL,Germany,DEU,0,0,12,0,12
2010,Niger,NER,Germany,DEU,0,0,12,5,17
2010,Nigeria,NGA,Germany,DEU,20,36,886,135,1077
2010,Pakistan,PAK,Germany,DEU,53,5,605,38,701
2010,Peru,PER,Germany,DEU,0,0,5,0,5
2010,Philippines,PHL,Germany,DEU,0,0,5,0,5
2010,Poland,POL,Germany,DEU,0,0,5,0,5
2010,Romania,ROU,Germany,DEU,0,0,11,0,11
2010,South Africa,ZAF,Germany,DEU,0,0,5,0,5
2010,Russian Federation,RUS,Germany,DEU,195,70,725,368,1358
2010,Rwanda,RWA,Germany,DEU,12,5,16,0,33
2010,Serbia and Kosovo: S/RES/1244 (1999),SRB,Germany,DEU,5,56,4892,778,5731
2010,Senegal,SEN,Germany,DEU,0,5,34,10,49
2010,Sierra Leone,SLE,Germany,DEU,5,19,89,10,123
2010,Somalia,SOM,Germany,DEU,372,80,45,400,897
2010,Viet Nam,VNM,Germany,DEU,0,10,948,93,1051
2010,Sudan,SDN,Germany,DEU,5,0,10,20,35
2010,Syrian Arab Rep.,SYR,Germany,DEU,230,24,1066,119,1439
2010,United Rep. of Tanzania,TZA,Germany,DEU,0,0,5,0,5
2010,Tajikistan,TJK,Germany,DEU,0,0,52,5,57
2010,Turkmenistan,TKM,Germany,DEU,0,0,5,5,10
2010,Togo,TGO,Germany,DEU,15,0,47,23,85
2010,Tunisia,TUN,Germany,DEU,5,0,136,33,174
2010,Turkey,TUR,Germany,DEU,188,13,1259,256,1716
2010,Uganda,UGA,Germany,DEU,5,5,24,0,34
2010,Ukraine,UKR,Germany,DEU,0,0,27,24,51
2010,United States of America,USA,Germany,DEU,0,0,5,0,5
2010,Uzbekistan,UZB,Germany,DEU,0,0,14,0,14
2010,Yemen,YEM,Germany,DEU,10,0,17,0,27
2010,Zimbabwe,ZWE,Germany,DEU,0,0,13,0,13
2010,Stateless,XXA,Germany,DEU,16,0,110,18,144
2011,Afghanistan,AFG,Germany,DEU,701,1493,3813,388,6395
2011,Albania,ALB,Germany,DEU,0,12,44,13,69
2011,Algeria,DZA,Germany,DEU,0,0,354,73,427
2011,Angola,AGO,Germany,DEU,5,10,38,10,63
2011,Egypt,EGY,Germany,DEU,13,0,43,15,71
2011,Armenia,ARM,Germany,DEU,5,11,151,73,240
2011,Azerbaijan,AZE,Germany,DEU,39,10,216,34,299
2011,Burundi,BDI,Germany,DEU,0,0,5,0,5
2011,Benin,BEN,Germany,DEU,0,0,33,5,38
2011,Bangladesh,BGD,Germany,DEU,0,0,97,5,102
2011,Burkina Faso,BFA,Germany,DEU,5,0,35,0,40
2011,Belarus,BLR,Germany,DEU,0,0,28,24,52
2011,Brazil,BRA,Germany,DEU,0,0,5,0,5
2011,Bosnia and Herzegovina,BIH,Germany,DEU,0,10,256,52,318
2011,Bulgaria,BGR,Germany,DEU,0,0,13,0,13
2011,Cambodia,KHM,Germany,DEU,0,0,0,5,5
2011,Chad,TCD,Germany,DEU,0,0,5,0,5
2011,China,CHN,Germany,DEU,50,0,332,31,413
2011,Cameroon,CMR,Germany,DEU,5,5,101,21,132
2011,Congo,COG,Germany,DEU,0,5,18,0,23
2011,Dem. Rep. of the Congo,COD,Germany,DEU,10,43,112,18,183
2011,Colombia,COL,Germany,DEU,0,0,15,5,20
2011,Cuba,CUB,Germany,DEU,5,0,12,0,17
2011,Eritrea,ERI,Germany,DEU,250,34,16,82,382
2011,Estonia,EST,Germany,DEU,0,0,10,0,10
2011,Ethiopia,ETH,Germany,DEU,44,13,155,31,243
2011,Gabon,GAB,Germany,DEU,0,0,5,0,5
2011,Gambia,GMB,Germany,DEU,11,5,180,21,217
2011,Georgia,GEO,Germany,DEU,5,5,173,178,361
2011,Ghana,GHA,Germany,DEU,0,0,179,36,215
2011,Guinea-Bissau,GNB,Germany,DEU,0,0,14,0,14
2011,Guinea,GIN,Germany,DEU,40,5,113,22,180
2011,Haiti,HTI,Germany,DEU,0,0,5,0,5
2011,Honduras,HND,Germany,DEU,0,5,5,0,10
2011,Croatia,HRV,Germany,DEU,0,0,10,0,10
2011,Cote d'Ivoire,CIV,Germany,DEU,10,5,61,12,88
2011,India,IND,Germany,DEU,0,0,822,49,871
2011,Iran (Islamic Rep. of),IRN,Germany,DEU,1133,24,894,179,2230
2011,Iraq,IRQ,Germany,DEU,2670,70,1963,294,4997
2011,Israel,ISR,Germany,DEU,0,0,22,0,22
2011,Jordan,JOR,Germany,DEU,0,0,18,10,28
2011,Kazakhstan,KAZ,Germany,DEU,5,0,20,0,25
2011,Kenya,KEN,Germany,DEU,5,5,89,16,115
2011,Kyrgyzstan,KGZ,Germany,DEU,5,5,46,10,66
2011,Dem. People's Rep. of Korea,PRK,Germany,DEU,0,0,0,5,5
2011,Liberia,LBR,Germany,DEU,0,0,5,5,10
2011,Libya,LBY,Germany,DEU,0,0,5,38,43
2011,Lebanon,LBN,Germany,DEU,5,0,247,56,308
2011,Sri Lanka,LKA,Germany,DEU,124,11,178,19,332
2011,Lithuania,LTU,Germany,DEU,0,0,5,0,5
2011,Latvia,LVA,Germany,DEU,0,0,5,0,5
2011,Mauritania,MRT,Germany,DEU,0,0,10,0,10
2011,North Macedonia,MKD,Germany,DEU,0,0,1041,198,1239
2011,Rep. of Moldova,MDA,Germany,DEU,0,0,12,5,17
2011,Mali,MLI,Germany,DEU,0,0,14,10,24
2011,Mongolia,MNG,Germany,DEU,0,5,17,31,53
2011,Morocco,MAR,Germany,DEU,5,0,238,41,284
2011,Montenegro,MNE,Germany,DEU,0,0,57,17,74
2011,Myanmar,MMR,Germany,DEU,82,0,10,0,92
2011,Nepal,NPL,Germany,DEU,0,0,0,5,5
2011,Niger,NER,Germany,DEU,0,0,17,5,22
2011,Nigeria,NGA,Germany,DEU,29,43,557,95,724
2011,Pakistan,PAK,Germany,DEU,148,0,865,52,1065
2011,Philippines,PHL,Germany,DEU,0,0,5,0,5
2011,Poland,POL,Germany,DEU,0,0,0,5,5
2011,Romania,ROU,Germany,DEU,0,0,5,0,5
2011,Russian Federation,RUS,Germany,DEU,110,30,501,415,1056
2011,Rwanda,RWA,Germany,DEU,0,0,17,0,17
2011,El Salvador,SLV,Germany,DEU,0,0,5,0,5
2011,Serbia and Kosovo: S/RES/1244 (1999),SRB,Germany,DEU,0,34,4985,947,5966
2011,Senegal,SEN,Germany,DEU,0,0,40,5,45
2011,Sierra Leone,SLE,Germany,DEU,5,5,45,5,60
2011,Somalia,SOM,Germany,DEU,451,305,31,516,1303
2011,Viet Nam,VNM,Germany,DEU,5,10,628,86,729
2011,Sudan,SDN,Germany,DEU,5,24,34,22,85
2011,Syrian Arab Rep.,SYR,Germany,DEU,283,17,362,154,816
2011,United Rep. of Tanzania,TZA,Germany,DEU,0,0,0,5,5
2011,Tajikistan,TJK,Germany,DEU,5,0,41,20,66
2011,Turkmenistan,TKM,Germany,DEU,0,0,5,0,5
2011,Togo,TGO,Germany,DEU,11,0,41,17,69
2011,Tunisia,TUN,Germany,DEU,0,0,175,125,300
2011,Turkey,TUR,Germany,DEU,116,15,1118,243,1492
2011,Uganda,UGA,Germany,DEU,5,0,32,5,42
2011,Ukraine,UKR,Germany,DEU,5,10,33,14,62
2011,United States of America,USA,Germany,DEU,0,0,5,0,5
2011,Uzbekistan,UZB,Germany,DEU,5,0,13,5,23
2011,Venezuela (Bolivarian Republic of),VEN,Germany,DEU,0,0,5,0,5
2011,Yemen,YEM,Germany,DEU,14,0,0,0,14
2011,Zimbabwe,ZWE,Germany,DEU,0,0,5,0,5
2011,Stateless,XXA,Germany,DEU,21,10,53,11,95
2012,Afghanistan,AFG,Germany,DEU,755,994,2262,445,4456
2012,Albania,ALB,Germany,DEU,0,12,82,20,114
2012,Algeria,DZA,Germany,DEU,0,0,286,59,345
2012,Angola,AGO,Germany,DEU,0,15,21,10,46
2012,Egypt,EGY,Germany,DEU,13,0,31,23,67
2012,Armenia,ARM,Germany,DEU,5,30,214,53,302
2012,Azerbaijan,AZE,Germany,DEU,15,20,220,65,320
2012,Burundi,BDI,Germany,DEU,0,5,5,0,10
2012,Benin,BEN,Germany,DEU,0,0,59,5,64
2012,Bangladesh,BGD,Germany,DEU,10,0,172,5,187
2012,Burkina Faso,BFA,Germany,DEU,0,0,43,10,53
2012,Belarus,BLR,Germany,DEU,0,0,46,18,64
2012,Bosnia and Herzegovina,BIH,Germany,DEU,0,21,1742,93,1856
2012,Bulgaria,BGR,Germany,DEU,0,0,52,0,52
2012,Cambodia,KHM,Germany,DEU,0,0,11,0,11
2012,Chad,TCD,Germany,DEU,0,0,0,21,21
2012,China,CHN,Germany,DEU,54,5,111,10,180
2012,Cameroon,CMR,Germany,DEU,0,10,145,15,170
2012,Congo,COG,Germany,DEU,0,0,5,5,10
2012,Dem. Rep. of the Congo,COD,Germany,DEU,10,15,82,12,119
2012,Colombia,COL,Germany,DEU,0,0,26,5,31
2012,Cuba,CUB,Germany,DEU,0,0,5,0,5
2012,Equatorial Guinea,GNQ,Germany,DEU,0,0,5,0,5
2012,Eritrea,ERI,Germany,DEU,204,35,38,81,358
2012,Ethiopia,ETH,Germany,DEU,61,11,214,29,315
2012,Gabon,GAB,Germany,DEU,0,0,0,5,5
2012,Gambia,GMB,Germany,DEU,10,5,112,22,149
2012,Georgia,GEO,Germany,DEU,5,0,256,322,583
2012,Ghana,GHA,Germany,DEU,0,5,162,55,222
2012,Guinea-Bissau,GNB,Germany,DEU,0,0,18,10,28
2012,Guatemala,GTM,Germany,DEU,0,0,0,5,5
2012,Guinea,GIN,Germany,DEU,23,10,79,48,160
2012,Haiti,HTI,Germany,DEU,0,5,0,0,5
2012,Honduras,HND,Germany,DEU,0,13,5,0,18
2012,Croatia,HRV,Germany,DEU,0,0,24,13,37
2012,Cote d'Ivoire,CIV,Germany,DEU,0,0,46,10,56
2012,India,IND,Germany,DEU,0,5,597,21,623
2012,Iran (Islamic Rep. of),IRN,Germany,DEU,1414,44,1022,215,2695
2012,Iraq,IRQ,Germany,DEU,2594,98,1418,244,4354
2012,Israel,ISR,Germany,DEU,0,0,5,0,5
2012,Jamaica,JAM,Germany,DEU,0,0,0,5,5
2012,Jordan,JOR,Germany,DEU,5,0,13,0,18
2012,Kazakhstan,KAZ,Germany,DEU,0,0,5,20,25
2012,Kenya,KEN,Germany,DEU,0,5,126,15,146
2012,Kyrgyzstan,KGZ,Germany,DEU,5,0,28,11,44
2012,Liberia,LBR,Germany,DEU,0,0,5,5,10
2012,Libya,LBY,Germany,DEU,10,0,0,35,45
2012,Lebanon,LBN,Germany,DEU,10,5,234,57,306
2012,Sri Lanka,LKA,Germany,DEU,136,19,261,36,452
2012,Lithuania,LTU,Germany,DEU,0,0,5,0,5
2012,Mauritania,MRT,Germany,DEU,0,0,5,5,10
2012,North Macedonia,MKD,Germany,DEU,0,5,4098,360,4463
2012,Rep. of Moldova,MDA,Germany,DEU,0,0,17,5,22
2012,Mexico,MEX,Germany,DEU,0,5,0,0,5
2012,Mali,MLI,Germany,DEU,0,0,10,22,32
2012,Mongolia,MNG,Germany,DEU,0,0,21,15,36
2012,Morocco,MAR,Germany,DEU,0,0,211,63,274
2012,Montenegro,MNE,Germany,DEU,0,5,253,13,271
2012,Myanmar,MMR,Germany,DEU,30,0,5,0,35
2012,Nepal,NPL,Germany,DEU,0,0,13,0,13
2012,Niger,NER,Germany,DEU,0,0,14,15,29
2012,Nigeria,NGA,Germany,DEU,15,25,352,93,485
2012,Pakistan,PAK,Germany,DEU,280,13,1150,112,1555
2012,Peru,PER,Germany,DEU,0,0,0,5,5
2012,Philippines,PHL,Germany,DEU,0,0,5,0,5
2012,Romania,ROU,Germany,DEU,0,0,12,0,12
2012,South Africa,ZAF,Germany,DEU,0,0,5,0,5
2012,Russian Federation,RUS,Germany,DEU,102,30,536,339,1007
2012,Rwanda,RWA,Germany,DEU,5,0,17,0,22
2012,Serbia and Kosovo: S/RES/1244 (1999),SRB,Germany,DEU,5,42,10327,1107,11481
2012,Senegal,SEN,Germany,DEU,0,0,17,16,33
2012,Sierra Leone,SLE,Germany,DEU,5,5,13,10,33
2012,Somalia,SOM,Germany,DEU,277,224,38,278,817
2012,Viet Nam,VNM,Germany,DEU,5,0,477,62,544
2012,Sudan,SDN,Germany,DEU,0,20,48,24,92
2012,Slovakia,SVK,Germany,DEU,0,0,5,0,5
2012,Syrian Arab Rep.,SYR,Germany,DEU,1708,3522,10,267,5507
2012,Tajikistan,TJK,Germany,DEU,12,0,51,5,68
2012,Turkmenistan,TKM,Germany,DEU,0,0,5,0,5
2012,Togo,TGO,Germany,DEU,5,0,43,15,63
2012,Tunisia,TUN,Germany,DEU,0,0,116,167,283
2012,Turkey,TUR,Germany,DEU,105,16,683,177,981
2012,Uganda,UGA,Germany,DEU,0,5,11,5,21
2012,Ukraine,UKR,Germany,DEU,0,0,18,5,23
2012,Uzbekistan,UZB,Germany,DEU,5,0,18,0,23
2012,Yemen,YEM,Germany,DEU,0,0,0,14,14
2012,Zimbabwe,ZWE,Germany,DEU,0,0,11,0,11
2012,Stateless,XXA,Germany,DEU,79,156,29,25,289
2013,Afghanistan,AFG,Germany,DEU,1180,1588,2243,760,5771
2013,Albania,ALB,Germany,DEU,5,31,361,95,492
2013,Algeria,DZA,Germany,DEU,10,5,266,167,448
2013,Angola,AGO,Germany,DEU,5,35,23,5,68
2013,Egypt,EGY,Germany,DEU,62,24,152,73,311
2013,Armenia,ARM,Germany,DEU,10,57,396,126,589
2013,Azerbaijan,AZE,Germany,DEU,35,34,452,65,586
2013,Bahrain,BHR,Germany,DEU,5,0,0,0,5
2013,Burundi,BDI,Germany,DEU,0,0,5,0,5
2013,Benin,BEN,Germany,DEU,0,0,106,11,117
2013,Bangladesh,BGD,Germany,DEU,13,5,207,18,243
2013,Burkina Faso,BFA,Germany,DEU,0,0,65,31,96
2013,Belarus,BLR,Germany,DEU,5,0,42,55,102
2013,Brazil,BRA,Germany,DEU,0,5,0,0,5
2013,Bosnia and Herzegovina,BIH,Germany,DEU,0,16,2003,315,2334
2013,Bulgaria,BGR,Germany,DEU,0,0,52,10,62
2013,Cambodia,KHM,Germany,DEU,0,0,5,0,5
2013,Chad,TCD,Germany,DEU,0,0,5,23,28
2013,China,CHN,Germany,DEU,43,5,158,36,242
2013,Chile,CHL,Germany,DEU,0,0,5,0,5
2013,Cameroon,CMR,Germany,DEU,10,5,101,58,174
2013,Congo,COG,Germany,DEU,5,0,10,5,20
2013,Dem. Rep. of the Congo,COD,Germany,DEU,10,24,140,16,190
2013,Colombia,COL,Germany,DEU,0,0,19,5,24
2013,Cuba,CUB,Germany,DEU,0,0,13,5,18
2013,Dominican Rep.,DOM,Germany,DEU,0,0,5,0,5
2013,Eritrea,ERI,Germany,DEU,368,51,20,136,575
2013,Ethiopia,ETH,Germany,DEU,71,19,223,44,357
2013,Gambia,GMB,Germany,DEU,5,5,76,63,149
2013,Palestinian,PSE,Germany,DEU,16,10,10,18,54
2013,United Kingdom of Great Britain and Northern Ireland,GBR,Germany,DEU,0,0,5,0,5
2013,Georgia,GEO,Germany,DEU,5,0,445,992,1442
2013,Ghana,GHA,Germany,DEU,0,10,323,128,461
2013,Guinea-Bissau,GNB,Germany,DEU,0,0,33,29,62
2013,Guinea,GIN,Germany,DEU,56,30,199,108,393
2013,Haiti,HTI,Germany,DEU,0,0,10,12,22
2013,Honduras,HND,Germany,DEU,0,5,0,0,5
2013,Croatia,HRV,Germany,DEU,5,0,24,0,29
2013,Cote d'Ivoire,CIV,Germany,DEU,5,0,40,57,102
2013,India,IND,Germany,DEU,0,0,544,39,583
2013,Iran (Islamic Rep. of),IRN,Germany,DEU,1709,62,995,437,3203
2013,Iraq,IRQ,Germany,DEU,2047,143,1437,317,3944
2013,Israel,ISR,Germany,DEU,0,0,0,5,5
2013,Jamaica,JAM,Germany,DEU,0,0,11,0,11
2013,Jordan,JOR,Germany,DEU,0,0,16,11,27
2013,Kazakhstan,KAZ,Germany,DEU,0,0,15,49,64
2013,Kenya,KEN,Germany,DEU,5,5,70,10,90
2013,Kyrgyzstan,KGZ,Germany,DEU,5,0,47,23,75
2013,Dem. People's Rep. of Korea,PRK,Germany,DEU,0,0,5,11,16
2013,Liberia,LBR,Germany,DEU,0,0,0,10,10
2013,Libya,LBY,Germany,DEU,0,15,67,37,119
2013,Lebanon,LBN,Germany,DEU,14,11,277,58,360
2013,Sri Lanka,LKA,Germany,DEU,106,19,224,56,405
2013,Lithuania,LTU,Germany,DEU,0,0,10,0,10
2013,Latvia,LVA,Germany,DEU,0,0,5,0,5
2013,Mauritania,MRT,Germany,DEU,0,0,5,33,38
2013,North Macedonia,MKD,Germany,DEU,5,10,3526,439,3980
2013,Rep. of Moldova,MDA,Germany,DEU,0,5,20,5,30
2013,Mexico,MEX,Germany,DEU,0,10,0,0,10
2013,Mali,MLI,Germany,DEU,5,0,55,86,146
2013,Mongolia,MNG,Germany,DEU,0,5,5,22,32
2013,Morocco,MAR,Germany,DEU,5,0,380,178,563
2013,Montenegro,MNE,Germany,DEU,0,5,138,38,181
2013,Myanmar,MMR,Germany,DEU,29,10,10,0,49
2013,Nepal,NPL,Germany,DEU,0,0,17,0,17
2013,Niger,NER,Germany,DEU,0,0,19,19,38
2013,Nigeria,NGA,Germany,DEU,36,39,362,240,677
2013,Pakistan,PAK,Germany,DEU,762,22,1141,353,2278
2013,Poland,POL,Germany,DEU,0,0,5,0,5
2013,Romania,ROU,Germany,DEU,0,0,27,5,32
2013,Russian Federation,RUS,Germany,DEU,141,90,1300,10299,11830
2013,Rwanda,RWA,Germany,DEU,5,0,14,0,19
2013,Serbia and Kosovo: S/RES/1244 (1999),SRB,Germany,DEU,0,40,8531,1261,9832
2013,Senegal,SEN,Germany,DEU,0,5,52,44,101
2013,Sierra Leone,SLE,Germany,DEU,5,17,38,15,75
2013,Somalia,SOM,Germany,DEU,449,258,271,398,1376
2013,Spain,ESP,Germany,DEU,0,0,5,0,5
2013,Viet Nam,VNM,Germany,DEU,0,5,501,91,597
2013,Sudan,SDN,Germany,DEU,11,5,62,69,147
2013,South Sudan,SSD,Germany,DEU,0,0,0,5,5
2013,Syrian Arab Rep.,SYR,Germany,DEU,2726,5464,10,368,8568
2013,United Rep. of Tanzania,TZA,Germany,DEU,0,0,0,5,5
2013,Thailand,THA,Germany,DEU,0,0,5,0,5
2013,Tajikistan,TJK,Germany,DEU,10,12,48,10,80
2013,Turkmenistan,TKM,Germany,DEU,0,0,15,0,15
2013,Togo,TGO,Germany,DEU,5,0,21,22,48
2013,Tunisia,TUN,Germany,DEU,5,0,152,125,282
2013,Turkey,TUR,Germany,DEU,74,21,732,258,1085
2013,Uganda,UGA,Germany,DEU,5,10,24,5,44
2013,Ukraine,UKR,Germany,DEU,0,5,24,26,55
2013,United States of America,USA,Germany,DEU,0,0,0,5,5
2013,Uzbekistan,UZB,Germany,DEU,5,0,21,0,26
2013,Venezuela (Bolivarian Republic of),VEN,Germany,DEU,0,0,5,0,5
2013,Yemen,YEM,Germany,DEU,0,0,0,5,5
2013,Zimbabwe,ZWE,Germany,DEU,0,5,5,5,15
2013,Stateless,XXA,Germany,DEU,61,96,38,26,221
2014,Afghanistan,AFG,Germany,DEU,1830,1307,1554,2185,6876
2014,Albania,ALB,Germany,DEU,10,65,2805,434,3314
2014,Algeria,DZA,Germany,DEU,0,5,360,759,1124
2014,Angola,AGO,Germany,DEU,5,27,0,34,66
2014,Egypt,EGY,Germany,DEU,79,13,171,283,546
2014,Armenia,ARM,Germany,DEU,10,64,455,286,815
2014,Azerbaijan,AZE,Germany,DEU,40,30,517,114,701
2014,Bahrain,BHR,Germany,DEU,27,0,0,0,27
2014,Burundi,BDI,Germany,DEU,5,0,0,5,10
2014,Benin,BEN,Germany,DEU,0,0,99,62,161
2014,Bangladesh,BGD,Germany,DEU,31,16,398,112,557
2014,Burkina Faso,BFA,Germany,DEU,0,0,64,143,207
2014,Belarus,BLR,Germany,DEU,5,0,26,54,85
2014,Bosnia and Herzegovina,BIH,Germany,DEU,0,12,3625,850,4487
2014,Bulgaria,BGR,Germany,DEU,0,0,55,11,66
2014,Cambodia,KHM,Germany,DEU,0,0,0,12,12
2014,Central African Rep.,CAF,Germany,DEU,0,0,0,5,5
2014,Chad,TCD,Germany,DEU,0,0,5,168,173
2014,China,CHN,Germany,DEU,13,13,97,54,177
2014,Cameroon,CMR,Germany,DEU,5,12,117,240,374
2014,Congo,COG,Germany,DEU,0,0,21,16,37
2014,Dem. Rep. of the Congo,COD,Germany,DEU,5,25,62,33,125
2014,Colombia,COL,Germany,DEU,0,0,5,14,19
2014,Cuba,CUB,Germany,DEU,0,5,15,22,42
2014,Djibouti,DJI,Germany,DEU,0,0,0,5,5
2014,Ecuador,ECU,Germany,DEU,5,0,0,0,5
2014,Eritrea,ERI,Germany,DEU,738,230,16,773,1757
2014,Ethiopia,ETH,Germany,DEU,82,47,265,209,603
2014,France,FRA,Germany,DEU,0,0,0,5,5
2014,Gabon,GAB,Germany,DEU,0,0,0,5,5
2014,Gambia,GMB,Germany,DEU,11,0,105,600,716
2014,Palestinian,PSE,Germany,DEU,172,12,5,15,204
2014,Georgia,GEO,Germany,DEU,5,5,917,1372,2299
2014,Ghana,GHA,Germany,DEU,0,10,197,423,630
2014,Guinea-Bissau,GNB,Germany,DEU,0,0,82,150,232
2014,Greece,GRC,Germany,DEU,0,0,5,0,5
2014,Guatemala,GTM,Germany,DEU,0,0,10,0,10
2014,Guinea,GIN,Germany,DEU,60,32,115,444,651
2014,Haiti,HTI,Germany,DEU,0,0,5,0,5
2014,Croatia,HRV,Germany,DEU,0,0,10,10,20
2014,Hungary,HUN,Germany,DEU,0,0,5,0,5
2014,Cote d'Ivoire,CIV,Germany,DEU,5,0,60,224,289
2014,India,IND,Germany,DEU,5,5,515,81,606
2014,Iran (Islamic Rep. of),IRN,Germany,DEU,1875,68,712,1145,3800
2014,Iraq,IRQ,Germany,DEU,2601,146,411,684,3842
2014,Israel,ISR,Germany,DEU,0,0,0,13,13
2014,Italy,ITA,Germany,DEU,0,0,0,10,10
2014,Jamaica,JAM,Germany,DEU,0,0,5,5,10
2014,Jordan,JOR,Germany,DEU,11,0,5,23,39
2014,Kazakhstan,KAZ,Germany,DEU,10,0,19,99,128
2014,Kenya,KEN,Germany,DEU,0,10,60,60,130
2014,Kyrgyzstan,KGZ,Germany,DEU,29,0,35,70,134
2014,Rep. of Korea,KOR,Germany,DEU,0,0,0,12,12
2014,Dem. People's Rep. of Korea,PRK,Germany,DEU,0,0,0,10,10
2014,Kuwait,KWT,Germany,DEU,0,0,0,5,5
2014,Liberia,LBR,Germany,DEU,0,0,0,57,57
2014,Libya,LBY,Germany,DEU,105,12,46,176,339
2014,Lebanon,LBN,Germany,DEU,17,5,185,238,445
2014,Sri Lanka,LKA,Germany,DEU,119,27,125,47,318
2014,Mauritania,MRT,Germany,DEU,0,0,18,82,100
2014,North Macedonia,MKD,Germany,DEU,0,13,4694,903,5610
2014,Rep. of Moldova,MDA,Germany,DEU,5,0,12,10,27
2014,Mexico,MEX,Germany,DEU,0,0,5,0,5
2014,Mali,MLI,Germany,DEU,5,5,187,356,553
2014,Malawi,MWI,Germany,DEU,0,0,0,5,5
2014,Mongolia,MNG,Germany,DEU,0,0,83,148,231
2014,Morocco,MAR,Germany,DEU,5,5,513,615,1138
2014,Mozambique,MOZ,Germany,DEU,0,0,0,5,5
2014,Montenegro,MNE,Germany,DEU,0,0,582,59,641
2014,Myanmar,MMR,Germany,DEU,10,5,0,14,29
2014,Nepal,NPL,Germany,DEU,0,0,11,5,16
2014,Netherlands,NLD,Germany,DEU,0,0,0,5,5
2014,Niger,NER,Germany,DEU,0,0,27,149,176
2014,Nigeria,NGA,Germany,DEU,46,47,223,901,1217
2014,Pakistan,PAK,Germany,DEU,499,31,1412,954,2896
2014,Poland,POL,Germany,DEU,0,0,5,0,5
2014,Romania,ROU,Germany,DEU,0,0,11,5,16
2014,South Africa,ZAF,Germany,DEU,0,0,0,5,5
2014,Russian Federation,RUS,Germany,DEU,190,158,1296,3799,5443
2014,Rwanda,RWA,Germany,DEU,5,0,5,5,15
2014,Saudi Arabia,SAU,Germany,DEU,5,0,0,0,5
2014,Serbia and Kosovo: S/RES/1244 (1999),SRB,Germany,DEU,5,58,13770,2761,16594
2014,Senegal,SEN,Germany,DEU,0,0,75,179,254
2014,Sierra Leone,SLE,Germany,DEU,5,17,5,51,78
2014,Somalia,SOM,Germany,DEU,508,311,298,2231,3348
2014,Spain,ESP,Germany,DEU,0,0,12,0,12
2014,Viet Nam,VNM,Germany,DEU,0,5,114,121,240
2014,Sudan,SDN,Germany,DEU,41,18,36,345,440
2014,South Sudan,SSD,Germany,DEU,0,0,5,25,30
2014,Syrian Arab Rep.,SYR,Germany,DEU,19560,2998,10,2459,25027
2014,United Rep. of Tanzania,TZA,Germany,DEU,0,0,0,13,13
2014,Thailand,THA,Germany,DEU,5,0,0,0,5
2014,Tajikistan,TJK,Germany,DEU,20,0,80,60,160
2014,Turkmenistan,TKM,Germany,DEU,5,0,15,24,44
2014,Togo,TGO,Germany,DEU,0,0,27,52,79
2014,Tunisia,TUN,Germany,DEU,0,0,485,374,859
2014,Turkey,TUR,Germany,DEU,79,33,507,379,998
2014,Uganda,UGA,Germany,DEU,0,0,5,14,19
2014,Ukraine,UKR,Germany,DEU,10,10,36,274,330
2014,United States of America,USA,Germany,DEU,0,0,0,5,5
2014,Uzbekistan,UZB,Germany,DEU,5,0,5,12,22
2014,Venezuela (Bolivarian Republic of),VEN,Germany,DEU,0,0,5,0,5
2014,Yemen,YEM,Germany,DEU,0,5,10,48,63
2014,Zimbabwe,ZWE,Germany,DEU,0,0,5,5,10
2014,Stateless,XXA,Germany,DEU,516,189,35,163,903
2015,Afghanistan,AFG,Germany,DEU,1550,1001,809,2132,5492
2015,Albania,ALB,Germany,DEU,5,69,31086,4075,35235
2015,Algeria,DZA,Germany,DEU,11,5,330,666,1012
2015,Angola,AGO,Germany,DEU,5,24,20,14,63
2015,Egypt,EGY,Germany,DEU,335,21,224,244,824
2015,Armenia,ARM,Germany,DEU,18,34,263,300,615
2015,Azerbaijan,AZE,Germany,DEU,42,24,160,127,353
2015,Bahrain,BHR,Germany,DEU,26,0,0,0,26
2015,Burundi,BDI,Germany,DEU,0,0,5,0,5
2015,Benin,BEN,Germany,DEU,0,0,21,74,95
2015,Bangladesh,BGD,Germany,DEU,19,10,216,178,423
2015,Bhutan,BTN,Germany,DEU,0,0,5,0,5
2015,Burkina Faso,BFA,Germany,DEU,0,5,22,85,112
2015,Belarus,BLR,Germany,DEU,5,0,0,56,61
2015,Botswana,BWA,Germany,DEU,0,0,5,0,5
2015,Brazil,BRA,Germany,DEU,0,0,0,11,11
2015,Bosnia and Herzegovina,BIH,Germany,DEU,0,11,3081,809,3901
2015,Bulgaria,BGR,Germany,DEU,0,0,15,13,28
2015,Cambodia,KHM,Germany,DEU,0,0,5,0,5
2015,Chad,TCD,Germany,DEU,0,16,24,65,105
2015,China,CHN,Germany,DEU,26,0,95,28,149
2015,Cameroon,CMR,Germany,DEU,0,5,94,262,361
2015,Congo,COG,Germany,DEU,0,0,12,10,22
2015,Dem. Rep. of the Congo,COD,Germany,DEU,5,24,106,22,157
2015,Colombia,COL,Germany,DEU,0,0,0,12,12
2015,Cuba,CUB,Germany,DEU,0,0,0,35,35
2015,Czechia,CZE,Germany,DEU,0,0,0,11,11
2015,Djibouti,DJI,Germany,DEU,0,0,5,5,10
2015,Dominican Rep.,DOM,Germany,DEU,0,5,0,0,5
2015,Eritrea,ERI,Germany,DEU,8895,367,37,728,10027
2015,Ethiopia,ETH,Germany,DEU,58,35,85,188,366
2015,France,FRA,Germany,DEU,0,0,5,0,5
2015,Gambia,GMB,Germany,DEU,11,5,53,519,588
2015,Georgia,GEO,Germany,DEU,0,5,1371,641,2017
2015,Ghana,GHA,Germany,DEU,10,5,126,397,538
2015,Guinea-Bissau,GNB,Germany,DEU,0,0,20,185,205
2015,Greece,GRC,Germany,DEU,0,0,5,0,5
2015,Guinea,GIN,Germany,DEU,47,23,80,215,365
2015,Honduras,HND,Germany,DEU,0,0,0,14,14
2015,Croatia,HRV,Germany,DEU,0,0,14,0,14
2015,Cote d'Ivoire,CIV,Germany,DEU,5,5,29,295,334
2015,India,IND,Germany,DEU,5,5,410,98,518
2015,Iran (Islamic Rep. of),IRN,Germany,DEU,1424,37,260,737,2458
2015,Iraq,IRQ,Germany,DEU,10732,229,111,1667,12739
2015,Israel,ISR,Germany,DEU,0,0,5,0,5
2015,Italy,ITA,Germany,DEU,0,0,5,0,5
2015,Jamaica,JAM,Germany,DEU,0,0,0,11,11
2015,Jordan,JOR,Germany,DEU,23,0,5,23,51
2015,Kazakhstan,KAZ,Germany,DEU,0,0,15,58,73
2015,Kenya,KEN,Germany,DEU,0,0,109,54,163
2015,Kyrgyzstan,KGZ,Germany,DEU,5,0,13,39,57
2015,Dem. People's Rep. of Korea,PRK,Germany,DEU,0,0,5,0,5
2015,Liberia,LBR,Germany,DEU,0,0,0,41,41
2015,Libya,LBY,Germany,DEU,112,10,32,186,340
2015,Lebanon,LBN,Germany,DEU,33,10,135,204,382
2015,Sri Lanka,LKA,Germany,DEU,65,5,84,25,179
2015,Mauritania,MRT,Germany,DEU,0,0,15,55,70
2015,North Macedonia,MKD,Germany,DEU,22,11,4967,671,5671
2015,Rep. of Moldova,MDA,Germany,DEU,0,0,25,18,43
2015,Mexico,MEX,Germany,DEU,0,5,0,0,5
2015,Mali,MLI,Germany,DEU,5,5,59,245,314
2015,Mongolia,MNG,Germany,DEU,0,0,51,130,181
2015,Morocco,MAR,Germany,DEU,21,14,394,442,871
2015,Montenegro,MNE,Germany,DEU,0,5,1775,189,1969
2015,Myanmar,MMR,Germany,DEU,12,0,0,10,22
2015,Namibia,NAM,Germany,DEU,0,0,0,5,5
2015,Nepal,NPL,Germany,DEU,0,14,0,0,14
2015,Niger,NER,Germany,DEU,0,0,14,75,89
2015,Nigeria,NGA,Germany,DEU,31,40,176,867,1114
2015,Pakistan,PAK,Germany,DEU,143,27,831,860,1861
2015,Peru,PER,Germany,DEU,0,0,5,0,5
2015,Philippines,PHL,Germany,DEU,0,0,11,0,11
2015,Romania,ROU,Germany,DEU,0,0,5,0,5
2015,Russian Federation,RUS,Germany,DEU,167,117,811,2556,3651
2015,Rwanda,RWA,Germany,DEU,11,5,10,5,31
2015,Saudi Arabia,SAU,Germany,DEU,5,0,0,0,5
2015,Serbia and Kosovo: S/RES/1244 (1999),SRB,Germany,DEU,17,124,37130,3981,41252
2015,Senegal,SEN,Germany,DEU,0,0,29,182,211
2015,Sierra Leone,SLE,Germany,DEU,5,10,24,36,75
2015,Somalia,SOM,Germany,DEU,407,340,180,927,1854
2015,Viet Nam,VNM,Germany,DEU,0,5,71,188,264
2015,Sudan,SDN,Germany,DEU,46,87,47,261,441
2015,South Sudan,SSD,Germany,DEU,5,0,0,17,22
2015,Syrian Arab Rep.,SYR,Germany,DEU,97656,197,22,4062,101937
2015,United Rep. of Tanzania,TZA,Germany,DEU,0,0,0,11,11
2015,Tajikistan,TJK,Germany,DEU,5,0,24,130,159
2015,Turkmenistan,TKM,Germany,DEU,0,0,13,33,46
2015,Togo,TGO,Germany,DEU,0,0,17,37,54
2015,Tunisia,TUN,Germany,DEU,0,0,246,204,450
2015,Turkey,TUR,Germany,DEU,75,27,237,399,738
2015,Uganda,UGA,Germany,DEU,5,0,5,13,23
2015,Ukraine,UKR,Germany,DEU,51,0,42,874,967
2015,United States of America,USA,Germany,DEU,5,0,0,0,5
2015,Uzbekistan,UZB,Germany,DEU,12,0,0,0,12
2015,Venezuela (Bolivarian Republic of),VEN,Germany,DEU,0,0,5,0,5
2015,Yemen,YEM,Germany,DEU,13,31,0,23,67
2015,Zambia,ZMB,Germany,DEU,0,0,0,5,5
2015,Zimbabwe,ZWE,Germany,DEU,0,5,12,0,17
2015,Stateless,XXA,Germany,DEU,1825,0,25,152,2002
2016,Afghanistan,AFG,Germany,DEU,13647,24108,24734,4892,67381
2016,Albania,ALB,Germany,DEU,18,139,29681,5400,35238
2016,Algeria,DZA,Germany,DEU,41,97,3154,1712,5004
2016,Angola,AGO,Germany,DEU,5,23,40,24,92
2016,Egypt,EGY,Germany,DEU,374,92,1755,395,2616
2016,Armenia,ARM,Germany,DEU,33,149,1717,505,2404
2016,Azerbaijan,AZE,Germany,DEU,276,163,1681,446,2566
2016,Bahrain,BHR,Germany,DEU,5,0,0,0,5
2016,Burundi,BDI,Germany,DEU,0,11,0,5,16
2016,Benin,BEN,Germany,DEU,0,14,166,122,302
2016,Bangladesh,BGD,Germany,DEU,73,33,520,295,921
2016,Bhutan,BTN,Germany,DEU,0,0,0,5,5
2016,Burkina Faso,BFA,Germany,DEU,5,0,138,88,231
2016,Belarus,BLR,Germany,DEU,11,0,59,126,196
2016,Bosnia and Herzegovina,BIH,Germany,DEU,5,41,3658,884,4588
2016,Bulgaria,BGR,Germany,DEU,0,0,17,0,17
2016,Central African Rep.,CAF,Germany,DEU,5,0,0,5,10
2016,Chad,TCD,Germany,DEU,5,12,43,79,139
2016,China,CHN,Germany,DEU,78,22,386,171,657
2016,Cameroon,CMR,Germany,DEU,5,5,263,270,543
2016,Congo,COG,Germany,DEU,13,0,13,15,41
2016,Dem. Rep. of the Congo,COD,Germany,DEU,18,11,94,32,155
2016,Colombia,COL,Germany,DEU,5,0,24,5,34
2016,Cuba,CUB,Germany,DEU,0,0,15,45,60
2016,Djibouti,DJI,Germany,DEU,0,0,0,5,5
2016,Ecuador,ECU,Germany,DEU,0,0,5,0,5
2016,Eritrea,ERI,Germany,DEU,16568,3738,135,1498,21939
2016,Ethiopia,ETH,Germany,DEU,159,84,752,365,1360
2016,Gabon,GAB,Germany,DEU,5,0,5,0,10
2016,Gambia,GMB,Germany,DEU,41,31,544,470,1086
2016,United Kingdom of Great Britain and Northern Ireland,GBR,Germany,DEU,0,0,5,0,5
2016,Georgia,GEO,Germany,DEU,26,36,2441,1125,3628
2016,Ghana,GHA,Germany,DEU,10,49,1199,500,1758
2016,Guinea-Bissau,GNB,Germany,DEU,0,13,175,282,470
2016,Guinea,GIN,Germany,DEU,152,51,516,466,1185
2016,Honduras,HND,Germany,DEU,0,12,0,0,12
2016,Croatia,HRV,Germany,DEU,0,0,0,14,14
2016,Hungary,HUN,Germany,DEU,0,0,0,13,13
2016,Cote d'Ivoire,CIV,Germany,DEU,5,15,148,233,401
2016,India,IND,Germany,DEU,27,41,3636,932,4636
2016,Indonesia,IDN,Germany,DEU,0,0,0,5,5
2016,Iran (Islamic Rep. of),IRN,Germany,DEU,5288,364,3700,1671,11023
2016,Iraq,IRQ,Germany,DEU,36149,11139,14074,5757,67119
2016,Israel,ISR,Germany,DEU,0,0,12,10,22
2016,Italy,ITA,Germany,DEU,0,0,13,5,18
2016,Jamaica,JAM,Germany,DEU,0,0,5,5,10
2016,Jordan,JOR,Germany,DEU,19,16,35,55,125
2016,Kazakhstan,KAZ,Germany,DEU,0,0,73,48,121
2016,Kenya,KEN,Germany,DEU,0,5,110,68,183
2016,Kyrgyzstan,KGZ,Germany,DEU,15,5,31,27,78
2016,Dem. People's Rep. of Korea,PRK,Germany,DEU,0,0,5,10,15
2016,Kuwait,KWT,Germany,DEU,0,0,0,14,14
2016,Liberia,LBR,Germany,DEU,0,0,23,42,65
2016,Libya,LBY,Germany,DEU,334,99,680,366,1479
2016,Lebanon,LBN,Germany,DEU,148,179,2785,780,3892
2016,Sri Lanka,LKA,Germany,DEU,83,34,147,55,319
2016,Lithuania,LTU,Germany,DEU,0,0,5,0,5
2016,Latvia,LVA,Germany,DEU,0,0,0,5,5
2016,Mauritania,MRT,Germany,DEU,0,0,19,74,93
2016,North Macedonia,MKD,Germany,DEU,5,35,7814,1571,9425
2016,Rep. of Moldova,MDA,Germany,DEU,11,12,2826,1876,4725
2016,Mexico,MEX,Germany,DEU,0,0,5,0,5
2016,Mali,MLI,Germany,DEU,19,20,266,349,654
2016,Malawi,MWI,Germany,DEU,0,0,0,5,5
2016,Mongolia,MNG,Germany,DEU,5,5,110,107,227
2016,Morocco,MAR,Germany,DEU,77,89,3004,1481,4651
2016,Mozambique,MOZ,Germany,DEU,5,0,0,0,5
2016,Montenegro,MNE,Germany,DEU,0,14,2439,338,2791
2016,Myanmar,MMR,Germany,DEU,13,5,0,12,30
2016,Nepal,NPL,Germany,DEU,0,0,0,13,13
2016,Niger,NER,Germany,DEU,0,5,60,87,152
2016,Nigeria,NGA,Germany,DEU,123,238,1774,1553,3688
2016,Pakistan,PAK,Germany,DEU,263,144,8109,2556,11072
2016,Peru,PER,Germany,DEU,0,0,5,0,5
2016,Philippines,PHL,Germany,DEU,0,0,12,0,12
2016,Poland,POL,Germany,DEU,0,0,13,5,18
2016,Portugal,PRT,Germany,DEU,0,0,5,5,10
2016,Romania,ROU,Germany,DEU,0,0,5,5,10
2016,South Africa,ZAF,Germany,DEU,0,0,11,0,11
2016,Russian Federation,RUS,Germany,DEU,325,248,5459,5034,11066
2016,Rwanda,RWA,Germany,DEU,5,0,5,11,21
2016,El Salvador,SLV,Germany,DEU,0,0,5,0,5
2016,Saudi Arabia,SAU,Germany,DEU,29,0,12,5,46
2016,Serbia and Kosovo: S/RES/1244 (1999),SRB,Germany,DEU,13,156,25836,4293,30298
2016,Senegal,SEN,Germany,DEU,13,17,1270,290,1590
2016,Sierra Leone,SLE,Germany,DEU,5,5,46,79,135
2016,Somalia,SOM,Germany,DEU,1828,2731,582,1193,6334
2016,Spain,ESP,Germany,DEU,0,0,5,5,10
2016,Viet Nam,VNM,Germany,DEU,5,5,736,361,1107
2016,Sudan,SDN,Germany,DEU,143,92,157,357,749
2016,South Sudan,SSD,Germany,DEU,0,5,5,16,26
2016,Syrian Arab Rep.,SYR,Germany,DEU,164926,121182,158,5398,291664
2016,United Rep. of Tanzania,TZA,Germany,DEU,0,0,0,5,5
2016,Tajikistan,TJK,Germany,DEU,49,10,171,318,548
2016,Turkmenistan,TKM,Germany,DEU,5,5,186,49,245
2016,Togo,TGO,Germany,DEU,0,5,31,33,69
2016,Tunisia,TUN,Germany,DEU,5,5,855,483,1348
2016,Turkey,TUR,Germany,DEU,99,45,643,855,1642
2016,United Arab Emirates,ARE,Germany,DEU,5,0,0,0,5
2016,Uganda,UGA,Germany,DEU,0,14,15,27,56
2016,Ukraine,UKR,Germany,DEU,28,34,2260,1605,3927
2016,United States of America,USA,Germany,DEU,5,0,0,0,5
2016,Uzbekistan,UZB,Germany,DEU,10,0,5,5,20
2016,Venezuela (Bolivarian Republic of),VEN,Germany,DEU,5,0,22,5,32
2016,Yemen,YEM,Germany,DEU,50,200,0,53,303
2016,Zimbabwe,ZWE,Germany,DEU,11,5,23,0,39
2016,Stateless,XXA,Germany,DEU,3081,2299,295,211,5886
2017,Afghanistan,AFG,Germany,DEU,17718,32647,56309,5918,112592
2017,Albania,ALB,Germany,DEU,10,119,5955,997,7081
2017,Algeria,DZA,Germany,DEU,32,86,1759,1448,3325
2017,Angola,AGO,Germany,DEU,29,113,124,147,413
2017,Egypt,EGY,Germany,DEU,354,135,1625,580,2694
2017,Armenia,ARM,Germany,DEU,183,623,6839,1553,9198
2017,Azerbaijan,AZE,Germany,DEU,595,341,4178,1609,6723
2017,Bahrain,BHR,Germany,DEU,14,5,5,5,29
2017,Burundi,BDI,Germany,DEU,19,5,12,5,41
2017,Benin,BEN,Germany,DEU,10,26,463,99,598
2017,Bangladesh,BGD,Germany,DEU,217,89,2221,529,3056
2017,Bhutan,BTN,Germany,DEU,0,0,5,0,5
2017,Burkina Faso,BFA,Germany,DEU,10,19,320,135,484
2017,Belarus,BLR,Germany,DEU,20,13,313,316,662
2017,Botswana,BWA,Germany,DEU,5,0,0,0,5
2017,Brazil,BRA,Germany,DEU,0,5,28,0,33
2017,Bosnia and Herzegovina,BIH,Germany,DEU,0,21,1031,195,1247
2017,Bulgaria,BGR,Germany,DEU,0,0,22,0,22
2017,Cambodia,KHM,Germany,DEU,0,5,12,5,22
2017,Canada,CAN,Germany,DEU,0,0,5,0,5
2017,Central African Rep.,CAF,Germany,DEU,13,18,47,25,103
2017,Chad,TCD,Germany,DEU,15,10,116,119,260
2017,China,CHN,Germany,DEU,191,46,1131,494,1862
2017,Chile,CHL,Germany,DEU,0,0,5,0,5
2017,Cameroon,CMR,Germany,DEU,64,125,1704,864,2757
2017,Congo,COG,Germany,DEU,22,20,72,45,159
2017,Dem. Rep. of the Congo,COD,Germany,DEU,156,166,438,157,917
2017,Comoros,COM,Germany,DEU,0,0,5,5,10
2017,Colombia,COL,Germany,DEU,0,0,53,16,69
2017,Cuba,CUB,Germany,DEU,0,0,171,45,216
2017,Czechia,CZE,Germany,DEU,0,0,5,0,5
2017,Djibouti,DJI,Germany,DEU,13,0,10,10,33
2017,Dominican Rep.,DOM,Germany,DEU,0,0,5,5,10
2017,Equatorial Guinea,GNQ,Germany,DEU,5,5,5,5,20
2017,Eritrea,ERI,Germany,DEU,10033,7906,452,2970,21361
2017,Ethiopia,ETH,Germany,DEU,1055,817,5721,907,8500
2017,France,FRA,Germany,DEU,0,0,5,0,5
2017,Gabon,GAB,Germany,DEU,0,0,19,12,31
2017,Gambia,GMB,Germany,DEU,216,230,5806,3064,9316
2017,United Kingdom of Great Britain and Northern Ireland,GBR,Germany,DEU,0,0,12,0,12
2017,Georgia,GEO,Germany,DEU,17,98,4095,1343,5553
2017,Ghana,GHA,Germany,DEU,36,138,2522,751,3447
2017,Guinea-Bissau,GNB,Germany,DEU,5,37,320,230,592
2017,Greece,GRC,Germany,DEU,0,0,5,12,17
2017,Guatemala,GTM,Germany,DEU,0,0,10,0,10
2017,Guinea,GIN,Germany,DEU,589,611,3204,2826,7230
2017,Haiti,HTI,Germany,DEU,0,0,10,0,10
2017,Honduras,HND,Germany,DEU,11,5,11,0,27
2017,Croatia,HRV,Germany,DEU,0,0,16,0,16
2017,Hungary,HUN,Germany,DEU,0,0,5,0,5
2017,Cote d'Ivoire,CIV,Germany,DEU,85,144,1164,1180,2573
2017,India,IND,Germany,DEU,39,58,2758,745,3600
2017,Indonesia,IDN,Germany,DEU,0,0,12,0,12
2017,Iran (Islamic Rep. of),IRN,Germany,DEU,13881,934,11174,3607,29596
2017,Iraq,IRQ,Germany,DEU,24009,15489,21751,7713,68962
2017,Israel,ISR,Germany,DEU,0,5,25,5,35
2017,Italy,ITA,Germany,DEU,0,0,14,5,19
2017,Jamaica,JAM,Germany,DEU,44,0,83,10,137
2017,Jordan,JOR,Germany,DEU,48,78,240,113,479
2017,Kazakhstan,KAZ,Germany,DEU,5,5,150,45,205
2017,Kenya,KEN,Germany,DEU,10,5,279,87,381
2017,Kyrgyzstan,KGZ,Germany,DEU,18,15,115,65,213
2017,Rep. of Korea,KOR,Germany,DEU,0,0,5,14,19
2017,Dem. People's Rep. of Korea,PRK,Germany,DEU,0,0,38,41,79
2017,Kuwait,KWT,Germany,DEU,5,0,17,32,54
2017,Liberia,LBR,Germany,DEU,13,5,91,141,250
2017,Libya,LBY,Germany,DEU,309,271,557,704,1841
2017,Lebanon,LBN,Germany,DEU,139,334,2985,670,4128
2017,Sri Lanka,LKA,Germany,DEU,134,52,814,230,1230
2017,Lithuania,LTU,Germany,DEU,0,0,5,0,5
2017,Latvia,LVA,Germany,DEU,0,0,5,0,5
2017,Madagascar,MDG,Germany,DEU,0,0,5,0,5
2017,Mauritania,MRT,Germany,DEU,16,5,82,35,138
2017,North Macedonia,MKD,Germany,DEU,5,35,3378,508,3926
2017,Rep. of Moldova,MDA,Germany,DEU,15,10,1035,165,1225
2017,Mexico,MEX,Germany,DEU,0,0,5,5,10
2017,Mali,MLI,Germany,DEU,55,76,1017,659,1807
2017,Malaysia,MYS,Germany,DEU,5,0,14,0,19
2017,Mongolia,MNG,Germany,DEU,10,71,796,319,1196
2017,Morocco,MAR,Germany,DEU,85,133,1907,1287,3412
2017,Mozambique,MOZ,Germany,DEU,0,0,5,5,10
2017,Montenegro,MNE,Germany,DEU,5,0,530,78,613
2017,Mauritius,MUS,Germany,DEU,0,0,5,0,5
2017,Myanmar,MMR,Germany,DEU,137,37,46,39,259
2017,Nepal,NPL,Germany,DEU,5,0,105,25,135
2017,Netherlands,NLD,Germany,DEU,0,0,5,5,10
2017,Niger,NER,Germany,DEU,5,5,166,100,276
2017,Nicaragua,NIC,Germany,DEU,0,0,5,0,5
2017,Nigeria,NGA,Germany,DEU,1538,2328,12484,6002,22352
2017,Oman,OMN,Germany,DEU,0,0,12,0,12
2017,Pakistan,PAK,Germany,DEU,487,367,14605,3631,19090
2017,Paraguay,PRY,Germany,DEU,0,0,0,5,5
2017,Peru,PER,Germany,DEU,0,0,0,12,12
2017,Philippines,PHL,Germany,DEU,0,5,21,11,37
2017,Poland,POL,Germany,DEU,0,0,20,0,20
2017,Portugal,PRT,Germany,DEU,0,0,0,5,5
2017,Romania,ROU,Germany,DEU,0,0,17,14,31
2017,South Africa,ZAF,Germany,DEU,0,0,17,5,22
2017,Russian Federation,RUS,Germany,DEU,707,651,9075,3973,14406
2017,Rwanda,RWA,Germany,DEU,23,5,44,5,77
2017,El Salvador,SLV,Germany,DEU,0,5,27,10,42
2017,Saudi Arabia,SAU,Germany,DEU,31,11,19,13,74
2017,Serbia and Kosovo: S/RES/1244 (1999),SRB,Germany,DEU,5,122,6255,1113,7495
2017,Senegal,SEN,Germany,DEU,33,42,946,402,1423
2017,Sierra Leone,SLE,Germany,DEU,155,185,954,565,1859
2017,Somalia,SOM,Germany,DEU,4814,6187,2287,4172,17460
2017,Spain,ESP,Germany,DEU,0,0,14,21,35
2017,Viet Nam,VNM,Germany,DEU,16,14,614,219,863
2017,Sudan,SDN,Germany,DEU,642,587,743,1426,3398
2017,South Sudan,SSD,Germany,DEU,16,14,22,51,103
2017,Slovakia,SVK,Germany,DEU,0,0,0,5,5
2017,Syrian Arab Rep.,SYR,Germany,DEU,34201,55274,107,7309,96891
2017,United Rep. of Tanzania,TZA,Germany,DEU,24,13,81,38,156
2017,Thailand,THA,Germany,DEU,0,0,5,5,10
2017,Tajikistan,TJK,Germany,DEU,264,134,1406,899,2703
2017,Turkmenistan,TKM,Germany,DEU,5,17,145,67,234
2017,Togo,TGO,Germany,DEU,31,35,490,266,822
2017,Trinidad and Tobago,TTO,Germany,DEU,0,0,5,0,5
2017,Tunisia,TUN,Germany,DEU,11,20,500,337,868
2017,Turkey,TUR,Germany,DEU,3260,233,6602,1654,11749
2017,United Arab Emirates,ARE,Germany,DEU,13,0,0,0,13
2017,Uganda,UGA,Germany,DEU,42,11,216,37,306
2017,Ukraine,UKR,Germany,DEU,109,186,4071,1046,5412
2017,Uruguay,URY,Germany,DEU,0,0,0,5,5
2017,United States of America,USA,Germany,DEU,5,5,12,5,27
2017,Uzbekistan,UZB,Germany,DEU,19,12,44,25,100
2017,Venezuela (Bolivarian Republic of),VEN,Germany,DEU,54,28,127,5,214
2017,Yemen,YEM,Germany,DEU,176,703,13,161,1053
2017,Zambia,ZMB,Germany,DEU,0,0,5,0,5
2017,Zimbabwe,ZWE,Germany,DEU,98,13,195,36,342
2017,Stateless,XXA,Germany,DEU,1374,1188,728,401,3691
2018,Afghanistan,AFG,Germany,DEU,1994,4130,6143,3229,15496
2018,Albania,ALB,Germany,DEU,5,22,1682,355,2064
2018,Algeria,DZA,Germany,DEU,12,20,763,890,1685
2018,Angola,AGO,Germany,DEU,12,32,123,145,312
2018,Egypt,EGY,Germany,DEU,83,28,498,212,821
2018,Argentina,ARG,Germany,DEU,0,0,5,0,5
2018,Armenia,ARM,Germany,DEU,23,126,1896,644,2689
2018,Azerbaijan,AZE,Germany,DEU,134,74,1632,854,2694
2018,Bahrain,BHR,Germany,DEU,10,5,5,0,20
2018,Burundi,BDI,Germany,DEU,10,10,19,0,39
2018,Benin,BEN,Germany,DEU,0,0,82,62,144
2018,Bangladesh,BGD,Germany,DEU,30,17,268,80,395
2018,Bhutan,BTN,Germany,DEU,0,0,5,0,5
2018,Burkina Faso,BFA,Germany,DEU,5,0,82,58,145
2018,Belarus,BLR,Germany,DEU,0,5,73,144,222
2018,Botswana,BWA,Germany,DEU,0,0,5,0,5
2018,Brazil,BRA,Germany,DEU,0,0,15,0,15
2018,Bosnia and Herzegovina,BIH,Germany,DEU,0,5,346,68,419
2018,Bulgaria,BGR,Germany,DEU,0,0,5,5,10
2018,Cambodia,KHM,Germany,DEU,0,0,15,5,20
2018,Canada,CAN,Germany,DEU,0,0,5,0,5
2018,Central African Rep.,CAF,Germany,DEU,0,0,17,10,27
2018,Chad,TCD,Germany,DEU,0,5,37,69,111
2018,China,CHN,Germany,DEU,65,5,211,177,458
2018,Cameroon,CMR,Germany,DEU,44,64,926,431,1465
2018,Congo,COG,Germany,DEU,5,0,25,11,41
2018,Dem. Rep. of the Congo,COD,Germany,DEU,40,31,166,43,280
2018,Comoros,COM,Germany,DEU,0,0,5,5,10
2018,Colombia,COL,Germany,DEU,0,5,117,5,127
2018,Cuba,CUB,Germany,DEU,0,0,62,25,87
2018,Djibouti,DJI,Germany,DEU,5,0,5,5,15
2018,Dominican Rep.,DOM,Germany,DEU,0,0,5,0,5
2018,Equatorial Guinea,GNQ,Germany,DEU,0,0,5,0,5
2018,Eritrea,ERI,Germany,DEU,2218,2969,332,1676,7195
2018,Ethiopia,ETH,Germany,DEU,201,198,1044,338,1781
2018,Gabon,GAB,Germany,DEU,0,5,19,5,29
2018,Gambia,GMB,Germany,DEU,122,139,2476,1116,3853
2018,Georgia,GEO,Germany,DEU,10,50,4021,491,4572
2018,Ghana,GHA,Germany,DEU,13,44,717,317,1091
2018,Guinea-Bissau,GNB,Germany,DEU,5,10,99,140,254
2018,Guinea,GIN,Germany,DEU,321,254,1860,1112,3547
2018,Haiti,HTI,Germany,DEU,0,0,5,0,5
2018,Honduras,HND,Germany,DEU,0,14,0,0,14
2018,Croatia,HRV,Germany,DEU,0,0,5,0,5
2018,Hungary,HUN,Germany,DEU,0,0,0,5,5
2018,Cote d'Ivoire,CIV,Germany,DEU,47,80,809,312,1248
2018,India,IND,Germany,DEU,11,12,739,210,972
2018,Indonesia,IDN,Germany,DEU,0,0,0,13,13
2018,Iran (Islamic Rep. of),IRN,Germany,DEU,2315,226,5023,2841,10405
2018,Iraq,IRQ,Germany,DEU,4249,2022,7364,4273,17908
2018,Israel,ISR,Germany,DEU,0,0,22,0,22
2018,Italy,ITA,Germany,DEU,0,0,20,5,25
2018,Jamaica,JAM,Germany,DEU,14,0,13,5,32
2018,Jordan,JOR,Germany,DEU,13,20,109,78,220
2018,Kazakhstan,KAZ,Germany,DEU,5,0,39,25,69
2018,Kenya,KEN,Germany,DEU,0,5,198,126,329
2018,Kyrgyzstan,KGZ,Germany,DEU,5,13,106,23,147
2018,Rep. of Korea,KOR,Germany,DEU,0,0,13,0,13
2018,Dem. People's Rep. of Korea,PRK,Germany,DEU,0,0,13,5,18
2018,Kuwait,KWT,Germany,DEU,0,0,10,21,31
2018,Liberia,LBR,Germany,DEU,12,18,134,94,258
2018,Libya,LBY,Germany,DEU,77,121,428,580,1206
2018,Lebanon,LBN,Germany,DEU,17,48,626,221,912
2018,Sri Lanka,LKA,Germany,DEU,46,25,366,128,565
2018,Latvia,LVA,Germany,DEU,0,0,5,0,5
2018,Madagascar,MDG,Germany,DEU,0,0,5,0,5
2018,Mauritania,MRT,Germany,DEU,10,0,20,16,46
2018,North Macedonia,MKD,Germany,DEU,0,12,1160,166,1338
2018,Rep. of Moldova,MDA,Germany,DEU,5,12,1495,84,1596
2018,Mali,MLI,Germany,DEU,12,26,240,202,480
2018,Malaysia,MYS,Germany,DEU,5,0,10,0,15
2018,Malawi,MWI,Germany,DEU,0,0,5,0,5
2018,Mongolia,MNG,Germany,DEU,5,16,161,51,233
2018,Morocco,MAR,Germany,DEU,29,39,814,558,1440
2018,Mozambique,MOZ,Germany,DEU,0,5,16,11,32
2018,Montenegro,MNE,Germany,DEU,0,0,160,12,172
2018,Myanmar,MMR,Germany,DEU,43,0,19,18,80
2018,Namibia,NAM,Germany,DEU,0,0,5,5,10
2018,Nepal,NPL,Germany,DEU,0,10,32,15,57
2018,Netherlands,NLD,Germany,DEU,0,0,5,0,5
2018,Niger,NER,Germany,DEU,0,10,55,52,117
2018,Nicaragua,NIC,Germany,DEU,0,0,5,5,10
2018,Nigeria,NGA,Germany,DEU,752,945,5672,4595,11964
2018,Pakistan,PAK,Germany,DEU,117,73,2479,844,3513
2018,Philippines,PHL,Germany,DEU,0,10,20,5,35
2018,Poland,POL,Germany,DEU,0,0,5,0,5
2018,Portugal,PRT,Germany,DEU,0,0,0,5,5
2018,South Africa,ZAF,Germany,DEU,0,0,14,10,24
2018,Russian Federation,RUS,Germany,DEU,548,199,3737,1818,6302
2018,Rwanda,RWA,Germany,DEU,29,5,45,12,91
2018,El Salvador,SLV,Germany,DEU,0,5,15,0,20
2018,Saudi Arabia,SAU,Germany,DEU,13,5,14,5,37
2018,Serbia and Kosovo: S/RES/1244 (1999),SRB,Germany,DEU,0,33,1705,320,2058
2018,Senegal,SEN,Germany,DEU,5,5,172,168,350
2018,Sierra Leone,SLE,Germany,DEU,51,60,560,166,837
2018,Somalia,SOM,Germany,DEU,1853,1262,1687,2276,7078
2018,Spain,ESP,Germany,DEU,0,0,25,5,30
2018,Viet Nam,VNM,Germany,DEU,5,10,490,74,579
2018,Sudan,SDN,Germany,DEU,226,215,431,666,1538
2018,South Sudan,SSD,Germany,DEU,5,15,37,26,83
2018,Syrian Arab Rep.,SYR,Germany,DEU,17503,17451,47,6855,41856
2018,United Rep. of Tanzania,TZA,Germany,DEU,0,5,56,33,94
2018,Thailand,THA,Germany,DEU,5,0,5,0,10
2018,Tajikistan,TJK,Germany,DEU,68,30,530,261,889
2018,Turkmenistan,TKM,Germany,DEU,12,10,59,5,86
2018,Togo,TGO,Germany,DEU,14,18,359,170,561
2018,Trinidad and Tobago,TTO,Germany,DEU,5,0,0,0,5
2018,Tunisia,TUN,Germany,DEU,10,10,322,361,703
2018,Turkey,TUR,Germany,DEU,3644,92,4090,793,8619
2018,Uganda,UGA,Germany,DEU,32,5,51,31,119
2018,Ukraine,UKR,Germany,DEU,20,53,1107,181,1361
2018,United States of America,USA,Germany,DEU,5,0,18,5,28
2018,Uzbekistan,UZB,Germany,DEU,0,5,42,10,57
2018,Venezuela (Bolivarian Republic of),VEN,Germany,DEU,66,27,189,12,294
2018,Yemen,YEM,Germany,DEU,75,504,15,213,807
2018,Zambia,ZMB,Germany,DEU,0,0,5,5,10
2018,Zimbabwe,ZWE,Germany,DEU,25,5,91,17,138
2018,Stateless,XXA,Germany,DEU,687,217,216,282,1402
2019,Afghanistan,AFG,Germany,DEU,1619,2363,2543,3096,9621
2019,Albania,ALB,Germany,DEU,5,13,1410,243,1671
2019,Algeria,DZA,Germany,DEU,5,22,573,548,1148
2019,Angola,AGO,Germany,DEU,5,26,96,201,328
2019,Egypt,EGY,Germany,DEU,91,12,340,197,640
2019,Argentina,ARG,Germany,DEU,0,0,14,0,14
2019,Armenia,ARM,Germany,DEU,5,58,856,365,1284
2019,Azerbaijan,AZE,Germany,DEU,58,24,1090,510,1682
2019,Bahrain,BHR,Germany,DEU,5,0,0,0,5
2019,Burundi,BDI,Germany,DEU,10,0,0,5,15
2019,Benin,BEN,Germany,DEU,5,5,46,58,114
2019,Bangladesh,BGD,Germany,DEU,18,5,127,40,190
2019,Burkina Faso,BFA,Germany,DEU,5,5,61,55,126
2019,Belarus,BLR,Germany,DEU,5,0,51,225,281
2019,Brazil,BRA,Germany,DEU,0,0,19,0,19
2019,Bosnia and Herzegovina,BIH,Germany,DEU,0,5,251,45,301
2019,Bulgaria,BGR,Germany,DEU,0,0,5,0,5
2019,Cambodia,KHM,Germany,DEU,0,5,26,0,31
2019,Canada,CAN,Germany,DEU,0,0,5,0,5
2019,Central African Rep.,CAF,Germany,DEU,0,0,5,14,19
2019,Chad,TCD,Germany,DEU,5,0,19,30,54
2019,China,CHN,Germany,DEU,157,5,199,483,844
2019,Cameroon,CMR,Germany,DEU,34,30,613,284,961
2019,Congo,COG,Germany,DEU,5,0,17,18,40
2019,Dem. Rep. of the Congo,COD,Germany,DEU,14,26,135,59,234
2019,Comoros,COM,Germany,DEU,0,0,5,0,5
2019,Colombia,COL,Germany,DEU,5,0,233,5,243
2019,Cuba,CUB,Germany,DEU,0,0,25,14,39
2019,Djibouti,DJI,Germany,DEU,0,0,5,0,5
2019,Dominican Rep.,DOM,Germany,DEU,0,0,5,5,10
2019,Ecuador,ECU,Germany,DEU,0,0,5,0,5
2019,Equatorial Guinea,GNQ,Germany,DEU,0,0,5,0,5
2019,Eritrea,ERI,Germany,DEU,2115,1141,362,633,4251
2019,Ethiopia,ETH,Germany,DEU,147,85,628,250,1110
2019,France,FRA,Germany,DEU,0,0,5,0,5
2019,Gabon,GAB,Germany,DEU,0,5,10,16,31
2019,Gambia,GMB,Germany,DEU,39,29,619,640,1327
2019,United Kingdom of Great Britain and Northern Ireland,GBR,Germany,DEU,0,0,5,0,5
2019,Georgia,GEO,Germany,DEU,5,16,2737,462,3220
2019,Ghana,GHA,Germany,DEU,5,16,501,421,943
2019,Guinea-Bissau,GNB,Germany,DEU,0,5,70,109,184
2019,Guatemala,GTM,Germany,DEU,0,0,10,0,10
2019,Guinea,GIN,Germany,DEU,353,183,1582,888,3006
2019,Haiti,HTI,Germany,DEU,0,0,5,0,5
2019,Honduras,HND,Germany,DEU,5,0,29,0,34
2019,Croatia,HRV,Germany,DEU,0,0,5,0,5
2019,Cote d'Ivoire,CIV,Germany,DEU,27,28,470,266,791
2019,India,IND,Germany,DEU,5,5,435,201,646
2019,Indonesia,IDN,Germany,DEU,0,0,10,0,10
2019,Iran (Islamic Rep. of),IRN,Germany,DEU,1753,158,5161,2200,9272
2019,Iraq,IRQ,Germany,DEU,4558,1452,5533,4225,15768
2019,Israel,ISR,Germany,DEU,0,0,5,5,10
2019,Italy,ITA,Germany,DEU,0,0,14,5,19
2019,Jamaica,JAM,Germany,DEU,10,0,14,5,29
2019,Jordan,JOR,Germany,DEU,5,10,115,121,251
2019,Kazakhstan,KAZ,Germany,DEU,0,0,63,32,95
2019,Kenya,KEN,Germany,DEU,0,5,140,88,233
2019,Kyrgyzstan,KGZ,Germany,DEU,5,10,57,18,90
2019,Rep. of Korea,KOR,Germany,DEU,0,0,12,0,12
2019,Dem. People's Rep. of Korea,PRK,Germany,DEU,0,0,5,0,5
2019,Kuwait,KWT,Germany,DEU,0,0,5,14,19
2019,Liberia,LBR,Germany,DEU,5,11,85,51,152
2019,Libya,LBY,Germany,DEU,54,110,274,261,699
2019,Lebanon,LBN,Germany,DEU,18,19,424,285,746
2019,Sri Lanka,LKA,Germany,DEU,37,14,172,74,297
2019,Lithuania,LTU,Germany,DEU,0,0,5,0,5
2019,Latvia,LVA,Germany,DEU,0,0,5,0,5
2019,Madagascar,MDG,Germany,DEU,0,0,5,5,10
2019,Mauritania,MRT,Germany,DEU,0,0,13,19,32
2019,North Macedonia,MKD,Germany,DEU,0,5,969,205,1179
2019,Rep. of Moldova,MDA,Germany,DEU,0,13,1300,263,1576
2019,Mexico,MEX,Germany,DEU,0,0,0,5,5
2019,Mali,MLI,Germany,DEU,19,24,121,157,321
2019,Malaysia,MYS,Germany,DEU,0,0,5,0,5
2019,Malawi,MWI,Germany,DEU,0,5,0,0,5
2019,Mongolia,MNG,Germany,DEU,5,16,86,48,155
2019,Morocco,MAR,Germany,DEU,10,27,590,403,1030
2019,Mozambique,MOZ,Germany,DEU,0,0,0,5,5
2019,Montenegro,MNE,Germany,DEU,0,0,83,18,101
2019,Mauritius,MUS,Germany,DEU,0,0,5,0,5
2019,Myanmar,MMR,Germany,DEU,28,5,40,20,93
2019,Namibia,NAM,Germany,DEU,0,0,13,0,13
2019,Nepal,NPL,Germany,DEU,0,5,10,5,20
2019,Netherlands,NLD,Germany,DEU,0,0,5,0,5
2019,Niger,NER,Germany,DEU,0,0,38,45,83
2019,Nicaragua,NIC,Germany,DEU,5,0,75,5,85
2019,Nigeria,NGA,Germany,DEU,429,437,5337,5650,11853
2019,Pakistan,PAK,Germany,DEU,154,28,1368,816,2366
2019,Peru,PER,Germany,DEU,0,5,5,0,10
2019,Philippines,PHL,Germany,DEU,0,0,12,0,12
2019,Poland,POL,Germany,DEU,0,0,10,0,10
2019,Romania,ROU,Germany,DEU,0,0,5,0,5
2019,South Africa,ZAF,Germany,DEU,0,0,22,13,35
2019,Russian Federation,RUS,Germany,DEU,210,67,2087,1567,3931
2019,Rwanda,RWA,Germany,DEU,27,0,36,26,89
2019,El Salvador,SLV,Germany,DEU,0,44,5,0,49
2019,Saudi Arabia,SAU,Germany,DEU,22,0,5,5,32
2019,Serbia and Kosovo: S/RES/1244 (1999),SRB,Germany,DEU,0,5,1269,301,1575
2019,Senegal,SEN,Germany,DEU,10,0,139,174,323
2019,Sierra Leone,SLE,Germany,DEU,31,31,215,88,365
2019,Somalia,SOM,Germany,DEU,1604,501,959,1445,4509
2019,Spain,ESP,Germany,DEU,0,0,5,0,5
2019,Viet Nam,VNM,Germany,DEU,0,5,679,124,808
2019,Sudan,SDN,Germany,DEU,74,31,295,309,709
2019,South Sudan,SSD,Germany,DEU,5,0,15,10,30
2019,Eswatini,SWZ,Germany,DEU,0,0,5,0,5
2019,Sweden,SWE,Germany,DEU,0,0,5,0,5
2019,Syrian Arab Rep.,SYR,Germany,DEU,22158,15486,39,6340,44023
2019,United Rep. of Tanzania,TZA,Germany,DEU,5,0,64,120,189
2019,Tajikistan,TJK,Germany,DEU,59,29,249,134,471
2019,Turkmenistan,TKM,Germany,DEU,0,0,52,5,57
2019,Togo,TGO,Germany,DEU,14,10,172,120,316
2019,Tunisia,TUN,Germany,DEU,5,0,294,235,534
2019,Turkey,TUR,Germany,DEU,4809,62,4251,658,9780
2019,Uganda,UGA,Germany,DEU,21,5,85,12,123
2019,Ukraine,UKR,Germany,DEU,10,41,808,240,1099
2019,United States of America,USA,Germany,DEU,0,0,11,5,16
2019,Uzbekistan,UZB,Germany,DEU,15,5,5,29,54
2019,Venezuela (Bolivarian Republic of),VEN,Germany,DEU,67,53,142,14,276
2019,Yemen,YEM,Germany,DEU,100,611,18,158,887
2019,Zambia,ZMB,Germany,DEU,0,0,5,0,5
2019,Zimbabwe,ZWE,Germany,DEU,5,0,46,45,96
2019,Stateless,XXA,Germany,DEU,536,73,66,128,803
2020,Afghanistan,AFG,Germany,DEU,1877,2079,1958,2638,8552
2020,Albania,ALB,Germany,DEU,5,5,185,820,1015
2020,Algeria,DZA,Germany,DEU,13,10,620,535,1178
2020,Angola,AGO,Germany,DEU,5,33,81,161,280
2020,Egypt,EGY,Germany,DEU,83,19,105,354,561
2020,Argentina,ARG,Germany,DEU,0,0,0,11,11
2020,Armenia,ARM,Germany,DEU,10,26,122,588,746
2020,Austria,AUT,Germany,DEU,0,0,5,0,5
2020,Azerbaijan,AZE,Germany,DEU,59,12,136,726,933
2020,Bahrain,BHR,Germany,DEU,5,0,0,0,5
2020,Burundi,BDI,Germany,DEU,0,0,0,14,14
2020,Belgium,BEL,Germany,DEU,0,0,0,5,5
2020,Benin,BEN,Germany,DEU,0,5,33,56,94
2020,Bangladesh,BGD,Germany,DEU,15,0,39,120,174
2020,Burkina Faso,BFA,Germany,DEU,10,5,23,56,94
2020,Belarus,BLR,Germany,DEU,5,0,88,25,118
2020,Brazil,BRA,Germany,DEU,5,0,5,24,34
2020,Bosnia and Herzegovina,BIH,Germany,DEU,0,5,41,138,184
2020,Bulgaria,BGR,Germany,DEU,0,0,5,5,10
2020,Cambodia,KHM,Germany,DEU,0,0,0,10,10
2020,Canada,CAN,Germany,DEU,0,0,0,5,5
2020,Chad,TCD,Germany,DEU,5,0,25,51,81
2020,China,CHN,Germany,DEU,138,0,118,188,444
2020,Chile,CHL,Germany,DEU,0,0,0,5,5
2020,Cameroon,CMR,Germany,DEU,29,13,124,622,788
2020,Congo,COG,Germany,DEU,5,0,10,22,37
2020,Dem. Rep. of the Congo,COD,Germany,DEU,5,23,35,118,181
2020,Colombia,COL,Germany,DEU,0,0,11,509,520
2020,Costa Rica,CRI,Germany,DEU,0,0,0,5,5
2020,Cuba,CUB,Germany,DEU,0,0,5,35,40
2020,Djibouti,DJI,Germany,DEU,5,0,0,5,10
2020,Dominican Rep.,DOM,Germany,DEU,0,0,0,5,5
2020,Equatorial Guinea,GNQ,Germany,DEU,5,0,0,0,5
2020,Eritrea,ERI,Germany,DEU,2715,188,238,299,3440
2020,Ethiopia,ETH,Germany,DEU,153,82,88,470,793
2020,Gabon,GAB,Germany,DEU,0,0,0,12,12
2020,Gambia,GMB,Germany,DEU,58,16,347,413,834
2020,Palestinian,PSE,Germany,DEU,48,5,54,111,218
2020,United Kingdom of Great Britain and Northern Ireland,GBR,Germany,DEU,0,0,0,10,10
2020,Georgia,GEO,Germany,DEU,5,18,520,1709,2252
2020,Ghana,GHA,Germany,DEU,10,12,152,443,617
2020,Guinea-Bissau,GNB,Germany,DEU,0,0,32,42,74
2020,Guatemala,GTM,Germany,DEU,0,0,0,5,5
2020,Guinea,GIN,Germany,DEU,393,88,338,1084,1903
2020,Haiti,HTI,Germany,DEU,0,0,0,13,13
2020,Honduras,HND,Germany,DEU,5,0,5,35,45
2020,Cote d'Ivoire,CIV,Germany,DEU,36,13,107,341,497
2020,India,IND,Germany,DEU,0,5,89,303,397
2020,Iran (Islamic Rep. of),IRN,Germany,DEU,1561,33,725,4458,6777
2020,Iraq,IRQ,Germany,DEU,3785,662,1792,4637,10876
2020,Israel,ISR,Germany,DEU,0,0,0,5,5
2020,Italy,ITA,Germany,DEU,0,0,0,5,5
2020,Jamaica,JAM,Germany,DEU,5,0,0,19,24
2020,Jordan,JOR,Germany,DEU,5,10,49,124,188
2020,Kazakhstan,KAZ,Germany,DEU,0,0,17,92,109
2020,Kenya,KEN,Germany,DEU,5,0,34,283,322
2020,Kyrgyzstan,KGZ,Germany,DEU,32,0,13,75,120
2020,Kuwait,KWT,Germany,DEU,0,0,5,0,5
2020,Liberia,LBR,Germany,DEU,12,5,34,78,129
2020,Libya,LBY,Germany,DEU,242,30,194,242,708
2020,Lebanon,LBN,Germany,DEU,28,18,224,551,821
2020,Sri Lanka,LKA,Germany,DEU,43,13,40,204,300
2020,Lithuania,LTU,Germany,DEU,0,0,0,5,5
2020,Madagascar,MDG,Germany,DEU,0,0,0,5,5
2020,Mauritania,MRT,Germany,DEU,10,0,10,22,42
2020,North Macedonia,MKD,Germany,DEU,0,0,97,365,462
2020,Rep. of Moldova,MDA,Germany,DEU,0,10,495,1069,1574
2020,Mexico,MEX,Germany,DEU,0,0,0,18,18
2020,Mali,MLI,Germany,DEU,26,10,65,106,207
2020,Malaysia,MYS,Germany,DEU,0,0,0,5,5
2020,Malawi,MWI,Germany,DEU,0,0,5,0,5
2020,Mongolia,MNG,Germany,DEU,5,0,27,104,136
2020,Morocco,MAR,Germany,DEU,12,11,374,580,977
2020,Mozambique,MOZ,Germany,DEU,0,13,0,0,13
2020,Montenegro,MNE,Germany,DEU,0,0,10,67,77
2020,Myanmar,MMR,Germany,DEU,22,0,14,302,338
2020,Namibia,NAM,Germany,DEU,0,0,0,28,28
2020,Nepal,NPL,Germany,DEU,0,0,0,5,5
2020,Netherlands,NLD,Germany,DEU,0,0,0,12,12
2020,Niger,NER,Germany,DEU,0,5,15,29,49
2020,Nicaragua,NIC,Germany,DEU,0,0,0,72,72
2020,Nigeria,NGA,Germany,DEU,303,228,1343,3795,5669
2020,Norway,NOR,Germany,DEU,0,0,0,11,11
2020,Oman,OMN,Germany,DEU,0,0,0,5,5
2020,Pakistan,PAK,Germany,DEU,147,30,341,1088,1606
2020,Paraguay,PRY,Germany,DEU,0,0,0,10,10
2020,Peru,PER,Germany,DEU,0,0,0,17,17
2020,Poland,POL,Germany,DEU,0,0,0,5,5
2020,Romania,ROU,Germany,DEU,0,0,0,10,10
2020,South Africa,ZAF,Germany,DEU,0,0,5,16,21
2020,Russian Federation,RUS,Germany,DEU,148,27,959,1750,2884
2020,Rwanda,RWA,Germany,DEU,38,0,10,94,142
2020,El Salvador,SLV,Germany,DEU,33,0,0,15,48
2020,Saudi Arabia,SAU,Germany,DEU,20,0,5,5,30
2020,Serbia and Kosovo: S/RES/1244 (1999),SRB,Germany,DEU,0,5,224,764,993
2020,Senegal,SEN,Germany,DEU,5,0,61,122,188
2020,Sierra Leone,SLE,Germany,DEU,30,16,48,152,246
2020,Somalia,SOM,Germany,DEU,1599,165,760,521,3045
2020,Spain,ESP,Germany,DEU,0,0,0,12,12
2020,Viet Nam,VNM,Germany,DEU,0,5,285,812,1102
2020,Sudan,SDN,Germany,DEU,86,17,96,360,559
2020,South Sudan,SSD,Germany,DEU,12,5,5,19,41
2020,Syrian Arab Rep.,SYR,Germany,DEU,33940,92,3139,28,37199
2020,United Rep. of Tanzania,TZA,Germany,DEU,5,0,17,101,123
2020,Thailand,THA,Germany,DEU,0,5,0,11,16
2020,Tajikistan,TJK,Germany,DEU,67,5,105,298,475
2020,Turkmenistan,TKM,Germany,DEU,0,0,11,13,24
2020,Togo,TGO,Germany,DEU,0,5,57,138,200
2020,Trinidad and Tobago,TTO,Germany,DEU,0,0,0,5,5
2020,Tunisia,TUN,Germany,DEU,10,0,203,304,517
2020,Turkey,TUR,Germany,DEU,4162,27,577,4492,9258
2020,Uganda,UGA,Germany,DEU,10,0,12,73,95
2020,Ukraine,UKR,Germany,DEU,5,27,143,630,805
2020,United States of America,USA,Germany,DEU,0,5,0,10,15
2020,Uzbekistan,UZB,Germany,DEU,5,0,5,14,24
2020,Venezuela (Bolivarian Republic of),VEN,Germany,DEU,127,360,14,633,1134
2020,Yemen,YEM,Germany,DEU,373,23,56,120,572
2020,Zambia,ZMB,Germany,DEU,0,0,0,5,5
2020,Zimbabwe,ZWE,Germany,DEU,10,5,15,75,105
2020,Stateless,XXA,Germany,DEU,254,0,43,44,341
2014,Albania,ALB,Luxembourg,LUX,0,0,0,17,17
2014,Serbia and Kosovo: S/RES/1244 (1999),SRB,Luxembourg,LUX,0,0,0,17,17
2015,Albania,ALB,Luxembourg,LUX,0,0,0,16,16
2015,Montenegro,MNE,Luxembourg,LUX,0,0,0,5,5
2015,Serbia and Kosovo: S/RES/1244 (1999),SRB,Luxembourg,LUX,0,0,0,30,30
2016,Albania,ALB,Luxembourg,LUX,0,0,0,11,11
2016,Azerbaijan,AZE,Luxembourg,LUX,0,0,0,5,5
2016,Serbia and Kosovo: S/RES/1244 (1999),SRB,Luxembourg,LUX,0,0,0,5,5
2017,Afghanistan,AFG,Finland,FIN,5,0,42,65,112
2017,Albania,ALB,Finland,FIN,0,0,0,5,5
2017,Algeria,DZA,Finland,FIN,0,0,0,5,5
2017,Bangladesh,BGD,Finland,FIN,0,0,0,5,5
2017,Cameroon,CMR,Finland,FIN,0,0,13,0,13
2017,Ethiopia,ETH,Finland,FIN,5,0,0,0,5
2017,Gambia,GMB,Finland,FIN,0,0,0,5,5
2017,Iran (Islamic Rep. of),IRN,Finland,FIN,0,0,0,12,12
2017,Iraq,IRQ,Finland,FIN,15,0,164,277,456
2017,Morocco,MAR,Finland,FIN,0,0,5,0,5
2017,Nigeria,NGA,Finland,FIN,0,0,5,14,19
2017,Russian Federation,RUS,Finland,FIN,0,0,0,11,11
2017,Serbia and Kosovo: S/RES/1244 (1999),SRB,Finland,FIN,0,0,0,5,5
2017,Somalia,SOM,Finland,FIN,0,0,5,24,29
2017,Syrian Arab Rep.,SYR,Finland,FIN,0,5,0,0,5
2017,Turkey,TUR,Finland,FIN,0,0,5,5,10
2017,Ukraine,UKR,Finland,FIN,0,0,0,5,5
2017,Stateless,XXA,Finland,FIN,0,0,5,0,5
2019,Afghanistan,AFG,Finland,FIN,38,13,154,98,303
2019,Albania,ALB,Finland,FIN,0,0,0,5,5
2019,Algeria,DZA,Finland,FIN,0,0,0,12,12
2019,Egypt,EGY,Finland,FIN,0,0,5,0,5
2019,Azerbaijan,AZE,Finland,FIN,0,0,0,5,5
2019,Bangladesh,BGD,Finland,FIN,0,0,0,5,5
2019,Belarus,BLR,Finland,FIN,0,0,0,5,5
2019,Cameroon,CMR,Finland,FIN,5,0,12,5,22
2019,Dem. Rep. of the Congo,COD,Finland,FIN,0,0,5,0,5
2019,Ethiopia,ETH,Finland,FIN,0,0,5,5,10
2019,Gambia,GMB,Finland,FIN,0,0,5,0,5
2019,Georgia,GEO,Finland,FIN,0,0,5,5,10
2019,Iran (Islamic Rep. of),IRN,Finland,FIN,10,0,45,28,83
2019,Iraq,IRQ,Finland,FIN,184,33,850,507,1574
2019,Jordan,JOR,Finland,FIN,0,0,5,0,5
2019,Lebanon,LBN,Finland,FIN,0,0,0,5,5
2019,Sri Lanka,LKA,Finland,FIN,0,0,5,0,5
2019,Morocco,MAR,Finland,FIN,0,0,0,10,10
2019,Nigeria,NGA,Finland,FIN,0,0,11,5,16
2019,Pakistan,PAK,Finland,FIN,0,0,13,0,13
2019,Russian Federation,RUS,Finland,FIN,10,0,19,5,34
2019,Sierra Leone,SLE,Finland,FIN,0,0,5,0,5
2019,Somalia,SOM,Finland,FIN,22,0,92,216,330
2019,Syrian Arab Rep.,SYR,Finland,FIN,0,0,0,5,5
2019,Turkey,TUR,Finland,FIN,11,0,13,5,29
2019,Ukraine,UKR,Finland,FIN,0,0,0,11,11
2019,Stateless,XXA,Finland,FIN,0,0,0,10,10
2001,Afghanistan,AFG,France,FRA,10,0,0,0,10
2001,Albania,ALB,France,FRA,42,0,0,0,42
2001,Algeria,DZA,France,FRA,113,0,0,0,113
2001,Angola,AGO,France,FRA,47,0,0,0,47
2001,Armenia,ARM,France,FRA,64,0,0,0,64
2001,Azerbaijan,AZE,France,FRA,49,0,0,0,49
2001,Burundi,BDI,France,FRA,5,0,0,0,5
2001,Bangladesh,BGD,France,FRA,126,0,0,0,126
2001,Belarus,BLR,France,FRA,10,0,0,0,10
2001,Bosnia and Herzegovina,BIH,France,FRA,34,0,0,0,34
2001,Bulgaria,BGR,France,FRA,5,0,0,0,5
2001,Central African Rep.,CAF,France,FRA,15,0,0,0,15
2001,China,CHN,France,FRA,10,0,0,0,10
2001,Cameroon,CMR,France,FRA,5,0,0,0,5
2001,Congo,COG,France,FRA,99,0,0,0,99
2001,Dem. Rep. of the Congo,COD,France,FRA,135,0,0,0,135
2001,Colombia,COL,France,FRA,5,0,0,0,5
2001,Ethiopia,ETH,France,FRA,5,0,0,0,5
2001,Georgia,GEO,France,FRA,56,0,0,0,56
2001,Guinea-Bissau,GNB,France,FRA,5,0,0,0,5
2001,Guinea,GIN,France,FRA,18,0,0,0,18
2001,Haiti,HTI,France,FRA,113,0,0,0,113
2001,Croatia,HRV,France,FRA,5,0,0,0,5
2001,India,IND,France,FRA,26,0,0,0,26
2001,Iran (Islamic Rep. of),IRN,France,FRA,14,0,0,0,14
2001,Iraq,IRQ,France,FRA,64,0,0,0,64
2001,Kazakhstan,KAZ,France,FRA,17,0,0,0,17
2001,Lebanon,LBN,France,FRA,5,0,0,0,5
2001,Sri Lanka,LKA,France,FRA,298,0,0,0,298
2001,Mauritania,MRT,France,FRA,113,0,0,0,113
2001,Rep. of Moldova,MDA,France,FRA,23,0,0,0,23
2001,Mali,MLI,France,FRA,12,0,0,0,12
2001,Myanmar,MMR,France,FRA,5,0,0,0,5
2001,Nigeria,NGA,France,FRA,10,0,0,0,10
2001,Pakistan,PAK,France,FRA,15,0,0,0,15
2001,Romania,ROU,France,FRA,5,0,0,0,5
2001,Russian Federation,RUS,France,FRA,95,0,0,0,95
2001,Rwanda,RWA,France,FRA,21,0,0,0,21
2001,Serbia and Kosovo: S/RES/1244 (1999),SRB,France,FRA,149,0,0,0,149
2001,Senegal,SEN,France,FRA,14,0,0,0,14
2001,Sierra Leone,SLE,France,FRA,11,0,0,0,11
2001,Somalia,SOM,France,FRA,10,0,0,0,10
2001,Viet Nam,VNM,France,FRA,5,0,0,0,5
2001,Sudan,SDN,France,FRA,5,0,0,0,5
2001,Slovakia,SVK,France,FRA,10,0,0,0,10
2001,Syrian Arab Rep.,SYR,France,FRA,10,0,0,0,10
2001,Togo,TGO,France,FRA,5,0,0,0,5
2001,Tunisia,TUN,France,FRA,5,0,0,0,5
2001,Turkey,TUR,France,FRA,272,0,0,0,272
2001,Ukraine,UKR,France,FRA,52,0,0,0,52
2001,Uzbekistan,UZB,France,FRA,5,0,0,0,5
2001,Afghanistan,AFG,Germany,DEU,4576,670,34,1006,6286
2001,Albania,ALB,Germany,DEU,0,0,5,143,148
2001,Algeria,DZA,Germany,DEU,0,0,16,369,385
2001,Angola,AGO,Germany,DEU,0,0,5,52,57
2001,Egypt,EGY,Germany,DEU,0,0,5,26,31
2001,Armenia,ARM,Germany,DEU,5,0,11,324,340
2001,Azerbaijan,AZE,Germany,DEU,5,0,12,175,192
2001,Burundi,BDI,Germany,DEU,0,0,0,5,5
2001,Benin,BEN,Germany,DEU,0,0,0,5,5
2001,Bangladesh,BGD,Germany,DEU,0,0,5,88,93
2001,Bhutan,BTN,Germany,DEU,0,0,0,5,5
2001,Burkina Faso,BFA,Germany,DEU,0,0,0,14,14
2001,Belarus,BLR,Germany,DEU,0,0,5,47,52
2001,Bosnia and Herzegovina,BIH,Germany,DEU,0,5,40,676,721
2001,Bulgaria,BGR,Germany,DEU,0,0,0,32,32
2001,China,CHN,Germany,DEU,0,0,10,77,87
2001,Cameroon,CMR,Germany,DEU,0,0,5,44,49
2001,Congo,COG,Germany,DEU,0,0,0,5,5
2001,Dem. Rep. of the Congo,COD,Germany,DEU,10,17,14,221,262
2001,Colombia,COL,Germany,DEU,0,0,0,5,5
2001,Cuba,CUB,Germany,DEU,0,0,0,5,5
2001,Czechia,CZE,Germany,DEU,0,0,0,29,29
2001,Ecuador,ECU,Germany,DEU,0,0,0,5,5
2001,Eritrea,ERI,Germany,DEU,0,0,0,23,23
2001,Estonia,EST,Germany,DEU,0,0,0,5,5
2001,Ethiopia,ETH,Germany,DEU,5,5,5,46,61
2001,Gambia,GMB,Germany,DEU,0,0,0,12,12
2001,Georgia,GEO,Germany,DEU,0,0,21,262,283
2001,Ghana,GHA,Germany,DEU,0,0,5,81,86
2001,Guinea,GIN,Germany,DEU,0,0,0,51,51
2001,Croatia,HRV,Germany,DEU,0,0,5,111,116
2001,Hungary,HUN,Germany,DEU,0,0,0,5,5
2001,Cote d'Ivoire,CIV,Germany,DEU,0,0,0,21,21
2001,India,IND,Germany,DEU,5,0,18,327,350
2001,Iran (Islamic Rep. of),IRN,Germany,DEU,61,5,85,708,859
2001,Iraq,IRQ,Germany,DEU,20,10,12,427,469
2001,Jordan,JOR,Germany,DEU,0,0,0,33,33
2001,Kazakhstan,KAZ,Germany,DEU,0,0,0,16,16
2001,Kenya,KEN,Germany,DEU,0,0,0,5,5
2001,Kyrgyzstan,KGZ,Germany,DEU,0,0,0,10,10
2001,Dem. People's Rep. of Korea,PRK,Germany,DEU,0,0,0,19,19
2001,Liberia,LBR,Germany,DEU,0,0,0,20,20
2001,Libya,LBY,Germany,DEU,0,0,0,10,10
2001,Lebanon,LBN,Germany,DEU,0,0,31,148,179
2001,Sri Lanka,LKA,Germany,DEU,5,10,16,472,503
2001,Lithuania,LTU,Germany,DEU,0,0,0,18,18
2001,Latvia,LVA,Germany,DEU,0,0,0,5,5
2001,North Macedonia,MKD,Germany,DEU,0,0,62,855,917
2001,Rep. of Moldova,MDA,Germany,DEU,0,0,5,62,67
2001,Mongolia,MNG,Germany,DEU,0,0,0,35,35
2001,Morocco,MAR,Germany,DEU,0,0,5,37,42
2001,Nepal,NPL,Germany,DEU,0,0,0,35,35
2001,Niger,NER,Germany,DEU,0,0,0,14,14
2001,Nigeria,NGA,Germany,DEU,0,5,5,81,91
2001,Pakistan,PAK,Germany,DEU,23,10,16,581,630
2001,Peru,PER,Germany,DEU,0,0,0,5,5
2001,Poland,POL,Germany,DEU,0,0,32,60,92
2001,Romania,ROU,Germany,DEU,5,0,5,77,87
2001,Russian Federation,RUS,Germany,DEU,5,0,12,249,266
2001,Rwanda,RWA,Germany,DEU,0,0,0,5,5
2001,Serbia and Kosovo: S/RES/1244 (1999),SRB,Germany,DEU,5,110,130,6307,6552
2001,Senegal,SEN,Germany,DEU,0,0,0,5,5
2001,Sierra Leone,SLE,Germany,DEU,0,0,10,54,64
2001,Somalia,SOM,Germany,DEU,0,12,0,5,17
2001,Viet Nam,VNM,Germany,DEU,5,5,23,404,437
2001,Sudan,SDN,Germany,DEU,0,0,0,38,38
2001,Slovakia,SVK,Germany,DEU,0,0,0,93,93
2001,Slovenia,SVN,Germany,DEU,0,0,0,11,11
2001,Syrian Arab Rep.,SYR,Germany,DEU,14,12,20,335,381
2001,Tajikistan,TJK,Germany,DEU,0,0,0,10,10
2001,Togo,TGO,Germany,DEU,20,0,41,253,314
2001,Tunisia,TUN,Germany,DEU,0,0,0,41,41
2001,Turkey,TUR,Germany,DEU,387,92,347,4009,4835
2001,Uganda,UGA,Germany,DEU,0,0,0,12,12
2001,Ukraine,UKR,Germany,DEU,5,0,12,104,121
2001,Uzbekistan,UZB,Germany,DEU,0,0,0,13,13
2001,Yemen,YEM,Germany,DEU,0,0,0,5,5
2001,Stateless,XXA,Germany,DEU,0,0,0,21,21
2002,Afghanistan,AFG,France,FRA,5,0,0,0,5
2002,Albania,ALB,France,FRA,76,0,0,0,76
2002,Algeria,DZA,France,FRA,102,0,0,0,102
2002,Angola,AGO,France,FRA,35,0,0,0,35
2002,Armenia,ARM,France,FRA,56,0,0,0,56
2002,Azerbaijan,AZE,France,FRA,61,0,0,0,61
2002,Bangladesh,BGD,France,FRA,75,0,0,0,75
2002,Belarus,BLR,France,FRA,5,0,0,0,5
2002,Bosnia and Herzegovina,BIH,France,FRA,22,0,0,0,22
2002,Cambodia,KHM,France,FRA,5,0,0,0,5
2002,Central African Rep.,CAF,France,FRA,10,0,0,0,10
2002,Chad,TCD,France,FRA,5,0,0,0,5
2002,China,CHN,France,FRA,10,0,0,0,10
2002,Cameroon,CMR,France,FRA,10,0,0,0,10
2002,Congo,COG,France,FRA,80,0,0,0,80
2002,Dem. Rep. of the Congo,COD,France,FRA,178,0,0,0,178
2002,Ecuador,ECU,France,FRA,5,0,0,0,5
2002,Georgia,GEO,France,FRA,56,0,0,0,56
2002,Guinea,GIN,France,FRA,35,0,0,0,35
2002,Haiti,HTI,France,FRA,130,0,0,0,130
2002,Cote d'Ivoire,CIV,France,FRA,5,0,0,0,5
2002,India,IND,France,FRA,20,0,0,0,20
2002,Iran (Islamic Rep. of),IRN,France,FRA,34,0,0,0,34
2002,Iraq,IRQ,France,FRA,42,0,0,0,42
2002,Kazakhstan,KAZ,France,FRA,16,0,0,0,16
2002,Kyrgyzstan,KGZ,France,FRA,5,0,0,0,5
2002,Lebanon,LBN,France,FRA,5,0,0,0,5
2002,Sri Lanka,LKA,France,FRA,331,0,0,0,331
2002,Mauritania,MRT,France,FRA,107,0,0,0,107
2002,Rep. of Moldova,MDA,France,FRA,15,0,0,0,15
2002,Mali,MLI,France,FRA,5,0,0,0,5
2002,Myanmar,MMR,France,FRA,5,0,0,0,5
2002,Nigeria,NGA,France,FRA,5,0,0,0,5
2002,Pakistan,PAK,France,FRA,5,0,0,0,5
2002,Russian Federation,RUS,France,FRA,119,0,0,0,119
2002,Rwanda,RWA,France,FRA,12,0,0,0,12
2002,Serbia and Kosovo: S/RES/1244 (1999),SRB,France,FRA,102,0,0,0,102
2002,Senegal,SEN,France,FRA,18,0,0,0,18
2002,Sierra Leone,SLE,France,FRA,5,0,0,0,5
2002,Sudan,SDN,France,FRA,10,0,0,0,10
2002,Slovakia,SVK,France,FRA,10,0,0,0,10
2002,Syrian Arab Rep.,SYR,France,FRA,5,0,0,0,5
2002,Togo,TGO,France,FRA,5,0,0,0,5
2002,Tunisia,TUN,France,FRA,5,0,0,0,5
2002,Turkey,TUR,France,FRA,248,0,0,0,248
2002,Ukraine,UKR,France,FRA,36,0,0,0,36
2002,Uzbekistan,UZB,France,FRA,5,0,0,0,5
2002,Afghanistan,AFG,Germany,DEU,5,223,0,525,753
2002,Albania,ALB,Germany,DEU,0,5,11,94,110
2002,Algeria,DZA,Germany,DEU,5,0,10,274,289
2002,Angola,AGO,Germany,DEU,0,0,5,83,88
2002,Egypt,EGY,Germany,DEU,0,0,0,41,41
2002,Armenia,ARM,Germany,DEU,0,5,0,279,284
2002,Azerbaijan,AZE,Germany,DEU,0,5,0,189,194
2002,Benin,BEN,Germany,DEU,0,0,0,10,10
2002,Bangladesh,BGD,Germany,DEU,0,0,0,39,39
2002,Burkina Faso,BFA,Germany,DEU,0,0,0,11,11
2002,Belarus,BLR,Germany,DEU,0,0,5,66,71
2002,Bosnia and Herzegovina,BIH,Germany,DEU,0,10,30,530,570
2002,Bulgaria,BGR,Germany,DEU,0,0,13,118,131
2002,Central African Rep.,CAF,Germany,DEU,0,0,0,10,10
2002,China,CHN,Germany,DEU,0,0,10,97,107
2002,Cameroon,CMR,Germany,DEU,0,0,5,67,72
2002,Dem. Rep. of the Congo,COD,Germany,DEU,5,10,14,292,321
2002,Colombia,COL,Germany,DEU,0,0,0,5,5
2002,Cuba,CUB,Germany,DEU,0,0,0,5,5
2002,Czechia,CZE,Germany,DEU,0,0,0,19,19
2002,Ecuador,ECU,Germany,DEU,0,0,0,5,5
2002,Eritrea,ERI,Germany,DEU,0,5,0,19,24
2002,Estonia,EST,Germany,DEU,0,0,0,5,5
2002,Ethiopia,ETH,Germany,DEU,5,10,5,34,54
2002,Gambia,GMB,Germany,DEU,0,0,0,10,10
2002,Georgia,GEO,Germany,DEU,0,0,12,238,250
2002,Ghana,GHA,Germany,DEU,0,0,5,80,85
2002,Guinea-Bissau,GNB,Germany,DEU,0,0,0,5,5
2002,Guinea,GIN,Germany,DEU,0,0,0,33,33
2002,Croatia,HRV,Germany,DEU,0,0,5,69,74
2002,Hungary,HUN,Germany,DEU,0,0,5,23,28
2002,Cote d'Ivoire,CIV,Germany,DEU,0,0,0,16,16
2002,India,IND,Germany,DEU,5,0,13,295,313
2002,Iran (Islamic Rep. of),IRN,Germany,DEU,76,5,67,772,920
2002,Iraq,IRQ,Germany,DEU,24,0,22,407,453
2002,Israel,ISR,Germany,DEU,0,0,0,5,5
2002,Jordan,JOR,Germany,DEU,0,0,5,21,26
2002,Kazakhstan,KAZ,Germany,DEU,0,0,0,19,19
2002,Kenya,KEN,Germany,DEU,0,0,0,12,12
2002,Kyrgyzstan,KGZ,Germany,DEU,0,0,0,5,5
2002,Dem. People's Rep. of Korea,PRK,Germany,DEU,0,0,0,12,12
2002,Liberia,LBR,Germany,DEU,5,0,0,23,28
2002,Libya,LBY,Germany,DEU,0,0,0,15,15
2002,Lebanon,LBN,Germany,DEU,0,0,24,169,193
2002,Sri Lanka,LKA,Germany,DEU,5,0,13,331,349
2002,Lithuania,LTU,Germany,DEU,0,0,0,20,20
2002,Latvia,LVA,Germany,DEU,0,0,0,5,5
2002,Mauritania,MRT,Germany,DEU,0,0,0,5,5
2002,North Macedonia,MKD,Germany,DEU,0,0,45,502,547
2002,Rep. of Moldova,MDA,Germany,DEU,0,0,0,43,43
2002,Mongolia,MNG,Germany,DEU,0,0,0,27,27
2002,Morocco,MAR,Germany,DEU,0,0,0,48,48
2002,Myanmar,MMR,Germany,DEU,0,0,0,5,5
2002,Nepal,NPL,Germany,DEU,0,0,0,33,33
2002,Niger,NER,Germany,DEU,0,0,0,10,10
2002,Nigeria,NGA,Germany,DEU,0,5,0,90,95
2002,Pakistan,PAK,Germany,DEU,10,5,11,301,327
2002,Poland,POL,Germany,DEU,0,0,5,10,15
2002,Romania,ROU,Germany,DEU,0,0,13,110,123
2002,Russian Federation,RUS,Germany,DEU,0,0,21,312,333
2002,Rwanda,RWA,Germany,DEU,0,0,0,5,5
2002,Serbia and Kosovo: S/RES/1244 (1999),SRB,Germany,DEU,0,183,943,23359,24485
2002,Senegal,SEN,Germany,DEU,0,0,0,5,5
2002,Sierra Leone,SLE,Germany,DEU,0,5,0,38,43
2002,Somalia,SOM,Germany,DEU,0,0,0,11,11
2002,Viet Nam,VNM,Germany,DEU,0,0,15,465,480
2002,Sudan,SDN,Germany,DEU,5,0,0,23,28
2002,Slovakia,SVK,Germany,DEU,0,0,5,210,215
2002,Syrian Arab Rep.,SYR,Germany,DEU,22,5,16,299,342
2002,Tajikistan,TJK,Germany,DEU,0,0,0,5,5
2002,Togo,TGO,Germany,DEU,10,5,22,366,403
2002,Tunisia,TUN,Germany,DEU,0,0,0,39,39
2002,Turkey,TUR,Germany,DEU,290,74,320,3968,4652
2002,Uganda,UGA,Germany,DEU,0,5,0,5,10
2002,Ukraine,UKR,Germany,DEU,0,0,5,70,75
2002,Uzbekistan,UZB,Germany,DEU,0,0,0,5,5
2002,Yemen,YEM,Germany,DEU,0,0,0,15,15
2002,Stateless,XXA,Germany,DEU,0,0,0,16,16
2003,Afghanistan,AFG,France,FRA,23,0,0,0,23
2003,Albania,ALB,France,FRA,121,0,0,0,121
2003,Algeria,DZA,France,FRA,111,0,0,0,111
2003,Angola,AGO,France,FRA,73,0,0,0,73
2003,Armenia,ARM,France,FRA,93,0,0,0,93
2003,Azerbaijan,AZE,France,FRA,104,0,0,0,104
2003,Burundi,BDI,France,FRA,5,0,0,0,5
2003,Bangladesh,BGD,France,FRA,60,0,0,0,60
2003,Belarus,BLR,France,FRA,30,0,0,0,30
2003,Bosnia and Herzegovina,BIH,France,FRA,23,0,0,0,23
2003,Cambodia,KHM,France,FRA,5,0,0,0,5
2003,Central African Rep.,CAF,France,FRA,13,0,0,0,13
2003,Chad,TCD,France,FRA,24,0,0,0,24
2003,China,CHN,France,FRA,5,0,0,0,5
2003,Cameroon,CMR,France,FRA,11,0,0,0,11
2003,Congo,COG,France,FRA,127,0,0,0,127
2003,Dem. Rep. of the Congo,COD,France,FRA,296,0,0,0,296
2003,Colombia,COL,France,FRA,13,0,0,0,13
2003,Georgia,GEO,France,FRA,173,0,0,0,173
2003,Guinea-Bissau,GNB,France,FRA,5,0,0,0,5
2003,Guinea,GIN,France,FRA,54,0,0,0,54
2003,Haiti,HTI,France,FRA,122,0,0,0,122
2003,India,IND,France,FRA,23,0,0,0,23
2003,Iran (Islamic Rep. of),IRN,France,FRA,33,0,0,0,33
2003,Iraq,IRQ,France,FRA,10,0,0,0,10
2003,Kazakhstan,KAZ,France,FRA,21,0,0,0,21
2003,Kyrgyzstan,KGZ,France,FRA,5,0,0,0,5
2003,Sri Lanka,LKA,France,FRA,342,0,0,0,342
2003,Madagascar,MDG,France,FRA,5,0,0,0,5
2003,Mauritania,MRT,France,FRA,277,0,0,0,277
2003,North Macedonia,MKD,France,FRA,30,0,0,0,30
2003,Rep. of Moldova,MDA,France,FRA,37,0,0,0,37
2003,Mali,MLI,France,FRA,5,0,0,0,5
2003,Mongolia,MNG,France,FRA,10,0,0,0,10
2003,Myanmar,MMR,France,FRA,5,0,0,0,5
2003,Nigeria,NGA,France,FRA,15,0,0,0,15
2003,Pakistan,PAK,France,FRA,16,0,0,0,16
2003,Russian Federation,RUS,France,FRA,230,0,0,0,230
2003,Rwanda,RWA,France,FRA,10,0,0,0,10
2003,Serbia and Kosovo: S/RES/1244 (1999),SRB,France,FRA,138,0,0,0,138
2003,Senegal,SEN,France,FRA,14,0,0,0,14
2003,Sierra Leone,SLE,France,FRA,21,0,0,0,21
2003,Somalia,SOM,France,FRA,5,0,0,0,5
2003,Sudan,SDN,France,FRA,19,0,0,0,19
2003,Slovakia,SVK,France,FRA,13,0,0,0,13
2003,Syrian Arab Rep.,SYR,France,FRA,5,0,0,0,5
2003,Togo,TGO,France,FRA,10,0,0,0,10
2003,Turkey,TUR,France,FRA,368,0,0,0,368
2003,Ukraine,UKR,France,FRA,70,0,0,0,70
2003,Uzbekistan,UZB,France,FRA,19,0,0,0,19
2003,Afghanistan,AFG,Germany,DEU,30,153,482,3432,4097
2003,Albania,ALB,Germany,DEU,0,5,0,60,65
2003,Algeria,DZA,Germany,DEU,0,5,11,309,325
2003,Angola,AGO,Germany,DEU,0,5,5,48,58
2003,Egypt,EGY,Germany,DEU,0,0,5,38,43
2003,Armenia,ARM,Germany,DEU,0,5,0,234,239
2003,Azerbaijan,AZE,Germany,DEU,0,0,0,143,143
2003,Burundi,BDI,Germany,DEU,0,0,0,5,5
2003,Benin,BEN,Germany,DEU,0,0,0,5,5
2003,Bangladesh,BGD,Germany,DEU,0,0,0,44,44
2003,Bhutan,BTN,Germany,DEU,0,0,0,5,5
2003,Burkina Faso,BFA,Germany,DEU,0,0,0,13,13
2003,Belarus,BLR,Germany,DEU,0,0,5,51,56
2003,Bosnia and Herzegovina,BIH,Germany,DEU,0,12,10,421,443
2003,Bulgaria,BGR,Germany,DEU,0,0,12,127,139
2003,China,CHN,Germany,DEU,5,0,5,112,122
2003,Cameroon,CMR,Germany,DEU,0,0,5,99,104
2003,Congo,COG,Germany,DEU,0,0,0,5,5
2003,Dem. Rep. of the Congo,COD,Germany,DEU,5,5,24,415,449
2003,Cuba,CUB,Germany,DEU,0,0,0,5,5
2003,Czechia,CZE,Germany,DEU,0,0,0,16,16
2003,Ecuador,ECU,Germany,DEU,0,0,0,5,5
2003,Eritrea,ERI,Germany,DEU,5,0,0,11,16
2003,Estonia,EST,Germany,DEU,0,0,0,5,5
2003,Ethiopia,ETH,Germany,DEU,5,5,0,53,63
2003,Gambia,GMB,Germany,DEU,0,0,0,5,5
2003,Georgia,GEO,Germany,DEU,0,0,12,204,216
2003,Ghana,GHA,Germany,DEU,0,0,5,56,61
2003,Guinea,GIN,Germany,DEU,0,0,0,31,31
2003,Croatia,HRV,Germany,DEU,0,5,0,62,67
2003,Hungary,HUN,Germany,DEU,0,0,0,5,5
2003,Cote d'Ivoire,CIV,Germany,DEU,0,0,0,26,26
2003,India,IND,Germany,DEU,0,0,10,272,282
2003,Iran (Islamic Rep. of),IRN,Germany,DEU,41,5,53,756,855
2003,Iraq,IRQ,Germany,DEU,0,10,10,224,244
2003,Israel,ISR,Germany,DEU,0,0,0,5,5
2003,Jordan,JOR,Germany,DEU,0,0,5,24,29
2003,Kazakhstan,KAZ,Germany,DEU,0,0,0,10,10
2003,Kenya,KEN,Germany,DEU,0,0,0,5,5
2003,Kyrgyzstan,KGZ,Germany,DEU,0,0,0,10,10
2003,Dem. People's Rep. of Korea,PRK,Germany,DEU,5,0,0,0,5
2003,Liberia,LBR,Germany,DEU,0,0,0,18,18
2003,Libya,LBY,Germany,DEU,0,0,0,17,17
2003,Lebanon,LBN,Germany,DEU,10,0,15,177,202
2003,Sri Lanka,LKA,Germany,DEU,0,0,10,254,264
2003,Lithuania,LTU,Germany,DEU,0,0,0,5,5
2003,Latvia,LVA,Germany,DEU,0,0,0,5,5
2003,North Macedonia,MKD,Germany,DEU,0,0,28,329,357
2003,Rep. of Moldova,MDA,Germany,DEU,0,0,5,40,45
2003,Mali,MLI,Germany,DEU,0,0,0,5,5
2003,Mongolia,MNG,Germany,DEU,0,0,0,12,12
2003,Morocco,MAR,Germany,DEU,0,0,0,41,41
2003,Myanmar,MMR,Germany,DEU,0,0,0,5,5
2003,Nepal,NPL,Germany,DEU,0,0,0,33,33
2003,Niger,NER,Germany,DEU,0,0,0,10,10
2003,Nigeria,NGA,Germany,DEU,0,5,10,99,114
2003,Pakistan,PAK,Germany,DEU,10,0,12,312,334
2003,Poland,POL,Germany,DEU,0,0,0,11,11
2003,Romania,ROU,Germany,DEU,0,0,5,62,67
2003,Russian Federation,RUS,Germany,DEU,10,5,15,464,494
2003,Serbia and Kosovo: S/RES/1244 (1999),SRB,Germany,DEU,0,100,155,7318,7573
2003,Senegal,SEN,Germany,DEU,0,0,0,5,5
2003,Sierra Leone,SLE,Germany,DEU,0,0,5,46,51
2003,Somalia,SOM,Germany,DEU,0,0,0,5,5
2003,Viet Nam,VNM,Germany,DEU,5,0,23,424,452
2003,Sudan,SDN,Germany,DEU,5,0,0,31,36
2003,Slovakia,SVK,Germany,DEU,0,0,14,175,189
2003,Syrian Arab Rep.,SYR,Germany,DEU,21,0,14,274,309
2003,Tajikistan,TJK,Germany,DEU,0,0,0,5,5
2003,Togo,TGO,Germany,DEU,5,0,30,321,356
2003,Tunisia,TUN,Germany,DEU,0,0,5,29,34
2003,Turkey,TUR,Germany,DEU,131,54,246,3636,4067
2003,Uganda,UGA,Germany,DEU,0,0,0,5,5
2003,Ukraine,UKR,Germany,DEU,0,0,10,56,66
2003,Uzbekistan,UZB,Germany,DEU,0,0,0,5,5
2003,Yemen,YEM,Germany,DEU,0,0,0,21,21
2003,Stateless,XXA,Germany,DEU,0,0,0,13,13
2004,Afghanistan,AFG,France,FRA,28,0,0,0,28
2004,Albania,ALB,France,FRA,112,0,0,0,112
2004,Algeria,DZA,France,FRA,73,0,0,0,73
2004,Angola,AGO,France,FRA,213,0,0,0,213
2004,Egypt,EGY,France,FRA,10,0,0,0,10
2004,Armenia,ARM,France,FRA,190,0,0,0,190
2004,Azerbaijan,AZE,France,FRA,164,0,0,0,164
2004,Burundi,BDI,France,FRA,5,0,0,0,5
2004,Bangladesh,BGD,France,FRA,81,0,0,0,81
2004,Belarus,BLR,France,FRA,47,0,0,0,47
2004,Bosnia and Herzegovina,BIH,France,FRA,50,0,0,0,50
2004,Cambodia,KHM,France,FRA,5,0,0,0,5
2004,Central African Rep.,CAF,France,FRA,28,0,0,0,28
2004,Chad,TCD,France,FRA,68,0,0,0,68
2004,China,CHN,France,FRA,11,0,0,0,11
2004,Cameroon,CMR,France,FRA,36,0,0,0,36
2004,Congo,COG,France,FRA,229,0,0,0,229
2004,Dem. Rep. of the Congo,COD,France,FRA,600,0,0,0,600
2004,Colombia,COL,France,FRA,12,0,0,0,12
2004,Eritrea,ERI,France,FRA,5,0,0,0,5
2004,Ethiopia,ETH,France,FRA,5,0,0,0,5
2004,Georgia,GEO,France,FRA,313,0,0,0,313
2004,Guinea,GIN,France,FRA,90,0,0,0,90
2004,Haiti,HTI,France,FRA,59,0,0,0,59
2004,Cote d'Ivoire,CIV,France,FRA,112,0,0,0,112
2004,India,IND,France,FRA,17,0,0,0,17
2004,Iran (Islamic Rep. of),IRN,France,FRA,23,0,0,0,23
2004,Kazakhstan,KAZ,France,FRA,68,0,0,0,68
2004,Kyrgyzstan,KGZ,France,FRA,16,0,0,0,16
2004,Sri Lanka,LKA,France,FRA,391,0,0,0,391
2004,Madagascar,MDG,France,FRA,20,0,0,0,20
2004,Mauritania,MRT,France,FRA,474,0,0,0,474
2004,North Macedonia,MKD,France,FRA,20,0,0,0,20
2004,Rep. of Moldova,MDA,France,FRA,59,0,0,0,59
2004,Mali,MLI,France,FRA,5,0,0,0,5
2004,Mongolia,MNG,France,FRA,29,0,0,0,29
2004,Myanmar,MMR,France,FRA,5,0,0,0,5
2004,Niger,NER,France,FRA,5,0,0,0,5
2004,Nigeria,NGA,France,FRA,28,0,0,0,28
2004,Pakistan,PAK,France,FRA,19,0,0,0,19
2004,Peru,PER,France,FRA,5,0,0,0,5
2004,Russian Federation,RUS,France,FRA,262,0,0,0,262
2004,Rwanda,RWA,France,FRA,11,0,0,0,11
2004,Serbia and Kosovo: S/RES/1244 (1999),SRB,France,FRA,157,0,0,0,157
2004,Senegal,SEN,France,FRA,16,0,0,0,16
2004,Sierra Leone,SLE,France,FRA,20,0,0,0,20
2004,Somalia,SOM,France,FRA,5,0,0,0,5
2004,Sudan,SDN,France,FRA,20,0,0,0,20
2004,Slovakia,SVK,France,FRA,5,0,0,0,5
2004,Syrian Arab Rep.,SYR,France,FRA,5,0,0,0,5
2004,Tajikistan,TJK,France,FRA,5,0,0,0,5
2004,Togo,TGO,France,FRA,36,0,0,0,36
2004,Tunisia,TUN,France,FRA,5,0,0,0,5
2004,Turkey,TUR,France,FRA,563,0,0,0,563
2004,Ukraine,UKR,France,FRA,54,0,0,0,54
2004,Uzbekistan,UZB,France,FRA,37,0,0,0,37
2004,Afghanistan,AFG,Germany,DEU,49,57,112,608,826
2004,Albania,ALB,Germany,DEU,0,0,10,76,86
2004,Algeria,DZA,Germany,DEU,0,0,5,247,252
2004,Angola,AGO,Germany,DEU,0,5,0,45,50
2004,Egypt,EGY,Germany,DEU,5,0,0,28,33
2004,Armenia,ARM,Germany,DEU,0,0,10,185,195
2004,Azerbaijan,AZE,Germany,DEU,0,0,10,212,222
2004,Benin,BEN,Germany,DEU,0,0,0,5,5
2004,Bangladesh,BGD,Germany,DEU,0,0,0,32,32
2004,Burkina Faso,BFA,Germany,DEU,0,0,0,10,10
2004,Belarus,BLR,Germany,DEU,0,0,5,51,56
2004,Bosnia and Herzegovina,BIH,Germany,DEU,0,5,10,334,349
2004,Bulgaria,BGR,Germany,DEU,0,0,5,125,130
2004,Cambodia,KHM,Germany,DEU,0,0,0,5,5
2004,Chad,TCD,Germany,DEU,0,0,0,5,5
2004,China,CHN,Germany,DEU,21,0,0,128,149
2004,Cameroon,CMR,Germany,DEU,0,5,0,98,103
2004,Congo,COG,Germany,DEU,0,0,0,5,5
2004,Dem. Rep. of the Congo,COD,Germany,DEU,0,5,10,281,296
2004,Colombia,COL,Germany,DEU,0,0,0,5,5
2004,Cuba,CUB,Germany,DEU,0,0,0,5,5
2004,Eritrea,ERI,Germany,DEU,10,0,0,33,43
2004,Ethiopia,ETH,Germany,DEU,5,0,0,50,55
2004,Gambia,GMB,Germany,DEU,0,0,0,5,5
2004,Georgia,GEO,Germany,DEU,5,5,10,178,198
2004,Ghana,GHA,Germany,DEU,0,0,5,57,62
2004,Guinea,GIN,Germany,DEU,0,0,0,30,30
2004,Croatia,HRV,Germany,DEU,0,0,0,43,43
2004,Hungary,HUN,Germany,DEU,0,0,0,5,5
2004,Cote d'Ivoire,CIV,Germany,DEU,0,0,0,19,19
2004,India,IND,Germany,DEU,5,0,5,222,232
2004,Indonesia,IDN,Germany,DEU,0,0,0,5,5
2004,Iran (Islamic Rep. of),IRN,Germany,DEU,54,5,28,902,989
2004,Iraq,IRQ,Germany,DEU,0,5,10,197,212
2004,Israel,ISR,Germany,DEU,0,0,0,5,5
2004,Jordan,JOR,Germany,DEU,0,0,0,20,20
2004,Kazakhstan,KAZ,Germany,DEU,0,0,0,12,12
2004,Kyrgyzstan,KGZ,Germany,DEU,0,0,0,10,10
2004,Dem. People's Rep. of Korea,PRK,Germany,DEU,0,0,0,5,5
2004,Liberia,LBR,Germany,DEU,0,0,0,22,22
2004,Libya,LBY,Germany,DEU,0,0,0,12,12
2004,Lebanon,LBN,Germany,DEU,0,0,5,134,139
2004,Sri Lanka,LKA,Germany,DEU,0,5,0,151,156
2004,Mauritania,MRT,Germany,DEU,0,0,0,5,5
2004,North Macedonia,MKD,Germany,DEU,0,0,17,258,275
2004,Rep. of Moldova,MDA,Germany,DEU,0,0,0,18,18
2004,Mongolia,MNG,Germany,DEU,0,0,0,10,10
2004,Morocco,MAR,Germany,DEU,0,0,5,36,41
2004,Myanmar,MMR,Germany,DEU,0,0,0,10,10
2004,Nepal,NPL,Germany,DEU,0,0,0,29,29
2004,Niger,NER,Germany,DEU,0,0,0,5,5
2004,Nigeria,NGA,Germany,DEU,0,0,11,107,118
2004,Pakistan,PAK,Germany,DEU,5,5,5,274,289
2004,Poland,POL,Germany,DEU,0,0,0,5,5
2004,Romania,ROU,Germany,DEU,0,0,0,33,33
2004,Russian Federation,RUS,Germany,DEU,27,5,13,382,427
2004,Serbia and Kosovo: S/RES/1244 (1999),SRB,Germany,DEU,0,27,102,4934,5063
2004,Sierra Leone,SLE,Germany,DEU,0,0,5,36,41
2004,Somalia,SOM,Germany,DEU,0,0,0,15,15
2004,Viet Nam,VNM,Germany,DEU,0,5,20,321,346
2004,Sudan,SDN,Germany,DEU,5,0,0,20,25
2004,Slovakia,SVK,Germany,DEU,0,0,0,61,61
2004,Syrian Arab Rep.,SYR,Germany,DEU,10,5,21,366,402
2004,Tajikistan,TJK,Germany,DEU,0,0,0,5,5
2004,Turkmenistan,TKM,Germany,DEU,0,0,0,5,5
2004,Togo,TGO,Germany,DEU,5,0,13,284,302
2004,Tunisia,TUN,Germany,DEU,5,0,0,24,29
2004,Turkey,TUR,Germany,DEU,101,34,205,2767,3107
2004,Uganda,UGA,Germany,DEU,0,0,0,16,16
2004,Ukraine,UKR,Germany,DEU,0,0,5,80,85
2004,Uzbekistan,UZB,Germany,DEU,0,0,0,12,12
2004,Yemen,YEM,Germany,DEU,0,0,5,12,17
2005,Afghanistan,AFG,France,FRA,53,0,0,0,53
2005,Albania,ALB,France,FRA,208,0,0,0,208
2005,Algeria,DZA,France,FRA,224,0,0,0,224
2005,Angola,AGO,France,FRA,310,0,0,0,310
2005,Egypt,EGY,France,FRA,5,0,0,0,5
2005,Armenia,ARM,France,FRA,530,0,0,0,530
2005,Azerbaijan,AZE,France,FRA,359,0,0,0,359
2005,Burundi,BDI,France,FRA,10,0,0,0,10
2005,Bangladesh,BGD,France,FRA,340,0,0,0,340
2005,Belarus,BLR,France,FRA,72,0,0,0,72
2005,Bosnia and Herzegovina,BIH,France,FRA,165,0,0,0,165
2005,Cambodia,KHM,France,FRA,5,0,0,0,5
2005,Central African Rep.,CAF,France,FRA,41,0,0,0,41
2005,Chad,TCD,France,FRA,95,0,0,0,95
2005,China,CHN,France,FRA,31,0,0,0,31
2005,Cameroon,CMR,France,FRA,98,0,0,0,98
2005,Congo,COG,France,FRA,401,0,0,0,401
2005,Dem. Rep. of the Congo,COD,France,FRA,836,0,0,0,836
2005,Comoros,COM,France,FRA,5,0,0,0,5
2005,Colombia,COL,France,FRA,11,0,0,0,11
2005,Djibouti,DJI,France,FRA,5,0,0,0,5
2005,Eritrea,ERI,France,FRA,5,0,0,0,5
2005,Ethiopia,ETH,France,FRA,5,0,0,0,5
2005,Palestinian,PSE,France,FRA,5,0,0,0,5
2005,Georgia,GEO,France,FRA,566,0,0,0,566
2005,Guinea-Bissau,GNB,France,FRA,10,0,0,0,10
2005,Guinea,GIN,France,FRA,231,0,0,0,231
2005,Haiti,HTI,France,FRA,204,0,0,0,204
2005,Cote d'Ivoire,CIV,France,FRA,238,0,0,0,238
2005,India,IND,France,FRA,37,0,0,0,37
2005,Iran (Islamic Rep. of),IRN,France,FRA,31,0,0,0,31
2005,Iraq,IRQ,France,FRA,5,0,0,0,5
2005,Kazakhstan,KAZ,France,FRA,69,0,0,0,69
2005,Kyrgyzstan,KGZ,France,FRA,47,0,0,0,47
2005,Liberia,LBR,France,FRA,31,0,0,0,31
2005,Lebanon,LBN,France,FRA,5,0,0,0,5
2005,Sri Lanka,LKA,France,FRA,903,0,0,0,903
2005,Madagascar,MDG,France,FRA,33,0,0,0,33
2005,Mauritania,MRT,France,FRA,376,0,0,0,376
2005,North Macedonia,MKD,France,FRA,48,0,0,0,48
2005,Rep. of Moldova,MDA,France,FRA,82,0,0,0,82
2005,Mali,MLI,France,FRA,17,0,0,0,17
2005,Mongolia,MNG,France,FRA,88,0,0,0,88
2005,Morocco,MAR,France,FRA,5,0,0,0,5
2005,Myanmar,MMR,France,FRA,10,0,0,0,10
2005,Nepal,NPL,France,FRA,5,0,0,0,5
2005,Niger,NER,France,FRA,5,0,0,0,5
2005,Nigeria,NGA,France,FRA,139,0,0,0,139
2005,Pakistan,PAK,France,FRA,46,0,0,0,46
2005,Peru,PER,France,FRA,5,0,0,0,5
2005,Russian Federation,RUS,France,FRA,723,0,0,0,723
2005,Rwanda,RWA,France,FRA,74,0,0,0,74
2005,Serbia and Kosovo: S/RES/1244 (1999),SRB,France,FRA,544,0,0,0,544
2005,Senegal,SEN,France,FRA,15,0,0,0,15
2005,Sierra Leone,SLE,France,FRA,22,0,0,0,22
2005,Somalia,SOM,France,FRA,38,0,0,0,38
2005,Sudan,SDN,France,FRA,99,0,0,0,99
2005,Syrian Arab Rep.,SYR,France,FRA,10,0,0,0,10
2005,Togo,TGO,France,FRA,52,0,0,0,52
2005,Tunisia,TUN,France,FRA,5,0,0,0,5
2005,Turkey,TUR,France,FRA,786,0,0,0,786
2005,Ukraine,UKR,France,FRA,76,0,0,0,76
2005,Uzbekistan,UZB,France,FRA,51,0,0,0,51
2005,Afghanistan,AFG,Germany,DEU,43,22,10,317,392
2005,Albania,ALB,Germany,DEU,0,0,0,61,61
2005,Algeria,DZA,Germany,DEU,10,0,5,181,196
2005,Angola,AGO,Germany,DEU,0,5,0,24,29
2005,Egypt,EGY,Germany,DEU,0,0,0,14,14
2005,Armenia,ARM,Germany,DEU,10,0,17,115,142
2005,Azerbaijan,AZE,Germany,DEU,15,5,10,188,218
2005,Benin,BEN,Germany,DEU,0,0,0,11,11
2005,Bangladesh,BGD,Germany,DEU,0,0,0,23,23
2005,Burkina Faso,BFA,Germany,DEU,0,0,0,10,10
2005,Belarus,BLR,Germany,DEU,0,0,0,46,46
2005,Bosnia and Herzegovina,BIH,Germany,DEU,0,5,14,183,202
2005,Bulgaria,BGR,Germany,DEU,0,0,5,72,77
2005,Central African Rep.,CAF,Germany,DEU,0,0,0,5,5
2005,China,CHN,Germany,DEU,22,13,0,158,193
2005,Cameroon,CMR,Germany,DEU,5,0,0,103,108
2005,Congo,COG,Germany,DEU,0,0,0,5,5
2005,Dem. Rep. of the Congo,COD,Germany,DEU,0,5,5,178,188
2005,Colombia,COL,Germany,DEU,11,0,0,0,11
2005,Czechia,CZE,Germany,DEU,0,0,0,10,10
2005,Eritrea,ERI,Germany,DEU,65,5,0,59,129
2005,Ethiopia,ETH,Germany,DEU,19,0,0,67,86
2005,Gambia,GMB,Germany,DEU,0,0,0,10,10
2005,Georgia,GEO,Germany,DEU,0,5,0,112,117
2005,Ghana,GHA,Germany,DEU,0,0,5,66,71
2005,Guinea,GIN,Germany,DEU,5,0,0,28,33
2005,Croatia,HRV,Germany,DEU,0,0,0,11,11
2005,Hungary,HUN,Germany,DEU,0,0,0,5,5
2005,Cote d'Ivoire,CIV,Germany,DEU,5,0,0,19,24
2005,India,IND,Germany,DEU,0,0,10,159,169
2005,Iran (Islamic Rep. of),IRN,Germany,DEU,178,29,26,781,1014
2005,Iraq,IRQ,Germany,DEU,10,5,18,309,342
2005,Israel,ISR,Germany,DEU,0,0,0,5,5
2005,Jordan,JOR,Germany,DEU,0,0,0,20,20
2005,Kazakhstan,KAZ,Germany,DEU,0,0,0,10,10
2005,Kenya,KEN,Germany,DEU,0,0,0,5,5
2005,Kyrgyzstan,KGZ,Germany,DEU,0,0,0,10,10
2005,Dem. People's Rep. of Korea,PRK,Germany,DEU,0,0,12,0,12
2005,Liberia,LBR,Germany,DEU,0,0,0,14,14
2005,Libya,LBY,Germany,DEU,0,0,0,23,23
2005,Lebanon,LBN,Germany,DEU,5,0,5,91,101
2005,Sri Lanka,LKA,Germany,DEU,0,0,0,146,146
2005,Lithuania,LTU,Germany,DEU,0,0,0,5,5
2005,North Macedonia,MKD,Germany,DEU,0,0,10,145,155
2005,Rep. of Moldova,MDA,Germany,DEU,0,0,0,14,14
2005,Mongolia,MNG,Germany,DEU,0,0,0,13,13
2005,Morocco,MAR,Germany,DEU,0,0,0,33,33
2005,Myanmar,MMR,Germany,DEU,0,0,0,10,10
2005,Nepal,NPL,Germany,DEU,0,0,0,28,28
2005,Niger,NER,Germany,DEU,0,0,0,10,10
2005,Nigeria,NGA,Germany,DEU,5,0,0,98,103
2005,Pakistan,PAK,Germany,DEU,21,0,5,161,187
2005,Poland,POL,Germany,DEU,0,0,0,5,5
2005,Romania,ROU,Germany,DEU,0,0,0,35,35
2005,Russian Federation,RUS,Germany,DEU,196,14,30,511,751
2005,Serbia and Kosovo: S/RES/1244 (1999),SRB,Germany,DEU,5,45,118,5316,5484
2005,Senegal,SEN,Germany,DEU,0,0,0,5,5
2005,Sierra Leone,SLE,Germany,DEU,0,0,0,24,24
2005,Somalia,SOM,Germany,DEU,5,0,0,16,21
2005,Viet Nam,VNM,Germany,DEU,5,0,10,251,266
2005,Sudan,SDN,Germany,DEU,0,0,0,34,34
2005,Slovakia,SVK,Germany,DEU,0,0,0,64,64
2005,Syrian Arab Rep.,SYR,Germany,DEU,136,10,16,295,457
2005,Turkmenistan,TKM,Germany,DEU,0,0,0,10,10
2005,Togo,TGO,Germany,DEU,17,0,5,360,382
2005,Tunisia,TUN,Germany,DEU,0,0,0,23,23
2005,Turkey,TUR,Germany,DEU,341,30,116,2006,2493
2005,Uganda,UGA,Germany,DEU,0,0,0,13,13
2005,Ukraine,UKR,Germany,DEU,0,0,5,60,65
2005,Uzbekistan,UZB,Germany,DEU,0,0,0,16,16
2005,Yemen,YEM,Germany,DEU,14,0,5,18,37
2005,Zimbabwe,ZWE,Germany,DEU,0,0,0,5,5
2005,Stateless,XXA,Germany,DEU,5,0,0,18,23
2006,Afghanistan,AFG,France,FRA,27,0,0,0,27
2006,Albania,ALB,France,FRA,51,32,0,0,83
2006,Algeria,DZA,France,FRA,73,25,0,0,98
2006,Angola,AGO,France,FRA,84,5,0,0,89
2006,Egypt,EGY,France,FRA,11,0,0,0,11
2006,Armenia,ARM,France,FRA,180,21,0,0,201
2006,Azerbaijan,AZE,France,FRA,111,0,0,0,111
2006,Burundi,BDI,France,FRA,12,0,0,0,12
2006,Bangladesh,BGD,France,FRA,126,5,0,0,131
2006,Belarus,BLR,France,FRA,46,5,0,0,51
2006,Bosnia and Herzegovina,BIH,France,FRA,241,5,0,0,246
2006,Central African Rep.,CAF,France,FRA,11,0,0,0,11
2006,Chad,TCD,France,FRA,38,0,0,0,38
2006,China,CHN,France,FRA,18,0,0,0,18
2006,Cameroon,CMR,France,FRA,37,5,0,0,42
2006,Congo,COG,France,FRA,74,5,0,0,79
2006,Dem. Rep. of the Congo,COD,France,FRA,255,14,0,0,269
2006,Comoros,COM,France,FRA,5,0,0,0,5
2006,Colombia,COL,France,FRA,0,11,0,0,11
2006,Djibouti,DJI,France,FRA,5,0,0,0,5
2006,Eritrea,ERI,France,FRA,10,0,0,0,10
2006,Ethiopia,ETH,France,FRA,10,0,0,0,10
2006,Palestinian,PSE,France,FRA,5,0,0,0,5
2006,Georgia,GEO,France,FRA,130,20,0,0,150
2006,Guinea-Bissau,GNB,France,FRA,5,0,0,0,5
2006,Guinea,GIN,France,FRA,150,11,0,0,161
2006,Haiti,HTI,France,FRA,158,39,0,0,197
2006,Cote d'Ivoire,CIV,France,FRA,102,5,0,0,107
2006,India,IND,France,FRA,12,0,0,0,12
2006,Iran (Islamic Rep. of),IRN,France,FRA,24,5,0,0,29
2006,Iraq,IRQ,France,FRA,40,19,0,0,59
2006,Kazakhstan,KAZ,France,FRA,11,5,0,0,16
2006,Kyrgyzstan,KGZ,France,FRA,15,0,0,0,15
2006,Liberia,LBR,France,FRA,5,5,0,0,10
2006,Sri Lanka,LKA,France,FRA,340,5,0,0,345
2006,Madagascar,MDG,France,FRA,21,5,0,0,26
2006,Mauritania,MRT,France,FRA,161,0,0,0,161
2006,North Macedonia,MKD,France,FRA,22,0,0,0,22
2006,Rep. of Moldova,MDA,France,FRA,23,12,0,0,35
2006,Mali,MLI,France,FRA,5,0,0,0,5
2006,Mongolia,MNG,France,FRA,28,11,0,0,39
2006,Myanmar,MMR,France,FRA,5,0,0,0,5
2006,Nepal,NPL,France,FRA,5,0,0,0,5
2006,Nigeria,NGA,France,FRA,53,16,0,0,69
2006,Pakistan,PAK,France,FRA,28,10,0,0,38
2006,Russian Federation,RUS,France,FRA,336,32,0,0,368
2006,Rwanda,RWA,France,FRA,69,0,0,0,69
2006,Serbia and Kosovo: S/RES/1244 (1999),SRB,France,FRA,356,11,0,0,367
2006,Senegal,SEN,France,FRA,5,0,0,0,5
2006,Sierra Leone,SLE,France,FRA,11,0,0,0,11
2006,Somalia,SOM,France,FRA,25,0,0,0,25
2006,Sudan,SDN,France,FRA,80,0,0,0,80
2006,Syrian Arab Rep.,SYR,France,FRA,5,0,0,0,5
2006,Togo,TGO,France,FRA,49,0,0,0,49
2006,Tunisia,TUN,France,FRA,5,0,0,0,5
2006,Turkey,TUR,France,FRA,291,5,0,0,296
2006,Ukraine,UKR,France,FRA,21,5,0,0,26
2006,Uzbekistan,UZB,France,FRA,12,0,0,0,12
2006,Afghanistan,AFG,Germany,DEU,38,94,5,839,976
2006,Albania,ALB,Germany,DEU,0,0,0,39,39
2006,Algeria,DZA,Germany,DEU,0,0,10,105,115
2006,Angola,AGO,Germany,DEU,0,0,0,36,36
2006,Egypt,EGY,Germany,DEU,0,0,0,21,21
2006,Armenia,ARM,Germany,DEU,0,0,0,124,124
2006,Azerbaijan,AZE,Germany,DEU,5,0,0,108,113
2006,Burundi,BDI,Germany,DEU,0,0,0,5,5
2006,Bangladesh,BGD,Germany,DEU,0,0,0,5,5
2006,Burkina Faso,BFA,Germany,DEU,0,0,0,10,10
2006,Belarus,BLR,Germany,DEU,5,0,0,38,43
2006,Bosnia and Herzegovina,BIH,Germany,DEU,0,0,5,130,135
2006,Bulgaria,BGR,Germany,DEU,0,0,5,56,61
2006,China,CHN,Germany,DEU,5,23,5,91,124
2006,Cameroon,CMR,Germany,DEU,0,0,5,60,65
2006,Congo,COG,Germany,DEU,0,0,0,5,5
2006,Dem. Rep. of the Congo,COD,Germany,DEU,5,0,0,123,128
2006,Cuba,CUB,Germany,DEU,0,0,5,0,5
2006,Czechia,CZE,Germany,DEU,0,0,0,10,10
2006,Eritrea,ERI,Germany,DEU,27,27,0,54,108
2006,Ethiopia,ETH,Germany,DEU,0,5,0,55,60
2006,Gambia,GMB,Germany,DEU,0,0,0,10,10
2006,Georgia,GEO,Germany,DEU,0,0,5,79,84
2006,Ghana,GHA,Germany,DEU,0,0,0,45,45
2006,Guinea,GIN,Germany,DEU,0,5,0,38,43
2006,Croatia,HRV,Germany,DEU,5,0,0,15,20
2006,Cote d'Ivoire,CIV,Germany,DEU,0,0,0,10,10
2006,India,IND,Germany,DEU,0,5,5,110,120
2006,Iran (Islamic Rep. of),IRN,Germany,DEU,51,31,23,542,647
2006,Iraq,IRQ,Germany,DEU,38,11,11,281,341
2006,Israel,ISR,Germany,DEU,0,0,0,5,5
2006,Jordan,JOR,Germany,DEU,5,0,0,18,23
2006,Kenya,KEN,Germany,DEU,0,0,0,5,5
2006,Liberia,LBR,Germany,DEU,0,0,0,10,10
2006,Libya,LBY,Germany,DEU,0,0,0,14,14
2006,Lebanon,LBN,Germany,DEU,0,0,11,87,98
2006,Sri Lanka,LKA,Germany,DEU,5,0,5,128,138
2006,North Macedonia,MKD,Germany,DEU,0,0,5,97,102
2006,Rep. of Moldova,MDA,Germany,DEU,0,0,0,11,11
2006,Mongolia,MNG,Germany,DEU,0,0,0,5,5
2006,Morocco,MAR,Germany,DEU,0,0,0,21,21
2006,Montenegro,MNE,Germany,DEU,0,0,0,36,36
2006,Myanmar,MMR,Germany,DEU,12,0,0,0,12
2006,Nepal,NPL,Germany,DEU,0,0,0,34,34
2006,Nigeria,NGA,Germany,DEU,0,0,10,90,100
2006,Pakistan,PAK,Germany,DEU,10,0,5,110,125
2006,Romania,ROU,Germany,DEU,0,0,5,11,16
2006,Russian Federation,RUS,Germany,DEU,58,5,10,278,351
2006,Serbia and Kosovo: S/RES/1244 (1999),SRB,Germany,DEU,11,38,52,2044,2145
2006,Sierra Leone,SLE,Germany,DEU,0,0,0,25,25
2006,Somalia,SOM,Germany,DEU,0,0,0,13,13
2006,Viet Nam,VNM,Germany,DEU,5,0,12,203,220
2006,Sudan,SDN,Germany,DEU,0,0,0,22,22
2006,Slovakia,SVK,Germany,DEU,0,0,5,118,123
2006,Syrian Arab Rep.,SYR,Germany,DEU,39,5,14,181,239
2006,Turkmenistan,TKM,Germany,DEU,0,0,0,5,5
2006,Togo,TGO,Germany,DEU,5,5,0,116,126
2006,Tunisia,TUN,Germany,DEU,0,0,0,25,25
2006,Turkey,TUR,Germany,DEU,45,18,105,1028,1196
2006,Uganda,UGA,Germany,DEU,0,0,0,14,14
2006,Ukraine,UKR,Germany,DEU,0,0,0,30,30
2006,Uzbekistan,UZB,Germany,DEU,0,0,0,10,10
2006,Yemen,YEM,Germany,DEU,0,0,0,33,33
2006,Armenia,ARM,Croatia,HRV,0,0,0,5,5
2007,Afghanistan,AFG,France,FRA,25,0,0,0,25
2007,Albania,ALB,France,FRA,27,29,0,0,56
2007,Algeria,DZA,France,FRA,81,48,0,0,129
2007,Angola,AGO,France,FRA,113,5,0,0,118
2007,Armenia,ARM,France,FRA,192,40,0,0,232
2007,Azerbaijan,AZE,France,FRA,173,0,0,0,173
2007,Burundi,BDI,France,FRA,15,0,0,0,15
2007,Bangladesh,BGD,France,FRA,199,5,0,0,204
2007,Belarus,BLR,France,FRA,39,0,0,0,39
2007,Bolivia (Plurinational State of),BOL,France,FRA,5,0,0,0,5
2007,Bosnia and Herzegovina,BIH,France,FRA,175,5,0,0,180
2007,Cambodia,KHM,France,FRA,5,0,0,0,5
2007,Central African Rep.,CAF,France,FRA,16,0,0,0,16
2007,Chad,TCD,France,FRA,43,5,0,0,48
2007,China,CHN,France,FRA,13,0,0,0,13
2007,Cameroon,CMR,France,FRA,38,11,0,0,49
2007,Congo,COG,France,FRA,100,5,0,0,105
2007,Dem. Rep. of the Congo,COD,France,FRA,284,28,0,0,312
2007,Comoros,COM,France,FRA,17,0,0,0,17
2007,Colombia,COL,France,FRA,12,10,0,0,22
2007,Cuba,CUB,France,FRA,5,0,0,0,5
2007,Eritrea,ERI,France,FRA,5,5,0,0,10
2007,Ethiopia,ETH,France,FRA,24,0,0,0,24
2007,Gabon,GAB,France,FRA,5,0,0,0,5
2007,Palestinian,PSE,France,FRA,5,0,0,0,5
2007,Georgia,GEO,France,FRA,92,22,0,0,114
2007,Guinea-Bissau,GNB,France,FRA,5,0,0,0,5
2007,Guinea,GIN,France,FRA,210,24,0,0,234
2007,Haiti,HTI,France,FRA,172,69,0,0,241
2007,Cote d'Ivoire,CIV,France,FRA,82,5,0,0,87
2007,India,IND,France,FRA,5,0,0,0,5
2007,Iran (Islamic Rep. of),IRN,France,FRA,28,10,0,0,38
2007,Iraq,IRQ,France,FRA,40,12,0,0,52
2007,Kazakhstan,KAZ,France,FRA,17,10,0,0,27
2007,Kyrgyzstan,KGZ,France,FRA,11,5,0,0,16
2007,Liberia,LBR,France,FRA,5,0,0,0,5
2007,Sri Lanka,LKA,France,FRA,560,32,0,0,592
2007,Madagascar,MDG,France,FRA,17,5,0,0,22
2007,Mauritania,MRT,France,FRA,99,5,0,0,104
2007,North Macedonia,MKD,France,FRA,20,5,0,0,25
2007,Rep. of Moldova,MDA,France,FRA,25,5,0,0,30
2007,Mali,MLI,France,FRA,10,0,0,0,10
2007,Mongolia,MNG,France,FRA,13,0,0,0,13
2007,Morocco,MAR,France,FRA,5,0,0,0,5
2007,Myanmar,MMR,France,FRA,5,0,0,0,5
2007,Niger,NER,France,FRA,5,0,0,0,5
2007,Nigeria,NGA,France,FRA,35,10,0,0,45
2007,Pakistan,PAK,France,FRA,25,5,0,0,30
2007,Peru,PER,France,FRA,12,0,0,0,12
2007,Romania,ROU,France,FRA,5,0,0,0,5
2007,Russian Federation,RUS,France,FRA,454,48,0,0,502
2007,Rwanda,RWA,France,FRA,59,0,0,0,59
2007,Serbia and Kosovo: S/RES/1244 (1999),SRB,France,FRA,531,46,0,0,577
2007,Senegal,SEN,France,FRA,5,0,0,0,5
2007,Sierra Leone,SLE,France,FRA,12,0,0,0,12
2007,Somalia,SOM,France,FRA,18,0,0,0,18
2007,Sudan,SDN,France,FRA,52,5,0,0,57
2007,Syrian Arab Rep.,SYR,France,FRA,5,5,0,0,10
2007,Togo,TGO,France,FRA,45,0,0,0,45
2007,Turkey,TUR,France,FRA,465,11,0,0,476
2007,Ukraine,UKR,France,FRA,20,5,0,0,25
2007,Uzbekistan,UZB,France,FRA,5,5,0,0,10
2007,Afghanistan,AFG,Germany,DEU,38,57,10,238,343
2007,Albania,ALB,Germany,DEU,0,0,0,25,25
2007,Algeria,DZA,Germany,DEU,0,0,5,114,119
2007,Angola,AGO,Germany,DEU,0,0,0,13,13
2007,Egypt,EGY,Germany,DEU,0,0,0,14,14
2007,Armenia,ARM,Germany,DEU,10,0,5,70,85
2007,Azerbaijan,AZE,Germany,DEU,15,0,0,57,72
2007,Benin,BEN,Germany,DEU,0,0,0,5,5
2007,Bangladesh,BGD,Germany,DEU,0,0,0,5,5
2007,Burkina Faso,BFA,Germany,DEU,0,0,0,5,5
2007,Belarus,BLR,Germany,DEU,0,0,0,27,27
2007,Bosnia and Herzegovina,BIH,Germany,DEU,0,5,5,81,91
2007,Bulgaria,BGR,Germany,DEU,0,0,0,10,10
2007,China,CHN,Germany,DEU,0,5,5,58,68
2007,Cameroon,CMR,Germany,DEU,5,0,0,41,46
2007,Dem. Rep. of the Congo,COD,Germany,DEU,0,0,0,44,44
2007,Cuba,CUB,Germany,DEU,0,0,0,5,5
2007,Czechia,CZE,Germany,DEU,0,0,0,10,10
2007,Eritrea,ERI,Germany,DEU,48,65,5,36,154
2007,Ethiopia,ETH,Germany,DEU,0,12,0,66,78
2007,Gambia,GMB,Germany,DEU,0,0,0,10,10
2007,Georgia,GEO,Germany,DEU,0,5,0,50,55
2007,Ghana,GHA,Germany,DEU,0,0,5,40,45
2007,Guinea,GIN,Germany,DEU,5,0,0,23,28
2007,Croatia,HRV,Germany,DEU,0,0,0,5,5
2007,Hungary,HUN,Germany,DEU,0,0,0,13,13
2007,Cote d'Ivoire,CIV,Germany,DEU,0,0,0,15,15
2007,India,IND,Germany,DEU,0,0,5,79,84
2007,Iran (Islamic Rep. of),IRN,Germany,DEU,149,89,42,413,693
2007,Iraq,IRQ,Germany,DEU,3994,12,29,611,4646
2007,Israel,ISR,Germany,DEU,0,0,0,5,5
2007,Jordan,JOR,Germany,DEU,0,0,0,5,5
2007,Kenya,KEN,Germany,DEU,0,0,0,5,5
2007,Liberia,LBR,Germany,DEU,0,0,0,5,5
2007,Libya,LBY,Germany,DEU,0,0,0,12,12
2007,Lebanon,LBN,Germany,DEU,0,0,22,110,132
2007,Sri Lanka,LKA,Germany,DEU,10,17,5,60,92
2007,North Macedonia,MKD,Germany,DEU,0,0,10,63,73
2007,Rep. of Moldova,MDA,Germany,DEU,0,0,0,10,10
2007,Mongolia,MNG,Germany,DEU,0,0,0,5,5
2007,Morocco,MAR,Germany,DEU,0,0,5,29,34
2007,Montenegro,MNE,Germany,DEU,0,0,0,34,34
2007,Myanmar,MMR,Germany,DEU,5,0,0,0,5
2007,Nepal,NPL,Germany,DEU,0,0,0,10,10
2007,Niger,NER,Germany,DEU,0,0,0,5,5
2007,Nigeria,NGA,Germany,DEU,0,0,5,73,78
2007,Pakistan,PAK,Germany,DEU,0,0,31,113,144
2007,Poland,POL,Germany,DEU,0,0,0,5,5
2007,Romania,ROU,Germany,DEU,0,0,0,10,10
2007,Russian Federation,RUS,Germany,DEU,86,5,10,238,339
2007,Serbia and Kosovo: S/RES/1244 (1999),SRB,Germany,DEU,11,18,33,962,1024
2007,Senegal,SEN,Germany,DEU,0,0,0,5,5
2007,Sierra Leone,SLE,Germany,DEU,0,0,0,25,25
2007,Somalia,SOM,Germany,DEU,15,17,0,16,48
2007,Viet Nam,VNM,Germany,DEU,5,0,5,142,152
2007,Sudan,SDN,Germany,DEU,0,0,0,12,12
2007,Slovakia,SVK,Germany,DEU,0,0,5,161,166
2007,Syrian Arab Rep.,SYR,Germany,DEU,35,13,12,126,186
2007,United Rep. of Tanzania,TZA,Germany,DEU,0,0,0,5,5
2007,Turkmenistan,TKM,Germany,DEU,0,0,0,5,5
2007,Togo,TGO,Germany,DEU,0,0,5,43,48
2007,Tunisia,TUN,Germany,DEU,0,0,5,20,25
2007,Turkey,TUR,Germany,DEU,29,10,42,620,701
2007,Uganda,UGA,Germany,DEU,0,0,0,5,5
2007,Ukraine,UKR,Germany,DEU,0,0,0,23,23
2007,Yemen,YEM,Germany,DEU,0,0,0,5,5
2007,Zimbabwe,ZWE,Germany,DEU,0,0,0,5,5
2007,Stateless,XXA,Germany,DEU,0,0,0,5,5
2007,Palestinian,PSE,Croatia,HRV,0,0,10,0,10
2008,Afghanistan,AFG,Germany,DEU,36,44,5,79,164
2008,Albania,ALB,Germany,DEU,0,0,0,13,13
2008,Algeria,DZA,Germany,DEU,0,0,5,74,79
2008,Angola,AGO,Germany,DEU,0,0,0,10,10
2008,Egypt,EGY,Germany,DEU,0,0,0,10,10
2008,Armenia,ARM,Germany,DEU,0,0,5,78,83
2008,Azerbaijan,AZE,Germany,DEU,39,0,5,64,108
2008,Bangladesh,BGD,Germany,DEU,0,0,0,10,10
2008,Belarus,BLR,Germany,DEU,0,0,0,10,10
2008,Bosnia and Herzegovina,BIH,Germany,DEU,0,0,0,64,64
2008,Bulgaria,BGR,Germany,DEU,0,0,5,0,5
2008,China,CHN,Germany,DEU,5,10,0,18,33
2008,Cameroon,CMR,Germany,DEU,0,0,0,20,20
2008,Dem. Rep. of the Congo,COD,Germany,DEU,0,0,0,15,15
2008,Colombia,COL,Germany,DEU,0,0,0,5,5
2008,Czechia,CZE,Germany,DEU,0,0,0,5,5
2008,Eritrea,ERI,Germany,DEU,22,19,0,5,46
2008,Ethiopia,ETH,Germany,DEU,11,5,0,37,53
2008,Gambia,GMB,Germany,DEU,0,0,0,5,5
2008,Georgia,GEO,Germany,DEU,0,0,0,54,54
2008,Ghana,GHA,Germany,DEU,0,0,0,15,15
2008,Guinea,GIN,Germany,DEU,0,0,0,10,10
2008,Croatia,HRV,Germany,DEU,0,0,0,5,5
2008,India,IND,Germany,DEU,0,0,5,51,56
2008,Iran (Islamic Rep. of),IRN,Germany,DEU,210,14,28,198,450
2008,Iraq,IRQ,Germany,DEU,856,45,5,579,1485
2008,Jordan,JOR,Germany,DEU,0,5,0,0,5
2008,Kazakhstan,KAZ,Germany,DEU,0,0,0,5,5
2008,Libya,LBY,Germany,DEU,0,0,0,5,5
2008,Lebanon,LBN,Germany,DEU,5,0,5,39,49
2008,Sri Lanka,LKA,Germany,DEU,32,17,5,65,119
2008,North Macedonia,MKD,Germany,DEU,0,0,0,59,59
2008,Rep. of Moldova,MDA,Germany,DEU,0,0,0,5,5
2008,Morocco,MAR,Germany,DEU,5,0,0,14,19
2008,Montenegro,MNE,Germany,DEU,0,0,0,17,17
2008,Nepal,NPL,Germany,DEU,0,0,0,5,5
2008,Nigeria,NGA,Germany,DEU,5,0,0,47,52
2008,Pakistan,PAK,Germany,DEU,5,0,10,41,56
2008,Romania,ROU,Germany,DEU,0,0,0,5,5
2008,Russian Federation,RUS,Germany,DEU,47,16,0,113,176
2008,Serbia and Kosovo: S/RES/1244 (1999),SRB,Germany,DEU,5,15,25,550,595
2008,Sierra Leone,SLE,Germany,DEU,0,0,0,10,10
2008,Somalia,SOM,Germany,DEU,16,5,0,5,26
2008,Viet Nam,VNM,Germany,DEU,0,0,20,178,198
2008,Sudan,SDN,Germany,DEU,0,0,0,5,5
2008,Slovakia,SVK,Germany,DEU,0,0,0,35,35
2008,Syrian Arab Rep.,SYR,Germany,DEU,37,5,5,94,141
2008,Togo,TGO,Germany,DEU,0,0,5,22,27
2008,Tunisia,TUN,Germany,DEU,0,5,0,17,22
2008,Turkey,TUR,Germany,DEU,43,5,22,373,443
2008,Uganda,UGA,Germany,DEU,0,0,0,5,5
2008,Ukraine,UKR,Germany,DEU,0,0,0,11,11
2008,Uzbekistan,UZB,Germany,DEU,0,0,5,0,5
2008,Stateless,XXA,Germany,DEU,0,0,0,5,5
2009,Afghanistan,AFG,France,FRA,18,14,0,0,32
2009,Albania,ALB,France,FRA,19,27,0,0,46
2009,Algeria,DZA,France,FRA,16,10,0,0,26
2009,Angola,AGO,France,FRA,63,10,0,0,73
2009,Egypt,EGY,France,FRA,10,0,0,0,10
2009,Armenia,ARM,France,FRA,281,79,0,0,360
2009,Azerbaijan,AZE,France,FRA,206,0,0,0,206
2009,Bangladesh,BGD,France,FRA,293,5,0,0,298
2009,Bhutan,BTN,France,FRA,5,0,0,0,5
2009,Burkina Faso,BFA,France,FRA,5,0,0,0,5
2009,Belarus,BLR,France,FRA,16,0,0,0,16
2009,Bosnia and Herzegovina,BIH,France,FRA,14,0,0,0,14
2009,Central African Rep.,CAF,France,FRA,10,0,0,0,10
2009,Chad,TCD,France,FRA,47,0,0,0,47
2009,China,CHN,France,FRA,10,0,0,0,10
2009,Cameroon,CMR,France,FRA,17,5,0,0,22
2009,Congo,COG,France,FRA,72,26,0,0,98
2009,Dem. Rep. of the Congo,COD,France,FRA,253,25,0,0,278
2009,Comoros,COM,France,FRA,49,0,0,0,49
2009,Colombia,COL,France,FRA,0,10,0,0,10
2009,Eritrea,ERI,France,FRA,10,0,0,0,10
2009,Ethiopia,ETH,France,FRA,5,5,0,0,10
2009,Palestinian,PSE,France,FRA,5,0,0,0,5
2009,Georgia,GEO,France,FRA,42,5,0,0,47
2009,Guinea,GIN,France,FRA,147,58,0,0,205
2009,Haiti,HTI,France,FRA,16,17,0,0,33
2009,Cote d'Ivoire,CIV,France,FRA,47,21,0,0,68
2009,Iran (Islamic Rep. of),IRN,France,FRA,19,10,0,0,29
2009,Iraq,IRQ,France,FRA,13,5,0,0,18
2009,Kazakhstan,KAZ,France,FRA,5,0,0,0,5
2009,Kyrgyzstan,KGZ,France,FRA,5,5,0,0,10
2009,Lebanon,LBN,France,FRA,5,0,0,0,5
2009,Sri Lanka,LKA,France,FRA,593,616,0,0,1209
2009,Mauritania,MRT,France,FRA,66,5,0,0,71
2009,North Macedonia,MKD,France,FRA,5,0,0,0,5
2009,Mali,MLI,France,FRA,15,88,0,0,103
2009,Mongolia,MNG,France,FRA,0,11,0,0,11
2009,Myanmar,MMR,France,FRA,10,0,0,0,10
2009,Nepal,NPL,France,FRA,10,0,0,0,10
2009,Nigeria,NGA,France,FRA,11,17,0,0,28
2009,Pakistan,PAK,France,FRA,17,5,0,0,22
2009,Russian Federation,RUS,France,FRA,713,49,0,0,762
2009,Rwanda,RWA,France,FRA,54,0,0,0,54
2009,Serbia and Kosovo: S/RES/1244 (1999),SRB,France,FRA,333,125,0,0,458
2009,Senegal,SEN,France,FRA,5,14,0,0,19
2009,Sierra Leone,SLE,France,FRA,5,5,0,0,10
2009,Somalia,SOM,France,FRA,0,5,0,0,5
2009,Sudan,SDN,France,FRA,83,10,0,0,93
2009,Togo,TGO,France,FRA,23,0,0,0,23
2009,Turkey,TUR,France,FRA,316,10,0,0,326
2009,Ukraine,UKR,France,FRA,10,0,0,0,10
2009,Uzbekistan,UZB,France,FRA,10,0,0,0,10
2009,Afghanistan,AFG,Germany,DEU,38,50,5,87,180
2009,Albania,ALB,Germany,DEU,0,0,0,12,12
2009,Algeria,DZA,Germany,DEU,0,5,5,84,94
2009,Angola,AGO,Germany,DEU,0,5,0,5,10
2009,Egypt,EGY,Germany,DEU,5,0,0,5,10
2009,Armenia,ARM,Germany,DEU,5,5,0,70,80
2009,Azerbaijan,AZE,Germany,DEU,23,5,0,80,108
2009,Burkina Faso,BFA,Germany,DEU,0,0,0,5,5
2009,Belarus,BLR,Germany,DEU,0,0,0,5,5
2009,Bosnia and Herzegovina,BIH,Germany,DEU,0,5,0,74,79
2009,Bulgaria,BGR,Germany,DEU,0,0,0,13,13
2009,China,CHN,Germany,DEU,5,12,0,29,46
2009,Cameroon,CMR,Germany,DEU,0,0,0,26,26
2009,Dem. Rep. of the Congo,COD,Germany,DEU,0,0,0,29,29
2009,Colombia,COL,Germany,DEU,0,0,0,5,5
2009,Czechia,CZE,Germany,DEU,0,0,0,5,5
2009,Eritrea,ERI,Germany,DEU,24,20,0,5,49
2009,Ethiopia,ETH,Germany,DEU,5,5,0,34,44
2009,Gambia,GMB,Germany,DEU,0,0,0,5,5
2009,Georgia,GEO,Germany,DEU,5,0,5,47,57
2009,Ghana,GHA,Germany,DEU,0,0,0,26,26
2009,Guinea,GIN,Germany,DEU,0,5,0,15,20
2009,Croatia,HRV,Germany,DEU,0,0,0,5,5
2009,Hungary,HUN,Germany,DEU,0,0,0,10,10
2009,Cote d'Ivoire,CIV,Germany,DEU,0,0,0,5,5
2009,India,IND,Germany,DEU,0,0,0,71,71
2009,Iran (Islamic Rep. of),IRN,Germany,DEU,248,19,28,133,428
2009,Iraq,IRQ,Germany,DEU,430,109,36,1097,1672
2009,Israel,ISR,Germany,DEU,0,0,0,5,5
2009,Jordan,JOR,Germany,DEU,0,0,0,20,20
2009,Kenya,KEN,Germany,DEU,0,0,0,5,5
2009,Liberia,LBR,Germany,DEU,0,0,0,5,5
2009,Libya,LBY,Germany,DEU,0,0,0,5,5
2009,Lebanon,LBN,Germany,DEU,0,5,5,53,63
2009,Sri Lanka,LKA,Germany,DEU,25,20,5,22,72
2009,North Macedonia,MKD,Germany,DEU,0,0,5,23,28
2009,Rep. of Moldova,MDA,Germany,DEU,0,0,0,5,5
2009,Morocco,MAR,Germany,DEU,0,0,0,18,18
2009,Montenegro,MNE,Germany,DEU,5,0,0,34,39
2009,Nepal,NPL,Germany,DEU,0,0,0,5,5
2009,Niger,NER,Germany,DEU,0,0,0,5,5
2009,Nigeria,NGA,Germany,DEU,0,10,0,35,45
2009,Pakistan,PAK,Germany,DEU,13,0,5,37,55
2009,Russian Federation,RUS,Germany,DEU,49,11,0,141,201
2009,Rwanda,RWA,Germany,DEU,0,0,0,5,5
2009,Serbia and Kosovo: S/RES/1244 (1999),SRB,Germany,DEU,5,28,35,622,690
2009,Sierra Leone,SLE,Germany,DEU,0,5,0,18,23
2009,Somalia,SOM,Germany,DEU,14,5,0,0,19
2009,Viet Nam,VNM,Germany,DEU,0,5,21,220,246
2009,Sudan,SDN,Germany,DEU,0,0,0,13,13
2009,Slovakia,SVK,Germany,DEU,0,0,0,17,17
2009,Syrian Arab Rep.,SYR,Germany,DEU,40,10,5,201,256
2009,Togo,TGO,Germany,DEU,0,0,5,24,29
2009,Tunisia,TUN,Germany,DEU,0,0,0,24,24
2009,Turkey,TUR,Germany,DEU,47,15,21,371,454
2009,Uganda,UGA,Germany,DEU,0,0,0,5,5
2009,Ukraine,UKR,Germany,DEU,0,0,0,5,5
2009,Uzbekistan,UZB,Germany,DEU,0,0,0,5,5
2009,Stateless,XXA,Germany,DEU,12,0,0,0,12
2010,Afghanistan,AFG,France,FRA,36,50,0,0,86
2010,Albania,ALB,France,FRA,11,29,0,0,40
2010,Algeria,DZA,France,FRA,13,10,0,0,23
2010,Angola,AGO,France,FRA,44,5,0,0,49
2010,Egypt,EGY,France,FRA,10,0,0,0,10
2010,Armenia,ARM,France,FRA,149,49,0,0,198
2010,Azerbaijan,AZE,France,FRA,93,5,0,0,98
2010,Burundi,BDI,France,FRA,5,0,0,0,5
2010,Bangladesh,BGD,France,FRA,338,5,0,0,343
2010,Bhutan,BTN,France,FRA,10,0,0,0,10
2010,Belarus,BLR,France,FRA,5,5,0,0,10
2010,Bosnia and Herzegovina,BIH,France,FRA,29,0,0,0,29
2010,Cambodia,KHM,France,FRA,5,0,0,0,5
2010,Central African Rep.,CAF,France,FRA,13,0,0,0,13
2010,Chad,TCD,France,FRA,34,0,0,0,34
2010,China,CHN,France,FRA,14,0,0,0,14
2010,Cameroon,CMR,France,FRA,23,5,0,0,28
2010,Congo,COG,France,FRA,70,17,0,0,87
2010,Dem. Rep. of the Congo,COD,France,FRA,325,26,0,0,351
2010,Comoros,COM,France,FRA,13,0,0,0,13
2010,Colombia,COL,France,FRA,10,0,0,0,10
2010,Eritrea,ERI,France,FRA,10,0,0,0,10
2010,Ethiopia,ETH,France,FRA,5,0,0,0,5
2010,Gambia,GMB,France,FRA,0,5,0,0,5
2010,Palestinian,PSE,France,FRA,5,0,0,0,5
2010,Georgia,GEO,France,FRA,38,5,0,0,43
2010,Guinea-Bissau,GNB,France,FRA,5,0,0,0,5
2010,Guinea,GIN,France,FRA,174,66,0,0,240
2010,Haiti,HTI,France,FRA,14,21,0,0,35
2010,Cote d'Ivoire,CIV,France,FRA,26,10,0,0,36
2010,Iran (Islamic Rep. of),IRN,France,FRA,24,0,0,0,24
2010,Iraq,IRQ,France,FRA,13,0,0,0,13
2010,Kazakhstan,KAZ,France,FRA,5,0,0,0,5
2010,Kenya,KEN,France,FRA,0,5,0,0,5
2010,Kyrgyzstan,KGZ,France,FRA,5,0,0,0,5
2010,Sri Lanka,LKA,France,FRA,841,161,0,0,1002
2010,Mauritania,MRT,France,FRA,92,23,0,0,115
2010,North Macedonia,MKD,France,FRA,11,0,0,0,11
2010,Mali,MLI,France,FRA,10,175,0,0,185
2010,Mongolia,MNG,France,FRA,12,5,0,0,17
2010,Montenegro,MNE,France,FRA,10,0,0,0,10
2010,Myanmar,MMR,France,FRA,5,0,0,0,5
2010,Nepal,NPL,France,FRA,14,0,0,0,14
2010,Niger,NER,France,FRA,5,0,0,0,5
2010,Nigeria,NGA,France,FRA,22,27,0,0,49
2010,Pakistan,PAK,France,FRA,35,5,0,0,40
2010,Russian Federation,RUS,France,FRA,748,58,0,0,806
2010,Rwanda,RWA,France,FRA,32,0,0,0,32
2010,Serbia and Kosovo: S/RES/1244 (1999),SRB,France,FRA,327,157,0,0,484
2010,Senegal,SEN,France,FRA,0,20,0,0,20
2010,Sierra Leone,SLE,France,FRA,0,13,0,0,13
2010,Somalia,SOM,France,FRA,11,0,0,0,11
2010,Sudan,SDN,France,FRA,83,10,0,0,93
2010,Syrian Arab Rep.,SYR,France,FRA,11,0,0,0,11
2010,Togo,TGO,France,FRA,22,0,0,0,22
2010,Turkey,TUR,France,FRA,354,17,0,0,371
2010,Uganda,UGA,France,FRA,5,0,0,0,5
2010,Ukraine,UKR,France,FRA,5,5,0,0,10
2010,Afghanistan,AFG,United Kingdom of Great Britain and Northern Ireland,GBR,0,0,0,22,22
2010,Albania,ALB,United Kingdom of Great Britain and Northern Ireland,GBR,0,0,0,5,5
2010,Algeria,DZA,United Kingdom of Great Britain and Northern Ireland,GBR,0,0,0,13,13
2010,Angola,AGO,United Kingdom of Great Britain and Northern Ireland,GBR,0,0,5,0,5
2010,Egypt,EGY,United Kingdom of Great Britain and Northern Ireland,GBR,0,0,5,0,5
2010,Armenia,ARM,United Kingdom of Great Britain and Northern Ireland,GBR,0,0,5,0,5
2010,Bangladesh,BGD,United Kingdom of Great Britain and Northern Ireland,GBR,0,0,0,5,5
2010,China,CHN,United Kingdom of Great Britain and Northern Ireland,GBR,0,0,11,5,16
2010,Dem. Rep. of the Congo,COD,United Kingdom of Great Britain and Northern Ireland,GBR,0,0,0,5,5
2010,Eritrea,ERI,United Kingdom of Great Britain and Northern Ireland,GBR,5,0,0,5,10
2010,Gambia,GMB,United Kingdom of Great Britain and Northern Ireland,GBR,0,0,0,11,11
2010,Palestinian,PSE,United Kingdom of Great Britain and Northern Ireland,GBR,0,0,0,5,5
2010,Georgia,GEO,United Kingdom of Great Britain and Northern Ireland,GBR,0,0,0,5,5
2010,India,IND,United Kingdom of Great Britain and Northern Ireland,GBR,0,0,17,5,22
2010,Iran (Islamic Rep. of),IRN,United Kingdom of Great Britain and Northern Ireland,GBR,0,5,14,12,31
2010,Iraq,IRQ,United Kingdom of Great Britain and Northern Ireland,GBR,0,0,5,14,19
2010,Jamaica,JAM,United Kingdom of Great Britain and Northern Ireland,GBR,5,0,0,0,5
2010,Lebanon,LBN,United Kingdom of Great Britain and Northern Ireland,GBR,0,0,0,5,5
2010,Sri Lanka,LKA,United Kingdom of Great Britain and Northern Ireland,GBR,0,0,0,12,12
2010,Malawi,MWI,United Kingdom of Great Britain and Northern Ireland,GBR,0,0,0,5,5
2010,Nigeria,NGA,United Kingdom of Great Britain and Northern Ireland,GBR,0,0,16,12,28
2010,Pakistan,PAK,United Kingdom of Great Britain and Northern Ireland,GBR,0,0,21,10,31
2010,South Africa,ZAF,United Kingdom of Great Britain and Northern Ireland,GBR,0,0,5,0,5
2010,Serbia and Kosovo: S/RES/1244 (1999),SRB,United Kingdom of Great Britain and Northern Ireland,GBR,0,0,0,5,5
2010,Somalia,SOM,United Kingdom of Great Britain and Northern Ireland,GBR,11,0,0,0,11
2010,Viet Nam,VNM,United Kingdom of Great Britain and Northern Ireland,GBR,0,0,0,10,10
2010,Sudan,SDN,United Kingdom of Great Britain and Northern Ireland,GBR,5,0,0,12,17
2010,Syrian Arab Rep.,SYR,United Kingdom of Great Britain and Northern Ireland,GBR,0,0,0,5,5
2010,Turkey,TUR,United Kingdom of Great Britain and Northern Ireland,GBR,0,0,0,5,5
2010,Uganda,UGA,United Kingdom of Great Britain and Northern Ireland,GBR,5,0,5,0,10
2010,Zimbabwe,ZWE,United Kingdom of Great Britain and Northern Ireland,GBR,10,0,12,0,22
2010,Stateless,XXA,United Kingdom of Great Britain and Northern Ireland,GBR,0,0,0,5,5
2010,Afghanistan,AFG,Germany,DEU,42,30,10,78,160
2010,Albania,ALB,Germany,DEU,0,0,0,5,5
2010,Algeria,DZA,Germany,DEU,0,0,15,110,125
2010,Angola,AGO,Germany,DEU,0,0,0,14,14
2010,Egypt,EGY,Germany,DEU,0,0,0,23,23
2010,Armenia,ARM,Germany,DEU,0,5,0,106,111
2010,Azerbaijan,AZE,Germany,DEU,5,5,5,98,113
2010,Bangladesh,BGD,Germany,DEU,0,0,0,18,18
2010,Burkina Faso,BFA,Germany,DEU,0,0,0,5,5
2010,Belarus,BLR,Germany,DEU,0,0,0,10,10
2010,Bosnia and Herzegovina,BIH,Germany,DEU,0,5,15,66,86
2010,China,CHN,Germany,DEU,5,5,5,49,64
2010,Cameroon,CMR,Germany,DEU,0,0,0,35,35
2010,Congo,COG,Germany,DEU,0,0,0,5,5
2010,Dem. Rep. of the Congo,COD,Germany,DEU,5,5,0,38,48
2010,Czechia,CZE,Germany,DEU,0,0,0,5,5
2010,Eritrea,ERI,Germany,DEU,10,14,0,5,29
2010,Ethiopia,ETH,Germany,DEU,5,18,0,46,69
2010,Gambia,GMB,Germany,DEU,0,0,0,5,5
2010,Georgia,GEO,Germany,DEU,0,5,5,95,105
2010,Ghana,GHA,Germany,DEU,0,0,5,29,34
2010,Guinea,GIN,Germany,DEU,0,0,5,27,32
2010,Croatia,HRV,Germany,DEU,0,0,0,5,5
2010,Cote d'Ivoire,CIV,Germany,DEU,0,0,0,5,5
2010,India,IND,Germany,DEU,0,0,5,93,98
2010,Iran (Islamic Rep. of),IRN,Germany,DEU,425,52,31,312,820
2010,Iraq,IRQ,Germany,DEU,154,39,28,308,529
2010,Jordan,JOR,Germany,DEU,0,0,0,13,13
2010,Kazakhstan,KAZ,Germany,DEU,0,0,0,5,5
2010,Kenya,KEN,Germany,DEU,0,0,0,5,5
2010,Liberia,LBR,Germany,DEU,0,5,0,0,5
2010,Lebanon,LBN,Germany,DEU,5,0,17,78,100
2010,Sri Lanka,LKA,Germany,DEU,14,11,5,53,83
2010,North Macedonia,MKD,Germany,DEU,0,5,367,430,802
2010,Rep. of Moldova,MDA,Germany,DEU,0,0,0,5,5
2010,Mongolia,MNG,Germany,DEU,0,0,0,5,5
2010,Morocco,MAR,Germany,DEU,0,5,0,23,28
2010,Montenegro,MNE,Germany,DEU,0,0,5,42,47
2010,Nepal,NPL,Germany,DEU,0,0,0,5,5
2010,Nigeria,NGA,Germany,DEU,0,5,5,63,73
2010,Pakistan,PAK,Germany,DEU,5,5,10,92,112
2010,Poland,POL,Germany,DEU,0,0,0,5,5
2010,Russian Federation,RUS,Germany,DEU,53,16,11,180,260
2010,Rwanda,RWA,Germany,DEU,0,5,0,0,5
2010,Serbia and Kosovo: S/RES/1244 (1999),SRB,Germany,DEU,5,54,494,1471,2024
2010,Sierra Leone,SLE,Germany,DEU,0,5,0,19,24
2010,Somalia,SOM,Germany,DEU,12,5,0,0,17
2010,Viet Nam,VNM,Germany,DEU,0,0,10,185,195
2010,Sudan,SDN,Germany,DEU,0,0,0,5,5
2010,Slovakia,SVK,Germany,DEU,0,0,0,10,10
2010,Syrian Arab Rep.,SYR,Germany,DEU,90,26,18,484,618
2010,Turkmenistan,TKM,Germany,DEU,5,0,0,0,5
2010,Togo,TGO,Germany,DEU,0,0,5,19,24
2010,Tunisia,TUN,Germany,DEU,0,0,0,19,19
2010,Turkey,TUR,Germany,DEU,63,12,33,342,450
2010,Uganda,UGA,Germany,DEU,0,0,0,5,5
2010,Ukraine,UKR,Germany,DEU,0,0,0,10,10
2010,Yemen,YEM,Germany,DEU,0,0,0,5,5
2010,Zimbabwe,ZWE,Germany,DEU,0,0,0,5,5
2010,Stateless,XXA,Germany,DEU,5,0,0,17,22
2011,Afghanistan,AFG,United Kingdom of Great Britain and Northern Ireland,GBR,0,0,0,12,12
2011,Albania,ALB,United Kingdom of Great Britain and Northern Ireland,GBR,0,0,0,5,5
2011,Algeria,DZA,United Kingdom of Great Britain and Northern Ireland,GBR,0,0,0,5,5
2011,Egypt,EGY,United Kingdom of Great Britain and Northern Ireland,GBR,0,0,0,5,5
2011,Bangladesh,BGD,United Kingdom of Great Britain and Northern Ireland,GBR,0,0,5,0,5
2011,China,CHN,United Kingdom of Great Britain and Northern Ireland,GBR,0,0,0,5,5
2011,Eritrea,ERI,United Kingdom of Great Britain and Northern Ireland,GBR,5,0,0,0,5
2011,United Kingdom of Great Britain and Northern Ireland,GBR,United Kingdom of Great Britain and Northern Ireland,GBR,0,0,0,5,5
2011,Georgia,GEO,United Kingdom of Great Britain and Northern Ireland,GBR,0,0,5,0,5
2011,India,IND,United Kingdom of Great Britain and Northern Ireland,GBR,0,0,0,10,10
2011,Iran (Islamic Rep. of),IRN,United Kingdom of Great Britain and Northern Ireland,GBR,0,13,0,0,13
2011,Iraq,IRQ,United Kingdom of Great Britain and Northern Ireland,GBR,0,5,12,0,17
2011,Sri Lanka,LKA,United Kingdom of Great Britain and Northern Ireland,GBR,0,0,0,12,12
2011,Nigeria,NGA,United Kingdom of Great Britain and Northern Ireland,GBR,0,0,0,12,12
2011,Pakistan,PAK,United Kingdom of Great Britain and Northern Ireland,GBR,0,0,0,14,14
2011,Serbia and Kosovo: S/RES/1244 (1999),SRB,United Kingdom of Great Britain and Northern Ireland,GBR,0,0,0,5,5
2011,Somalia,SOM,United Kingdom of Great Britain and Northern Ireland,GBR,0,0,0,13,13
2011,Sudan,SDN,United Kingdom of Great Britain and Northern Ireland,GBR,0,0,0,5,5
2011,Turkey,TUR,United Kingdom of Great Britain and Northern Ireland,GBR,0,5,0,0,5
2011,Zimbabwe,ZWE,United Kingdom of Great Britain and Northern Ireland,GBR,5,5,5,0,15
2011,Afghanistan,AFG,Germany,DEU,33,31,24,91,179
2011,Albania,ALB,Germany,DEU,0,0,0,10,10
2011,Algeria,DZA,Germany,DEU,0,0,11,77,88
2011,Angola,AGO,Germany,DEU,0,0,0,5,5
2011,Egypt,EGY,Germany,DEU,0,0,0,16,16
2011,Armenia,ARM,Germany,DEU,5,0,10,89,104
2011,Azerbaijan,AZE,Germany,DEU,11,5,0,72,88
2011,Bangladesh,BGD,Germany,DEU,0,0,0,10,10
2011,Belarus,BLR,Germany,DEU,0,0,0,15,15
2011,Bosnia and Herzegovina,BIH,Germany,DEU,0,0,11,64,75
2011,Bulgaria,BGR,Germany,DEU,0,0,0,11,11
2011,China,CHN,Germany,DEU,20,10,0,72,102
2011,Cameroon,CMR,Germany,DEU,0,0,0,13,13
2011,Dem. Rep. of the Congo,COD,Germany,DEU,0,0,0,18,18
2011,Colombia,COL,Germany,DEU,0,0,0,5,5
2011,Czechia,CZE,Germany,DEU,0,0,0,5,5
2011,Eritrea,ERI,Germany,DEU,15,5,0,5,25
2011,Ethiopia,ETH,Germany,DEU,0,5,5,20,30
2011,Gambia,GMB,Germany,DEU,0,0,0,10,10
2011,Georgia,GEO,Germany,DEU,0,0,0,69,69
2011,Ghana,GHA,Germany,DEU,0,0,5,16,21
2011,Guinea,GIN,Germany,DEU,0,0,5,25,30
2011,Croatia,HRV,Germany,DEU,0,0,0,5,5
2011,Cote d'Ivoire,CIV,Germany,DEU,0,0,0,5,5
2011,India,IND,Germany,DEU,0,5,0,74,79
2011,Iran (Islamic Rep. of),IRN,Germany,DEU,236,39,19,193,487
2011,Iraq,IRQ,Germany,DEU,110,27,27,191,355
2011,Israel,ISR,Germany,DEU,0,0,0,5,5
2011,Jordan,JOR,Germany,DEU,0,0,0,13,13
2011,Liberia,LBR,Germany,DEU,0,0,0,5,5
2011,Libya,LBY,Germany,DEU,0,0,0,5,5
2011,Lebanon,LBN,Germany,DEU,0,5,12,44,61
2011,Sri Lanka,LKA,Germany,DEU,0,5,5,26,36
2011,Latvia,LVA,Germany,DEU,0,0,0,5,5
2011,North Macedonia,MKD,Germany,DEU,0,5,285,436,726
2011,Rep. of Moldova,MDA,Germany,DEU,0,0,0,5,5
2011,Mongolia,MNG,Germany,DEU,0,0,0,5,5
2011,Morocco,MAR,Germany,DEU,0,0,0,31,31
2011,Montenegro,MNE,Germany,DEU,0,0,0,30,30
2011,Niger,NER,Germany,DEU,0,0,0,5,5
2011,Nigeria,NGA,Germany,DEU,0,5,0,42,47
2011,Pakistan,PAK,Germany,DEU,5,5,5,48,63
2011,Russian Federation,RUS,Germany,DEU,20,17,12,153,202
2011,Serbia and Kosovo: S/RES/1244 (1999),SRB,Germany,DEU,5,40,651,2237,2933
2011,Senegal,SEN,Germany,DEU,0,0,0,5,5
2011,Sierra Leone,SLE,Germany,DEU,0,5,0,11,16
2011,Somalia,SOM,Germany,DEU,5,0,0,14,19
2011,Viet Nam,VNM,Germany,DEU,0,5,5,121,131
2011,Sudan,SDN,Germany,DEU,0,0,0,5,5
2011,Slovakia,SVK,Germany,DEU,0,0,0,10,10
2011,Syrian Arab Rep.,SYR,Germany,DEU,107,23,0,98,228
2011,Tajikistan,TJK,Germany,DEU,0,0,0,5,5
2011,Togo,TGO,Germany,DEU,5,0,0,16,21
2011,Tunisia,TUN,Germany,DEU,0,0,0,24,24
2011,Turkey,TUR,Germany,DEU,15,11,39,259,324
2011,Uganda,UGA,Germany,DEU,0,0,0,5,5
2011,Ukraine,UKR,Germany,DEU,0,0,0,10,10
2011,Stateless,XXA,Germany,DEU,0,0,0,5,5
2012,Afghanistan,AFG,United Kingdom of Great Britain and Northern Ireland,GBR,0,5,5,18,28
2012,Albania,ALB,United Kingdom of Great Britain and Northern Ireland,GBR,0,0,5,5,10
2012,Algeria,DZA,United Kingdom of Great Britain and Northern Ireland,GBR,0,0,5,5,10
2012,Egypt,EGY,United Kingdom of Great Britain and Northern Ireland,GBR,0,0,0,5,5
2012,Bangladesh,BGD,United Kingdom of Great Britain and Northern Ireland,GBR,0,0,5,16,21
2012,China,CHN,United Kingdom of Great Britain and Northern Ireland,GBR,0,5,0,5,10
2012,Eritrea,ERI,United Kingdom of Great Britain and Northern Ireland,GBR,0,0,0,5,5
2012,Palestinian,PSE,United Kingdom of Great Britain and Northern Ireland,GBR,0,0,0,5,5
2012,India,IND,United Kingdom of Great Britain and Northern Ireland,GBR,0,0,0,30,30
2012,Iran (Islamic Rep. of),IRN,United Kingdom of Great Britain and Northern Ireland,GBR,5,0,10,5,20
2012,Iraq,IRQ,United Kingdom of Great Britain and Northern Ireland,GBR,0,0,0,14,14
2012,Sri Lanka,LKA,United Kingdom of Great Britain and Northern Ireland,GBR,0,5,0,5,10
2012,Mongolia,MNG,United Kingdom of Great Britain and Northern Ireland,GBR,0,5,0,0,5
2012,Morocco,MAR,United Kingdom of Great Britain and Northern Ireland,GBR,0,0,0,5,5
2012,Nigeria,NGA,United Kingdom of Great Britain and Northern Ireland,GBR,0,0,11,5,16
2012,Pakistan,PAK,United Kingdom of Great Britain and Northern Ireland,GBR,0,0,24,26,50
2012,Somalia,SOM,United Kingdom of Great Britain and Northern Ireland,GBR,0,5,0,5,10
2012,Viet Nam,VNM,United Kingdom of Great Britain and Northern Ireland,GBR,0,0,0,5,5
2012,Sudan,SDN,United Kingdom of Great Britain and Northern Ireland,GBR,0,0,0,13,13
2012,Syrian Arab Rep.,SYR,United Kingdom of Great Britain and Northern Ireland,GBR,0,0,5,5,10
2012,Zimbabwe,ZWE,United Kingdom of Great Britain and Northern Ireland,GBR,5,11,0,0,16
2012,Afghanistan,AFG,Germany,DEU,34,20,12,102,168
2012,Albania,ALB,Germany,DEU,0,0,0,19,19
2012,Algeria,DZA,Germany,DEU,0,0,12,93,105
2012,Egypt,EGY,Germany,DEU,0,0,0,16,16
2012,Armenia,ARM,Germany,DEU,10,0,5,67,82
2012,Azerbaijan,AZE,Germany,DEU,0,5,5,39,49
2012,Benin,BEN,Germany,DEU,0,0,0,5,5
2012,Bangladesh,BGD,Germany,DEU,0,0,0,5,5
2012,Belarus,BLR,Germany,DEU,0,0,0,14,14
2012,Bosnia and Herzegovina,BIH,Germany,DEU,0,5,53,217,275
2012,Bulgaria,BGR,Germany,DEU,0,0,0,15,15
2012,Cambodia,KHM,Germany,DEU,0,0,5,0,5
2012,China,CHN,Germany,DEU,5,5,5,55,70
2012,Cameroon,CMR,Germany,DEU,0,0,5,16,21
2012,Dem. Rep. of the Congo,COD,Germany,DEU,5,0,0,15,20
2012,Colombia,COL,Germany,DEU,0,0,0,5,5
2012,Czechia,CZE,Germany,DEU,0,0,0,5,5
2012,Eritrea,ERI,Germany,DEU,12,0,0,5,17
2012,Estonia,EST,Germany,DEU,0,0,0,10,10
2012,Ethiopia,ETH,Germany,DEU,0,5,0,23,28
2012,Gambia,GMB,Germany,DEU,0,5,0,11,16
2012,Georgia,GEO,Germany,DEU,0,0,5,75,80
2012,Ghana,GHA,Germany,DEU,0,0,0,16,16
2012,Guinea,GIN,Germany,DEU,0,5,0,27,32
2012,Croatia,HRV,Germany,DEU,0,0,5,5,10
2012,Hungary,HUN,Germany,DEU,0,0,5,0,5
2012,Cote d'Ivoire,CIV,Germany,DEU,0,0,0,12,12
2012,India,IND,Germany,DEU,0,5,0,43,48
2012,Iran (Islamic Rep. of),IRN,Germany,DEU,175,25,28,138,366
2012,Iraq,IRQ,Germany,DEU,63,25,19,165,272
2012,Jordan,JOR,Germany,DEU,5,0,0,5,10
2012,Libya,LBY,Germany,DEU,0,0,0,5,5
2012,Lebanon,LBN,Germany,DEU,0,0,5,47,52
2012,Sri Lanka,LKA,Germany,DEU,0,5,5,19,29
2012,North Macedonia,MKD,Germany,DEU,0,5,436,1735,2176
2012,Rep. of Moldova,MDA,Germany,DEU,0,0,0,5,5
2012,Morocco,MAR,Germany,DEU,0,0,5,29,34
2012,Montenegro,MNE,Germany,DEU,0,0,27,67,94
2012,Niger,NER,Germany,DEU,0,0,0,5,5
2012,Nigeria,NGA,Germany,DEU,0,5,5,54,64
2012,Pakistan,PAK,Germany,DEU,5,5,11,82,103
2012,Romania,ROU,Germany,DEU,0,0,0,5,5
2012,Russian Federation,RUS,Germany,DEU,31,10,5,155,201
2012,Serbia and Kosovo: S/RES/1244 (1999),SRB,Germany,DEU,0,30,553,4512,5095
2012,Sierra Leone,SLE,Germany,DEU,0,5,0,5,10
2012,Somalia,SOM,Germany,DEU,0,5,0,32,37
2012,Viet Nam,VNM,Germany,DEU,0,0,5,79,84
2012,Sudan,SDN,Germany,DEU,0,0,0,5,5
2012,Slovakia,SVK,Germany,DEU,0,0,0,5,5
2012,Syrian Arab Rep.,SYR,Germany,DEU,279,1958,10,47,2294
2012,Togo,TGO,Germany,DEU,0,0,0,10,10
2012,Tunisia,TUN,Germany,DEU,0,0,5,28,33
2012,Turkey,TUR,Germany,DEU,21,13,21,233,288
2012,Ukraine,UKR,Germany,DEU,0,5,0,16,21
2012,Zimbabwe,ZWE,Germany,DEU,0,0,0,5,5
2012,Stateless,XXA,Germany,DEU,10,69,0,13,92
2013,Afghanistan,AFG,Belgium,BEL,0,0,0,71,71
2013,Albania,ALB,Belgium,BEL,0,0,0,42,42
2013,Algeria,DZA,Belgium,BEL,0,0,0,5,5
2013,Angola,AGO,Belgium,BEL,0,0,0,18,18
2013,Egypt,EGY,Belgium,BEL,0,0,0,24,24
2013,Armenia,ARM,Belgium,BEL,0,0,0,48,48
2013,Azerbaijan,AZE,Belgium,BEL,0,0,0,15,15
2013,Burundi,BDI,Belgium,BEL,0,0,0,22,22
2013,Bangladesh,BGD,Belgium,BEL,0,0,0,13,13
2013,Burkina Faso,BFA,Belgium,BEL,0,0,0,5,5
2013,Bosnia and Herzegovina,BIH,Belgium,BEL,0,0,0,12,12
2013,Cameroon,CMR,Belgium,BEL,0,0,0,22,22
2013,Dem. Rep. of the Congo,COD,Belgium,BEL,0,0,0,80,80
2013,Eritrea,ERI,Belgium,BEL,0,0,0,5,5
2013,Gambia,GMB,Belgium,BEL,0,0,0,5,5
2013,Georgia,GEO,Belgium,BEL,0,0,0,36,36
2013,Guinea,GIN,Belgium,BEL,0,0,0,102,102
2013,Croatia,HRV,Belgium,BEL,0,0,0,5,5
2013,Cote d'Ivoire,CIV,Belgium,BEL,0,0,0,22,22
2013,Iran (Islamic Rep. of),IRN,Belgium,BEL,0,0,0,51,51
2013,Iraq,IRQ,Belgium,BEL,0,0,0,94,94
2013,Kazakhstan,KAZ,Belgium,BEL,0,0,0,12,12
2013,Kenya,KEN,Belgium,BEL,0,0,0,5,5
2013,Kyrgyzstan,KGZ,Belgium,BEL,0,0,0,14,14
2013,Liberia,LBR,Belgium,BEL,0,0,0,5,5
2013,Lebanon,LBN,Belgium,BEL,0,0,0,11,11
2013,Sri Lanka,LKA,Belgium,BEL,0,0,0,12,12
2013,Mauritania,MRT,Belgium,BEL,0,0,0,37,37
2013,North Macedonia,MKD,Belgium,BEL,0,0,0,45,45
2013,Mongolia,MNG,Belgium,BEL,0,0,0,5,5
2013,Morocco,MAR,Belgium,BEL,0,0,0,10,10
2013,Nepal,NPL,Belgium,BEL,0,0,0,5,5
2013,Niger,NER,Belgium,BEL,0,0,0,5,5
2013,Nigeria,NGA,Belgium,BEL,0,0,0,16,16
2013,Pakistan,PAK,Belgium,BEL,0,0,0,34,34
2013,Russian Federation,RUS,Belgium,BEL,0,0,0,322,322
2013,Rwanda,RWA,Belgium,BEL,0,0,0,26,26
2013,Serbia and Kosovo: S/RES/1244 (1999),SRB,Belgium,BEL,0,0,0,185,185
2013,Senegal,SEN,Belgium,BEL,0,0,0,24,24
2013,Sierra Leone,SLE,Belgium,BEL,0,0,0,5,5
2013,Somalia,SOM,Belgium,BEL,0,0,0,17,17
2013,Sudan,SDN,Belgium,BEL,0,0,0,5,5
2013,Syrian Arab Rep.,SYR,Belgium,BEL,0,0,0,5,5
2013,United Rep. of Tanzania,TZA,Belgium,BEL,0,0,0,10,10
2013,Togo,TGO,Belgium,BEL,0,0,0,20,20
2013,Turkey,TUR,Belgium,BEL,0,0,0,20,20
2013,Ukraine,UKR,Belgium,BEL,0,0,0,5,5
2013,Afghanistan,AFG,United Kingdom of Great Britain and Northern Ireland,GBR,5,0,0,18,23
2013,Albania,ALB,United Kingdom of Great Britain and Northern Ireland,GBR,0,0,5,5,10
2013,Algeria,DZA,United Kingdom of Great Britain and Northern Ireland,GBR,0,0,0,5,5
2013,Bangladesh,BGD,United Kingdom of Great Britain and Northern Ireland,GBR,0,0,5,15,20
2013,China,CHN,United Kingdom of Great Britain and Northern Ireland,GBR,0,0,5,12,17
2013,Dem. Rep. of the Congo,COD,United Kingdom of Great Britain and Northern Ireland,GBR,5,0,0,0,5
2013,Eritrea,ERI,United Kingdom of Great Britain and Northern Ireland,GBR,0,0,0,10,10
2013,Ghana,GHA,United Kingdom of Great Britain and Northern Ireland,GBR,0,0,5,0,5
2013,India,IND,United Kingdom of Great Britain and Northern Ireland,GBR,0,0,0,18,18
2013,Iran (Islamic Rep. of),IRN,United Kingdom of Great Britain and Northern Ireland,GBR,0,0,12,0,12
2013,Iraq,IRQ,United Kingdom of Great Britain and Northern Ireland,GBR,0,0,0,5,5
2013,Sri Lanka,LKA,United Kingdom of Great Britain and Northern Ireland,GBR,0,0,0,5,5
2013,Malawi,MWI,United Kingdom of Great Britain and Northern Ireland,GBR,0,0,5,0,5
2013,Nigeria,NGA,United Kingdom of Great Britain and Northern Ireland,GBR,0,0,0,5,5
2013,Pakistan,PAK,United Kingdom of Great Britain and Northern Ireland,GBR,0,0,22,27,49
2013,Viet Nam,VNM,United Kingdom of Great Britain and Northern Ireland,GBR,0,0,0,5,5
2013,Sudan,SDN,United Kingdom of Great Britain and Northern Ireland,GBR,0,0,0,5,5
2013,Zimbabwe,ZWE,United Kingdom of Great Britain and Northern Ireland,GBR,5,5,0,0,10
2013,Afghanistan,AFG,Germany,DEU,109,60,12,174,355
2013,Albania,ALB,Germany,DEU,0,0,0,25,25
2013,Algeria,DZA,Germany,DEU,5,0,13,68,86
2013,Angola,AGO,Germany,DEU,0,0,0,5,5
2013,Egypt,EGY,Germany,DEU,0,0,5,11,16
2013,Armenia,ARM,Germany,DEU,5,5,0,84,94
2013,Azerbaijan,AZE,Germany,DEU,5,5,0,65,75
2013,Bangladesh,BGD,Germany,DEU,0,0,0,15,15
2013,Burkina Faso,BFA,Germany,DEU,0,0,0,5,5
2013,Belarus,BLR,Germany,DEU,0,0,0,14,14
2013,Bosnia and Herzegovina,BIH,Germany,DEU,0,0,71,934,1005
2013,Bulgaria,BGR,Germany,DEU,0,0,0,24,24
2013,Chad,TCD,Germany,DEU,0,0,0,5,5
2013,China,CHN,Germany,DEU,17,5,0,78,100
2013,Cameroon,CMR,Germany,DEU,0,5,0,16,21
2013,Dem. Rep. of the Congo,COD,Germany,DEU,0,5,5,13,23
2013,Colombia,COL,Germany,DEU,0,0,0,5,5
2013,Czechia,CZE,Germany,DEU,0,0,0,5,5
2013,Eritrea,ERI,Germany,DEU,5,0,0,11,16
2013,Ethiopia,ETH,Germany,DEU,0,0,0,22,22
2013,Gambia,GMB,Germany,DEU,0,0,0,11,11
2013,Georgia,GEO,Germany,DEU,0,0,5,126,131
2013,Ghana,GHA,Germany,DEU,0,0,0,18,18
2013,Guinea-Bissau,GNB,Germany,DEU,0,0,0,5,5
2013,Guinea,GIN,Germany,DEU,0,5,0,16,21
2013,Croatia,HRV,Germany,DEU,0,0,0,16,16
2013,Cote d'Ivoire,CIV,Germany,DEU,0,0,0,10,10
2013,India,IND,Germany,DEU,0,5,0,44,49
2013,Iran (Islamic Rep. of),IRN,Germany,DEU,139,34,17,108,298
2013,Iraq,IRQ,Germany,DEU,69,16,22,167,274
2013,Jordan,JOR,Germany,DEU,0,0,0,10,10
2013,Kazakhstan,KAZ,Germany,DEU,5,0,0,0,5
2013,Kenya,KEN,Germany,DEU,0,0,0,5,5
2013,Libya,LBY,Germany,DEU,0,0,0,15,15
2013,Lebanon,LBN,Germany,DEU,0,5,5,47,57
2013,Sri Lanka,LKA,Germany,DEU,10,5,0,37,52
2013,North Macedonia,MKD,Germany,DEU,0,0,355,2065,2420
2013,Morocco,MAR,Germany,DEU,0,5,0,32,37
2013,Montenegro,MNE,Germany,DEU,0,0,15,102,117
2013,Nepal,NPL,Germany,DEU,0,0,0,5,5
2013,Nigeria,NGA,Germany,DEU,0,5,0,53,58
2013,Pakistan,PAK,Germany,DEU,22,5,11,67,105
2013,Romania,ROU,Germany,DEU,0,0,0,5,5
2013,Russian Federation,RUS,Germany,DEU,14,26,19,412,471
2013,Rwanda,RWA,Germany,DEU,5,0,0,0,5
2013,Serbia and Kosovo: S/RES/1244 (1999),SRB,Germany,DEU,0,20,431,4957,5408
2013,Sierra Leone,SLE,Germany,DEU,0,0,0,13,13
2013,Somalia,SOM,Germany,DEU,5,11,0,67,83
2013,Viet Nam,VNM,Germany,DEU,0,0,10,66,76
2013,Sudan,SDN,Germany,DEU,0,0,0,10,10
2013,Slovakia,SVK,Germany,DEU,0,0,0,19,19
2013,Syrian Arab Rep.,SYR,Germany,DEU,181,330,15,141,667
2013,Tajikistan,TJK,Germany,DEU,0,0,0,5,5
2013,Togo,TGO,Germany,DEU,0,0,0,14,14
2013,Tunisia,TUN,Germany,DEU,0,0,5,27,32
2013,Turkey,TUR,Germany,DEU,17,13,30,165,225
2013,Uganda,UGA,Germany,DEU,0,0,0,5,5
2013,Stateless,XXA,Germany,DEU,10,5,0,33,48
2013,Montenegro,MNE,Luxembourg,LUX,0,0,5,0,5
2013,Serbia and Kosovo: S/RES/1244 (1999),SRB,Luxembourg,LUX,0,0,14,0,14
2014,Afghanistan,AFG,Belgium,BEL,0,0,0,402,402
2014,Albania,ALB,Belgium,BEL,0,0,0,129,129
2014,Algeria,DZA,Belgium,BEL,0,0,0,36,36
2014,Angola,AGO,Belgium,BEL,0,0,0,25,25
2014,Egypt,EGY,Belgium,BEL,0,0,0,32,32
2014,Armenia,ARM,Belgium,BEL,0,0,0,97,97
2014,Azerbaijan,AZE,Belgium,BEL,0,0,0,51,51
2014,Burundi,BDI,Belgium,BEL,0,0,0,30,30
2014,Benin,BEN,Belgium,BEL,0,0,0,16,16
2014,Bangladesh,BGD,Belgium,BEL,0,0,0,86,86
2014,Burkina Faso,BFA,Belgium,BEL,0,0,0,13,13
2014,Belarus,BLR,Belgium,BEL,0,0,0,16,16
2014,Bosnia and Herzegovina,BIH,Belgium,BEL,0,0,0,27,27
2014,Chad,TCD,Belgium,BEL,0,0,0,5,5
2014,China,CHN,Belgium,BEL,0,0,0,16,16
2014,Cameroon,CMR,Belgium,BEL,0,0,0,43,43
2014,Congo,COG,Belgium,BEL,0,0,0,5,5
2014,Dem. Rep. of the Congo,COD,Belgium,BEL,0,0,0,191,191
2014,Djibouti,DJI,Belgium,BEL,0,0,0,10,10
2014,Eritrea,ERI,Belgium,BEL,0,0,0,15,15
2014,Ethiopia,ETH,Belgium,BEL,0,0,0,5,5
2014,Gambia,GMB,Belgium,BEL,0,0,0,13,13
2014,Georgia,GEO,Belgium,BEL,0,0,0,98,98
2014,Ghana,GHA,Belgium,BEL,0,0,0,5,5
2014,Guinea-Bissau,GNB,Belgium,BEL,0,0,0,5,5
2014,Guinea,GIN,Belgium,BEL,0,0,0,444,444
2014,Croatia,HRV,Belgium,BEL,0,0,0,15,15
2014,Cote d'Ivoire,CIV,Belgium,BEL,0,0,0,31,31
2014,India,IND,Belgium,BEL,0,0,0,10,10
2014,Iran (Islamic Rep. of),IRN,Belgium,BEL,0,0,0,79,79
2014,Iraq,IRQ,Belgium,BEL,0,0,0,167,167
2014,Jordan,JOR,Belgium,BEL,0,0,0,5,5
2014,Kazakhstan,KAZ,Belgium,BEL,0,0,0,19,19
2014,Kenya,KEN,Belgium,BEL,0,0,0,5,5
2014,Kyrgyzstan,KGZ,Belgium,BEL,0,0,0,33,33
2014,Liberia,LBR,Belgium,BEL,0,0,0,18,18
2014,Lebanon,LBN,Belgium,BEL,0,0,0,23,23
2014,Sri Lanka,LKA,Belgium,BEL,0,0,0,29,29
2014,Mauritania,MRT,Belgium,BEL,0,0,0,70,70
2014,North Macedonia,MKD,Belgium,BEL,0,0,0,142,142
2014,Rep. of Moldova,MDA,Belgium,BEL,0,0,0,5,5
2014,Mali,MLI,Belgium,BEL,0,0,0,17,17
2014,Mongolia,MNG,Belgium,BEL,0,0,0,5,5
2014,Morocco,MAR,Belgium,BEL,0,0,0,45,45
2014,Myanmar,MMR,Belgium,BEL,0,0,0,10,10
2014,Nepal,NPL,Belgium,BEL,0,0,0,10,10
2014,Niger,NER,Belgium,BEL,0,0,0,15,15
2014,Nigeria,NGA,Belgium,BEL,0,0,0,32,32
2014,Pakistan,PAK,Belgium,BEL,0,0,0,147,147
2014,Russian Federation,RUS,Belgium,BEL,0,0,0,651,651
2014,Rwanda,RWA,Belgium,BEL,0,0,0,45,45
2014,Serbia and Kosovo: S/RES/1244 (1999),SRB,Belgium,BEL,0,0,0,428,428
2014,Senegal,SEN,Belgium,BEL,0,0,0,51,51
2014,Sierra Leone,SLE,Belgium,BEL,0,0,0,39,39
2014,Somalia,SOM,Belgium,BEL,0,0,0,53,53
2014,Sudan,SDN,Belgium,BEL,0,0,0,11,11
2014,Syrian Arab Rep.,SYR,Belgium,BEL,0,0,0,15,15
2014,United Rep. of Tanzania,TZA,Belgium,BEL,0,0,0,18,18
2014,Togo,TGO,Belgium,BEL,0,0,0,45,45
2014,Tunisia,TUN,Belgium,BEL,0,0,0,10,10
2014,Turkey,TUR,Belgium,BEL,0,0,0,107,107
2014,Uganda,UGA,Belgium,BEL,0,0,0,5,5
2014,Ukraine,UKR,Belgium,BEL,0,0,0,26,26
2014,Stateless,XXA,Belgium,BEL,0,0,0,5,5
2014,Afghanistan,AFG,United Kingdom of Great Britain and Northern Ireland,GBR,0,0,5,5,10
2014,Albania,ALB,United Kingdom of Great Britain and Northern Ireland,GBR,0,0,0,5,5
2014,Bangladesh,BGD,United Kingdom of Great Britain and Northern Ireland,GBR,0,0,5,0,5
2014,China,CHN,United Kingdom of Great Britain and Northern Ireland,GBR,0,0,5,0,5
2014,Dem. Rep. of the Congo,COD,United Kingdom of Great Britain and Northern Ireland,GBR,0,5,0,0,5
2014,Eritrea,ERI,United Kingdom of Great Britain and Northern Ireland,GBR,0,5,0,0,5
2014,India,IND,United Kingdom of Great Britain and Northern Ireland,GBR,0,0,0,5,5
2014,Iran (Islamic Rep. of),IRN,United Kingdom of Great Britain and Northern Ireland,GBR,5,0,0,10,15
2014,Iraq,IRQ,United Kingdom of Great Britain and Northern Ireland,GBR,0,0,0,11,11
2014,Lebanon,LBN,United Kingdom of Great Britain and Northern Ireland,GBR,0,0,0,5,5
2014,Sri Lanka,LKA,United Kingdom of Great Britain and Northern Ireland,GBR,0,5,0,0,5
2014,Pakistan,PAK,United Kingdom of Great Britain and Northern Ireland,GBR,0,0,11,23,34
2014,Somalia,SOM,United Kingdom of Great Britain and Northern Ireland,GBR,0,0,0,5,5
2014,Viet Nam,VNM,United Kingdom of Great Britain and Northern Ireland,GBR,0,0,0,5,5
2014,Syrian Arab Rep.,SYR,United Kingdom of Great Britain and Northern Ireland,GBR,5,0,0,0,5
2014,Afghanistan,AFG,Germany,DEU,196,70,15,130,411
2014,Albania,ALB,Germany,DEU,0,5,24,112,141
2014,Algeria,DZA,Germany,DEU,0,0,10,62,72
2014,Egypt,EGY,Germany,DEU,0,0,5,29,34
2014,Armenia,ARM,Germany,DEU,5,0,5,58,68
2014,Azerbaijan,AZE,Germany,DEU,5,5,5,35,50
2014,Bangladesh,BGD,Germany,DEU,5,0,0,13,18
2014,Burkina Faso,BFA,Germany,DEU,0,0,0,10,10
2014,Belarus,BLR,Germany,DEU,0,0,5,10,15
2014,Bosnia and Herzegovina,BIH,Germany,DEU,0,5,367,1735,2107
2014,Bulgaria,BGR,Germany,DEU,0,0,0,10,10
2014,Chad,TCD,Germany,DEU,0,0,0,28,28
2014,China,CHN,Germany,DEU,5,5,5,25,40
2014,Cameroon,CMR,Germany,DEU,0,0,0,13,13
2014,Dem. Rep. of the Congo,COD,Germany,DEU,0,0,0,11,11
2014,Eritrea,ERI,Germany,DEU,5,17,0,15,37
2014,Ethiopia,ETH,Germany,DEU,5,0,0,34,39
2014,Gambia,GMB,Germany,DEU,5,0,0,18,23
2014,Georgia,GEO,Germany,DEU,0,0,21,190,211
2014,Ghana,GHA,Germany,DEU,0,0,0,13,13
2014,Guinea-Bissau,GNB,Germany,DEU,0,0,0,11,11
2014,Guinea,GIN,Germany,DEU,0,5,5,23,33
2014,Croatia,HRV,Germany,DEU,0,0,0,5,5
2014,Hungary,HUN,Germany,DEU,0,0,0,10,10
2014,Cote d'Ivoire,CIV,Germany,DEU,0,0,0,13,13
2014,India,IND,Germany,DEU,0,0,5,25,30
2014,Iran (Islamic Rep. of),IRN,Germany,DEU,162,22,47,78,309
2014,Iraq,IRQ,Germany,DEU,620,22,21,78,741
2014,Israel,ISR,Germany,DEU,0,0,5,0,5
2014,Jordan,JOR,Germany,DEU,0,0,0,10,10
2014,Kazakhstan,KAZ,Germany,DEU,0,0,0,10,10
2014,Kenya,KEN,Germany,DEU,0,0,0,10,10
2014,Kyrgyzstan,KGZ,Germany,DEU,0,0,0,13,13
2014,Liberia,LBR,Germany,DEU,0,0,0,5,5
2014,Libya,LBY,Germany,DEU,0,0,5,12,17
2014,Lebanon,LBN,Germany,DEU,5,5,16,45,71
2014,Sri Lanka,LKA,Germany,DEU,5,5,5,30,45
2014,Mauritania,MRT,Germany,DEU,0,0,0,5,5
2014,North Macedonia,MKD,Germany,DEU,0,10,870,2058,2938
2014,Rep. of Moldova,MDA,Germany,DEU,0,0,0,5,5
2014,Mali,MLI,Germany,DEU,0,0,0,5,5
2014,Mongolia,MNG,Germany,DEU,0,0,0,5,5
2014,Morocco,MAR,Germany,DEU,0,0,10,47,57
2014,Montenegro,MNE,Germany,DEU,0,0,64,163,227
2014,Niger,NER,Germany,DEU,0,0,0,5,5
2014,Nigeria,NGA,Germany,DEU,5,5,5,32,47
2014,Pakistan,PAK,Germany,DEU,32,5,15,91,143
2014,Romania,ROU,Germany,DEU,0,0,5,0,5
2014,Russian Federation,RUS,Germany,DEU,10,65,44,891,1010
2014,Serbia and Kosovo: S/RES/1244 (1999),SRB,Germany,DEU,0,21,1755,7198,8974
2014,Sierra Leone,SLE,Germany,DEU,0,0,0,5,5
2014,Somalia,SOM,Germany,DEU,14,36,5,79,134
2014,Spain,ESP,Germany,DEU,0,0,0,5,5
2014,Viet Nam,VNM,Germany,DEU,0,0,11,34,45
2014,Sudan,SDN,Germany,DEU,0,0,0,13,13
2014,Slovakia,SVK,Germany,DEU,0,0,0,10,10
2014,Syrian Arab Rep.,SYR,Germany,DEU,947,354,10,365,1676
2014,Turkmenistan,TKM,Germany,DEU,0,0,0,5,5
2014,Togo,TGO,Germany,DEU,0,0,0,11,11
2014,Tunisia,TUN,Germany,DEU,0,0,18,59,77
2014,Turkey,TUR,Germany,DEU,5,11,39,115,170
2014,Ukraine,UKR,Germany,DEU,0,0,0,15,15
2014,Stateless,XXA,Germany,DEU,77,26,5,27,135
2014,Albania,ALB,Luxembourg,LUX,0,0,0,26,26
2014,Bosnia and Herzegovina,BIH,Luxembourg,LUX,0,0,0,5,5
2014,Montenegro,MNE,Luxembourg,LUX,0,0,0,10,10
2014,Serbia and Kosovo: S/RES/1244 (1999),SRB,Luxembourg,LUX,0,0,0,27,27
2014,Afghanistan,AFG,Sweden,SWE,5,40,14,18,77
2014,Algeria,DZA,Sweden,SWE,0,0,5,37,42
2014,China,CHN,Sweden,SWE,5,0,0,0,5
2014,Eritrea,ERI,Sweden,SWE,5,0,0,5,10
2014,Iraq,IRQ,Sweden,SWE,0,5,5,0,10
2014,Libya,LBY,Sweden,SWE,0,0,5,12,17
2014,North Macedonia,MKD,Sweden,SWE,0,0,5,0,5
2014,Morocco,MAR,Sweden,SWE,0,0,25,70,95
2014,Montenegro,MNE,Sweden,SWE,0,5,0,0,5
2014,Russian Federation,RUS,Sweden,SWE,0,0,5,0,5
2014,Serbia and Kosovo: S/RES/1244 (1999),SRB,Sweden,SWE,0,0,13,0,13
2014,Somalia,SOM,Sweden,SWE,0,13,5,0,18
2014,Syrian Arab Rep.,SYR,Sweden,SWE,0,12,0,10,22
2014,Tunisia,TUN,Sweden,SWE,0,0,5,5,10
2014,Stateless,XXA,Sweden,SWE,0,0,0,14,14
2015,Afghanistan,AFG,Belgium,BEL,0,0,0,238,238
2015,Albania,ALB,Belgium,BEL,0,0,0,68,68
2015,Algeria,DZA,Belgium,BEL,0,0,0,25,25
2015,Angola,AGO,Belgium,BEL,0,0,0,22,22
2015,Egypt,EGY,Belgium,BEL,0,0,0,26,26
2015,Armenia,ARM,Belgium,BEL,0,0,0,106,106
2015,Azerbaijan,AZE,Belgium,BEL,0,0,0,23,23
2015,Burundi,BDI,Belgium,BEL,0,0,0,5,5
2015,Benin,BEN,Belgium,BEL,0,0,0,14,14
2015,Bangladesh,BGD,Belgium,BEL,0,0,0,69,69
2015,Burkina Faso,BFA,Belgium,BEL,0,0,0,10,10
2015,Belarus,BLR,Belgium,BEL,0,0,0,5,5
2015,Bosnia and Herzegovina,BIH,Belgium,BEL,0,0,0,15,15
2015,Canada,CAN,Belgium,BEL,0,0,0,39,39
2015,China,CHN,Belgium,BEL,0,0,0,167,167
2015,Congo,COG,Belgium,BEL,0,0,0,117,117
2015,Djibouti,DJI,Belgium,BEL,0,0,0,12,12
2015,Eritrea,ERI,Belgium,BEL,0,0,0,22,22
2015,Ethiopia,ETH,Belgium,BEL,0,0,0,13,13
2015,Gambia,GMB,Belgium,BEL,0,0,0,10,10
2015,Georgia,GEO,Belgium,BEL,0,0,0,26,26
2015,Guinea-Bissau,GNB,Belgium,BEL,0,0,0,5,5
2015,Guinea,GIN,Belgium,BEL,0,0,0,183,183
2015,Honduras,HND,Belgium,BEL,0,0,0,5,5
2015,Cote d'Ivoire,CIV,Belgium,BEL,0,0,0,17,17
2015,Indonesia,IDN,Belgium,BEL,0,0,0,17,17
2015,Iran (Islamic Rep. of),IRN,Belgium,BEL,0,0,0,26,26
2015,Iraq,IRQ,Belgium,BEL,0,0,0,106,106
2015,Jamaica,JAM,Belgium,BEL,0,0,0,5,5
2015,Kenya,KEN,Belgium,BEL,0,0,0,5,5
2015,Kyrgyzstan,KGZ,Belgium,BEL,0,0,0,26,26
2015,Liberia,LBR,Belgium,BEL,0,0,0,5,5
2015,Lebanon,LBN,Belgium,BEL,0,0,0,21,21
2015,Sri Lanka,LKA,Belgium,BEL,0,0,0,5,5
2015,Mauritania,MRT,Belgium,BEL,0,0,0,21,21
2015,North Macedonia,MKD,Belgium,BEL,0,0,0,71,71
2015,Mali,MLI,Belgium,BEL,0,0,0,12,12
2015,Morocco,MAR,Belgium,BEL,0,0,0,39,39
2015,Myanmar,MMR,Belgium,BEL,0,0,0,5,5
2015,Nepal,NPL,Belgium,BEL,0,0,0,19,19
2015,Niger,NER,Belgium,BEL,0,0,0,18,18
2015,Nigeria,NGA,Belgium,BEL,0,0,0,17,17
2015,Pakistan,PAK,Belgium,BEL,0,0,0,127,127
2015,Russian Federation,RUS,Belgium,BEL,0,0,0,340,340
2015,Rwanda,RWA,Belgium,BEL,0,0,0,55,55
2015,Serbia and Kosovo: S/RES/1244 (1999),SRB,Belgium,BEL,0,0,0,238,238
2015,Senegal,SEN,Belgium,BEL,0,0,0,33,33
2015,Sierra Leone,SLE,Belgium,BEL,0,0,0,5,5
2015,Somalia,SOM,Belgium,BEL,0,0,0,34,34
2015,Sudan,SDN,Belgium,BEL,0,0,0,14,14
2015,Syrian Arab Rep.,SYR,Belgium,BEL,0,0,0,10,10
2015,United Rep. of Tanzania,TZA,Belgium,BEL,0,0,0,5,5
2015,Togo,TGO,Belgium,BEL,0,0,0,30,30
2015,Tunisia,TUN,Belgium,BEL,0,0,0,17,17
2015,Turkey,TUR,Belgium,BEL,0,0,0,60,60
2015,Uganda,UGA,Belgium,BEL,0,0,0,5,5
2015,Ukraine,UKR,Belgium,BEL,0,0,0,23,23
2015,Stateless,XXA,Belgium,BEL,0,0,0,5,5
2015,Afghanistan,AFG,Finland,FIN,12,0,0,0,12
2015,Albania,ALB,Finland,FIN,0,0,5,0,5
2015,Algeria,DZA,Finland,FIN,0,0,5,0,5
2015,Armenia,ARM,Finland,FIN,0,0,5,0,5
2015,Ghana,GHA,Finland,FIN,0,0,5,0,5
2015,Iran (Islamic Rep. of),IRN,Finland,FIN,0,0,5,0,5
2015,Iraq,IRQ,Finland,FIN,0,5,5,13,23
2015,Nigeria,NGA,Finland,FIN,0,0,5,5,10
2015,Russian Federation,RUS,Finland,FIN,5,0,18,5,28
2015,Serbia and Kosovo: S/RES/1244 (1999),SRB,Finland,FIN,0,0,5,0,5
2015,Somalia,SOM,Finland,FIN,0,0,5,0,5
2015,Stateless,XXA,Finland,FIN,5,0,0,0,5
2015,Afghanistan,AFG,United Kingdom of Great Britain and Northern Ireland,GBR,5,0,0,5,10
2015,Albania,ALB,United Kingdom of Great Britain and Northern Ireland,GBR,0,0,0,5,5
2015,Egypt,EGY,United Kingdom of Great Britain and Northern Ireland,GBR,0,0,5,0,5
2015,Bangladesh,BGD,United Kingdom of Great Britain and Northern Ireland,GBR,0,0,5,0,5
2015,India,IND,United Kingdom of Great Britain and Northern Ireland,GBR,0,0,0,5,5
2015,Iran (Islamic Rep. of),IRN,United Kingdom of Great Britain and Northern Ireland,GBR,0,0,5,5,10
2015,Iraq,IRQ,United Kingdom of Great Britain and Northern Ireland,GBR,0,0,0,5,5
2015,Nigeria,NGA,United Kingdom of Great Britain and Northern Ireland,GBR,0,0,5,0,5
2015,Pakistan,PAK,United Kingdom of Great Britain and Northern Ireland,GBR,0,0,5,0,5
2015,Sudan,SDN,United Kingdom of Great Britain and Northern Ireland,GBR,0,0,5,0,5
2015,Afghanistan,AFG,Germany,DEU,158,133,10,173,474
2015,Albania,ALB,Germany,DEU,0,0,64,422,486
2015,Algeria,DZA,Germany,DEU,0,0,5,102,107
2015,Angola,AGO,Germany,DEU,0,5,0,0,5
2015,Egypt,EGY,Germany,DEU,0,10,0,30,40
2015,Armenia,ARM,Germany,DEU,5,5,5,63,78
2015,Azerbaijan,AZE,Germany,DEU,0,5,5,27,37
2015,Benin,BEN,Germany,DEU,0,0,0,10,10
2015,Bangladesh,BGD,Germany,DEU,5,0,5,14,24
2015,Burkina Faso,BFA,Germany,DEU,0,0,0,15,15
2015,Belarus,BLR,Germany,DEU,0,0,0,10,10
2015,Bosnia and Herzegovina,BIH,Germany,DEU,0,0,259,2340,2599
2015,Chad,TCD,Germany,DEU,0,5,0,39,44
2015,China,CHN,Germany,DEU,0,0,5,13,18
2015,Cameroon,CMR,Germany,DEU,0,0,0,20,20
2015,Dem. Rep. of the Congo,COD,Germany,DEU,0,0,0,5,5
2015,Eritrea,ERI,Germany,DEU,20,19,0,33,72
2015,Ethiopia,ETH,Germany,DEU,0,5,5,18,28
2015,Gambia,GMB,Germany,DEU,0,0,0,15,15
2015,Georgia,GEO,Germany,DEU,0,0,55,288,343
2015,Ghana,GHA,Germany,DEU,0,0,5,24,29
2015,Guinea-Bissau,GNB,Germany,DEU,0,0,0,17,17
2015,Guinea,GIN,Germany,DEU,5,0,5,38,48
2015,Croatia,HRV,Germany,DEU,0,0,5,5,10
2015,Cote d'Ivoire,CIV,Germany,DEU,0,0,0,13,13
2015,India,IND,Germany,DEU,0,0,5,28,33
2015,Iran (Islamic Rep. of),IRN,Germany,DEU,109,17,18,62,206
2015,Iraq,IRQ,Germany,DEU,3778,141,17,121,4057
2015,Jordan,JOR,Germany,DEU,0,0,5,5,10
2015,Kazakhstan,KAZ,Germany,DEU,0,0,0,14,14
2015,Kenya,KEN,Germany,DEU,0,0,0,5,5
2015,Kyrgyzstan,KGZ,Germany,DEU,0,0,0,14,14
2015,Liberia,LBR,Germany,DEU,0,0,0,5,5
2015,Libya,LBY,Germany,DEU,0,0,5,13,18
2015,Lebanon,LBN,Germany,DEU,0,5,19,42,66
2015,Sri Lanka,LKA,Germany,DEU,0,5,0,26,31
2015,Mauritania,MRT,Germany,DEU,0,0,0,16,16
2015,North Macedonia,MKD,Germany,DEU,0,11,616,1947,2574
2015,Mali,MLI,Germany,DEU,0,0,0,22,22
2015,Mongolia,MNG,Germany,DEU,0,0,5,26,31
2015,Morocco,MAR,Germany,DEU,0,0,5,86,91
2015,Montenegro,MNE,Germany,DEU,0,0,80,248,328
2015,Niger,NER,Germany,DEU,0,0,0,17,17
2015,Nigeria,NGA,Germany,DEU,0,5,5,25,35
2015,Pakistan,PAK,Germany,DEU,19,10,12,113,154
2015,Russian Federation,RUS,Germany,DEU,27,92,107,955,1181
2015,Serbia and Kosovo: S/RES/1244 (1999),SRB,Germany,DEU,0,17,2620,8253,10890
2015,Senegal,SEN,Germany,DEU,0,5,0,0,5
2015,Somalia,SOM,Germany,DEU,27,34,5,118,184
2015,Viet Nam,VNM,Germany,DEU,0,5,10,26,41
2015,Sudan,SDN,Germany,DEU,0,10,0,28,38
2015,Syrian Arab Rep.,SYR,Germany,DEU,3482,85,0,116,3683
2015,Tajikistan,TJK,Germany,DEU,0,0,5,14,19
2015,Turkmenistan,TKM,Germany,DEU,0,0,0,5,5
2015,Togo,TGO,Germany,DEU,0,0,0,10,10
2015,Tunisia,TUN,Germany,DEU,0,0,10,64,74
2015,Turkey,TUR,Germany,DEU,23,5,28,93,149
2015,Ukraine,UKR,Germany,DEU,0,0,0,41,41
2015,Yemen,YEM,Germany,DEU,0,5,0,5,10
2015,Stateless,XXA,Germany,DEU,151,0,0,5,156
2015,Albania,ALB,Luxembourg,LUX,0,0,0,19,19
2015,Bosnia and Herzegovina,BIH,Luxembourg,LUX,0,0,0,5,5
2015,Serbia and Kosovo: S/RES/1244 (1999),SRB,Luxembourg,LUX,0,0,0,45,45
2015,Afghanistan,AFG,Netherlands,NLD,125,5,171,0,301
2015,Albania,ALB,Netherlands,NLD,0,0,5,0,5
2015,Algeria,DZA,Netherlands,NLD,0,0,5,0,5
2015,Egypt,EGY,Netherlands,NLD,0,0,26,0,26
2015,Armenia,ARM,Netherlands,NLD,0,0,36,0,36
2015,Azerbaijan,AZE,Netherlands,NLD,0,0,31,0,31
2015,Burundi,BDI,Netherlands,NLD,0,0,15,0,15
2015,Bangladesh,BGD,Netherlands,NLD,0,0,5,0,5
2015,Bosnia and Herzegovina,BIH,Netherlands,NLD,0,0,5,0,5
2015,China,CHN,Netherlands,NLD,0,0,5,0,5
2015,Cameroon,CMR,Netherlands,NLD,5,0,0,0,5
2015,Congo,COG,Netherlands,NLD,5,0,11,0,16
2015,Eritrea,ERI,Netherlands,NLD,12,0,27,0,39
2015,Ethiopia,ETH,Netherlands,NLD,5,0,15,0,20
2015,Gambia,GMB,Netherlands,NLD,0,0,5,0,5
2015,Georgia,GEO,Netherlands,NLD,0,0,10,0,10
2015,Ghana,GHA,Netherlands,NLD,0,0,5,0,5
2015,Guinea,GIN,Netherlands,NLD,15,0,13,0,28
2015,Cote d'Ivoire,CIV,Netherlands,NLD,5,0,5,0,10
2015,Iran (Islamic Rep. of),IRN,Netherlands,NLD,52,0,55,0,107
2015,Iraq,IRQ,Netherlands,NLD,65,5,102,0,172
2015,Jordan,JOR,Netherlands,NLD,0,0,5,0,5
2015,Libya,LBY,Netherlands,NLD,10,0,27,0,37
2015,Lebanon,LBN,Netherlands,NLD,0,0,10,0,10
2015,Sri Lanka,LKA,Netherlands,NLD,5,0,36,0,41
2015,Mali,MLI,Netherlands,NLD,0,0,5,0,5
2015,Mongolia,MNG,Netherlands,NLD,0,0,5,0,5
2015,Morocco,MAR,Netherlands,NLD,0,0,5,0,5
2015,Nepal,NPL,Netherlands,NLD,0,0,10,0,10
2015,Nigeria,NGA,Netherlands,NLD,5,0,26,0,31
2015,Pakistan,PAK,Netherlands,NLD,14,0,38,0,52
2015,Russian Federation,RUS,Netherlands,NLD,5,0,33,0,38
2015,Rwanda,RWA,Netherlands,NLD,0,0,5,0,5
2015,Serbia and Kosovo: S/RES/1244 (1999),SRB,Netherlands,NLD,0,0,11,0,11
2015,Sierra Leone,SLE,Netherlands,NLD,19,0,26,0,45
2015,Somalia,SOM,Netherlands,NLD,61,0,88,0,149
2015,Sudan,SDN,Netherlands,NLD,10,0,15,0,25
2015,Syrian Arab Rep.,SYR,Netherlands,NLD,10,0,28,0,38
2015,Tunisia,TUN,Netherlands,NLD,0,0,5,0,5
2015,Turkey,TUR,Netherlands,NLD,0,0,14,0,14
2015,Uganda,UGA,Netherlands,NLD,10,0,10,0,20
2015,Ukraine,UKR,Netherlands,NLD,0,0,34,0,34
2015,Zimbabwe,ZWE,Netherlands,NLD,0,0,5,0,5
2015,Stateless,XXA,Netherlands,NLD,10,0,19,0,29
2015,Afghanistan,AFG,Norway,NOR,0,0,18,26,44
2015,Azerbaijan,AZE,Norway,NOR,0,0,5,0,5
2015,Bangladesh,BGD,Norway,NOR,0,0,0,5,5
2015,Belarus,BLR,Norway,NOR,0,0,5,0,5
2015,Bosnia and Herzegovina,BIH,Norway,NOR,0,0,5,0,5
2015,Congo,COG,Norway,NOR,0,0,13,0,13
2015,Eritrea,ERI,Norway,NOR,50,0,5,75,130
2015,Ethiopia,ETH,Norway,NOR,0,0,0,5,5
2015,Gambia,GMB,Norway,NOR,0,0,0,5,5
2015,Iran (Islamic Rep. of),IRN,Norway,NOR,0,0,0,10,10
2015,Iraq,IRQ,Norway,NOR,0,0,5,15,20
2015,Libya,LBY,Norway,NOR,0,0,0,10,10
2015,Sri Lanka,LKA,Norway,NOR,0,0,5,0,5
2015,Morocco,MAR,Norway,NOR,0,0,0,5,5
2015,Montenegro,MNE,Norway,NOR,0,0,5,5,10
2015,Myanmar,MMR,Norway,NOR,0,0,0,5,5
2015,Nigeria,NGA,Norway,NOR,0,0,15,5,20
2015,Pakistan,PAK,Norway,NOR,0,0,0,5,5
2015,Russian Federation,RUS,Norway,NOR,0,0,18,5,23
2015,Serbia and Kosovo: S/RES/1244 (1999),SRB,Norway,NOR,0,0,0,10,10
2015,Somalia,SOM,Norway,NOR,5,0,23,42,70
2015,Sudan,SDN,Norway,NOR,0,0,0,11,11
2015,Syrian Arab Rep.,SYR,Norway,NOR,12,0,0,0,12
2015,Tajikistan,TJK,Norway,NOR,0,0,5,0,5
2015,Tunisia,TUN,Norway,NOR,0,0,0,5,5
2015,Turkey,TUR,Norway,NOR,0,0,5,0,5
2015,Uganda,UGA,Norway,NOR,0,0,5,0,5
2015,Uzbekistan,UZB,Norway,NOR,0,0,5,5,10
2015,Stateless,XXA,Norway,NOR,0,0,0,12,12
2015,Afghanistan,AFG,Sweden,SWE,47,19,27,41,134
2015,Albania,ALB,Sweden,SWE,0,0,28,21,49
2015,Algeria,DZA,Sweden,SWE,0,0,20,44,64
2015,Angola,AGO,Sweden,SWE,0,5,0,0,5
2015,Egypt,EGY,Sweden,SWE,0,0,13,5,18
2015,Armenia,ARM,Sweden,SWE,0,13,18,18,49
2015,Azerbaijan,AZE,Sweden,SWE,0,10,12,22,44
2015,Burundi,BDI,Sweden,SWE,0,5,0,0,5
2015,Bangladesh,BGD,Sweden,SWE,0,14,0,0,14
2015,Belarus,BLR,Sweden,SWE,0,5,14,25,44
2015,Bolivia (Plurinational State of),BOL,Sweden,SWE,0,0,5,5,10
2015,Bosnia and Herzegovina,BIH,Sweden,SWE,0,5,20,13,38
2015,China,CHN,Sweden,SWE,5,0,0,0,5
2015,Chile,CHL,Sweden,SWE,0,0,5,0,5
2015,Dem. Rep. of the Congo,COD,Sweden,SWE,0,5,5,0,10
2015,Cuba,CUB,Sweden,SWE,0,0,11,0,11
2015,Eritrea,ERI,Sweden,SWE,179,15,0,242,436
2015,Ethiopia,ETH,Sweden,SWE,5,10,20,12,47
2015,Gambia,GMB,Sweden,SWE,0,0,5,0,5
2015,Palestinian,PSE,Sweden,SWE,0,11,10,5,26
2015,Georgia,GEO,Sweden,SWE,0,5,38,38,81
2015,Ghana,GHA,Sweden,SWE,0,0,0,5,5
2015,Guinea,GIN,Sweden,SWE,0,0,5,5,10
2015,Croatia,HRV,Sweden,SWE,0,0,11,0,11
2015,Cote d'Ivoire,CIV,Sweden,SWE,0,0,5,0,5
2015,India,IND,Sweden,SWE,0,5,0,0,5
2015,Iran (Islamic Rep. of),IRN,Sweden,SWE,38,13,24,22,97
2015,Iraq,IRQ,Sweden,SWE,102,147,197,109,555
2015,Israel,ISR,Sweden,SWE,0,5,0,0,5
2015,Jordan,JOR,Sweden,SWE,0,0,5,15,20
2015,Japan,JPN,Sweden,SWE,0,0,0,5,5
2015,Kazakhstan,KAZ,Sweden,SWE,0,5,18,12,35
2015,Kenya,KEN,Sweden,SWE,0,0,5,5,10
2015,Kyrgyzstan,KGZ,Sweden,SWE,0,0,10,0,10
2015,Libya,LBY,Sweden,SWE,5,5,16,43,69
2015,Lebanon,LBN,Sweden,SWE,0,23,42,5,70
2015,Sri Lanka,LKA,Sweden,SWE,0,0,0,5,5
2015,North Macedonia,MKD,Sweden,SWE,0,0,14,22,36
2015,Rep. of Moldova,MDA,Sweden,SWE,0,0,5,0,5
2015,Mongolia,MNG,Sweden,SWE,0,23,51,14,88
2015,Morocco,MAR,Sweden,SWE,0,5,34,85,124
2015,Montenegro,MNE,Sweden,SWE,0,0,11,5,16
2015,Nigeria,NGA,Sweden,SWE,0,5,0,15,20
2015,Pakistan,PAK,Sweden,SWE,0,0,0,10,10
2015,Poland,POL,Sweden,SWE,0,0,5,0,5
2015,Russian Federation,RUS,Sweden,SWE,5,18,48,37,108
2015,El Salvador,SLV,Sweden,SWE,0,0,5,11,16
2015,Serbia and Kosovo: S/RES/1244 (1999),SRB,Sweden,SWE,0,52,304,209,565
2015,Somalia,SOM,Sweden,SWE,52,32,87,623,794
2015,Viet Nam,VNM,Sweden,SWE,0,5,12,0,17
2015,Sudan,SDN,Sweden,SWE,5,0,5,10,20
2015,Slovenia,SVN,Sweden,SWE,0,0,5,0,5
2015,Syrian Arab Rep.,SYR,Sweden,SWE,24,235,0,74,333
2015,United Rep. of Tanzania,TZA,Sweden,SWE,0,0,0,5,5
2015,Tajikistan,TJK,Sweden,SWE,0,0,5,0,5
2015,Turkmenistan,TKM,Sweden,SWE,0,0,0,5,5
2015,Tunisia,TUN,Sweden,SWE,0,5,5,25,35
2015,Turkey,TUR,Sweden,SWE,0,5,13,0,18
2015,Uganda,UGA,Sweden,SWE,0,5,0,0,5
2015,Ukraine,UKR,Sweden,SWE,0,5,20,20,45
2015,Uzbekistan,UZB,Sweden,SWE,11,5,12,5,33
2015,Yemen,YEM,Sweden,SWE,5,13,5,0,23
2015,Stateless,XXA,Sweden,SWE,41,53,18,49,161
2016,Iran (Islamic Rep. of),IRN,Armenia,ARM,0,0,5,0,5
2016,Afghanistan,AFG,Belgium,BEL,0,0,0,381,381
2016,Albania,ALB,Belgium,BEL,0,0,0,133,133
2016,Algeria,DZA,Belgium,BEL,0,0,0,13,13
2016,Angola,AGO,Belgium,BEL,0,0,0,15,15
2016,Egypt,EGY,Belgium,BEL,0,0,0,16,16
2016,Armenia,ARM,Belgium,BEL,0,0,0,63,63
2016,Azerbaijan,AZE,Belgium,BEL,0,0,0,11,11
2016,Burundi,BDI,Belgium,BEL,0,0,0,5,5
2016,Benin,BEN,Belgium,BEL,0,0,0,11,11
2016,Bangladesh,BGD,Belgium,BEL,0,0,0,36,36
2016,Burkina Faso,BFA,Belgium,BEL,0,0,0,10,10
2016,Belarus,BLR,Belgium,BEL,0,0,0,5,5
2016,Bosnia and Herzegovina,BIH,Belgium,BEL,0,0,0,22,22
2016,Chad,TCD,Belgium,BEL,0,0,0,5,5
2016,China,CHN,Belgium,BEL,0,0,0,188,188
2016,Cameroon,CMR,Belgium,BEL,0,0,0,22,22
2016,Congo,COG,Belgium,BEL,0,0,0,5,5
2016,Dem. Rep. of the Congo,COD,Belgium,BEL,0,0,0,74,74
2016,Djibouti,DJI,Belgium,BEL,0,0,0,17,17
2016,Dominican Rep.,DOM,Belgium,BEL,0,0,0,5,5
2016,Eritrea,ERI,Belgium,BEL,0,0,0,19,19
2016,Ethiopia,ETH,Belgium,BEL,0,0,0,12,12
2016,Gambia,GMB,Belgium,BEL,0,0,0,10,10
2016,Georgia,GEO,Belgium,BEL,0,0,0,36,36
2016,Ghana,GHA,Belgium,BEL,0,0,0,12,12
2016,Guinea,GIN,Belgium,BEL,0,0,0,110,110
2016,Cote d'Ivoire,CIV,Belgium,BEL,0,0,0,11,11
2016,India,IND,Belgium,BEL,0,0,0,10,10
2016,Iran (Islamic Rep. of),IRN,Belgium,BEL,0,0,0,17,17
2016,Iraq,IRQ,Belgium,BEL,0,0,0,135,135
2016,Kenya,KEN,Belgium,BEL,0,0,0,10,10
2016,Kyrgyzstan,KGZ,Belgium,BEL,0,0,0,5,5
2016,Lebanon,LBN,Belgium,BEL,0,0,0,23,23
2016,Mauritania,MRT,Belgium,BEL,0,0,0,30,30
2016,North Macedonia,MKD,Belgium,BEL,0,0,0,55,55
2016,Mexico,MEX,Belgium,BEL,0,0,0,5,5
2016,Mali,MLI,Belgium,BEL,0,0,0,12,12
2016,Morocco,MAR,Belgium,BEL,0,0,0,44,44
2016,Montenegro,MNE,Belgium,BEL,0,0,0,5,5
2016,Nepal,NPL,Belgium,BEL,0,0,0,13,13
2016,Niger,NER,Belgium,BEL,0,0,0,10,10
2016,Nigeria,NGA,Belgium,BEL,0,0,0,22,22
2016,Pakistan,PAK,Belgium,BEL,0,0,0,89,89
2016,Russian Federation,RUS,Belgium,BEL,0,0,0,234,234
2016,Rwanda,RWA,Belgium,BEL,0,0,0,42,42
2016,Serbia and Kosovo: S/RES/1244 (1999),SRB,Belgium,BEL,0,0,0,184,184
2016,Senegal,SEN,Belgium,BEL,0,0,0,29,29
2016,Sierra Leone,SLE,Belgium,BEL,0,0,0,5,5
2016,Somalia,SOM,Belgium,BEL,0,0,0,95,95
2016,Sudan,SDN,Belgium,BEL,0,0,0,15,15
2016,Syrian Arab Rep.,SYR,Belgium,BEL,0,0,0,20,20
2016,United Rep. of Tanzania,TZA,Belgium,BEL,0,0,0,13,13
2016,Togo,TGO,Belgium,BEL,0,0,0,14,14
2016,Tunisia,TUN,Belgium,BEL,0,0,0,12,12
2016,Turkey,TUR,Belgium,BEL,0,0,0,18,18
2016,Uganda,UGA,Belgium,BEL,0,0,0,5,5
2016,Ukraine,UKR,Belgium,BEL,0,0,0,32,32
2016,Zimbabwe,ZWE,Belgium,BEL,0,0,0,5,5
2016,Egypt,EGY,Cyprus,CYP,0,0,5,0,5
2016,Georgia,GEO,Cyprus,CYP,0,0,5,0,5
2016,India,IND,Cyprus,CYP,0,0,5,0,5
2016,Iran (Islamic Rep. of),IRN,Cyprus,CYP,0,0,16,15,31
2016,Iraq,IRQ,Cyprus,CYP,0,0,0,5,5
2016,Sri Lanka,LKA,Cyprus,CYP,0,0,0,5,5
2016,Pakistan,PAK,Cyprus,CYP,0,0,0,5,5
2016,Sierra Leone,SLE,Cyprus,CYP,5,0,0,0,5
2016,Viet Nam,VNM,Cyprus,CYP,0,0,5,0,5
2016,Syrian Arab Rep.,SYR,Cyprus,CYP,5,34,5,15,59
2016,Turkey,TUR,Cyprus,CYP,0,0,0,5,5
2016,Afghanistan,AFG,Finland,FIN,5,0,16,19,40
2016,Dem. Rep. of the Congo,COD,Finland,FIN,0,0,0,5,5
2016,Ethiopia,ETH,Finland,FIN,0,0,0,5,5
2016,Gambia,GMB,Finland,FIN,0,0,0,5,5
2016,Iran (Islamic Rep. of),IRN,Finland,FIN,0,0,0,5,5
2016,Iraq,IRQ,Finland,FIN,14,0,56,85,155
2016,Morocco,MAR,Finland,FIN,0,0,0,5,5
2016,Nigeria,NGA,Finland,FIN,0,0,5,5,10
2016,Russian Federation,RUS,Finland,FIN,0,0,10,20,30
2016,Serbia and Kosovo: S/RES/1244 (1999),SRB,Finland,FIN,0,0,11,0,11
2016,Somalia,SOM,Finland,FIN,0,0,0,5,5
2016,Turkey,TUR,Finland,FIN,0,0,5,0,5
2016,Ukraine,UKR,Finland,FIN,0,0,0,10,10
2016,Afghanistan,AFG,France,FRA,5,5,10,0,20
2016,Albania,ALB,France,FRA,0,10,119,310,439
2016,Algeria,DZA,France,FRA,0,0,5,18,23
2016,Angola,AGO,France,FRA,0,0,5,16,21
2016,Egypt,EGY,France,FRA,0,0,30,13,43
2016,Armenia,ARM,France,FRA,5,5,70,135,215
2016,Azerbaijan,AZE,France,FRA,5,0,17,76,98
2016,Bangladesh,BGD,France,FRA,14,0,138,643,795
2016,Belarus,BLR,France,FRA,0,0,0,10,10
2016,Bosnia and Herzegovina,BIH,France,FRA,0,0,10,35,45
2016,Chad,TCD,France,FRA,0,0,10,5,15
2016,China,CHN,France,FRA,0,0,5,12,17
2016,Cameroon,CMR,France,FRA,0,0,5,5,10
2016,Congo,COG,France,FRA,0,0,10,18,28
2016,Dem. Rep. of the Congo,COD,France,FRA,15,0,89,221,325
2016,Eritrea,ERI,France,FRA,0,0,5,0,5
2016,Georgia,GEO,France,FRA,0,0,55,137,192
2016,Guinea-Bissau,GNB,France,FRA,0,0,0,5,5
2016,Guinea,GIN,France,FRA,0,0,29,70,99
2016,Haiti,HTI,France,FRA,0,0,20,54,74
2016,Cote d'Ivoire,CIV,France,FRA,0,0,17,17,34
2016,India,IND,France,FRA,0,0,0,5,5
2016,Iran (Islamic Rep. of),IRN,France,FRA,5,0,5,0,10
2016,Iraq,IRQ,France,FRA,0,5,0,0,5
2016,Kazakhstan,KAZ,France,FRA,0,5,5,11,21
2016,Kyrgyzstan,KGZ,France,FRA,0,0,0,5,5
2016,Dem. People's Rep. of Korea,PRK,France,FRA,0,0,5,0,5
2016,Sri Lanka,LKA,France,FRA,23,0,105,1012,1140
2016,Mauritania,MRT,France,FRA,5,0,31,128,164
2016,North Macedonia,MKD,France,FRA,0,0,5,17,22
2016,Mali,MLI,France,FRA,0,5,5,23,33
2016,Mongolia,MNG,France,FRA,0,0,12,5,17
2016,Morocco,MAR,France,FRA,0,0,0,5,5
2016,Montenegro,MNE,France,FRA,0,0,0,15,15
2016,Myanmar,MMR,France,FRA,0,0,10,30,40
2016,Nepal,NPL,France,FRA,0,0,0,12,12
2016,Nigeria,NGA,France,FRA,5,0,35,45,85
2016,Pakistan,PAK,France,FRA,0,0,19,47,66
2016,Russian Federation,RUS,France,FRA,36,5,191,434,666
2016,Rwanda,RWA,France,FRA,0,0,12,0,12
2016,Serbia and Kosovo: S/RES/1244 (1999),SRB,France,FRA,13,10,128,368,519
2016,Senegal,SEN,France,FRA,0,0,5,0,5
2016,Sierra Leone,SLE,France,FRA,0,0,5,0,5
2016,Somalia,SOM,France,FRA,0,14,0,0,14
2016,Sudan,SDN,France,FRA,0,0,23,5,28
2016,Syrian Arab Rep.,SYR,France,FRA,0,5,0,0,5
2016,Togo,TGO,France,FRA,0,0,0,5,5
2016,Turkey,TUR,France,FRA,27,0,162,157,346
2016,Ukraine,UKR,France,FRA,5,0,20,36,61
2016,Uzbekistan,UZB,France,FRA,0,0,0,5,5
2016,Western Sahara,ESH,France,FRA,0,0,5,5,10
2016,Afghanistan,AFG,United Kingdom of Great Britain and Northern Ireland,GBR,0,0,0,5,5
2016,Angola,AGO,United Kingdom of Great Britain and Northern Ireland,GBR,0,0,0,5,5
2016,China,CHN,United Kingdom of Great Britain and Northern Ireland,GBR,0,0,0,5,5
2016,Cote d'Ivoire,CIV,United Kingdom of Great Britain and Northern Ireland,GBR,0,0,0,5,5
2016,Iran (Islamic Rep. of),IRN,United Kingdom of Great Britain and Northern Ireland,GBR,0,0,0,5,5
2016,Iraq,IRQ,United Kingdom of Great Britain and Northern Ireland,GBR,0,0,0,12,12
2016,Pakistan,PAK,United Kingdom of Great Britain and Northern Ireland,GBR,0,0,0,5,5
2016,Serbia and Kosovo: S/RES/1244 (1999),SRB,United Kingdom of Great Britain and Northern Ireland,GBR,0,0,5,0,5
2016,Viet Nam,VNM,United Kingdom of Great Britain and Northern Ireland,GBR,0,0,13,0,13
2016,Sudan,SDN,United Kingdom of Great Britain and Northern Ireland,GBR,0,0,5,0,5
2016,Afghanistan,AFG,Germany,DEU,166,169,83,447,865
2016,Albania,ALB,Germany,DEU,0,12,339,2084,2435
2016,Algeria,DZA,Germany,DEU,0,0,76,209,285
2016,Egypt,EGY,Germany,DEU,5,10,19,101,135
2016,Armenia,ARM,Germany,DEU,5,5,65,147,222
2016,Azerbaijan,AZE,Germany,DEU,12,10,44,90,156
2016,Benin,BEN,Germany,DEU,0,0,0,20,20
2016,Bangladesh,BGD,Germany,DEU,5,0,5,28,38
2016,Burkina Faso,BFA,Germany,DEU,0,0,0,26,26
2016,Belarus,BLR,Germany,DEU,0,0,0,20,20
2016,Bosnia and Herzegovina,BIH,Germany,DEU,0,5,361,1931,2297
2016,Bulgaria,BGR,Germany,DEU,0,0,0,5,5
2016,Chad,TCD,Germany,DEU,0,10,5,22,37
2016,China,CHN,Germany,DEU,5,5,5,26,41
2016,Cameroon,CMR,Germany,DEU,0,0,5,32,37
2016,Congo,COG,Germany,DEU,0,5,0,0,5
2016,Dem. Rep. of the Congo,COD,Germany,DEU,0,0,0,13,13
2016,Czechia,CZE,Germany,DEU,0,0,0,5,5
2016,Eritrea,ERI,Germany,DEU,98,33,0,90,221
2016,Ethiopia,ETH,Germany,DEU,0,5,12,29,46
2016,Gambia,GMB,Germany,DEU,0,0,5,40,45
2016,Georgia,GEO,Germany,DEU,5,10,99,315,429
2016,Ghana,GHA,Germany,DEU,0,0,10,39,49
2016,Guinea-Bissau,GNB,Germany,DEU,0,0,0,58,58
2016,Guinea,GIN,Germany,DEU,0,5,10,51,66
2016,Croatia,HRV,Germany,DEU,0,0,0,11,11
2016,Cote d'Ivoire,CIV,Germany,DEU,0,0,5,15,20
2016,India,IND,Germany,DEU,0,0,10,47,57
2016,Iran (Islamic Rep. of),IRN,Germany,DEU,155,43,106,201,505
2016,Iraq,IRQ,Germany,DEU,652,212,174,405,1443
2016,Jordan,JOR,Germany,DEU,0,0,5,12,17
2016,Kazakhstan,KAZ,Germany,DEU,0,0,0,18,18
2016,Kenya,KEN,Germany,DEU,0,0,0,13,13
2016,Kyrgyzstan,KGZ,Germany,DEU,0,0,0,5,5
2016,Liberia,LBR,Germany,DEU,0,0,0,5,5
2016,Libya,LBY,Germany,DEU,5,0,10,32,47
2016,Lebanon,LBN,Germany,DEU,5,10,68,96,179
2016,Sri Lanka,LKA,Germany,DEU,5,0,5,40,50
2016,Mauritania,MRT,Germany,DEU,0,0,0,12,12
2016,North Macedonia,MKD,Germany,DEU,0,10,1360,3917,5287
2016,Rep. of Moldova,MDA,Germany,DEU,0,0,10,62,72
2016,Mali,MLI,Germany,DEU,0,0,5,29,34
2016,Mongolia,MNG,Germany,DEU,0,0,0,39,39
2016,Morocco,MAR,Germany,DEU,5,5,32,141,183
2016,Montenegro,MNE,Germany,DEU,0,5,136,287,428
2016,Niger,NER,Germany,DEU,0,0,5,31,36
2016,Nigeria,NGA,Germany,DEU,5,10,12,71,98
2016,Pakistan,PAK,Germany,DEU,12,10,92,1749,1863
2016,Romania,ROU,Germany,DEU,0,0,0,5,5
2016,Russian Federation,RUS,Germany,DEU,32,56,253,1392,1733
2016,Serbia and Kosovo: S/RES/1244 (1999),SRB,Germany,DEU,0,43,3190,9567,12800
2016,Senegal,SEN,Germany,DEU,0,0,5,14,19
2016,Sierra Leone,SLE,Germany,DEU,0,0,5,5,10
2016,Somalia,SOM,Germany,DEU,38,297,12,201,548
2016,Viet Nam,VNM,Germany,DEU,0,5,11,60,76
2016,Sudan,SDN,Germany,DEU,5,0,0,30,35
2016,South Sudan,SSD,Germany,DEU,0,0,0,5,5
2016,Syrian Arab Rep.,SYR,Germany,DEU,1594,1290,10,482,3376
2016,United Rep. of Tanzania,TZA,Germany,DEU,0,0,5,0,5
2016,Tajikistan,TJK,Germany,DEU,0,0,0,15,15
2016,Turkmenistan,TKM,Germany,DEU,0,0,0,14,14
2016,Togo,TGO,Germany,DEU,0,0,0,5,5
2016,Tunisia,TUN,Germany,DEU,0,0,31,187,218
2016,Turkey,TUR,Germany,DEU,5,0,62,128,195
2016,Uganda,UGA,Germany,DEU,0,0,0,5,5
2016,Ukraine,UKR,Germany,DEU,0,0,20,93,113
2016,Yemen,YEM,Germany,DEU,0,33,0,0,33
2016,Stateless,XXA,Germany,DEU,39,22,5,13,79
2016,Albania,ALB,Luxembourg,LUX,0,0,0,10,10
2016,Azerbaijan,AZE,Luxembourg,LUX,0,0,0,10,10
2016,Bosnia and Herzegovina,BIH,Luxembourg,LUX,0,0,0,5,5
2016,Montenegro,MNE,Luxembourg,LUX,0,0,0,5,5
2016,Serbia and Kosovo: S/RES/1244 (1999),SRB,Luxembourg,LUX,0,0,0,14,14
2016,Afghanistan,AFG,Netherlands,NLD,57,0,155,11,223
2016,Albania,ALB,Netherlands,NLD,0,0,10,11,21
2016,Algeria,DZA,Netherlands,NLD,0,0,5,0,5
2016,Egypt,EGY,Netherlands,NLD,0,0,21,0,21
2016,Armenia,ARM,Netherlands,NLD,5,0,18,5,28
2016,Azerbaijan,AZE,Netherlands,NLD,0,0,10,0,10
2016,Burundi,BDI,Netherlands,NLD,0,0,12,0,12
2016,Bangladesh,BGD,Netherlands,NLD,0,0,5,0,5
2016,Belarus,BLR,Netherlands,NLD,0,0,5,0,5
2016,China,CHN,Netherlands,NLD,0,0,5,0,5
2016,Cameroon,CMR,Netherlands,NLD,5,0,0,0,5
2016,Congo,COG,Netherlands,NLD,5,0,18,0,23
2016,Eritrea,ERI,Netherlands,NLD,16,0,24,16,56
2016,Ethiopia,ETH,Netherlands,NLD,12,0,11,0,23
2016,Georgia,GEO,Netherlands,NLD,0,0,10,5,15
2016,Ghana,GHA,Netherlands,NLD,0,0,5,0,5
2016,Guinea,GIN,Netherlands,NLD,11,0,19,0,30
2016,Cote d'Ivoire,CIV,Netherlands,NLD,0,0,5,0,5
2016,India,IND,Netherlands,NLD,0,0,5,0,5
2016,Iran (Islamic Rep. of),IRN,Netherlands,NLD,28,0,52,5,85
2016,Iraq,IRQ,Netherlands,NLD,123,0,217,19,359
2016,Jamaica,JAM,Netherlands,NLD,0,0,5,0,5
2016,Kyrgyzstan,KGZ,Netherlands,NLD,0,0,5,0,5
2016,Libya,LBY,Netherlands,NLD,0,0,13,5,18
2016,Sri Lanka,LKA,Netherlands,NLD,0,0,30,0,30
2016,North Macedonia,MKD,Netherlands,NLD,0,0,0,5,5
2016,Morocco,MAR,Netherlands,NLD,0,0,5,5,10
2016,Nepal,NPL,Netherlands,NLD,0,0,5,0,5
2016,Nigeria,NGA,Netherlands,NLD,15,0,45,0,60
2016,Pakistan,PAK,Netherlands,NLD,5,0,11,0,16
2016,Russian Federation,RUS,Netherlands,NLD,0,0,10,0,10
2016,Rwanda,RWA,Netherlands,NLD,0,0,5,0,5
2016,Serbia and Kosovo: S/RES/1244 (1999),SRB,Netherlands,NLD,0,0,0,10,10
2016,Sierra Leone,SLE,Netherlands,NLD,16,0,16,0,32
2016,Somalia,SOM,Netherlands,NLD,33,0,56,0,89
2016,Sudan,SDN,Netherlands,NLD,5,0,14,5,24
2016,Syrian Arab Rep.,SYR,Netherlands,NLD,11,0,5,25,41
2016,Tajikistan,TJK,Netherlands,NLD,5,0,0,0,5
2016,Tunisia,TUN,Netherlands,NLD,5,0,0,0,5
2016,Turkey,TUR,Netherlands,NLD,0,0,0,5,5
2016,Uganda,UGA,Netherlands,NLD,0,0,5,0,5
2016,Ukraine,UKR,Netherlands,NLD,0,0,20,0,20
2016,Stateless,XXA,Netherlands,NLD,5,0,11,0,16
2016,Afghanistan,AFG,Norway,NOR,0,0,16,20,36
2016,Albania,ALB,Norway,NOR,0,0,5,0,5
2016,Algeria,DZA,Norway,NOR,0,0,0,5,5
2016,Azerbaijan,AZE,Norway,NOR,0,0,0,5,5
2016,Eritrea,ERI,Norway,NOR,52,0,11,20,83
2016,Ethiopia,ETH,Norway,NOR,5,0,14,0,19
2016,Gambia,GMB,Norway,NOR,0,0,5,0,5
2016,Iran (Islamic Rep. of),IRN,Norway,NOR,0,0,21,10,31
2016,Iraq,IRQ,Norway,NOR,0,0,38,15,53
2016,Jordan,JOR,Norway,NOR,0,0,0,5,5
2016,Libya,LBY,Norway,NOR,0,5,0,5,10
2016,Morocco,MAR,Norway,NOR,0,0,0,5,5
2016,Nigeria,NGA,Norway,NOR,0,0,5,0,5
2016,Russian Federation,RUS,Norway,NOR,0,0,5,11,16
2016,Serbia and Kosovo: S/RES/1244 (1999),SRB,Norway,NOR,0,0,5,5,10
2016,Somalia,SOM,Norway,NOR,0,0,22,12,34
2016,Sudan,SDN,Norway,NOR,5,0,5,0,10
2016,Syrian Arab Rep.,SYR,Norway,NOR,12,0,0,12,24
2016,Turkey,TUR,Norway,NOR,0,0,0,5,5
2016,Uzbekistan,UZB,Norway,NOR,13,0,0,0,13
2016,Yemen,YEM,Norway,NOR,5,0,0,0,5
2016,Stateless,XXA,Norway,NOR,5,0,0,0,5
2016,Afghanistan,AFG,Sweden,SWE,69,28,122,158,377
2016,Albania,ALB,Sweden,SWE,0,5,41,16,62
2016,Algeria,DZA,Sweden,SWE,0,0,47,38,85
2016,Angola,AGO,Sweden,SWE,0,5,5,0,10
2016,Egypt,EGY,Sweden,SWE,5,5,27,10,47
2016,Armenia,ARM,Sweden,SWE,0,15,63,14,92
2016,Azerbaijan,AZE,Sweden,SWE,5,38,74,17,134
2016,Burundi,BDI,Sweden,SWE,0,5,0,0,5
2016,Benin,BEN,Sweden,SWE,0,0,5,0,5
2016,Bangladesh,BGD,Sweden,SWE,0,0,15,10,25
2016,Belarus,BLR,Sweden,SWE,0,10,32,33,75
2016,Bolivia (Plurinational State of),BOL,Sweden,SWE,0,0,22,0,22
2016,Bosnia and Herzegovina,BIH,Sweden,SWE,0,0,34,10,44
2016,Chad,TCD,Sweden,SWE,0,0,0,5,5
2016,China,CHN,Sweden,SWE,0,0,5,0,5
2016,Chile,CHL,Sweden,SWE,0,0,5,0,5
2016,Congo,COG,Sweden,SWE,0,0,0,5,5
2016,Dem. Rep. of the Congo,COD,Sweden,SWE,0,0,11,0,11
2016,Colombia,COL,Sweden,SWE,0,0,5,0,5
2016,Cuba,CUB,Sweden,SWE,0,0,17,5,22
2016,Djibouti,DJI,Sweden,SWE,5,0,10,0,15
2016,Eritrea,ERI,Sweden,SWE,335,261,10,186,792
2016,Ethiopia,ETH,Sweden,SWE,23,13,82,25,143
2016,Gambia,GMB,Sweden,SWE,0,0,0,5,5
2016,Palestinian,PSE,Sweden,SWE,5,12,13,0,30
2016,Georgia,GEO,Sweden,SWE,0,5,78,50,133
2016,Ghana,GHA,Sweden,SWE,0,0,0,5,5
2016,Guinea,GIN,Sweden,SWE,0,0,10,0,10
2016,Cote d'Ivoire,CIV,Sweden,SWE,0,0,5,0,5
2016,India,IND,Sweden,SWE,0,0,15,5,20
2016,Indonesia,IDN,Sweden,SWE,0,0,5,0,5
2016,Iran (Islamic Rep. of),IRN,Sweden,SWE,149,28,113,36,326
2016,Iraq,IRQ,Sweden,SWE,73,156,350,248,827
2016,Israel,ISR,Sweden,SWE,0,5,5,0,10
2016,Jordan,JOR,Sweden,SWE,5,11,53,21,90
2016,Kazakhstan,KAZ,Sweden,SWE,0,13,52,27,92
2016,Kenya,KEN,Sweden,SWE,5,0,27,5,37
2016,Kyrgyzstan,KGZ,Sweden,SWE,0,10,36,13,59
2016,Libya,LBY,Sweden,SWE,10,0,54,27,91
2016,Lebanon,LBN,Sweden,SWE,5,24,54,17,100
2016,Sri Lanka,LKA,Sweden,SWE,0,5,10,0,15
2016,North Macedonia,MKD,Sweden,SWE,0,0,33,13,46
2016,Rep. of Moldova,MDA,Sweden,SWE,0,0,5,0,5
2016,Mongolia,MNG,Sweden,SWE,0,26,253,15,294
2016,Morocco,MAR,Sweden,SWE,0,0,37,71,108
2016,Montenegro,MNE,Sweden,SWE,0,0,5,0,5
2016,Nepal,NPL,Sweden,SWE,0,0,11,0,11
2016,Nigeria,NGA,Sweden,SWE,5,5,36,13,59
2016,Pakistan,PAK,Sweden,SWE,0,0,25,5,30
2016,Romania,ROU,Sweden,SWE,0,0,0,5,5
2016,South Africa,ZAF,Sweden,SWE,0,0,5,0,5
2016,Russian Federation,RUS,Sweden,SWE,10,33,125,35,203
2016,El Salvador,SLV,Sweden,SWE,0,5,15,0,20
2016,Serbia and Kosovo: S/RES/1244 (1999),SRB,Sweden,SWE,0,27,270,94,391
2016,Senegal,SEN,Sweden,SWE,0,0,5,0,5
2016,Sierra Leone,SLE,Sweden,SWE,0,0,5,0,5
2016,Somalia,SOM,Sweden,SWE,81,60,198,372,711
2016,Viet Nam,VNM,Sweden,SWE,0,5,11,0,16
2016,Sudan,SDN,Sweden,SWE,10,10,12,20,52
2016,Syrian Arab Rep.,SYR,Sweden,SWE,63,702,5,204,974
2016,United Rep. of Tanzania,TZA,Sweden,SWE,0,0,14,0,14
2016,Tajikistan,TJK,Sweden,SWE,0,0,5,5,10
2016,Tunisia,TUN,Sweden,SWE,0,5,16,20,41
2016,Turkey,TUR,Sweden,SWE,0,0,29,11,40
2016,Uganda,UGA,Sweden,SWE,14,0,0,0,14
2016,Ukraine,UKR,Sweden,SWE,0,5,45,31,81
2016,United States of America,USA,Sweden,SWE,0,0,5,0,5
2016,Uzbekistan,UZB,Sweden,SWE,14,0,61,13,88
2016,Yemen,YEM,Sweden,SWE,5,46,5,5,61
2016,Stateless,XXA,Sweden,SWE,120,68,49,82,319
2017,Afghanistan,AFG,Belgium,BEL,0,0,0,454,454
2017,Egypt,EGY,Cyprus,CYP,0,0,0,10,10
2017,Bangladesh,BGD,Cyprus,CYP,0,0,0,10,10
2017,Cameroon,CMR,Cyprus,CYP,0,0,0,5,5
2017,India,IND,Cyprus,CYP,0,0,0,5,5
2017,Iran (Islamic Rep. of),IRN,Cyprus,CYP,0,0,0,32,32
2017,Sri Lanka,LKA,Cyprus,CYP,0,0,0,5,5
2017,Pakistan,PAK,Cyprus,CYP,0,0,0,10,10
2017,Russian Federation,RUS,Cyprus,CYP,0,0,0,5,5
2017,Viet Nam,VNM,Cyprus,CYP,0,0,0,10,10
2017,Syrian Arab Rep.,SYR,Cyprus,CYP,0,0,0,37,37
2017,Turkey,TUR,Cyprus,CYP,0,0,0,5,5
2017,Afghanistan,AFG,United Kingdom of Great Britain and Northern Ireland,GBR,0,0,5,5,10
2017,Canada,CAN,United Kingdom of Great Britain and Northern Ireland,GBR,0,0,0,5,5
2017,Eritrea,ERI,United Kingdom of Great Britain and Northern Ireland,GBR,0,0,5,0,5
2017,Iran (Islamic Rep. of),IRN,United Kingdom of Great Britain and Northern Ireland,GBR,0,0,13,0,13
2017,Iraq,IRQ,United Kingdom of Great Britain and Northern Ireland,GBR,0,0,10,5,15
2017,Sri Lanka,LKA,United Kingdom of Great Britain and Northern Ireland,GBR,0,0,0,5,5
2017,Nigeria,NGA,United Kingdom of Great Britain and Northern Ireland,GBR,0,0,0,5,5
2017,Pakistan,PAK,United Kingdom of Great Britain and Northern Ireland,GBR,0,0,0,5,5
2017,Viet Nam,VNM,United Kingdom of Great Britain and Northern Ireland,GBR,0,5,0,0,5
2017,Afghanistan,AFG,Germany,DEU,214,590,413,1728,2945
2017,Albania,ALB,Germany,DEU,0,11,244,2511,2766
2017,Algeria,DZA,Germany,DEU,0,5,102,416,523
2017,Angola,AGO,Germany,DEU,0,5,0,5,10
2017,Egypt,EGY,Germany,DEU,11,10,32,133,186
2017,Armenia,ARM,Germany,DEU,5,34,208,446,693
2017,Azerbaijan,AZE,Germany,DEU,17,22,189,362,590
2017,Burundi,BDI,Germany,DEU,0,0,0,5,5
2017,Benin,BEN,Germany,DEU,0,0,11,21,32
2017,Bangladesh,BGD,Germany,DEU,5,5,28,158,196
2017,Burkina Faso,BFA,Germany,DEU,0,0,10,19,29
2017,Belarus,BLR,Germany,DEU,0,0,5,85,90
2017,Bosnia and Herzegovina,BIH,Germany,DEU,0,13,143,862,1018
2017,Central African Rep.,CAF,Germany,DEU,0,0,0,10,10
2017,Chad,TCD,Germany,DEU,0,5,5,32,42
2017,China,CHN,Germany,DEU,5,5,27,68,105
2017,Cameroon,CMR,Germany,DEU,0,0,26,89,115
2017,Congo,COG,Germany,DEU,0,0,0,11,11
2017,Dem. Rep. of the Congo,COD,Germany,DEU,0,17,21,56,94
2017,Colombia,COL,Germany,DEU,0,0,0,5,5
2017,Cuba,CUB,Germany,DEU,0,0,0,13,13
2017,Czechia,CZE,Germany,DEU,0,0,0,5,5
2017,Eritrea,ERI,Germany,DEU,62,161,5,320,548
2017,Ethiopia,ETH,Germany,DEU,16,28,41,244,329
2017,Gambia,GMB,Germany,DEU,0,10,83,301,394
2017,Georgia,GEO,Germany,DEU,0,15,184,588,787
2017,Ghana,GHA,Germany,DEU,0,5,37,92,134
2017,Guinea-Bissau,GNB,Germany,DEU,0,5,5,55,65
2017,Guinea,GIN,Germany,DEU,10,24,48,256,338
2017,Cote d'Ivoire,CIV,Germany,DEU,0,0,14,46,60
2017,India,IND,Germany,DEU,0,0,32,129,161
2017,Iran (Islamic Rep. of),IRN,Germany,DEU,261,67,212,490,1030
2017,Iraq,IRQ,Germany,DEU,311,448,419,1563,2741
2017,Jamaica,JAM,Germany,DEU,0,0,0,5,5
2017,Jordan,JOR,Germany,DEU,0,5,13,24,42
2017,Kazakhstan,KAZ,Germany,DEU,0,0,16,70,86
2017,Kenya,KEN,Germany,DEU,0,0,5,16,21
2017,Kyrgyzstan,KGZ,Germany,DEU,5,0,5,11,21
2017,Kuwait,KWT,Germany,DEU,0,0,0,5,5
2017,Liberia,LBR,Germany,DEU,0,0,0,12,12
2017,Libya,LBY,Germany,DEU,24,11,13,72,120
2017,Lebanon,LBN,Germany,DEU,10,10,165,146,331
2017,Sri Lanka,LKA,Germany,DEU,5,0,21,176,202
2017,Mauritania,MRT,Germany,DEU,0,0,5,10,15
2017,North Macedonia,MKD,Germany,DEU,0,13,586,2498,3097
2017,Rep. of Moldova,MDA,Germany,DEU,0,0,25,110,135
2017,Mali,MLI,Germany,DEU,5,0,16,80,101
2017,Mongolia,MNG,Germany,DEU,0,0,15,113,128
2017,Morocco,MAR,Germany,DEU,5,13,75,401,494
2017,Montenegro,MNE,Germany,DEU,0,5,44,383,432
2017,Myanmar,MMR,Germany,DEU,5,0,0,5,10
2017,Nepal,NPL,Germany,DEU,0,0,0,5,5
2017,Niger,NER,Germany,DEU,0,0,10,19,29
2017,Nigeria,NGA,Germany,DEU,38,116,127,619,900
2017,Pakistan,PAK,Germany,DEU,14,26,306,1076,1422
2017,Poland,POL,Germany,DEU,0,0,0,5,5
2017,Russian Federation,RUS,Germany,DEU,72,158,744,2056,3030
2017,Rwanda,RWA,Germany,DEU,0,5,0,5,10
2017,Serbia and Kosovo: S/RES/1244 (1999),SRB,Germany,DEU,0,38,892,4443,5373
2017,Senegal,SEN,Germany,DEU,0,5,43,163,211
2017,Sierra Leone,SLE,Germany,DEU,0,5,29,71,105
2017,Somalia,SOM,Germany,DEU,92,309,62,823,1286
2017,Viet Nam,VNM,Germany,DEU,0,0,29,57,86
2017,Sudan,SDN,Germany,DEU,5,17,15,165,202
2017,South Sudan,SSD,Germany,DEU,0,0,0,5,5
2017,Syrian Arab Rep.,SYR,Germany,DEU,679,957,26,974,2636
2017,United Rep. of Tanzania,TZA,Germany,DEU,0,5,0,26,31
2017,Tajikistan,TJK,Germany,DEU,0,5,18,76,99
2017,Turkmenistan,TKM,Germany,DEU,0,0,0,11,11
2017,Togo,TGO,Germany,DEU,0,5,5,24,34
2017,Tunisia,TUN,Germany,DEU,0,0,27,159,186
2017,Turkey,TUR,Germany,DEU,31,19,388,430,868
2017,Uganda,UGA,Germany,DEU,0,0,5,16,21
2017,Ukraine,UKR,Germany,DEU,0,5,98,277,380
2017,Uzbekistan,UZB,Germany,DEU,0,0,0,5,5
2017,Venezuela (Bolivarian Republic of),VEN,Germany,DEU,0,0,0,5,5
2017,Yemen,YEM,Germany,DEU,0,30,0,15,45
2017,Zimbabwe,ZWE,Germany,DEU,0,0,0,5,5
2017,Stateless,XXA,Germany,DEU,25,20,10,70,125
2017,Afghanistan,AFG,Netherlands,NLD,93,22,307,30,452
2017,Albania,ALB,Netherlands,NLD,0,0,5,0,5
2017,Algeria,DZA,Netherlands,NLD,0,0,13,5,18
2017,Egypt,EGY,Netherlands,NLD,0,0,11,0,11
2017,Armenia,ARM,Netherlands,NLD,0,0,40,0,40
2017,Congo,COG,Netherlands,NLD,0,0,16,0,16
2017,Eritrea,ERI,Netherlands,NLD,490,0,35,0,525
2017,Ethiopia,ETH,Netherlands,NLD,10,0,10,0,20
2017,Gambia,GMB,Netherlands,NLD,0,0,5,0,5
2017,Georgia,GEO,Netherlands,NLD,0,0,10,11,21
2017,Guinea,GIN,Netherlands,NLD,0,0,20,0,20
2017,Iran (Islamic Rep. of),IRN,Netherlands,NLD,34,0,88,5,127
2017,Iraq,IRQ,Netherlands,NLD,188,5,190,20,403
2017,Libya,LBY,Netherlands,NLD,0,0,23,0,23
2017,Sri Lanka,LKA,Netherlands,NLD,0,0,24,0,24
2017,Morocco,MAR,Netherlands,NLD,0,0,12,5,17
2017,Nigeria,NGA,Netherlands,NLD,14,0,52,0,66
2017,Pakistan,PAK,Netherlands,NLD,0,0,19,0,19
2017,Russian Federation,RUS,Netherlands,NLD,0,0,10,0,10
2017,Serbia and Kosovo: S/RES/1244 (1999),SRB,Netherlands,NLD,0,0,22,0,22
2017,Sierra Leone,SLE,Netherlands,NLD,0,0,28,0,28
2017,Somalia,SOM,Netherlands,NLD,26,0,64,0,90
2017,Viet Nam,VNM,Netherlands,NLD,0,0,10,0,10
2017,Sudan,SDN,Netherlands,NLD,5,0,22,0,27
2017,Syrian Arab Rep.,SYR,Netherlands,NLD,762,0,10,0,772
2017,Turkey,TUR,Netherlands,NLD,0,0,5,0,5
2017,Uganda,UGA,Netherlands,NLD,0,0,20,0,20
2017,Ukraine,UKR,Netherlands,NLD,0,0,23,0,23
2017,Yemen,YEM,Netherlands,NLD,15,0,0,0,15
2017,Stateless,XXA,Netherlands,NLD,16,0,14,0,30
2017,Afghanistan,AFG,Norway,NOR,0,0,20,5,25
2017,Algeria,DZA,Norway,NOR,0,0,0,5,5
2017,Angola,AGO,Norway,NOR,0,0,0,5,5
2017,Azerbaijan,AZE,Norway,NOR,0,0,5,5,10
2017,Eritrea,ERI,Norway,NOR,23,0,0,10,33
2017,Ethiopia,ETH,Norway,NOR,5,0,5,0,10
2017,Iran (Islamic Rep. of),IRN,Norway,NOR,0,0,5,5,10
2017,Iraq,IRQ,Norway,NOR,5,0,16,10,31
2017,Libya,LBY,Norway,NOR,5,0,0,0,5
2017,Morocco,MAR,Norway,NOR,5,0,0,0,5
2017,Nigeria,NGA,Norway,NOR,0,0,5,5,10
2017,Pakistan,PAK,Norway,NOR,0,0,0,5,5
2017,Russian Federation,RUS,Norway,NOR,0,0,0,13,13
2017,Somalia,SOM,Norway,NOR,0,0,5,5,10
2017,Sudan,SDN,Norway,NOR,5,0,0,0,5
2017,Syrian Arab Rep.,SYR,Norway,NOR,25,0,0,0,25
2017,Ukraine,UKR,Norway,NOR,0,0,5,0,5
2017,Uzbekistan,UZB,Norway,NOR,0,0,5,0,5
2017,Stateless,XXA,Norway,NOR,0,0,5,5,10
2017,Afghanistan,AFG,Sweden,SWE,136,44,362,228,770
2017,Albania,ALB,Sweden,SWE,0,0,37,23,60
2017,Algeria,DZA,Sweden,SWE,0,0,36,20,56
2017,Angola,AGO,Sweden,SWE,0,0,5,0,5
2017,Egypt,EGY,Sweden,SWE,0,0,10,13,23
2017,Armenia,ARM,Sweden,SWE,5,0,78,11,94
2017,Azerbaijan,AZE,Sweden,SWE,10,0,47,18,75
2017,Burundi,BDI,Sweden,SWE,0,0,5,0,5
2017,Bangladesh,BGD,Sweden,SWE,0,0,10,5,15
2017,Belarus,BLR,Sweden,SWE,0,0,27,34,61
2017,Bolivia (Plurinational State of),BOL,Sweden,SWE,0,0,12,0,12
2017,Bosnia and Herzegovina,BIH,Sweden,SWE,0,0,33,5,38
2017,China,CHN,Sweden,SWE,0,0,5,0,5
2017,Chile,CHL,Sweden,SWE,0,0,5,0,5
2017,Cameroon,CMR,Sweden,SWE,0,0,5,0,5
2017,Congo,COG,Sweden,SWE,0,0,0,5,5
2017,Dem. Rep. of the Congo,COD,Sweden,SWE,5,0,12,0,17
2017,Colombia,COL,Sweden,SWE,0,0,0,10,10
2017,Cuba,CUB,Sweden,SWE,0,0,5,14,19
2017,Djibouti,DJI,Sweden,SWE,0,0,11,0,11
2017,Eritrea,ERI,Sweden,SWE,129,47,29,49,254
2017,Ethiopia,ETH,Sweden,SWE,18,0,64,25,107
2017,Gambia,GMB,Sweden,SWE,0,0,5,5,10
2017,Palestinian,PSE,Sweden,SWE,5,0,21,17,43
2017,Georgia,GEO,Sweden,SWE,0,0,70,29,99
2017,Ghana,GHA,Sweden,SWE,0,0,10,0,10
2017,Guinea,GIN,Sweden,SWE,0,0,0,5,5
2017,Cote d'Ivoire,CIV,Sweden,SWE,0,0,5,0,5
2017,India,IND,Sweden,SWE,0,0,18,5,23
2017,Iran (Islamic Rep. of),IRN,Sweden,SWE,73,0,104,32,209
2017,Iraq,IRQ,Sweden,SWE,49,40,305,201,595
2017,Italy,ITA,Sweden,SWE,0,0,5,0,5
2017,Jordan,JOR,Sweden,SWE,0,0,48,13,61
2017,Kazakhstan,KAZ,Sweden,SWE,0,0,73,24,97
2017,Kenya,KEN,Sweden,SWE,0,0,14,5,19
2017,Kyrgyzstan,KGZ,Sweden,SWE,5,0,35,10,50
2017,Dem. People's Rep. of Korea,PRK,Sweden,SWE,0,0,5,0,5
2017,Kuwait,KWT,Sweden,SWE,0,0,5,5,10
2017,Libya,LBY,Sweden,SWE,0,0,25,28,53
2017,Lebanon,LBN,Sweden,SWE,5,0,72,11,88
2017,Sri Lanka,LKA,Sweden,SWE,0,0,5,0,5
2017,Latvia,LVA,Sweden,SWE,0,0,0,5,5
2017,North Macedonia,MKD,Sweden,SWE,0,0,15,15,30
2017,Mali,MLI,Sweden,SWE,0,0,0,5,5
2017,Mongolia,MNG,Sweden,SWE,0,0,122,23,145
2017,Morocco,MAR,Sweden,SWE,0,0,62,73,135
2017,Montenegro,MNE,Sweden,SWE,0,0,13,0,13
2017,Nepal,NPL,Sweden,SWE,0,0,5,0,5
2017,Nicaragua,NIC,Sweden,SWE,0,0,12,0,12
2017,Nigeria,NGA,Sweden,SWE,10,0,25,18,53
2017,Pakistan,PAK,Sweden,SWE,0,0,26,10,36
2017,Russian Federation,RUS,Sweden,SWE,0,5,65,36,106
2017,El Salvador,SLV,Sweden,SWE,0,0,14,0,14
2017,Serbia and Kosovo: S/RES/1244 (1999),SRB,Sweden,SWE,0,11,149,65,225
2017,Senegal,SEN,Sweden,SWE,0,0,5,0,5
2017,Sierra Leone,SLE,Sweden,SWE,0,0,5,0,5
2017,Somalia,SOM,Sweden,SWE,38,5,130,183,356
2017,Viet Nam,VNM,Sweden,SWE,0,0,11,0,11
2017,Sudan,SDN,Sweden,SWE,13,0,16,14,43
2017,Syrian Arab Rep.,SYR,Sweden,SWE,28,267,10,87,392
2017,United Rep. of Tanzania,TZA,Sweden,SWE,0,0,5,5,10
2017,Tajikistan,TJK,Sweden,SWE,0,0,11,0,11
2017,Tunisia,TUN,Sweden,SWE,0,0,15,5,20
2017,Turkey,TUR,Sweden,SWE,0,0,25,17,42
2017,Uganda,UGA,Sweden,SWE,12,0,5,0,17
2017,Ukraine,UKR,Sweden,SWE,0,0,35,20,55
2017,Uzbekistan,UZB,Sweden,SWE,5,0,29,15,49
2017,Yemen,YEM,Sweden,SWE,0,14,0,15,29
2017,Stateless,XXA,Sweden,SWE,80,13,113,63,269
2018,Afghanistan,AFG,Belgium,BEL,15,5,1155,0,1175
2018,Albania,ALB,Belgium,BEL,25,0,295,0,320
2018,Algeria,DZA,Belgium,BEL,0,0,35,0,35
2018,Angola,AGO,Belgium,BEL,0,0,70,0,70
2018,Egypt,EGY,Belgium,BEL,5,0,40,0,45
2018,Armenia,ARM,Belgium,BEL,0,0,95,0,95
2018,Azerbaijan,AZE,Belgium,BEL,0,0,10,0,10
2018,Burundi,BDI,Belgium,BEL,95,0,30,0,125
2018,Benin,BEN,Belgium,BEL,0,0,20,0,20
2018,Bangladesh,BGD,Belgium,BEL,0,0,15,0,15
2018,Burkina Faso,BFA,Belgium,BEL,0,0,20,0,20
2018,Belarus,BLR,Belgium,BEL,0,0,15,0,15
2018,Brazil,BRA,Belgium,BEL,0,0,5,0,5
2018,Bosnia and Herzegovina,BIH,Belgium,BEL,0,0,20,0,20
2018,China,CHN,Belgium,BEL,0,0,25,0,25
2018,Cameroon,CMR,Belgium,BEL,10,0,145,0,155
2018,Congo,COG,Belgium,BEL,0,0,10,0,10
2018,Dem. Rep. of the Congo,COD,Belgium,BEL,15,0,290,0,305
2018,Djibouti,DJI,Belgium,BEL,5,0,45,0,50
2018,Eritrea,ERI,Belgium,BEL,0,0,40,0,40
2018,Ethiopia,ETH,Belgium,BEL,0,0,25,0,25
2018,Gambia,GMB,Belgium,BEL,0,0,15,0,15
2018,Georgia,GEO,Belgium,BEL,5,10,55,0,70
2018,Ghana,GHA,Belgium,BEL,0,0,30,0,30
2018,Guinea,GIN,Belgium,BEL,30,5,220,0,255
2018,Cote d'Ivoire,CIV,Belgium,BEL,0,0,45,0,45
2018,India,IND,Belgium,BEL,0,0,25,0,25
2018,Iran (Islamic Rep. of),IRN,Belgium,BEL,0,0,65,0,65
2018,Iraq,IRQ,Belgium,BEL,155,60,875,0,1090
2018,Jordan,JOR,Belgium,BEL,0,0,15,0,15
2018,Kazakhstan,KAZ,Belgium,BEL,0,0,10,0,10
2018,Kyrgyzstan,KGZ,Belgium,BEL,0,0,20,0,20
2018,Lebanon,LBN,Belgium,BEL,0,0,30,0,30
2018,Sri Lanka,LKA,Belgium,BEL,0,0,70,0,70
2018,Mauritania,MRT,Belgium,BEL,10,0,60,0,70
2018,North Macedonia,MKD,Belgium,BEL,5,0,85,0,90
2018,Mali,MLI,Belgium,BEL,0,0,10,0,10
2018,Morocco,MAR,Belgium,BEL,0,0,75,0,75
2018,Montenegro,MNE,Belgium,BEL,0,0,5,0,5
2018,Nepal,NPL,Belgium,BEL,0,0,20,0,20
2018,Niger,NER,Belgium,BEL,0,0,20,0,20
2018,Nigeria,NGA,Belgium,BEL,0,0,50,0,50
2018,Afghanistan,AFG,Finland,FIN,41,11,84,83,219
2018,Albania,ALB,Finland,FIN,0,0,0,5,5
2018,Algeria,DZA,Finland,FIN,0,0,0,12,12
2018,Egypt,EGY,Finland,FIN,0,0,5,0,5
2018,Bangladesh,BGD,Finland,FIN,0,0,0,5,5
2018,Belarus,BLR,Finland,FIN,0,0,0,5,5
2018,Cameroon,CMR,Finland,FIN,0,0,5,5,10
2018,Ethiopia,ETH,Finland,FIN,0,0,0,10,10
2018,Gambia,GMB,Finland,FIN,0,0,0,5,5
2018,Iran (Islamic Rep. of),IRN,Finland,FIN,0,0,14,34,48
2018,Iraq,IRQ,Finland,FIN,87,15,502,558,1162
2018,Nigeria,NGA,Finland,FIN,5,0,27,10,42
2018,Pakistan,PAK,Finland,FIN,5,0,0,5,10
2018,Philippines,PHL,Finland,FIN,0,0,0,5,5
2018,Russian Federation,RUS,Finland,FIN,5,0,14,33,52
2018,Serbia and Kosovo: S/RES/1244 (1999),SRB,Finland,FIN,0,0,5,0,5
2018,Somalia,SOM,Finland,FIN,20,0,26,162,208
2018,Sudan,SDN,Finland,FIN,0,0,0,5,5
2018,Turkey,TUR,Finland,FIN,0,0,5,13,18
2018,Yemen,YEM,Finland,FIN,0,5,0,0,5
2018,Stateless,XXA,Finland,FIN,0,0,0,5,5
2018,Afghanistan,AFG,United Kingdom of Great Britain and Northern Ireland,GBR,5,0,0,0,5
2018,China,CHN,United Kingdom of Great Britain and Northern Ireland,GBR,0,0,0,5,5
2018,Iran (Islamic Rep. of),IRN,United Kingdom of Great Britain and Northern Ireland,GBR,0,0,0,12,12
2018,Iraq,IRQ,United Kingdom of Great Britain and Northern Ireland,GBR,0,0,0,5,5
2018,Nigeria,NGA,United Kingdom of Great Britain and Northern Ireland,GBR,0,0,0,5,5
2018,Pakistan,PAK,United Kingdom of Great Britain and Northern Ireland,GBR,0,0,5,0,5
2018,Ukraine,UKR,United Kingdom of Great Britain and Northern Ireland,GBR,0,0,5,0,5
2018,Afghanistan,AFG,Germany,DEU,296,561,263,2011,3131
2018,Albania,ALB,Germany,DEU,5,11,92,1057,1165
2018,Algeria,DZA,Germany,DEU,0,5,60,311,376
2018,Angola,AGO,Germany,DEU,0,5,0,5,10
2018,Egypt,EGY,Germany,DEU,11,0,31,114,156
2018,Armenia,ARM,Germany,DEU,5,18,85,477,585
2018,Azerbaijan,AZE,Germany,DEU,5,5,78,456,544
2018,Benin,BEN,Germany,DEU,0,0,0,12,12
2018,Bangladesh,BGD,Germany,DEU,0,0,18,144,162
2018,Burkina Faso,BFA,Germany,DEU,5,0,0,14,19
2018,Belarus,BLR,Germany,DEU,0,0,14,58,72
2018,Bosnia and Herzegovina,BIH,Germany,DEU,0,0,39,412,451
2018,Chad,TCD,Germany,DEU,0,0,5,35,40
2018,China,CHN,Germany,DEU,0,5,12,32,49
2018,Cameroon,CMR,Germany,DEU,0,5,14,88,107
2018,Congo,COG,Germany,DEU,0,0,0,5,5
2018,Dem. Rep. of the Congo,COD,Germany,DEU,5,10,11,41,67
2018,Cuba,CUB,Germany,DEU,0,0,0,5,5
2018,Djibouti,DJI,Germany,DEU,0,0,0,5,5
2018,Equatorial Guinea,GNQ,Germany,DEU,0,0,0,5,5
2018,Eritrea,ERI,Germany,DEU,21,130,5,252,408
2018,Ethiopia,ETH,Germany,DEU,11,13,43,195,262
2018,Gambia,GMB,Germany,DEU,0,12,89,375,476
2018,Georgia,GEO,Germany,DEU,0,5,105,482,592
2018,Ghana,GHA,Germany,DEU,5,0,17,108,130
2018,Guinea-Bissau,GNB,Germany,DEU,0,0,5,33,38
2018,Guinea,GIN,Germany,DEU,12,24,33,277,346
2018,Cote d'Ivoire,CIV,Germany,DEU,0,5,10,50,65
2018,India,IND,Germany,DEU,5,0,18,98,121
2018,Iran (Islamic Rep. of),IRN,Germany,DEU,131,43,169,682,1025
2018,Iraq,IRQ,Germany,DEU,62,136,263,1664,2125
2018,Jamaica,JAM,Germany,DEU,0,0,0,5,5
2018,Jordan,JOR,Germany,DEU,5,0,10,17,32
2018,Kazakhstan,KAZ,Germany,DEU,0,0,0,17,17
2018,Kenya,KEN,Germany,DEU,0,0,0,14,14
2018,Kyrgyzstan,KGZ,Germany,DEU,0,0,5,51,56
2018,Rep. of Korea,KOR,Germany,DEU,0,0,0,5,5
2018,Kuwait,KWT,Germany,DEU,0,0,0,5,5
2018,Liberia,LBR,Germany,DEU,0,0,0,14,14
2018,Libya,LBY,Germany,DEU,0,17,15,66,98
2018,Lebanon,LBN,Germany,DEU,0,5,39,149,193
2018,Sri Lanka,LKA,Germany,DEU,5,10,19,130,164
2018,Madagascar,MDG,Germany,DEU,0,0,0,5,5
2018,Mauritania,MRT,Germany,DEU,0,0,5,5,10
2018,North Macedonia,MKD,Germany,DEU,0,10,174,1082,1266
2018,Rep. of Moldova,MDA,Germany,DEU,0,0,62,552,614
2018,Mali,MLI,Germany,DEU,0,0,10,71,81
2018,Mongolia,MNG,Germany,DEU,0,5,11,35,51
2018,Morocco,MAR,Germany,DEU,5,0,29,297,331
2018,Montenegro,MNE,Germany,DEU,0,0,35,193,228
2018,Myanmar,MMR,Germany,DEU,0,0,0,5,5
2018,Nepal,NPL,Germany,DEU,0,0,5,5,10
2018,Niger,NER,Germany,DEU,0,0,5,28,33
2018,Nigeria,NGA,Germany,DEU,42,70,137,822,1071
2018,Pakistan,PAK,Germany,DEU,10,13,180,1106,1309
2018,Philippines,PHL,Germany,DEU,0,0,0,5,5
2018,Russian Federation,RUS,Germany,DEU,48,102,300,1374,1824
2018,Rwanda,RWA,Germany,DEU,0,5,0,5,10
2018,Saudi Arabia,SAU,Germany,DEU,0,0,0,5,5
2018,Serbia and Kosovo: S/RES/1244 (1999),SRB,Germany,DEU,0,16,277,2007,2300
2018,Senegal,SEN,Germany,DEU,0,0,15,94,109
2018,Sierra Leone,SLE,Germany,DEU,5,5,12,53,75
2018,Somalia,SOM,Germany,DEU,67,188,62,773,1090
2018,Viet Nam,VNM,Germany,DEU,0,5,17,33,55
2018,Sudan,SDN,Germany,DEU,10,21,11,251,293
2018,South Sudan,SSD,Germany,DEU,0,0,0,11,11
2018,Syrian Arab Rep.,SYR,Germany,DEU,742,234,22,1021,2019
2018,United Rep. of Tanzania,TZA,Germany,DEU,0,0,0,18,18
2018,Tajikistan,TJK,Germany,DEU,5,5,20,120,150
2018,Togo,TGO,Germany,DEU,0,5,10,39,54
2018,Tunisia,TUN,Germany,DEU,0,0,20,126,146
2018,Turkey,TUR,Germany,DEU,22,14,217,245,498
2018,United Arab Emirates,ARE,Germany,DEU,0,5,0,0,5
2018,Uganda,UGA,Germany,DEU,0,5,0,10,15
2018,Ukraine,UKR,Germany,DEU,5,0,60,264,329
2018,Uzbekistan,UZB,Germany,DEU,0,0,0,12,12
2018,Yemen,YEM,Germany,DEU,0,18,0,16,34
2018,Zimbabwe,ZWE,Germany,DEU,5,0,0,0,5
2018,Stateless,XXA,Germany,DEU,24,14,5,63,106
2018,Afghanistan,AFG,Netherlands,NLD,126,22,263,26,437
2018,Algeria,DZA,Netherlands,NLD,0,0,16,10,26
2018,Egypt,EGY,Netherlands,NLD,0,0,43,0,43
2018,Armenia,ARM,Netherlands,NLD,0,0,32,0,32
2018,Azerbaijan,AZE,Netherlands,NLD,0,0,22,5,27
2018,Burundi,BDI,Netherlands,NLD,0,0,11,0,11
2018,Congo,COG,Netherlands,NLD,0,0,11,0,11
2018,Eritrea,ERI,Netherlands,NLD,106,0,40,0,146
2018,Ethiopia,ETH,Netherlands,NLD,19,0,13,0,32
2018,Gambia,GMB,Netherlands,NLD,0,0,5,0,5
2018,Georgia,GEO,Netherlands,NLD,0,0,10,0,10
2018,Guinea,GIN,Netherlands,NLD,0,0,17,0,17
2018,Cote d'Ivoire,CIV,Netherlands,NLD,0,0,10,0,10
2018,Iran (Islamic Rep. of),IRN,Netherlands,NLD,43,0,167,12,222
2018,Iraq,IRQ,Netherlands,NLD,31,5,289,16,341
2018,Libya,LBY,Netherlands,NLD,0,0,25,5,30
2018,Sri Lanka,LKA,Netherlands,NLD,0,0,15,0,15
2018,Morocco,MAR,Netherlands,NLD,0,0,25,19,44
2018,Nigeria,NGA,Netherlands,NLD,5,0,43,0,48
2018,Pakistan,PAK,Netherlands,NLD,0,0,23,0,23
2018,Russian Federation,RUS,Netherlands,NLD,0,0,10,0,10
2018,Serbia and Kosovo: S/RES/1244 (1999),SRB,Netherlands,NLD,0,0,22,0,22
2018,Sierra Leone,SLE,Netherlands,NLD,0,0,20,0,20
2018,Somalia,SOM,Netherlands,NLD,11,0,56,0,67
2018,Sudan,SDN,Netherlands,NLD,28,0,21,0,49
2018,Syrian Arab Rep.,SYR,Netherlands,NLD,0,0,20,0,20
2018,Tunisia,TUN,Netherlands,NLD,0,0,10,0,10
2018,Turkey,TUR,Netherlands,NLD,0,0,21,0,21
2018,Uganda,UGA,Netherlands,NLD,0,0,26,0,26
2018,Ukraine,UKR,Netherlands,NLD,0,0,11,0,11
2018,Stateless,XXA,Netherlands,NLD,0,0,17,0,17
2018,Afghanistan,AFG,Norway,NOR,0,0,0,5,5
2018,Eritrea,ERI,Norway,NOR,29,0,0,5,34
2018,Ethiopia,ETH,Norway,NOR,0,0,0,5,5
2018,Iran (Islamic Rep. of),IRN,Norway,NOR,0,0,0,5,5
2018,Iraq,IRQ,Norway,NOR,0,0,0,12,12
2018,Nigeria,NGA,Norway,NOR,0,0,5,0,5
2018,Russian Federation,RUS,Norway,NOR,0,0,5,10,15
2018,Serbia and Kosovo: S/RES/1244 (1999),SRB,Norway,NOR,0,0,5,0,5
2018,Somalia,SOM,Norway,NOR,0,0,5,0,5
2018,Syrian Arab Rep.,SYR,Norway,NOR,10,0,0,0,10
2018,Turkey,TUR,Norway,NOR,0,0,0,5,5
2018,Ukraine,UKR,Norway,NOR,0,0,5,0,5
2018,Stateless,XXA,Norway,NOR,5,0,0,0,5
2018,Afghanistan,AFG,Sweden,SWE,134,13,380,150,677
2018,Albania,ALB,Sweden,SWE,0,0,54,14,68
2018,Algeria,DZA,Sweden,SWE,0,0,15,19,34
2018,Angola,AGO,Sweden,SWE,0,0,10,0,10
2018,Egypt,EGY,Sweden,SWE,0,0,36,12,48
2018,Argentina,ARG,Sweden,SWE,0,0,0,5,5
2018,Armenia,ARM,Sweden,SWE,0,0,67,20,87
2018,Azerbaijan,AZE,Sweden,SWE,5,0,45,22,72
2018,Burundi,BDI,Sweden,SWE,5,0,0,0,5
2018,Bangladesh,BGD,Sweden,SWE,0,0,26,13,39
2018,Belarus,BLR,Sweden,SWE,0,0,17,27,44
2018,Bolivia (Plurinational State of),BOL,Sweden,SWE,0,0,12,0,12
2018,Bosnia and Herzegovina,BIH,Sweden,SWE,0,0,10,13,23
2018,China,CHN,Sweden,SWE,5,0,0,5,10
2018,Chile,CHL,Sweden,SWE,0,0,5,0,5
2018,Cameroon,CMR,Sweden,SWE,0,0,5,5,10
2018,Dem. Rep. of the Congo,COD,Sweden,SWE,0,0,18,0,18
2018,Colombia,COL,Sweden,SWE,0,0,5,0,5
2018,Cuba,CUB,Sweden,SWE,0,0,5,5,10
2018,Djibouti,DJI,Sweden,SWE,0,0,10,5,15
2018,Eritrea,ERI,Sweden,SWE,128,10,25,56,219
2018,Ethiopia,ETH,Sweden,SWE,15,0,98,30,143
2018,Gambia,GMB,Sweden,SWE,0,0,5,11,16
2018,Palestinian,PSE,Sweden,SWE,14,0,26,11,51
2018,Georgia,GEO,Sweden,SWE,0,0,77,45,122
2018,Ghana,GHA,Sweden,SWE,0,0,10,0,10
2018,Guinea,GIN,Sweden,SWE,0,0,12,0,12
2018,Cote d'Ivoire,CIV,Sweden,SWE,0,0,0,5,5
2018,India,IND,Sweden,SWE,0,0,16,5,21
2018,Iran (Islamic Rep. of),IRN,Sweden,SWE,77,0,212,42,331
2018,Iraq,IRQ,Sweden,SWE,44,38,363,159,604
2018,Jordan,JOR,Sweden,SWE,0,0,32,5,37
2018,Kazakhstan,KAZ,Sweden,SWE,0,0,49,39,88
2018,Kenya,KEN,Sweden,SWE,5,0,11,0,16
2018,Kyrgyzstan,KGZ,Sweden,SWE,0,0,57,14,71
2018,Kuwait,KWT,Sweden,SWE,0,0,5,0,5
2018,Libya,LBY,Sweden,SWE,5,0,24,21,50
2018,Lebanon,LBN,Sweden,SWE,0,5,110,13,128
2018,Sri Lanka,LKA,Sweden,SWE,0,0,5,0,5
2018,North Macedonia,MKD,Sweden,SWE,0,0,12,13,25
2018,Rep. of Moldova,MDA,Sweden,SWE,0,0,0,5,5
2018,Mexico,MEX,Sweden,SWE,0,0,5,0,5
2018,Mongolia,MNG,Sweden,SWE,0,0,130,38,168
2018,Morocco,MAR,Sweden,SWE,0,0,58,43,101
2018,Montenegro,MNE,Sweden,SWE,0,0,5,0,5
2018,Nicaragua,NIC,Sweden,SWE,0,0,20,0,20
2018,Nigeria,NGA,Sweden,SWE,10,0,65,24,99
2018,Pakistan,PAK,Sweden,SWE,0,0,28,11,39
2018,Peru,PER,Sweden,SWE,0,0,0,5,5
2018,Russian Federation,RUS,Sweden,SWE,0,5,135,28,168
2018,Rwanda,RWA,Sweden,SWE,0,0,5,0,5
2018,El Salvador,SLV,Sweden,SWE,0,0,5,0,5
2018,Serbia and Kosovo: S/RES/1244 (1999),SRB,Sweden,SWE,0,0,73,26,99
2018,Senegal,SEN,Sweden,SWE,0,0,10,0,10
2018,Sierra Leone,SLE,Sweden,SWE,0,0,5,0,5
2018,Somalia,SOM,Sweden,SWE,46,5,143,118,312
2018,Viet Nam,VNM,Sweden,SWE,0,0,11,0,11
2018,Sudan,SDN,Sweden,SWE,10,0,16,5,31
2018,Syrian Arab Rep.,SYR,Sweden,SWE,16,123,15,121,275
2018,United Rep. of Tanzania,TZA,Sweden,SWE,0,0,12,5,17
2018,Tajikistan,TJK,Sweden,SWE,0,0,12,0,12
2018,Tunisia,TUN,Sweden,SWE,0,0,18,10,28
2018,Turkey,TUR,Sweden,SWE,5,0,40,24,69
2018,Uganda,UGA,Sweden,SWE,15,0,5,5,25
2018,Ukraine,UKR,Sweden,SWE,0,0,40,10,50
2018,Uzbekistan,UZB,Sweden,SWE,5,0,52,23,80
2018,Yemen,YEM,Sweden,SWE,5,14,0,5,24
2018,Stateless,XXA,Sweden,SWE,29,12,109,55,205
2019,Afghanistan,AFG,Belgium,BEL,30,25,511,73,639
2019,Albania,ALB,Belgium,BEL,10,0,68,31,109
2019,Algeria,DZA,Belgium,BEL,0,0,11,0,11
2019,Angola,AGO,Belgium,BEL,0,0,13,0,13
2019,Egypt,EGY,Belgium,BEL,0,0,18,5,23
2019,Armenia,ARM,Belgium,BEL,0,0,27,5,32
2019,Azerbaijan,AZE,Belgium,BEL,0,0,11,0,11
2019,Burundi,BDI,Belgium,BEL,0,0,19,0,19
2019,Benin,BEN,Belgium,BEL,0,0,5,0,5
2019,Bangladesh,BGD,Belgium,BEL,0,0,5,0,5
2019,Burkina Faso,BFA,Belgium,BEL,5,0,17,0,22
2019,Belarus,BLR,Belgium,BEL,0,0,0,5,5
2019,Bosnia and Herzegovina,BIH,Belgium,BEL,0,0,0,5,5
2019,Chad,TCD,Belgium,BEL,0,0,5,0,5
2019,China,CHN,Belgium,BEL,0,0,5,0,5
2019,Cameroon,CMR,Belgium,BEL,10,0,54,5,69
2019,Dem. Rep. of the Congo,COD,Belgium,BEL,5,0,127,22,154
2019,Colombia,COL,Belgium,BEL,0,0,17,0,17
2019,Djibouti,DJI,Belgium,BEL,0,0,11,0,11
2019,Eritrea,ERI,Belgium,BEL,0,0,5,0,5
2019,Ethiopia,ETH,Belgium,BEL,0,0,5,0,5
2019,Gambia,GMB,Belgium,BEL,0,0,5,0,5
2019,Palestinian,PSE,Belgium,BEL,10,0,24,5,39
2019,Georgia,GEO,Belgium,BEL,0,0,13,5,18
2019,Ghana,GHA,Belgium,BEL,0,0,10,0,10
2019,Guinea,GIN,Belgium,BEL,25,10,158,23,216
2019,Cote d'Ivoire,CIV,Belgium,BEL,0,0,34,5,39
2019,India,IND,Belgium,BEL,0,0,0,5,5
2019,Iran (Islamic Rep. of),IRN,Belgium,BEL,0,0,11,0,11
2019,Iraq,IRQ,Belgium,BEL,11,5,146,26,188
2019,Jordan,JOR,Belgium,BEL,0,0,5,0,5
2019,Kyrgyzstan,KGZ,Belgium,BEL,0,0,5,0,5
2019,Lebanon,LBN,Belgium,BEL,0,0,13,0,13
2019,Sri Lanka,LKA,Belgium,BEL,0,0,23,0,23
2019,Mauritania,MRT,Belgium,BEL,5,0,18,5,28
2019,North Macedonia,MKD,Belgium,BEL,0,0,14,0,14
2019,Mali,MLI,Belgium,BEL,0,0,5,0,5
2019,Morocco,MAR,Belgium,BEL,0,0,24,0,24
2019,Niger,NER,Belgium,BEL,0,0,16,5,21
2019,Nigeria,NGA,Belgium,BEL,0,0,15,0,15
2019,Pakistan,PAK,Belgium,BEL,0,0,13,5,18
2019,Russian Federation,RUS,Belgium,BEL,0,0,49,11,60
2019,Rwanda,RWA,Belgium,BEL,11,0,53,13,77
2019,Serbia and Kosovo: S/RES/1244 (1999),SRB,Belgium,BEL,0,0,44,22,66
2019,Senegal,SEN,Belgium,BEL,5,0,18,0,23
2019,Sierra Leone,SLE,Belgium,BEL,0,0,10,0,10
2019,Somalia,SOM,Belgium,BEL,0,0,35,10,45
2019,Sudan,SDN,Belgium,BEL,0,0,16,0,16
2019,Syrian Arab Rep.,SYR,Belgium,BEL,0,0,65,23,88
2019,Togo,TGO,Belgium,BEL,5,0,32,0,37
2019,Tunisia,TUN,Belgium,BEL,0,0,5,0,5
2019,Turkey,TUR,Belgium,BEL,5,0,54,14,73
2019,Ukraine,UKR,Belgium,BEL,0,0,16,5,21
2019,Venezuela (Bolivarian Republic of),VEN,Belgium,BEL,0,0,12,0,12
2019,Zimbabwe,ZWE,Belgium,BEL,0,0,5,0,5
2019,Stateless,XXA,Belgium,BEL,0,0,5,0,5
2019,Afghanistan,AFG,United Kingdom of Great Britain and Northern Ireland,GBR,5,0,0,5,10
2019,Bangladesh,BGD,United Kingdom of Great Britain and Northern Ireland,GBR,0,0,5,0,5
2019,Eritrea,ERI,United Kingdom of Great Britain and Northern Ireland,GBR,5,0,0,0,5
2019,Ethiopia,ETH,United Kingdom of Great Britain and Northern Ireland,GBR,0,0,5,0,5
2019,Palestinian,PSE,United Kingdom of Great Britain and Northern Ireland,GBR,0,0,5,0,5
2019,India,IND,United Kingdom of Great Britain and Northern Ireland,GBR,0,0,0,5,5
2019,Iran (Islamic Rep. of),IRN,United Kingdom of Great Britain and Northern Ireland,GBR,13,0,5,0,18
2019,Iraq,IRQ,United Kingdom of Great Britain and Northern Ireland,GBR,0,0,11,5,16
2019,Nigeria,NGA,United Kingdom of Great Britain and Northern Ireland,GBR,0,0,5,0,5
2019,Pakistan,PAK,United Kingdom of Great Britain and Northern Ireland,GBR,0,0,5,0,5
2019,El Salvador,SLV,United Kingdom of Great Britain and Northern Ireland,GBR,0,0,0,5,5
2019,Sudan,SDN,United Kingdom of Great Britain and Northern Ireland,GBR,5,0,0,0,5
2019,Turkey,TUR,United Kingdom of Great Britain and Northern Ireland,GBR,0,0,0,5,5
2019,Stateless,XXA,United Kingdom of Great Britain and Northern Ireland,GBR,0,0,0,10,10
2019,Afghanistan,AFG,Germany,DEU,115,508,145,1720,2488
2019,Albania,ALB,Germany,DEU,0,5,93,831,929
2019,Algeria,DZA,Germany,DEU,0,5,60,282,347
2019,Angola,AGO,Germany,DEU,0,0,5,16,21
2019,Egypt,EGY,Germany,DEU,10,0,10,127,147
2019,Armenia,ARM,Germany,DEU,5,11,33,312,361
2019,Azerbaijan,AZE,Germany,DEU,0,15,71,462,548
2019,Burundi,BDI,Germany,DEU,0,0,0,5,5
2019,Benin,BEN,Germany,DEU,0,0,5,19,24
2019,Bangladesh,BGD,Germany,DEU,0,0,10,145,155
2019,Burkina Faso,BFA,Germany,DEU,0,0,5,19,24
2019,Belarus,BLR,Germany,DEU,0,0,5,89,94
2019,Bosnia and Herzegovina,BIH,Germany,DEU,0,0,51,312,363
2019,Central African Rep.,CAF,Germany,DEU,0,0,0,5,5
2019,Chad,TCD,Germany,DEU,0,0,0,29,29
2019,China,CHN,Germany,DEU,5,5,0,35,45
2019,Cameroon,CMR,Germany,DEU,5,0,22,83,110
2019,Congo,COG,Germany,DEU,0,0,0,5,5
2019,Dem. Rep. of the Congo,COD,Germany,DEU,0,0,5,32,37
2019,Colombia,COL,Germany,DEU,0,0,0,10,10
2019,Cuba,CUB,Germany,DEU,0,0,0,10,10
2019,Djibouti,DJI,Germany,DEU,0,0,0,5,5
2019,Eritrea,ERI,Germany,DEU,10,113,14,182,319
2019,Ethiopia,ETH,Germany,DEU,5,14,27,199,245
2019,Gambia,GMB,Germany,DEU,5,10,48,310,373
2019,Georgia,GEO,Germany,DEU,0,0,90,465,555
2019,Ghana,GHA,Germany,DEU,0,5,11,106,122
2019,Guinea-Bissau,GNB,Germany,DEU,0,5,10,25,40
2019,Guinea,GIN,Germany,DEU,15,5,51,312,383
2019,Cote d'Ivoire,CIV,Germany,DEU,0,0,11,56,67
2019,India,IND,Germany,DEU,5,0,10,106,121
2019,Iran (Islamic Rep. of),IRN,Germany,DEU,153,28,173,730,1084
2019,Iraq,IRQ,Germany,DEU,81,94,228,1523,1926
2019,Jamaica,JAM,Germany,DEU,0,0,0,10,10
2019,Jordan,JOR,Germany,DEU,0,0,10,24,34
2019,Kazakhstan,KAZ,Germany,DEU,0,0,0,21,21
2019,Kenya,KEN,Germany,DEU,0,0,0,10,10
2019,Kyrgyzstan,KGZ,Germany,DEU,0,0,0,11,11
2019,Liberia,LBR,Germany,DEU,0,0,5,22,27
2019,Libya,LBY,Germany,DEU,5,22,5,98,130
2019,Lebanon,LBN,Germany,DEU,0,5,23,180,208
2019,Sri Lanka,LKA,Germany,DEU,0,5,5,48,58
2019,Madagascar,MDG,Germany,DEU,0,0,0,5,5
2019,Mauritania,MRT,Germany,DEU,0,0,0,10,10
2019,North Macedonia,MKD,Germany,DEU,0,0,141,1039,1180
2019,Rep. of Moldova,MDA,Germany,DEU,0,0,24,1000,1024
2019,Mali,MLI,Germany,DEU,5,0,10,75,90
2019,Mongolia,MNG,Germany,DEU,0,5,0,36,41
2019,Morocco,MAR,Germany,DEU,0,0,38,288,326
2019,Montenegro,MNE,Germany,DEU,0,0,12,105,117
2019,Myanmar,MMR,Germany,DEU,5,0,0,0,5
2019,Niger,NER,Germany,DEU,0,0,5,20,25
2019,Nigeria,NGA,Germany,DEU,17,50,143,1504,1714
2019,Pakistan,PAK,Germany,DEU,13,10,103,1145,1271
2019,Philippines,PHL,Germany,DEU,0,0,0,5,5
2019,South Africa,ZAF,Germany,DEU,0,0,5,0,5
2019,Russian Federation,RUS,Germany,DEU,41,42,214,1342,1639
2019,Rwanda,RWA,Germany,DEU,0,0,0,5,5
2019,Serbia and Kosovo: S/RES/1244 (1999),SRB,Germany,DEU,0,5,255,1838,2098
2019,Senegal,SEN,Germany,DEU,0,0,10,78,88
2019,Sierra Leone,SLE,Germany,DEU,0,0,15,42,57
2019,Somalia,SOM,Germany,DEU,59,83,38,676,856
2019,Viet Nam,VNM,Germany,DEU,0,0,11,34,45
2019,Sudan,SDN,Germany,DEU,5,5,21,179,210
2019,South Sudan,SSD,Germany,DEU,0,0,0,5,5
2019,Slovakia,SVK,Germany,DEU,0,0,0,5,5
2019,Syrian Arab Rep.,SYR,Germany,DEU,547,176,18,1074,1815
2019,United Rep. of Tanzania,TZA,Germany,DEU,0,0,0,13,13
2019,Tajikistan,TJK,Germany,DEU,5,16,18,179,218
2019,Turkmenistan,TKM,Germany,DEU,0,0,0,5,5
2019,Togo,TGO,Germany,DEU,0,0,5,29,34
2019,Tunisia,TUN,Germany,DEU,0,0,18,97,115
2019,Turkey,TUR,Germany,DEU,62,10,184,390,646
2019,Uganda,UGA,Germany,DEU,0,0,0,18,18
2019,Ukraine,UKR,Germany,DEU,5,5,52,269,331
2019,Uzbekistan,UZB,Germany,DEU,0,0,0,10,10
2019,Yemen,YEM,Germany,DEU,5,28,0,10,43
2019,Zimbabwe,ZWE,Germany,DEU,0,0,0,5,5
2019,Stateless,XXA,Germany,DEU,18,5,0,36,59
2019,Afghanistan,AFG,Netherlands,NLD,91,13,293,117,514
2019,Albania,ALB,Netherlands,NLD,0,0,19,69,88
2019,Algeria,DZA,Netherlands,NLD,0,0,26,66,92
2019,Angola,AGO,Netherlands,NLD,0,0,0,5,5
2019,Egypt,EGY,Netherlands,NLD,0,0,32,17,49
2019,Armenia,ARM,Netherlands,NLD,0,0,29,10,39
2019,Azerbaijan,AZE,Netherlands,NLD,0,0,22,25,47
2019,Burundi,BDI,Netherlands,NLD,0,0,15,5,20
2019,Bangladesh,BGD,Netherlands,NLD,0,0,11,0,11
2019,Burkina Faso,BFA,Netherlands,NLD,0,0,5,0,5
2019,Belarus,BLR,Netherlands,NLD,0,0,0,5,5
2019,Bosnia and Herzegovina,BIH,Netherlands,NLD,0,0,5,24,29
2019,China,CHN,Netherlands,NLD,16,0,5,0,21
2019,Cameroon,CMR,Netherlands,NLD,0,0,10,0,10
2019,Congo,COG,Netherlands,NLD,0,0,14,11,25
2019,Dem. Rep. of the Congo,COD,Netherlands,NLD,0,0,5,0,5
2019,Cuba,CUB,Netherlands,NLD,13,0,0,0,13
2019,Eritrea,ERI,Netherlands,NLD,5,0,39,33,77
2019,Ethiopia,ETH,Netherlands,NLD,5,0,12,10,27
2019,Gambia,GMB,Netherlands,NLD,0,0,10,17,27
2019,Palestinian,PSE,Netherlands,NLD,0,0,10,0,10
2019,Georgia,GEO,Netherlands,NLD,0,0,27,33,60
2019,Ghana,GHA,Netherlands,NLD,0,0,0,5,5
2019,Guinea,GIN,Netherlands,NLD,5,0,14,22,41
2019,Cote d'Ivoire,CIV,Netherlands,NLD,0,0,5,5,10
2019,India,IND,Netherlands,NLD,0,0,5,0,5
2019,Iran (Islamic Rep. of),IRN,Netherlands,NLD,67,22,188,94,371
2019,Iraq,IRQ,Netherlands,NLD,46,12,252,235,545
2019,Jamaica,JAM,Netherlands,NLD,5,0,0,0,5
2019,Jordan,JOR,Netherlands,NLD,0,0,0,12,12
2019,Liberia,LBR,Netherlands,NLD,0,0,0,5,5
2019,Libya,LBY,Netherlands,NLD,5,0,16,32,53
2019,Lebanon,LBN,Netherlands,NLD,0,0,0,12,12
2019,Sri Lanka,LKA,Netherlands,NLD,0,0,26,25,51
2019,North Macedonia,MKD,Netherlands,NLD,0,0,0,37,37
2019,Rep. of Moldova,MDA,Netherlands,NLD,0,0,5,24,29
2019,Mongolia,MNG,Netherlands,NLD,0,0,0,5,5
2019,Morocco,MAR,Netherlands,NLD,0,5,24,86,115
2019,Myanmar,MMR,Netherlands,NLD,0,0,13,0,13
2019,Nepal,NPL,Netherlands,NLD,0,0,10,0,10
2019,Niger,NER,Netherlands,NLD,0,0,0,5,5
2019,Nigeria,NGA,Netherlands,NLD,5,0,39,34,78
2019,Pakistan,PAK,Netherlands,NLD,5,0,21,22,48
2019,Russian Federation,RUS,Netherlands,NLD,0,0,19,14,33
2019,Rwanda,RWA,Netherlands,NLD,0,0,5,0,5
2019,Serbia and Kosovo: S/RES/1244 (1999),SRB,Netherlands,NLD,0,0,21,23,44
2019,Senegal,SEN,Netherlands,NLD,5,0,0,5,10
2019,Sierra Leone,SLE,Netherlands,NLD,5,0,17,18,40
2019,Somalia,SOM,Netherlands,NLD,5,5,31,43,84
2019,Viet Nam,VNM,Netherlands,NLD,0,0,5,0,5
2019,Sudan,SDN,Netherlands,NLD,0,0,26,22,48
2019,Syrian Arab Rep.,SYR,Netherlands,NLD,10,0,58,50,118
2019,Tunisia,TUN,Netherlands,NLD,0,0,10,24,34
2019,Turkey,TUR,Netherlands,NLD,0,0,28,12,40
2019,Uganda,UGA,Netherlands,NLD,0,0,19,13,32
2019,Ukraine,UKR,Netherlands,NLD,0,0,15,12,27
2019,United States of America,USA,Netherlands,NLD,0,0,5,0,5
2019,Uzbekistan,UZB,Netherlands,NLD,0,0,5,0,5
2019,Venezuela (Bolivarian Republic of),VEN,Netherlands,NLD,0,0,12,12,24
2019,Yemen,YEM,Netherlands,NLD,5,0,5,0,10
2019,Stateless,XXA,Netherlands,NLD,0,0,46,13,59
2019,Afghanistan,AFG,Norway,NOR,5,0,0,5,10
2019,Belarus,BLR,Norway,NOR,0,0,5,0,5
2019,Eritrea,ERI,Norway,NOR,5,0,0,5,10
2019,Iran (Islamic Rep. of),IRN,Norway,NOR,13,0,0,0,13
2019,Iraq,IRQ,Norway,NOR,0,0,5,5,10
2019,Lebanon,LBN,Norway,NOR,5,0,0,0,5
2019,Morocco,MAR,Norway,NOR,0,0,5,0,5
2019,Nigeria,NGA,Norway,NOR,0,0,0,5,5
2019,Russian Federation,RUS,Norway,NOR,0,0,5,12,17
2019,Serbia and Kosovo: S/RES/1244 (1999),SRB,Norway,NOR,0,0,5,0,5
2019,Somalia,SOM,Norway,NOR,0,0,5,5,10
2019,Syrian Arab Rep.,SYR,Norway,NOR,12,0,0,0,12
2019,Stateless,XXA,Norway,NOR,5,0,0,0,5
2019,Afghanistan,AFG,Sweden,SWE,58,10,167,77,312
2019,Albania,ALB,Sweden,SWE,0,0,30,22,52
2019,Algeria,DZA,Sweden,SWE,0,0,12,10,22
2019,Angola,AGO,Sweden,SWE,0,0,0,5,5
2019,Egypt,EGY,Sweden,SWE,5,5,27,5,42
2019,Armenia,ARM,Sweden,SWE,0,0,95,16,111
2019,Azerbaijan,AZE,Sweden,SWE,11,0,61,35,107
2019,Burundi,BDI,Sweden,SWE,0,0,5,0,5
2019,Bangladesh,BGD,Sweden,SWE,0,0,32,5,37
2019,Belarus,BLR,Sweden,SWE,0,0,19,21,40
2019,Bolivia (Plurinational State of),BOL,Sweden,SWE,0,0,16,0,16
2019,Bosnia and Herzegovina,BIH,Sweden,SWE,0,0,18,5,23
2019,China,CHN,Sweden,SWE,0,0,5,0,5
2019,Cameroon,CMR,Sweden,SWE,0,0,0,11,11
2019,Congo,COG,Sweden,SWE,0,0,0,5,5
2019,Dem. Rep. of the Congo,COD,Sweden,SWE,0,0,21,5,26
2019,Colombia,COL,Sweden,SWE,0,0,10,0,10
2019,Cuba,CUB,Sweden,SWE,0,0,14,5,19
2019,Djibouti,DJI,Sweden,SWE,0,0,5,0,5
2019,Ecuador,ECU,Sweden,SWE,0,0,5,5,10
2019,Eritrea,ERI,Sweden,SWE,83,5,13,50,151
2019,Ethiopia,ETH,Sweden,SWE,12,5,106,16,139
2019,Gambia,GMB,Sweden,SWE,0,0,10,12,22
2019,Palestinian,PSE,Sweden,SWE,5,5,85,14,109
2019,Georgia,GEO,Sweden,SWE,0,0,56,21,77
2019,Ghana,GHA,Sweden,SWE,0,0,13,0,13
2019,Guinea,GIN,Sweden,SWE,5,0,5,0,10
2019,Cote d'Ivoire,CIV,Sweden,SWE,0,0,5,0,5
2019,India,IND,Sweden,SWE,0,0,13,0,13
2019,Iran (Islamic Rep. of),IRN,Sweden,SWE,57,0,94,41,192
2019,Iraq,IRQ,Sweden,SWE,23,20,281,126,450
2019,Jamaica,JAM,Sweden,SWE,0,0,5,0,5
2019,Jordan,JOR,Sweden,SWE,0,5,28,5,38
2019,Kazakhstan,KAZ,Sweden,SWE,0,0,47,28,75
2019,Kenya,KEN,Sweden,SWE,0,0,22,0,22
2019,Kyrgyzstan,KGZ,Sweden,SWE,0,0,35,19,54
2019,Kuwait,KWT,Sweden,SWE,0,0,5,0,5
2019,Libya,LBY,Sweden,SWE,0,0,10,14,24
2019,Lebanon,LBN,Sweden,SWE,0,5,129,17,151
2019,Sri Lanka,LKA,Sweden,SWE,0,0,5,0,5
2019,Mauritania,MRT,Sweden,SWE,0,0,5,0,5
2019,North Macedonia,MKD,Sweden,SWE,0,0,19,0,19
2019,Mongolia,MNG,Sweden,SWE,0,0,54,24,78
2019,Morocco,MAR,Sweden,SWE,0,0,47,47,94
2019,Montenegro,MNE,Sweden,SWE,0,11,0,0,11
2019,Nicaragua,NIC,Sweden,SWE,0,0,15,0,15
2019,Nigeria,NGA,Sweden,SWE,10,0,65,31,106
2019,Pakistan,PAK,Sweden,SWE,5,0,21,16,42
2019,Peru,PER,Sweden,SWE,0,0,13,0,13
2019,Russian Federation,RUS,Sweden,SWE,0,0,109,34,143
2019,El Salvador,SLV,Sweden,SWE,0,5,19,5,29
2019,Serbia and Kosovo: S/RES/1244 (1999),SRB,Sweden,SWE,0,0,97,18,115
2019,Senegal,SEN,Sweden,SWE,0,0,5,0,5
2019,Sierra Leone,SLE,Sweden,SWE,0,0,5,0,5
2019,Somalia,SOM,Sweden,SWE,14,10,190,115,329
2019,Viet Nam,VNM,Sweden,SWE,0,0,13,0,13
2019,Sudan,SDN,Sweden,SWE,0,0,5,5,10
2019,Syrian Arab Rep.,SYR,Sweden,SWE,5,76,21,222,324
2019,United Rep. of Tanzania,TZA,Sweden,SWE,0,0,13,0,13
2019,Tajikistan,TJK,Sweden,SWE,0,0,5,5,10
2019,Turkmenistan,TKM,Sweden,SWE,5,0,0,0,5
2019,Tunisia,TUN,Sweden,SWE,0,0,13,10,23
2019,Turkey,TUR,Sweden,SWE,5,0,29,15,49
2019,Uganda,UGA,Sweden,SWE,0,0,0,14,14
2019,Ukraine,UKR,Sweden,SWE,0,0,19,18,37
2019,United States of America,USA,Sweden,SWE,0,0,5,0,5
2019,Uzbekistan,UZB,Sweden,SWE,0,0,28,21,49
2019,Venezuela (Bolivarian Republic of),VEN,Sweden,SWE,0,0,5,0,5
2019,Yemen,YEM,Sweden,SWE,0,12,0,5,17
2019,Zimbabwe,ZWE,Sweden,SWE,0,0,0,5,5
2019,Stateless,XXA,Sweden,SWE,21,10,108,126,265
2020,Afghanistan,AFG,Belgium,BEL,25,20,680,0,725
2020,Albania,ALB,Belgium,BEL,10,0,340,0,350
2020,Algeria,DZA,Belgium,BEL,5,0,30,0,35
2020,Angola,AGO,Belgium,BEL,0,0,25,0,25
2020,Egypt,EGY,Belgium,BEL,0,0,15,0,15
2020,Armenia,ARM,Belgium,BEL,0,0,40,0,40
2020,Azerbaijan,AZE,Belgium,BEL,0,0,10,0,10
2020,Burundi,BDI,Belgium,BEL,5,0,30,0,35
2020,Benin,BEN,Belgium,BEL,0,0,15,0,15
2020,Bangladesh,BGD,Belgium,BEL,0,0,5,0,5
2020,Belarus,BLR,Belgium,BEL,0,0,5,0,5
2020,Brazil,BRA,Belgium,BEL,0,0,5,0,5
2020,Bosnia and Herzegovina,BIH,Belgium,BEL,0,0,10,0,10
2020,China,CHN,Belgium,BEL,0,0,15,0,15
2020,Cameroon,CMR,Belgium,BEL,10,0,115,0,125
2020,Congo,COG,Belgium,BEL,0,0,5,0,5
2020,Dem. Rep. of the Congo,COD,Belgium,BEL,10,0,170,0,180
2020,Colombia,COL,Belgium,BEL,0,0,130,0,130
2020,Djibouti,DJI,Belgium,BEL,5,0,25,0,30
2020,Eritrea,ERI,Belgium,BEL,0,0,95,0,95
2020,Ethiopia,ETH,Belgium,BEL,0,0,20,0,20
2020,Gambia,GMB,Belgium,BEL,0,0,15,0,15
2020,Palestinian,PSE,Belgium,BEL,25,5,695,0,725
2020,Georgia,GEO,Belgium,BEL,0,0,60,0,60
2020,Ghana,GHA,Belgium,BEL,0,0,5,0,5
2020,Guinea,GIN,Belgium,BEL,55,5,480,0,540
2020,Cote d'Ivoire,CIV,Belgium,BEL,5,0,25,0,30
2020,India,IND,Belgium,BEL,5,0,5,0,10
2020,Iran (Islamic Rep. of),IRN,Belgium,BEL,0,0,45,0,45
2020,Iraq,IRQ,Belgium,BEL,10,10,590,0,610
2020,Jordan,JOR,Belgium,BEL,0,0,15,0,15
2020,Kazakhstan,KAZ,Belgium,BEL,0,0,5,0,5
2020,Kyrgyzstan,KGZ,Belgium,BEL,0,0,10,0,10
2020,Liberia,LBR,Belgium,BEL,0,0,5,0,5
2020,Libya,LBY,Belgium,BEL,0,0,5,0,5
2020,Lebanon,LBN,Belgium,BEL,5,0,35,0,40
2020,Sri Lanka,LKA,Belgium,BEL,0,0,25,0,25
2020,Lithuania,LTU,Belgium,BEL,0,0,5,0,5
2020,Mauritania,MRT,Belgium,BEL,5,0,40,0,45
2020,North Macedonia,MKD,Belgium,BEL,0,0,75,0,75
2020,Mali,MLI,Belgium,BEL,0,0,15,0,15
2020,Morocco,MAR,Belgium,BEL,0,0,35,0,35
2020,Myanmar,MMR,Belgium,BEL,0,0,5,0,5
2020,Niger,NER,Belgium,BEL,0,0,15,0,15
2020,Nicaragua,NIC,Belgium,BEL,0,0,5,0,5
2020,Nigeria,NGA,Belgium,BEL,0,0,25,0,25
2020,Pakistan,PAK,Belgium,BEL,0,0,50,0,50
2020,Peru,PER,Belgium,BEL,0,0,5,0,5
2020,Russian Federation,RUS,Belgium,BEL,5,0,175,0,180
2020,Rwanda,RWA,Belgium,BEL,5,0,80,0,85
2020,El Salvador,SLV,Belgium,BEL,0,0,120,0,120
2020,Serbia and Kosovo: S/RES/1244 (1999),SRB,Belgium,BEL,10,0,130,0,140
2020,Senegal,SEN,Belgium,BEL,5,0,60,0,65
2020,Sierra Leone,SLE,Belgium,BEL,0,0,15,0,15
2020,Somalia,SOM,Belgium,BEL,0,0,175,0,175
2020,Sudan,SDN,Belgium,BEL,0,0,35,0,35
2020,Suriname,SUR,Belgium,BEL,0,0,20,0,20
2020,Syrian Arab Rep.,SYR,Belgium,BEL,0,0,715,0,715
2020,United Rep. of Tanzania,TZA,Belgium,BEL,0,0,10,0,10
2020,Tajikistan,TJK,Belgium,BEL,0,0,5,0,5
2020,Togo,TGO,Belgium,BEL,0,0,25,0,25
2020,Tunisia,TUN,Belgium,BEL,0,0,10,0,10
2020,Turkey,TUR,Belgium,BEL,45,0,150,0,195
2020,Uganda,UGA,Belgium,BEL,0,0,5,0,5
2020,Ukraine,UKR,Belgium,BEL,0,0,50,0,50
2020,Venezuela (Bolivarian Republic of),VEN,Belgium,BEL,5,0,280,0,285
2020,Yemen,YEM,Belgium,BEL,0,0,65,0,65
2020,Zimbabwe,ZWE,Belgium,BEL,0,0,5,0,5
2020,Stateless,XXA,Belgium,BEL,0,0,10,0,10
2020,Afghanistan,AFG,Finland,FIN,35,13,96,88,232
2020,Albania,ALB,Finland,FIN,0,0,0,5,5
2020,Bangladesh,BGD,Finland,FIN,0,0,5,5,10
2020,Cameroon,CMR,Finland,FIN,0,0,0,13,13
2020,Dem. Rep. of the Congo,COD,Finland,FIN,0,0,0,5,5
2020,Ethiopia,ETH,Finland,FIN,0,0,5,0,5
2020,Gambia,GMB,Finland,FIN,0,0,0,5,5
2020,Georgia,GEO,Finland,FIN,0,0,0,5,5
2020,Ghana,GHA,Finland,FIN,0,0,5,5,10
2020,India,IND,Finland,FIN,0,0,0,5,5
2020,Iran (Islamic Rep. of),IRN,Finland,FIN,10,0,16,21,47
2020,Iraq,IRQ,Finland,FIN,193,37,369,493,1092
2020,Lebanon,LBN,Finland,FIN,0,5,0,0,5
2020,Sri Lanka,LKA,Finland,FIN,0,0,0,14,14
2020,Morocco,MAR,Finland,FIN,0,0,0,5,5
2020,Nigeria,NGA,Finland,FIN,5,0,14,5,24
2020,Russian Federation,RUS,Finland,FIN,5,0,28,68,101
2020,Rwanda,RWA,Finland,FIN,0,0,0,5,5
2020,Somalia,SOM,Finland,FIN,30,5,52,224,311
2020,Turkey,TUR,Finland,FIN,0,0,0,12,12
2020,Ukraine,UKR,Finland,FIN,0,0,5,17,22
2020,Yemen,YEM,Finland,FIN,5,0,0,0,5
2020,Stateless,XXA,Finland,FIN,0,0,0,10,10
2020,Albania,ALB,United Kingdom of Great Britain and Northern Ireland,GBR,5,0,0,0,5
2020,Eritrea,ERI,United Kingdom of Great Britain and Northern Ireland,GBR,0,0,0,5,5
2020,Iran (Islamic Rep. of),IRN,United Kingdom of Great Britain and Northern Ireland,GBR,0,0,0,5,5
2020,Iraq,IRQ,United Kingdom of Great Britain and Northern Ireland,GBR,0,0,0,14,14
2020,Nigeria,NGA,United Kingdom of Great Britain and Northern Ireland,GBR,0,0,5,0,5
2020,Viet Nam,VNM,United Kingdom of Great Britain and Northern Ireland,GBR,0,0,0,5,5
2020,Sudan,SDN,United Kingdom of Great Britain and Northern Ireland,GBR,5,0,0,0,5
2020,Syrian Arab Rep.,SYR,United Kingdom of Great Britain and Northern Ireland,GBR,5,0,0,0,5
2020,Stateless,XXA,United Kingdom of Great Britain and Northern Ireland,GBR,0,0,5,0,5
2020,Afghanistan,AFG,Germany,DEU,159,471,171,1450,2251
2020,Albania,ALB,Germany,DEU,0,0,40,414,454
2020,Algeria,DZA,Germany,DEU,0,0,49,227,276
2020,Angola,AGO,Germany,DEU,0,0,0,15,15
2020,Egypt,EGY,Germany,DEU,14,0,19,98,131
2020,Armenia,ARM,Germany,DEU,0,0,44,197,241
2020,Azerbaijan,AZE,Germany,DEU,10,5,85,268,368
2020,Benin,BEN,Germany,DEU,0,0,0,17,17
2020,Bangladesh,BGD,Germany,DEU,0,5,5,79,89
2020,Burkina Faso,BFA,Germany,DEU,0,0,5,16,21
2020,Belarus,BLR,Germany,DEU,0,0,5,26,31
2020,Bosnia and Herzegovina,BIH,Germany,DEU,0,0,19,212,231
2020,Chad,TCD,Germany,DEU,0,0,5,13,18
2020,China,CHN,Germany,DEU,5,0,14,44,63
2020,Cameroon,CMR,Germany,DEU,0,0,21,65,86
2020,Dem. Rep. of the Congo,COD,Germany,DEU,0,5,0,18,23
2020,Colombia,COL,Germany,DEU,0,0,0,29,29
2020,Cuba,CUB,Germany,DEU,0,0,0,16,16
2020,Djibouti,DJI,Germany,DEU,0,0,0,5,5
2020,Eritrea,ERI,Germany,DEU,43,64,16,120,243
2020,Ethiopia,ETH,Germany,DEU,22,17,26,335,400
2020,Gambia,GMB,Germany,DEU,0,11,29,342,382
2020,Palestinian,PSE,Germany,DEU,0,10,5,16,31
2020,Georgia,GEO,Germany,DEU,5,0,68,462,535
2020,Ghana,GHA,Germany,DEU,0,5,19,103,127
2020,Guinea-Bissau,GNB,Germany,DEU,0,5,0,24,29
2020,Guinea,GIN,Germany,DEU,14,10,97,256,377
2020,Cote d'Ivoire,CIV,Germany,DEU,5,0,21,71,97
2020,India,IND,Germany,DEU,0,5,5,56,66
2020,Iran (Islamic Rep. of),IRN,Germany,DEU,175,31,192,742,1140
2020,Iraq,IRQ,Germany,DEU,157,92,275,1452,1976
2020,Jordan,JOR,Germany,DEU,0,0,5,28,33
2020,Kazakhstan,KAZ,Germany,DEU,0,0,0,12,12
2020,Kenya,KEN,Germany,DEU,0,0,11,16,27
2020,Kyrgyzstan,KGZ,Germany,DEU,5,0,0,19,24
2020,Liberia,LBR,Germany,DEU,0,5,0,26,31
2020,Libya,LBY,Germany,DEU,16,10,10,52,88
2020,Lebanon,LBN,Germany,DEU,0,0,44,127,171
2020,Sri Lanka,LKA,Germany,DEU,0,5,13,31,49
2020,Mauritania,MRT,Germany,DEU,0,0,0,15,15
2020,North Macedonia,MKD,Germany,DEU,0,0,77,378,455
2020,Rep. of Moldova,MDA,Germany,DEU,0,5,22,956,983
2020,Mali,MLI,Germany,DEU,0,5,10,59,74
2020,Mongolia,MNG,Germany,DEU,0,0,10,42,52
2020,Morocco,MAR,Germany,DEU,0,5,26,196,227
2020,Mozambique,MOZ,Germany,DEU,0,0,0,5,5
2020,Montenegro,MNE,Germany,DEU,0,0,10,131,141
2020,Myanmar,MMR,Germany,DEU,0,0,0,5,5
2020,Niger,NER,Germany,DEU,0,0,10,15,25
2020,Nigeria,NGA,Germany,DEU,33,59,185,1611,1888
2020,Pakistan,PAK,Germany,DEU,23,10,73,813,919
2020,Russian Federation,RUS,Germany,DEU,91,20,203,1135,1449
2020,Rwanda,RWA,Germany,DEU,0,0,0,14,14
2020,Serbia and Kosovo: S/RES/1244 (1999),SRB,Germany,DEU,0,5,134,863,1002
2020,Senegal,SEN,Germany,DEU,0,5,5,50,60
2020,Sierra Leone,SLE,Germany,DEU,0,5,10,53,68
2020,Somalia,SOM,Germany,DEU,58,61,43,507,669
2020,Viet Nam,VNM,Germany,DEU,0,0,11,57,68
2020,Sudan,SDN,Germany,DEU,0,5,36,134,175
2020,South Sudan,SSD,Germany,DEU,0,0,0,5,5
2020,Syrian Arab Rep.,SYR,Germany,DEU,357,100,27,1027,1511
2020,United Rep. of Tanzania,TZA,Germany,DEU,0,0,0,5,5
2020,Tajikistan,TJK,Germany,DEU,21,0,15,158,194
2020,Togo,TGO,Germany,DEU,0,0,5,28,33
2020,Tunisia,TUN,Germany,DEU,5,0,17,92,114
2020,Turkey,TUR,Germany,DEU,89,11,219,400,719
2020,Uganda,UGA,Germany,DEU,0,0,0,10,10
2020,Ukraine,UKR,Germany,DEU,0,0,33,217,250
2020,Uzbekistan,UZB,Germany,DEU,0,0,0,10,10
2020,Venezuela (Bolivarian Republic of),VEN,Germany,DEU,5,5,0,14,24
2020,Yemen,YEM,Germany,DEU,0,5,0,15,20
2020,Zimbabwe,ZWE,Germany,DEU,5,0,0,5,10
2020,Stateless,XXA,Germany,DEU,13,5,5,31,54
2020,Afghanistan,AFG,Netherlands,NLD,34,5,139,31,209
2020,Albania,ALB,Netherlands,NLD,0,0,5,0,5
2020,Algeria,DZA,Netherlands,NLD,0,0,15,47,62
2020,Egypt,EGY,Netherlands,NLD,0,0,15,0,15
2020,Armenia,ARM,Netherlands,NLD,0,0,5,0,5
2020,Azerbaijan,AZE,Netherlands,NLD,5,0,13,0,18
2020,Burundi,BDI,Netherlands,NLD,0,0,5,0,5
2020,Burkina Faso,BFA,Netherlands,NLD,0,0,0,5,5
2020,Bosnia and Herzegovina,BIH,Netherlands,NLD,0,0,0,5,5
2020,China,CHN,Netherlands,NLD,0,0,0,5,5
2020,Congo,COG,Netherlands,NLD,0,0,5,0,5
2020,Colombia,COL,Netherlands,NLD,0,0,0,5,5
2020,Cuba,CUB,Netherlands,NLD,11,0,0,0,11
2020,Eritrea,ERI,Netherlands,NLD,11,0,26,11,48
2020,Ethiopia,ETH,Netherlands,NLD,5,0,15,0,20
2020,Gambia,GMB,Netherlands,NLD,0,0,11,5,16
2020,Georgia,GEO,Netherlands,NLD,0,0,12,5,17
2020,Ghana,GHA,Netherlands,NLD,0,0,0,5,5
2020,Guinea,GIN,Netherlands,NLD,0,0,15,5,20
2020,Cote d'Ivoire,CIV,Netherlands,NLD,0,0,5,0,5
2020,India,IND,Netherlands,NLD,0,0,0,10,10
2020,Iran (Islamic Rep. of),IRN,Netherlands,NLD,33,14,73,20,140
2020,Iraq,IRQ,Netherlands,NLD,19,5,75,46,145
2020,Jordan,JOR,Netherlands,NLD,0,0,5,0,5
2020,Liberia,LBR,Netherlands,NLD,0,0,0,5,5
2020,Libya,LBY,Netherlands,NLD,0,0,18,5,23
2020,Lebanon,LBN,Netherlands,NLD,5,0,5,0,10
2020,North Macedonia,MKD,Netherlands,NLD,0,0,0,5,5
2020,Morocco,MAR,Netherlands,NLD,0,0,22,50,72
2020,Myanmar,MMR,Netherlands,NLD,0,0,10,0,10
2020,Nigeria,NGA,Netherlands,NLD,5,0,32,5,42
2020,Pakistan,PAK,Netherlands,NLD,5,5,17,5,32
2020,Russian Federation,RUS,Netherlands,NLD,0,0,5,11,16
2020,Serbia and Kosovo: S/RES/1244 (1999),SRB,Netherlands,NLD,0,0,10,22,32
2020,Senegal,SEN,Netherlands,NLD,0,0,5,0,5
2020,Sierra Leone,SLE,Netherlands,NLD,0,0,10,0,10
2020,Somalia,SOM,Netherlands,NLD,5,0,17,19,41
2020,Sudan,SDN,Netherlands,NLD,0,0,5,5,10
2020,Syrian Arab Rep.,SYR,Netherlands,NLD,53,5,58,19,135
2020,Tunisia,TUN,Netherlands,NLD,0,0,0,13,13
2020,Turkey,TUR,Netherlands,NLD,0,0,14,5,19
2020,Uganda,UGA,Netherlands,NLD,0,0,11,0,11
2020,Ukraine,UKR,Netherlands,NLD,0,0,10,0,10
2020,Uzbekistan,UZB,Netherlands,NLD,0,0,0,5,5
2020,Venezuela (Bolivarian Republic of),VEN,Netherlands,NLD,0,0,11,5,16
2020,Yemen,YEM,Netherlands,NLD,0,0,5,5,10
2020,Zimbabwe,ZWE,Netherlands,NLD,5,0,0,0,5
2020,Stateless,XXA,Netherlands,NLD,5,0,15,5,25
2020,Afghanistan,AFG,Norway,NOR,0,14,0,0,14
2020,China,CHN,Norway,NOR,0,0,0,5,5
2020,Colombia,COL,Norway,NOR,0,0,5,0,5
2020,Eritrea,ERI,Norway,NOR,10,0,0,5,15
2020,Iran (Islamic Rep. of),IRN,Norway,NOR,0,0,5,5,10
2020,Iraq,IRQ,Norway,NOR,5,0,5,0,10
2020,Russian Federation,RUS,Norway,NOR,0,0,0,5,5
2020,Somalia,SOM,Norway,NOR,5,0,0,5,10
2020,Syrian Arab Rep.,SYR,Norway,NOR,12,5,0,0,17
2020,Afghanistan,AFG,Sweden,SWE,30,10,123,34,197
2020,Albania,ALB,Sweden,SWE,0,0,38,5,43
2020,Algeria,DZA,Sweden,SWE,0,0,5,17,22
2020,Angola,AGO,Sweden,SWE,0,0,5,0,5
2020,Egypt,EGY,Sweden,SWE,0,5,39,23,67
2020,Armenia,ARM,Sweden,SWE,5,0,73,5,83
2020,Azerbaijan,AZE,Sweden,SWE,0,0,55,14,69
2020,Burundi,BDI,Sweden,SWE,0,0,5,0,5
2020,Bangladesh,BGD,Sweden,SWE,0,0,30,5,35
2020,Burkina Faso,BFA,Sweden,SWE,0,0,0,5,5
2020,Belarus,BLR,Sweden,SWE,0,0,13,13,26
2020,Bolivia (Plurinational State of),BOL,Sweden,SWE,0,0,5,0,5
2020,Brazil,BRA,Sweden,SWE,0,0,0,5,5
2020,Bosnia and Herzegovina,BIH,Sweden,SWE,0,0,16,5,21
2020,Cameroon,CMR,Sweden,SWE,0,0,0,13,13
2020,Dem. Rep. of the Congo,COD,Sweden,SWE,0,5,20,5,30
2020,Colombia,COL,Sweden,SWE,0,0,5,5,10
2020,Cuba,CUB,Sweden,SWE,5,0,12,5,22
2020,Djibouti,DJI,Sweden,SWE,0,0,12,0,12
2020,Eritrea,ERI,Sweden,SWE,36,5,13,32,86
2020,Ethiopia,ETH,Sweden,SWE,0,5,121,19,145
2020,Gambia,GMB,Sweden,SWE,0,0,12,5,17
2020,Palestinian,PSE,Sweden,SWE,5,0,107,34,146
2020,Georgia,GEO,Sweden,SWE,0,5,25,13,43
2020,Ghana,GHA,Sweden,SWE,0,0,19,0,19
2020,Guinea,GIN,Sweden,SWE,0,0,0,5,5
2020,India,IND,Sweden,SWE,0,0,10,5,15
2020,Iran (Islamic Rep. of),IRN,Sweden,SWE,27,0,102,62,191
2020,Iraq,IRQ,Sweden,SWE,29,5,245,64,343
2020,Jordan,JOR,Sweden,SWE,0,0,29,0,29
2020,Japan,JPN,Sweden,SWE,0,0,0,5,5
2020,Kazakhstan,KAZ,Sweden,SWE,5,0,55,10,70
2020,Kenya,KEN,Sweden,SWE,0,0,12,0,12
2020,Kyrgyzstan,KGZ,Sweden,SWE,0,5,17,11,33
2020,Liberia,LBR,Sweden,SWE,0,0,0,5,5
2020,Libya,LBY,Sweden,SWE,0,0,13,13,26
2020,Lebanon,LBN,Sweden,SWE,0,0,83,5,88
2020,Sri Lanka,LKA,Sweden,SWE,0,0,0,5,5
2020,North Macedonia,MKD,Sweden,SWE,0,0,5,0,5
2020,Mali,MLI,Sweden,SWE,0,0,5,0,5
2020,Mongolia,MNG,Sweden,SWE,0,0,70,15,85
2020,Morocco,MAR,Sweden,SWE,0,0,26,32,58
2020,Nicaragua,NIC,Sweden,SWE,0,0,10,0,10
2020,Nigeria,NGA,Sweden,SWE,10,0,65,20,95
2020,Pakistan,PAK,Sweden,SWE,0,5,24,5,34
2020,Peru,PER,Sweden,SWE,0,0,5,0,5
2020,South Africa,ZAF,Sweden,SWE,0,0,0,5,5
2020,Russian Federation,RUS,Sweden,SWE,5,0,94,30,129
2020,Rwanda,RWA,Sweden,SWE,0,0,5,0,5
2020,El Salvador,SLV,Sweden,SWE,0,0,12,5,17
2020,Serbia and Kosovo: S/RES/1244 (1999),SRB,Sweden,SWE,0,0,47,5,52
2020,Senegal,SEN,Sweden,SWE,0,0,0,5,5
2020,Sierra Leone,SLE,Sweden,SWE,0,0,5,0,5
2020,Somalia,SOM,Sweden,SWE,24,15,187,80,306
2020,Viet Nam,VNM,Sweden,SWE,0,0,5,0,5
2020,Sudan,SDN,Sweden,SWE,0,0,13,0,13
2020,Syrian Arab Rep.,SYR,Sweden,SWE,23,74,50,111,258
2020,United Rep. of Tanzania,TZA,Sweden,SWE,0,0,11,0,11
2020,Thailand,THA,Sweden,SWE,0,0,5,0,5
2020,Tajikistan,TJK,Sweden,SWE,0,0,11,0,11
2020,Tunisia,TUN,Sweden,SWE,0,0,17,0,17
2020,Turkey,TUR,Sweden,SWE,0,0,32,10,42
2020,Uganda,UGA,Sweden,SWE,5,0,17,5,27
2020,Ukraine,UKR,Sweden,SWE,0,5,31,11,47
2020,United States of America,USA,Sweden,SWE,0,0,5,0,5
2020,Uzbekistan,UZB,Sweden,SWE,0,5,125,32,162
2020,Venezuela (Bolivarian Republic of),VEN,Sweden,SWE,0,0,5,0,5
2020,Yemen,YEM,Sweden,SWE,0,13,0,5,18
2020,Stateless,XXA,Sweden,SWE,12,14,114,54,194
2021,Afghanistan,AFG,Finland,FIN,154,13,35,38,240
2021,Angola,AGO,Finland,FIN,0,0,0,5,5
2021,Bangladesh,BGD,Finland,FIN,0,0,5,5,10
2021,Cameroon,CMR,Finland,FIN,0,0,0,5,5
2021,Dem. Rep. of the Congo,COD,Finland,FIN,5,0,0,0,5
2021,Cuba,CUB,Finland,FIN,0,0,0,5,5
2021,Ethiopia,ETH,Finland,FIN,5,0,5,5,15
2021,Gambia,GMB,Finland,FIN,0,0,11,0,11
2021,Georgia,GEO,Finland,FIN,0,0,0,5,5
2021,Iran (Islamic Rep. of),IRN,Finland,FIN,23,0,29,20,72
2021,Iraq,IRQ,Finland,FIN,233,15,330,337,915
2021,Kazakhstan,KAZ,Finland,FIN,0,0,0,5,5
2021,Sri Lanka,LKA,Finland,FIN,0,0,0,5,5
2021,Morocco,MAR,Finland,FIN,0,0,0,5,5
2021,Nigeria,NGA,Finland,FIN,0,0,5,18,23
2021,Russian Federation,RUS,Finland,FIN,19,0,17,108,144
2021,Serbia and Kosovo: S/RES/1244 (1999),SRB,Finland,FIN,0,0,5,0,5
2021,Sierra Leone,SLE,Finland,FIN,0,0,0,5,5
2021,Somalia,SOM,Finland,FIN,74,14,59,139,286
2021,Turkey,TUR,Finland,FIN,0,0,5,14,19
2021,Yemen,YEM,Finland,FIN,0,0,0,5,5
2021,Stateless,XXA,Finland,FIN,5,0,0,0,5
2021,Afghanistan,AFG,United Kingdom of Great Britain and Northern Ireland,GBR,5,0,0,5,10
2021,Albania,ALB,United Kingdom of Great Britain and Northern Ireland,GBR,5,0,0,0,5
2021,Iran (Islamic Rep. of),IRN,United Kingdom of Great Britain and Northern Ireland,GBR,5,0,0,0,5
2021,Iraq,IRQ,United Kingdom of Great Britain and Northern Ireland,GBR,0,0,5,0,5
2021,Libya,LBY,United Kingdom of Great Britain and Northern Ireland,GBR,0,5,0,0,5
2021,Viet Nam,VNM,United Kingdom of Great Britain and Northern Ireland,GBR,5,0,0,0,5
2021,Sudan,SDN,United Kingdom of Great Britain and Northern Ireland,GBR,5,0,0,0,5
2021,Syrian Arab Rep.,SYR,United Kingdom of Great Britain and Northern Ireland,GBR,5,0,0,0,5
2021,Stateless,XXA,United Kingdom of Great Britain and Northern Ireland,GBR,14,0,0,0,14
2021,Afghanistan,AFG,Germany,DEU,166,500,103,1170,1939
2021,Albania,ALB,Germany,DEU,0,0,73,556,629
2021,Algeria,DZA,Germany,DEU,0,5,46,290,341
2021,Angola,AGO,Germany,DEU,0,0,10,10,20
2021,Egypt,EGY,Germany,DEU,26,10,5,82,123
2021,Armenia,ARM,Germany,DEU,0,10,32,215,257
2021,Azerbaijan,AZE,Germany,DEU,5,18,40,296,359
2021,Benin,BEN,Germany,DEU,0,5,5,20,30
2021,Bangladesh,BGD,Germany,DEU,5,0,5,54,64
2021,Burkina Faso,BFA,Germany,DEU,0,0,5,13,18
2021,Belarus,BLR,Germany,DEU,0,0,10,30,40
2021,Bosnia and Herzegovina,BIH,Germany,DEU,0,0,31,712,743
2021,Chad,TCD,Germany,DEU,0,0,0,33,33
2021,China,CHN,Germany,DEU,0,5,22,59,86
2021,Cameroon,CMR,Germany,DEU,0,0,21,60,81
2021,Dem. Rep. of the Congo,COD,Germany,DEU,0,0,5,17,22
2021,Colombia,COL,Germany,DEU,5,0,0,10,15
2021,Cuba,CUB,Germany,DEU,0,0,0,5,5
2021,Eritrea,ERI,Germany,DEU,23,60,19,110,212
2021,Ethiopia,ETH,Germany,DEU,84,21,22,327,454
2021,Gambia,GMB,Germany,DEU,5,10,37,246,298
2021,Palestinian,PSE,Germany,DEU,5,0,0,21,26
2021,Georgia,GEO,Germany,DEU,0,5,82,596,683
2021,Ghana,GHA,Germany,DEU,0,5,19,81,105
2021,Guinea-Bissau,GNB,Germany,DEU,0,0,5,12,17
2021,Guinea,GIN,Germany,DEU,22,17,68,286,393
2021,Cote d'Ivoire,CIV,Germany,DEU,0,0,5,47,52
2021,India,IND,Germany,DEU,5,0,5,43,53
2021,Iran (Islamic Rep. of),IRN,Germany,DEU,178,54,158,714,1104
2021,Iraq,IRQ,Germany,DEU,66,143,232,1246,1687
2021,Jamaica,JAM,Germany,DEU,0,0,0,5,5
2021,Jordan,JOR,Germany,DEU,0,0,10,29,39
2021,Kazakhstan,KAZ,Germany,DEU,0,0,0,13,13
2021,Kenya,KEN,Germany,DEU,0,0,0,10,10
2021,Kyrgyzstan,KGZ,Germany,DEU,0,0,0,5,5
2021,Liberia,LBR,Germany,DEU,0,0,0,25,25
2021,Libya,LBY,Germany,DEU,0,25,10,90,125
2021,Lebanon,LBN,Germany,DEU,0,10,46,154,210
2021,Sri Lanka,LKA,Germany,DEU,5,0,10,63,78
2021,Mauritania,MRT,Germany,DEU,0,0,0,5,5
2021,North Macedonia,MKD,Germany,DEU,0,0,134,1583,1717
2021,Rep. of Moldova,MDA,Germany,DEU,0,0,62,2521,2583
2021,Mali,MLI,Germany,DEU,0,5,5,61,71
2021,Mongolia,MNG,Germany,DEU,0,5,5,41,51
2021,Morocco,MAR,Germany,DEU,0,0,32,202,234
2021,Montenegro,MNE,Germany,DEU,0,0,14,111,125
2021,Myanmar,MMR,Germany,DEU,0,5,5,5,15
2021,Niger,NER,Germany,DEU,0,0,0,11,11
2021,Nicaragua,NIC,Germany,DEU,0,0,0,5,5
2021,Nigeria,NGA,Germany,DEU,40,47,139,1024,1250
2021,Pakistan,PAK,Germany,DEU,34,15,75,733,857
2021,South Africa,ZAF,Germany,DEU,0,0,0,5,5
2021,Russian Federation,RUS,Germany,DEU,79,22,172,939,1212
2021,Serbia and Kosovo: S/RES/1244 (1999),SRB,Germany,DEU,0,5,140,1072,1217
2021,Senegal,SEN,Germany,DEU,0,0,12,52,64
2021,Sierra Leone,SLE,Germany,DEU,0,5,5,43,53
2021,Somalia,SOM,Germany,DEU,105,58,52,379,594
2021,Viet Nam,VNM,Germany,DEU,0,0,10,50,60
2021,Sudan,SDN,Germany,DEU,5,10,19,145,179
2021,Syrian Arab Rep.,SYR,Germany,DEU,218,498,78,18702,19496
2021,United Rep. of Tanzania,TZA,Germany,DEU,0,0,0,5,5
2021,Tajikistan,TJK,Germany,DEU,23,5,24,135,187
2021,Turkmenistan,TKM,Germany,DEU,0,0,0,5,5
2021,Togo,TGO,Germany,DEU,0,0,5,24,29
2021,Tunisia,TUN,Germany,DEU,0,0,20,89,109
2021,Turkey,TUR,Germany,DEU,107,10,189,539,845
2021,Uganda,UGA,Germany,DEU,5,0,0,5,10
2021,Ukraine,UKR,Germany,DEU,0,0,42,205,247
2021,Uzbekistan,UZB,Germany,DEU,0,0,0,5,5
2021,Venezuela (Bolivarian Republic of),VEN,Germany,DEU,14,0,0,10,24
2021,Yemen,YEM,Germany,DEU,0,0,0,12,12
2021,Zimbabwe,ZWE,Germany,DEU,5,0,0,5,10
2021,Stateless,XXA,Germany,DEU,10,0,5,76,91
2021,Afghanistan,AFG,Netherlands,NLD,53,5,62,12,132
2021,Algeria,DZA,Netherlands,NLD,0,0,10,40,50
2021,Angola,AGO,Netherlands,NLD,0,0,5,0,5
2021,Egypt,EGY,Netherlands,NLD,0,0,18,5,23
2021,Armenia,ARM,Netherlands,NLD,0,0,12,0,12
2021,Azerbaijan,AZE,Netherlands,NLD,5,0,5,0,10
2021,Bangladesh,BGD,Netherlands,NLD,5,0,0,0,5
2021,Belarus,BLR,Netherlands,NLD,0,0,0,10,10
2021,China,CHN,Netherlands,NLD,5,0,0,5,10
2021,Cameroon,CMR,Netherlands,NLD,5,0,0,0,5
2021,Dem. Rep. of the Congo,COD,Netherlands,NLD,0,0,5,0,5
2021,Colombia,COL,Netherlands,NLD,0,0,5,5,10
2021,Cuba,CUB,Netherlands,NLD,10,5,0,0,15
2021,Eritrea,ERI,Netherlands,NLD,23,0,16,10,49
2021,Ethiopia,ETH,Netherlands,NLD,11,0,5,5,21
2021,Gambia,GMB,Netherlands,NLD,0,0,17,13,30
2021,Georgia,GEO,Netherlands,NLD,0,0,14,0,14
2021,Ghana,GHA,Netherlands,NLD,0,0,0,5,5
2021,Guinea,GIN,Netherlands,NLD,5,0,10,10,25
2021,Cote d'Ivoire,CIV,Netherlands,NLD,0,0,5,0,5
2021,India,IND,Netherlands,NLD,0,0,11,0,11
2021,Iran (Islamic Rep. of),IRN,Netherlands,NLD,67,13,69,17,166
2021,Iraq,IRQ,Netherlands,NLD,24,0,63,34,121
2021,Jordan,JOR,Netherlands,NLD,0,0,11,0,11
2021,Kenya,KEN,Netherlands,NLD,0,0,5,0,5
2021,Libya,LBY,Netherlands,NLD,0,0,17,12,29
2021,Lebanon,LBN,Netherlands,NLD,0,0,5,0,5
2021,Sri Lanka,LKA,Netherlands,NLD,0,0,5,12,17
2021,Morocco,MAR,Netherlands,NLD,0,0,11,55,66
2021,Myanmar,MMR,Netherlands,NLD,0,0,5,0,5
2021,Nigeria,NGA,Netherlands,NLD,5,0,35,46,86
2021,Pakistan,PAK,Netherlands,NLD,5,0,5,0,10
2021,Russian Federation,RUS,Netherlands,NLD,0,0,12,10,22
2021,Serbia and Kosovo: S/RES/1244 (1999),SRB,Netherlands,NLD,0,0,10,0,10
2021,Senegal,SEN,Netherlands,NLD,0,0,5,0,5
2021,Sierra Leone,SLE,Netherlands,NLD,0,0,13,5,18
2021,Somalia,SOM,Netherlands,NLD,5,0,20,19,44
2021,Sudan,SDN,Netherlands,NLD,5,0,0,5,10
2021,Syrian Arab Rep.,SYR,Netherlands,NLD,62,0,49,30,141
2021,Tajikistan,TJK,Netherlands,NLD,0,0,5,0,5
2021,Tunisia,TUN,Netherlands,NLD,0,0,0,11,11
2021,Turkey,TUR,Netherlands,NLD,12,0,5,5,22
2021,Uganda,UGA,Netherlands,NLD,5,0,12,5,22
2021,Ukraine,UKR,Netherlands,NLD,0,0,5,5,10
2021,United States of America,USA,Netherlands,NLD,0,0,5,0,5
2021,Venezuela (Bolivarian Republic of),VEN,Netherlands,NLD,5,5,5,5,20
2021,Yemen,YEM,Netherlands,NLD,10,0,5,5,20
2021,Zimbabwe,ZWE,Netherlands,NLD,0,0,5,0,5
2021,Stateless,XXA,Netherlands,NLD,5,0,11,5,21
2021,Afghanistan,AFG,Norway,NOR,0,0,0,5,5
2021,China,CHN,Norway,NOR,5,0,0,0,5
2021,Eritrea,ERI,Norway,NOR,5,0,0,0,5
2021,Iran (Islamic Rep. of),IRN,Norway,NOR,0,0,0,5,5
2021,Iraq,IRQ,Norway,NOR,0,0,5,0,5
2021,Nigeria,NGA,Norway,NOR,0,0,0,5,5
2021,Russian Federation,RUS,Norway,NOR,0,0,0,5,5
2021,Somalia,SOM,Norway,NOR,0,0,5,0,5
2021,Syrian Arab Rep.,SYR,Norway,NOR,10,0,0,0,10
2021,Afghanistan,AFG,Sweden,SWE,86,5,92,37,220
2021,Albania,ALB,Sweden,SWE,0,0,23,10,33
2021,Algeria,DZA,Sweden,SWE,0,0,19,11,30
2021,Angola,AGO,Sweden,SWE,0,0,5,0,5
2021,Egypt,EGY,Sweden,SWE,0,0,27,5,32
2021,Armenia,ARM,Sweden,SWE,5,0,60,0,65
2021,Azerbaijan,AZE,Sweden,SWE,0,0,61,11,72
2021,Bangladesh,BGD,Sweden,SWE,0,0,31,5,36
2021,Belarus,BLR,Sweden,SWE,0,0,18,10,28
2021,Bosnia and Herzegovina,BIH,Sweden,SWE,0,0,21,5,26
2021,China,CHN,Sweden,SWE,0,0,13,0,13
2021,Chile,CHL,Sweden,SWE,0,0,5,0,5
2021,Cameroon,CMR,Sweden,SWE,0,0,10,10,20
2021,Dem. Rep. of the Congo,COD,Sweden,SWE,0,0,5,0,5
2021,Cuba,CUB,Sweden,SWE,0,0,10,0,10
2021,Djibouti,DJI,Sweden,SWE,0,0,10,0,10
2021,Eritrea,ERI,Sweden,SWE,34,0,19,42,95
2021,Ethiopia,ETH,Sweden,SWE,5,0,102,15,122
2021,Gambia,GMB,Sweden,SWE,0,0,16,5,21
2021,Palestinian,PSE,Sweden,SWE,5,0,87,24,116
2021,Georgia,GEO,Sweden,SWE,0,0,71,11,82
2021,Ghana,GHA,Sweden,SWE,0,0,5,0,5
2021,Guinea,GIN,Sweden,SWE,0,0,5,0,5
2021,Honduras,HND,Sweden,SWE,0,5,0,0,5
2021,India,IND,Sweden,SWE,0,0,5,0,5
2021,Iran (Islamic Rep. of),IRN,Sweden,SWE,37,0,67,43,147
2021,Iraq,IRQ,Sweden,SWE,21,12,267,54,354
2021,Jordan,JOR,Sweden,SWE,5,0,28,5,38
2021,Kazakhstan,KAZ,Sweden,SWE,0,0,40,12,52
2021,Kenya,KEN,Sweden,SWE,0,0,10,5,15
2021,Kyrgyzstan,KGZ,Sweden,SWE,0,0,29,5,34
2021,Liberia,LBR,Sweden,SWE,0,0,5,0,5
2021,Libya,LBY,Sweden,SWE,0,0,35,12,47
2021,Lebanon,LBN,Sweden,SWE,10,5,47,0,62
2021,Sri Lanka,LKA,Sweden,SWE,0,0,5,0,5
2021,North Macedonia,MKD,Sweden,SWE,0,5,0,0,5
2021,Mongolia,MNG,Sweden,SWE,0,5,109,10,124
2021,Morocco,MAR,Sweden,SWE,5,0,32,22,59
2021,Niger,NER,Sweden,SWE,0,0,0,5,5
2021,Nigeria,NGA,Sweden,SWE,5,0,59,21,85
2021,Pakistan,PAK,Sweden,SWE,5,0,12,10,27
2021,Peru,PER,Sweden,SWE,0,0,5,0,5
2021,South Africa,ZAF,Sweden,SWE,0,0,5,0,5
2021,Russian Federation,RUS,Sweden,SWE,5,0,84,22,111
2021,Rwanda,RWA,Sweden,SWE,0,0,5,0,5
2021,El Salvador,SLV,Sweden,SWE,0,0,15,5,20
2021,Serbia and Kosovo: S/RES/1244 (1999),SRB,Sweden,SWE,0,0,69,16,85
2021,Sierra Leone,SLE,Sweden,SWE,0,0,5,0,5
2021,Somalia,SOM,Sweden,SWE,23,10,124,55,212
2021,Viet Nam,VNM,Sweden,SWE,0,0,11,0,11
2021,Sudan,SDN,Sweden,SWE,0,0,13,0,13
2021,Syrian Arab Rep.,SYR,Sweden,SWE,23,18,23,70,134
2021,United Rep. of Tanzania,TZA,Sweden,SWE,0,0,5,5,10
2021,Tajikistan,TJK,Sweden,SWE,0,0,5,0,5
2021,Tunisia,TUN,Sweden,SWE,0,0,13,5,18
2021,Turkey,TUR,Sweden,SWE,0,0,17,5,22
2021,Uganda,UGA,Sweden,SWE,5,0,5,0,10
2021,Ukraine,UKR,Sweden,SWE,0,0,65,5,70
2021,United States of America,USA,Sweden,SWE,0,0,5,0,5
2021,Uzbekistan,UZB,Sweden,SWE,5,0,96,18,119
2021,Venezuela (Bolivarian Republic of),VEN,Sweden,SWE,0,0,10,0,10
2021,Yemen,YEM,Sweden,SWE,0,0,0,13,13
2021,Stateless,XXA,Sweden,SWE,39,10,118,36,203
2010,Afghanistan,AFG,Ireland,IRL,0,0,10,0,10
2010,Albania,ALB,Ireland,IRL,0,0,10,0,10
2010,Angola,AGO,Ireland,IRL,0,0,5,0,5
2010,Bangladesh,BGD,Ireland,IRL,0,0,5,0,5
2010,Cameroon,CMR,Ireland,IRL,0,0,43,0,43
2010,Dem. Rep. of the Congo,COD,Ireland,IRL,0,0,14,0,14
2010,Georgia,GEO,Ireland,IRL,0,0,70,0,70
2010,Ghana,GHA,Ireland,IRL,0,0,18,0,18
2010,Iraq,IRQ,Ireland,IRL,0,0,5,0,5
2010,Kenya,KEN,Ireland,IRL,0,0,16,0,16
2010,Liberia,LBR,Ireland,IRL,0,0,15,0,15
2010,Rep. of Moldova,MDA,Ireland,IRL,0,0,26,0,26
2010,Morocco,MAR,Ireland,IRL,0,0,5,0,5
2010,Nigeria,NGA,Ireland,IRL,0,0,191,0,191
2010,Pakistan,PAK,Ireland,IRL,0,0,16,0,16
2010,South Africa,ZAF,Ireland,IRL,0,0,21,0,21
2010,Sierra Leone,SLE,Ireland,IRL,0,0,5,0,5
2010,Somalia,SOM,Ireland,IRL,0,0,12,0,12
2010,Viet Nam,VNM,Ireland,IRL,0,0,5,0,5
2010,Zimbabwe,ZWE,Ireland,IRL,0,0,5,0,5
2011,Afghanistan,AFG,Ireland,IRL,0,0,10,0,10
2011,Albania,ALB,Ireland,IRL,0,0,27,0,27
2011,Algeria,DZA,Ireland,IRL,0,0,12,0,12
2011,Armenia,ARM,Ireland,IRL,0,0,5,0,5
2011,Burundi,BDI,Ireland,IRL,0,0,13,0,13
2011,Bangladesh,BGD,Ireland,IRL,0,0,30,0,30
2011,Cameroon,CMR,Ireland,IRL,0,0,27,0,27
2011,Congo,COG,Ireland,IRL,0,0,11,0,11
2011,Dem. Rep. of the Congo,COD,Ireland,IRL,0,0,153,0,153
2011,Palestinian,PSE,Ireland,IRL,0,5,0,0,5
2011,Georgia,GEO,Ireland,IRL,0,0,30,0,30
2011,Ghana,GHA,Ireland,IRL,0,0,50,0,50
2011,Guinea,GIN,Ireland,IRL,0,0,10,0,10
2011,Croatia,HRV,Ireland,IRL,0,0,5,0,5
2011,Iran (Islamic Rep. of),IRN,Ireland,IRL,0,0,11,0,11
2011,Iraq,IRQ,Ireland,IRL,0,0,5,0,5
2011,Kenya,KEN,Ireland,IRL,0,0,10,0,10
2011,Rep. of Moldova,MDA,Ireland,IRL,0,0,5,0,5
2011,Malawi,MWI,Ireland,IRL,0,0,5,0,5
2011,Nigeria,NGA,Ireland,IRL,0,0,230,0,230
2011,Pakistan,PAK,Ireland,IRL,0,0,71,0,71
2011,South Africa,ZAF,Ireland,IRL,0,0,12,0,12
2011,Sierra Leone,SLE,Ireland,IRL,0,0,17,0,17
2011,Somalia,SOM,Ireland,IRL,0,0,27,0,27
2011,Sudan,SDN,Ireland,IRL,0,0,12,0,12
2011,Uganda,UGA,Ireland,IRL,0,0,16,0,16
2011,Zimbabwe,ZWE,Ireland,IRL,0,0,5,0,5
2012,Afghanistan,AFG,Ireland,IRL,0,0,10,0,10
2012,Algeria,DZA,Ireland,IRL,0,0,5,0,5
2012,Angola,AGO,Ireland,IRL,0,0,10,0,10
2012,Bangladesh,BGD,Ireland,IRL,0,0,5,0,5
2012,Bhutan,BTN,Ireland,IRL,0,0,5,0,5
2012,China,CHN,Ireland,IRL,0,0,5,0,5
2012,Cameroon,CMR,Ireland,IRL,0,0,14,0,14
2012,Dem. Rep. of the Congo,COD,Ireland,IRL,0,0,5,0,5
2012,Georgia,GEO,Ireland,IRL,0,0,17,0,17
2012,Ghana,GHA,Ireland,IRL,0,0,43,0,43
2012,Kenya,KEN,Ireland,IRL,0,0,10,0,10
2012,Liberia,LBR,Ireland,IRL,0,0,5,0,5
2012,Rep. of Moldova,MDA,Ireland,IRL,0,0,5,0,5
2012,Nigeria,NGA,Ireland,IRL,0,0,69,0,69
2012,Pakistan,PAK,Ireland,IRL,0,11,93,0,104
2012,Rwanda,RWA,Ireland,IRL,0,0,5,0,5
2012,Serbia and Kosovo: S/RES/1244 (1999),SRB,Ireland,IRL,0,0,5,0,5
2012,Sierra Leone,SLE,Ireland,IRL,0,0,5,0,5
2012,Somalia,SOM,Ireland,IRL,0,10,17,0,27
2012,Sudan,SDN,Ireland,IRL,0,0,5,0,5
2012,Zimbabwe,ZWE,Ireland,IRL,0,0,13,0,13
2013,Afghanistan,AFG,Ireland,IRL,0,0,43,0,43
2013,Albania,ALB,Ireland,IRL,0,0,5,0,5
2013,Algeria,DZA,Ireland,IRL,0,0,11,0,11
2013,Angola,AGO,Ireland,IRL,0,0,13,0,13
2013,Armenia,ARM,Ireland,IRL,0,5,0,0,5
2013,Bangladesh,BGD,Ireland,IRL,0,0,5,0,5
2013,Bhutan,BTN,Ireland,IRL,0,0,5,0,5
2013,Belarus,BLR,Ireland,IRL,0,0,5,0,5
2013,Cameroon,CMR,Ireland,IRL,0,0,16,5,21
2013,Congo,COG,Ireland,IRL,0,0,12,0,12
2013,Dem. Rep. of the Congo,COD,Ireland,IRL,0,0,44,0,44
2013,Palestinian,PSE,Ireland,IRL,0,0,5,0,5
2013,Georgia,GEO,Ireland,IRL,0,0,12,0,12
2013,Ghana,GHA,Ireland,IRL,0,0,29,5,34
2013,Croatia,HRV,Ireland,IRL,0,0,5,0,5
2013,India,IND,Ireland,IRL,0,0,5,0,5
2013,Iran (Islamic Rep. of),IRN,Ireland,IRL,0,0,0,12,12
2013,Iraq,IRQ,Ireland,IRL,0,0,19,10,29
2013,Israel,ISR,Ireland,IRL,0,0,0,5,5
2013,Kenya,KEN,Ireland,IRL,0,0,14,0,14
2013,Kuwait,KWT,Ireland,IRL,0,0,0,5,5
2013,Liberia,LBR,Ireland,IRL,0,0,11,0,11
2013,Lebanon,LBN,Ireland,IRL,0,0,10,0,10
2013,Rep. of Moldova,MDA,Ireland,IRL,0,0,22,0,22
2013,Malawi,MWI,Ireland,IRL,0,0,5,0,5
2013,Nepal,NPL,Ireland,IRL,0,0,0,5,5
2013,Nigeria,NGA,Ireland,IRL,0,0,72,34,106
2013,Pakistan,PAK,Ireland,IRL,0,5,26,5,36
2013,Serbia and Kosovo: S/RES/1244 (1999),SRB,Ireland,IRL,0,0,19,0,19
2013,Somalia,SOM,Ireland,IRL,0,5,10,5,20
2013,Sudan,SDN,Ireland,IRL,0,0,23,0,23
2013,Syrian Arab Rep.,SYR,Ireland,IRL,0,10,0,0,10
2013,Togo,TGO,Ireland,IRL,0,0,10,0,10
2013,Uganda,UGA,Ireland,IRL,0,0,11,0,11
2013,Venezuela (Bolivarian Republic of),VEN,Ireland,IRL,0,0,5,0,5
2013,Zimbabwe,ZWE,Ireland,IRL,0,0,47,0,47
2014,Afghanistan,AFG,Ireland,IRL,42,0,32,35,109
2014,Albania,ALB,Ireland,IRL,0,0,10,28,38
2014,Algeria,DZA,Ireland,IRL,0,0,24,51,75
2014,Angola,AGO,Ireland,IRL,0,0,5,16,21
2014,Egypt,EGY,Ireland,IRL,0,0,0,11,11
2014,Armenia,ARM,Ireland,IRL,0,0,5,5,10
2014,Azerbaijan,AZE,Ireland,IRL,0,0,0,5,5
2014,Burundi,BDI,Ireland,IRL,0,0,0,5,5
2014,Benin,BEN,Ireland,IRL,0,0,12,0,12
2014,Bangladesh,BGD,Ireland,IRL,0,0,21,25,46
2014,Bhutan,BTN,Ireland,IRL,5,0,5,18,28
2014,Belarus,BLR,Ireland,IRL,0,0,0,10,10
2014,Bolivia (Plurinational State of),BOL,Ireland,IRL,5,0,0,0,5
2014,Botswana,BWA,Ireland,IRL,0,0,0,5,5
2014,Brazil,BRA,Ireland,IRL,0,0,0,5,5
2014,China,CHN,Ireland,IRL,0,0,11,42,53
2014,Cameroon,CMR,Ireland,IRL,5,0,24,44,73
2014,Congo,COG,Ireland,IRL,0,0,10,14,24
2014,Dem. Rep. of the Congo,COD,Ireland,IRL,22,0,36,74,132
2014,Cabo Verde,CPV,Ireland,IRL,0,0,5,0,5
2014,Eritrea,ERI,Ireland,IRL,10,0,12,10,32
2014,Ethiopia,ETH,Ireland,IRL,0,0,0,14,14
2014,Palestinian,PSE,Ireland,IRL,12,0,0,0,12
2014,Georgia,GEO,Ireland,IRL,5,0,31,81,117
2014,Ghana,GHA,Ireland,IRL,0,0,22,57,79
2014,Guinea,GIN,Ireland,IRL,0,0,5,16,21
2014,Guyana,GUY,Ireland,IRL,0,0,0,5,5
2014,Cote d'Ivoire,CIV,Ireland,IRL,0,0,0,14,14
2014,India,IND,Ireland,IRL,0,0,0,18,18
2014,Iran (Islamic Rep. of),IRN,Ireland,IRL,12,0,10,26,48
2014,Iraq,IRQ,Ireland,IRL,33,0,5,32,70
2014,Kenya,KEN,Ireland,IRL,0,0,10,21,31
2014,Kuwait,KWT,Ireland,IRL,5,0,0,5,10
2014,Liberia,LBR,Ireland,IRL,0,0,5,18,23
2014,Libya,LBY,Ireland,IRL,0,0,0,5,5
2014,Sri Lanka,LKA,Ireland,IRL,5,0,0,5,10
2014,Rep. of Moldova,MDA,Ireland,IRL,0,0,5,36,41
2014,Malawi,MWI,Ireland,IRL,0,0,5,13,18
2014,Mongolia,MNG,Ireland,IRL,0,0,0,5,5
2014,Morocco,MAR,Ireland,IRL,0,0,10,5,15
2014,Mauritius,MUS,Ireland,IRL,0,0,12,0,12
2014,Myanmar,MMR,Ireland,IRL,5,0,0,0,5
2014,Nepal,NPL,Ireland,IRL,0,0,5,17,22
2014,Niger,NER,Ireland,IRL,0,0,5,0,5
2014,Nigeria,NGA,Ireland,IRL,5,0,66,268,339
2014,Pakistan,PAK,Ireland,IRL,18,0,43,109,170
2014,South Africa,ZAF,Ireland,IRL,0,0,15,18,33
2014,Russian Federation,RUS,Ireland,IRL,5,0,5,20,30
2014,Rwanda,RWA,Ireland,IRL,0,0,5,5,10
2014,Serbia and Kosovo: S/RES/1244 (1999),SRB,Ireland,IRL,0,0,5,26,31
2014,Sierra Leone,SLE,Ireland,IRL,0,0,5,19,24
2014,Somalia,SOM,Ireland,IRL,27,0,5,36,68
2014,Sudan,SDN,Ireland,IRL,29,0,10,61,100
2014,Eswatini,SWZ,Ireland,IRL,0,0,0,5,5
2014,Togo,TGO,Ireland,IRL,0,0,5,13,18
2014,Uganda,UGA,Ireland,IRL,5,0,14,18,37
2014,Ukraine,UKR,Ireland,IRL,0,0,10,15,25
2014,Zimbabwe,ZWE,Ireland,IRL,13,0,48,49,110
2015,Afghanistan,AFG,Ireland,IRL,44,0,10,15,69
2015,Albania,ALB,Ireland,IRL,0,0,60,18,78
2015,Algeria,DZA,Ireland,IRL,5,0,37,36,78
2015,Angola,AGO,Ireland,IRL,0,0,14,0,14
2015,Egypt,EGY,Ireland,IRL,0,0,10,0,10
2015,Armenia,ARM,Ireland,IRL,0,0,5,0,5
2015,Burundi,BDI,Ireland,IRL,5,0,0,0,5
2015,Benin,BEN,Ireland,IRL,0,0,5,5,10
2015,Bangladesh,BGD,Ireland,IRL,0,0,26,23,49
2015,Bhutan,BTN,Ireland,IRL,0,0,0,13,13
2015,Belarus,BLR,Ireland,IRL,0,0,0,5,5
2015,Bolivia (Plurinational State of),BOL,Ireland,IRL,0,0,5,0,5
2015,Brazil,BRA,Ireland,IRL,0,0,5,5,10
2015,China,CHN,Ireland,IRL,0,0,15,12,27
2015,Cameroon,CMR,Ireland,IRL,0,0,15,23,38
2015,Congo,COG,Ireland,IRL,5,0,5,16,26
2015,Dem. Rep. of the Congo,COD,Ireland,IRL,21,0,68,24,113
2015,Cabo Verde,CPV,Ireland,IRL,0,0,0,5,5
2015,Eritrea,ERI,Ireland,IRL,12,0,0,0,12
2015,Ethiopia,ETH,Ireland,IRL,0,0,5,5,10
2015,Georgia,GEO,Ireland,IRL,0,0,15,29,44
2015,Ghana,GHA,Ireland,IRL,0,0,18,15,33
2015,Guinea,GIN,Ireland,IRL,0,0,5,5,10
2015,Cote d'Ivoire,CIV,Ireland,IRL,0,0,5,5,10
2015,India,IND,Ireland,IRL,0,0,0,12,12
2015,Iran (Islamic Rep. of),IRN,Ireland,IRL,14,0,0,15,29
2015,Iraq,IRQ,Ireland,IRL,14,0,0,13,27
2015,Jordan,JOR,Ireland,IRL,0,0,5,0,5
2015,Kenya,KEN,Ireland,IRL,10,0,0,5,15
2015,Kuwait,KWT,Ireland,IRL,5,0,0,5,10
2015,Liberia,LBR,Ireland,IRL,0,0,0,13,13
2015,Libya,LBY,Ireland,IRL,5,0,0,0,5
2015,Lesotho,LSO,Ireland,IRL,0,0,5,0,5
2015,Sri Lanka,LKA,Ireland,IRL,0,0,5,5,10
2015,Rep. of Moldova,MDA,Ireland,IRL,0,0,5,21,26
2015,Malawi,MWI,Ireland,IRL,5,0,27,16,48
2015,Morocco,MAR,Ireland,IRL,0,0,0,10,10
2015,Mauritius,MUS,Ireland,IRL,0,0,11,10,21
2015,Nepal,NPL,Ireland,IRL,0,0,10,5,15
2015,Niger,NER,Ireland,IRL,0,0,5,5,10
2015,Nigeria,NGA,Ireland,IRL,0,0,111,173,284
2015,Pakistan,PAK,Ireland,IRL,16,0,72,74,162
2015,Philippines,PHL,Ireland,IRL,0,0,5,0,5
2015,South Africa,ZAF,Ireland,IRL,5,0,18,13,36
2015,Russian Federation,RUS,Ireland,IRL,0,0,0,5,5
2015,Rwanda,RWA,Ireland,IRL,5,0,5,0,10
2015,Serbia and Kosovo: S/RES/1244 (1999),SRB,Ireland,IRL,0,0,5,5,10
2015,Sierra Leone,SLE,Ireland,IRL,0,0,11,10,21
2015,Somalia,SOM,Ireland,IRL,12,0,10,15,37
2015,Sudan,SDN,Ireland,IRL,5,0,10,20,35
2015,Syrian Arab Rep.,SYR,Ireland,IRL,5,0,0,0,5
2015,Togo,TGO,Ireland,IRL,0,0,5,0,5
2015,Turkey,TUR,Ireland,IRL,5,0,0,0,5
2015,Uganda,UGA,Ireland,IRL,5,0,13,0,18
2015,Ukraine,UKR,Ireland,IRL,0,0,10,5,15
2015,Zimbabwe,ZWE,Ireland,IRL,10,0,71,41,122
2016,Afghanistan,AFG,Ireland,IRL,18,0,5,15,38
2016,Albania,ALB,Ireland,IRL,5,0,42,11,58
2016,Algeria,DZA,Ireland,IRL,5,0,34,15,54
2016,Egypt,EGY,Ireland,IRL,0,0,5,10,15
2016,Armenia,ARM,Ireland,IRL,0,0,5,0,5
2016,Burundi,BDI,Ireland,IRL,0,0,5,0,5
2016,Bangladesh,BGD,Ireland,IRL,5,0,22,5,32
2016,Bhutan,BTN,Ireland,IRL,0,0,5,0,5
2016,Belarus,BLR,Ireland,IRL,0,0,0,5,5
2016,Cameroon,CMR,Ireland,IRL,5,0,5,5,15
2016,Congo,COG,Ireland,IRL,0,0,0,5,5
2016,Dem. Rep. of the Congo,COD,Ireland,IRL,10,0,24,27,61
2016,Ethiopia,ETH,Ireland,IRL,5,0,0,5,10
2016,Palestinian,PSE,Ireland,IRL,0,0,0,5,5
2016,Georgia,GEO,Ireland,IRL,5,0,0,26,31
2016,Ghana,GHA,Ireland,IRL,5,0,5,10,20
2016,"China, Hong Kong SAR",HKG,Ireland,IRL,0,0,10,5,15
2016,Cote d'Ivoire,CIV,Ireland,IRL,0,0,10,0,10
2016,India,IND,Ireland,IRL,0,0,5,5,10
2016,Iran (Islamic Rep. of),IRN,Ireland,IRL,0,0,0,10,10
2016,Iraq,IRQ,Ireland,IRL,0,0,5,11,16
2016,Israel,ISR,Ireland,IRL,5,0,0,0,5
2016,Liberia,LBR,Ireland,IRL,0,0,5,0,5
2016,Sri Lanka,LKA,Ireland,IRL,5,0,0,0,5
2016,Rep. of Moldova,MDA,Ireland,IRL,0,0,0,15,15
2016,Malawi,MWI,Ireland,IRL,0,0,29,0,29
2016,Mauritius,MUS,Ireland,IRL,0,0,5,10,15
2016,Nepal,NPL,Ireland,IRL,0,0,0,5,5
2016,Nigeria,NGA,Ireland,IRL,10,0,59,94,163
2016,Pakistan,PAK,Ireland,IRL,16,0,85,66,167
2016,South Africa,ZAF,Ireland,IRL,0,0,15,12,27
2016,Rwanda,RWA,Ireland,IRL,0,0,5,5,10
2016,Serbia and Kosovo: S/RES/1244 (1999),SRB,Ireland,IRL,0,0,0,5,5
2016,Sierra Leone,SLE,Ireland,IRL,0,0,5,5,10
2016,Somalia,SOM,Ireland,IRL,5,0,0,10,15
2016,Sudan,SDN,Ireland,IRL,0,0,5,24,29
2016,Uganda,UGA,Ireland,IRL,5,0,0,5,10
2016,Ukraine,UKR,Ireland,IRL,5,0,5,5,15
2016,Venezuela (Bolivarian Republic of),VEN,Ireland,IRL,0,0,5,0,5
2016,Zimbabwe,ZWE,Ireland,IRL,23,0,42,16,81
2020,Algeria,DZA,Ireland,IRL,0,0,5,0,5
2020,Pakistan,PAK,Ireland,IRL,0,0,5,0,5
2021,Malawi,MWI,Ireland,IRL,0,5,0,0,5
2021,Nigeria,NGA,Ireland,IRL,0,5,0,0,5
2010,Afghanistan,AFG,Russian Federation,RUS,0,392,398,0,790
2010,Angola,AGO,Russian Federation,RUS,0,5,0,0,5
2010,Azerbaijan,AZE,Russian Federation,RUS,0,0,5,0,5
2010,Palestinian,PSE,Russian Federation,RUS,0,0,11,0,11
2010,Georgia,GEO,Russian Federation,RUS,0,525,362,0,887
2010,India,IND,Russian Federation,RUS,0,5,0,0,5
2010,Iraq,IRQ,Russian Federation,RUS,0,5,10,0,15
2010,Kyrgyzstan,KGZ,Russian Federation,RUS,0,0,33,0,33
2010,Dem. People's Rep. of Korea,PRK,Russian Federation,RUS,0,5,22,0,27
2010,Serbia and Kosovo: S/RES/1244 (1999),SRB,Russian Federation,RUS,0,0,5,0,5
2010,Somalia,SOM,Russian Federation,RUS,0,5,5,0,10
2010,Sudan,SDN,Russian Federation,RUS,0,5,0,0,5
2010,Tajikistan,TJK,Russian Federation,RUS,0,5,11,0,16
2010,Turkmenistan,TKM,Russian Federation,RUS,0,10,5,0,15
2010,Ukraine,UKR,Russian Federation,RUS,0,10,0,0,10
2010,Uzbekistan,UZB,Russian Federation,RUS,0,52,40,0,92
2011,Afghanistan,AFG,Russian Federation,RUS,277,0,0,184,461
2011,Angola,AGO,Russian Federation,RUS,0,0,0,5,5
2011,Azerbaijan,AZE,Russian Federation,RUS,5,0,0,5,10
2011,Dem. Rep. of the Congo,COD,Russian Federation,RUS,0,0,0,5,5
2011,Cuba,CUB,Russian Federation,RUS,0,0,0,5,5
2011,Ethiopia,ETH,Russian Federation,RUS,0,0,0,5,5
2011,Georgia,GEO,Russian Federation,RUS,286,0,0,95,381
2011,Iraq,IRQ,Russian Federation,RUS,0,0,0,5,5
2011,Kyrgyzstan,KGZ,Russian Federation,RUS,20,0,0,20,40
2011,Dem. People's Rep. of Korea,PRK,Russian Federation,RUS,13,0,0,24,37
2011,Rep. of Moldova,MDA,Russian Federation,RUS,5,0,0,0,5
2011,Nigeria,NGA,Russian Federation,RUS,5,0,0,0,5
2011,Sudan,SDN,Russian Federation,RUS,0,0,0,5,5
2011,Syrian Arab Rep.,SYR,Russian Federation,RUS,0,0,0,11,11
2011,Tajikistan,TJK,Russian Federation,RUS,0,0,0,17,17
2011,Ukraine,UKR,Russian Federation,RUS,0,0,0,5,5
2011,Uzbekistan,UZB,Russian Federation,RUS,23,0,0,21,44
2012,Afghanistan,AFG,Russian Federation,RUS,229,0,258,0,487
2012,Angola,AGO,Russian Federation,RUS,0,0,5,0,5
2012,Egypt,EGY,Russian Federation,RUS,0,0,5,0,5
2012,Belarus,BLR,Russian Federation,RUS,0,0,5,0,5
2012,China,CHN,Russian Federation,RUS,5,0,5,0,10
2012,Dem. Rep. of the Congo,COD,Russian Federation,RUS,0,0,13,0,13
2012,Georgia,GEO,Russian Federation,RUS,176,0,37,0,213
2012,Iraq,IRQ,Russian Federation,RUS,5,0,0,0,5
2012,Kazakhstan,KAZ,Russian Federation,RUS,0,0,11,0,11
2012,Kyrgyzstan,KGZ,Russian Federation,RUS,19,0,5,0,24
2012,Dem. People's Rep. of Korea,PRK,Russian Federation,RUS,47,0,17,0,64
2012,Nigeria,NGA,Russian Federation,RUS,5,0,0,0,5
2012,Syrian Arab Rep.,SYR,Russian Federation,RUS,49,0,46,0,95
2012,Tajikistan,TJK,Russian Federation,RUS,12,0,10,0,22
2012,Turkmenistan,TKM,Russian Federation,RUS,11,0,0,0,11
2012,Ukraine,UKR,Russian Federation,RUS,0,0,5,0,5
2012,Uzbekistan,UZB,Russian Federation,RUS,49,0,18,0,67
2013,Afghanistan,AFG,Russian Federation,RUS,0,222,241,94,557
2013,Angola,AGO,Russian Federation,RUS,0,0,0,5,5
2013,Egypt,EGY,Russian Federation,RUS,0,5,0,14,19
2013,Cambodia,KHM,Russian Federation,RUS,0,0,0,5,5
2013,China,CHN,Russian Federation,RUS,0,5,0,0,5
2013,Congo,COG,Russian Federation,RUS,0,5,0,0,5
2013,Georgia,GEO,Russian Federation,RUS,0,104,29,38,171
2013,Iran (Islamic Rep. of),IRN,Russian Federation,RUS,0,5,0,5,10
2013,Iraq,IRQ,Russian Federation,RUS,0,0,0,13,13
2013,Kazakhstan,KAZ,Russian Federation,RUS,0,0,0,5,5
2013,Kyrgyzstan,KGZ,Russian Federation,RUS,0,5,12,0,17
2013,Dem. People's Rep. of Korea,PRK,Russian Federation,RUS,0,20,5,5,30
2013,Rep. of Moldova,MDA,Russian Federation,RUS,0,0,0,5,5
2013,Pakistan,PAK,Russian Federation,RUS,0,5,0,0,5
2013,Sudan,SDN,Russian Federation,RUS,0,5,0,0,5
2013,Syrian Arab Rep.,SYR,Russian Federation,RUS,0,1191,55,71,1317
2013,Ukraine,UKR,Russian Federation,RUS,0,0,5,0,5
2013,Uzbekistan,UZB,Russian Federation,RUS,0,40,0,5,45
2014,Afghanistan,AFG,Russian Federation,RUS,0,248,167,0,415
2014,Egypt,EGY,Russian Federation,RUS,0,12,24,0,36
2014,Armenia,ARM,Russian Federation,RUS,0,0,14,0,14
2014,Bangladesh,BGD,Russian Federation,RUS,0,5,0,0,5
2014,China,CHN,Russian Federation,RUS,0,0,5,0,5
2014,Congo,COG,Russian Federation,RUS,0,5,5,0,10
2014,Ethiopia,ETH,Russian Federation,RUS,0,0,5,0,5
2014,Palestinian,PSE,Russian Federation,RUS,0,5,5,0,10
2014,Georgia,GEO,Russian Federation,RUS,0,103,34,0,137
2014,Cote d'Ivoire,CIV,Russian Federation,RUS,0,0,5,0,5
2014,Iran (Islamic Rep. of),IRN,Russian Federation,RUS,0,5,0,0,5
2014,Iraq,IRQ,Russian Federation,RUS,0,0,13,0,13
2014,Jordan,JOR,Russian Federation,RUS,0,5,0,0,5
2014,Kyrgyzstan,KGZ,Russian Federation,RUS,0,15,10,0,25
2014,Dem. People's Rep. of Korea,PRK,Russian Federation,RUS,0,25,5,0,30
2014,Rep. of Moldova,MDA,Russian Federation,RUS,0,0,13,0,13
2014,Sudan,SDN,Russian Federation,RUS,0,0,12,0,12
2014,Syrian Arab Rep.,SYR,Russian Federation,RUS,0,1369,384,0,1753
2014,Tajikistan,TJK,Russian Federation,RUS,0,12,0,0,12
2014,Turkmenistan,TKM,Russian Federation,RUS,0,5,5,0,10
2014,Ukraine,UKR,Russian Federation,RUS,0,248201,0,16687,264888
2014,Uzbekistan,UZB,Russian Federation,RUS,0,24,41,0,65
2015,Afghanistan,AFG,Russian Federation,RUS,0,220,269,0,489
2015,Azerbaijan,AZE,Russian Federation,RUS,0,13,0,0,13
2015,Bangladesh,BGD,Russian Federation,RUS,0,0,5,0,5
2015,Belarus,BLR,Russian Federation,RUS,0,0,14,0,14
2015,Central African Rep.,CAF,Russian Federation,RUS,0,0,5,0,5
2015,China,CHN,Russian Federation,RUS,0,0,5,0,5
2015,Congo,COG,Russian Federation,RUS,0,0,5,0,5
2015,Ethiopia,ETH,Russian Federation,RUS,0,5,0,0,5
2015,Palestinian,PSE,Russian Federation,RUS,0,10,5,0,15
2015,Georgia,GEO,Russian Federation,RUS,0,68,16,0,84
2015,Guinea,GIN,Russian Federation,RUS,0,0,5,0,5
2015,India,IND,Russian Federation,RUS,0,0,5,0,5
2015,Iraq,IRQ,Russian Federation,RUS,0,5,21,0,26
2015,Kazakhstan,KAZ,Russian Federation,RUS,0,5,5,0,10
2015,Kyrgyzstan,KGZ,Russian Federation,RUS,0,10,10,0,20
2015,Dem. People's Rep. of Korea,PRK,Russian Federation,RUS,0,32,5,0,37
2015,Libya,LBY,Russian Federation,RUS,0,5,0,0,5
2015,Lebanon,LBN,Russian Federation,RUS,0,5,0,0,5
2015,Latvia,LVA,Russian Federation,RUS,0,5,0,0,5
2015,Rep. of Moldova,MDA,Russian Federation,RUS,0,13,13,0,26
2015,Nepal,NPL,Russian Federation,RUS,0,0,5,0,5
2015,Nigeria,NGA,Russian Federation,RUS,0,5,0,0,5
2015,Syrian Arab Rep.,SYR,Russian Federation,RUS,0,695,395,0,1090
2015,Tajikistan,TJK,Russian Federation,RUS,0,5,21,0,26
2015,Turkmenistan,TKM,Russian Federation,RUS,0,13,0,0,13
2015,Turkey,TUR,Russian Federation,RUS,0,0,5,0,5
2015,Ukraine,UKR,Russian Federation,RUS,0,148379,0,21,148400
2015,Uzbekistan,UZB,Russian Federation,RUS,0,22,40,0,62
2015,Yemen,YEM,Russian Federation,RUS,0,42,34,0,76
2015,Stateless,XXA,Russian Federation,RUS,0,5,0,0,5
2016,Afghanistan,AFG,Russian Federation,RUS,0,151,0,0,151
2016,Egypt,EGY,Russian Federation,RUS,0,0,0,10,10
2016,Azerbaijan,AZE,Russian Federation,RUS,0,0,0,13,13
2016,Bangladesh,BGD,Russian Federation,RUS,0,0,0,5,5
2016,Belarus,BLR,Russian Federation,RUS,0,0,0,19,19
2016,Congo,COG,Russian Federation,RUS,0,0,0,5,5
2016,Dem. Rep. of the Congo,COD,Russian Federation,RUS,0,0,0,15,15
2016,Palestinian,PSE,Russian Federation,RUS,0,0,0,12,12
2016,Georgia,GEO,Russian Federation,RUS,0,45,0,31,76
2016,Cote d'Ivoire,CIV,Russian Federation,RUS,0,5,0,0,5
2016,Iran (Islamic Rep. of),IRN,Russian Federation,RUS,0,14,0,0,14
2016,Iraq,IRQ,Russian Federation,RUS,0,0,0,16,16
2016,Israel,ISR,Russian Federation,RUS,0,5,0,0,5
2016,Kyrgyzstan,KGZ,Russian Federation,RUS,0,0,0,13,13
2016,Dem. People's Rep. of Korea,PRK,Russian Federation,RUS,0,24,0,5,29
2016,Rep. of Moldova,MDA,Russian Federation,RUS,0,0,0,19,19
2016,Pakistan,PAK,Russian Federation,RUS,0,0,0,5,5
2016,Sudan,SDN,Russian Federation,RUS,0,0,0,10,10
2016,Syrian Arab Rep.,SYR,Russian Federation,RUS,0,542,0,369,911
2016,Tajikistan,TJK,Russian Federation,RUS,0,12,0,17,29
2016,Turkmenistan,TKM,Russian Federation,RUS,0,0,0,12,12
2016,Turkey,TUR,Russian Federation,RUS,0,0,0,10,10
2016,Ukraine,UKR,Russian Federation,RUS,0,21095,0,1018,22113
2016,United States of America,USA,Russian Federation,RUS,0,0,0,5,5
2016,Uzbekistan,UZB,Russian Federation,RUS,0,30,0,50,80
2016,Yemen,YEM,Russian Federation,RUS,0,25,0,37,62
2016,Stateless,XXA,Russian Federation,RUS,0,19,0,0,19
2017,Afghanistan,AFG,Russian Federation,RUS,0,194,0,241,435
2017,Armenia,ARM,Russian Federation,RUS,0,0,0,5,5
2017,Belarus,BLR,Russian Federation,RUS,0,0,0,19,19
2017,Cameroon,CMR,Russian Federation,RUS,0,0,0,5,5
2017,Congo,COG,Russian Federation,RUS,0,0,0,5,5
2017,Dem. Rep. of the Congo,COD,Russian Federation,RUS,0,10,0,12,22
2017,Palestinian,PSE,Russian Federation,RUS,0,5,0,5,10
2017,Georgia,GEO,Russian Federation,RUS,0,34,0,14,48
2017,Germany,DEU,Russian Federation,RUS,0,11,0,5,16
2017,Iran (Islamic Rep. of),IRN,Russian Federation,RUS,0,0,0,5,5
2017,Iraq,IRQ,Russian Federation,RUS,0,15,0,16,31
2017,Kazakhstan,KAZ,Russian Federation,RUS,0,0,0,14,14
2017,Kyrgyzstan,KGZ,Russian Federation,RUS,0,0,0,14,14
2017,Dem. People's Rep. of Korea,PRK,Russian Federation,RUS,0,23,0,10,33
2017,Latvia,LVA,Russian Federation,RUS,0,0,0,5,5
2017,Rep. of Moldova,MDA,Russian Federation,RUS,0,0,0,14,14
2017,Pakistan,PAK,Russian Federation,RUS,0,0,0,5,5
2017,Sudan,SDN,Russian Federation,RUS,0,5,0,5,10
2017,Syrian Arab Rep.,SYR,Russian Federation,RUS,0,352,0,444,796
2017,Tajikistan,TJK,Russian Federation,RUS,0,5,0,21,26
2017,Turkmenistan,TKM,Russian Federation,RUS,0,0,0,10,10
2017,Turkey,TUR,Russian Federation,RUS,0,0,0,5,5
2017,Ukraine,UKR,Russian Federation,RUS,0,9678,0,2932,12610
2017,Uzbekistan,UZB,Russian Federation,RUS,0,12,0,41,53
2017,Yemen,YEM,Russian Federation,RUS,0,36,0,36,72
2017,Stateless,XXA,Russian Federation,RUS,0,0,0,13,13
2018,Afghanistan,AFG,Russian Federation,RUS,0,293,0,419,712
2018,Egypt,EGY,Russian Federation,RUS,0,0,0,5,5
2018,Argentina,ARG,Russian Federation,RUS,0,5,0,0,5
2018,Armenia,ARM,Russian Federation,RUS,0,0,0,5,5
2018,Azerbaijan,AZE,Russian Federation,RUS,0,0,0,15,15
2018,Belgium,BEL,Russian Federation,RUS,0,0,0,31,31
2018,Bangladesh,BGD,Russian Federation,RUS,0,0,0,10,10
2018,Cameroon,CMR,Russian Federation,RUS,0,0,0,11,11
2018,Congo,COG,Russian Federation,RUS,0,0,0,5,5
2018,Dem. Rep. of the Congo,COD,Russian Federation,RUS,0,0,0,10,10
2018,Cuba,CUB,Russian Federation,RUS,0,0,0,5,5
2018,Eritrea,ERI,Russian Federation,RUS,0,0,0,10,10
2018,Palestinian,PSE,Russian Federation,RUS,0,0,0,11,11
2018,Georgia,GEO,Russian Federation,RUS,0,22,0,13,35
2018,Germany,DEU,Russian Federation,RUS,0,0,0,12,12
2018,Cote d'Ivoire,CIV,Russian Federation,RUS,0,0,0,5,5
2018,India,IND,Russian Federation,RUS,0,0,0,5,5
2018,Iran (Islamic Rep. of),IRN,Russian Federation,RUS,0,0,0,5,5
2018,Iraq,IRQ,Russian Federation,RUS,0,0,0,10,10
2018,Kazakhstan,KAZ,Russian Federation,RUS,0,5,0,14,19
2018,Kyrgyzstan,KGZ,Russian Federation,RUS,0,5,0,15,20
2018,Dem. People's Rep. of Korea,PRK,Russian Federation,RUS,0,18,0,0,18
2018,Latvia,LVA,Russian Federation,RUS,0,5,0,0,5
2018,Rep. of Moldova,MDA,Russian Federation,RUS,0,5,0,21,26
2018,Nigeria,NGA,Russian Federation,RUS,0,0,0,10,10
2018,Somalia,SOM,Russian Federation,RUS,0,0,0,10,10
2018,Sudan,SDN,Russian Federation,RUS,0,0,0,10,10
2018,Syrian Arab Rep.,SYR,Russian Federation,RUS,0,165,0,210,375
2018,Tajikistan,TJK,Russian Federation,RUS,0,0,0,28,28
2018,Turkmenistan,TKM,Russian Federation,RUS,0,5,0,5,10
2018,Turkey,TUR,Russian Federation,RUS,0,5,0,0,5
2018,Ukraine,UKR,Russian Federation,RUS,0,5383,0,1120,6503
2018,Uzbekistan,UZB,Russian Federation,RUS,0,13,0,38,51
2018,Yemen,YEM,Russian Federation,RUS,0,56,0,20,76
2018,Stateless,XXA,Russian Federation,RUS,0,10,0,10,20
2019,Afghanistan,AFG,Russian Federation,RUS,335,0,0,450,785
2019,Egypt,EGY,Russian Federation,RUS,0,0,0,5,5
2019,Armenia,ARM,Russian Federation,RUS,0,0,0,10,10
2019,Azerbaijan,AZE,Russian Federation,RUS,10,0,0,19,29
2019,Belgium,BEL,Russian Federation,RUS,0,0,0,25,25
2019,China,CHN,Russian Federation,RUS,0,0,0,5,5
2019,Cameroon,CMR,Russian Federation,RUS,5,0,0,5,10
2019,Dem. Rep. of the Congo,COD,Russian Federation,RUS,0,0,0,10,10
2019,Eritrea,ERI,Russian Federation,RUS,0,0,0,5,5
2019,Palestinian,PSE,Russian Federation,RUS,5,0,0,5,10
2019,Georgia,GEO,Russian Federation,RUS,23,0,0,10,33
2019,Germany,DEU,Russian Federation,RUS,5,0,0,13,18
2019,Cote d'Ivoire,CIV,Russian Federation,RUS,0,0,0,5,5
2019,Iraq,IRQ,Russian Federation,RUS,0,0,0,10,10
2019,Kazakhstan,KAZ,Russian Federation,RUS,5,0,0,15,20
2019,Kyrgyzstan,KGZ,Russian Federation,RUS,11,0,0,16,27
2019,Rep. of Korea,KOR,Russian Federation,RUS,5,0,0,0,5
2019,Dem. People's Rep. of Korea,PRK,Russian Federation,RUS,12,0,0,10,22
2019,Latvia,LVA,Russian Federation,RUS,0,0,0,5,5
2019,Rep. of Moldova,MDA,Russian Federation,RUS,5,0,0,18,23
2019,Nigeria,NGA,Russian Federation,RUS,0,0,0,11,11
2019,Pakistan,PAK,Russian Federation,RUS,0,0,0,5,5
2019,Philippines,PHL,Russian Federation,RUS,0,0,0,5,5
2019,Somalia,SOM,Russian Federation,RUS,0,0,0,5,5
2019,Viet Nam,VNM,Russian Federation,RUS,0,0,0,5,5
2019,Sudan,SDN,Russian Federation,RUS,0,0,0,12,12
2019,Syrian Arab Rep.,SYR,Russian Federation,RUS,127,0,0,209,336
2019,Tajikistan,TJK,Russian Federation,RUS,18,0,0,40,58
2019,Turkmenistan,TKM,Russian Federation,RUS,12,0,0,5,17
2019,Turkey,TUR,Russian Federation,RUS,0,0,0,5,5
2019,Ukraine,UKR,Russian Federation,RUS,5300,0,0,650,5950
2019,United States of America,USA,Russian Federation,RUS,0,0,0,5,5
2019,Uzbekistan,UZB,Russian Federation,RUS,5,0,0,42,47
2019,Venezuela (Bolivarian Republic of),VEN,Russian Federation,RUS,0,0,0,5,5
2019,Yemen,YEM,Russian Federation,RUS,40,0,0,25,65
2019,Stateless,XXA,Russian Federation,RUS,22,0,0,0,22
2020,Afghanistan,AFG,Russian Federation,RUS,207,0,0,347,554
2020,Armenia,ARM,Russian Federation,RUS,0,0,0,14,14
2020,Azerbaijan,AZE,Russian Federation,RUS,5,0,0,16,21
2020,Belgium,BEL,Russian Federation,RUS,0,0,0,32,32
2020,China,CHN,Russian Federation,RUS,18,0,0,589,607
2020,Cameroon,CMR,Russian Federation,RUS,0,0,0,10,10
2020,Dem. Rep. of the Congo,COD,Russian Federation,RUS,12,0,0,0,12
2020,Cuba,CUB,Russian Federation,RUS,5,0,0,5,10
2020,Eritrea,ERI,Russian Federation,RUS,0,0,0,5,5
2020,Estonia,EST,Russian Federation,RUS,5,0,0,0,5
2020,Ethiopia,ETH,Russian Federation,RUS,0,0,0,5,5
2020,Georgia,GEO,Russian Federation,RUS,25,0,0,10,35
2020,Germany,DEU,Russian Federation,RUS,0,0,0,5,5
2020,Guinea,GIN,Russian Federation,RUS,0,0,0,5,5
2020,Iran (Islamic Rep. of),IRN,Russian Federation,RUS,0,0,0,5,5
2020,Iraq,IRQ,Russian Federation,RUS,0,0,0,5,5
2020,Israel,ISR,Russian Federation,RUS,5,0,0,0,5
2020,Italy,ITA,Russian Federation,RUS,0,0,0,5,5
2020,Kazakhstan,KAZ,Russian Federation,RUS,5,0,0,19,24
2020,Kyrgyzstan,KGZ,Russian Federation,RUS,5,0,0,13,18
2020,Dem. People's Rep. of Korea,PRK,Russian Federation,RUS,13,0,0,5,18
2020,Latvia,LVA,Russian Federation,RUS,5,0,0,0,5
2020,Rep. of Moldova,MDA,Russian Federation,RUS,0,0,0,11,11
2020,Nigeria,NGA,Russian Federation,RUS,0,0,0,12,12
2020,Pakistan,PAK,Russian Federation,RUS,0,0,0,5,5
2020,Philippines,PHL,Russian Federation,RUS,5,0,0,0,5
2020,Syrian Arab Rep.,SYR,Russian Federation,RUS,50,0,0,195,245
2020,Tajikistan,TJK,Russian Federation,RUS,5,0,0,28,33
2020,Turkmenistan,TKM,Russian Federation,RUS,14,0,0,10,24
2020,Ukraine,UKR,Russian Federation,RUS,5079,0,0,320,5399
2020,United States of America,USA,Russian Federation,RUS,0,0,0,5,5
2020,Uzbekistan,UZB,Russian Federation,RUS,33,0,0,33,66
2020,Yemen,YEM,Russian Federation,RUS,41,0,0,20,61
2020,Stateless,XXA,Russian Federation,RUS,10,0,0,20,30
2021,Afghanistan,AFG,Russian Federation,RUS,211,0,0,255,466
2021,Egypt,EGY,Russian Federation,RUS,5,0,0,0,5
2021,Armenia,ARM,Russian Federation,RUS,10,0,0,10,20
2021,Azerbaijan,AZE,Russian Federation,RUS,13,0,0,0,13
2021,Belgium,BEL,Russian Federation,RUS,0,0,0,28,28
2021,China,CHN,Russian Federation,RUS,10,0,0,278,288
2021,Cameroon,CMR,Russian Federation,RUS,0,0,0,10,10
2021,Dem. Rep. of the Congo,COD,Russian Federation,RUS,11,0,0,0,11
2021,Cuba,CUB,Russian Federation,RUS,0,0,0,11,11
2021,Ethiopia,ETH,Russian Federation,RUS,0,0,0,5,5
2021,Palestinian,PSE,Russian Federation,RUS,0,0,0,5,5
2021,Georgia,GEO,Russian Federation,RUS,24,0,0,10,34
2021,Germany,DEU,Russian Federation,RUS,0,0,0,5,5
2021,Guinea,GIN,Russian Federation,RUS,0,0,0,10,10
2021,India,IND,Russian Federation,RUS,0,0,0,5,5
2021,Iran (Islamic Rep. of),IRN,Russian Federation,RUS,0,0,0,5,5
2021,Israel,ISR,Russian Federation,RUS,0,0,0,5,5
2021,Kazakhstan,KAZ,Russian Federation,RUS,25,0,0,10,35
2021,Kyrgyzstan,KGZ,Russian Federation,RUS,10,0,0,18,28
2021,Dem. People's Rep. of Korea,PRK,Russian Federation,RUS,11,0,0,0,11
2021,Rep. of Moldova,MDA,Russian Federation,RUS,14,0,0,0,14
2021,Nigeria,NGA,Russian Federation,RUS,0,0,0,10,10
2021,Pakistan,PAK,Russian Federation,RUS,5,0,0,0,5
2021,Sudan,SDN,Russian Federation,RUS,0,0,0,5,5
2021,Syrian Arab Rep.,SYR,Russian Federation,RUS,24,0,0,114,138
2021,Tajikistan,TJK,Russian Federation,RUS,5,0,0,21,26
2021,Turkmenistan,TKM,Russian Federation,RUS,38,0,0,10,48
2021,Ukraine,UKR,Russian Federation,RUS,3522,0,0,100,3622
2021,Uzbekistan,UZB,Russian Federation,RUS,36,0,0,20,56
2021,Yemen,YEM,Russian Federation,RUS,10,0,0,26,36
2021,Stateless,XXA,Russian Federation,RUS,19,0,0,0,19
2010,Afghanistan,AFG,Switzerland,CHE,0,43,0,0,43
2010,Algeria,DZA,Switzerland,CHE,0,26,0,0,26
2010,Angola,AGO,Switzerland,CHE,0,28,0,0,28
2010,Armenia,ARM,Switzerland,CHE,0,11,0,0,11
2010,Azerbaijan,AZE,Switzerland,CHE,0,5,0,0,5
2010,Bangladesh,BGD,Switzerland,CHE,0,16,0,0,16
2010,Belarus,BLR,Switzerland,CHE,0,5,0,0,5
2010,Bosnia and Herzegovina,BIH,Switzerland,CHE,0,53,0,0,53
2010,Bulgaria,BGR,Switzerland,CHE,0,5,0,0,5
2010,Cambodia,KHM,Switzerland,CHE,0,5,0,0,5
2010,China,CHN,Switzerland,CHE,0,46,0,0,46
2010,Cameroon,CMR,Switzerland,CHE,0,16,0,0,16
2010,Congo,COG,Switzerland,CHE,0,5,0,0,5
2010,Dem. Rep. of the Congo,COD,Switzerland,CHE,0,61,0,0,61
2010,Cuba,CUB,Switzerland,CHE,0,5,0,0,5
2010,Eritrea,ERI,Switzerland,CHE,0,47,0,0,47
2010,Ethiopia,ETH,Switzerland,CHE,0,37,0,0,37
2010,Palestinian,PSE,Switzerland,CHE,0,5,0,0,5
2010,Georgia,GEO,Switzerland,CHE,0,5,0,0,5
2010,Cote d'Ivoire,CIV,Switzerland,CHE,0,5,0,0,5
2010,Iran (Islamic Rep. of),IRN,Switzerland,CHE,0,22,0,0,22
2010,Iraq,IRQ,Switzerland,CHE,0,43,0,0,43
2010,Kenya,KEN,Switzerland,CHE,0,5,0,0,5
2010,Sri Lanka,LKA,Switzerland,CHE,0,19,0,0,19
2010,North Macedonia,MKD,Switzerland,CHE,0,15,0,0,15
2010,Mongolia,MNG,Switzerland,CHE,0,5,0,0,5
2010,Morocco,MAR,Switzerland,CHE,0,5,0,0,5
2010,Mozambique,MOZ,Switzerland,CHE,0,5,0,0,5
2010,Montenegro,MNE,Switzerland,CHE,0,5,0,0,5
2010,Nigeria,NGA,Switzerland,CHE,0,10,0,0,10
2010,Russian Federation,RUS,Switzerland,CHE,0,14,0,0,14
2010,Serbia and Kosovo: S/RES/1244 (1999),SRB,Switzerland,CHE,0,177,0,0,177
2010,Somalia,SOM,Switzerland,CHE,0,5,0,0,5
2010,Viet Nam,VNM,Switzerland,CHE,0,5,0,0,5
2010,Sudan,SDN,Switzerland,CHE,0,5,0,0,5
2010,Syrian Arab Rep.,SYR,Switzerland,CHE,0,5,0,0,5
2010,Togo,TGO,Switzerland,CHE,0,5,0,0,5
2010,Tunisia,TUN,Switzerland,CHE,0,5,0,0,5
2010,Turkey,TUR,Switzerland,CHE,0,55,0,0,55
2010,Uganda,UGA,Switzerland,CHE,0,5,0,0,5
2010,Ukraine,UKR,Switzerland,CHE,0,16,0,0,16
2010,Yemen,YEM,Switzerland,CHE,0,5,0,0,5
2011,Afghanistan,AFG,Switzerland,CHE,0,199,0,0,199
2011,Algeria,DZA,Switzerland,CHE,0,11,0,0,11
2011,Angola,AGO,Switzerland,CHE,0,26,0,0,26
2011,Armenia,ARM,Switzerland,CHE,0,5,0,0,5
2011,Azerbaijan,AZE,Switzerland,CHE,0,5,0,0,5
2011,Benin,BEN,Switzerland,CHE,0,5,0,0,5
2011,Bangladesh,BGD,Switzerland,CHE,0,10,0,0,10
2011,Bosnia and Herzegovina,BIH,Switzerland,CHE,0,19,0,0,19
2011,China,CHN,Switzerland,CHE,0,5,0,0,5
2011,Cameroon,CMR,Switzerland,CHE,0,13,0,0,13
2011,Congo,COG,Switzerland,CHE,0,5,0,0,5
2011,Dem. Rep. of the Congo,COD,Switzerland,CHE,0,80,0,0,80
2011,Ecuador,ECU,Switzerland,CHE,0,5,0,0,5
2011,Eritrea,ERI,Switzerland,CHE,0,46,0,0,46
2011,Ethiopia,ETH,Switzerland,CHE,0,16,0,0,16
2011,Palestinian,PSE,Switzerland,CHE,0,10,0,0,10
2011,Georgia,GEO,Switzerland,CHE,0,5,0,0,5
2011,Ghana,GHA,Switzerland,CHE,0,5,0,0,5
2011,Guinea-Bissau,GNB,Switzerland,CHE,0,5,0,0,5
2011,Guinea,GIN,Switzerland,CHE,0,5,0,0,5
2011,Croatia,HRV,Switzerland,CHE,0,5,0,0,5
2011,Cote d'Ivoire,CIV,Switzerland,CHE,0,10,0,0,10
2011,India,IND,Switzerland,CHE,0,10,0,0,10
2011,Iran (Islamic Rep. of),IRN,Switzerland,CHE,0,23,0,0,23
2011,Iraq,IRQ,Switzerland,CHE,0,38,0,0,38
2011,Sri Lanka,LKA,Switzerland,CHE,0,10,0,0,10
2011,Mali,MLI,Switzerland,CHE,0,5,0,0,5
2011,Morocco,MAR,Switzerland,CHE,0,5,0,0,5
2011,Nepal,NPL,Switzerland,CHE,0,5,0,0,5
2011,Nigeria,NGA,Switzerland,CHE,0,19,0,0,19
2011,Poland,POL,Switzerland,CHE,0,5,0,0,5
2011,Russian Federation,RUS,Switzerland,CHE,0,20,0,0,20
2011,Serbia and Kosovo: S/RES/1244 (1999),SRB,Switzerland,CHE,0,116,0,0,116
2011,Somalia,SOM,Switzerland,CHE,0,10,0,0,10
2011,Sudan,SDN,Switzerland,CHE,0,5,0,0,5
2011,Syrian Arab Rep.,SYR,Switzerland,CHE,0,140,0,0,140
2011,Togo,TGO,Switzerland,CHE,0,10,0,0,10
2011,Turkey,TUR,Switzerland,CHE,0,28,0,0,28
2003,Bhutan,BTN,Nepal,NPL,0,24,0,0,24
2004,Bhutan,BTN,Nepal,NPL,0,102,10,39,151
2008,Cote d'Ivoire,CIV,Israel,ISR,0,0,30,0,30
2008,Liberia,LBR,Israel,ISR,0,0,31,0,31
2008,Nigeria,NGA,Israel,ISR,0,0,5,0,5
2008,Turkey,TUR,Israel,ISR,0,0,55,0,55
2015,Burundi,BDI,Kenya,KEN,0,0,0,10,10
2015,Dem. Rep. of the Congo,COD,Kenya,KEN,55,0,0,12,67
2015,Ethiopia,ETH,Kenya,KEN,114,0,10,139,263
2015,Rwanda,RWA,Kenya,KEN,0,0,5,14,19
2015,Somalia,SOM,Kenya,KEN,5,0,0,16,21
2015,Sudan,SDN,Kenya,KEN,0,0,0,40,40
2015,South Sudan,SSD,Kenya,KEN,5,0,10,49,64
2015,Uganda,UGA,Kenya,KEN,5,0,0,5,10
2016,Burundi,BDI,Kenya,KEN,11,0,0,5,16
2016,Dem. Rep. of the Congo,COD,Kenya,KEN,17,0,0,10,27
2016,Ethiopia,ETH,Kenya,KEN,43,0,0,102,145
2016,Rwanda,RWA,Kenya,KEN,0,0,0,12,12
2016,Somalia,SOM,Kenya,KEN,5,0,0,0,5
2016,Sudan,SDN,Kenya,KEN,0,0,0,27,27
2016,South Sudan,SSD,Kenya,KEN,0,0,0,23,23
2016,United Rep. of Tanzania,TZA,Kenya,KEN,0,0,0,13,13
2016,Uganda,UGA,Kenya,KEN,0,0,0,5,5
2017,Burundi,BDI,Kenya,KEN,0,0,0,88,88
2017,Dem. Rep. of the Congo,COD,Kenya,KEN,20,0,0,44,64
2017,Eritrea,ERI,Kenya,KEN,0,0,0,14,14
2017,Ethiopia,ETH,Kenya,KEN,15,0,0,580,595
2017,Liberia,LBR,Kenya,KEN,0,0,0,5,5
2017,Rwanda,RWA,Kenya,KEN,0,0,0,22,22
2017,Sudan,SDN,Kenya,KEN,0,0,0,35,35
2017,United Rep. of Tanzania,TZA,Kenya,KEN,0,0,0,5,5
2017,Uganda,UGA,Kenya,KEN,0,0,0,5,5
2019,Eritrea,ERI,Niger,NER,20,0,0,0,20
2019,Ethiopia,ETH,Niger,NER,10,0,0,0,10
2019,Somalia,SOM,Niger,NER,32,0,0,0,32
2020,Eritrea,ERI,Niger,NER,19,0,0,0,19
2020,Ethiopia,ETH,Niger,NER,15,0,0,0,15
2020,Somalia,SOM,Niger,NER,21,0,0,0,21
2021,Eritrea,ERI,Niger,NER,5,0,0,0,5
2021,Ethiopia,ETH,Niger,NER,10,0,0,0,10
2006,Angola,AGO,Congo,COG,0,0,5,0,5
2006,Burundi,BDI,Congo,COG,0,0,0,5,5
2006,Central African Rep.,CAF,Congo,COG,0,0,17,13,30
2006,Chad,TCD,Congo,COG,5,0,12,22,39
2006,Dem. Rep. of the Congo,COD,Congo,COG,26,0,65,41,132
2006,Cote d'Ivoire,CIV,Congo,COG,0,0,29,19,48
2006,Mauritania,MRT,Congo,COG,0,0,5,0,5
2006,Sierra Leone,SLE,Congo,COG,0,0,0,5,5
2006,Sudan,SDN,Congo,COG,0,0,0,11,11
2006,Cameroon,CMR,Israel,ISR,0,0,14,0,14
2006,Dem. Rep. of the Congo,COD,Israel,ISR,0,5,5,0,10
2006,Colombia,COL,Israel,ISR,0,0,10,19,29
2006,Eritrea,ERI,Israel,ISR,0,0,0,28,28
2006,Ethiopia,ETH,Israel,ISR,0,0,61,28,89
2006,Georgia,GEO,Israel,ISR,0,0,0,5,5
2006,Ghana,GHA,Israel,ISR,0,0,46,28,74
2006,Guinea-Bissau,GNB,Israel,ISR,0,0,10,0,10
2006,Guinea,GIN,Israel,ISR,0,0,254,49,303
2006,Cote d'Ivoire,CIV,Israel,ISR,0,67,15,0,82
2006,India,IND,Israel,ISR,0,0,5,0,5
2006,Kenya,KEN,Israel,ISR,0,0,5,0,5
2006,Liberia,LBR,Israel,ISR,0,10,16,0,26
2006,Sri Lanka,LKA,Israel,ISR,0,0,5,0,5
2006,Mali,MLI,Israel,ISR,0,0,10,0,10
2006,Myanmar,MMR,Israel,ISR,0,0,0,5,5
2006,Nigeria,NGA,Israel,ISR,0,0,231,88,319
2006,Philippines,PHL,Israel,ISR,0,0,5,0,5
2006,South Africa,ZAF,Israel,ISR,0,0,5,0,5
2006,Senegal,SEN,Israel,ISR,0,0,5,0,5
2006,Sierra Leone,SLE,Israel,ISR,0,0,10,0,10
2006,Sudan,SDN,Israel,ISR,0,263,0,0,263
2006,Togo,TGO,Israel,ISR,0,0,12,0,12
2006,Turkey,TUR,Israel,ISR,0,0,45,5,50
2006,Uganda,UGA,Israel,ISR,0,0,5,0,5
2006,Ukraine,UKR,Israel,ISR,0,0,5,0,5
2006,Zimbabwe,ZWE,Israel,ISR,0,0,15,5,20
2007,Angola,AGO,Congo,COG,0,0,5,0,5
2007,Burundi,BDI,Congo,COG,5,0,0,0,5
2007,Central African Rep.,CAF,Congo,COG,0,0,5,0,5
2007,Chad,TCD,Congo,COG,0,0,15,0,15
2007,Dem. Rep. of the Congo,COD,Congo,COG,47,0,88,0,135
2007,Cote d'Ivoire,CIV,Congo,COG,0,0,48,0,48
2008,Central African Rep.,CAF,Congo,COG,0,0,18,40,58
2008,Chad,TCD,Congo,COG,5,0,49,65,119
2008,Dem. Rep. of the Congo,COD,Congo,COG,11,0,262,2451,2724
2008,Guinea,GIN,Congo,COG,0,0,0,38,38
2008,Cote d'Ivoire,CIV,Congo,COG,0,0,67,311,378
2008,Liberia,LBR,Congo,COG,0,0,0,48,48
2008,Nigeria,NGA,Congo,COG,0,0,0,18,18
2008,Senegal,SEN,Congo,COG,0,0,0,14,14
2008,Sierra Leone,SLE,Congo,COG,0,0,5,30,35
2008,Sudan,SDN,Congo,COG,5,0,5,12,22
2008,Uganda,UGA,Congo,COG,0,0,0,10,10
2009,Central African Rep.,CAF,Congo,COG,0,0,0,5,5
2009,Chad,TCD,Congo,COG,5,0,5,10,20
2009,Dem. Rep. of the Congo,COD,Congo,COG,33,0,57,27,117
2009,Cote d'Ivoire,CIV,Congo,COG,0,0,12,17,29
2009,Mauritania,MRT,Congo,COG,0,0,0,5,5
2009,Sudan,SDN,Congo,COG,5,0,0,0,5
2007,Burundi,BDI,Israel,ISR,0,0,5,0,5
2007,Central African Rep.,CAF,Israel,ISR,0,0,5,0,5
2007,Cameroon,CMR,Israel,ISR,0,0,5,5,10
2007,Colombia,COL,Israel,ISR,0,0,0,5,5
2007,Ethiopia,ETH,Israel,ISR,0,0,15,0,15
2007,Gambia,GMB,Israel,ISR,0,0,0,5,5
2007,Georgia,GEO,Israel,ISR,0,0,5,5,10
2007,Ghana,GHA,Israel,ISR,0,0,5,14,19
2007,Guinea-Bissau,GNB,Israel,ISR,0,0,5,0,5
2007,Guinea,GIN,Israel,ISR,0,0,11,0,11
2007,Cote d'Ivoire,CIV,Israel,ISR,0,0,0,11,11
2007,Kenya,KEN,Israel,ISR,0,0,10,5,15
2007,Liberia,LBR,Israel,ISR,0,0,34,0,34
2007,Mali,MLI,Israel,ISR,0,0,5,0,5
2007,Nepal,NPL,Israel,ISR,0,0,5,0,5
2007,Nigeria,NGA,Israel,ISR,0,0,155,60,215
2007,Philippines,PHL,Israel,ISR,0,0,0,13,13
2007,Togo,TGO,Israel,ISR,0,0,0,5,5
2007,Turkey,TUR,Israel,ISR,0,0,70,11,81
2007,Dem. Rep. of the Congo,COD,Eswatini,SWZ,19,0,0,0,19
2007,Rwanda,RWA,Eswatini,SWZ,20,0,0,0,20
2008,Central African Rep.,CAF,Mauritania,MRT,0,0,5,0,5
2008,Chad,TCD,Mauritania,MRT,5,0,0,0,5
2008,Cameroon,CMR,Mauritania,MRT,5,0,0,0,5
2008,Congo,COG,Mauritania,MRT,0,0,12,0,12
2008,Dem. Rep. of the Congo,COD,Mauritania,MRT,17,0,14,0,31
2008,Guinea,GIN,Mauritania,MRT,0,0,11,0,11
2008,Cote d'Ivoire,CIV,Mauritania,MRT,36,0,76,18,130
2008,Liberia,LBR,Mauritania,MRT,10,0,30,0,40
2008,Senegal,SEN,Mauritania,MRT,5,0,0,0,5
2008,Sierra Leone,SLE,Mauritania,MRT,0,0,13,0,13
2008,Sudan,SDN,Mauritania,MRT,0,0,5,0,5
2008,Togo,TGO,Mauritania,MRT,0,0,5,0,5
2008,Afghanistan,AFG,Tajikistan,TJK,828,0,634,0,1462
2008,Iran (Islamic Rep. of),IRN,Tajikistan,TJK,0,0,5,0,5
2009,Afghanistan,AFG,Kazakhstan,KAZ,64,0,74,0,138
2009,China,CHN,Kazakhstan,KAZ,5,0,5,0,10
2009,Kyrgyzstan,KGZ,Kazakhstan,KAZ,29,0,0,0,29
2009,Uzbekistan,UZB,Kazakhstan,KAZ,164,0,10,5,179
2009,Central African Rep.,CAF,Mauritania,MRT,0,0,5,5,10
2009,Chad,TCD,Mauritania,MRT,0,0,5,0,5
2009,Cameroon,CMR,Mauritania,MRT,0,0,0,12,12
2009,Congo,COG,Mauritania,MRT,0,0,5,10,15
2009,Dem. Rep. of the Congo,COD,Mauritania,MRT,10,0,45,10,65
2009,Gambia,GMB,Mauritania,MRT,0,0,5,0,5
2009,Palestinian,PSE,Mauritania,MRT,13,0,0,0,13
2009,Guinea,GIN,Mauritania,MRT,0,0,5,0,5
2009,Cote d'Ivoire,CIV,Mauritania,MRT,36,0,104,20,160
2009,Liberia,LBR,Mauritania,MRT,0,0,14,13,27
2009,Nigeria,NGA,Mauritania,MRT,0,0,0,5,5
2009,Senegal,SEN,Mauritania,MRT,5,0,0,0,5
2009,Sierra Leone,SLE,Mauritania,MRT,0,0,5,0,5
2009,Togo,TGO,Mauritania,MRT,0,0,14,0,14
2009,Afghanistan,AFG,Papua New Guinea,PNG,5,0,0,0,5
2009,Sri Lanka,LKA,Papua New Guinea,PNG,5,0,0,0,5
2009,Nigeria,NGA,Papua New Guinea,PNG,0,0,5,0,5
2010,Afghanistan,AFG,Kazakhstan,KAZ,32,0,64,5,101
2010,China,CHN,Kazakhstan,KAZ,5,0,13,5,23
2010,Kyrgyzstan,KGZ,Kazakhstan,KAZ,10,0,30,30,70
2010,Tajikistan,TJK,Kazakhstan,KAZ,0,0,10,0,10
2010,Uzbekistan,UZB,Kazakhstan,KAZ,20,0,90,29,139
2010,Cote d'Ivoire,CIV,Liberia,LBR,0,10,0,0,10
2010,Sierra Leone,SLE,Liberia,LBR,170,0,330,0,500
2010,Togo,TGO,Liberia,LBR,5,0,0,0,5
2010,Cameroon,CMR,Mauritania,MRT,0,0,5,0,5
2010,Congo,COG,Mauritania,MRT,0,0,5,0,5
2010,Dem. Rep. of the Congo,COD,Mauritania,MRT,17,0,33,0,50
2010,Guinea,GIN,Mauritania,MRT,0,0,24,0,24
2010,Cote d'Ivoire,CIV,Mauritania,MRT,12,0,40,0,52
2010,Liberia,LBR,Mauritania,MRT,0,0,5,0,5
2010,Mali,MLI,Mauritania,MRT,0,0,5,0,5
2010,Switzerland,CHE,Mauritania,MRT,0,0,5,0,5
2010,Togo,TGO,Mauritania,MRT,0,0,5,0,5
2010,Sri Lanka,LKA,Papua New Guinea,PNG,0,0,5,0,5
2010,Dem. Rep. of the Congo,COD,United Rep. of Tanzania,TZA,24,0,0,0,24
2010,Rwanda,RWA,United Rep. of Tanzania,TZA,11,0,0,0,11
2011,Afghanistan,AFG,Fiji,FJI,5,0,0,0,5
2011,Iraq,IRQ,Fiji,FJI,0,0,0,5,5
2011,Cote d'Ivoire,CIV,Ghana,GHA,0,0,0,8234,8234
2011,Liberia,LBR,Ghana,GHA,0,0,0,5,5
2011,Sudan,SDN,Ghana,GHA,5,0,0,0,5
2011,Central African Rep.,CAF,Cote d'Ivoire,CIV,0,0,5,0,5
2011,Congo,COG,Cote d'Ivoire,CIV,5,0,5,0,10
2011,Dem. Rep. of the Congo,COD,Cote d'Ivoire,CIV,10,0,0,0,10
2011,Liberia,LBR,Cote d'Ivoire,CIV,0,0,171,0,171
2011,Nigeria,NGA,Cote d'Ivoire,CIV,0,0,23,0,23
2011,Togo,TGO,Cote d'Ivoire,CIV,0,0,10,0,10
2011,Cote d'Ivoire,CIV,Liberia,LBR,5,0,0,0,5
2011,Sudan,SDN,Liberia,LBR,5,0,0,0,5
2011,Togo,TGO,Liberia,LBR,0,0,14,0,14
2011,Sri Lanka,LKA,Papua New Guinea,PNG,0,0,5,0,5
2012,Guinea,GIN,Liberia,LBR,24,0,540,0,564
2012,Syrian Arab Rep.,SYR,"China, Macao SAR",MAC,5,0,0,0,5
2013,Mali,MLI,Liberia,LBR,5,0,0,0,5
2013,Togo,TGO,Liberia,LBR,5,0,5,0,10
2014,Central African Rep.,CAF,Cote d'Ivoire,CIV,192,0,0,0,192
2014,Dem. Rep. of the Congo,COD,Cote d'Ivoire,CIV,5,0,0,5,10
2014,Guinea,GIN,Cote d'Ivoire,CIV,0,0,0,5,5
2014,Liberia,LBR,Cote d'Ivoire,CIV,0,0,0,13,13
2014,Rwanda,RWA,Cote d'Ivoire,CIV,5,0,0,0,5
2015,Central African Rep.,CAF,Cote d'Ivoire,CIV,77,0,35,0,112
2015,Liberia,LBR,Cote d'Ivoire,CIV,0,0,0,5,5
2015,Mali,MLI,Cote d'Ivoire,CIV,5,0,0,5,10
2015,Syrian Arab Rep.,SYR,Cote d'Ivoire,CIV,17,0,0,0,17
2015,Yemen,YEM,Cote d'Ivoire,CIV,5,0,0,0,5
2016,Burundi,BDI,Cote d'Ivoire,CIV,5,0,0,0,5
2016,Central African Rep.,CAF,Cote d'Ivoire,CIV,33,0,0,0,33
2016,Chad,TCD,Cote d'Ivoire,CIV,0,0,0,5,5
2016,Cameroon,CMR,Cote d'Ivoire,CIV,0,0,0,10,10
2016,Congo,COG,Cote d'Ivoire,CIV,0,0,0,10,10
2016,Dem. Rep. of the Congo,COD,Cote d'Ivoire,CIV,0,0,0,32,32
2016,Gabon,GAB,Cote d'Ivoire,CIV,0,0,0,5,5
2016,Ghana,GHA,Cote d'Ivoire,CIV,0,0,0,10,10
2016,Liberia,LBR,Cote d'Ivoire,CIV,0,0,0,232,232
2016,Nigeria,NGA,Cote d'Ivoire,CIV,0,0,0,68,68
2016,Rwanda,RWA,Cote d'Ivoire,CIV,0,0,0,10,10
2016,Sierra Leone,SLE,Cote d'Ivoire,CIV,0,0,0,10,10
2016,Togo,TGO,Cote d'Ivoire,CIV,0,0,0,12,12
2017,Burundi,BDI,Cote d'Ivoire,CIV,5,0,0,0,5
2017,Central African Rep.,CAF,Cote d'Ivoire,CIV,62,0,0,0,62
2017,Dem. Rep. of the Congo,COD,Cote d'Ivoire,CIV,5,0,0,0,5
2017,Liberia,LBR,Cote d'Ivoire,CIV,5,0,0,0,5
2017,Rwanda,RWA,Cote d'Ivoire,CIV,5,0,0,0,5
2017,Syrian Arab Rep.,SYR,Cote d'Ivoire,CIV,10,0,0,0,10
2017,Turkey,TUR,Cote d'Ivoire,CIV,20,0,0,0,20
2001,Ethiopia,ETH,Sudan,SDN,287,0,2913,0,3200
2002,Burundi,BDI,Cote d'Ivoire,CIV,0,0,13,0,13
2002,Central African Rep.,CAF,Cote d'Ivoire,CIV,18,0,10,0,28
2002,Chad,TCD,Cote d'Ivoire,CIV,0,0,5,0,5
2002,Congo,COG,Cote d'Ivoire,CIV,68,0,23,0,91
2002,Dem. Rep. of the Congo,COD,Cote d'Ivoire,CIV,10,0,22,0,32
2002,Liberia,LBR,Cote d'Ivoire,CIV,0,0,0,1328,1328
2002,Rwanda,RWA,Cote d'Ivoire,CIV,19,0,0,0,19
2003,Burundi,BDI,Cote d'Ivoire,CIV,13,0,0,0,13
2003,Cambodia,KHM,Cote d'Ivoire,CIV,5,0,0,0,5
2003,Central African Rep.,CAF,Cote d'Ivoire,CIV,10,0,0,0,10
2003,Congo,COG,Cote d'Ivoire,CIV,37,0,23,0,60
2003,Dem. Rep. of the Congo,COD,Cote d'Ivoire,CIV,33,0,60,0,93
2003,Guinea,GIN,Cote d'Ivoire,CIV,5,0,0,0,5
2003,Rwanda,RWA,Cote d'Ivoire,CIV,11,0,5,0,16
2003,China,CHN,Nepal,NPL,0,0,0,5,5
2003,Iran (Islamic Rep. of),IRN,Nepal,NPL,0,0,5,0,5
2004,Afghanistan,AFG,Cote d'Ivoire,CIV,0,0,10,0,10
2004,Burundi,BDI,Cote d'Ivoire,CIV,5,0,0,0,5
2004,Cambodia,KHM,Cote d'Ivoire,CIV,0,0,5,0,5
2004,Central African Rep.,CAF,Cote d'Ivoire,CIV,0,0,22,0,22
2004,Congo,COG,Cote d'Ivoire,CIV,23,5,37,0,65
2004,Dem. Rep. of the Congo,COD,Cote d'Ivoire,CIV,48,5,42,0,95
2004,Guinea,GIN,Cote d'Ivoire,CIV,0,0,5,0,5
2004,Kenya,KEN,Cote d'Ivoire,CIV,0,0,5,0,5
2004,Rwanda,RWA,Cote d'Ivoire,CIV,0,0,12,0,12
2004,Sierra Leone,SLE,Cote d'Ivoire,CIV,5,0,146,0,151
2004,Iraq,IRQ,Nepal,NPL,0,0,0,10,10
2004,Niger,NER,Nepal,NPL,0,0,5,0,5
2004,Pakistan,PAK,Nepal,NPL,0,0,0,43,43
2005,Armenia,ARM,Ecuador,ECU,5,0,0,0,5
2005,Cameroon,CMR,Ecuador,ECU,0,0,0,5,5
2005,Colombia,COL,Ecuador,ECU,2442,0,2395,1078,5915
2005,Cuba,CUB,Ecuador,ECU,14,0,0,0,14
2005,Palestinian,PSE,Ecuador,ECU,0,0,0,5,5
2005,Haiti,HTI,Ecuador,ECU,5,0,0,0,5
2005,Iraq,IRQ,Ecuador,ECU,0,0,0,5,5
2005,Pakistan,PAK,Ecuador,ECU,0,0,0,5,5
2005,Peru,PER,Ecuador,ECU,13,0,259,0,272
2005,Russian Federation,RUS,Ecuador,ECU,0,0,5,0,5
2005,Somalia,SOM,Ecuador,ECU,5,0,0,0,5
2005,Angola,AGO,Mozambique,MOZ,0,0,0,61,61
2005,Burundi,BDI,Mozambique,MOZ,0,0,0,646,646
2005,Dem. Rep. of the Congo,COD,Mozambique,MOZ,0,0,0,558,558
2005,Ethiopia,ETH,Mozambique,MOZ,0,0,0,28,28
2005,Rwanda,RWA,Mozambique,MOZ,0,0,0,433,433
2005,Sudan,SDN,Mozambique,MOZ,0,0,0,10,10
2006,Rwanda,RWA,Burundi,BDI,206,0,7837,11297,19340
2006,Afghanistan,AFG,Ecuador,ECU,5,0,0,0,5
2006,Colombia,COL,Ecuador,ECU,1943,0,2184,49,4176
2006,Cuba,CUB,Ecuador,ECU,29,0,0,0,29
2006,Haiti,HTI,Ecuador,ECU,5,0,0,0,5
2006,Nepal,NPL,Ecuador,ECU,0,0,5,0,5
2006,Peru,PER,Ecuador,ECU,5,0,508,0,513
2006,Russian Federation,RUS,Ecuador,ECU,5,0,0,0,5
2006,Venezuela (Bolivarian Republic of),VEN,Ecuador,ECU,0,0,5,0,5
2006,Burundi,BDI,Ethiopia,ETH,5,0,0,0,5
2006,Cameroon,CMR,Ethiopia,ETH,0,0,5,0,5
2006,Dem. Rep. of the Congo,COD,Ethiopia,ETH,31,0,0,0,31
2006,Eritrea,ERI,Ethiopia,ETH,2655,0,0,0,2655
2006,Sudan,SDN,Ethiopia,ETH,10,0,0,0,10
2007,Burundi,BDI,Ethiopia,ETH,49,0,0,12,61
2007,Dem. Rep. of the Congo,COD,Ethiopia,ETH,77,0,10,25,112
2007,Eritrea,ERI,Ethiopia,ETH,7806,0,0,0,7806
2007,Kenya,KEN,Ethiopia,ETH,2644,0,0,0,2644
2007,Nigeria,NGA,Ethiopia,ETH,5,0,0,5,10
2007,Rwanda,RWA,Ethiopia,ETH,5,0,0,5,10
2007,Somalia,SOM,Ethiopia,ETH,9251,0,0,5,9256
2007,Sudan,SDN,Ethiopia,ETH,54,0,0,16,70
2007,Uganda,UGA,Ethiopia,ETH,5,0,0,0,5
2008,Central African Rep.,CAF,Chad,TCD,0,0,5,0,5
2008,Cameroon,CMR,Chad,TCD,0,0,5,0,5
2008,Dem. Rep. of the Congo,COD,Chad,TCD,0,0,21,0,21
2008,Liberia,LBR,Chad,TCD,0,0,10,0,10
2008,Rwanda,RWA,Chad,TCD,0,0,5,0,5
2008,Somalia,SOM,Chad,TCD,0,0,5,0,5
2008,Sudan,SDN,Chad,TCD,0,0,53,0,53
2008,Burundi,BDI,Ethiopia,ETH,5,0,0,0,5
2008,Chad,TCD,Ethiopia,ETH,0,0,0,5,5
2008,Cameroon,CMR,Ethiopia,ETH,0,0,0,5,5
2008,Dem. Rep. of the Congo,COD,Ethiopia,ETH,14,0,0,0,14
2008,Eritrea,ERI,Ethiopia,ETH,7895,0,105,0,8000
2008,Nigeria,NGA,Ethiopia,ETH,0,0,0,13,13
2008,Somalia,SOM,Ethiopia,ETH,8883,0,2416,2731,14030
2008,Sudan,SDN,Ethiopia,ETH,139,0,0,12,151
2008,Cameroon,CMR,Israel,ISR,0,0,5,0,5
2008,Colombia,COL,Israel,ISR,0,0,5,11,16
2008,Eritrea,ERI,Israel,ISR,0,4416,0,5,4421
2008,Ethiopia,ETH,Israel,ISR,0,0,5,12,17
2008,Georgia,GEO,Israel,ISR,0,0,0,5,5
2008,Ghana,GHA,Israel,ISR,0,0,71,25,96
2008,Guinea,GIN,Israel,ISR,0,0,0,12,12
2008,Cote d'Ivoire,CIV,Israel,ISR,0,234,506,76,816
2008,Kenya,KEN,Israel,ISR,0,0,12,14,26
2008,Dem. People's Rep. of Korea,PRK,Israel,ISR,0,0,5,0,5
2008,Liberia,LBR,Israel,ISR,0,0,0,10,10
2008,Sri Lanka,LKA,Israel,ISR,0,0,0,5,5
2008,Mauritania,MRT,Israel,ISR,0,0,5,0,5
2008,Mali,MLI,Israel,ISR,0,0,5,0,5
2008,Myanmar,MMR,Israel,ISR,0,0,0,5,5
2008,Nigeria,NGA,Israel,ISR,0,0,194,66,260
2008,Philippines,PHL,Israel,ISR,0,0,10,10,20
2008,South Africa,ZAF,Israel,ISR,5,0,0,0,5
2008,Sierra Leone,SLE,Israel,ISR,0,0,5,0,5
2008,Sudan,SDN,Israel,ISR,0,3767,0,261,4028
2008,Togo,TGO,Israel,ISR,0,0,0,5,5
2008,Turkey,TUR,Israel,ISR,0,0,51,42,93
2008,Zimbabwe,ZWE,Israel,ISR,0,0,0,5,5
2008,Myanmar,MMR,Papua New Guinea,PNG,5,0,0,0,5
2009,Central African Rep.,CAF,Chad,TCD,0,0,5,0,5
2009,Dem. Rep. of the Congo,COD,Chad,TCD,5,0,85,0,90
2009,Sudan,SDN,Chad,TCD,0,0,35,0,35
2009,Burundi,BDI,Ethiopia,ETH,14,0,0,28,42
2009,Cameroon,CMR,Ethiopia,ETH,0,0,0,12,12
2009,Dem. Rep. of the Congo,COD,Ethiopia,ETH,35,0,0,23,58
2009,Djibouti,DJI,Ethiopia,ETH,12,0,0,0,12
2009,Eritrea,ERI,Ethiopia,ETH,16724,0,359,495,17578
2009,Kenya,KEN,Ethiopia,ETH,119,0,0,0,119
2009,Rwanda,RWA,Ethiopia,ETH,5,0,0,0,5
2009,Somalia,SOM,Ethiopia,ETH,2201,0,492,851,3544
2009,Sudan,SDN,Ethiopia,ETH,26,0,0,13,39
2009,Yemen,YEM,Ethiopia,ETH,5,0,0,0,5
2009,Russian Federation,RUS,Fiji,FJI,0,0,5,0,5
2009,Cote d'Ivoire,CIV,Liberia,LBR,42,0,10,0,52
2009,Pakistan,PAK,"China, Macao SAR",MAC,5,0,0,0,5
2010,Central African Rep.,CAF,Chad,TCD,0,0,0,5,5
2010,Dem. Rep. of the Congo,COD,Chad,TCD,13,0,0,0,13
2010,Liberia,LBR,Chad,TCD,0,0,0,10,10
2010,Sudan,SDN,Chad,TCD,12,0,0,5,17
2010,Eritrea,ERI,Djibouti,DJI,111,0,0,71,182
2010,Ethiopia,ETH,Djibouti,DJI,22,0,0,61,83
2010,Somalia,SOM,Djibouti,DJI,0,0,0,25,25
2010,Burundi,BDI,Ethiopia,ETH,5,0,0,5,10
2010,Congo,COG,Ethiopia,ETH,5,0,0,0,5
2010,Dem. Rep. of the Congo,COD,Ethiopia,ETH,99,0,0,52,151
2010,Djibouti,DJI,Ethiopia,ETH,0,0,11,0,11
2010,Eritrea,ERI,Ethiopia,ETH,0,0,0,326,326
2010,Cote d'Ivoire,CIV,Ethiopia,ETH,0,0,5,0,5
2010,Kenya,KEN,Ethiopia,ETH,0,0,0,1111,1111
2010,Somalia,SOM,Ethiopia,ETH,2928,0,691,491,4110
2010,Sudan,SDN,Ethiopia,ETH,112,0,0,22,134
2010,Uganda,UGA,Ethiopia,ETH,5,0,0,0,5
2011,Central African Rep.,CAF,Chad,TCD,948,0,0,0,948
2011,Dem. Rep. of the Congo,COD,Chad,TCD,19,0,0,0,19
2011,Guinea,GIN,Chad,TCD,5,0,0,0,5
2011,Sudan,SDN,Chad,TCD,4884,0,0,0,4884
2011,Burundi,BDI,Ethiopia,ETH,5,0,0,0,5
2011,Dem. Rep. of the Congo,COD,Ethiopia,ETH,99,0,0,0,99
2011,Djibouti,DJI,Ethiopia,ETH,10,0,0,0,10
2011,Eritrea,ERI,Ethiopia,ETH,0,0,0,93,93
2011,Kenya,KEN,Ethiopia,ETH,0,0,0,32,32
2011,Somalia,SOM,Ethiopia,ETH,37,0,0,122,159
2011,Sudan,SDN,Ethiopia,ETH,96,0,0,5,101
2011,Yemen,YEM,Ethiopia,ETH,12,0,0,0,12
2011,Cote d'Ivoire,CIV,Sierra Leone,SLE,0,17,0,0,17
2011,Nigeria,NGA,Sierra Leone,SLE,0,0,0,142,142
2011,Sudan,SDN,Sierra Leone,SLE,0,10,0,0,10
2011,Burundi,BDI,United Rep. of Tanzania,TZA,0,0,5,17,22
2011,Dem. Rep. of the Congo,COD,United Rep. of Tanzania,TZA,0,0,0,906,906
2011,Eritrea,ERI,United Rep. of Tanzania,TZA,13,0,0,0,13
2011,Rwanda,RWA,United Rep. of Tanzania,TZA,0,0,0,23,23
2011,Sudan,SDN,United Rep. of Tanzania,TZA,0,0,0,5,5
2011,Uganda,UGA,United Rep. of Tanzania,TZA,0,0,0,5,5
2012,Cuba,CUB,Bahamas,BHS,18,0,31,0,49
2012,Burundi,BDI,Botswana,BWA,5,0,0,0,5
2012,Dem. Rep. of the Congo,COD,Botswana,BWA,41,0,0,0,41
2012,Ethiopia,ETH,Botswana,BWA,5,0,0,0,5
2012,Namibia,NAM,Botswana,BWA,0,0,0,17,17
2012,Rwanda,RWA,Botswana,BWA,0,0,0,5,5
2012,Somalia,SOM,Botswana,BWA,33,0,0,0,33
2012,Zimbabwe,ZWE,Botswana,BWA,10,5,0,18,33
2012,Eritrea,ERI,Djibouti,DJI,108,0,0,0,108
2012,Dem. Rep. of the Congo,COD,Ethiopia,ETH,70,0,0,5,75
2012,Eritrea,ERI,Ethiopia,ETH,15,0,0,0,15
2012,Kenya,KEN,Ethiopia,ETH,303,0,0,0,303
2012,Somalia,SOM,Ethiopia,ETH,744,0,14,10,768
2012,Sudan,SDN,Ethiopia,ETH,39,0,0,496,535
2012,South Sudan,SSD,Ethiopia,ETH,0,0,0,5,5
2012,Yemen,YEM,Ethiopia,ETH,17,0,0,0,17
2012,Angola,AGO,Cote d'Ivoire,CIV,5,0,0,0,5
2012,Congo,COG,Cote d'Ivoire,CIV,10,0,0,0,10
2012,Ghana,GHA,Cote d'Ivoire,CIV,0,0,5,0,5
2012,Liberia,LBR,Cote d'Ivoire,CIV,0,0,181,5,186
2012,Nigeria,NGA,Cote d'Ivoire,CIV,0,0,5,0,5
2012,Dem. Rep. of the Congo,COD,Rwanda,RWA,15108,0,795,0,15903
2012,Bangladesh,BGD,United Rep. of Tanzania,TZA,0,0,0,11,11
2012,Dem. Rep. of the Congo,COD,United Rep. of Tanzania,TZA,5,0,0,71,76
2012,Ethiopia,ETH,United Rep. of Tanzania,TZA,0,0,0,5,5
2012,Somalia,SOM,United Rep. of Tanzania,TZA,0,0,0,297,297
2013,Cuba,CUB,Bahamas,BHS,16,0,66,0,82
2013,Haiti,HTI,Bahamas,BHS,0,0,5,5,10
2013,Sri Lanka,LKA,Bahamas,BHS,0,0,0,5,5
2013,Guatemala,GTM,Belize,BLZ,0,0,0,17,17
2013,Honduras,HND,Belize,BLZ,0,0,0,12,12
2013,El Salvador,SLV,Belize,BLZ,0,0,0,32,32
2013,Burundi,BDI,Ethiopia,ETH,10,0,0,0,10
2013,Dem. Rep. of the Congo,COD,Ethiopia,ETH,13,0,0,0,13
2013,Eritrea,ERI,Ethiopia,ETH,15,0,0,28,43
2013,Somalia,SOM,Ethiopia,ETH,205,0,0,0,205
2013,Sudan,SDN,Ethiopia,ETH,20,0,0,0,20
2013,South Sudan,SSD,Ethiopia,ETH,12,0,0,0,12
2013,Yemen,YEM,Ethiopia,ETH,16,0,0,25,41
2013,Central African Rep.,CAF,Cote d'Ivoire,CIV,27,0,0,0,27
2013,Dem. Rep. of the Congo,COD,Cote d'Ivoire,CIV,5,0,0,0,5
2013,Liberia,LBR,Cote d'Ivoire,CIV,5,0,0,0,5
2013,Sudan,SDN,Cote d'Ivoire,CIV,5,0,0,0,5
2013,Cuba,CUB,Turks and Caicos Islands,TCA,5,0,0,20,25
2014,Honduras,HND,Belize,BLZ,0,0,0,10,10
2014,El Salvador,SLV,Belize,BLZ,0,0,0,12,12
2014,Dem. Rep. of the Congo,COD,Ethiopia,ETH,22,0,0,0,22
2014,Eritrea,ERI,Ethiopia,ETH,13,0,0,34,47
2014,Kenya,KEN,Ethiopia,ETH,0,0,0,10,10
2014,Sudan,SDN,Ethiopia,ETH,0,0,0,75,75
2014,South Sudan,SSD,Ethiopia,ETH,13,0,0,25,38
2014,Yemen,YEM,Ethiopia,ETH,5,0,0,12,17
2014,Afghanistan,AFG,Fiji,FJI,5,0,0,0,5
2014,Burundi,BDI,Kenya,KEN,40,0,44,405,489
2014,Cameroon,CMR,Kenya,KEN,0,0,0,10,10
2014,Congo,COG,Kenya,KEN,0,0,0,13,13
2014,Dem. Rep. of the Congo,COD,Kenya,KEN,2727,0,109,614,3450
2014,Eritrea,ERI,Kenya,KEN,83,0,5,0,88
2014,Ethiopia,ETH,Kenya,KEN,536,0,288,866,1690
2014,Iran (Islamic Rep. of),IRN,Kenya,KEN,5,0,0,0,5
2014,Mozambique,MOZ,Kenya,KEN,0,0,10,0,10
2014,Nigeria,NGA,Kenya,KEN,5,0,0,0,5
2014,Pakistan,PAK,Kenya,KEN,0,0,0,5,5
2014,Rwanda,RWA,Kenya,KEN,10,0,11,117,138
2014,Sierra Leone,SLE,Kenya,KEN,0,0,0,5,5
2014,Somalia,SOM,Kenya,KEN,45,0,29,1248,1322
2014,Sudan,SDN,Kenya,KEN,5,0,0,745,750
2014,South Sudan,SSD,Kenya,KEN,48,0,0,327,375
2014,United Rep. of Tanzania,TZA,Kenya,KEN,0,0,0,24,24
2014,Uganda,UGA,Kenya,KEN,104,0,21,99,224
2014,Zimbabwe,ZWE,Kenya,KEN,5,0,0,0,5
2014,Cote d'Ivoire,CIV,Liberia,LBR,0,0,0,11,11
2014,Mali,MLI,Liberia,LBR,14,0,0,0,14
2014,Syrian Arab Rep.,SYR,Liberia,LBR,5,0,0,0,5
2015,Syrian Arab Rep.,SYR,Antigua and Barbuda,ATG,15,0,0,0,15
2015,Central African Rep.,CAF,Burkina Faso,BFA,113,0,0,0,113
2015,Chad,TCD,Burkina Faso,BFA,5,0,0,0,5
2015,El Salvador,SLV,Belize,BLZ,34,0,0,0,34
2015,Egypt,EGY,Ethiopia,ETH,5,0,0,0,5
2015,Burundi,BDI,Ethiopia,ETH,0,0,5,5,10
2015,Congo,COG,Ethiopia,ETH,0,0,0,5,5
2015,Dem. Rep. of the Congo,COD,Ethiopia,ETH,14,0,5,10,29
2015,Eritrea,ERI,Ethiopia,ETH,14,0,0,0,14
2015,Somalia,SOM,Ethiopia,ETH,5,0,0,0,5
2015,Sudan,SDN,Ethiopia,ETH,11,0,0,37,48
2015,South Sudan,SSD,Ethiopia,ETH,5,0,5,55,65
2015,Syrian Arab Rep.,SYR,Ethiopia,ETH,10,0,0,0,10
2015,Yemen,YEM,Ethiopia,ETH,69,0,0,0,69
2015,Lebanon,LBN,Fiji,FJI,0,0,0,5,5
2015,Burundi,BDI,Kenya,KEN,177,5,5,432,619
2015,Congo,COG,Kenya,KEN,10,0,0,14,24
2015,Dem. Rep. of the Congo,COD,Kenya,KEN,2704,13,5,867,3589
2015,Eritrea,ERI,Kenya,KEN,35,0,0,5,40
2015,Ethiopia,ETH,Kenya,KEN,863,22,45,945,1875
2015,Iran (Islamic Rep. of),IRN,Kenya,KEN,5,0,0,0,5
2015,Rwanda,RWA,Kenya,KEN,10,0,12,0,22
2015,Somalia,SOM,Kenya,KEN,75,1263,5,769,2112
2015,Sudan,SDN,Kenya,KEN,149,138,0,292,579
2015,South Sudan,SSD,Kenya,KEN,22,47,0,330,399
2015,Syrian Arab Rep.,SYR,Kenya,KEN,0,0,0,16,16
2015,United Rep. of Tanzania,TZA,Kenya,KEN,0,0,0,10,10
2015,Uganda,UGA,Kenya,KEN,90,0,5,131,226
2015,Yemen,YEM,Kenya,KEN,0,0,0,5,5
2015,Mali,MLI,Liberia,LBR,0,0,0,5,5
2015,Nigeria,NGA,Liberia,LBR,0,0,0,10,10
2015,Sierra Leone,SLE,Liberia,LBR,0,0,0,5,5
2015,Togo,TGO,Liberia,LBR,0,0,0,10,10
2015,Cuba,CUB,Turks and Caicos Islands,TCA,0,0,0,5,5
2016,China,CHN,Bahamas,BHS,0,0,0,5,5
2016,Central African Rep.,CAF,Burkina Faso,BFA,78,0,0,0,78
2016,Chad,TCD,Burkina Faso,BFA,5,0,0,0,5
2016,Dem. Rep. of the Congo,COD,Burkina Faso,BFA,5,0,0,0,5
2016,Rwanda,RWA,Burkina Faso,BFA,5,0,0,0,5
2016,Burundi,BDI,Ethiopia,ETH,5,0,0,0,5
2016,Dem. Rep. of the Congo,COD,Ethiopia,ETH,57,0,0,0,57
2016,Cuba,CUB,Ethiopia,ETH,5,0,0,0,5
2016,Eritrea,ERI,Ethiopia,ETH,5,0,0,0,5
2016,Iraq,IRQ,Ethiopia,ETH,10,0,0,0,10
2016,Liberia,LBR,Ethiopia,ETH,0,0,0,5,5
2016,Somalia,SOM,Ethiopia,ETH,13,0,0,0,13
2016,Sudan,SDN,Ethiopia,ETH,17,0,0,0,17
2016,South Sudan,SSD,Ethiopia,ETH,0,0,0,439,439
2016,Yemen,YEM,Ethiopia,ETH,50,0,0,10,60
2016,Afghanistan,AFG,Kenya,KEN,5,0,0,0,5
2016,Burundi,BDI,Kenya,KEN,985,22,0,2073,3080
2016,Congo,COG,Kenya,KEN,0,0,0,10,10
2016,Dem. Rep. of the Congo,COD,Kenya,KEN,2481,260,0,1307,4048
2016,Eritrea,ERI,Kenya,KEN,19,10,0,59,88
2016,Ethiopia,ETH,Kenya,KEN,1077,108,0,2341,3526
2016,Cote d'Ivoire,CIV,Kenya,KEN,0,0,0,5,5
2016,Iraq,IRQ,Kenya,KEN,0,5,0,0,5
2016,Pakistan,PAK,Kenya,KEN,0,5,0,0,5
2016,Rwanda,RWA,Kenya,KEN,13,13,0,120,146
2016,Somalia,SOM,Kenya,KEN,46,5,0,488,539
2016,Sudan,SDN,Kenya,KEN,363,5,0,1526,1894
2016,South Sudan,SSD,Kenya,KEN,5,82,0,82,169
2016,United Rep. of Tanzania,TZA,Kenya,KEN,0,0,0,18,18
2016,Uganda,UGA,Kenya,KEN,81,14,10,490,595
2016,Yemen,YEM,Kenya,KEN,18,0,0,10,28
2016,Tibetan,TIB,Kenya,KEN,5,0,0,0,5
2016,Pakistan,PAK,Liberia,LBR,0,5,0,0,5
2017,Cuba,CUB,Bahamas,BHS,0,0,5,5,10
2017,Burundi,BDI,Burkina Faso,BFA,10,0,0,0,10
2017,Central African Rep.,CAF,Burkina Faso,BFA,40,0,0,76,116
2017,Chad,TCD,Burkina Faso,BFA,0,0,0,5,5
2017,Dem. Rep. of the Congo,COD,Burkina Faso,BFA,10,0,0,0,10
2017,Cote d'Ivoire,CIV,Burkina Faso,BFA,0,0,0,5,5
2017,Rwanda,RWA,Burkina Faso,BFA,5,0,0,0,5
2017,Togo,TGO,Burkina Faso,BFA,0,0,0,5,5
2017,Burundi,BDI,Ethiopia,ETH,0,0,0,10,10
2017,Dem. Rep. of the Congo,COD,Ethiopia,ETH,75,0,0,123,198
2017,Eritrea,ERI,Ethiopia,ETH,17,0,0,13,30
2017,Sudan,SDN,Ethiopia,ETH,22,0,0,0,22
2017,Yemen,YEM,Ethiopia,ETH,13,0,0,0,13
2017,Burundi,BDI,Kenya,KEN,258,0,0,111,369
2017,Congo,COG,Kenya,KEN,0,0,0,13,13
2017,Dem. Rep. of the Congo,COD,Kenya,KEN,1419,0,0,186,1605
2017,Eritrea,ERI,Kenya,KEN,32,0,0,41,73
2017,Ethiopia,ETH,Kenya,KEN,418,0,0,1019,1437
2017,Mozambique,MOZ,Kenya,KEN,5,0,0,0,5
2017,Rwanda,RWA,Kenya,KEN,21,0,0,110,131
2017,Sierra Leone,SLE,Kenya,KEN,5,0,0,0,5
2017,Somalia,SOM,Kenya,KEN,35,0,0,1001,1036
2017,Sudan,SDN,Kenya,KEN,35,0,0,13,48
2017,South Sudan,SSD,Kenya,KEN,5,0,0,1213,1218
2017,Uganda,UGA,Kenya,KEN,50,0,0,114,164
2017,Yemen,YEM,Kenya,KEN,44,0,0,22,66
2018,Colombia,COL,Bahamas,BHS,5,0,0,0,5
2018,Central African Rep.,CAF,Congo,COG,760,0,0,0,760
2018,Chad,TCD,Congo,COG,0,0,0,5,5
2018,Dem. Rep. of the Congo,COD,Congo,COG,5,0,131,0,136
2018,Mauritania,MRT,Congo,COG,0,0,21,0,21
2018,Rwanda,RWA,Congo,COG,0,0,68,0,68
2018,Syrian Arab Rep.,SYR,Congo,COG,5,0,0,0,5
2018,Eritrea,ERI,Djibouti,DJI,0,0,0,354,354
2018,Ethiopia,ETH,Djibouti,DJI,0,0,0,698,698
2018,Burundi,BDI,Ethiopia,ETH,0,0,0,5,5
2018,Dem. Rep. of the Congo,COD,Ethiopia,ETH,0,5,0,225,230
2018,Eritrea,ERI,Ethiopia,ETH,0,0,0,107,107
2018,Sudan,SDN,Ethiopia,ETH,0,0,0,61,61
2018,South Sudan,SSD,Ethiopia,ETH,0,0,0,428,428
2018,Central African Rep.,CAF,Niger,NER,15,0,0,14,29
2018,Chad,TCD,Niger,NER,0,0,0,23,23
2018,Cameroon,CMR,Niger,NER,5,0,0,41,46
2018,Dem. Rep. of the Congo,COD,Niger,NER,0,0,0,5,5
2018,Eritrea,ERI,Niger,NER,1296,0,0,0,1296
2018,Ethiopia,ETH,Niger,NER,73,0,0,0,73
2018,Guinea-Bissau,GNB,Niger,NER,0,0,0,5,5
2018,Guinea,GIN,Niger,NER,0,0,0,13,13
2018,Cote d'Ivoire,CIV,Niger,NER,0,0,0,5,5
2018,Liberia,LBR,Niger,NER,0,0,0,5,5
2018,Libya,LBY,Niger,NER,0,0,0,15,15
2018,Mali,MLI,Niger,NER,0,0,0,14,14
2018,Nigeria,NGA,Niger,NER,0,0,0,83,83
2018,Pakistan,PAK,Niger,NER,0,0,0,5,5
2018,Sierra Leone,SLE,Niger,NER,0,0,0,5,5
2018,Somalia,SOM,Niger,NER,161,0,0,5,166
2018,Sudan,SDN,Niger,NER,26,0,0,696,722
2018,Syrian Arab Rep.,SYR,Niger,NER,5,0,0,0,5
2018,Togo,TGO,Niger,NER,0,0,0,5,5
2019,Dem. Rep. of the Congo,COD,Ethiopia,ETH,0,0,0,51,51
2019,Djibouti,DJI,Ethiopia,ETH,0,0,0,5,5
2019,Eritrea,ERI,Ethiopia,ETH,5,0,0,90,95
2019,Kenya,KEN,Ethiopia,ETH,0,0,0,429,429
2019,Somalia,SOM,Ethiopia,ETH,0,0,0,29,29
2019,South Sudan,SSD,Ethiopia,ETH,0,0,0,232,232
2019,Yemen,YEM,Ethiopia,ETH,0,0,0,66,66
2019,Eritrea,ERI,Niger,NER,734,0,26,5,765
2019,Ethiopia,ETH,Niger,NER,64,0,24,0,88
2019,Somalia,SOM,Niger,NER,207,0,16,10,233
2019,Sudan,SDN,Niger,NER,94,0,0,0,94
2019,Syrian Arab Rep.,SYR,Niger,NER,5,0,0,0,5
2019,Indonesia,IDN,Solomon Islands,SLB,0,0,0,5,5
2020,Burundi,BDI,Ethiopia,ETH,5,0,0,0,5
2020,Dem. Rep. of the Congo,COD,Ethiopia,ETH,10,0,0,14,24
2020,Eritrea,ERI,Ethiopia,ETH,10,0,0,0,10
2020,Somalia,SOM,Ethiopia,ETH,12,0,0,0,12
2020,South Sudan,SSD,Ethiopia,ETH,5,0,0,0,5
2020,Syrian Arab Rep.,SYR,Ethiopia,ETH,5,0,0,0,5
2020,Yemen,YEM,Ethiopia,ETH,10,0,0,0,10
2020,Eritrea,ERI,Niger,NER,211,0,0,24,235
2020,Ethiopia,ETH,Niger,NER,5,0,0,0,5
2020,Somalia,SOM,Niger,NER,26,0,0,20,46
2020,Sudan,SDN,Niger,NER,29,0,0,21,50
2021,Dem. Rep. of the Congo,COD,Ethiopia,ETH,15,0,0,0,15
2021,Eritrea,ERI,Ethiopia,ETH,10,0,0,0,10
2021,Somalia,SOM,Ethiopia,ETH,13,0,0,0,13
2021,Sudan,SDN,Ethiopia,ETH,15,0,0,0,15
2021,South Sudan,SSD,Ethiopia,ETH,38,0,0,0,38
2021,Syrian Arab Rep.,SYR,Ethiopia,ETH,33,0,0,0,33
2021,Yemen,YEM,Ethiopia,ETH,14,0,0,0,14
2021,Eritrea,ERI,Niger,NER,60,0,0,12,72
2021,Somalia,SOM,Niger,NER,11,0,0,0,11
2021,Sudan,SDN,Niger,NER,50,0,0,13,63
2006,Ethiopia,ETH,Somalia,SOM,5,0,28,0,33
2007,Ethiopia,ETH,Somalia,SOM,28,0,10,0,38
2014,Cuba,CUB,Haiti,HTI,0,0,0,5,5
2002,Afghanistan,AFG,India,IND,62,0,10,0,72
2002,Ethiopia,ETH,India,IND,0,0,5,0,5
2002,Iran (Islamic Rep. of),IRN,India,IND,5,0,0,0,5
2002,Myanmar,MMR,India,IND,14,0,18,0,32
2002,Somalia,SOM,India,IND,0,0,5,0,5
2002,Sudan,SDN,India,IND,10,0,11,0,21
2003,Afghanistan,AFG,India,IND,0,0,18,0,18
2003,Eritrea,ERI,India,IND,0,0,5,0,5
2003,Ethiopia,ETH,India,IND,0,0,5,0,5
2003,Iran (Islamic Rep. of),IRN,India,IND,5,0,5,0,10
2003,Myanmar,MMR,India,IND,14,0,85,0,99
2003,Somalia,SOM,India,IND,5,0,5,0,10
2003,Sudan,SDN,India,IND,5,0,17,0,22
2003,Burundi,BDI,Kenya,KEN,0,0,5,0,5
2003,Dem. Rep. of the Congo,COD,Kenya,KEN,11,0,31,0,42
2003,Eritrea,ERI,Kenya,KEN,5,0,5,0,10
2003,Ethiopia,ETH,Kenya,KEN,24,0,130,0,154
2003,Rwanda,RWA,Kenya,KEN,0,0,27,0,27
2003,Uganda,UGA,Kenya,KEN,0,0,33,0,33
2003,Dem. Rep. of the Congo,COD,Niger,NER,0,0,27,0,27
2003,Iran (Islamic Rep. of),IRN,United Arab Emirates,ARE,0,0,5,0,5
2004,Afghanistan,AFG,India,IND,10,0,16,0,26
2004,Eritrea,ERI,India,IND,5,0,0,0,5
2004,Ethiopia,ETH,India,IND,0,0,5,0,5
2004,Iran (Islamic Rep. of),IRN,India,IND,0,0,5,0,5
2004,Myanmar,MMR,India,IND,47,0,121,12,180
2004,Somalia,SOM,India,IND,10,0,5,11,26
2004,Sudan,SDN,India,IND,0,0,23,0,23
2004,China,CHN,Kazakhstan,KAZ,11,0,0,0,11
2004,Turkmenistan,TKM,Kazakhstan,KAZ,10,0,0,0,10
2004,Uzbekistan,UZB,Kazakhstan,KAZ,5,0,0,0,5
2004,Burundi,BDI,Kenya,KEN,0,0,5,0,5
2004,Dem. Rep. of the Congo,COD,Kenya,KEN,13,0,17,0,30
2004,Eritrea,ERI,Kenya,KEN,5,0,0,0,5
2004,Ethiopia,ETH,Kenya,KEN,16,0,176,0,192
2004,Rwanda,RWA,Kenya,KEN,0,0,27,0,27
2004,Somalia,SOM,Kenya,KEN,14,0,5,0,19
2004,Uganda,UGA,Kenya,KEN,5,0,17,0,22
2004,Mauritania,MRT,United Arab Emirates,ARE,0,0,5,0,5
2005,Viet Nam,VNM,Cambodia,KHM,63,0,157,34,254
2005,Angola,AGO,"China, Hong Kong SAR",HKG,0,0,5,0,5
2005,Bangladesh,BGD,"China, Hong Kong SAR",HKG,0,0,5,0,5
2005,Cameroon,CMR,"China, Hong Kong SAR",HKG,0,0,11,0,11
2005,Congo,COG,"China, Hong Kong SAR",HKG,0,0,5,0,5
2005,Dem. Rep. of the Congo,COD,"China, Hong Kong SAR",HKG,5,0,10,0,15
2005,Ethiopia,ETH,"China, Hong Kong SAR",HKG,0,0,5,0,5
2005,Ghana,GHA,"China, Hong Kong SAR",HKG,0,0,5,0,5
2005,Iran (Islamic Rep. of),IRN,"China, Hong Kong SAR",HKG,5,0,0,0,5
2005,Liberia,LBR,"China, Hong Kong SAR",HKG,0,0,5,0,5
2005,Sri Lanka,LKA,"China, Hong Kong SAR",HKG,0,0,28,0,28
2005,Nepal,NPL,"China, Hong Kong SAR",HKG,0,0,5,0,5
2005,Nigeria,NGA,"China, Hong Kong SAR",HKG,0,0,20,0,20
2005,Pakistan,PAK,"China, Hong Kong SAR",HKG,5,0,27,0,32
2005,Viet Nam,VNM,"China, Hong Kong SAR",HKG,5,0,0,0,5
2005,Zimbabwe,ZWE,"China, Hong Kong SAR",HKG,0,0,5,0,5
2005,Afghanistan,AFG,India,IND,5,0,5,12,22
2005,Ethiopia,ETH,India,IND,0,0,0,5,5
2005,Iran (Islamic Rep. of),IRN,India,IND,0,0,5,0,5
2005,Myanmar,MMR,India,IND,89,0,49,23,161
2005,Somalia,SOM,India,IND,20,0,5,0,25
2005,Sudan,SDN,India,IND,0,0,5,5,10
2005,Burundi,BDI,Kenya,KEN,5,0,0,0,5
2005,Dem. Rep. of the Congo,COD,Kenya,KEN,19,0,10,0,29
2005,Eritrea,ERI,Kenya,KEN,0,0,10,0,10
2005,Ethiopia,ETH,Kenya,KEN,19,0,125,0,144
2005,Rwanda,RWA,Kenya,KEN,10,0,56,0,66
2005,Somalia,SOM,Kenya,KEN,12,0,0,0,12
2005,Uganda,UGA,Kenya,KEN,0,0,15,0,15
2005,Cambodia,KHM,Thailand,THA,0,0,68,0,68
2005,China,CHN,Thailand,THA,0,0,21,0,21
2005,Cote d'Ivoire,CIV,Thailand,THA,5,0,0,0,5
2005,Iran (Islamic Rep. of),IRN,Thailand,THA,5,0,13,0,18
2005,Lao People's Dem. Rep.,LAO,Thailand,THA,5,0,5,0,10
2005,Sri Lanka,LKA,Thailand,THA,0,0,5,0,5
2005,Myanmar,MMR,Thailand,THA,5,0,22,0,27
2005,Nepal,NPL,Thailand,THA,5,0,5,0,10
2005,Nigeria,NGA,Thailand,THA,0,0,5,0,5
2005,Pakistan,PAK,Thailand,THA,0,0,5,0,5
2005,Viet Nam,VNM,Thailand,THA,0,0,29,0,29
2006,Eritrea,ERI,Egypt,EGY,0,0,10,0,10
2006,Ethiopia,ETH,Egypt,EGY,0,0,29,0,29
2006,Jordan,JOR,Egypt,EGY,0,0,5,0,5
2006,Somalia,SOM,Egypt,EGY,19,0,0,0,19
2006,Tajikistan,TJK,Egypt,EGY,0,0,5,0,5
2006,Viet Nam,VNM,Cambodia,KHM,14,0,93,18,125
2006,Ethiopia,ETH,Djibouti,DJI,19,0,61,0,80
2006,Bangladesh,BGD,"China, Hong Kong SAR",HKG,0,0,14,0,14
2006,Cameroon,CMR,"China, Hong Kong SAR",HKG,0,0,12,5,17
2006,Congo,COG,"China, Hong Kong SAR",HKG,0,0,10,0,10
2006,Dem. Rep. of the Congo,COD,"China, Hong Kong SAR",HKG,0,0,5,0,5
2006,Ethiopia,ETH,"China, Hong Kong SAR",HKG,5,0,0,0,5
2006,Ghana,GHA,"China, Hong Kong SAR",HKG,0,0,46,16,62
2006,Cote d'Ivoire,CIV,"China, Hong Kong SAR",HKG,0,0,0,5,5
2006,India,IND,"China, Hong Kong SAR",HKG,0,0,33,29,62
2006,Liberia,LBR,"China, Hong Kong SAR",HKG,0,0,11,0,11
2006,Sri Lanka,LKA,"China, Hong Kong SAR",HKG,0,0,48,54,102
2006,Nepal,NPL,"China, Hong Kong SAR",HKG,0,0,10,27,37
2006,Nigeria,NGA,"China, Hong Kong SAR",HKG,0,0,29,10,39
2006,Pakistan,PAK,"China, Hong Kong SAR",HKG,0,0,45,11,56
2006,Philippines,PHL,"China, Hong Kong SAR",HKG,0,0,0,5,5
2006,Togo,TGO,"China, Hong Kong SAR",HKG,0,0,10,0,10
2006,Afghanistan,AFG,India,IND,0,0,12,5,17
2006,Congo,COG,India,IND,0,0,0,5,5
2006,Dem. Rep. of the Congo,COD,India,IND,5,0,0,0,5
2006,Ethiopia,ETH,India,IND,0,0,0,5,5
2006,Iran (Islamic Rep. of),IRN,India,IND,0,0,5,0,5
2006,Myanmar,MMR,India,IND,35,0,24,5,64
2006,Somalia,SOM,India,IND,0,0,0,11,11
2006,Sudan,SDN,India,IND,0,0,12,0,12
2006,Burundi,BDI,Kenya,KEN,0,0,5,0,5
2006,Dem. Rep. of the Congo,COD,Kenya,KEN,13,0,13,0,26
2006,Eritrea,ERI,Kenya,KEN,5,0,0,0,5
2006,Ethiopia,ETH,Kenya,KEN,94,0,221,0,315
2006,Rwanda,RWA,Kenya,KEN,37,0,46,0,83
2006,Sierra Leone,SLE,Kenya,KEN,0,0,0,5,5
2006,Somalia,SOM,Kenya,KEN,5,0,10,0,15
2006,United Rep. of Tanzania,TZA,Kenya,KEN,5,0,0,0,5
2006,Uganda,UGA,Kenya,KEN,14,0,0,0,14
2006,Algeria,DZA,Lebanon,LBN,0,0,5,0,5
2006,Egypt,EGY,Lebanon,LBN,0,0,5,0,5
2006,Iraq,IRQ,Lebanon,LBN,12,0,85,0,97
2006,Somalia,SOM,Lebanon,LBN,0,0,5,0,5
2006,Sudan,SDN,Lebanon,LBN,0,0,30,0,30
2006,Syrian Arab Rep.,SYR,Lebanon,LBN,0,0,12,0,12
2006,Iraq,IRQ,Nepal,NPL,5,0,0,0,5
2006,Pakistan,PAK,Nepal,NPL,67,0,63,5,135
2006,Burundi,BDI,Rwanda,RWA,5,0,0,73,78
2006,Dem. Rep. of the Congo,COD,Rwanda,RWA,129,0,0,121,250
2006,Somalia,SOM,Rwanda,RWA,0,0,0,5,5
2006,Uganda,UGA,Rwanda,RWA,0,0,0,11,11
2006,Afghanistan,AFG,Syrian Arab Rep.,SYR,41,0,0,0,41
2006,Eritrea,ERI,Syrian Arab Rep.,SYR,5,0,0,0,5
2006,Iran (Islamic Rep. of),IRN,Syrian Arab Rep.,SYR,12,0,17,0,29
2006,Kenya,KEN,Syrian Arab Rep.,SYR,0,0,0,5,5
2006,Somalia,SOM,Syrian Arab Rep.,SYR,135,0,19,0,154
2006,Sudan,SDN,Syrian Arab Rep.,SYR,11,0,22,0,33
2006,Cambodia,KHM,Thailand,THA,0,0,93,16,109
2006,China,CHN,Thailand,THA,5,0,12,5,22
2006,Dem. Rep. of the Congo,COD,Thailand,THA,0,0,10,0,10
2006,India,IND,Thailand,THA,0,0,5,0,5
2006,Iran (Islamic Rep. of),IRN,Thailand,THA,0,0,0,5,5
2006,Lao People's Dem. Rep.,LAO,Thailand,THA,12,0,0,0,12
2006,Sri Lanka,LKA,Thailand,THA,5,0,18,0,23
2006,Myanmar,MMR,Thailand,THA,5,0,0,0,5
2006,Nepal,NPL,Thailand,THA,5,0,13,0,18
2006,Nigeria,NGA,Thailand,THA,0,0,0,5,5
2006,Sierra Leone,SLE,Thailand,THA,0,0,5,0,5
2006,Somalia,SOM,Thailand,THA,5,0,0,0,5
2006,Viet Nam,VNM,Thailand,THA,14,0,23,5,42
2006,Afghanistan,AFG,Turkey,TUR,22,0,0,0,22
2006,Dem. Rep. of the Congo,COD,Turkey,TUR,0,0,5,0,5
2006,Eritrea,ERI,Turkey,TUR,5,0,0,0,5
2006,Iran (Islamic Rep. of),IRN,Turkey,TUR,185,0,112,0,297
2006,Iraq,IRQ,Turkey,TUR,5,0,0,0,5
2006,Somalia,SOM,Turkey,TUR,12,0,36,0,48
2006,Sudan,SDN,Turkey,TUR,0,0,5,0,5
2006,Tunisia,TUN,Turkey,TUR,0,0,5,0,5
2007,Dem. Rep. of the Congo,COD,Egypt,EGY,0,0,0,5,5
2007,Eritrea,ERI,Egypt,EGY,0,0,24,5,29
2007,Ethiopia,ETH,Egypt,EGY,0,0,78,5,83
2007,Cote d'Ivoire,CIV,Egypt,EGY,0,0,5,0,5
2007,Iraq,IRQ,Egypt,EGY,5,0,0,0,5
2007,Rwanda,RWA,Egypt,EGY,0,0,0,5,5
2007,Somalia,SOM,Egypt,EGY,58,0,0,0,58
2007,Sudan,SDN,Egypt,EGY,18,0,204,0,222
2007,Uzbekistan,UZB,Egypt,EGY,5,0,0,0,5
2007,Viet Nam,VNM,Cambodia,KHM,24,0,136,10,170
2007,Angola,AGO,"China, Hong Kong SAR",HKG,0,0,5,0,5
2007,Bangladesh,BGD,"China, Hong Kong SAR",HKG,0,0,64,0,64
2007,Cameroon,CMR,"China, Hong Kong SAR",HKG,0,0,0,5,5
2007,Congo,COG,"China, Hong Kong SAR",HKG,0,0,5,0,5
2007,Ghana,GHA,"China, Hong Kong SAR",HKG,0,0,12,10,22
2007,Guinea,GIN,"China, Hong Kong SAR",HKG,0,0,5,0,5
2007,India,IND,"China, Hong Kong SAR",HKG,0,0,98,0,98
2007,Indonesia,IDN,"China, Hong Kong SAR",HKG,0,0,5,0,5
2007,Liberia,LBR,"China, Hong Kong SAR",HKG,0,0,0,5,5
2007,Sri Lanka,LKA,"China, Hong Kong SAR",HKG,0,0,18,44,62
2007,Nepal,NPL,"China, Hong Kong SAR",HKG,0,0,127,80,207
2007,Nigeria,NGA,"China, Hong Kong SAR",HKG,0,0,5,11,16
2007,Pakistan,PAK,"China, Hong Kong SAR",HKG,0,0,151,11,162
2007,Philippines,PHL,"China, Hong Kong SAR",HKG,0,0,5,0,5
2007,Togo,TGO,"China, Hong Kong SAR",HKG,0,0,11,0,11
2007,Afghanistan,AFG,India,IND,5,0,28,5,38
2007,Dem. Rep. of the Congo,COD,India,IND,0,0,5,0,5
2007,Iran (Islamic Rep. of),IRN,India,IND,0,0,5,5,10
2007,Myanmar,MMR,India,IND,12,0,5,5,22
2007,Somalia,SOM,India,IND,0,0,11,0,11
2007,Burundi,BDI,Kenya,KEN,5,0,5,0,10
2007,Dem. Rep. of the Congo,COD,Kenya,KEN,23,0,24,10,57
2007,Eritrea,ERI,Kenya,KEN,0,0,5,0,5
2007,Ethiopia,ETH,Kenya,KEN,72,0,233,82,387
2007,Rwanda,RWA,Kenya,KEN,19,0,46,5,70
2007,Somalia,SOM,Kenya,KEN,17,0,0,0,17
2007,Sudan,SDN,Kenya,KEN,0,0,10,0,10
2007,Uganda,UGA,Kenya,KEN,0,0,54,23,77
2007,Egypt,EGY,Lebanon,LBN,5,0,0,0,5
2007,Bangladesh,BGD,Lebanon,LBN,0,0,5,0,5
2007,Iran (Islamic Rep. of),IRN,Lebanon,LBN,0,0,5,0,5
2007,Iraq,IRQ,Lebanon,LBN,0,0,14,0,14
2007,Somalia,SOM,Lebanon,LBN,0,0,5,0,5
2007,Sudan,SDN,Lebanon,LBN,0,0,38,0,38
2007,Syrian Arab Rep.,SYR,Lebanon,LBN,14,0,0,0,14
2007,Benin,BEN,Morocco,MAR,0,0,5,0,5
2007,Central African Rep.,CAF,Morocco,MAR,0,0,5,0,5
2007,Cameroon,CMR,Morocco,MAR,0,0,12,0,12
2007,Congo,COG,Morocco,MAR,0,0,16,0,16
2007,Dem. Rep. of the Congo,COD,Morocco,MAR,0,0,249,0,249
2007,Gambia,GMB,Morocco,MAR,0,0,12,0,12
2007,Ghana,GHA,Morocco,MAR,0,0,22,0,22
2007,Guinea,GIN,Morocco,MAR,0,0,5,0,5
2007,Cote d'Ivoire,CIV,Morocco,MAR,0,0,10,0,10
2007,Liberia,LBR,Morocco,MAR,0,0,32,0,32
2007,Mali,MLI,Morocco,MAR,0,0,5,0,5
2007,Niger,NER,Morocco,MAR,0,0,5,0,5
2007,Nigeria,NGA,Morocco,MAR,0,0,177,0,177
2007,Rwanda,RWA,Morocco,MAR,0,0,5,0,5
2007,Sierra Leone,SLE,Morocco,MAR,0,0,14,0,14
2007,Sudan,SDN,Morocco,MAR,0,0,5,0,5
2007,Pakistan,PAK,Nepal,NPL,5,0,27,0,32
2007,Burundi,BDI,Rwanda,RWA,25,0,0,0,25
2007,Dem. Rep. of the Congo,COD,Rwanda,RWA,44,0,0,0,44
2007,Afghanistan,AFG,Syrian Arab Rep.,SYR,19,0,14,0,33
2007,Ethiopia,ETH,Syrian Arab Rep.,SYR,0,0,5,0,5
2007,Iran (Islamic Rep. of),IRN,Syrian Arab Rep.,SYR,0,0,20,0,20
2007,Somalia,SOM,Syrian Arab Rep.,SYR,62,0,12,0,74
2007,Sudan,SDN,Syrian Arab Rep.,SYR,16,0,14,0,30
2007,Syrian Arab Rep.,SYR,Syrian Arab Rep.,SYR,0,0,0,5,5
2007,Cambodia,KHM,Thailand,THA,5,0,30,5,40
2007,China,CHN,Thailand,THA,5,0,0,0,5
2007,Cameroon,CMR,Thailand,THA,0,0,5,0,5
2007,Dem. Rep. of the Congo,COD,Thailand,THA,0,0,10,14,24
2007,Cote d'Ivoire,CIV,Thailand,THA,5,0,0,0,5
2007,Iran (Islamic Rep. of),IRN,Thailand,THA,0,0,0,5,5
2007,Sri Lanka,LKA,Thailand,THA,11,0,0,0,11
2007,Nepal,NPL,Thailand,THA,0,0,17,5,22
2007,Nigeria,NGA,Thailand,THA,0,0,5,5,10
2007,Viet Nam,VNM,Thailand,THA,0,0,22,0,22
2007,Afghanistan,AFG,Turkey,TUR,17,0,18,0,35
2007,Eritrea,ERI,Turkey,TUR,0,0,5,0,5
2007,Ethiopia,ETH,Turkey,TUR,0,0,5,11,16
2007,Palestinian,PSE,Turkey,TUR,0,0,0,5,5
2007,Iran (Islamic Rep. of),IRN,Turkey,TUR,76,0,68,121,265
2007,Iraq,IRQ,Turkey,TUR,27,0,0,30,57
2007,Kazakhstan,KAZ,Turkey,TUR,0,0,5,0,5
2007,Liberia,LBR,Turkey,TUR,0,0,0,5,5
2007,Somalia,SOM,Turkey,TUR,23,0,12,22,57
2007,Sudan,SDN,Turkey,TUR,0,0,5,5,10
2007,Syrian Arab Rep.,SYR,Turkey,TUR,0,0,0,5,5
2008,Algeria,DZA,Egypt,EGY,0,0,0,5,5
2008,Chad,TCD,Egypt,EGY,0,0,0,5,5
2008,Eritrea,ERI,Egypt,EGY,5,0,100,0,105
2008,Ethiopia,ETH,Egypt,EGY,5,0,73,5,83
2008,Somalia,SOM,Egypt,EGY,5,0,0,0,5
2008,Sudan,SDN,Egypt,EGY,19,0,76,5,100
2008,Viet Nam,VNM,Cambodia,KHM,0,0,278,12,290
2008,Bangladesh,BGD,"China, Hong Kong SAR",HKG,0,0,138,5,143
2008,Cameroon,CMR,"China, Hong Kong SAR",HKG,0,0,5,0,5
2008,Congo,COG,"China, Hong Kong SAR",HKG,0,0,5,0,5
2008,Dem. Rep. of the Congo,COD,"China, Hong Kong SAR",HKG,0,0,5,0,5
2008,Ghana,GHA,"China, Hong Kong SAR",HKG,0,0,5,5,10
2008,India,IND,"China, Hong Kong SAR",HKG,0,0,74,12,86
2008,Indonesia,IDN,"China, Hong Kong SAR",HKG,0,0,5,0,5
2008,Liberia,LBR,"China, Hong Kong SAR",HKG,0,0,5,0,5
2008,Sri Lanka,LKA,"China, Hong Kong SAR",HKG,0,0,29,5,34
2008,Nepal,NPL,"China, Hong Kong SAR",HKG,0,0,140,22,162
2008,Nigeria,NGA,"China, Hong Kong SAR",HKG,0,0,5,0,5
2008,Pakistan,PAK,"China, Hong Kong SAR",HKG,0,0,145,17,162
2008,Philippines,PHL,"China, Hong Kong SAR",HKG,0,0,66,5,71
2008,Somalia,SOM,"China, Hong Kong SAR",HKG,5,0,0,0,5
2008,Togo,TGO,"China, Hong Kong SAR",HKG,0,0,24,0,24
2008,Afghanistan,AFG,India,IND,22,0,113,10,145
2008,Dem. Rep. of the Congo,COD,India,IND,0,0,0,5,5
2008,Eritrea,ERI,India,IND,5,0,0,0,5
2008,Ethiopia,ETH,India,IND,5,0,0,0,5
2008,Iran (Islamic Rep. of),IRN,India,IND,14,0,0,0,14
2008,Myanmar,MMR,India,IND,12,0,11,33,56
2008,Somalia,SOM,India,IND,17,0,0,13,30
2008,Sudan,SDN,Jordan,JOR,0,0,5,0,5
2008,Burundi,BDI,Kenya,KEN,11,0,0,0,11
2008,Dem. Rep. of the Congo,COD,Kenya,KEN,16,0,0,0,16
2008,Eritrea,ERI,Kenya,KEN,12,0,0,0,12
2008,Ethiopia,ETH,Kenya,KEN,201,0,60,51,312
2008,Rwanda,RWA,Kenya,KEN,5,0,32,0,37
2008,Somalia,SOM,Kenya,KEN,18,0,0,0,18
2008,Sudan,SDN,Kenya,KEN,65,0,38,0,103
2008,Uganda,UGA,Kenya,KEN,5,0,50,5,60
2008,Dem. Rep. of the Congo,COD,Libya,LBY,0,0,10,0,10
2008,Eritrea,ERI,Libya,LBY,5,0,0,0,5
2008,Ethiopia,ETH,Libya,LBY,5,0,0,0,5
2008,Iraq,IRQ,Libya,LBY,37,0,0,0,37
2008,Somalia,SOM,Libya,LBY,5,0,0,0,5
2008,Sudan,SDN,Libya,LBY,23,0,0,0,23
2008,Ethiopia,ETH,Lebanon,LBN,0,0,5,0,5
2008,Somalia,SOM,Lebanon,LBN,0,0,12,0,12
2008,Sudan,SDN,Lebanon,LBN,5,0,89,0,94
2008,Syrian Arab Rep.,SYR,Lebanon,LBN,0,0,10,0,10
2008,Chad,TCD,Morocco,MAR,0,0,5,0,5
2008,Cameroon,CMR,Morocco,MAR,0,0,13,0,13
2008,Congo,COG,Morocco,MAR,0,0,5,0,5
2008,Dem. Rep. of the Congo,COD,Morocco,MAR,0,0,188,0,188
2008,Ghana,GHA,Morocco,MAR,0,0,5,0,5
2008,Cote d'Ivoire,CIV,Morocco,MAR,0,0,21,0,21
2008,Liberia,LBR,Morocco,MAR,0,0,10,0,10
2008,Niger,NER,Morocco,MAR,0,0,5,0,5
2008,Nigeria,NGA,Morocco,MAR,0,0,63,0,63
2008,Sierra Leone,SLE,Morocco,MAR,0,0,10,0,10
2008,Uganda,UGA,Morocco,MAR,0,0,5,0,5
2008,Pakistan,PAK,Nepal,NPL,0,0,5,0,5
2008,Burundi,BDI,Rwanda,RWA,0,0,0,14,14
2008,Dem. Rep. of the Congo,COD,Rwanda,RWA,5,0,0,17,22
2008,Afghanistan,AFG,Syrian Arab Rep.,SYR,22,0,0,0,22
2008,Algeria,DZA,Syrian Arab Rep.,SYR,0,0,5,5,10
2008,Egypt,EGY,Syrian Arab Rep.,SYR,0,0,10,0,10
2008,Eritrea,ERI,Syrian Arab Rep.,SYR,0,0,0,5,5
2008,Ethiopia,ETH,Syrian Arab Rep.,SYR,0,0,5,0,5
2008,Iran (Islamic Rep. of),IRN,Syrian Arab Rep.,SYR,10,0,20,0,30
2008,Jordan,JOR,Syrian Arab Rep.,SYR,0,0,5,0,5
2008,Kuwait,KWT,Syrian Arab Rep.,SYR,0,0,0,12,12
2008,Sri Lanka,LKA,Syrian Arab Rep.,SYR,0,0,5,0,5
2008,Somalia,SOM,Syrian Arab Rep.,SYR,52,0,10,33,95
2008,Sudan,SDN,Syrian Arab Rep.,SYR,5,0,38,10,53
2008,Stateless,XXA,Syrian Arab Rep.,SYR,5,0,0,5,10
2008,Cambodia,KHM,Thailand,THA,0,0,10,0,10
2008,China,CHN,Thailand,THA,5,0,30,0,35
2008,Dem. Rep. of the Congo,COD,Thailand,THA,5,0,0,0,5
2008,Ethiopia,ETH,Thailand,THA,0,0,5,0,5
2008,Iran (Islamic Rep. of),IRN,Thailand,THA,0,0,5,0,5
2008,Iraq,IRQ,Thailand,THA,5,0,0,0,5
2008,Sri Lanka,LKA,Thailand,THA,5,0,39,5,49
2008,Nepal,NPL,Thailand,THA,0,0,12,0,12
2008,Pakistan,PAK,Thailand,THA,0,0,5,0,5
2008,Somalia,SOM,Thailand,THA,0,0,0,12,12
2008,Viet Nam,VNM,Thailand,THA,0,0,11,0,11
2008,Afghanistan,AFG,Turkey,TUR,42,0,5,64,111
2008,Burundi,BDI,Turkey,TUR,0,0,0,5,5
2008,China,CHN,Turkey,TUR,0,0,0,5,5
2008,Dem. Rep. of the Congo,COD,Turkey,TUR,5,0,0,31,36
2008,Eritrea,ERI,Turkey,TUR,5,0,0,10,15
2008,Ethiopia,ETH,Turkey,TUR,0,0,11,20,31
2008,Palestinian,PSE,Turkey,TUR,0,0,0,12,12
2008,Guinea,GIN,Turkey,TUR,0,0,0,5,5
2008,Cote d'Ivoire,CIV,Turkey,TUR,0,0,0,11,11
2008,Iran (Islamic Rep. of),IRN,Turkey,TUR,109,0,95,103,307
2008,Iraq,IRQ,Turkey,TUR,26,0,5,53,84
2008,Sri Lanka,LKA,Turkey,TUR,0,0,0,10,10
2008,Mauritania,MRT,Turkey,TUR,0,0,0,11,11
2008,Morocco,MAR,Turkey,TUR,0,0,5,0,5
2008,Nigeria,NGA,Turkey,TUR,0,0,0,5,5
2008,Pakistan,PAK,Turkey,TUR,0,0,10,0,10
2008,Somalia,SOM,Turkey,TUR,57,0,11,157,225
2008,Sudan,SDN,Turkey,TUR,10,0,10,22,42
2008,Syrian Arab Rep.,SYR,Turkey,TUR,5,0,0,0,5
2008,United States of America,USA,Turkey,TUR,0,0,5,0,5
2008,Uzbekistan,UZB,Turkey,TUR,0,0,5,0,5
2009,Chad,TCD,Algeria,DZA,0,0,19,0,19
2009,Cameroon,CMR,Algeria,DZA,0,0,64,0,64
2009,Congo,COG,Algeria,DZA,0,0,10,0,10
2009,Dem. Rep. of the Congo,COD,Algeria,DZA,0,0,87,0,87
2009,Cote d'Ivoire,CIV,Algeria,DZA,0,0,46,0,46
2009,Liberia,LBR,Algeria,DZA,0,0,95,0,95
2009,Nigeria,NGA,Algeria,DZA,0,0,73,0,73
2009,Eritrea,ERI,Egypt,EGY,23,0,10,17,50
2009,Ethiopia,ETH,Egypt,EGY,10,0,19,26,55
2009,Cote d'Ivoire,CIV,Egypt,EGY,0,0,10,0,10
2009,Somalia,SOM,Egypt,EGY,5,0,0,15,20
2009,Sudan,SDN,Egypt,EGY,20,0,146,30,196
2009,Myanmar,MMR,Cambodia,KHM,0,0,5,0,5
2009,Viet Nam,VNM,Cambodia,KHM,0,0,49,0,49
2009,Bangladesh,BGD,"China, Hong Kong SAR",HKG,0,0,62,24,86
2009,Congo,COG,"China, Hong Kong SAR",HKG,0,0,5,0,5
2009,Dem. Rep. of the Congo,COD,"China, Hong Kong SAR",HKG,0,0,0,5,5
2009,Guinea,GIN,"China, Hong Kong SAR",HKG,0,0,0,5,5
2009,Cote d'Ivoire,CIV,"China, Hong Kong SAR",HKG,0,0,5,0,5
2009,India,IND,"China, Hong Kong SAR",HKG,0,0,37,0,37
2009,Indonesia,IDN,"China, Hong Kong SAR",HKG,0,0,95,0,95
2009,Kenya,KEN,"China, Hong Kong SAR",HKG,0,0,5,0,5
2009,Sri Lanka,LKA,"China, Hong Kong SAR",HKG,0,0,14,5,19
2009,Nepal,NPL,"China, Hong Kong SAR",HKG,0,0,26,5,31
2009,Niger,NER,"China, Hong Kong SAR",HKG,0,0,5,0,5
2009,Nigeria,NGA,"China, Hong Kong SAR",HKG,0,0,10,5,15
2009,Pakistan,PAK,"China, Hong Kong SAR",HKG,5,0,56,26,87
2009,Philippines,PHL,"China, Hong Kong SAR",HKG,0,0,113,17,130
2009,Togo,TGO,"China, Hong Kong SAR",HKG,0,0,5,0,5
2009,Uganda,UGA,"China, Hong Kong SAR",HKG,0,0,5,0,5
2009,Afghanistan,AFG,India,IND,74,0,212,0,286
2009,Eritrea,ERI,India,IND,5,0,0,0,5
2009,Ethiopia,ETH,India,IND,0,0,5,0,5
2009,Iran (Islamic Rep. of),IRN,India,IND,0,0,15,0,15
2009,Iraq,IRQ,India,IND,0,0,0,10,10
2009,Myanmar,MMR,India,IND,24,0,0,0,24
2009,Somalia,SOM,India,IND,40,0,5,0,45
2009,Afghanistan,AFG,Indonesia,IDN,0,0,12,0,12
2009,Algeria,DZA,Indonesia,IDN,0,0,5,0,5
2009,Iran (Islamic Rep. of),IRN,Indonesia,IDN,5,0,0,0,5
2009,Pakistan,PAK,Indonesia,IDN,0,0,5,0,5
2009,Somalia,SOM,Indonesia,IDN,0,0,5,0,5
2009,Viet Nam,VNM,Indonesia,IDN,0,0,10,0,10
2009,Burundi,BDI,Israel,ISR,0,0,0,5,5
2009,Cameroon,CMR,Israel,ISR,0,0,0,5,5
2009,Colombia,COL,Israel,ISR,0,0,0,10,10
2009,Ethiopia,ETH,Israel,ISR,0,0,0,12,12
2009,Georgia,GEO,Israel,ISR,0,0,0,5,5
2009,Ghana,GHA,Israel,ISR,0,0,0,63,63
2009,Guinea,GIN,Israel,ISR,0,0,0,5,5
2009,Cote d'Ivoire,CIV,Israel,ISR,0,0,0,412,412
2009,Kenya,KEN,Israel,ISR,0,0,0,12,12
2009,Liberia,LBR,Israel,ISR,0,0,0,10,10
2009,Mali,MLI,Israel,ISR,0,0,0,5,5
2009,Myanmar,MMR,Israel,ISR,0,0,0,5,5
2009,Nigeria,NGA,Israel,ISR,0,0,0,182,182
2009,Philippines,PHL,Israel,ISR,0,0,0,12,12
2009,Togo,TGO,Israel,ISR,0,0,0,5,5
2009,Turkey,TUR,Israel,ISR,0,0,0,27,27
2009,Egypt,EGY,Jordan,JOR,0,0,28,0,28
2009,Ghana,GHA,Jordan,JOR,0,0,10,0,10
2009,Lebanon,LBN,Jordan,JOR,0,0,5,0,5
2009,Saudi Arabia,SAU,Jordan,JOR,0,0,5,0,5
2009,Sudan,SDN,Jordan,JOR,14,0,24,0,38
2009,Syrian Arab Rep.,SYR,Jordan,JOR,5,0,0,0,5
2009,Burundi,BDI,Kenya,KEN,23,0,20,5,48
2009,Dem. Rep. of the Congo,COD,Kenya,KEN,45,0,55,5,105
2009,Eritrea,ERI,Kenya,KEN,5,0,0,0,5
2009,Ethiopia,ETH,Kenya,KEN,281,0,83,41,405
2009,Rwanda,RWA,Kenya,KEN,25,0,82,0,107
2009,Somalia,SOM,Kenya,KEN,13,0,0,5,18
2009,Sudan,SDN,Kenya,KEN,62,0,70,5,137
2009,Uganda,UGA,Kenya,KEN,0,0,20,5,25
2009,Afghanistan,AFG,Kyrgyzstan,KGZ,73,0,17,60,150
2009,Uzbekistan,UZB,Kyrgyzstan,KGZ,95,0,0,5,100
2009,Chad,TCD,Libya,LBY,0,0,0,5,5
2009,Dem. Rep. of the Congo,COD,Libya,LBY,0,0,0,5,5
2009,Ethiopia,ETH,Libya,LBY,0,0,0,5,5
2009,Iraq,IRQ,Libya,LBY,0,0,0,5,5
2009,Somalia,SOM,Libya,LBY,0,0,0,5,5
2009,Sudan,SDN,Libya,LBY,10,0,10,0,20
2009,Egypt,EGY,Lebanon,LBN,0,0,0,5,5
2009,Iran (Islamic Rep. of),IRN,Lebanon,LBN,0,0,5,0,5
2009,Iraq,IRQ,Lebanon,LBN,0,0,5,58,63
2009,Sudan,SDN,Lebanon,LBN,0,0,53,18,71
2009,Syrian Arab Rep.,SYR,Lebanon,LBN,5,0,13,0,18
2009,Angola,AGO,Morocco,MAR,0,0,5,0,5
2009,Cameroon,CMR,Morocco,MAR,0,0,5,0,5
2009,Dem. Rep. of the Congo,COD,Morocco,MAR,5,0,85,0,90
2009,Eritrea,ERI,Morocco,MAR,0,0,5,0,5
2009,Guinea,GIN,Morocco,MAR,0,0,5,0,5
2009,Cote d'Ivoire,CIV,Morocco,MAR,5,0,11,0,16
2009,Kenya,KEN,Morocco,MAR,0,0,5,0,5
2009,Liberia,LBR,Morocco,MAR,0,0,10,0,10
2009,Nigeria,NGA,Morocco,MAR,0,0,22,0,22
2009,Sudan,SDN,Morocco,MAR,0,0,5,0,5
2009,Somalia,SOM,Nepal,NPL,5,0,0,0,5
2009,Afghanistan,AFG,Syrian Arab Rep.,SYR,13,0,0,0,13
2009,Ethiopia,ETH,Syrian Arab Rep.,SYR,0,0,5,0,5
2009,Iran (Islamic Rep. of),IRN,Syrian Arab Rep.,SYR,5,0,18,0,23
2009,Jordan,JOR,Syrian Arab Rep.,SYR,0,0,5,0,5
2009,Somalia,SOM,Syrian Arab Rep.,SYR,10,0,0,0,10
2009,Sudan,SDN,Syrian Arab Rep.,SYR,0,0,20,0,20
2009,Stateless,XXA,Syrian Arab Rep.,SYR,0,0,0,5,5
2009,Bangladesh,BGD,Thailand,THA,0,0,5,0,5
2009,Cambodia,KHM,Thailand,THA,5,0,5,0,10
2009,China,CHN,Thailand,THA,5,0,15,0,20
2009,Dem. Rep. of the Congo,COD,Thailand,THA,5,0,5,0,10
2009,Cote d'Ivoire,CIV,Thailand,THA,0,0,5,0,5
2009,India,IND,Thailand,THA,0,0,5,0,5
2009,Iran (Islamic Rep. of),IRN,Thailand,THA,0,0,5,0,5
2009,Iraq,IRQ,Thailand,THA,0,0,5,0,5
2009,Sri Lanka,LKA,Thailand,THA,72,0,5,5,82
2009,Somalia,SOM,Thailand,THA,19,0,0,0,19
2009,Viet Nam,VNM,Thailand,THA,0,0,10,12,22
2009,Afghanistan,AFG,Turkey,TUR,21,0,5,170,196
2009,Egypt,EGY,Turkey,TUR,0,0,0,5,5
2009,China,CHN,Turkey,TUR,0,0,0,5,5
2009,Congo,COG,Turkey,TUR,0,0,0,5,5
2009,Dem. Rep. of the Congo,COD,Turkey,TUR,0,0,0,5,5
2009,Eritrea,ERI,Turkey,TUR,5,0,0,0,5
2009,Ethiopia,ETH,Turkey,TUR,0,0,0,5,5
2009,Palestinian,PSE,Turkey,TUR,0,0,0,5,5
2009,Guinea,GIN,Turkey,TUR,0,0,0,5,5
2009,Cote d'Ivoire,CIV,Turkey,TUR,0,0,5,0,5
2009,Iran (Islamic Rep. of),IRN,Turkey,TUR,58,0,60,62,180
2009,Iraq,IRQ,Turkey,TUR,5,0,5,25,35
2009,Sri Lanka,LKA,Turkey,TUR,12,0,0,0,12
2009,Mauritania,MRT,Turkey,TUR,0,0,0,5,5
2009,Nigeria,NGA,Turkey,TUR,0,0,0,5,5
2009,Sierra Leone,SLE,Turkey,TUR,0,0,0,5,5
2009,Somalia,SOM,Turkey,TUR,12,0,17,10,39
2009,Sudan,SDN,Turkey,TUR,5,0,0,12,17
2010,Chad,TCD,Algeria,DZA,0,0,5,0,5
2010,Cameroon,CMR,Algeria,DZA,0,0,35,0,35
2010,Congo,COG,Algeria,DZA,0,0,5,0,5
2010,Dem. Rep. of the Congo,COD,Algeria,DZA,0,0,18,0,18
2010,Cote d'Ivoire,CIV,Algeria,DZA,0,0,15,0,15
2010,Liberia,LBR,Algeria,DZA,0,0,27,0,27
2010,Niger,NER,Algeria,DZA,0,0,5,0,5
2010,Nigeria,NGA,Algeria,DZA,0,0,22,0,22
2010,Sierra Leone,SLE,Algeria,DZA,0,0,5,0,5
2010,Eritrea,ERI,Egypt,EGY,10,0,35,0,45
2010,Ethiopia,ETH,Egypt,EGY,10,0,42,0,52
2010,Rwanda,RWA,Egypt,EGY,0,0,5,0,5
2010,Somalia,SOM,Egypt,EGY,0,0,0,5,5
2010,Sudan,SDN,Egypt,EGY,5,0,66,0,71
2010,Viet Nam,VNM,Cambodia,KHM,0,0,5,0,5
2010,Bangladesh,BGD,"China, Hong Kong SAR",HKG,0,0,13,5,18
2010,Cameroon,CMR,"China, Hong Kong SAR",HKG,0,0,5,0,5
2010,Dem. Rep. of the Congo,COD,"China, Hong Kong SAR",HKG,0,0,5,0,5
2010,Eritrea,ERI,"China, Hong Kong SAR",HKG,0,0,5,0,5
2010,India,IND,"China, Hong Kong SAR",HKG,0,0,23,0,23
2010,Indonesia,IDN,"China, Hong Kong SAR",HKG,0,0,39,0,39
2010,Liberia,LBR,"China, Hong Kong SAR",HKG,0,0,5,0,5
2010,Sri Lanka,LKA,"China, Hong Kong SAR",HKG,0,0,28,0,28
2010,Nepal,NPL,"China, Hong Kong SAR",HKG,0,0,24,0,24
2010,Nigeria,NGA,"China, Hong Kong SAR",HKG,0,0,5,0,5
2010,Pakistan,PAK,"China, Hong Kong SAR",HKG,5,0,28,0,33
2010,Philippines,PHL,"China, Hong Kong SAR",HKG,0,0,20,0,20
2010,Togo,TGO,"China, Hong Kong SAR",HKG,0,0,5,0,5
2010,Afghanistan,AFG,India,IND,90,0,439,582,1111
2010,Egypt,EGY,India,IND,0,0,5,0,5
2010,Dem. Rep. of the Congo,COD,India,IND,0,0,13,0,13
2010,Eritrea,ERI,India,IND,0,0,0,5,5
2010,Ethiopia,ETH,India,IND,0,0,0,5,5
2010,Palestinian,PSE,India,IND,0,0,0,5,5
2010,Iran (Islamic Rep. of),IRN,India,IND,13,0,0,0,13
2010,Iraq,IRQ,India,IND,0,0,0,5,5
2010,Myanmar,MMR,India,IND,14,0,0,46,60
2010,Somalia,SOM,India,IND,0,0,0,5,5
2010,Sudan,SDN,India,IND,0,0,0,5,5
2010,Afghanistan,AFG,Jordan,JOR,0,0,5,5,10
2010,Algeria,DZA,Jordan,JOR,0,0,5,0,5
2010,Egypt,EGY,Jordan,JOR,0,0,50,0,50
2010,Iraq,IRQ,Jordan,JOR,0,11,38,12,61
2010,Lebanon,LBN,Jordan,JOR,0,0,5,0,5
2010,Sri Lanka,LKA,Jordan,JOR,0,0,5,0,5
2010,Pakistan,PAK,Jordan,JOR,0,0,10,0,10
2010,Somalia,SOM,Jordan,JOR,5,0,0,0,5
2010,Sudan,SDN,Jordan,JOR,10,5,35,0,50
2010,Syrian Arab Rep.,SYR,Jordan,JOR,5,0,20,0,25
2010,Tunisia,TUN,Jordan,JOR,0,0,5,5,10
2010,Turkey,TUR,Jordan,JOR,0,0,10,0,10
2010,Yemen,YEM,Jordan,JOR,0,0,0,10,10
2010,Burundi,BDI,Kenya,KEN,0,0,5,0,5
2010,Dem. Rep. of the Congo,COD,Kenya,KEN,18,0,10,0,28
2010,Eritrea,ERI,Kenya,KEN,0,0,5,0,5
2010,Ethiopia,ETH,Kenya,KEN,135,0,85,12,232
2010,Pakistan,PAK,Kenya,KEN,5,0,5,0,10
2010,Rwanda,RWA,Kenya,KEN,24,0,10,0,34
2010,Somalia,SOM,Kenya,KEN,33,0,0,0,33
2010,Sudan,SDN,Kenya,KEN,26,0,64,0,90
2010,United Rep. of Tanzania,TZA,Kenya,KEN,0,0,0,5,5
2010,Uganda,UGA,Kenya,KEN,13,0,0,0,13
2010,Ethiopia,ETH,Lebanon,LBN,0,0,5,0,5
2010,Iraq,IRQ,Lebanon,LBN,0,0,14,0,14
2010,Saudi Arabia,SAU,Lebanon,LBN,0,0,0,5,5
2010,Somalia,SOM,Lebanon,LBN,0,0,0,5,5
2010,Sudan,SDN,Lebanon,LBN,10,0,102,26,138
2010,Syrian Arab Rep.,SYR,Lebanon,LBN,0,0,40,5,45
2010,Afghanistan,AFG,Malaysia,MYS,59,0,0,0,59
2010,Cambodia,KHM,Malaysia,MYS,0,0,15,0,15
2010,China,CHN,Malaysia,MYS,5,0,5,0,10
2010,Cameroon,CMR,Malaysia,MYS,0,0,5,0,5
2010,Iran (Islamic Rep. of),IRN,Malaysia,MYS,5,0,0,0,5
2010,Liberia,LBR,Malaysia,MYS,5,0,0,0,5
2010,Sri Lanka,LKA,Malaysia,MYS,0,0,75,0,75
2010,Myanmar,MMR,Malaysia,MYS,68,0,28,5,101
2010,Nepal,NPL,Malaysia,MYS,0,0,5,0,5
2010,Pakistan,PAK,Malaysia,MYS,0,0,10,0,10
2010,Sierra Leone,SLE,Malaysia,MYS,5,0,0,0,5
2010,Somalia,SOM,Malaysia,MYS,5,0,0,0,5
2010,Viet Nam,VNM,Malaysia,MYS,0,0,10,0,10
2010,Algeria,DZA,Morocco,MAR,0,0,5,0,5
2010,Benin,BEN,Morocco,MAR,0,0,5,0,5
2010,Bangladesh,BGD,Morocco,MAR,0,0,5,0,5
2010,Cameroon,CMR,Morocco,MAR,0,0,18,0,18
2010,Congo,COG,Morocco,MAR,0,0,10,0,10
2010,Dem. Rep. of the Congo,COD,Morocco,MAR,10,0,149,0,159
2010,Eritrea,ERI,Morocco,MAR,0,0,5,0,5
2010,Palestinian,PSE,Morocco,MAR,0,0,10,0,10
2010,Ghana,GHA,Morocco,MAR,0,0,5,0,5
2010,Iraq,IRQ,Morocco,MAR,0,0,33,0,33
2010,Liberia,LBR,Morocco,MAR,0,0,5,0,5
2010,Mali,MLI,Morocco,MAR,0,0,19,0,19
2010,Nigeria,NGA,Morocco,MAR,0,0,44,0,44
2010,Senegal,SEN,Morocco,MAR,0,0,5,0,5
2010,Somalia,SOM,Morocco,MAR,0,0,14,0,14
2010,Sudan,SDN,Morocco,MAR,0,0,5,0,5
2010,Tunisia,TUN,Morocco,MAR,0,0,12,0,12
2010,Uganda,UGA,Morocco,MAR,0,0,13,0,13
2010,Zimbabwe,ZWE,Morocco,MAR,0,0,5,0,5
2010,Myanmar,MMR,Nepal,NPL,5,0,5,0,10
2010,Pakistan,PAK,Nepal,NPL,5,0,0,0,5
2010,Afghanistan,AFG,Syrian Arab Rep.,SYR,0,0,0,15,15
2010,Egypt,EGY,Syrian Arab Rep.,SYR,0,0,5,0,5
2010,Iran (Islamic Rep. of),IRN,Syrian Arab Rep.,SYR,0,0,0,12,12
2010,Iraq,IRQ,Syrian Arab Rep.,SYR,5,0,10,0,15
2010,Mauritania,MRT,Syrian Arab Rep.,SYR,0,0,0,5,5
2010,Pakistan,PAK,Syrian Arab Rep.,SYR,5,0,0,0,5
2010,Sierra Leone,SLE,Syrian Arab Rep.,SYR,0,0,5,0,5
2010,Somalia,SOM,Syrian Arab Rep.,SYR,5,0,0,27,32
2010,Sudan,SDN,Syrian Arab Rep.,SYR,5,0,41,23,69
2010,Tunisia,TUN,Syrian Arab Rep.,SYR,0,0,5,0,5
2010,China,CHN,Thailand,THA,0,0,5,0,5
2010,Dem. Rep. of the Congo,COD,Thailand,THA,0,0,0,5,5
2010,Iran (Islamic Rep. of),IRN,Thailand,THA,5,0,0,0,5
2010,Sri Lanka,LKA,Thailand,THA,5,0,10,32,47
2010,Pakistan,PAK,Thailand,THA,0,0,0,14,14
2010,Somalia,SOM,Thailand,THA,44,0,0,23,67
2010,Viet Nam,VNM,Thailand,THA,0,0,18,25,43
2010,Afghanistan,AFG,Turkey,TUR,116,0,65,289,470
2010,Egypt,EGY,Turkey,TUR,0,0,5,0,5
2010,China,CHN,Turkey,TUR,0,0,0,5,5
2010,Dem. Rep. of the Congo,COD,Turkey,TUR,0,0,0,5,5
2010,Eritrea,ERI,Turkey,TUR,0,0,5,5,10
2010,Ethiopia,ETH,Turkey,TUR,5,0,0,5,10
2010,Palestinian,PSE,Turkey,TUR,0,0,0,5,5
2010,Guinea,GIN,Turkey,TUR,0,0,0,14,14
2010,Cote d'Ivoire,CIV,Turkey,TUR,0,0,0,5,5
2010,Iran (Islamic Rep. of),IRN,Turkey,TUR,87,0,159,372,618
2010,Iraq,IRQ,Turkey,TUR,5,0,11,107,123
2010,Sri Lanka,LKA,Turkey,TUR,0,0,0,5,5
2010,Myanmar,MMR,Turkey,TUR,0,0,0,5,5
2010,Nigeria,NGA,Turkey,TUR,0,0,0,5,5
2010,Pakistan,PAK,Turkey,TUR,0,0,0,5,5
2010,Somalia,SOM,Turkey,TUR,15,0,0,17,32
2010,Sudan,SDN,Turkey,TUR,22,0,10,0,32
2010,Syrian Arab Rep.,SYR,Turkey,TUR,0,0,0,11,11
2011,Benin,BEN,Algeria,DZA,0,0,5,0,5
2011,Cameroon,CMR,Algeria,DZA,0,0,21,5,26
2011,Dem. Rep. of the Congo,COD,Algeria,DZA,0,0,5,0,5
2011,Guinea,GIN,Algeria,DZA,0,0,5,0,5
2011,Liberia,LBR,Algeria,DZA,0,0,5,0,5
2011,Nigeria,NGA,Algeria,DZA,0,0,5,0,5
2011,Eritrea,ERI,Egypt,EGY,14,0,10,0,24
2011,Ethiopia,ETH,Egypt,EGY,0,0,14,0,14
2011,Iraq,IRQ,Egypt,EGY,0,0,0,5,5
2011,Somalia,SOM,Egypt,EGY,0,0,14,0,14
2011,Sudan,SDN,Egypt,EGY,18,0,5,0,23
2011,Afghanistan,AFG,"China, Hong Kong SAR",HKG,0,0,5,5,10
2011,Bangladesh,BGD,"China, Hong Kong SAR",HKG,0,0,5,0,5
2011,Guinea,GIN,"China, Hong Kong SAR",HKG,0,0,5,0,5
2011,India,IND,"China, Hong Kong SAR",HKG,0,0,21,0,21
2011,Indonesia,IDN,"China, Hong Kong SAR",HKG,0,0,34,0,34
2011,Sri Lanka,LKA,"China, Hong Kong SAR",HKG,0,0,29,27,56
2011,Nepal,NPL,"China, Hong Kong SAR",HKG,0,0,14,0,14
2011,Nigeria,NGA,"China, Hong Kong SAR",HKG,0,0,5,5,10
2011,Pakistan,PAK,"China, Hong Kong SAR",HKG,0,0,29,10,39
2011,Philippines,PHL,"China, Hong Kong SAR",HKG,0,0,22,0,22
2011,Togo,TGO,"China, Hong Kong SAR",HKG,0,0,5,5,10
2011,Afghanistan,AFG,India,IND,131,0,566,0,697
2011,Dem. Rep. of the Congo,COD,India,IND,0,0,10,0,10
2011,Eritrea,ERI,India,IND,5,0,0,0,5
2011,Palestinian,PSE,India,IND,0,0,0,5,5
2011,Iran (Islamic Rep. of),IRN,India,IND,5,0,0,11,16
2011,Iraq,IRQ,India,IND,0,0,5,0,5
2011,Myanmar,MMR,India,IND,10,0,11,0,21
2011,Sudan,SDN,India,IND,0,0,0,5,5
2011,Egypt,EGY,Kenya,KEN,0,0,0,5,5
2011,Burundi,BDI,Kenya,KEN,111,0,97,0,208
2011,Congo,COG,Kenya,KEN,0,0,0,16,16
2011,Dem. Rep. of the Congo,COD,Kenya,KEN,518,0,395,34,947
2011,Eritrea,ERI,Kenya,KEN,141,0,33,0,174
2011,Ethiopia,ETH,Kenya,KEN,910,0,846,85,1841
2011,Mozambique,MOZ,Kenya,KEN,0,0,0,5,5
2011,Rwanda,RWA,Kenya,KEN,41,0,225,5,271
2011,Somalia,SOM,Kenya,KEN,163,0,35,0,198
2011,Sudan,SDN,Kenya,KEN,74,0,129,18,221
2011,United Rep. of Tanzania,TZA,Kenya,KEN,0,0,0,5,5
2011,Uganda,UGA,Kenya,KEN,20,0,38,0,58
2011,Egypt,EGY,Lebanon,LBN,0,0,5,0,5
2011,Iraq,IRQ,Lebanon,LBN,5,0,16,0,21
2011,Sudan,SDN,Lebanon,LBN,0,0,64,18,82
2011,Syrian Arab Rep.,SYR,Lebanon,LBN,0,0,10,0,10
2011,China,CHN,Malaysia,MYS,13,0,13,0,26
2011,India,IND,Malaysia,MYS,0,0,5,0,5
2011,Iran (Islamic Rep. of),IRN,Malaysia,MYS,0,0,13,0,13
2011,Sri Lanka,LKA,Malaysia,MYS,0,0,143,0,143
2011,Myanmar,MMR,Malaysia,MYS,334,0,117,0,451
2011,Somalia,SOM,Malaysia,MYS,5,0,5,0,10
2011,Angola,AGO,Morocco,MAR,0,0,0,5,5
2011,Cameroon,CMR,Morocco,MAR,0,0,10,0,10
2011,Dem. Rep. of the Congo,COD,Morocco,MAR,5,0,53,10,68
2011,Gambia,GMB,Morocco,MAR,0,0,5,0,5
2011,Ghana,GHA,Morocco,MAR,0,0,5,0,5
2011,Guinea,GIN,Morocco,MAR,0,0,5,0,5
2011,Cote d'Ivoire,CIV,Morocco,MAR,0,0,5,0,5
2011,Liberia,LBR,Morocco,MAR,0,0,5,0,5
2011,Nigeria,NGA,Morocco,MAR,0,0,34,5,39
2011,Sierra Leone,SLE,Morocco,MAR,0,0,5,0,5
2011,Somalia,SOM,Morocco,MAR,0,0,5,0,5
2011,Togo,TGO,Morocco,MAR,0,0,5,0,5
2011,Uganda,UGA,Morocco,MAR,0,0,5,0,5
2011,Afghanistan,AFG,Syrian Arab Rep.,SYR,0,0,0,14,14
2011,Algeria,DZA,Syrian Arab Rep.,SYR,0,0,10,0,10
2011,Ethiopia,ETH,Syrian Arab Rep.,SYR,0,0,5,5,10
2011,Palestinian,PSE,Syrian Arab Rep.,SYR,0,0,5,0,5
2011,Iran (Islamic Rep. of),IRN,Syrian Arab Rep.,SYR,0,0,14,0,14
2011,Iraq,IRQ,Syrian Arab Rep.,SYR,13,0,61,0,74
2011,Pakistan,PAK,Syrian Arab Rep.,SYR,0,0,0,14,14
2011,Sudan,SDN,Syrian Arab Rep.,SYR,10,0,31,10,51
2011,Stateless,XXA,Syrian Arab Rep.,SYR,0,0,5,0,5
2011,China,CHN,Thailand,THA,5,0,0,0,5
2011,Dem. Rep. of the Congo,COD,Thailand,THA,0,0,5,10,15
2011,Guinea,GIN,Thailand,THA,0,0,0,5,5
2011,Sri Lanka,LKA,Thailand,THA,0,0,11,25,36
2011,Pakistan,PAK,Thailand,THA,5,0,0,12,17
2011,Viet Nam,VNM,Thailand,THA,0,0,10,12,22
2011,Afghanistan,AFG,Turkey,TUR,447,0,123,532,1102
2011,Egypt,EGY,Turkey,TUR,0,0,0,5,5
2011,Chad,TCD,Turkey,TUR,0,0,0,5,5
2011,Dem. Rep. of the Congo,COD,Turkey,TUR,12,0,0,5,17
2011,Eritrea,ERI,Turkey,TUR,5,0,0,5,10
2011,Ethiopia,ETH,Turkey,TUR,5,0,5,14,24
2011,Palestinian,PSE,Turkey,TUR,0,0,0,10,10
2011,Guinea,GIN,Turkey,TUR,0,0,0,12,12
2011,Iran (Islamic Rep. of),IRN,Turkey,TUR,595,0,174,770,1539
2011,Iraq,IRQ,Turkey,TUR,40,0,30,86,156
2011,Jordan,JOR,Turkey,TUR,0,0,5,0,5
2011,Sri Lanka,LKA,Turkey,TUR,0,0,0,5,5
2011,Morocco,MAR,Turkey,TUR,0,0,5,0,5
2011,Nigeria,NGA,Turkey,TUR,0,0,5,5,10
2011,Sierra Leone,SLE,Turkey,TUR,0,0,0,10,10
2011,Somalia,SOM,Turkey,TUR,21,0,0,24,45
2011,Sudan,SDN,Turkey,TUR,5,0,5,13,23
2011,Syrian Arab Rep.,SYR,Turkey,TUR,0,0,0,13,13
2011,Uzbekistan,UZB,Turkey,TUR,0,0,0,5,5
2012,Chad,TCD,Algeria,DZA,0,0,5,0,5
2012,Cameroon,CMR,Algeria,DZA,0,0,34,0,34
2012,Dem. Rep. of the Congo,COD,Algeria,DZA,0,0,5,0,5
2012,Niger,NER,Algeria,DZA,0,0,0,5,5
2012,Nigeria,NGA,Algeria,DZA,0,0,5,0,5
2012,Egypt,EGY,"China, Hong Kong SAR",HKG,0,0,0,5,5
2012,Benin,BEN,"China, Hong Kong SAR",HKG,0,0,0,5,5
2012,Bangladesh,BGD,"China, Hong Kong SAR",HKG,0,0,10,0,10
2012,India,IND,"China, Hong Kong SAR",HKG,0,0,20,0,20
2012,Indonesia,IDN,"China, Hong Kong SAR",HKG,0,0,111,5,116
2012,Sri Lanka,LKA,"China, Hong Kong SAR",HKG,0,0,20,5,25
2012,Pakistan,PAK,"China, Hong Kong SAR",HKG,0,0,15,0,15
2012,Philippines,PHL,"China, Hong Kong SAR",HKG,0,0,24,0,24
2012,Togo,TGO,"China, Hong Kong SAR",HKG,0,0,5,0,5
2012,Afghanistan,AFG,India,IND,99,0,379,0,478
2012,Dem. Rep. of the Congo,COD,India,IND,0,0,11,0,11
2012,Eritrea,ERI,India,IND,0,0,5,0,5
2012,Iran (Islamic Rep. of),IRN,India,IND,0,0,13,0,13
2012,Myanmar,MMR,India,IND,5,0,5,11,21
2012,Sudan,SDN,India,IND,0,0,5,0,5
2012,Burundi,BDI,Kenya,KEN,0,0,13,0,13
2012,Dem. Rep. of the Congo,COD,Kenya,KEN,25,0,36,0,61
2012,Eritrea,ERI,Kenya,KEN,5,0,0,0,5
2012,Ethiopia,ETH,Kenya,KEN,35,0,139,0,174
2012,Rwanda,RWA,Kenya,KEN,0,0,20,0,20
2012,Somalia,SOM,Kenya,KEN,5,0,5,0,10
2012,Sudan,SDN,Kenya,KEN,5,0,0,0,5
2012,South Sudan,SSD,Kenya,KEN,10,0,0,21,31
2012,United Rep. of Tanzania,TZA,Kenya,KEN,0,0,10,0,10
2012,Uganda,UGA,Kenya,KEN,0,0,14,5,19
2012,Egypt,EGY,Lebanon,LBN,0,0,5,0,5
2012,Ethiopia,ETH,Lebanon,LBN,0,0,5,5,10
2012,Iraq,IRQ,Lebanon,LBN,14,0,47,5,66
2012,Somalia,SOM,Lebanon,LBN,5,0,0,0,5
2012,Sudan,SDN,Lebanon,LBN,13,0,139,10,162
2012,Syrian Arab Rep.,SYR,Lebanon,LBN,5,0,0,0,5
2012,Afghanistan,AFG,Malaysia,MYS,0,0,0,5,5
2012,China,CHN,Malaysia,MYS,5,0,5,0,10
2012,Iran (Islamic Rep. of),IRN,Malaysia,MYS,0,0,11,0,11
2012,Liberia,LBR,Malaysia,MYS,0,0,5,0,5
2012,Sri Lanka,LKA,Malaysia,MYS,5,0,168,0,173
2012,Myanmar,MMR,Malaysia,MYS,250,0,222,0,472
2012,Pakistan,PAK,Malaysia,MYS,13,0,0,0,13
2012,Yemen,YEM,Malaysia,MYS,0,0,5,0,5
2012,Benin,BEN,Morocco,MAR,0,0,5,5,10
2012,Central African Rep.,CAF,Morocco,MAR,0,0,5,0,5
2012,Chad,TCD,Morocco,MAR,0,0,5,0,5
2012,Cameroon,CMR,Morocco,MAR,0,0,13,0,13
2012,Dem. Rep. of the Congo,COD,Morocco,MAR,0,0,59,19,78
2012,Eritrea,ERI,Morocco,MAR,0,0,5,0,5
2012,Ghana,GHA,Morocco,MAR,0,0,10,0,10
2012,Guinea,GIN,Morocco,MAR,0,0,14,5,19
2012,Cote d'Ivoire,CIV,Morocco,MAR,0,0,11,0,11
2012,Liberia,LBR,Morocco,MAR,0,0,11,0,11
2012,Nigeria,NGA,Morocco,MAR,0,0,67,5,72
2012,Sierra Leone,SLE,Morocco,MAR,0,0,0,5,5
2012,Togo,TGO,Morocco,MAR,0,0,5,0,5
2012,Uganda,UGA,Morocco,MAR,0,0,0,5,5
2012,Afghanistan,AFG,Syrian Arab Rep.,SYR,21,0,15,0,36
2012,Iran (Islamic Rep. of),IRN,Syrian Arab Rep.,SYR,0,0,5,0,5
2012,Iraq,IRQ,Syrian Arab Rep.,SYR,10,0,58,0,68
2012,Pakistan,PAK,Syrian Arab Rep.,SYR,0,0,10,0,10
2012,Sudan,SDN,Syrian Arab Rep.,SYR,5,0,28,0,33
2012,Bangladesh,BGD,Thailand,THA,0,0,10,0,10
2012,Cambodia,KHM,Thailand,THA,0,0,13,0,13
2012,China,CHN,Thailand,THA,10,0,15,0,25
2012,Cameroon,CMR,Thailand,THA,0,0,5,0,5
2012,Dem. Rep. of the Congo,COD,Thailand,THA,10,0,30,0,40
2012,Guinea,GIN,Thailand,THA,0,0,12,0,12
2012,Cote d'Ivoire,CIV,Thailand,THA,0,0,5,0,5
2012,Iran (Islamic Rep. of),IRN,Thailand,THA,0,0,12,0,12
2012,Iraq,IRQ,Thailand,THA,0,0,5,0,5
2012,Kuwait,KWT,Thailand,THA,0,0,0,5,5
2012,Lao People's Dem. Rep.,LAO,Thailand,THA,0,0,5,0,5
2012,Liberia,LBR,Thailand,THA,0,0,5,0,5
2012,Sri Lanka,LKA,Thailand,THA,27,0,98,12,137
2012,Nepal,NPL,Thailand,THA,0,0,5,0,5
2012,Pakistan,PAK,Thailand,THA,23,0,5,0,28
2012,Sierra Leone,SLE,Thailand,THA,0,0,5,0,5
2012,Somalia,SOM,Thailand,THA,0,0,5,0,5
2012,Viet Nam,VNM,Thailand,THA,0,0,181,0,181
2012,Stateless,XXA,Thailand,THA,5,0,0,0,5
2012,Chad,TCD,Tunisia,TUN,5,0,50,13,68
2012,Ethiopia,ETH,Tunisia,TUN,22,0,10,0,32
2012,Gambia,GMB,Tunisia,TUN,0,0,5,0,5
2012,Cote d'Ivoire,CIV,Tunisia,TUN,0,0,12,5,17
2012,Jordan,JOR,Tunisia,TUN,0,0,5,0,5
2012,Morocco,MAR,Tunisia,TUN,0,0,0,5,5
2012,Nigeria,NGA,Tunisia,TUN,0,0,5,0,5
2012,Pakistan,PAK,Tunisia,TUN,0,0,5,0,5
2012,Somalia,SOM,Tunisia,TUN,0,0,11,0,11
2012,Sudan,SDN,Tunisia,TUN,5,0,56,5,66
2012,Afghanistan,AFG,Turkey,TUR,29,0,34,247,310
2012,Bangladesh,BGD,Turkey,TUR,0,0,0,5,5
2012,China,CHN,Turkey,TUR,0,0,0,5,5
2012,Dem. Rep. of the Congo,COD,Turkey,TUR,0,0,0,10,10
2012,Eritrea,ERI,Turkey,TUR,0,0,0,11,11
2012,Ethiopia,ETH,Turkey,TUR,0,0,0,5,5
2012,Palestinian,PSE,Turkey,TUR,0,0,0,19,19
2012,Guinea,GIN,Turkey,TUR,0,0,0,5,5
2012,Iran (Islamic Rep. of),IRN,Turkey,TUR,74,0,23,188,285
2012,Iraq,IRQ,Turkey,TUR,16,0,21,53,90
2012,Kazakhstan,KAZ,Turkey,TUR,0,0,5,0,5
2012,Liberia,LBR,Turkey,TUR,0,0,0,5,5
2012,Morocco,MAR,Turkey,TUR,0,0,0,11,11
2012,Myanmar,MMR,Turkey,TUR,0,0,0,5,5
2012,Nigeria,NGA,Turkey,TUR,0,0,0,5,5
2012,Pakistan,PAK,Turkey,TUR,0,0,5,12,17
2012,Somalia,SOM,Turkey,TUR,32,0,0,5,37
2012,Sudan,SDN,Turkey,TUR,16,0,10,15,41
2012,Syrian Arab Rep.,SYR,Turkey,TUR,0,0,0,15,15
2012,Tunisia,TUN,Turkey,TUR,0,0,0,5,5
2012,Uzbekistan,UZB,Turkey,TUR,0,0,20,47,67
2013,Benin,BEN,Algeria,DZA,0,0,23,0,23
2013,Cameroon,CMR,Algeria,DZA,0,0,254,5,259
2013,Congo,COG,Algeria,DZA,0,0,10,0,10
2013,Dem. Rep. of the Congo,COD,Algeria,DZA,0,0,26,0,26
2013,Guinea,GIN,Algeria,DZA,0,0,43,0,43
2013,Cote d'Ivoire,CIV,Algeria,DZA,0,0,109,5,114
2013,Liberia,LBR,Algeria,DZA,0,0,12,0,12
2013,Mali,MLI,Algeria,DZA,0,0,5,0,5
2013,Niger,NER,Algeria,DZA,0,0,19,0,19
2013,Nigeria,NGA,Algeria,DZA,0,0,43,0,43
2013,Sierra Leone,SLE,Algeria,DZA,0,0,5,0,5
2013,Central African Rep.,CAF,Cameroon,CMR,5,0,26,30,61
2013,Chad,TCD,Cameroon,CMR,0,0,14,5,19
2013,Dem. Rep. of the Congo,COD,Cameroon,CMR,0,0,14,0,14
2013,Guinea-Bissau,GNB,Cameroon,CMR,0,0,5,0,5
2013,Guinea,GIN,Cameroon,CMR,0,0,33,31,64
2013,Cote d'Ivoire,CIV,Cameroon,CMR,0,0,10,0,10
2013,Mali,MLI,Cameroon,CMR,0,0,5,5,10
2013,Rwanda,RWA,Cameroon,CMR,0,0,11,5,16
2013,Senegal,SEN,Cameroon,CMR,0,0,24,15,39
2013,India,IND,"China, Hong Kong SAR",HKG,0,0,5,0,5
2013,Indonesia,IDN,"China, Hong Kong SAR",HKG,0,0,48,17,65
2013,Sri Lanka,LKA,"China, Hong Kong SAR",HKG,0,0,26,5,31
2013,Nepal,NPL,"China, Hong Kong SAR",HKG,0,0,5,0,5
2013,Pakistan,PAK,"China, Hong Kong SAR",HKG,0,0,5,13,18
2013,Philippines,PHL,"China, Hong Kong SAR",HKG,0,0,12,10,22
2013,Afghanistan,AFG,India,IND,45,0,111,113,269
2013,Cameroon,CMR,India,IND,0,0,5,0,5
2013,Dem. Rep. of the Congo,COD,India,IND,0,0,21,0,21
2013,Iraq,IRQ,India,IND,0,0,5,0,5
2013,Myanmar,MMR,India,IND,12,0,0,0,12
2013,Sudan,SDN,India,IND,0,0,5,0,5
2013,Afghanistan,AFG,Indonesia,IDN,14,0,35,41,90
2013,Iran (Islamic Rep. of),IRN,Indonesia,IDN,13,0,44,28,85
2013,Iraq,IRQ,Indonesia,IDN,0,0,12,0,12
2013,Sri Lanka,LKA,Indonesia,IDN,17,0,5,23,45
2013,Pakistan,PAK,Indonesia,IDN,0,0,0,5,5
2013,Somalia,SOM,Indonesia,IDN,0,0,0,5,5
2013,Sudan,SDN,Indonesia,IDN,0,0,0,5,5
2013,Yemen,YEM,Indonesia,IDN,0,0,0,5,5
2013,Burundi,BDI,Kenya,KEN,13,0,56,0,69
2013,Dem. Rep. of the Congo,COD,Kenya,KEN,162,0,44,0,206
2013,Eritrea,ERI,Kenya,KEN,5,0,14,0,19
2013,Ethiopia,ETH,Kenya,KEN,509,0,183,25,717
2013,Rwanda,RWA,Kenya,KEN,0,0,35,0,35
2013,Somalia,SOM,Kenya,KEN,13,0,0,0,13
2013,Sudan,SDN,Kenya,KEN,0,0,5,0,5
2013,South Sudan,SSD,Kenya,KEN,0,0,5,0,5
2013,Uganda,UGA,Kenya,KEN,0,0,13,5,18
2013,Egypt,EGY,Lebanon,LBN,0,0,26,0,26
2013,Ethiopia,ETH,Lebanon,LBN,0,0,5,0,5
2013,India,IND,Lebanon,LBN,0,0,5,0,5
2013,Iran (Islamic Rep. of),IRN,Lebanon,LBN,0,0,5,0,5
2013,Iraq,IRQ,Lebanon,LBN,15,0,39,5,59
2013,Madagascar,MDG,Lebanon,LBN,0,0,5,0,5
2013,Somalia,SOM,Lebanon,LBN,0,0,0,5,5
2013,Sudan,SDN,Lebanon,LBN,5,0,70,44,119
2013,Syrian Arab Rep.,SYR,Lebanon,LBN,45,0,0,0,45
2013,Indonesia,IDN,Malaysia,MYS,0,0,5,0,5
2013,Iran (Islamic Rep. of),IRN,Malaysia,MYS,0,0,20,0,20
2013,Sri Lanka,LKA,Malaysia,MYS,10,0,205,0,215
2013,Myanmar,MMR,Malaysia,MYS,124,0,285,5,414
2013,Pakistan,PAK,Malaysia,MYS,0,0,5,0,5
2013,Somalia,SOM,Malaysia,MYS,5,0,5,0,10
2013,Benin,BEN,Morocco,MAR,0,0,5,0,5
2013,Cameroon,CMR,Morocco,MAR,0,0,10,0,10
2013,Dem. Rep. of the Congo,COD,Morocco,MAR,0,0,19,0,19
2013,Cote d'Ivoire,CIV,Morocco,MAR,0,0,5,0,5
2013,Iraq,IRQ,Morocco,MAR,0,0,0,5,5
2013,Nigeria,NGA,Morocco,MAR,0,0,14,0,14
2013,Pakistan,PAK,Nepal,NPL,0,0,0,5,5
2013,Afghanistan,AFG,Syrian Arab Rep.,SYR,0,0,0,5,5
2013,Egypt,EGY,Syrian Arab Rep.,SYR,0,0,5,0,5
2013,Bangladesh,BGD,Syrian Arab Rep.,SYR,0,0,5,0,5
2013,Iran (Islamic Rep. of),IRN,Syrian Arab Rep.,SYR,0,0,0,5,5
2013,Iraq,IRQ,Syrian Arab Rep.,SYR,0,0,11,0,11
2013,Jordan,JOR,Syrian Arab Rep.,SYR,0,0,11,0,11
2013,Lebanon,LBN,Syrian Arab Rep.,SYR,0,0,11,0,11
2013,Pakistan,PAK,Syrian Arab Rep.,SYR,0,0,5,0,5
2013,Philippines,PHL,Syrian Arab Rep.,SYR,0,0,5,0,5
2013,Sudan,SDN,Syrian Arab Rep.,SYR,13,0,5,0,18
2013,South Sudan,SSD,Syrian Arab Rep.,SYR,5,0,0,0,5
2013,Yemen,YEM,Syrian Arab Rep.,SYR,0,0,0,5,5
2013,Cambodia,KHM,Thailand,THA,13,0,0,0,13
2013,China,CHN,Thailand,THA,5,0,5,0,10
2013,Dem. Rep. of the Congo,COD,Thailand,THA,10,0,11,0,21
2013,Iran (Islamic Rep. of),IRN,Thailand,THA,13,0,0,0,13
2013,Sri Lanka,LKA,Thailand,THA,15,0,0,0,15
2013,Pakistan,PAK,Thailand,THA,5,0,5,0,10
2013,Viet Nam,VNM,Thailand,THA,17,0,23,20,60
2013,Cote d'Ivoire,CIV,Tunisia,TUN,0,0,17,0,17
2013,Sudan,SDN,Tunisia,TUN,0,0,12,0,12
2013,Afghanistan,AFG,Turkey,TUR,24,0,29,68,121
2013,Dem. Rep. of the Congo,COD,Turkey,TUR,0,0,0,5,5
2013,Eritrea,ERI,Turkey,TUR,5,0,0,0,5
2013,Ethiopia,ETH,Turkey,TUR,5,0,0,0,5
2013,Palestinian,PSE,Turkey,TUR,0,0,0,11,11
2013,Iran (Islamic Rep. of),IRN,Turkey,TUR,52,0,98,138,288
2013,Iraq,IRQ,Turkey,TUR,0,0,5,40,45
2013,Kazakhstan,KAZ,Turkey,TUR,0,0,0,10,10
2013,Kyrgyzstan,KGZ,Turkey,TUR,0,0,0,22,22
2013,Libya,LBY,Turkey,TUR,0,0,0,5,5
2013,Morocco,MAR,Turkey,TUR,0,0,0,5,5
2013,Nigeria,NGA,Turkey,TUR,0,0,0,5,5
2013,Pakistan,PAK,Turkey,TUR,0,0,5,5,10
2013,Senegal,SEN,Turkey,TUR,0,0,0,5,5
2013,Sierra Leone,SLE,Turkey,TUR,0,0,0,5,5
2013,Somalia,SOM,Turkey,TUR,10,0,0,12,22
2013,Syrian Arab Rep.,SYR,Turkey,TUR,0,0,0,5,5
2013,Tajikistan,TJK,Turkey,TUR,0,0,0,13,13
2013,Turkmenistan,TKM,Turkey,TUR,0,0,0,19,19
2013,Uganda,UGA,Turkey,TUR,0,0,0,5,5
2013,Uzbekistan,UZB,Turkey,TUR,0,0,0,32,32
2013,Yemen,YEM,Turkey,TUR,0,0,0,10,10
2013,Eritrea,ERI,Yemen,YEM,0,0,0,5,5
2013,Ethiopia,ETH,Yemen,YEM,0,0,35,37,72
2014,Benin,BEN,Algeria,DZA,0,0,14,0,14
2014,Central African Rep.,CAF,Algeria,DZA,0,0,5,0,5
2014,Chad,TCD,Algeria,DZA,0,0,5,0,5
2014,Cameroon,CMR,Algeria,DZA,0,0,37,5,42
2014,Dem. Rep. of the Congo,COD,Algeria,DZA,0,0,12,0,12
2014,Guinea,GIN,Algeria,DZA,0,0,14,0,14
2014,Cote d'Ivoire,CIV,Algeria,DZA,0,0,37,10,47
2014,Liberia,LBR,Algeria,DZA,0,0,5,0,5
2014,Mali,MLI,Algeria,DZA,0,0,91,5,96
2014,Niger,NER,Algeria,DZA,0,0,5,0,5
2014,Nigeria,NGA,Algeria,DZA,0,0,12,0,12
2014,Chad,TCD,Egypt,EGY,0,0,5,0,5
2014,Eritrea,ERI,Egypt,EGY,5,0,5,0,10
2014,Ethiopia,ETH,Egypt,EGY,5,0,53,0,58
2014,Nigeria,NGA,Egypt,EGY,0,0,10,0,10
2014,Somalia,SOM,Egypt,EGY,0,0,15,0,15
2014,Sudan,SDN,Egypt,EGY,31,0,118,0,149
2014,South Sudan,SSD,Egypt,EGY,13,0,0,0,13
2014,Ghana,GHA,China,CHN,0,0,0,5,5
2014,Nigeria,NGA,China,CHN,0,0,5,5,10
2014,Somalia,SOM,China,CHN,12,0,23,12,47
2014,Burundi,BDI,Cameroon,CMR,0,0,5,0,5
2014,Central African Rep.,CAF,Cameroon,CMR,66,0,0,5,71
2014,Chad,TCD,Cameroon,CMR,0,0,31,5,36
2014,Dem. Rep. of the Congo,COD,Cameroon,CMR,0,0,43,5,48
2014,Guinea,GIN,Cameroon,CMR,0,0,16,0,16
2014,Cote d'Ivoire,CIV,Cameroon,CMR,0,0,5,0,5
2014,Mali,MLI,Cameroon,CMR,0,0,5,0,5
2014,Niger,NER,Cameroon,CMR,0,0,0,5,5
2014,Rwanda,RWA,Cameroon,CMR,5,0,45,0,50
2014,Senegal,SEN,Cameroon,CMR,0,0,5,0,5
2014,Sierra Leone,SLE,Cameroon,CMR,0,0,0,5,5
2014,Egypt,EGY,"China, Hong Kong SAR",HKG,0,0,5,0,5
2014,Dem. Rep. of the Congo,COD,"China, Hong Kong SAR",HKG,0,0,5,0,5
2014,India,IND,"China, Hong Kong SAR",HKG,0,0,5,0,5
2014,Indonesia,IDN,"China, Hong Kong SAR",HKG,0,0,5,0,5
2014,Sri Lanka,LKA,"China, Hong Kong SAR",HKG,0,0,5,0,5
2014,Namibia,NAM,"China, Hong Kong SAR",HKG,0,0,5,0,5
2014,Pakistan,PAK,"China, Hong Kong SAR",HKG,5,0,5,0,10
2014,Somalia,SOM,"China, Hong Kong SAR",HKG,0,0,5,0,5
2014,Togo,TGO,"China, Hong Kong SAR",HKG,0,0,5,0,5
2014,Uganda,UGA,"China, Hong Kong SAR",HKG,0,0,5,0,5
2014,Afghanistan,AFG,India,IND,22,0,140,109,271
2014,Dem. Rep. of the Congo,COD,India,IND,0,0,0,12,12
2014,Myanmar,MMR,India,IND,5,0,24,74,103
2014,Nigeria,NGA,India,IND,0,0,15,14,29
2014,Sudan,SDN,India,IND,5,0,0,0,5
2014,Afghanistan,AFG,Indonesia,IDN,24,0,66,0,90
2014,Iran (Islamic Rep. of),IRN,Indonesia,IDN,0,0,66,14,80
2014,Iraq,IRQ,Indonesia,IDN,10,0,0,0,10
2014,Sri Lanka,LKA,Indonesia,IDN,5,0,16,0,21
2014,Pakistan,PAK,Indonesia,IDN,0,0,0,5,5
2014,Sudan,SDN,Indonesia,IDN,0,0,0,5,5
2014,Yemen,YEM,Indonesia,IDN,0,0,0,5,5
2014,Iraq,IRQ,Jordan,JOR,32,0,5,0,37
2014,Sudan,SDN,Jordan,JOR,20,0,10,0,30
2014,South Sudan,SSD,Jordan,JOR,5,0,0,0,5
2014,Burundi,BDI,Kenya,KEN,5,0,26,13,44
2014,Dem. Rep. of the Congo,COD,Kenya,KEN,112,0,14,22,148
2014,Ethiopia,ETH,Kenya,KEN,85,0,172,330,587
2014,Rwanda,RWA,Kenya,KEN,0,0,23,51,74
2014,Somalia,SOM,Kenya,KEN,20,0,11,28,59
2014,Sudan,SDN,Kenya,KEN,5,0,0,0,5
2014,South Sudan,SSD,Kenya,KEN,11,0,0,43,54
2014,Uganda,UGA,Kenya,KEN,0,0,14,0,14
2014,Afghanistan,AFG,Kyrgyzstan,KGZ,0,0,19,0,19
2014,Uzbekistan,UZB,Kyrgyzstan,KGZ,0,0,0,5,5
2014,Afghanistan,AFG,Lebanon,LBN,0,0,5,0,5
2014,Egypt,EGY,Lebanon,LBN,0,0,39,0,39
2014,Ethiopia,ETH,Lebanon,LBN,0,0,10,0,10
2014,Iran (Islamic Rep. of),IRN,Lebanon,LBN,0,0,10,0,10
2014,Iraq,IRQ,Lebanon,LBN,88,0,50,0,138
2014,Mali,MLI,Lebanon,LBN,0,0,5,0,5
2014,Sudan,SDN,Lebanon,LBN,21,0,97,0,118
2014,Maldives,MDV,Sri Lanka,LKA,0,0,0,10,10
2014,Pakistan,PAK,Sri Lanka,LKA,38,0,54,0,92
2014,Egypt,EGY,Malaysia,MYS,0,0,5,0,5
2014,Palestinian,PSE,Malaysia,MYS,0,0,5,0,5
2014,Iran (Islamic Rep. of),IRN,Malaysia,MYS,10,0,28,0,38
2014,Iraq,IRQ,Malaysia,MYS,0,0,5,0,5
2014,Sri Lanka,LKA,Malaysia,MYS,13,0,252,0,265
2014,Myanmar,MMR,Malaysia,MYS,77,0,430,0,507
2014,Pakistan,PAK,Malaysia,MYS,0,0,42,0,42
2014,Somalia,SOM,Malaysia,MYS,0,0,11,0,11
2014,Sudan,SDN,Malaysia,MYS,0,0,10,0,10
2014,Syrian Arab Rep.,SYR,Malaysia,MYS,5,0,0,0,5
2014,Yemen,YEM,Malaysia,MYS,0,0,0,5,5
2014,Cameroon,CMR,Morocco,MAR,0,0,13,5,18
2014,Congo,COG,Morocco,MAR,0,0,14,0,14
2014,Dem. Rep. of the Congo,COD,Morocco,MAR,5,0,34,29,68
2014,Guinea,GIN,Morocco,MAR,0,0,0,5,5
2014,Cote d'Ivoire,CIV,Morocco,MAR,0,0,30,24,54
2014,Liberia,LBR,Morocco,MAR,0,0,0,5,5
2014,Niger,NER,Morocco,MAR,0,0,0,5,5
2014,Nigeria,NGA,Morocco,MAR,0,0,53,47,100
2014,Sierra Leone,SLE,Morocco,MAR,0,0,0,5,5
2014,Sudan,SDN,Morocco,MAR,0,0,5,0,5
2014,Uganda,UGA,Morocco,MAR,0,0,5,0,5
2014,Zimbabwe,ZWE,Morocco,MAR,0,0,5,0,5
2014,Pakistan,PAK,Nepal,NPL,70,0,5,0,75
2014,Afghanistan,AFG,Pakistan,PAK,205,0,836,0,1041
2014,Iran (Islamic Rep. of),IRN,Pakistan,PAK,11,0,5,0,16
2014,Somalia,SOM,Pakistan,PAK,0,0,11,0,11
2014,Afghanistan,AFG,Syrian Arab Rep.,SYR,0,0,0,14,14
2014,Algeria,DZA,Syrian Arab Rep.,SYR,0,0,0,5,5
2014,Egypt,EGY,Syrian Arab Rep.,SYR,0,0,32,5,37
2014,Ethiopia,ETH,Syrian Arab Rep.,SYR,5,0,10,0,15
2014,Guinea,GIN,Syrian Arab Rep.,SYR,18,0,0,0,18
2014,Iran (Islamic Rep. of),IRN,Syrian Arab Rep.,SYR,0,0,88,0,88
2014,Iraq,IRQ,Syrian Arab Rep.,SYR,32,0,0,39,71
2014,Jordan,JOR,Syrian Arab Rep.,SYR,0,0,13,0,13
2014,Kenya,KEN,Syrian Arab Rep.,SYR,0,0,10,0,10
2014,Libya,LBY,Syrian Arab Rep.,SYR,0,0,5,0,5
2014,Lebanon,LBN,Syrian Arab Rep.,SYR,0,0,22,5,27
2014,Morocco,MAR,Syrian Arab Rep.,SYR,0,0,10,0,10
2014,Pakistan,PAK,Syrian Arab Rep.,SYR,0,0,17,0,17
2014,Philippines,PHL,Syrian Arab Rep.,SYR,0,0,12,0,12
2014,Sudan,SDN,Syrian Arab Rep.,SYR,43,0,30,5,78
2014,South Sudan,SSD,Syrian Arab Rep.,SYR,0,0,0,5,5
2014,Tajikistan,TJK,Syrian Arab Rep.,SYR,0,0,5,0,5
2014,Tunisia,TUN,Syrian Arab Rep.,SYR,0,0,5,0,5
2014,Turkey,TUR,Syrian Arab Rep.,SYR,0,0,5,0,5
2014,Yemen,YEM,Syrian Arab Rep.,SYR,0,0,21,5,26
2014,China,CHN,Thailand,THA,0,0,5,0,5
2014,Dem. Rep. of the Congo,COD,Thailand,THA,5,0,0,0,5
2014,Iran (Islamic Rep. of),IRN,Thailand,THA,0,0,10,0,10
2014,Sri Lanka,LKA,Thailand,THA,5,0,5,0,10
2014,Pakistan,PAK,Thailand,THA,0,0,14,0,14
2014,Viet Nam,VNM,Thailand,THA,27,0,21,0,48
2014,Afghanistan,AFG,Tajikistan,TJK,39,0,80,0,119
2014,Pakistan,PAK,Tajikistan,TJK,0,0,13,0,13
2014,Eritrea,ERI,Tunisia,TUN,0,0,10,0,10
2014,Cote d'Ivoire,CIV,Tunisia,TUN,0,0,71,0,71
2014,Somalia,SOM,Tunisia,TUN,0,0,5,0,5
2014,Sudan,SDN,Tunisia,TUN,0,0,10,0,10
2014,Afghanistan,AFG,Turkey,TUR,5,0,5,93,103
2014,Algeria,DZA,Turkey,TUR,0,0,5,0,5
2014,Bangladesh,BGD,Turkey,TUR,0,0,0,5,5
2014,Dem. Rep. of the Congo,COD,Turkey,TUR,0,0,5,0,5
2014,Eritrea,ERI,Turkey,TUR,0,0,0,5,5
2014,Iran (Islamic Rep. of),IRN,Turkey,TUR,111,0,92,145,348
2014,Iraq,IRQ,Turkey,TUR,30,0,10,0,40
2014,Kyrgyzstan,KGZ,Turkey,TUR,0,0,5,5,10
2014,Nigeria,NGA,Turkey,TUR,0,0,0,5,5
2014,Senegal,SEN,Turkey,TUR,0,0,5,0,5
2014,Somalia,SOM,Turkey,TUR,0,0,5,0,5
2014,Sudan,SDN,Turkey,TUR,5,0,0,0,5
2014,Tajikistan,TJK,Turkey,TUR,0,0,5,0,5
2014,Turkmenistan,TKM,Turkey,TUR,0,0,5,0,5
2014,Uzbekistan,UZB,Turkey,TUR,0,0,5,0,5
2014,Afghanistan,AFG,Ukraine,UKR,0,0,5,0,5
2014,Dem. Rep. of the Congo,COD,Ukraine,UKR,0,0,5,0,5
2014,Iran (Islamic Rep. of),IRN,Ukraine,UKR,0,0,5,0,5
2014,Ethiopia,ETH,Yemen,YEM,0,0,55,35,90
2015,Iran (Islamic Rep. of),IRN,Afghanistan,AFG,0,0,0,5,5
2015,Pakistan,PAK,Afghanistan,AFG,10,0,0,0,10
2015,Chad,TCD,Algeria,DZA,0,0,5,0,5
2015,Cameroon,CMR,Algeria,DZA,0,0,13,0,13
2015,Dem. Rep. of the Congo,COD,Algeria,DZA,0,0,13,0,13
2015,Guinea,GIN,Algeria,DZA,0,0,16,0,16
2015,Cote d'Ivoire,CIV,Algeria,DZA,0,0,19,5,24
2015,Liberia,LBR,Algeria,DZA,0,0,5,0,5
2015,Mali,MLI,Algeria,DZA,0,0,48,5,53
2015,Nigeria,NGA,Algeria,DZA,0,0,0,5,5
2015,Eritrea,ERI,Egypt,EGY,0,0,5,0,5
2015,Ethiopia,ETH,Egypt,EGY,5,0,16,0,21
2015,Somalia,SOM,Egypt,EGY,10,0,0,0,10
2015,Sudan,SDN,Egypt,EGY,51,0,49,0,100
2015,South Sudan,SSD,Egypt,EGY,10,0,0,0,10
2015,Uzbekistan,UZB,Egypt,EGY,0,0,5,0,5
2015,Guinea,GIN,China,CHN,0,0,0,5,5
2015,Liberia,LBR,China,CHN,0,0,0,5,5
2015,Nigeria,NGA,China,CHN,0,0,15,17,32
2015,Pakistan,PAK,China,CHN,0,0,5,0,5
2015,Somalia,SOM,China,CHN,0,0,14,0,14
2015,Central African Rep.,CAF,Cameroon,CMR,57,0,11,10,78
2015,Chad,TCD,Cameroon,CMR,5,0,88,5,98
2015,Dem. Rep. of the Congo,COD,Cameroon,CMR,0,0,78,20,98
2015,Gambia,GMB,Cameroon,CMR,0,0,0,5,5
2015,Guinea-Bissau,GNB,Cameroon,CMR,0,0,14,0,14
2015,Guinea,GIN,Cameroon,CMR,0,0,49,42,91
2015,Cote d'Ivoire,CIV,Cameroon,CMR,0,0,19,5,24
2015,Mali,MLI,Cameroon,CMR,5,0,0,0,5
2015,Rwanda,RWA,Cameroon,CMR,5,0,74,0,79
2015,Senegal,SEN,Cameroon,CMR,0,0,10,13,23
2015,Sierra Leone,SLE,Cameroon,CMR,0,0,5,5,10
2015,India,IND,Micronesia (Federated States of),FSM,0,0,10,0,10
2015,Nepal,NPL,Micronesia (Federated States of),FSM,0,0,5,0,5
2015,Pakistan,PAK,"China, Hong Kong SAR",HKG,0,0,5,0,5
2015,Afghanistan,AFG,India,IND,28,0,266,0,294
2015,Cameroon,CMR,India,IND,0,0,5,0,5
2015,Dem. Rep. of the Congo,COD,India,IND,0,0,10,0,10
2015,Myanmar,MMR,India,IND,5,0,81,0,86
2015,Nigeria,NGA,India,IND,0,0,42,0,42
2015,Somalia,SOM,India,IND,0,0,5,0,5
2015,Sudan,SDN,India,IND,0,0,13,0,13
2015,Afghanistan,AFG,Indonesia,IDN,50,0,54,0,104
2015,Ethiopia,ETH,Indonesia,IDN,5,0,0,0,5
2015,Iran (Islamic Rep. of),IRN,Indonesia,IDN,5,0,73,0,78
2015,Iraq,IRQ,Indonesia,IDN,21,0,0,0,21
2015,Sri Lanka,LKA,Indonesia,IDN,12,0,20,0,32
2015,Somalia,SOM,Indonesia,IDN,5,0,0,0,5
2015,Sudan,SDN,Indonesia,IDN,0,0,5,0,5
2015,Egypt,EGY,Jordan,JOR,0,0,5,0,5
2015,Iraq,IRQ,Jordan,JOR,124,0,0,0,124
2015,Sudan,SDN,Jordan,JOR,29,0,10,0,39
2015,Afghanistan,AFG,Kyrgyzstan,KGZ,0,0,11,0,11
2015,Uzbekistan,UZB,Kyrgyzstan,KGZ,0,0,0,14,14
2015,Afghanistan,AFG,Lebanon,LBN,0,0,0,5,5
2015,Egypt,EGY,Lebanon,LBN,0,0,10,0,10
2015,Eritrea,ERI,Lebanon,LBN,0,0,5,0,5
2015,Ethiopia,ETH,Lebanon,LBN,0,0,23,0,23
2015,Iran (Islamic Rep. of),IRN,Lebanon,LBN,0,0,14,0,14
2015,Iraq,IRQ,Lebanon,LBN,23,0,0,5,28
2015,Somalia,SOM,Lebanon,LBN,0,0,5,0,5
2015,Sudan,SDN,Lebanon,LBN,37,0,156,0,193
2015,Syrian Arab Rep.,SYR,Lebanon,LBN,5,0,0,0,5
2015,Pakistan,PAK,Sri Lanka,LKA,38,0,82,0,120
2015,Central African Rep.,CAF,Mauritania,MRT,11,0,5,0,16
2015,Cameroon,CMR,Mauritania,MRT,5,0,5,0,10
2015,Dem. Rep. of the Congo,COD,Mauritania,MRT,0,0,17,0,17
2015,Cote d'Ivoire,CIV,Mauritania,MRT,5,0,41,5,51
2015,Liberia,LBR,Mauritania,MRT,0,0,0,5,5
2015,Senegal,SEN,Mauritania,MRT,12,0,0,0,12
2015,Afghanistan,AFG,Malaysia,MYS,5,0,0,0,5
2015,Egypt,EGY,Malaysia,MYS,0,0,5,0,5
2015,Palestinian,PSE,Malaysia,MYS,5,0,0,0,5
2015,Indonesia,IDN,Malaysia,MYS,0,0,5,0,5
2015,Iran (Islamic Rep. of),IRN,Malaysia,MYS,0,0,42,0,42
2015,Liberia,LBR,Malaysia,MYS,0,0,5,0,5
2015,Lebanon,LBN,Malaysia,MYS,0,0,5,0,5
2015,Sri Lanka,LKA,Malaysia,MYS,5,0,238,0,243
2015,Mali,MLI,Malaysia,MYS,0,0,5,0,5
2015,Myanmar,MMR,Malaysia,MYS,5,0,183,0,188
2015,Pakistan,PAK,Malaysia,MYS,5,0,110,0,115
2015,Somalia,SOM,Malaysia,MYS,5,0,21,0,26
2015,Sudan,SDN,Malaysia,MYS,0,0,5,0,5
2015,Syrian Arab Rep.,SYR,Malaysia,MYS,0,0,0,5,5
2015,Cameroon,CMR,Morocco,MAR,0,0,5,13,18
2015,Congo,COG,Morocco,MAR,0,0,5,0,5
2015,Dem. Rep. of the Congo,COD,Morocco,MAR,5,0,43,31,79
2015,Ghana,GHA,Morocco,MAR,0,0,5,0,5
2015,Guinea,GIN,Morocco,MAR,0,0,0,11,11
2015,Cote d'Ivoire,CIV,Morocco,MAR,0,0,34,29,63
2015,Liberia,LBR,Morocco,MAR,0,0,0,5,5
2015,Mali,MLI,Morocco,MAR,0,0,0,5,5
2015,Niger,NER,Morocco,MAR,0,0,0,5,5
2015,Nigeria,NGA,Morocco,MAR,0,0,5,17,22
2015,Rwanda,RWA,Morocco,MAR,0,0,0,5,5
2015,Sierra Leone,SLE,Morocco,MAR,0,0,0,5,5
2015,Sudan,SDN,Morocco,MAR,0,0,0,5,5
2015,China,CHN,Nepal,NPL,0,0,5,0,5
2015,Sri Lanka,LKA,Nepal,NPL,0,0,10,0,10
2015,Pakistan,PAK,Nepal,NPL,34,0,23,0,57
2015,Afghanistan,AFG,Pakistan,PAK,117,0,1500,5,1622
2015,Algeria,DZA,Pakistan,PAK,0,0,5,0,5
2015,Nigeria,NGA,Pakistan,PAK,0,0,5,0,5
2015,Somalia,SOM,Pakistan,PAK,0,0,5,0,5
2015,Afghanistan,AFG,Syrian Arab Rep.,SYR,0,0,35,0,35
2015,Algeria,DZA,Syrian Arab Rep.,SYR,0,0,13,0,13
2015,Egypt,EGY,Syrian Arab Rep.,SYR,0,0,20,0,20
2015,Burkina Faso,BFA,Syrian Arab Rep.,SYR,0,0,0,5,5
2015,Ethiopia,ETH,Syrian Arab Rep.,SYR,0,0,5,0,5
2015,Guinea,GIN,Syrian Arab Rep.,SYR,5,0,5,0,10
2015,India,IND,Syrian Arab Rep.,SYR,0,0,5,0,5
2015,Iran (Islamic Rep. of),IRN,Syrian Arab Rep.,SYR,0,0,84,0,84
2015,Iraq,IRQ,Syrian Arab Rep.,SYR,21,0,5,0,26
2015,Jordan,JOR,Syrian Arab Rep.,SYR,0,0,5,0,5
2015,Lebanon,LBN,Syrian Arab Rep.,SYR,0,0,47,0,47
2015,Sri Lanka,LKA,Syrian Arab Rep.,SYR,0,0,0,5,5
2015,Nigeria,NGA,Syrian Arab Rep.,SYR,0,0,0,5,5
2015,Pakistan,PAK,Syrian Arab Rep.,SYR,0,0,33,0,33
2015,Philippines,PHL,Syrian Arab Rep.,SYR,0,0,10,0,10
2015,Sierra Leone,SLE,Syrian Arab Rep.,SYR,0,0,5,0,5
2015,Sudan,SDN,Syrian Arab Rep.,SYR,36,0,21,0,57
2015,South Sudan,SSD,Syrian Arab Rep.,SYR,5,0,0,0,5
2015,Tunisia,TUN,Syrian Arab Rep.,SYR,0,0,5,0,5
2015,China,CHN,Thailand,THA,0,0,5,0,5
2015,Iran (Islamic Rep. of),IRN,Thailand,THA,0,0,11,0,11
2015,Sri Lanka,LKA,Thailand,THA,0,0,5,0,5
2015,Pakistan,PAK,Thailand,THA,27,0,22,12,61
2015,Viet Nam,VNM,Thailand,THA,28,0,21,0,49
2015,Bangladesh,BGD,Trinidad and Tobago,TTO,5,0,0,0,5
2015,Cuba,CUB,Trinidad and Tobago,TTO,0,0,0,5,5
2015,Nigeria,NGA,Trinidad and Tobago,TTO,0,0,10,0,10
2015,Syrian Arab Rep.,SYR,Trinidad and Tobago,TTO,0,0,5,0,5
2015,Eritrea,ERI,Tunisia,TUN,0,0,0,5,5
2015,Cote d'Ivoire,CIV,Tunisia,TUN,0,0,14,0,14
2015,Somalia,SOM,Tunisia,TUN,5,0,5,23,33
2015,Sudan,SDN,Tunisia,TUN,0,0,5,5,10
2015,Afghanistan,AFG,Turkey,TUR,141,0,28,38,207
2015,Egypt,EGY,Turkey,TUR,0,0,5,0,5
2015,Bangladesh,BGD,Turkey,TUR,0,0,5,0,5
2015,Cameroon,CMR,Turkey,TUR,0,0,0,5,5
2015,Congo,COG,Turkey,TUR,0,0,0,10,10
2015,Dem. Rep. of the Congo,COD,Turkey,TUR,0,0,0,11,11
2015,Eritrea,ERI,Turkey,TUR,0,0,0,5,5
2015,Ethiopia,ETH,Turkey,TUR,0,0,0,5,5
2015,Cote d'Ivoire,CIV,Turkey,TUR,0,0,5,0,5
2015,Iran (Islamic Rep. of),IRN,Turkey,TUR,355,0,313,160,828
2015,Iraq,IRQ,Turkey,TUR,12,0,5,23,40
2015,Kyrgyzstan,KGZ,Turkey,TUR,0,0,5,0,5
2015,Lebanon,LBN,Turkey,TUR,0,0,0,5,5
2015,Morocco,MAR,Turkey,TUR,13,0,0,0,13
2015,Nigeria,NGA,Turkey,TUR,0,0,0,13,13
2015,Pakistan,PAK,Turkey,TUR,0,0,0,5,5
2015,Somalia,SOM,Turkey,TUR,0,0,0,14,14
2015,Sudan,SDN,Turkey,TUR,0,0,5,5,10
2015,Uganda,UGA,Turkey,TUR,0,0,0,11,11
2015,Uzbekistan,UZB,Turkey,TUR,0,0,0,17,17
2015,Yemen,YEM,Turkey,TUR,23,0,0,5,28
2015,Iraq,IRQ,United Arab Emirates,ARE,334,0,0,10,344
2015,Syrian Arab Rep.,SYR,United Arab Emirates,ARE,19,0,0,5,24
2015,Stateless,XXA,United Arab Emirates,ARE,5,0,0,0,5
2015,Afghanistan,AFG,Ukraine,UKR,0,0,10,0,10
2015,Ethiopia,ETH,Yemen,YEM,0,0,5,36,41
2016,Cameroon,CMR,Algeria,DZA,0,0,5,0,5
2016,Dem. Rep. of the Congo,COD,Algeria,DZA,0,0,10,0,10
2016,Guinea,GIN,Algeria,DZA,0,0,19,0,19
2016,Cote d'Ivoire,CIV,Algeria,DZA,0,0,17,5,22
2016,Mali,MLI,Algeria,DZA,0,0,28,5,33
2016,Cameroon,CMR,Egypt,EGY,0,0,0,5,5
2016,Congo,COG,Egypt,EGY,0,0,0,5,5
2016,Eritrea,ERI,Egypt,EGY,0,0,5,16,21
2016,Ethiopia,ETH,Egypt,EGY,5,0,45,107,157
2016,Ghana,GHA,Egypt,EGY,0,0,0,5,5
2016,Guinea-Bissau,GNB,Egypt,EGY,0,0,5,0,5
2016,Iraq,IRQ,Egypt,EGY,0,0,0,5,5
2016,Nigeria,NGA,Egypt,EGY,0,0,11,13,24
2016,Russian Federation,RUS,Egypt,EGY,0,0,13,5,18
2016,Somalia,SOM,Egypt,EGY,0,0,5,30,35
2016,Sudan,SDN,Egypt,EGY,41,0,119,285,445
2016,South Sudan,SSD,Egypt,EGY,0,0,0,17,17
2016,Uganda,UGA,Egypt,EGY,0,0,5,0,5
2016,Uzbekistan,UZB,Egypt,EGY,0,0,14,5,19
2016,Cameroon,CMR,China,CHN,0,0,5,0,5
2016,Gambia,GMB,China,CHN,0,0,0,5,5
2016,Ghana,GHA,China,CHN,0,0,5,14,19
2016,Guinea,GIN,China,CHN,0,0,0,5,5
2016,Cote d'Ivoire,CIV,China,CHN,0,0,0,5,5
2016,Liberia,LBR,China,CHN,0,0,0,5,5
2016,Mali,MLI,China,CHN,0,0,0,5,5
2016,Nigeria,NGA,China,CHN,0,0,5,33,38
2016,Philippines,PHL,China,CHN,0,0,0,13,13
2016,Sierra Leone,SLE,China,CHN,0,0,0,10,10
2016,Somalia,SOM,China,CHN,0,0,0,5,5
2016,Uganda,UGA,China,CHN,0,0,0,5,5
2016,Zimbabwe,ZWE,China,CHN,0,0,0,5,5
2016,Central African Rep.,CAF,Cameroon,CMR,5,0,16,229,250
2016,Chad,TCD,Cameroon,CMR,0,0,46,116,162
2016,Congo,COG,Cameroon,CMR,0,0,0,5,5
2016,Dem. Rep. of the Congo,COD,Cameroon,CMR,12,0,37,79,128
2016,Guinea-Bissau,GNB,Cameroon,CMR,0,0,5,11,16
2016,Guinea,GIN,Cameroon,CMR,0,0,10,137,147
2016,Cote d'Ivoire,CIV,Cameroon,CMR,0,0,10,51,61
2016,Mali,MLI,Cameroon,CMR,0,0,0,13,13
2016,Nigeria,NGA,Cameroon,CMR,0,0,0,5,5
2016,Rwanda,RWA,Cameroon,CMR,5,0,18,37,60
2016,Senegal,SEN,Cameroon,CMR,0,0,5,38,43
2016,Sierra Leone,SLE,Cameroon,CMR,0,0,0,5,5
2016,Sudan,SDN,Cameroon,CMR,0,0,0,10,10
2016,Togo,TGO,Cameroon,CMR,0,0,0,5,5
2016,Nepal,NPL,Micronesia (Federated States of),FSM,0,0,5,0,5
2016,Afghanistan,AFG,India,IND,159,0,50,256,465
2016,Cameroon,CMR,India,IND,0,0,5,5,10
2016,Dem. Rep. of the Congo,COD,India,IND,0,0,0,5,5
2016,Mexico,MEX,India,IND,0,0,5,5,10
2016,Myanmar,MMR,India,IND,24,0,12,20,56
2016,Nigeria,NGA,India,IND,0,0,5,0,5
2016,Somalia,SOM,India,IND,19,0,5,0,24
2016,Sudan,SDN,India,IND,0,0,0,12,12
2016,Afghanistan,AFG,Indonesia,IDN,83,0,10,0,93
2016,Cote d'Ivoire,CIV,Indonesia,IDN,0,0,0,5,5
2016,India,IND,Indonesia,IDN,0,0,5,0,5
2016,Iran (Islamic Rep. of),IRN,Indonesia,IDN,10,0,57,23,90
2016,Sri Lanka,LKA,Indonesia,IDN,11,0,62,12,85
2016,Pakistan,PAK,Indonesia,IDN,0,0,0,5,5
2016,Somalia,SOM,Indonesia,IDN,0,0,5,0,5
2016,Sudan,SDN,Indonesia,IDN,0,0,5,0,5
2016,Iraq,IRQ,Jordan,JOR,5,0,0,0,5
2016,Sudan,SDN,Jordan,JOR,5,0,0,0,5
2016,Afghanistan,AFG,Kyrgyzstan,KGZ,0,0,23,0,23
2016,Egypt,EGY,Lebanon,LBN,5,0,12,0,17
2016,Cameroon,CMR,Lebanon,LBN,0,0,5,0,5
2016,Eritrea,ERI,Lebanon,LBN,0,0,5,0,5
2016,Ethiopia,ETH,Lebanon,LBN,0,0,28,0,28
2016,Iran (Islamic Rep. of),IRN,Lebanon,LBN,5,0,0,0,5
2016,Jordan,JOR,Lebanon,LBN,10,0,0,0,10
2016,Sudan,SDN,Lebanon,LBN,23,0,250,98,371
2016,Pakistan,PAK,Sri Lanka,LKA,56,0,57,0,113
2016,Chad,TCD,Mauritania,MRT,0,0,5,0,5
2016,Guinea,GIN,Mauritania,MRT,0,0,5,0,5
2016,Cote d'Ivoire,CIV,Mauritania,MRT,0,0,5,0,5
2016,Nigeria,NGA,Mauritania,MRT,0,0,5,0,5
2016,Senegal,SEN,Mauritania,MRT,0,0,5,0,5
2016,Afghanistan,AFG,Malaysia,MYS,12,0,14,0,26
2016,Bangladesh,BGD,Malaysia,MYS,0,0,5,0,5
2016,Iran (Islamic Rep. of),IRN,Malaysia,MYS,16,0,26,0,42
2016,Iraq,IRQ,Malaysia,MYS,5,0,0,0,5
2016,Sri Lanka,LKA,Malaysia,MYS,5,0,178,0,183
2016,Myanmar,MMR,Malaysia,MYS,0,0,202,0,202
2016,Pakistan,PAK,Malaysia,MYS,10,0,100,0,110
2016,Somalia,SOM,Malaysia,MYS,5,0,11,0,16
2016,Sudan,SDN,Malaysia,MYS,0,0,5,0,5
2016,Central African Rep.,CAF,Morocco,MAR,0,0,5,0,5
2016,Cameroon,CMR,Morocco,MAR,0,0,39,5,44
2016,Congo,COG,Morocco,MAR,0,0,16,0,16
2016,Dem. Rep. of the Congo,COD,Morocco,MAR,5,0,113,33,151
2016,Guinea,GIN,Morocco,MAR,0,0,37,5,42
2016,Cote d'Ivoire,CIV,Morocco,MAR,11,0,109,0,120
2016,Liberia,LBR,Morocco,MAR,0,0,5,0,5
2016,Mali,MLI,Morocco,MAR,0,0,21,10,31
2016,Nigeria,NGA,Morocco,MAR,0,0,15,10,25
2016,Rwanda,RWA,Morocco,MAR,0,0,5,0,5
2016,Senegal,SEN,Morocco,MAR,0,0,5,0,5
2016,Sierra Leone,SLE,Morocco,MAR,0,0,5,0,5
2016,Togo,TGO,Morocco,MAR,0,0,5,0,5
2016,Myanmar,MMR,Nepal,NPL,0,0,5,0,5
2016,Pakistan,PAK,Nepal,NPL,5,0,0,0,5
2016,Afghanistan,AFG,Pakistan,PAK,0,0,1734,1125,2859
2016,Somalia,SOM,Pakistan,PAK,0,0,5,0,5
2016,Afghanistan,AFG,Thailand,THA,5,0,0,0,5
2016,Cambodia,KHM,Thailand,THA,0,0,0,5,5
2016,China,CHN,Thailand,THA,0,0,5,0,5
2016,Iran (Islamic Rep. of),IRN,Thailand,THA,0,0,14,5,19
2016,Liberia,LBR,Thailand,THA,0,0,5,0,5
2016,Sri Lanka,LKA,Thailand,THA,0,0,5,0,5
2016,Nigeria,NGA,Thailand,THA,0,0,5,0,5
2016,Pakistan,PAK,Thailand,THA,92,0,285,15,392
2016,Somalia,SOM,Thailand,THA,0,0,11,0,11
2016,Viet Nam,VNM,Thailand,THA,5,0,24,0,29
2016,Central African Rep.,CAF,Tunisia,TUN,5,0,0,0,5
2016,Cote d'Ivoire,CIV,Tunisia,TUN,0,0,0,12,12
2016,Afghanistan,AFG,Turkey,TUR,37,0,5,68,110
2016,Algeria,DZA,Turkey,TUR,0,0,0,5,5
2016,Egypt,EGY,Turkey,TUR,0,0,0,5,5
2016,Cameroon,CMR,Turkey,TUR,0,0,0,5,5
2016,Dem. Rep. of the Congo,COD,Turkey,TUR,0,0,0,5,5
2016,Iran (Islamic Rep. of),IRN,Turkey,TUR,143,0,48,164,355
2016,Iraq,IRQ,Turkey,TUR,5,0,5,5,15
2016,Kyrgyzstan,KGZ,Turkey,TUR,0,0,0,10,10
2016,Pakistan,PAK,Turkey,TUR,0,0,0,14,14
2016,Somalia,SOM,Turkey,TUR,5,0,0,14,19
2016,Syrian Arab Rep.,SYR,Turkey,TUR,0,0,0,14,14
2016,Uganda,UGA,Turkey,TUR,0,0,0,5,5
2016,Uzbekistan,UZB,Turkey,TUR,0,0,0,10,10
2016,Afghanistan,AFG,Ukraine,UKR,0,0,5,0,5
2016,Kyrgyzstan,KGZ,Ukraine,UKR,0,0,5,0,5
2017,Iran (Islamic Rep. of),IRN,Afghanistan,AFG,0,0,5,0,5
2017,Pakistan,PAK,Afghanistan,AFG,0,0,0,14,14
2017,Cameroon,CMR,Algeria,DZA,0,0,10,0,10
2017,Dem. Rep. of the Congo,COD,Algeria,DZA,0,0,5,0,5
2017,Guinea,GIN,Algeria,DZA,0,0,5,0,5
2017,Cote d'Ivoire,CIV,Algeria,DZA,0,0,5,0,5
2017,Mali,MLI,Algeria,DZA,5,0,5,0,10
2017,Azerbaijan,AZE,Egypt,EGY,0,0,0,5,5
2017,Chad,TCD,Egypt,EGY,10,0,0,0,10
2017,Eritrea,ERI,Egypt,EGY,5,0,5,0,10
2017,Ethiopia,ETH,Egypt,EGY,24,0,190,0,214
2017,Somalia,SOM,Egypt,EGY,0,0,11,0,11
2017,Sudan,SDN,Egypt,EGY,115,0,672,0,787
2017,South Sudan,SSD,Egypt,EGY,14,0,0,0,14
2017,Uzbekistan,UZB,Egypt,EGY,0,0,0,16,16
2017,Benin,BEN,China,CHN,0,0,0,5,5
2017,Cameroon,CMR,China,CHN,0,0,5,5,10
2017,Ghana,GHA,China,CHN,0,0,0,13,13
2017,Guinea,GIN,China,CHN,0,0,0,5,5
2017,Cote d'Ivoire,CIV,China,CHN,0,0,0,5,5
2017,Liberia,LBR,China,CHN,0,0,21,11,32
2017,Mali,MLI,China,CHN,0,0,0,5,5
2017,Nigeria,NGA,China,CHN,0,0,23,11,34
2017,Pakistan,PAK,China,CHN,5,0,0,0,5
2017,Somalia,SOM,China,CHN,0,0,12,0,12
2017,Uganda,UGA,China,CHN,0,0,5,5,10
2017,Zimbabwe,ZWE,China,CHN,0,0,0,5,5
2017,Central African Rep.,CAF,Cameroon,CMR,16,0,45,28,89
2017,Chad,TCD,Cameroon,CMR,0,0,27,16,43
2017,Dem. Rep. of the Congo,COD,Cameroon,CMR,0,0,24,5,29
2017,Guinea,GIN,Cameroon,CMR,0,0,5,0,5
2017,Cote d'Ivoire,CIV,Cameroon,CMR,0,0,10,0,10
2017,Rwanda,RWA,Cameroon,CMR,0,0,20,0,20
2017,Angola,AGO,Cuba,CUB,0,0,10,0,10
2017,Dem. Rep. of the Congo,COD,Cuba,CUB,0,0,5,0,5
2017,Afghanistan,AFG,India,IND,116,0,156,10,282
2017,Angola,AGO,India,IND,0,0,5,0,5
2017,Cameroon,CMR,India,IND,0,0,12,0,12
2017,Dem. Rep. of the Congo,COD,India,IND,0,0,5,0,5
2017,Myanmar,MMR,India,IND,12,0,28,5,45
2017,Nigeria,NGA,India,IND,0,0,10,0,10
2017,Somalia,SOM,India,IND,13,0,5,0,18
2017,Ukraine,UKR,India,IND,0,0,5,0,5
2017,Uzbekistan,UZB,India,IND,0,0,5,0,5
2017,Afghanistan,AFG,Indonesia,IDN,59,0,5,21,85
2017,Bangladesh,BGD,Indonesia,IDN,5,0,0,5,10
2017,China,CHN,Indonesia,IDN,0,0,5,0,5
2017,Cameroon,CMR,Indonesia,IDN,0,0,5,14,19
2017,Dem. Rep. of the Congo,COD,Indonesia,IDN,0,0,5,0,5
2017,Ethiopia,ETH,Indonesia,IDN,0,0,45,0,45
2017,Ghana,GHA,Indonesia,IDN,0,0,0,5,5
2017,Guinea,GIN,Indonesia,IDN,0,0,0,5,5
2017,Cote d'Ivoire,CIV,Indonesia,IDN,0,0,5,0,5
2017,Iran (Islamic Rep. of),IRN,Indonesia,IDN,11,0,36,22,69
2017,Liberia,LBR,Indonesia,IDN,0,0,0,5,5
2017,Sri Lanka,LKA,Indonesia,IDN,0,0,26,12,38
2017,Mali,MLI,Indonesia,IDN,0,0,0,5,5
2017,Myanmar,MMR,Indonesia,IDN,0,0,0,5,5
2017,Nigeria,NGA,Indonesia,IDN,0,0,20,126,146
2017,Pakistan,PAK,Indonesia,IDN,0,0,12,5,17
2017,Sierra Leone,SLE,Indonesia,IDN,0,0,0,5,5
2017,Somalia,SOM,Indonesia,IDN,5,0,0,0,5
2017,Iraq,IRQ,Jordan,JOR,5,0,0,0,5
2017,Somalia,SOM,Jordan,JOR,5,0,0,0,5
2017,Sudan,SDN,Jordan,JOR,10,0,0,0,10
2017,Egypt,EGY,Lebanon,LBN,0,0,17,10,27
2017,Eritrea,ERI,Lebanon,LBN,5,0,0,0,5
2017,Ethiopia,ETH,Lebanon,LBN,0,0,42,5,47
2017,Cote d'Ivoire,CIV,Lebanon,LBN,0,0,5,0,5
2017,Iran (Islamic Rep. of),IRN,Lebanon,LBN,0,0,0,10,10
2017,Iraq,IRQ,Lebanon,LBN,0,0,23,0,23
2017,Kenya,KEN,Lebanon,LBN,0,0,5,0,5
2017,Madagascar,MDG,Lebanon,LBN,0,0,5,0,5
2017,Pakistan,PAK,Lebanon,LBN,0,0,5,0,5
2017,Sudan,SDN,Lebanon,LBN,5,0,196,39,240
2017,Afghanistan,AFG,Sri Lanka,LKA,10,0,0,0,10
2017,Pakistan,PAK,Sri Lanka,LKA,80,0,0,0,80
2017,Cameroon,CMR,Mauritania,MRT,0,0,5,0,5
2017,Guinea,GIN,Mauritania,MRT,0,0,5,0,5
2017,Cote d'Ivoire,CIV,Mauritania,MRT,0,0,5,23,28
2017,Nigeria,NGA,Mauritania,MRT,0,0,11,5,16
2017,Senegal,SEN,Mauritania,MRT,0,0,11,0,11
2017,Togo,TGO,Mauritania,MRT,0,0,0,5,5
2017,Afghanistan,AFG,Malaysia,MYS,18,0,0,0,18
2017,Cote d'Ivoire,CIV,Malaysia,MYS,0,0,5,0,5
2017,Iran (Islamic Rep. of),IRN,Malaysia,MYS,0,0,11,0,11
2017,Iraq,IRQ,Malaysia,MYS,0,0,0,5,5
2017,Liberia,LBR,Malaysia,MYS,0,0,5,0,5
2017,Sri Lanka,LKA,Malaysia,MYS,0,0,109,0,109
2017,Myanmar,MMR,Malaysia,MYS,0,0,946,0,946
2017,Nigeria,NGA,Malaysia,MYS,0,0,5,0,5
2017,Pakistan,PAK,Malaysia,MYS,46,0,61,0,107
2017,Russian Federation,RUS,Malaysia,MYS,0,0,5,0,5
2017,Sierra Leone,SLE,Malaysia,MYS,0,0,5,0,5
2017,Somalia,SOM,Malaysia,MYS,13,0,0,0,13
2017,Sudan,SDN,Malaysia,MYS,5,0,0,0,5
2017,Tunisia,TUN,Malaysia,MYS,0,0,5,0,5
2017,Benin,BEN,Morocco,MAR,0,0,0,5,5
2017,Burkina Faso,BFA,Morocco,MAR,0,0,5,0,5
2017,Central African Rep.,CAF,Morocco,MAR,0,0,5,0,5
2017,Cameroon,CMR,Morocco,MAR,0,0,14,10,24
2017,Congo,COG,Morocco,MAR,0,0,0,12,12
2017,Dem. Rep. of the Congo,COD,Morocco,MAR,0,0,28,5,33
2017,Gambia,GMB,Morocco,MAR,0,0,5,0,5
2017,Guinea,GIN,Morocco,MAR,0,0,18,15,33
2017,Cote d'Ivoire,CIV,Morocco,MAR,0,0,18,12,30
2017,Liberia,LBR,Morocco,MAR,0,0,5,5,10
2017,Mali,MLI,Morocco,MAR,0,0,0,12,12
2017,Senegal,SEN,Morocco,MAR,5,0,5,5,15
2017,Afghanistan,AFG,Pakistan,PAK,0,0,1495,141,1636
2017,Iran (Islamic Rep. of),IRN,Pakistan,PAK,0,0,10,0,10
2017,Somalia,SOM,Pakistan,PAK,0,0,5,0,5
2017,Egypt,EGY,Thailand,THA,0,0,5,0,5
2017,Cambodia,KHM,Thailand,THA,0,0,5,0,5
2017,China,CHN,Thailand,THA,0,0,5,0,5
2017,Dem. Rep. of the Congo,COD,Thailand,THA,0,0,5,0,5
2017,Ethiopia,ETH,Thailand,THA,0,0,5,0,5
2017,Palestinian,PSE,Thailand,THA,0,0,5,0,5
2017,Guinea,GIN,Thailand,THA,0,0,5,0,5
2017,India,IND,Thailand,THA,0,0,15,0,15
2017,Iran (Islamic Rep. of),IRN,Thailand,THA,5,0,23,5,33
2017,Sri Lanka,LKA,Thailand,THA,0,0,27,0,27
2017,Nepal,NPL,Thailand,THA,0,0,5,0,5
2017,Nigeria,NGA,Thailand,THA,0,0,5,0,5
2017,Pakistan,PAK,Thailand,THA,36,0,1273,55,1364
2017,Somalia,SOM,Thailand,THA,5,0,17,0,22
2017,Viet Nam,VNM,Thailand,THA,5,0,27,10,42
2017,Cuba,CUB,Trinidad and Tobago,TTO,5,0,0,0,5
2017,Afghanistan,AFG,Turkey,TUR,16,0,0,12,28
2017,Iran (Islamic Rep. of),IRN,Turkey,TUR,54,0,18,85,157
2017,Iraq,IRQ,Turkey,TUR,5,0,0,0,5
2017,Libya,LBY,Turkey,TUR,0,0,0,10,10
2017,Somalia,SOM,Turkey,TUR,5,0,0,0,5
2017,Uganda,UGA,Turkey,TUR,0,0,0,5,5
2018,Pakistan,PAK,Afghanistan,AFG,0,0,5,0,5
2018,Burkina Faso,BFA,Algeria,DZA,0,0,5,0,5
2018,Cameroon,CMR,Algeria,DZA,0,0,11,0,11
2018,Congo,COG,Algeria,DZA,0,0,0,5,5
2018,Dem. Rep. of the Congo,COD,Algeria,DZA,0,0,25,0,25
2018,Guinea,GIN,Algeria,DZA,0,0,49,5,54
2018,Cote d'Ivoire,CIV,Algeria,DZA,0,0,37,0,37
2018,Mali,MLI,Algeria,DZA,0,0,32,5,37
2018,Senegal,SEN,Algeria,DZA,0,0,5,0,5
2018,Djibouti,DJI,Egypt,EGY,0,0,5,0,5
2018,Eritrea,ERI,Egypt,EGY,5,0,0,0,5
2018,Ethiopia,ETH,Egypt,EGY,45,0,360,5,410
2018,Somalia,SOM,Egypt,EGY,0,0,5,0,5
2018,Sudan,SDN,Egypt,EGY,103,0,576,19,698
2018,Uzbekistan,UZB,Egypt,EGY,0,0,10,0,10
2018,Afghanistan,AFG,Azerbaijan,AZE,0,0,0,5,5
2018,Russian Federation,RUS,Azerbaijan,AZE,0,0,0,5,5
2018,Burundi,BDI,China,CHN,0,0,0,5,5
2018,Benin,BEN,China,CHN,0,0,0,5,5
2018,Cameroon,CMR,China,CHN,0,0,20,5,25
2018,Colombia,COL,China,CHN,0,0,5,0,5
2018,Gambia,GMB,China,CHN,0,0,5,0,5
2018,Ghana,GHA,China,CHN,0,0,13,10,23
2018,Guinea,GIN,China,CHN,0,0,5,0,5
2018,Cote d'Ivoire,CIV,China,CHN,0,0,0,5,5
2018,Kenya,KEN,China,CHN,0,0,5,0,5
2018,Liberia,LBR,China,CHN,0,0,26,38,64
2018,Mozambique,MOZ,China,CHN,0,0,5,0,5
2018,Nigeria,NGA,China,CHN,0,0,12,21,33
2018,Sierra Leone,SLE,China,CHN,0,0,5,0,5
2018,Somalia,SOM,China,CHN,0,0,5,0,5
2018,Uganda,UGA,China,CHN,0,0,16,5,21
2018,Zimbabwe,ZWE,China,CHN,0,0,12,5,17
2018,Central African Rep.,CAF,Cameroon,CMR,39,0,31,0,70
2018,Chad,TCD,Cameroon,CMR,0,0,16,5,21
2018,Dem. Rep. of the Congo,COD,Cameroon,CMR,0,0,12,5,17
2018,Mali,MLI,Cameroon,CMR,0,0,5,0,5
2018,Rwanda,RWA,Cameroon,CMR,0,0,13,0,13
2018,Iran (Islamic Rep. of),IRN,Cuba,CUB,0,0,5,0,5
2018,Afghanistan,AFG,India,IND,36,0,240,150,426
2018,Dem. Rep. of the Congo,COD,India,IND,0,0,5,0,5
2018,Myanmar,MMR,India,IND,10,0,24,0,34
2018,Somalia,SOM,India,IND,0,0,5,0,5
2018,Algeria,DZA,Indonesia,IDN,0,0,0,5,5
2018,Egypt,EGY,Indonesia,IDN,0,0,0,5,5
2018,Bangladesh,BGD,Indonesia,IDN,0,0,0,14,14
2018,Cameroon,CMR,Indonesia,IDN,0,0,21,17,38
2018,Dem. Rep. of the Congo,COD,Indonesia,IDN,0,0,5,5,10
2018,Ethiopia,ETH,Indonesia,IDN,5,0,10,23,38
2018,Ghana,GHA,Indonesia,IDN,0,0,0,5,5
2018,Guinea,GIN,Indonesia,IDN,0,0,0,5,5
2018,Cote d'Ivoire,CIV,Indonesia,IDN,0,0,5,5,10
2018,India,IND,Indonesia,IDN,0,0,0,5,5
2018,Iran (Islamic Rep. of),IRN,Indonesia,IDN,43,0,21,5,69
2018,Iraq,IRQ,Indonesia,IDN,0,0,0,5,5
2018,Sri Lanka,LKA,Indonesia,IDN,0,0,31,41,72
2018,Mali,MLI,Indonesia,IDN,0,0,0,5,5
2018,Morocco,MAR,Indonesia,IDN,0,0,5,0,5
2018,Nigeria,NGA,Indonesia,IDN,0,0,11,13,24
2018,Pakistan,PAK,Indonesia,IDN,0,0,0,5,5
2018,Senegal,SEN,Indonesia,IDN,0,0,0,5,5
2018,Sierra Leone,SLE,Indonesia,IDN,0,0,0,5,5
2018,Somalia,SOM,Indonesia,IDN,0,0,11,0,11
2018,Sudan,SDN,Indonesia,IDN,0,0,0,5,5
2018,Egypt,EGY,Lebanon,LBN,0,0,10,0,10
2018,Eritrea,ERI,Lebanon,LBN,0,0,5,0,5
2018,Ethiopia,ETH,Lebanon,LBN,0,0,57,0,57
2018,Iraq,IRQ,Lebanon,LBN,0,0,11,0,11
2018,Pakistan,PAK,Lebanon,LBN,5,0,0,0,5
2018,Sudan,SDN,Lebanon,LBN,5,0,84,11,100
2018,Pakistan,PAK,Sri Lanka,LKA,23,0,0,0,23
2018,Cameroon,CMR,Mauritania,MRT,0,0,5,0,5
2018,Guinea,GIN,Mauritania,MRT,0,0,13,0,13
2018,Cote d'Ivoire,CIV,Mauritania,MRT,0,0,0,13,13
2018,Mali,MLI,Mauritania,MRT,0,0,13,0,13
2018,Nigeria,NGA,Mauritania,MRT,0,0,5,12,17
2018,Senegal,SEN,Mauritania,MRT,0,0,0,5,5
2018,Afghanistan,AFG,Malaysia,MYS,25,0,32,0,57
2018,China,CHN,Malaysia,MYS,5,0,0,0,5
2018,Guinea,GIN,Malaysia,MYS,0,0,5,0,5
2018,India,IND,Malaysia,MYS,0,0,5,0,5
2018,Iran (Islamic Rep. of),IRN,Malaysia,MYS,0,0,13,0,13
2018,Liberia,LBR,Malaysia,MYS,0,0,5,0,5
2018,Sri Lanka,LKA,Malaysia,MYS,5,0,111,0,116
2018,Mali,MLI,Malaysia,MYS,0,0,5,0,5
2018,Myanmar,MMR,Malaysia,MYS,5,0,3524,0,3529
2018,Nigeria,NGA,Malaysia,MYS,0,0,5,0,5
2018,Pakistan,PAK,Malaysia,MYS,31,0,145,0,176
2018,Somalia,SOM,Malaysia,MYS,5,0,35,0,40
2018,Sudan,SDN,Malaysia,MYS,0,0,5,0,5
2018,Uzbekistan,UZB,Malaysia,MYS,0,0,5,0,5
2018,Burkina Faso,BFA,Morocco,MAR,0,0,5,0,5
2018,Central African Rep.,CAF,Morocco,MAR,0,0,5,0,5
2018,Cameroon,CMR,Morocco,MAR,0,0,26,22,48
2018,Congo,COG,Morocco,MAR,0,0,20,5,25
2018,Dem. Rep. of the Congo,COD,Morocco,MAR,0,0,48,10,58
2018,Guinea,GIN,Morocco,MAR,0,0,32,27,59
2018,Cote d'Ivoire,CIV,Morocco,MAR,5,0,30,22,57
2018,Liberia,LBR,Morocco,MAR,0,0,5,0,5
2018,Mali,MLI,Morocco,MAR,0,0,5,5,10
2018,Nigeria,NGA,Morocco,MAR,0,0,10,10,20
2018,Senegal,SEN,Morocco,MAR,5,0,5,5,15
2018,Sierra Leone,SLE,Morocco,MAR,0,0,0,5,5
2018,Sudan,SDN,Morocco,MAR,0,0,0,5,5
2018,Myanmar,MMR,Nepal,NPL,0,0,0,5,5
2018,Afghanistan,AFG,Thailand,THA,5,0,0,0,5
2018,Cambodia,KHM,Thailand,THA,0,0,41,5,46
2018,China,CHN,Thailand,THA,0,0,11,0,11
2018,Ethiopia,ETH,Thailand,THA,0,0,5,0,5
2018,Palestinian,PSE,Thailand,THA,0,0,5,0,5
2018,Guinea,GIN,Thailand,THA,0,0,0,5,5
2018,India,IND,Thailand,THA,0,0,0,5,5
2018,Iran (Islamic Rep. of),IRN,Thailand,THA,0,0,20,0,20
2018,Lao People's Dem. Rep.,LAO,Thailand,THA,0,0,5,0,5
2018,Sri Lanka,LKA,Thailand,THA,5,0,15,5,25
2018,Pakistan,PAK,Thailand,THA,56,0,470,35,561
2018,Somalia,SOM,Thailand,THA,5,0,33,5,43
2018,Viet Nam,VNM,Thailand,THA,41,0,125,5,171
2018,Dem. Rep. of the Congo,COD,Tunisia,TUN,0,0,5,0,5
2018,Guinea,GIN,Tunisia,TUN,0,0,5,0,5
2018,Mali,MLI,Tunisia,TUN,0,0,5,0,5
2018,Nigeria,NGA,Tunisia,TUN,0,0,5,0,5
2018,Iran (Islamic Rep. of),IRN,Turkey,TUR,31,0,17,19,67
2019,Cameroon,CMR,Algeria,DZA,0,0,13,5,18
2019,Dem. Rep. of the Congo,COD,Algeria,DZA,5,0,14,0,19
2019,Guinea,GIN,Algeria,DZA,0,0,35,5,40
2019,Cote d'Ivoire,CIV,Algeria,DZA,5,0,25,10,40
2019,Mali,MLI,Algeria,DZA,5,0,16,5,26
2019,Nigeria,NGA,Algeria,DZA,0,0,5,0,5
2019,Ethiopia,ETH,Egypt,EGY,53,0,533,13,599
2019,Russian Federation,RUS,Egypt,EGY,0,0,11,0,11
2019,Somalia,SOM,Egypt,EGY,0,0,13,0,13
2019,Sudan,SDN,Egypt,EGY,358,0,400,5,763
2019,Tajikistan,TJK,Egypt,EGY,0,0,5,0,5
2019,Uzbekistan,UZB,Egypt,EGY,0,0,32,0,32
2019,Zimbabwe,ZWE,Egypt,EGY,5,0,5,0,10
2019,Russian Federation,RUS,Azerbaijan,AZE,0,0,0,5,5
2019,Cameroon,CMR,China,CHN,0,0,12,0,12
2019,Ghana,GHA,China,CHN,0,0,0,5,5
2019,Cote d'Ivoire,CIV,China,CHN,0,0,0,5,5
2019,Kenya,KEN,China,CHN,0,0,15,0,15
2019,Nigeria,NGA,China,CHN,0,0,5,0,5
2019,Uganda,UGA,China,CHN,0,0,17,5,22
2019,Zimbabwe,ZWE,China,CHN,0,0,10,10,20
2019,Central African Rep.,CAF,Cameroon,CMR,52,0,5,24,81
2019,Chad,TCD,Cameroon,CMR,0,0,5,0,5
2019,Congo,COG,Cameroon,CMR,0,0,5,0,5
2019,Dem. Rep. of the Congo,COD,Cameroon,CMR,0,0,0,5,5
2019,Cote d'Ivoire,CIV,Cameroon,CMR,0,0,5,0,5
2019,Rwanda,RWA,Cameroon,CMR,5,0,0,0,5
2019,Iran (Islamic Rep. of),IRN,Cuba,CUB,0,0,5,0,5
2019,Philippines,PHL,"China, Hong Kong SAR",HKG,5,0,0,0,5
2019,Sudan,SDN,"China, Hong Kong SAR",HKG,5,0,0,0,5
2019,Afghanistan,AFG,India,IND,54,0,114,144,312
2019,Myanmar,MMR,India,IND,0,0,0,18,18
2019,Somalia,SOM,India,IND,5,0,5,12,22
2019,Sudan,SDN,India,IND,0,0,5,0,5
2019,Egypt,EGY,Indonesia,IDN,0,0,0,5,5
2019,Bangladesh,BGD,Indonesia,IDN,0,0,5,0,5
2019,Cameroon,CMR,Indonesia,IDN,0,0,10,0,10
2019,Dem. Rep. of the Congo,COD,Indonesia,IDN,0,0,5,0,5
2019,Ethiopia,ETH,Indonesia,IDN,0,0,12,5,17
2019,Cote d'Ivoire,CIV,Indonesia,IDN,0,0,0,5,5
2019,Iran (Islamic Rep. of),IRN,Indonesia,IDN,29,0,10,12,51
2019,Sri Lanka,LKA,Indonesia,IDN,0,0,5,21,26
2019,Somalia,SOM,Indonesia,IDN,5,0,0,0,5
2019,Sudan,SDN,Indonesia,IDN,0,0,0,10,10
2019,Egypt,EGY,Jordan,JOR,0,0,14,0,14
2019,Iraq,IRQ,Jordan,JOR,5,0,0,17,22
2019,Sudan,SDN,Jordan,JOR,10,0,17,0,27
2019,Yemen,YEM,Jordan,JOR,0,0,0,5,5
2019,Egypt,EGY,Lebanon,LBN,0,0,14,12,26
2019,Bahrain,BHR,Lebanon,LBN,0,0,0,5,5
2019,Bangladesh,BGD,Lebanon,LBN,0,0,0,5,5
2019,Cameroon,CMR,Lebanon,LBN,0,0,5,0,5
2019,Eritrea,ERI,Lebanon,LBN,0,0,5,0,5
2019,Ethiopia,ETH,Lebanon,LBN,0,0,78,68,146
2019,Iran (Islamic Rep. of),IRN,Lebanon,LBN,0,0,0,5,5
2019,Iraq,IRQ,Lebanon,LBN,5,0,0,658,663
2019,Jordan,JOR,Lebanon,LBN,0,0,0,26,26
2019,Kenya,KEN,Lebanon,LBN,0,0,5,0,5
2019,Sri Lanka,LKA,Lebanon,LBN,0,0,0,5,5
2019,Nigeria,NGA,Lebanon,LBN,0,0,19,0,19
2019,Philippines,PHL,Lebanon,LBN,0,0,13,0,13
2019,Sudan,SDN,Lebanon,LBN,5,0,50,31,86
2019,Syrian Arab Rep.,SYR,Lebanon,LBN,0,0,0,26,26
2019,Yemen,YEM,Lebanon,LBN,0,0,0,5,5
2019,Iran (Islamic Rep. of),IRN,Sri Lanka,LKA,5,0,0,0,5
2019,Pakistan,PAK,Sri Lanka,LKA,0,0,12,5,17
2019,Guinea-Bissau,GNB,Mauritania,MRT,0,0,0,5,5
2019,Guinea,GIN,Mauritania,MRT,0,0,5,0,5
2019,Nigeria,NGA,Mauritania,MRT,0,0,12,0,12
2019,Senegal,SEN,Mauritania,MRT,0,0,5,0,5
2019,Sierra Leone,SLE,Mauritania,MRT,0,0,13,5,18
2019,Togo,TGO,Mauritania,MRT,0,0,5,0,5
2019,Afghanistan,AFG,Malaysia,MYS,65,0,10,0,75
2019,Central African Rep.,CAF,Malaysia,MYS,5,0,0,0,5
2019,Iran (Islamic Rep. of),IRN,Malaysia,MYS,5,0,5,0,10
2019,Liberia,LBR,Malaysia,MYS,0,0,5,0,5
2019,Sri Lanka,LKA,Malaysia,MYS,0,0,54,0,54
2019,Myanmar,MMR,Malaysia,MYS,77,0,218,0,295
2019,Pakistan,PAK,Malaysia,MYS,23,0,59,0,82
2019,Somalia,SOM,Malaysia,MYS,21,0,0,0,21
2019,Sudan,SDN,Malaysia,MYS,0,0,5,0,5
2019,Burkina Faso,BFA,Morocco,MAR,0,0,0,5,5
2019,Central African Rep.,CAF,Morocco,MAR,0,0,5,0,5
2019,Cameroon,CMR,Morocco,MAR,0,0,32,11,43
2019,Congo,COG,Morocco,MAR,0,0,0,5,5
2019,Dem. Rep. of the Congo,COD,Morocco,MAR,0,0,10,10,20
2019,Guinea,GIN,Morocco,MAR,0,0,27,25,52
2019,Cote d'Ivoire,CIV,Morocco,MAR,0,0,18,11,29
2019,Liberia,LBR,Morocco,MAR,0,0,0,5,5
2019,Mali,MLI,Morocco,MAR,0,0,11,0,11
2019,Nigeria,NGA,Morocco,MAR,0,0,0,5,5
2019,Senegal,SEN,Morocco,MAR,0,0,10,0,10
2019,Sierra Leone,SLE,Morocco,MAR,0,0,0,5,5
2019,Sudan,SDN,Morocco,MAR,0,0,0,5,5
2019,Togo,TGO,Morocco,MAR,0,0,0,5,5
2019,Afghanistan,AFG,Pakistan,PAK,0,0,0,5,5
2019,Cambodia,KHM,Thailand,THA,5,0,44,5,54
2019,Cameroon,CMR,Thailand,THA,5,0,0,0,5
2019,Iran (Islamic Rep. of),IRN,Thailand,THA,5,0,0,0,5
2019,Sri Lanka,LKA,Thailand,THA,0,0,0,5,5
2019,Pakistan,PAK,Thailand,THA,0,0,18,5,23
2019,Russian Federation,RUS,Thailand,THA,0,0,5,0,5
2019,Somalia,SOM,Thailand,THA,0,0,12,0,12
2019,Viet Nam,VNM,Thailand,THA,5,0,97,0,102
2019,Cuba,CUB,Trinidad and Tobago,TTO,0,0,5,0,5
2019,Cameroon,CMR,Tunisia,TUN,0,0,5,0,5
2019,Cote d'Ivoire,CIV,Tunisia,TUN,0,0,5,0,5
2019,Nigeria,NGA,Tunisia,TUN,0,0,5,0,5
2020,Cameroon,CMR,Algeria,DZA,0,0,19,0,19
2020,Dem. Rep. of the Congo,COD,Algeria,DZA,0,0,11,0,11
2020,Guinea,GIN,Algeria,DZA,0,0,13,5,18
2020,Cote d'Ivoire,CIV,Algeria,DZA,0,0,11,5,16
2020,Mali,MLI,Algeria,DZA,0,0,13,0,13
2020,Nigeria,NGA,Algeria,DZA,0,0,0,5,5
2020,Togo,TGO,Algeria,DZA,0,0,5,0,5
2020,Ethiopia,ETH,Egypt,EGY,24,0,58,0,82
2020,Sudan,SDN,Egypt,EGY,329,0,69,0,398
2020,Uzbekistan,UZB,Egypt,EGY,0,0,10,0,10
2020,Afghanistan,AFG,Azerbaijan,AZE,5,0,0,0,5
2020,Ghana,GHA,China,CHN,0,0,11,0,11
2020,Kenya,KEN,China,CHN,0,0,10,0,10
2020,Liberia,LBR,China,CHN,0,0,5,0,5
2020,Nigeria,NGA,China,CHN,0,0,5,0,5
2020,Uganda,UGA,China,CHN,0,0,26,0,26
2020,Zimbabwe,ZWE,China,CHN,0,0,18,0,18
2020,Central African Rep.,CAF,Cameroon,CMR,14,0,0,64,78
2020,Chad,TCD,Cameroon,CMR,0,0,0,128,128
2020,Congo,COG,Cameroon,CMR,0,0,0,5,5
2020,Dem. Rep. of the Congo,COD,Cameroon,CMR,0,0,0,36,36
2020,Guinea,GIN,Cameroon,CMR,0,0,0,5,5
2020,Cote d'Ivoire,CIV,Cameroon,CMR,0,0,0,12,12
2020,Mali,MLI,Cameroon,CMR,0,0,0,5,5
2020,Rwanda,RWA,Cameroon,CMR,0,0,0,28,28
2020,Senegal,SEN,Cameroon,CMR,0,0,0,5,5
2020,Iran (Islamic Rep. of),IRN,Cuba,CUB,0,0,13,0,13
2020,Afghanistan,AFG,India,IND,30,0,46,243,319
2020,Dem. Rep. of the Congo,COD,India,IND,0,0,0,5,5
2020,Myanmar,MMR,India,IND,14,0,0,5,19
2020,Somalia,SOM,India,IND,0,0,0,11,11
2020,Sudan,SDN,India,IND,0,0,0,5,5
2020,Iran (Islamic Rep. of),IRN,Indonesia,IDN,0,0,0,5,5
2020,Egypt,EGY,Jordan,JOR,0,0,5,5,10
2020,Sudan,SDN,Jordan,JOR,0,0,0,12,12
2020,Egypt,EGY,Lebanon,LBN,0,0,5,24,29
2020,Bangladesh,BGD,Lebanon,LBN,0,0,5,0,5
2020,Eritrea,ERI,Lebanon,LBN,0,0,0,5,5
2020,Ethiopia,ETH,Lebanon,LBN,5,0,26,12,43
2020,Iran (Islamic Rep. of),IRN,Lebanon,LBN,0,0,0,5,5
2020,Iraq,IRQ,Lebanon,LBN,0,0,5,249,254
2020,Nigeria,NGA,Lebanon,LBN,0,0,5,0,5
2020,Sudan,SDN,Lebanon,LBN,5,0,12,65,82
2020,Central African Rep.,CAF,Mauritania,MRT,0,0,5,5,10
2020,Cameroon,CMR,Mauritania,MRT,0,0,5,0,5
2020,Dem. Rep. of the Congo,COD,Mauritania,MRT,0,0,5,0,5
2020,Guinea,GIN,Mauritania,MRT,0,0,15,0,15
2020,Cote d'Ivoire,CIV,Mauritania,MRT,0,0,5,0,5
2020,Mali,MLI,Mauritania,MRT,0,0,10,0,10
2020,Nigeria,NGA,Mauritania,MRT,0,0,5,0,5
2020,Senegal,SEN,Mauritania,MRT,11,0,5,0,16
2020,Sierra Leone,SLE,Mauritania,MRT,0,0,16,0,16
2020,Togo,TGO,Mauritania,MRT,0,0,14,0,14
2020,Afghanistan,AFG,Malaysia,MYS,20,0,0,5,25
2020,Iran (Islamic Rep. of),IRN,Malaysia,MYS,14,0,0,0,14
2020,Sri Lanka,LKA,Malaysia,MYS,0,0,10,66,76
2020,Myanmar,MMR,Malaysia,MYS,228,0,22,248,498
2020,Pakistan,PAK,Malaysia,MYS,0,0,11,15,26
2020,Sierra Leone,SLE,Malaysia,MYS,0,0,5,0,5
2020,Somalia,SOM,Malaysia,MYS,71,0,10,0,81
2020,Sudan,SDN,Malaysia,MYS,12,0,5,0,17
2020,Yemen,YEM,Malaysia,MYS,0,0,0,5,5
2020,Cameroon,CMR,Morocco,MAR,5,0,21,38,64
2020,Congo,COG,Morocco,MAR,0,0,0,5,5
2020,Dem. Rep. of the Congo,COD,Morocco,MAR,0,0,10,11,21
2020,Guinea,GIN,Morocco,MAR,0,0,46,28,74
2020,Cote d'Ivoire,CIV,Morocco,MAR,0,0,13,5,18
2020,Liberia,LBR,Morocco,MAR,0,0,5,0,5
2020,Mali,MLI,Morocco,MAR,0,0,5,0,5
2020,Nigeria,NGA,Morocco,MAR,0,0,13,5,18
2020,Senegal,SEN,Morocco,MAR,0,0,12,0,12
2020,Pakistan,PAK,Nepal,NPL,0,0,12,0,12
2020,Egypt,EGY,Thailand,THA,5,0,0,0,5
2020,Cambodia,KHM,Thailand,THA,12,0,0,5,17
2020,Kuwait,KWT,Thailand,THA,0,0,5,0,5
2020,Sri Lanka,LKA,Thailand,THA,0,0,11,0,11
2020,Pakistan,PAK,Thailand,THA,5,0,13,0,18
2020,Somalia,SOM,Thailand,THA,5,0,5,0,10
2020,Viet Nam,VNM,Thailand,THA,10,0,14,0,24
2020,Eritrea,ERI,Tunisia,TUN,0,0,10,0,10
2020,Ethiopia,ETH,Tunisia,TUN,0,0,5,0,5
2020,Cote d'Ivoire,CIV,Tunisia,TUN,0,0,5,0,5
2020,Somalia,SOM,Tunisia,TUN,0,0,5,0,5
2021,Cameroon,CMR,Algeria,DZA,0,0,19,0,19
2021,Dem. Rep. of the Congo,COD,Algeria,DZA,0,0,11,0,11
2021,Guinea,GIN,Algeria,DZA,0,0,13,5,18
2021,Cote d'Ivoire,CIV,Algeria,DZA,0,0,11,5,16
2021,Mali,MLI,Algeria,DZA,0,0,13,0,13
2021,Nigeria,NGA,Algeria,DZA,0,0,0,5,5
2021,Togo,TGO,Algeria,DZA,0,0,5,0,5
2021,Chad,TCD,Egypt,EGY,0,0,0,5,5
2021,Cameroon,CMR,Egypt,EGY,0,0,5,0,5
2021,Eritrea,ERI,Egypt,EGY,5,0,15,0,20
2021,Ethiopia,ETH,Egypt,EGY,22,0,1367,0,1389
2021,Guinea,GIN,Egypt,EGY,0,0,0,16,16
2021,Iraq,IRQ,Egypt,EGY,0,0,5,0,5
2021,Nigeria,NGA,Egypt,EGY,0,0,10,0,10
2021,Russian Federation,RUS,Egypt,EGY,0,0,5,0,5
2021,Somalia,SOM,Egypt,EGY,10,0,46,0,56
2021,Sudan,SDN,Egypt,EGY,163,0,893,0,1056
2021,South Sudan,SSD,Egypt,EGY,0,0,0,27,27
2021,Tajikistan,TJK,Egypt,EGY,0,0,0,5,5
2021,Uganda,UGA,Egypt,EGY,0,0,0,5,5
2021,Zimbabwe,ZWE,Egypt,EGY,0,0,5,0,5
2021,Afghanistan,AFG,Azerbaijan,AZE,10,0,0,0,10
2021,Russian Federation,RUS,Azerbaijan,AZE,0,0,0,11,11
2021,Cameroon,CMR,China,CHN,0,0,5,0,5
2021,Ghana,GHA,China,CHN,0,0,5,0,5
2021,Kenya,KEN,China,CHN,0,0,5,0,5
2021,Liberia,LBR,China,CHN,0,0,5,0,5
2021,Sierra Leone,SLE,China,CHN,0,0,5,0,5
2021,Somalia,SOM,China,CHN,0,0,0,5,5
2021,Uganda,UGA,China,CHN,0,0,12,0,12
2021,Zimbabwe,ZWE,China,CHN,0,0,10,0,10
2021,Burkina Faso,BFA,Cameroon,CMR,0,0,0,5,5
2021,Central African Rep.,CAF,Cameroon,CMR,10,0,0,96,106
2021,Chad,TCD,Cameroon,CMR,0,0,5,59,64
2021,Dem. Rep. of the Congo,COD,Cameroon,CMR,0,0,0,46,46
2021,Guinea-Bissau,GNB,Cameroon,CMR,0,0,0,5,5
2021,Guinea,GIN,Cameroon,CMR,0,0,0,35,35
2021,Cote d'Ivoire,CIV,Cameroon,CMR,0,0,0,22,22
2021,Mali,MLI,Cameroon,CMR,0,0,0,12,12
2021,Niger,NER,Cameroon,CMR,0,0,0,11,11
2021,Nigeria,NGA,Cameroon,CMR,0,0,0,5,5
2021,Rwanda,RWA,Cameroon,CMR,0,0,5,0,5
2021,Togo,TGO,Cameroon,CMR,0,0,0,5,5
2021,Afghanistan,AFG,India,IND,121,0,0,14,135
2021,Ethiopia,ETH,India,IND,0,0,0,5,5
2021,Myanmar,MMR,India,IND,0,0,0,10,10
2021,Egypt,EGY,Indonesia,IDN,0,0,0,5,5
2021,Bangladesh,BGD,Indonesia,IDN,0,0,0,5,5
2021,Sri Lanka,LKA,Indonesia,IDN,0,0,0,12,12
2021,Egypt,EGY,Jordan,JOR,0,0,5,0,5
2021,Sudan,SDN,Jordan,JOR,5,0,33,0,38
2021,Egypt,EGY,Lebanon,LBN,5,0,0,0,5
2021,Ethiopia,ETH,Lebanon,LBN,0,0,47,0,47
2021,Iraq,IRQ,Lebanon,LBN,0,0,13,5,18
2021,Sudan,SDN,Lebanon,LBN,10,0,77,5,92
2021,Pakistan,PAK,Sri Lanka,LKA,0,0,0,11,11
2021,Burkina Faso,BFA,Mauritania,MRT,0,0,5,0,5
2021,Cameroon,CMR,Mauritania,MRT,0,0,10,0,10
2021,Congo,COG,Mauritania,MRT,0,0,5,0,5
2021,Ghana,GHA,Mauritania,MRT,0,0,5,0,5
2021,Guinea,GIN,Mauritania,MRT,0,0,36,0,36
2021,Cote d'Ivoire,CIV,Mauritania,MRT,0,0,5,0,5
2021,Liberia,LBR,Mauritania,MRT,0,0,5,0,5
2021,Mali,MLI,Mauritania,MRT,0,0,19,0,19
2021,Nigeria,NGA,Mauritania,MRT,0,0,12,0,12
2021,Senegal,SEN,Mauritania,MRT,5,0,10,0,15
2021,Sierra Leone,SLE,Mauritania,MRT,0,0,22,0,22
2021,Togo,TGO,Mauritania,MRT,0,0,21,0,21
2021,Afghanistan,AFG,Malaysia,MYS,16,0,12,0,28
2021,Dem. Rep. of the Congo,COD,Malaysia,MYS,5,0,0,0,5
2021,Iran (Islamic Rep. of),IRN,Malaysia,MYS,5,0,5,0,10
2021,Sri Lanka,LKA,Malaysia,MYS,5,0,70,0,75
2021,Myanmar,MMR,Malaysia,MYS,91,0,10,0,101
2021,Pakistan,PAK,Malaysia,MYS,38,0,22,0,60
2021,Sierra Leone,SLE,Malaysia,MYS,0,0,5,0,5
2021,Somalia,SOM,Malaysia,MYS,10,0,0,0,10
2021,Sudan,SDN,Malaysia,MYS,5,0,0,0,5
2021,Cameroon,CMR,Morocco,MAR,0,0,0,12,12
2021,Dem. Rep. of the Congo,COD,Morocco,MAR,0,0,0,12,12
2021,Guinea,GIN,Morocco,MAR,0,0,5,0,5
2021,Cote d'Ivoire,CIV,Morocco,MAR,0,0,0,19,19
2021,Pakistan,PAK,Nepal,NPL,0,0,10,0,10
2021,Cambodia,KHM,Thailand,THA,5,0,12,0,17
2021,Iran (Islamic Rep. of),IRN,Thailand,THA,0,0,5,0,5
2021,Pakistan,PAK,Thailand,THA,13,0,10,0,23
2021,Viet Nam,VNM,Thailand,THA,30,0,46,15,91
2021,Chad,TCD,Tunisia,TUN,0,0,5,0,5
2021,Cameroon,CMR,Tunisia,TUN,0,0,12,10,22
2021,Dem. Rep. of the Congo,COD,Tunisia,TUN,0,0,10,0,10
2021,Eritrea,ERI,Tunisia,TUN,0,0,0,5,5
2021,Ethiopia,ETH,Tunisia,TUN,0,0,0,5,5
2021,Guinea,GIN,Tunisia,TUN,0,0,27,0,27
2021,Cote d'Ivoire,CIV,Tunisia,TUN,0,0,43,5,48
2021,Liberia,LBR,Tunisia,TUN,0,0,5,5,10
2021,Nigeria,NGA,Tunisia,TUN,0,0,5,0,5
2021,Senegal,SEN,Tunisia,TUN,0,0,0,5,5
2004,Angola,AGO,Dem. Rep. of the Congo,COD,0,0,10,0,10
2004,Burundi,BDI,Dem. Rep. of the Congo,COD,48,0,14,17,79
2004,Central African Rep.,CAF,Dem. Rep. of the Congo,COD,0,0,12,0,12
2004,Congo,COG,Dem. Rep. of the Congo,COD,0,0,11,14,25
2004,Kenya,KEN,Dem. Rep. of the Congo,COD,0,0,0,5,5
2004,Liberia,LBR,Dem. Rep. of the Congo,COD,0,0,24,18,42
2004,Rwanda,RWA,Dem. Rep. of the Congo,COD,5,0,12,130,147
2004,Sierra Leone,SLE,Dem. Rep. of the Congo,COD,0,0,0,10,10
2004,Sudan,SDN,Dem. Rep. of the Congo,COD,5,0,0,0,5
2004,Uganda,UGA,Dem. Rep. of the Congo,COD,0,0,0,5,5
2004,Afghanistan,AFG,Syrian Arab Rep.,SYR,13,0,0,0,13
2004,Congo,COG,Syrian Arab Rep.,SYR,0,0,0,5,5
2004,Eritrea,ERI,Syrian Arab Rep.,SYR,5,0,0,0,5
2004,Palestinian,PSE,Syrian Arab Rep.,SYR,0,0,5,0,5
2004,Ghana,GHA,Syrian Arab Rep.,SYR,0,0,0,5,5
2004,Iran (Islamic Rep. of),IRN,Syrian Arab Rep.,SYR,0,0,5,0,5
2004,Iraq,IRQ,Syrian Arab Rep.,SYR,17,0,5,5439,5461
2004,Jordan,JOR,Syrian Arab Rep.,SYR,0,0,0,5,5
2004,Mauritania,MRT,Syrian Arab Rep.,SYR,0,0,5,0,5
2004,Somalia,SOM,Syrian Arab Rep.,SYR,58,0,44,78,180
2004,Sudan,SDN,Syrian Arab Rep.,SYR,34,0,57,0,91
2004,Stateless,XXA,Syrian Arab Rep.,SYR,0,0,5,279,284
2005,Angola,AGO,Dem. Rep. of the Congo,COD,5,0,5,21,31
2005,Burundi,BDI,Dem. Rep. of the Congo,COD,57,0,10,41,108
2005,Central African Rep.,CAF,Dem. Rep. of the Congo,COD,0,0,12,0,12
2005,Chad,TCD,Dem. Rep. of the Congo,COD,0,0,5,0,5
2005,Cameroon,CMR,Dem. Rep. of the Congo,COD,5,0,0,0,5
2005,Congo,COG,Dem. Rep. of the Congo,COD,0,0,11,13,24
2005,Cote d'Ivoire,CIV,Dem. Rep. of the Congo,COD,5,0,0,10,15
2005,Kenya,KEN,Dem. Rep. of the Congo,COD,0,0,0,5,5
2005,Liberia,LBR,Dem. Rep. of the Congo,COD,0,0,14,77,91
2005,Rwanda,RWA,Dem. Rep. of the Congo,COD,33,0,12,33,78
2005,Sierra Leone,SLE,Dem. Rep. of the Congo,COD,0,0,0,5,5
2005,Somalia,SOM,Dem. Rep. of the Congo,COD,0,0,0,15,15
2005,Sudan,SDN,Dem. Rep. of the Congo,COD,0,0,0,10,10
2005,Uganda,UGA,Dem. Rep. of the Congo,COD,0,0,0,5,5
2005,Eritrea,ERI,Sudan,SDN,35,0,0,5,40
2005,Ethiopia,ETH,Sudan,SDN,5,0,0,5,10
2005,Somalia,SOM,Sudan,SDN,5,0,0,0,5
2005,Afghanistan,AFG,Syrian Arab Rep.,SYR,5,0,56,0,61
2005,Chad,TCD,Syrian Arab Rep.,SYR,0,0,5,0,5
2005,Eritrea,ERI,Syrian Arab Rep.,SYR,0,0,10,0,10
2005,Ethiopia,ETH,Syrian Arab Rep.,SYR,5,0,0,0,5
2005,Iran (Islamic Rep. of),IRN,Syrian Arab Rep.,SYR,13,0,30,0,43
2005,Jordan,JOR,Syrian Arab Rep.,SYR,0,0,5,0,5
2005,Liberia,LBR,Syrian Arab Rep.,SYR,0,0,5,0,5
2005,Morocco,MAR,Syrian Arab Rep.,SYR,0,0,5,0,5
2005,Pakistan,PAK,Syrian Arab Rep.,SYR,0,0,5,0,5
2005,Somalia,SOM,Syrian Arab Rep.,SYR,103,0,219,0,322
2005,Sudan,SDN,Syrian Arab Rep.,SYR,20,0,176,0,196
2005,Turkey,TUR,Syrian Arab Rep.,SYR,0,0,5,0,5
2005,Stateless,XXA,Syrian Arab Rep.,SYR,0,0,5,0,5
2006,Burundi,BDI,Dem. Rep. of the Congo,COD,5,0,0,24,29
2006,Central African Rep.,CAF,Dem. Rep. of the Congo,COD,0,0,0,5,5
2006,Congo,COG,Dem. Rep. of the Congo,COD,0,0,5,5,10
2006,Cote d'Ivoire,CIV,Dem. Rep. of the Congo,COD,0,0,0,5,5
2006,Liberia,LBR,Dem. Rep. of the Congo,COD,0,0,0,10,10
2006,Rwanda,RWA,Dem. Rep. of the Congo,COD,12,0,0,54,66
2006,Sudan,SDN,Dem. Rep. of the Congo,COD,5,0,0,0,5
2001,Afghanistan,AFG,Thailand,THA,15,0,5,5,25
2001,Cambodia,KHM,Thailand,THA,28,0,57,5,90
2001,China,CHN,Thailand,THA,26,0,31,5,62
2001,Palestinian,PSE,Thailand,THA,5,0,0,0,5
2001,Iran (Islamic Rep. of),IRN,Thailand,THA,5,0,32,18,55
2001,Iraq,IRQ,Thailand,THA,29,0,49,28,106
2001,Dem. People's Rep. of Korea,PRK,Thailand,THA,0,0,0,62,62
2001,Sri Lanka,LKA,Thailand,THA,5,0,13,5,23
2001,Myanmar,MMR,Thailand,THA,480,0,269,95,844
2002,Afghanistan,AFG,Azerbaijan,AZE,69,0,0,19,88
2002,Palestinian,PSE,Azerbaijan,AZE,10,0,0,0,10
2002,Iran (Islamic Rep. of),IRN,Azerbaijan,AZE,28,0,32,0,60
2002,Iraq,IRQ,Azerbaijan,AZE,13,0,12,5,30
2002,Sri Lanka,LKA,Azerbaijan,AZE,0,0,0,10,10
2002,Pakistan,PAK,Azerbaijan,AZE,0,0,0,10,10
2002,Russian Federation,RUS,Azerbaijan,AZE,48,0,0,0,48
2002,Turkey,TUR,Azerbaijan,AZE,0,0,0,5,5
2002,Yemen,YEM,Azerbaijan,AZE,0,0,0,10,10
2002,Afghanistan,AFG,Thailand,THA,0,0,11,5,16
2002,Cambodia,KHM,Thailand,THA,19,0,32,0,51
2002,China,CHN,Thailand,THA,21,0,22,14,57
2002,Palestinian,PSE,Thailand,THA,0,0,0,5,5
2002,Iran (Islamic Rep. of),IRN,Thailand,THA,10,0,35,18,63
2002,Iraq,IRQ,Thailand,THA,13,0,49,50,112
2002,Dem. People's Rep. of Korea,PRK,Thailand,THA,0,0,0,174,174
2002,Sri Lanka,LKA,Thailand,THA,10,0,31,22,63
2002,Myanmar,MMR,Thailand,THA,455,0,465,300,1220
2002,Viet Nam,VNM,Thailand,THA,5,0,37,12,54
2003,Afghanistan,AFG,Thailand,THA,0,0,0,5,5
2003,Algeria,DZA,Thailand,THA,0,0,5,0,5
2003,Cambodia,KHM,Thailand,THA,24,0,5,5,34
2003,China,CHN,Thailand,THA,0,0,18,18,36
2003,Cameroon,CMR,Thailand,THA,5,0,0,14,19
2003,Congo,COG,Thailand,THA,0,0,0,10,10
2003,Dem. Rep. of the Congo,COD,Thailand,THA,0,0,0,5,5
2003,Palestinian,PSE,Thailand,THA,12,0,0,0,12
2003,Germany,DEU,Thailand,THA,0,0,5,0,5
2003,Guinea,GIN,Thailand,THA,0,0,0,5,5
2003,Cote d'Ivoire,CIV,Thailand,THA,0,0,0,10,10
2003,India,IND,Thailand,THA,5,0,0,0,5
2003,Indonesia,IDN,Thailand,THA,5,0,0,0,5
2003,Iran (Islamic Rep. of),IRN,Thailand,THA,10,0,13,11,34
2003,Iraq,IRQ,Thailand,THA,12,0,10,40,62
2003,Dem. People's Rep. of Korea,PRK,Thailand,THA,0,0,0,123,123
2003,Lao People's Dem. Rep.,LAO,Thailand,THA,5,0,0,44,49
2003,Liberia,LBR,Thailand,THA,5,0,49,97,151
2003,Sri Lanka,LKA,Thailand,THA,5,0,11,70,86
2003,Myanmar,MMR,Thailand,THA,657,0,161,758,1576
2003,Nigeria,NGA,Thailand,THA,0,0,40,41,81
2003,Pakistan,PAK,Thailand,THA,5,0,11,16,32
2003,Sierra Leone,SLE,Thailand,THA,0,0,10,18,28
2003,Somalia,SOM,Thailand,THA,0,0,0,5,5
2003,Viet Nam,VNM,Thailand,THA,0,0,11,5,16
2003,Sudan,SDN,Thailand,THA,0,0,5,0,5
2003,Stateless,XXA,Thailand,THA,0,0,0,5,5
2004,Burundi,BDI,Cameroon,CMR,12,0,0,0,12
2004,Central African Rep.,CAF,Cameroon,CMR,256,0,344,24,624
2004,Chad,TCD,Cameroon,CMR,32,0,195,0,227
2004,Congo,COG,Cameroon,CMR,23,0,17,0,40
2004,Dem. Rep. of the Congo,COD,Cameroon,CMR,254,0,210,10,474
2004,Cote d'Ivoire,CIV,Cameroon,CMR,10,0,13,0,23
2004,Liberia,LBR,Cameroon,CMR,0,0,14,5,19
2004,Rwanda,RWA,Cameroon,CMR,70,0,79,0,149
2004,Afghanistan,AFG,Cyprus,CYP,5,0,0,5,10
2004,Egypt,EGY,Cyprus,CYP,0,0,5,0,5
2004,Bangladesh,BGD,Cyprus,CYP,0,0,0,5,5
2004,Bosnia and Herzegovina,BIH,Cyprus,CYP,0,0,5,0,5
2004,Palestinian,PSE,Cyprus,CYP,5,10,5,5,25
2004,Georgia,GEO,Cyprus,CYP,0,0,5,0,5
2004,Iran (Islamic Rep. of),IRN,Cyprus,CYP,14,25,5,12,56
2004,Iraq,IRQ,Cyprus,CYP,0,0,0,70,70
2004,Kyrgyzstan,KGZ,Cyprus,CYP,0,0,5,0,5
2004,Pakistan,PAK,Cyprus,CYP,0,0,13,0,13
2004,Russian Federation,RUS,Cyprus,CYP,0,0,11,0,11
2004,Serbia and Kosovo: S/RES/1244 (1999),SRB,Cyprus,CYP,0,10,10,0,20
2004,Turkey,TUR,Cyprus,CYP,5,0,12,5,22
2004,Afghanistan,AFG,"China, Hong Kong SAR",HKG,5,0,0,0,5
2004,Angola,AGO,"China, Hong Kong SAR",HKG,0,0,5,0,5
2004,Burundi,BDI,"China, Hong Kong SAR",HKG,5,0,0,0,5
2004,Cameroon,CMR,"China, Hong Kong SAR",HKG,10,0,15,5,30
2004,Congo,COG,"China, Hong Kong SAR",HKG,0,0,5,0,5
2004,Dem. Rep. of the Congo,COD,"China, Hong Kong SAR",HKG,0,0,5,5,10
2004,Eritrea,ERI,"China, Hong Kong SAR",HKG,5,0,0,0,5
2004,Ethiopia,ETH,"China, Hong Kong SAR",HKG,5,0,5,0,10
2004,Ghana,GHA,"China, Hong Kong SAR",HKG,0,0,0,5,5
2004,India,IND,"China, Hong Kong SAR",HKG,0,0,0,5,5
2004,Liberia,LBR,"China, Hong Kong SAR",HKG,0,0,0,12,12
2004,Sri Lanka,LKA,"China, Hong Kong SAR",HKG,0,0,24,47,71
2004,Nepal,NPL,"China, Hong Kong SAR",HKG,0,0,18,50,68
2004,Nigeria,NGA,"China, Hong Kong SAR",HKG,0,0,0,5,5
2004,Pakistan,PAK,"China, Hong Kong SAR",HKG,18,0,29,17,64
2004,Somalia,SOM,"China, Hong Kong SAR",HKG,5,0,0,0,5
2004,Viet Nam,VNM,"China, Hong Kong SAR",HKG,5,0,0,0,5
2004,Togo,TGO,"China, Hong Kong SAR",HKG,0,0,5,0,5
2004,Afghanistan,AFG,Indonesia,IDN,30,0,0,5,35
2004,Algeria,DZA,Indonesia,IDN,0,0,5,0,5
2004,China,CHN,Indonesia,IDN,0,0,5,0,5
2004,Dem. Rep. of the Congo,COD,Indonesia,IDN,0,0,5,0,5
2004,Cote d'Ivoire,CIV,Indonesia,IDN,5,0,0,0,5
2004,Iran (Islamic Rep. of),IRN,Indonesia,IDN,37,0,0,0,37
2004,Iraq,IRQ,Indonesia,IDN,0,0,0,10,10
2004,Liberia,LBR,Indonesia,IDN,0,0,13,0,13
2004,Sri Lanka,LKA,Indonesia,IDN,0,0,0,5,5
2004,Myanmar,MMR,Indonesia,IDN,0,10,0,0,10
2004,Somalia,SOM,Indonesia,IDN,0,5,0,0,5
2004,Viet Nam,VNM,Indonesia,IDN,5,0,0,0,5
2004,Turkey,TUR,Indonesia,IDN,0,0,0,5,5
2004,Afghanistan,AFG,Lebanon,LBN,0,0,5,0,5
2004,Algeria,DZA,Lebanon,LBN,0,0,0,10,10
2004,Egypt,EGY,Lebanon,LBN,0,0,5,0,5
2004,Burundi,BDI,Lebanon,LBN,0,0,0,5,5
2004,Eritrea,ERI,Lebanon,LBN,0,0,5,0,5
2004,Ethiopia,ETH,Lebanon,LBN,0,0,5,0,5
2004,Cote d'Ivoire,CIV,Lebanon,LBN,0,0,5,0,5
2004,Iraq,IRQ,Lebanon,LBN,0,0,5,260,265
2004,Jordan,JOR,Lebanon,LBN,5,0,0,5,10
2004,Liberia,LBR,Lebanon,LBN,0,0,0,5,5
2004,Sri Lanka,LKA,Lebanon,LBN,0,0,5,0,5
2004,Somalia,SOM,Lebanon,LBN,0,0,5,5,10
2004,Sudan,SDN,Lebanon,LBN,0,0,91,0,91
2004,Turkey,TUR,Lebanon,LBN,5,0,5,5,15
2004,Stateless,XXA,Lebanon,LBN,5,0,13,0,18
2004,Afghanistan,AFG,Sri Lanka,LKA,5,0,0,0,5
2004,Maldives,MDV,Sri Lanka,LKA,0,0,0,5,5
2004,Pakistan,PAK,Sri Lanka,LKA,39,0,34,10,83
2004,Afghanistan,AFG,Malaysia,MYS,10,0,0,0,10
2004,Burundi,BDI,Malaysia,MYS,5,0,0,0,5
2004,Bangladesh,BGD,Malaysia,MYS,0,0,0,30,30
2004,Cambodia,KHM,Malaysia,MYS,0,0,0,23,23
2004,China,CHN,Malaysia,MYS,5,0,0,5,10
2004,Palestinian,PSE,Malaysia,MYS,0,0,0,5,5
2004,India,IND,Malaysia,MYS,0,0,0,5,5
2004,Indonesia,IDN,Malaysia,MYS,524,11627,0,138,12289
2004,Iran (Islamic Rep. of),IRN,Malaysia,MYS,13,0,0,0,13
2004,Iraq,IRQ,Malaysia,MYS,19,0,0,0,19
2004,Liberia,LBR,Malaysia,MYS,12,0,0,0,12
2004,Sri Lanka,LKA,Malaysia,MYS,5,0,0,11,16
2004,Myanmar,MMR,Malaysia,MYS,896,4910,47,1203,7056
2004,Nigeria,NGA,Malaysia,MYS,0,0,0,5,5
2004,Pakistan,PAK,Malaysia,MYS,12,0,0,0,12
2004,Russian Federation,RUS,Malaysia,MYS,5,0,0,0,5
2004,Sierra Leone,SLE,Malaysia,MYS,0,0,0,5,5
2004,Somalia,SOM,Malaysia,MYS,5,0,0,0,5
2004,Sudan,SDN,Malaysia,MYS,5,0,0,0,5
2004,Syrian Arab Rep.,SYR,Oman,OMN,5,0,0,0,5
2004,Afghanistan,AFG,Pakistan,PAK,121,0,3444,4410,7975
2004,Algeria,DZA,Pakistan,PAK,0,0,0,11,11
2004,Burundi,BDI,Pakistan,PAK,0,0,18,0,18
2004,China,CHN,Pakistan,PAK,0,0,11,0,11
2004,Congo,COG,Pakistan,PAK,0,0,17,5,22
2004,Palestinian,PSE,Pakistan,PAK,0,0,0,5,5
2004,Ghana,GHA,Pakistan,PAK,0,0,5,0,5
2004,Cote d'Ivoire,CIV,Pakistan,PAK,0,0,12,5,17
2004,Iran (Islamic Rep. of),IRN,Pakistan,PAK,15,0,42,0,57
2004,Iraq,IRQ,Pakistan,PAK,0,0,0,14,14
2004,Kenya,KEN,Pakistan,PAK,0,0,5,0,5
2004,Liberia,LBR,Pakistan,PAK,0,0,13,5,18
2004,Mozambique,MOZ,Pakistan,PAK,0,0,0,5,5
2004,Nigeria,NGA,Pakistan,PAK,0,0,253,75,328
2004,Rwanda,RWA,Pakistan,PAK,0,0,5,0,5
2004,Sierra Leone,SLE,Pakistan,PAK,0,0,20,10,30
2004,Somalia,SOM,Pakistan,PAK,18,0,29,47,94
2004,United Rep. of Tanzania,TZA,Pakistan,PAK,0,0,75,11,86
2004,Tunisia,TUN,Pakistan,PAK,0,0,0,5,5
2004,Uganda,UGA,Pakistan,PAK,0,0,0,5,5
2004,Yemen,YEM,Pakistan,PAK,0,0,5,0,5
2004,Palestinian,PSE,Qatar,QAT,0,0,0,10,10
2004,Pakistan,PAK,Qatar,QAT,0,0,0,15,15
2004,Afghanistan,AFG,Saudi Arabia,SAU,0,0,0,10,10
2004,Eritrea,ERI,Saudi Arabia,SAU,53,0,14,0,67
2004,Palestinian,PSE,Saudi Arabia,SAU,0,5,0,0,5
2004,Liberia,LBR,Saudi Arabia,SAU,0,19,0,0,19
2004,Somalia,SOM,Saudi Arabia,SAU,0,0,26,0,26
2004,Sudan,SDN,Saudi Arabia,SAU,0,10,5,0,15
2004,Syrian Arab Rep.,SYR,Saudi Arabia,SAU,5,0,0,0,5
2004,Stateless,XXA,Saudi Arabia,SAU,0,0,0,5,5
2004,Cambodia,KHM,Thailand,THA,59,0,40,17,116
2004,China,CHN,Thailand,THA,26,0,22,11,59
2004,Cameroon,CMR,Thailand,THA,5,0,0,0,5
2004,Congo,COG,Thailand,THA,5,0,0,25,30
2004,Dem. Rep. of the Congo,COD,Thailand,THA,25,0,0,0,25
2004,Palestinian,PSE,Thailand,THA,0,0,0,5,5
2004,Ghana,GHA,Thailand,THA,0,0,0,5,5
2004,Guinea,GIN,Thailand,THA,0,0,5,0,5
2004,Cote d'Ivoire,CIV,Thailand,THA,13,0,0,0,13
2004,India,IND,Thailand,THA,0,0,11,0,11
2004,Indonesia,IDN,Thailand,THA,5,0,0,0,5
2004,Iran (Islamic Rep. of),IRN,Thailand,THA,5,0,19,28,52
2004,Iraq,IRQ,Thailand,THA,5,0,0,12,17
2004,Kenya,KEN,Thailand,THA,0,0,0,5,5
2004,Dem. People's Rep. of Korea,PRK,Thailand,THA,0,0,0,58,58
2004,Kuwait,KWT,Thailand,THA,0,0,0,5,5
2004,Lao People's Dem. Rep.,LAO,Thailand,THA,44,0,12,391,447
2004,Liberia,LBR,Thailand,THA,13,0,5,42,60
2004,Sri Lanka,LKA,Thailand,THA,10,0,12,0,22
2004,Myanmar,MMR,Thailand,THA,2695,0,486,394,3575
2004,Nepal,NPL,Thailand,THA,5,0,10,16,31
2004,Nigeria,NGA,Thailand,THA,0,0,12,54,66
2004,Pakistan,PAK,Thailand,THA,0,0,11,10,21
2004,Philippines,PHL,Thailand,THA,0,0,5,0,5
2004,Sierra Leone,SLE,Thailand,THA,0,0,0,16,16
2004,Somalia,SOM,Thailand,THA,11,0,0,0,11
2004,Viet Nam,VNM,Thailand,THA,25,0,23,5,53
2004,Sudan,SDN,Thailand,THA,5,0,0,0,5
2004,Uganda,UGA,Thailand,THA,0,0,0,5,5
2004,Afghanistan,AFG,Uzbekistan,UZB,66,0,65,529,660
2004,Kyrgyzstan,KGZ,Uzbekistan,UZB,0,0,0,10,10
2004,Tajikistan,TJK,Uzbekistan,UZB,0,0,0,10,10
2004,Turkmenistan,TKM,Uzbekistan,UZB,5,0,0,0,5
2005,Algeria,DZA,Egypt,EGY,0,0,0,5,5
2005,Burundi,BDI,Egypt,EGY,0,0,0,5,5
2005,Chad,TCD,Egypt,EGY,5,0,0,5,10
2005,China,CHN,Egypt,EGY,0,0,5,0,5
2005,Cameroon,CMR,Egypt,EGY,0,0,0,10,10
2005,Dem. Rep. of the Congo,COD,Egypt,EGY,0,0,0,11,11
2005,Eritrea,ERI,Egypt,EGY,35,0,43,17,95
2005,Ethiopia,ETH,Egypt,EGY,38,0,118,69,225
2005,Palestinian,PSE,Egypt,EGY,10,0,0,0,10
2005,Iraq,IRQ,Egypt,EGY,0,0,0,10,10
2005,Jordan,JOR,Egypt,EGY,0,0,0,5,5
2005,Liberia,LBR,Egypt,EGY,0,0,0,5,5
2005,Libya,LBY,Egypt,EGY,0,0,0,5,5
2005,Nigeria,NGA,Egypt,EGY,0,0,5,0,5
2005,Sierra Leone,SLE,Egypt,EGY,0,0,0,5,5
2005,Somalia,SOM,Egypt,EGY,374,0,11,56,441
2005,Sudan,SDN,Egypt,EGY,5,0,0,326,331
2005,Syrian Arab Rep.,SYR,Egypt,EGY,0,0,0,5,5
2005,Tajikistan,TJK,Egypt,EGY,0,0,0,5,5
2005,Uganda,UGA,Egypt,EGY,0,0,5,0,5
2005,Yemen,YEM,Egypt,EGY,0,0,0,5,5
2005,Myanmar,MMR,Bangladesh,BGD,0,0,5,14,19
2005,Palestinian,PSE,Bosnia and Herzegovina,BIH,5,0,0,0,5
2005,North Macedonia,MKD,Bosnia and Herzegovina,BIH,0,0,21,5,26
2005,Rep. of Moldova,MDA,Bosnia and Herzegovina,BIH,0,0,5,0,5
2005,Serbia and Kosovo: S/RES/1244 (1999),SRB,Bosnia and Herzegovina,BIH,159,0,74,41,274
2005,Iraq,IRQ,China,CHN,0,5,0,0,5
2005,Liberia,LBR,China,CHN,0,0,5,5,10
2005,Pakistan,PAK,China,CHN,47,0,13,5,65
2005,Somalia,SOM,China,CHN,0,14,0,0,14
2005,Zimbabwe,ZWE,China,CHN,0,5,0,0,5
2005,Burundi,BDI,Cameroon,CMR,5,0,0,22,27
2005,Central African Rep.,CAF,Cameroon,CMR,103,0,152,182,437
2005,Chad,TCD,Cameroon,CMR,28,0,170,165,363
2005,Congo,COG,Cameroon,CMR,20,0,51,112,183
2005,Dem. Rep. of the Congo,COD,Cameroon,CMR,78,0,211,649,938
2005,Guinea-Bissau,GNB,Cameroon,CMR,0,0,17,14,31
2005,Cote d'Ivoire,CIV,Cameroon,CMR,10,0,46,117,173
2005,Liberia,LBR,Cameroon,CMR,0,0,18,22,40
2005,Nigeria,NGA,Cameroon,CMR,5,0,0,0,5
2005,Rwanda,RWA,Cameroon,CMR,32,0,76,83,191
2005,Togo,TGO,Cameroon,CMR,5,0,0,14,19
2005,Iran (Islamic Rep. of),IRN,Cyprus,CYP,0,0,5,0,5
2005,Syrian Arab Rep.,SYR,Cyprus,CYP,0,0,0,14,14
2005,Ethiopia,ETH,Eritrea,ERI,47,0,0,18,65
2005,Sudan,SDN,Eritrea,ERI,0,0,11,0,11
2005,Afghanistan,AFG,Indonesia,IDN,0,0,0,5,5
2005,Cameroon,CMR,Indonesia,IDN,0,0,5,0,5
2005,Dem. Rep. of the Congo,COD,Indonesia,IDN,5,0,0,0,5
2005,Cote d'Ivoire,CIV,Indonesia,IDN,0,0,5,5,10
2005,Liberia,LBR,Indonesia,IDN,0,0,0,14,14
2005,Myanmar,MMR,Indonesia,IDN,0,0,0,5,5
2005,Pakistan,PAK,Indonesia,IDN,0,0,0,5,5
2005,Somalia,SOM,Indonesia,IDN,0,0,0,13,13
2005,Iraq,IRQ,Kuwait,KWT,0,5,0,0,5
2005,Algeria,DZA,Lebanon,LBN,0,0,5,0,5
2005,Egypt,EGY,Lebanon,LBN,0,0,0,13,13
2005,Ethiopia,ETH,Lebanon,LBN,0,0,5,0,5
2005,Iran (Islamic Rep. of),IRN,Lebanon,LBN,0,0,0,12,12
2005,Iraq,IRQ,Lebanon,LBN,18,0,86,35,139
2005,Somalia,SOM,Lebanon,LBN,0,0,5,0,5
2005,Sudan,SDN,Lebanon,LBN,0,0,24,29,53
2005,Turkey,TUR,Lebanon,LBN,0,0,5,0,5
2005,Stateless,XXA,Lebanon,LBN,0,0,11,5,16
2005,Maldives,MDV,Sri Lanka,LKA,0,0,0,5,5
2005,Pakistan,PAK,Sri Lanka,LKA,62,0,15,5,82
2005,Afghanistan,AFG,Malaysia,MYS,27,0,0,10,37
2005,Algeria,DZA,Malaysia,MYS,5,0,0,0,5
2005,Bangladesh,BGD,Malaysia,MYS,0,0,5,135,140
2005,Cambodia,KHM,Malaysia,MYS,5,0,0,36,41
2005,China,CHN,Malaysia,MYS,10,0,0,5,15
2005,Congo,COG,Malaysia,MYS,0,0,0,5,5
2005,Eritrea,ERI,Malaysia,MYS,0,0,0,5,5
2005,India,IND,Malaysia,MYS,0,0,0,10,10
2005,Indonesia,IDN,Malaysia,MYS,5424,0,0,176,5600
2005,Iran (Islamic Rep. of),IRN,Malaysia,MYS,5,0,0,0,5
2005,Iraq,IRQ,Malaysia,MYS,5,0,0,10,15
2005,Liberia,LBR,Malaysia,MYS,5,0,0,30,35
2005,Libya,LBY,Malaysia,MYS,0,0,0,5,5
2005,Sri Lanka,LKA,Malaysia,MYS,24,0,0,116,140
2005,Myanmar,MMR,Malaysia,MYS,5276,0,10,3040,8326
2005,Nepal,NPL,Malaysia,MYS,10,0,0,13,23
2005,Nigeria,NGA,Malaysia,MYS,0,0,5,25,30
2005,Pakistan,PAK,Malaysia,MYS,5,0,0,23,28
2005,Russian Federation,RUS,Malaysia,MYS,5,0,0,0,5
2005,Somalia,SOM,Malaysia,MYS,10,0,0,14,24
2005,Viet Nam,VNM,Malaysia,MYS,0,0,0,10,10
2005,Sudan,SDN,Malaysia,MYS,16,0,0,0,16
2005,Syrian Arab Rep.,SYR,Malaysia,MYS,0,0,0,5,5
2005,Thailand,THA,Malaysia,MYS,87,0,0,11,98
2005,Zimbabwe,ZWE,Malaysia,MYS,5,0,0,0,5
2005,Afghanistan,AFG,Oman,OMN,0,0,0,16,16
2005,Pakistan,PAK,Oman,OMN,0,0,0,5,5
2005,Afghanistan,AFG,Pakistan,PAK,327,0,3014,2508,5849
2005,Angola,AGO,Pakistan,PAK,0,0,5,5,10
2005,Burundi,BDI,Pakistan,PAK,0,0,5,5,10
2005,Congo,COG,Pakistan,PAK,0,0,0,10,10
2005,Ethiopia,ETH,Pakistan,PAK,0,0,5,0,5
2005,Gambia,GMB,Pakistan,PAK,0,0,0,10,10
2005,Palestinian,PSE,Pakistan,PAK,0,0,0,5,5
2005,Ghana,GHA,Pakistan,PAK,0,0,0,10,10
2005,Cote d'Ivoire,CIV,Pakistan,PAK,0,0,0,14,14
2005,Iran (Islamic Rep. of),IRN,Pakistan,PAK,15,0,32,0,47
2005,Iraq,IRQ,Pakistan,PAK,0,0,10,5,15
2005,Liberia,LBR,Pakistan,PAK,0,0,5,29,34
2005,Niger,NER,Pakistan,PAK,0,0,0,5,5
2005,Nigeria,NGA,Pakistan,PAK,0,0,18,246,264
2005,South Africa,ZAF,Pakistan,PAK,0,0,0,10,10
2005,Russian Federation,RUS,Pakistan,PAK,10,0,0,0,10
2005,Rwanda,RWA,Pakistan,PAK,0,0,0,14,14
2005,Senegal,SEN,Pakistan,PAK,0,0,0,5,5
2005,Sierra Leone,SLE,Pakistan,PAK,0,0,0,51,51
2005,Somalia,SOM,Pakistan,PAK,5,0,5,0,10
2005,Sudan,SDN,Pakistan,PAK,0,0,0,13,13
2005,United Rep. of Tanzania,TZA,Pakistan,PAK,0,0,0,41,41
2005,Uzbekistan,UZB,Pakistan,PAK,30,0,0,0,30
2005,Zimbabwe,ZWE,Pakistan,PAK,0,0,0,11,11
2005,Egypt,EGY,Saudi Arabia,SAU,0,0,5,0,5
2005,China,CHN,Saudi Arabia,SAU,5,0,0,0,5
2005,Eritrea,ERI,Saudi Arabia,SAU,162,0,0,5,167
2005,Ethiopia,ETH,Saudi Arabia,SAU,0,0,0,14,14
2005,Palestinian,PSE,Saudi Arabia,SAU,0,10,0,0,10
2005,Myanmar,MMR,Saudi Arabia,SAU,0,0,0,10,10
2005,Pakistan,PAK,Saudi Arabia,SAU,0,0,0,5,5
2005,Somalia,SOM,Saudi Arabia,SAU,0,0,5,0,5
2005,Sudan,SDN,Saudi Arabia,SAU,17,0,11,47,75
2005,Afghanistan,AFG,Turkmenistan,TKM,11,0,0,0,11
2005,Armenia,ARM,Turkmenistan,TKM,5,0,0,0,5
2005,Azerbaijan,AZE,Turkmenistan,TKM,5,0,11,0,16
2005,Afghanistan,AFG,Uzbekistan,UZB,38,0,28,0,66
2005,Azerbaijan,AZE,Uzbekistan,UZB,0,0,0,5,5
2005,Kyrgyzstan,KGZ,Uzbekistan,UZB,0,0,0,5,5
2005,Russian Federation,RUS,Uzbekistan,UZB,0,0,5,0,5
2005,Syrian Arab Rep.,SYR,Uzbekistan,UZB,0,0,0,5,5
2005,Tajikistan,TJK,Uzbekistan,UZB,0,0,0,5,5
2005,Stateless,XXA,Uzbekistan,UZB,0,0,14,0,14
2006,North Macedonia,MKD,Bosnia and Herzegovina,BIH,0,0,34,0,34
2006,Serbia and Kosovo: S/RES/1244 (1999),SRB,Bosnia and Herzegovina,BIH,5,0,16,0,21
2006,Burundi,BDI,China,CHN,0,0,0,5,5
2006,Dem. Rep. of the Congo,COD,China,CHN,0,0,0,5,5
2006,Eritrea,ERI,China,CHN,5,0,0,0,5
2006,Cote d'Ivoire,CIV,China,CHN,5,0,0,0,5
2006,Liberia,LBR,China,CHN,0,0,0,10,10
2006,Sri Lanka,LKA,China,CHN,0,0,5,5,10
2006,Pakistan,PAK,China,CHN,16,0,22,12,50
2006,Angola,AGO,Cameroon,CMR,0,0,0,5,5
2006,Burundi,BDI,Cameroon,CMR,0,0,0,14,14
2006,Central African Rep.,CAF,Cameroon,CMR,1019,0,506,447,1972
2006,Chad,TCD,Cameroon,CMR,196,0,934,826,1956
2006,Congo,COG,Cameroon,CMR,5,0,35,80,120
2006,Dem. Rep. of the Congo,COD,Cameroon,CMR,93,0,284,531,908
2006,Equatorial Guinea,GNQ,Cameroon,CMR,10,0,0,0,10
2006,Guinea-Bissau,GNB,Cameroon,CMR,0,0,21,13,34
2006,Cote d'Ivoire,CIV,Cameroon,CMR,18,0,183,143,344
2006,Liberia,LBR,Cameroon,CMR,0,0,11,126,137
2006,Nigeria,NGA,Cameroon,CMR,0,0,0,13,13
2006,Rwanda,RWA,Cameroon,CMR,50,0,228,113,391
2006,Sierra Leone,SLE,Cameroon,CMR,0,0,5,5,10
2006,Sudan,SDN,Cameroon,CMR,13,0,0,0,13
2006,Togo,TGO,Cameroon,CMR,10,0,40,43,93
2006,Ethiopia,ETH,Cuba,CUB,24,0,0,0,24
2006,Ethiopia,ETH,Eritrea,ERI,31,0,18,5,54
2006,Sudan,SDN,Eritrea,ERI,0,0,5,0,5
2006,Afghanistan,AFG,Indonesia,IDN,0,0,0,5,5
2006,Dem. Rep. of the Congo,COD,Indonesia,IDN,5,0,0,0,5
2006,Cote d'Ivoire,CIV,Indonesia,IDN,0,0,0,5,5
2006,Iraq,IRQ,Indonesia,IDN,5,5,0,0,10
2006,Liberia,LBR,Indonesia,IDN,0,0,0,5,5
2006,Sri Lanka,LKA,Indonesia,IDN,0,0,0,40,40
2006,Myanmar,MMR,Indonesia,IDN,94,0,0,0,94
2006,Nigeria,NGA,Indonesia,IDN,0,0,10,17,27
2006,Somalia,SOM,Indonesia,IDN,0,0,10,0,10
2006,China,CHN,Kazakhstan,KAZ,5,0,0,0,5
2006,Iraq,IRQ,Kazakhstan,KAZ,5,0,0,0,5
2006,Kyrgyzstan,KGZ,Kazakhstan,KAZ,5,0,0,0,5
2006,Russian Federation,RUS,Kazakhstan,KAZ,0,0,0,5,5
2006,Uzbekistan,UZB,Kazakhstan,KAZ,158,0,5,10,173
2006,China,CHN,Kyrgyzstan,KGZ,5,0,0,0,5
2006,Uzbekistan,UZB,Kyrgyzstan,KGZ,120,0,0,13,133
2006,Algeria,DZA,Libya,LBY,5,0,0,0,5
2006,Chad,TCD,Libya,LBY,0,0,10,0,10
2006,Congo,COG,Libya,LBY,0,0,0,10,10
2006,Dem. Rep. of the Congo,COD,Libya,LBY,5,0,0,187,192
2006,Eritrea,ERI,Libya,LBY,0,0,5,0,5
2006,Ethiopia,ETH,Libya,LBY,0,0,5,0,5
2006,Palestinian,PSE,Libya,LBY,33,0,0,515,548
2006,Iraq,IRQ,Libya,LBY,5,0,13,279,297
2006,Liberia,LBR,Libya,LBY,0,0,5,26,31
2006,Morocco,MAR,Libya,LBY,0,0,5,0,5
2006,Nigeria,NGA,Libya,LBY,0,0,0,15,15
2006,Sierra Leone,SLE,Libya,LBY,0,0,0,81,81
2006,Somalia,SOM,Libya,LBY,0,0,10,345,355
2006,Sudan,SDN,Libya,LBY,5,0,206,0,211
2006,Liberia,LBR,Sri Lanka,LKA,0,0,0,5,5
2006,Pakistan,PAK,Sri Lanka,LKA,76,0,51,20,147
2006,Dem. Rep. of the Congo,COD,Mauritania,MRT,15,0,5,0,20
2006,Guinea,GIN,Mauritania,MRT,0,0,5,0,5
2006,Cote d'Ivoire,CIV,Mauritania,MRT,64,0,35,0,99
2006,Iraq,IRQ,Mauritania,MRT,5,0,0,0,5
2006,Liberia,LBR,Mauritania,MRT,17,0,80,0,97
2006,Sierra Leone,SLE,Mauritania,MRT,0,0,35,0,35
2006,Sudan,SDN,Mauritania,MRT,5,0,0,0,5
2006,Togo,TGO,Mauritania,MRT,11,0,0,0,11
2006,Afghanistan,AFG,Malaysia,MYS,14,0,0,5,19
2006,Algeria,DZA,Malaysia,MYS,0,0,0,5,5
2006,Egypt,EGY,Malaysia,MYS,0,0,0,5,5
2006,Bangladesh,BGD,Malaysia,MYS,0,0,62,29,91
2006,Cambodia,KHM,Malaysia,MYS,0,0,10,40,50
2006,China,CHN,Malaysia,MYS,5,0,0,5,10
2006,Cameroon,CMR,Malaysia,MYS,0,0,0,14,14
2006,Congo,COG,Malaysia,MYS,0,0,0,5,5
2006,Dem. Rep. of the Congo,COD,Malaysia,MYS,0,0,0,5,5
2006,Palestinian,PSE,Malaysia,MYS,0,0,0,10,10
2006,Cote d'Ivoire,CIV,Malaysia,MYS,0,0,0,11,11
2006,India,IND,Malaysia,MYS,0,0,5,5,10
2006,Indonesia,IDN,Malaysia,MYS,514,0,301,10,825
2006,Iran (Islamic Rep. of),IRN,Malaysia,MYS,0,0,11,0,11
2006,Iraq,IRQ,Malaysia,MYS,29,0,0,11,40
2006,Liberia,LBR,Malaysia,MYS,5,0,5,64,74
2006,Lebanon,LBN,Malaysia,MYS,5,0,0,0,5
2006,Sri Lanka,LKA,Malaysia,MYS,19,0,20,174,213
2006,Myanmar,MMR,Malaysia,MYS,8632,0,116,324,9072
2006,Nepal,NPL,Malaysia,MYS,10,0,0,33,43
2006,Nigeria,NGA,Malaysia,MYS,0,0,29,26,55
2006,Pakistan,PAK,Malaysia,MYS,5,0,5,14,24
2006,Russian Federation,RUS,Malaysia,MYS,0,0,5,0,5
2006,Sierra Leone,SLE,Malaysia,MYS,0,0,0,5,5
2006,Somalia,SOM,Malaysia,MYS,28,0,0,11,39
2006,Viet Nam,VNM,Malaysia,MYS,0,0,0,5,5
2006,Sudan,SDN,Malaysia,MYS,14,0,0,12,26
2006,Thailand,THA,Malaysia,MYS,37,0,0,21,58
2006,China,CHN,Mongolia,MNG,5,0,0,5,10
2006,Algeria,DZA,Morocco,MAR,0,0,0,5,5
2006,Benin,BEN,Morocco,MAR,0,0,10,0,10
2006,Central African Rep.,CAF,Morocco,MAR,0,0,5,0,5
2006,Cameroon,CMR,Morocco,MAR,5,0,21,0,26
2006,Congo,COG,Morocco,MAR,0,0,13,0,13
2006,Dem. Rep. of the Congo,COD,Morocco,MAR,92,0,160,24,276
2006,Gambia,GMB,Morocco,MAR,0,0,38,0,38
2006,Ghana,GHA,Morocco,MAR,0,0,43,0,43
2006,Guinea,GIN,Morocco,MAR,0,0,19,0,19
2006,Cote d'Ivoire,CIV,Morocco,MAR,182,0,10,0,192
2006,Kenya,KEN,Morocco,MAR,0,0,5,0,5
2006,Liberia,LBR,Morocco,MAR,0,0,89,5,94
2006,Mali,MLI,Morocco,MAR,0,0,5,0,5
2006,Niger,NER,Morocco,MAR,0,0,11,0,11
2006,Nigeria,NGA,Morocco,MAR,5,0,240,115,360
2006,Rwanda,RWA,Morocco,MAR,0,0,10,0,10
2006,Sierra Leone,SLE,Morocco,MAR,0,0,12,0,12
2006,Sudan,SDN,Morocco,MAR,0,0,13,0,13
2006,Togo,TGO,Morocco,MAR,5,0,5,0,10
2006,Afghanistan,AFG,Pakistan,PAK,284,0,1528,766,2578
2006,China,CHN,Pakistan,PAK,5,0,0,0,5
2006,India,IND,Pakistan,PAK,0,0,0,5,5
2006,Iran (Islamic Rep. of),IRN,Pakistan,PAK,11,0,18,32,61
2006,Iraq,IRQ,Pakistan,PAK,10,0,0,51,61
2006,Nigeria,NGA,Pakistan,PAK,0,0,0,5,5
2006,Somalia,SOM,Pakistan,PAK,5,0,0,30,35
2006,United Rep. of Tanzania,TZA,Pakistan,PAK,0,0,0,5,5
2006,Tajikistan,TJK,Pakistan,PAK,5,0,0,0,5
2006,Tunisia,TUN,Pakistan,PAK,0,0,0,10,10
2006,Egypt,EGY,Sudan,SDN,5,0,0,0,5
2006,Chad,TCD,Sudan,SDN,0,0,0,5,5
2006,Eritrea,ERI,Sudan,SDN,73,0,0,79,152
2006,Ethiopia,ETH,Sudan,SDN,15,0,0,203,218
2006,Somalia,SOM,Sudan,SDN,5,0,0,0,5
2006,Algeria,DZA,Tunisia,TUN,0,0,0,5,5
2006,Dem. Rep. of the Congo,COD,Tunisia,TUN,0,0,0,5,5
2006,Cote d'Ivoire,CIV,Tunisia,TUN,5,0,0,0,5
2006,Iraq,IRQ,Tunisia,TUN,5,0,0,0,5
2006,Liberia,LBR,Tunisia,TUN,0,0,0,5,5
2006,Rwanda,RWA,Tunisia,TUN,5,0,0,0,5
2006,Afghanistan,AFG,United Arab Emirates,ARE,5,0,0,0,5
2006,Ethiopia,ETH,United Arab Emirates,ARE,5,0,0,0,5
2006,Iran (Islamic Rep. of),IRN,United Arab Emirates,ARE,15,0,11,0,26
2006,Iraq,IRQ,United Arab Emirates,ARE,0,0,0,12,12
2006,Somalia,SOM,United Arab Emirates,ARE,11,0,0,0,11
2006,Sudan,SDN,United Arab Emirates,ARE,13,0,5,0,18
2006,Syrian Arab Rep.,SYR,United Arab Emirates,ARE,69,0,0,0,69
2006,Uzbekistan,UZB,United Arab Emirates,ARE,5,0,0,0,5
2006,China,CHN,Yemen,YEM,5,0,0,0,5
2006,Eritrea,ERI,Yemen,YEM,84,0,5,5,94
2006,Ethiopia,ETH,Yemen,YEM,152,0,254,520,926
2006,Iraq,IRQ,Yemen,YEM,483,0,0,0,483
2006,Philippines,PHL,Yemen,YEM,0,0,0,5,5
2006,Sudan,SDN,Yemen,YEM,14,0,18,0,32
2007,Liberia,LBR,Bangladesh,BGD,0,0,0,5,5
2007,Myanmar,MMR,Bangladesh,BGD,42,0,0,35,77
2007,Egypt,EGY,China,CHN,0,0,0,5,5
2007,Eritrea,ERI,China,CHN,5,0,0,0,5
2007,Palestinian,PSE,China,CHN,0,0,0,5,5
2007,Iraq,IRQ,China,CHN,40,0,0,5,45
2007,Rep. of Korea,KOR,China,CHN,0,0,0,5,5
2007,Sri Lanka,LKA,China,CHN,0,0,0,10,10
2007,Pakistan,PAK,China,CHN,61,0,5,5,71
2007,Burundi,BDI,Cameroon,CMR,0,0,10,0,10
2007,Central African Rep.,CAF,Cameroon,CMR,998,0,441,622,2061
2007,Chad,TCD,Cameroon,CMR,318,0,404,730,1452
2007,Congo,COG,Cameroon,CMR,0,0,10,32,42
2007,Dem. Rep. of the Congo,COD,Cameroon,CMR,50,0,189,211,450
2007,Gabon,GAB,Cameroon,CMR,11,0,0,0,11
2007,Ghana,GHA,Cameroon,CMR,0,0,0,5,5
2007,Guinea-Bissau,GNB,Cameroon,CMR,0,0,10,30,40
2007,Guinea,GIN,Cameroon,CMR,0,0,5,10,15
2007,Cote d'Ivoire,CIV,Cameroon,CMR,5,0,27,261,293
2007,Liberia,LBR,Cameroon,CMR,5,0,0,18,23
2007,Mauritania,MRT,Cameroon,CMR,5,0,0,0,5
2007,Morocco,MAR,Cameroon,CMR,0,0,0,5,5
2007,Niger,NER,Cameroon,CMR,0,0,0,5,5
2007,Nigeria,NGA,Cameroon,CMR,0,0,0,5,5
2007,Rwanda,RWA,Cameroon,CMR,99,0,160,31,290
2007,Sierra Leone,SLE,Cameroon,CMR,5,0,0,5,10
2007,Sudan,SDN,Cameroon,CMR,10,0,0,14,24
2007,Togo,TGO,Cameroon,CMR,0,0,19,27,46
2007,Angola,AGO,Dem. Rep. of the Congo,COD,5,0,0,0,5
2007,Central African Rep.,CAF,Dem. Rep. of the Congo,COD,5,0,0,0,5
2007,Congo,COG,Dem. Rep. of the Congo,COD,0,0,5,0,5
2007,Cote d'Ivoire,CIV,Dem. Rep. of the Congo,COD,0,0,13,0,13
2007,Rwanda,RWA,Dem. Rep. of the Congo,COD,5,0,5,24,34
2007,Somalia,SOM,Dem. Rep. of the Congo,COD,0,0,0,10,10
2007,Sudan,SDN,Dem. Rep. of the Congo,COD,0,0,5,0,5
2007,Afghanistan,AFG,Cuba,CUB,0,0,5,0,5
2007,Eritrea,ERI,Cuba,CUB,5,0,0,0,5
2007,Ethiopia,ETH,Cuba,CUB,11,0,0,0,11
2007,Iran (Islamic Rep. of),IRN,Cuba,CUB,5,0,0,0,5
2007,Liberia,LBR,Cuba,CUB,0,0,0,5,5
2007,Ethiopia,ETH,Eritrea,ERI,31,0,55,0,86
2007,Afghanistan,AFG,Indonesia,IDN,0,0,0,12,12
2007,China,CHN,Indonesia,IDN,5,0,0,0,5
2007,Iran (Islamic Rep. of),IRN,Indonesia,IDN,0,0,0,5,5
2007,Iraq,IRQ,Indonesia,IDN,11,0,0,0,11
2007,Sri Lanka,LKA,Indonesia,IDN,97,0,0,80,177
2007,Myanmar,MMR,Indonesia,IDN,11,0,5,13,29
2007,Nepal,NPL,Indonesia,IDN,0,0,0,16,16
2007,Nigeria,NGA,Indonesia,IDN,0,0,5,19,24
2007,Pakistan,PAK,Indonesia,IDN,0,0,5,0,5
2007,Somalia,SOM,Indonesia,IDN,5,0,0,0,5
2007,Viet Nam,VNM,Indonesia,IDN,0,0,35,0,35
2007,Algeria,DZA,Jordan,JOR,0,0,0,5,5
2007,Egypt,EGY,Jordan,JOR,5,0,5,5,15
2007,Palestinian,PSE,Jordan,JOR,0,0,0,5,5
2007,Libya,LBY,Jordan,JOR,0,0,5,0,5
2007,Lebanon,LBN,Jordan,JOR,0,0,0,5,5
2007,Russian Federation,RUS,Jordan,JOR,5,0,0,0,5
2007,Somalia,SOM,Jordan,JOR,34,0,0,0,34
2007,Sudan,SDN,Jordan,JOR,13,0,5,5,23
2007,Syrian Arab Rep.,SYR,Jordan,JOR,5,0,5,19,29
2007,Tunisia,TUN,Jordan,JOR,5,0,0,0,5
2007,Yemen,YEM,Jordan,JOR,0,0,0,5,5
2007,Stateless,XXA,Jordan,JOR,0,0,0,10,10
2007,China,CHN,Kazakhstan,KAZ,12,0,0,0,12
2007,Kyrgyzstan,KGZ,Kazakhstan,KAZ,12,0,0,5,17
2007,Uzbekistan,UZB,Kazakhstan,KAZ,137,0,24,12,173
2007,Afghanistan,AFG,Kyrgyzstan,KGZ,5,0,0,14,19
2007,China,CHN,Kyrgyzstan,KGZ,5,0,0,5,10
2007,Uzbekistan,UZB,Kyrgyzstan,KGZ,128,0,0,25,153
2007,Chad,TCD,Libya,LBY,0,0,5,0,5
2007,Cameroon,CMR,Libya,LBY,0,0,5,0,5
2007,Dem. Rep. of the Congo,COD,Libya,LBY,5,0,14,19,38
2007,Eritrea,ERI,Libya,LBY,80,0,5,10,95
2007,Ethiopia,ETH,Libya,LBY,14,0,0,0,14
2007,Palestinian,PSE,Libya,LBY,92,0,0,0,92
2007,Cote d'Ivoire,CIV,Libya,LBY,0,0,5,0,5
2007,Iraq,IRQ,Libya,LBY,1176,0,191,44,1411
2007,Liberia,LBR,Libya,LBY,5,0,5,24,34
2007,Nigeria,NGA,Libya,LBY,5,0,0,0,5
2007,Sierra Leone,SLE,Libya,LBY,0,0,5,12,17
2007,Somalia,SOM,Libya,LBY,5,0,5,11,21
2007,Sudan,SDN,Libya,LBY,17,0,78,12,107
2007,Palestinian,PSE,Sri Lanka,LKA,5,0,0,0,5
2007,Pakistan,PAK,Sri Lanka,LKA,42,0,51,45,138
2007,Central African Rep.,CAF,Mauritania,MRT,0,0,5,0,5
2007,Congo,COG,Mauritania,MRT,5,0,0,0,5
2007,Dem. Rep. of the Congo,COD,Mauritania,MRT,12,0,18,0,30
2007,Guinea,GIN,Mauritania,MRT,0,0,5,0,5
2007,Cote d'Ivoire,CIV,Mauritania,MRT,108,0,110,0,218
2007,India,IND,Mauritania,MRT,0,0,13,10,23
2007,Iraq,IRQ,Mauritania,MRT,45,0,0,0,45
2007,Liberia,LBR,Mauritania,MRT,13,0,191,0,204
2007,Lebanon,LBN,Mauritania,MRT,0,0,5,0,5
2007,Sierra Leone,SLE,Mauritania,MRT,11,0,61,0,72
2007,Togo,TGO,Mauritania,MRT,12,0,10,0,22
2007,Western Sahara,ESH,Mauritania,MRT,0,0,0,10,10
2007,Afghanistan,AFG,Pakistan,PAK,505,0,662,335,1502
2007,Ethiopia,ETH,Pakistan,PAK,5,0,0,0,5
2007,Iran (Islamic Rep. of),IRN,Pakistan,PAK,10,0,69,5,84
2007,Iraq,IRQ,Pakistan,PAK,10,0,0,0,10
2007,Somalia,SOM,Pakistan,PAK,127,0,5,0,132
2007,Uzbekistan,UZB,Pakistan,PAK,0,0,5,0,5
2007,Eritrea,ERI,Sudan,SDN,44,0,5,0,49
2007,Ethiopia,ETH,Sudan,SDN,13,17,10,10,50
2007,Somalia,SOM,Sudan,SDN,5,0,0,0,5
2007,Guinea,GIN,Tunisia,TUN,0,0,0,5,5
2007,Cote d'Ivoire,CIV,Tunisia,TUN,15,0,10,28,53
2007,Iraq,IRQ,Tunisia,TUN,5,0,0,0,5
2007,Liberia,LBR,Tunisia,TUN,0,0,21,26,47
2007,Sierra Leone,SLE,Tunisia,TUN,0,0,0,5,5
2007,Palestinian,PSE,United Arab Emirates,ARE,0,0,0,5,5
2007,Iraq,IRQ,United Arab Emirates,ARE,95,0,0,0,95
2007,Eritrea,ERI,Yemen,YEM,235,0,5,5,245
2007,Ethiopia,ETH,Yemen,YEM,215,0,286,106,607
2007,Iraq,IRQ,Yemen,YEM,2239,0,0,5,2244
2007,Sudan,SDN,Yemen,YEM,0,0,0,13,13
2008,Central African Rep.,CAF,Algeria,DZA,0,0,0,18,18
2008,Chad,TCD,Algeria,DZA,0,0,0,32,32
2008,Cameroon,CMR,Algeria,DZA,0,0,5,113,118
2008,Congo,COG,Algeria,DZA,0,0,0,5,5
2008,Dem. Rep. of the Congo,COD,Algeria,DZA,25,0,18,120,163
2008,Guinea,GIN,Algeria,DZA,0,0,0,5,5
2008,Cote d'Ivoire,CIV,Algeria,DZA,0,0,5,236,241
2008,Iraq,IRQ,Algeria,DZA,0,0,0,24,24
2008,Liberia,LBR,Algeria,DZA,0,0,17,85,102
2008,Morocco,MAR,Algeria,DZA,0,0,0,5,5
2008,Niger,NER,Algeria,DZA,0,0,0,5,5
2008,Nigeria,NGA,Algeria,DZA,0,0,0,31,31
2008,Rwanda,RWA,Algeria,DZA,0,0,0,5,5
2008,Sierra Leone,SLE,Algeria,DZA,0,0,0,5,5
2008,Togo,TGO,Algeria,DZA,0,0,0,10,10
2008,Iraq,IRQ,Bangladesh,BGD,5,0,0,0,5
2008,Sri Lanka,LKA,Bangladesh,BGD,0,0,5,0,5
2008,Myanmar,MMR,Bangladesh,BGD,64,0,41,10,115
2008,Pakistan,PAK,Bangladesh,BGD,0,0,13,0,13
2008,Somalia,SOM,Bangladesh,BGD,12,0,0,0,12
2008,Angola,AGO,Cameroon,CMR,0,0,5,5,10
2008,Central African Rep.,CAF,Cameroon,CMR,688,0,187,495,1370
2008,Chad,TCD,Cameroon,CMR,318,0,477,481,1276
2008,Congo,COG,Cameroon,CMR,0,0,10,21,31
2008,Dem. Rep. of the Congo,COD,Cameroon,CMR,54,0,141,180,375
2008,Guinea-Bissau,GNB,Cameroon,CMR,0,0,12,31,43
2008,Guinea,GIN,Cameroon,CMR,0,0,83,197,280
2008,Cote d'Ivoire,CIV,Cameroon,CMR,0,0,31,197,228
2008,Liberia,LBR,Cameroon,CMR,0,0,5,21,26
2008,Mauritania,MRT,Cameroon,CMR,0,0,0,5,5
2008,Niger,NER,Cameroon,CMR,0,0,0,5,5
2008,Rwanda,RWA,Cameroon,CMR,23,0,202,29,254
2008,Sierra Leone,SLE,Cameroon,CMR,0,0,5,5,10
2008,Sudan,SDN,Cameroon,CMR,18,0,11,5,34
2008,Togo,TGO,Cameroon,CMR,0,0,5,17,22
2008,Angola,AGO,Dem. Rep. of the Congo,COD,0,0,5,0,5
2008,Burundi,BDI,Dem. Rep. of the Congo,COD,0,0,0,5,5
2008,Central African Rep.,CAF,Dem. Rep. of the Congo,COD,0,0,5,0,5
2008,Chad,TCD,Dem. Rep. of the Congo,COD,0,0,0,5,5
2008,Congo,COG,Dem. Rep. of the Congo,COD,0,0,0,10,10
2008,Guinea,GIN,Dem. Rep. of the Congo,COD,0,0,0,5,5
2008,Cote d'Ivoire,CIV,Dem. Rep. of the Congo,COD,0,0,0,10,10
2008,Rwanda,RWA,Dem. Rep. of the Congo,COD,5,0,0,15,20
2008,Eritrea,ERI,Cuba,CUB,5,0,0,0,5
2008,Ethiopia,ETH,Cuba,CUB,0,0,5,0,5
2008,Palestinian,PSE,Cyprus,CYP,12,0,0,0,12
2008,Iraq,IRQ,Cyprus,CYP,0,0,0,21,21
2008,Ethiopia,ETH,Eritrea,ERI,0,0,0,1900,1900
2008,Sudan,SDN,Eritrea,ERI,0,0,0,63,63
2008,Afghanistan,AFG,Kazakhstan,KAZ,49,0,45,0,94
2008,China,CHN,Kazakhstan,KAZ,10,0,0,0,10
2008,Kyrgyzstan,KGZ,Kazakhstan,KAZ,5,0,0,5,10
2008,Russian Federation,RUS,Kazakhstan,KAZ,0,0,5,5,10
2008,Uzbekistan,UZB,Kazakhstan,KAZ,65,0,11,0,76
2008,Afghanistan,AFG,Kyrgyzstan,KGZ,30,0,0,10,40
2008,Uzbekistan,UZB,Kyrgyzstan,KGZ,173,0,0,17,190
2008,China,CHN,Sri Lanka,LKA,0,0,0,5,5
2008,Palestinian,PSE,Sri Lanka,LKA,16,0,0,0,16
2008,India,IND,Sri Lanka,LKA,0,0,5,0,5
2008,Iran (Islamic Rep. of),IRN,Sri Lanka,LKA,0,0,0,5,5
2008,Myanmar,MMR,Sri Lanka,LKA,55,0,0,0,55
2008,Pakistan,PAK,Sri Lanka,LKA,56,0,38,51,145
2008,Iraq,IRQ,Oman,OMN,5,0,0,0,5
2008,Afghanistan,AFG,Pakistan,PAK,374,0,491,262,1127
2008,Angola,AGO,Pakistan,PAK,0,0,0,5,5
2008,Congo,COG,Pakistan,PAK,0,0,0,12,12
2008,Ghana,GHA,Pakistan,PAK,0,0,0,5,5
2008,Cote d'Ivoire,CIV,Pakistan,PAK,0,0,0,5,5
2008,Iran (Islamic Rep. of),IRN,Pakistan,PAK,13,0,17,11,41
2008,Iraq,IRQ,Pakistan,PAK,27,0,0,67,94
2008,Liberia,LBR,Pakistan,PAK,0,0,0,5,5
2008,Morocco,MAR,Pakistan,PAK,0,0,0,5,5
2008,Niger,NER,Pakistan,PAK,0,0,0,5,5
2008,Nigeria,NGA,Pakistan,PAK,0,0,0,98,98
2008,Sierra Leone,SLE,Pakistan,PAK,0,0,0,14,14
2008,Somalia,SOM,Pakistan,PAK,158,0,0,17,175
2008,United Rep. of Tanzania,TZA,Pakistan,PAK,0,0,0,21,21
2008,Zimbabwe,ZWE,Pakistan,PAK,0,0,0,5,5
2008,Eritrea,ERI,Sudan,SDN,110,0,0,0,110
2008,Ethiopia,ETH,Sudan,SDN,132,0,0,0,132
2008,Palestinian,PSE,Sudan,SDN,0,5,0,0,5
2008,Somalia,SOM,Sudan,SDN,5,0,0,17,22
2008,Gambia,GMB,Trinidad and Tobago,TTO,0,0,0,5,5
2008,Ghana,GHA,Trinidad and Tobago,TTO,0,0,5,0,5
2008,Cote d'Ivoire,CIV,Trinidad and Tobago,TTO,0,0,0,5,5
2008,Liberia,LBR,Trinidad and Tobago,TTO,0,0,0,16,16
2008,Nigeria,NGA,Trinidad and Tobago,TTO,0,0,0,5,5
2008,Senegal,SEN,Trinidad and Tobago,TTO,0,0,14,0,14
2008,Somalia,SOM,Trinidad and Tobago,TTO,5,0,0,0,5
2008,Guinea,GIN,Tunisia,TUN,0,0,5,5,10
2008,Cote d'Ivoire,CIV,Tunisia,TUN,0,0,14,31,45
2008,Liberia,LBR,Tunisia,TUN,0,0,5,5,10
2008,Egypt,EGY,United Arab Emirates,ARE,0,0,5,0,5
2008,Iran (Islamic Rep. of),IRN,United Arab Emirates,ARE,13,0,0,0,13
2008,Iraq,IRQ,United Arab Emirates,ARE,90,5,0,0,95
2008,Russian Federation,RUS,United Arab Emirates,ARE,0,0,5,0,5
2008,Sudan,SDN,United Arab Emirates,ARE,5,0,0,0,5
2008,Eritrea,ERI,Yemen,YEM,192,0,31,12,235
2008,Ethiopia,ETH,Yemen,YEM,173,0,308,224,705
2008,Palestinian,PSE,Yemen,YEM,77,0,0,0,77
2008,Iran (Islamic Rep. of),IRN,Yemen,YEM,5,0,0,0,5
2008,Iraq,IRQ,Yemen,YEM,928,0,0,106,1034
2008,Sudan,SDN,Yemen,YEM,10,0,35,13,58
2008,Syrian Arab Rep.,SYR,Yemen,YEM,0,0,5,0,5
2008,Stateless,XXA,Yemen,YEM,5,0,0,0,5
2009,Palestinian,PSE,Bangladesh,BGD,5,0,0,0,5
2009,Sri Lanka,LKA,Bangladesh,BGD,5,0,0,0,5
2009,Myanmar,MMR,Bangladesh,BGD,18,0,15,0,33
2009,Pakistan,PAK,Bangladesh,BGD,0,0,5,0,5
2009,Somalia,SOM,Bangladesh,BGD,10,0,0,0,10
2009,Palestinian,PSE,China,CHN,0,0,5,0,5
2009,Iraq,IRQ,China,CHN,10,0,0,5,15
2009,Pakistan,PAK,China,CHN,16,0,0,0,16
2009,Yemen,YEM,China,CHN,0,0,5,0,5
2009,Burundi,BDI,Cameroon,CMR,5,0,0,0,5
2009,Burkina Faso,BFA,Cameroon,CMR,0,0,0,5,5
2009,Central African Rep.,CAF,Cameroon,CMR,1238,0,92,485,1815
2009,Chad,TCD,Cameroon,CMR,358,0,249,534,1141
2009,Congo,COG,Cameroon,CMR,12,0,5,5,22
2009,Dem. Rep. of the Congo,COD,Cameroon,CMR,78,0,138,86,302
2009,Gabon,GAB,Cameroon,CMR,0,0,0,5,5
2009,Guinea-Bissau,GNB,Cameroon,CMR,0,0,10,25,35
2009,Guinea,GIN,Cameroon,CMR,5,0,21,130,156
2009,Cote d'Ivoire,CIV,Cameroon,CMR,0,0,28,140,168
2009,Liberia,LBR,Cameroon,CMR,0,0,0,5,5
2009,Mauritania,MRT,Cameroon,CMR,0,0,5,0,5
2009,Mali,MLI,Cameroon,CMR,0,0,0,5,5
2009,Rwanda,RWA,Cameroon,CMR,49,0,63,11,123
2009,Sierra Leone,SLE,Cameroon,CMR,0,0,0,5,5
2009,Sudan,SDN,Cameroon,CMR,5,0,0,13,18
2009,Togo,TGO,Cameroon,CMR,0,0,0,5,5
2009,Colombia,COL,Cuba,CUB,5,0,0,0,5
2009,Ethiopia,ETH,Cuba,CUB,0,0,5,0,5
2009,Cuba,CUB,Haiti,HTI,0,0,0,10,10
2009,Myanmar,MMR,Sri Lanka,LKA,0,0,0,5,5
2009,Pakistan,PAK,Sri Lanka,LKA,59,0,40,93,192
2009,Afghanistan,AFG,Malaysia,MYS,211,0,70,0,281
2009,Bangladesh,BGD,Malaysia,MYS,0,0,5,5,10
2009,Cambodia,KHM,Malaysia,MYS,5,5,20,0,30
2009,China,CHN,Malaysia,MYS,13,0,5,0,18
2009,Cameroon,CMR,Malaysia,MYS,0,0,10,5,15
2009,Dem. Rep. of the Congo,COD,Malaysia,MYS,0,0,0,11,11
2009,Palestinian,PSE,Malaysia,MYS,53,0,0,15,68
2009,Guinea,GIN,Malaysia,MYS,0,0,5,0,5
2009,Cote d'Ivoire,CIV,Malaysia,MYS,0,0,10,0,10
2009,India,IND,Malaysia,MYS,0,0,0,5,5
2009,Indonesia,IDN,Malaysia,MYS,13,153,57,60,283
2009,Iran (Islamic Rep. of),IRN,Malaysia,MYS,5,0,13,0,18
2009,Iraq,IRQ,Malaysia,MYS,127,0,0,86,213
2009,Liberia,LBR,Malaysia,MYS,0,0,11,0,11
2009,Sri Lanka,LKA,Malaysia,MYS,984,0,93,228,1305
2009,Myanmar,MMR,Malaysia,MYS,33802,0,411,2084,36297
2009,Nepal,NPL,Malaysia,MYS,0,0,17,25,42
2009,Nigeria,NGA,Malaysia,MYS,0,0,5,0,5
2009,Pakistan,PAK,Malaysia,MYS,0,0,26,5,31
2009,Somalia,SOM,Malaysia,MYS,283,0,20,56,359
2009,Viet Nam,VNM,Malaysia,MYS,0,0,10,5,15
2009,Sudan,SDN,Malaysia,MYS,25,0,0,0,25
2009,Thailand,THA,Malaysia,MYS,5,0,0,28,33
2009,China,CHN,Mongolia,MNG,0,0,0,5,5
2009,Afghanistan,AFG,Pakistan,PAK,380,0,122,1022,1524
2009,Bangladesh,BGD,Pakistan,PAK,0,0,0,5,5
2009,Bosnia and Herzegovina,BIH,Pakistan,PAK,0,0,0,5,5
2009,China,CHN,Pakistan,PAK,0,0,0,5,5
2009,Palestinian,PSE,Pakistan,PAK,0,0,0,10,10
2009,Iran (Islamic Rep. of),IRN,Pakistan,PAK,5,0,11,0,16
2009,Iraq,IRQ,Pakistan,PAK,15,0,5,5,25
2009,Jordan,JOR,Pakistan,PAK,0,0,0,5,5
2009,Kenya,KEN,Pakistan,PAK,0,0,0,5,5
2009,Sri Lanka,LKA,Pakistan,PAK,5,0,0,5,10
2009,Somalia,SOM,Pakistan,PAK,80,0,10,107,197
2009,Turkmenistan,TKM,Pakistan,PAK,0,0,0,5,5
2009,Turkey,TUR,Pakistan,PAK,5,0,0,0,5
2009,Uzbekistan,UZB,Pakistan,PAK,0,0,0,5,5
2009,Cameroon,CMR,Trinidad and Tobago,TTO,0,0,5,0,5
2009,Ethiopia,ETH,Trinidad and Tobago,TTO,0,0,0,5,5
2009,Ghana,GHA,Trinidad and Tobago,TTO,0,0,0,11,11
2009,Iran (Islamic Rep. of),IRN,Trinidad and Tobago,TTO,5,0,0,0,5
2009,Liberia,LBR,Trinidad and Tobago,TTO,0,0,0,5,5
2009,Nigeria,NGA,Trinidad and Tobago,TTO,0,0,5,13,18
2009,Senegal,SEN,Trinidad and Tobago,TTO,0,0,5,0,5
2009,Guinea,GIN,Tunisia,TUN,0,0,5,0,5
2009,Cote d'Ivoire,CIV,Tunisia,TUN,5,0,17,32,54
2009,Palestinian,PSE,United Arab Emirates,ARE,29,0,0,0,29
2009,Iran (Islamic Rep. of),IRN,United Arab Emirates,ARE,0,0,12,0,12
2009,Iraq,IRQ,United Arab Emirates,ARE,139,0,0,0,139
2009,Libya,LBY,United Arab Emirates,ARE,0,0,5,0,5
2009,Russian Federation,RUS,United Arab Emirates,ARE,0,0,5,0,5
2009,Sudan,SDN,United Arab Emirates,ARE,0,0,5,0,5
2009,Eritrea,ERI,Yemen,YEM,157,0,5,5,167
2009,Ethiopia,ETH,Yemen,YEM,908,0,129,42,1079
2009,Palestinian,PSE,Yemen,YEM,86,0,0,21,107
2009,Iraq,IRQ,Yemen,YEM,376,0,0,154,530
2009,Liberia,LBR,Yemen,YEM,0,0,0,10,10
2009,Sudan,SDN,Yemen,YEM,18,0,0,5,23
2009,Syrian Arab Rep.,SYR,Yemen,YEM,19,0,0,0,19
2009,Tunisia,TUN,Yemen,YEM,0,0,0,14,14
2010,Palestinian,PSE,China,CHN,5,0,0,0,5
2010,Iraq,IRQ,China,CHN,5,0,0,0,5
2010,Pakistan,PAK,China,CHN,11,0,22,26,59
2010,Somalia,SOM,China,CHN,5,0,0,5,10
2010,Eritrea,ERI,Cuba,CUB,5,0,0,5,10
2010,Ethiopia,ETH,Cuba,CUB,0,0,0,5,5
2010,Afghanistan,AFG,Indonesia,IDN,330,0,0,2398,2728
2010,China,CHN,Indonesia,IDN,5,0,0,0,5
2010,Palestinian,PSE,Indonesia,IDN,0,0,0,12,12
2010,Guinea,GIN,Indonesia,IDN,0,0,5,5,10
2010,Iran (Islamic Rep. of),IRN,Indonesia,IDN,31,0,5,69,105
2010,Iraq,IRQ,Indonesia,IDN,25,0,0,305,330
2010,Sri Lanka,LKA,Indonesia,IDN,184,0,5,135,324
2010,Myanmar,MMR,Indonesia,IDN,38,0,0,5,43
2010,Pakistan,PAK,Indonesia,IDN,0,0,5,0,5
2010,Somalia,SOM,Indonesia,IDN,22,0,0,5,27
2010,Syrian Arab Rep.,SYR,Indonesia,IDN,0,0,0,5,5
2010,Afghanistan,AFG,Kyrgyzstan,KGZ,146,0,12,16,174
2010,China,CHN,Kyrgyzstan,KGZ,5,0,0,0,5
2010,Syrian Arab Rep.,SYR,Kyrgyzstan,KGZ,10,0,0,0,10
2010,Uzbekistan,UZB,Kyrgyzstan,KGZ,119,0,0,5,124
2010,Afghanistan,AFG,Sri Lanka,LKA,0,0,5,0,5
2010,Pakistan,PAK,Sri Lanka,LKA,54,0,98,145,297
2010,Afghanistan,AFG,Pakistan,PAK,261,0,309,558,1128
2010,China,CHN,Pakistan,PAK,5,0,0,0,5
2010,Indonesia,IDN,Pakistan,PAK,0,0,0,5,5
2010,Iran (Islamic Rep. of),IRN,Pakistan,PAK,19,0,20,0,39
2010,Iraq,IRQ,Pakistan,PAK,0,0,0,12,12
2010,Somalia,SOM,Pakistan,PAK,51,0,5,34,90
2010,Algeria,DZA,Tunisia,TUN,0,0,5,0,5
2010,Dem. Rep. of the Congo,COD,Tunisia,TUN,0,0,5,0,5
2010,Guinea,GIN,Tunisia,TUN,0,0,5,13,18
2010,Cote d'Ivoire,CIV,Tunisia,TUN,0,0,10,18,28
2010,Iraq,IRQ,Tunisia,TUN,0,0,0,5,5
2010,Rwanda,RWA,Tunisia,TUN,5,0,0,0,5
2010,Palestinian,PSE,United Arab Emirates,ARE,10,0,0,0,10
2010,Iran (Islamic Rep. of),IRN,United Arab Emirates,ARE,12,0,0,0,12
2010,Iraq,IRQ,United Arab Emirates,ARE,348,0,0,5,353
2010,Pakistan,PAK,United Arab Emirates,ARE,5,0,0,5,10
2010,Somalia,SOM,United Arab Emirates,ARE,5,0,0,0,5
2010,Sudan,SDN,United Arab Emirates,ARE,0,0,12,0,12
2010,Syrian Arab Rep.,SYR,United Arab Emirates,ARE,11,0,5,5,21
2010,Egypt,EGY,Yemen,YEM,14,0,0,0,14
2010,Eritrea,ERI,Yemen,YEM,167,0,0,31,198
2010,Ethiopia,ETH,Yemen,YEM,769,0,448,540,1757
2010,Palestinian,PSE,Yemen,YEM,42,0,0,20,62
2010,Iran (Islamic Rep. of),IRN,Yemen,YEM,11,0,0,0,11
2010,Iraq,IRQ,Yemen,YEM,61,83,5,311,460
2010,Jordan,JOR,Yemen,YEM,5,0,0,0,5
2010,Sudan,SDN,Yemen,YEM,5,0,10,12,27
2010,Syrian Arab Rep.,SYR,Yemen,YEM,12,0,0,0,12
2011,Iran (Islamic Rep. of),IRN,Afghanistan,AFG,5,0,0,5,10
2011,Pakistan,PAK,Afghanistan,AFG,20,0,0,5,25
2011,Palestinian,PSE,China,CHN,5,0,0,5,10
2011,Iran (Islamic Rep. of),IRN,China,CHN,0,0,0,5,5
2011,Iraq,IRQ,China,CHN,0,0,0,13,13
2011,Pakistan,PAK,China,CHN,36,0,50,5,91
2011,Somalia,SOM,China,CHN,14,5,0,0,19
2011,Central African Rep.,CAF,Cameroon,CMR,468,0,160,181,809
2011,Chad,TCD,Cameroon,CMR,52,0,128,120,300
2011,Congo,COG,Cameroon,CMR,5,0,5,0,10
2011,Dem. Rep. of the Congo,COD,Cameroon,CMR,20,0,87,23,130
2011,Equatorial Guinea,GNQ,Cameroon,CMR,10,0,0,0,10
2011,Eritrea,ERI,Cameroon,CMR,5,0,0,0,5
2011,Ghana,GHA,Cameroon,CMR,0,0,5,0,5
2011,Guinea-Bissau,GNB,Cameroon,CMR,0,0,5,13,18
2011,Guinea,GIN,Cameroon,CMR,0,0,48,267,315
2011,Cote d'Ivoire,CIV,Cameroon,CMR,71,0,0,28,99
2011,Liberia,LBR,Cameroon,CMR,0,0,5,0,5
2011,Mauritania,MRT,Cameroon,CMR,0,0,0,5,5
2011,Rwanda,RWA,Cameroon,CMR,29,0,70,14,113
2011,Senegal,SEN,Cameroon,CMR,0,0,11,0,11
2011,Sierra Leone,SLE,Cameroon,CMR,0,0,0,5,5
2011,Sudan,SDN,Cameroon,CMR,16,0,0,5,21
2011,Togo,TGO,Cameroon,CMR,0,0,0,5,5
2011,Eritrea,ERI,Cuba,CUB,5,0,0,0,5
2011,Iran (Islamic Rep. of),IRN,Cuba,CUB,5,0,0,0,5
2011,Syrian Arab Rep.,SYR,Cyprus,CYP,0,0,0,15,15
2011,Afghanistan,AFG,Indonesia,IDN,388,0,11,1277,1676
2011,Algeria,DZA,Indonesia,IDN,0,0,0,5,5
2011,China,CHN,Indonesia,IDN,15,0,0,0,15
2011,Cameroon,CMR,Indonesia,IDN,0,0,0,17,17
2011,Dem. Rep. of the Congo,COD,Indonesia,IDN,0,0,0,5,5
2011,Gambia,GMB,Indonesia,IDN,0,0,0,5,5
2011,Palestinian,PSE,Indonesia,IDN,0,0,0,5,5
2011,Guinea,GIN,Indonesia,IDN,0,0,5,5,10
2011,Iran (Islamic Rep. of),IRN,Indonesia,IDN,47,0,5,223,275
2011,Iraq,IRQ,Indonesia,IDN,41,0,5,415,461
2011,Kuwait,KWT,Indonesia,IDN,0,0,0,5,5
2011,Sri Lanka,LKA,Indonesia,IDN,47,0,0,98,145
2011,Morocco,MAR,Indonesia,IDN,0,0,0,5,5
2011,Myanmar,MMR,Indonesia,IDN,55,0,0,92,147
2011,Pakistan,PAK,Indonesia,IDN,5,0,0,56,61
2011,Senegal,SEN,Indonesia,IDN,0,0,0,5,5
2011,Somalia,SOM,Indonesia,IDN,36,0,0,5,41
2011,Thailand,THA,Indonesia,IDN,5,0,0,0,5
2011,Afghanistan,AFG,Jordan,JOR,5,0,20,23,48
2011,Egypt,EGY,Jordan,JOR,10,0,70,26,106
2011,Bangladesh,BGD,Jordan,JOR,0,0,5,0,5
2011,Dem. Rep. of the Congo,COD,Jordan,JOR,0,0,10,0,10
2011,Eritrea,ERI,Jordan,JOR,5,0,0,0,5
2011,India,IND,Jordan,JOR,0,0,0,12,12
2011,Iraq,IRQ,Jordan,JOR,201,0,331,506,1038
2011,Libya,LBY,Jordan,JOR,0,0,0,10,10
2011,Lebanon,LBN,Jordan,JOR,0,0,0,5,5
2011,Sri Lanka,LKA,Jordan,JOR,0,0,5,15,20
2011,Morocco,MAR,Jordan,JOR,0,0,11,0,11
2011,Pakistan,PAK,Jordan,JOR,0,0,15,0,15
2011,Philippines,PHL,Jordan,JOR,0,0,5,0,5
2011,Romania,ROU,Jordan,JOR,0,0,5,0,5
2011,Russian Federation,RUS,Jordan,JOR,0,0,0,5,5
2011,Somalia,SOM,Jordan,JOR,40,0,10,22,72
2011,Sudan,SDN,Jordan,JOR,99,0,54,113,266
2011,Syrian Arab Rep.,SYR,Jordan,JOR,5,0,28,34,67
2011,Tunisia,TUN,Jordan,JOR,12,0,0,0,12
2011,Yemen,YEM,Jordan,JOR,0,0,16,16,32
2011,Afghanistan,AFG,Kyrgyzstan,KGZ,30,0,41,18,89
2011,China,CHN,Kyrgyzstan,KGZ,0,0,0,5,5
2011,Kazakhstan,KAZ,Kyrgyzstan,KGZ,0,0,5,11,16
2011,Uzbekistan,UZB,Kyrgyzstan,KGZ,116,0,5,17,138
2011,Pakistan,PAK,Sri Lanka,LKA,22,0,75,0,97
2011,Central African Rep.,CAF,Mauritania,MRT,0,0,5,0,5
2011,Cameroon,CMR,Mauritania,MRT,0,0,5,11,16
2011,Dem. Rep. of the Congo,COD,Mauritania,MRT,12,0,16,49,77
2011,Guinea,GIN,Mauritania,MRT,0,0,5,45,50
2011,Cote d'Ivoire,CIV,Mauritania,MRT,21,0,0,117,138
2011,Liberia,LBR,Mauritania,MRT,0,0,0,23,23
2011,Nigeria,NGA,Mauritania,MRT,0,0,0,5,5
2011,Senegal,SEN,Mauritania,MRT,12,0,0,0,12
2011,Togo,TGO,Mauritania,MRT,0,0,5,0,5
2011,Afghanistan,AFG,Pakistan,PAK,395,0,282,674,1351
2011,Egypt,EGY,Pakistan,PAK,0,0,0,5,5
2011,Iran (Islamic Rep. of),IRN,Pakistan,PAK,10,0,10,13,33
2011,Iraq,IRQ,Pakistan,PAK,5,0,0,0,5
2011,Somalia,SOM,Pakistan,PAK,23,0,0,30,53
2011,Central African Rep.,CAF,Tunisia,TUN,5,0,0,0,5
2011,Chad,TCD,Tunisia,TUN,18,0,81,0,99
2011,Congo,COG,Tunisia,TUN,5,0,0,0,5
2011,Dem. Rep. of the Congo,COD,Tunisia,TUN,5,0,0,0,5
2011,Eritrea,ERI,Tunisia,TUN,981,0,5,56,1042
2011,Ethiopia,ETH,Tunisia,TUN,256,0,34,0,290
2011,Gambia,GMB,Tunisia,TUN,0,0,5,0,5
2011,Palestinian,PSE,Tunisia,TUN,21,0,0,0,21
2011,Ghana,GHA,Tunisia,TUN,0,0,10,0,10
2011,Guinea,GIN,Tunisia,TUN,0,0,5,0,5
2011,Cote d'Ivoire,CIV,Tunisia,TUN,16,0,32,0,48
2011,Iraq,IRQ,Tunisia,TUN,317,0,0,0,317
2011,Liberia,LBR,Tunisia,TUN,5,0,5,0,10
2011,Mali,MLI,Tunisia,TUN,5,0,10,0,15
2011,Morocco,MAR,Tunisia,TUN,5,0,5,0,10
2011,Nigeria,NGA,Tunisia,TUN,5,0,42,0,47
2011,Pakistan,PAK,Tunisia,TUN,13,0,0,0,13
2011,Somalia,SOM,Tunisia,TUN,1052,0,14,0,1066
2011,Sudan,SDN,Tunisia,TUN,869,0,76,0,945
2011,Syrian Arab Rep.,SYR,Tunisia,TUN,5,0,0,0,5
2011,Afghanistan,AFG,United Arab Emirates,ARE,0,0,5,16,21
2011,Ethiopia,ETH,United Arab Emirates,ARE,0,0,0,5,5
2011,Iran (Islamic Rep. of),IRN,United Arab Emirates,ARE,13,0,0,0,13
2011,Iraq,IRQ,United Arab Emirates,ARE,185,5,0,0,190
2011,Sudan,SDN,United Arab Emirates,ARE,0,0,5,0,5
2011,Syrian Arab Rep.,SYR,United Arab Emirates,ARE,0,0,0,14,14
2011,Tunisia,TUN,United Arab Emirates,ARE,0,0,0,10,10
2011,Algeria,DZA,Yemen,YEM,0,0,0,5,5
2011,Egypt,EGY,Yemen,YEM,0,0,0,5,5
2011,Dem. Rep. of the Congo,COD,Yemen,YEM,0,0,0,5,5
2011,Eritrea,ERI,Yemen,YEM,109,0,5,19,133
2011,Ethiopia,ETH,Yemen,YEM,966,0,518,101,1585
2011,Palestinian,PSE,Yemen,YEM,70,0,0,134,204
2011,Greece,GRC,Yemen,YEM,0,0,0,5,5
2011,Iraq,IRQ,Yemen,YEM,33,0,5,0,38
2011,Jordan,JOR,Yemen,YEM,5,0,0,5,10
2011,Russian Federation,RUS,Yemen,YEM,0,0,0,5,5
2011,Sudan,SDN,Yemen,YEM,5,0,0,0,5
2011,Syrian Arab Rep.,SYR,Yemen,YEM,5,0,0,22,27
2012,Iran (Islamic Rep. of),IRN,Afghanistan,AFG,0,0,13,0,13
2012,Pakistan,PAK,Afghanistan,AFG,5,0,0,0,5
2012,Iraq,IRQ,China,CHN,5,0,0,0,5
2012,Pakistan,PAK,China,CHN,5,5,0,0,10
2012,Rwanda,RWA,China,CHN,5,0,0,0,5
2012,Somalia,SOM,China,CHN,32,5,0,5,42
2012,Burundi,BDI,Cameroon,CMR,0,0,0,5,5
2012,Burkina Faso,BFA,Cameroon,CMR,0,0,0,12,12
2012,Central African Rep.,CAF,Cameroon,CMR,69,0,261,1220,1550
2012,Chad,TCD,Cameroon,CMR,15,0,80,277,372
2012,Congo,COG,Cameroon,CMR,0,0,5,12,17
2012,Dem. Rep. of the Congo,COD,Cameroon,CMR,13,0,39,107,159
2012,Equatorial Guinea,GNQ,Cameroon,CMR,5,0,0,0,5
2012,Gambia,GMB,Cameroon,CMR,0,0,0,32,32
2012,Ghana,GHA,Cameroon,CMR,0,0,0,5,5
2012,Guinea-Bissau,GNB,Cameroon,CMR,0,0,0,38,38
2012,Guinea,GIN,Cameroon,CMR,0,0,48,613,661
2012,Cote d'Ivoire,CIV,Cameroon,CMR,20,0,5,181,206
2012,Liberia,LBR,Cameroon,CMR,0,0,0,10,10
2012,Sri Lanka,LKA,Cameroon,CMR,0,0,0,5,5
2012,Mali,MLI,Cameroon,CMR,0,0,0,15,15
2012,Niger,NER,Cameroon,CMR,0,0,0,5,5
2012,Nigeria,NGA,Cameroon,CMR,0,0,0,10,10
2012,Rwanda,RWA,Cameroon,CMR,12,0,84,10,106
2012,Senegal,SEN,Cameroon,CMR,0,0,21,323,344
2012,Sierra Leone,SLE,Cameroon,CMR,0,0,0,10,10
2012,Somalia,SOM,Cameroon,CMR,0,0,0,5,5
2012,Sudan,SDN,Cameroon,CMR,18,0,0,33,51
2012,Togo,TGO,Cameroon,CMR,0,0,0,5,5
2012,Syrian Arab Rep.,SYR,Cuba,CUB,60,0,0,0,60
2012,Iran (Islamic Rep. of),IRN,Cyprus,CYP,0,0,0,10,10
2012,Pakistan,PAK,Cyprus,CYP,0,0,0,5,5
2012,Sierra Leone,SLE,Cyprus,CYP,0,0,0,10,10
2012,Syrian Arab Rep.,SYR,Cyprus,CYP,0,0,0,45,45
2012,Afghanistan,AFG,Indonesia,IDN,654,0,33,2023,2710
2012,Egypt,EGY,Indonesia,IDN,0,0,0,11,11
2012,China,CHN,Indonesia,IDN,5,0,0,0,5
2012,Cameroon,CMR,Indonesia,IDN,0,0,5,5,10
2012,Dem. Rep. of the Congo,COD,Indonesia,IDN,0,0,5,0,5
2012,Ethiopia,ETH,Indonesia,IDN,5,0,0,0,5
2012,Gambia,GMB,Indonesia,IDN,0,0,0,5,5
2012,Palestinian,PSE,Indonesia,IDN,12,0,0,110,122
2012,Cote d'Ivoire,CIV,Indonesia,IDN,0,0,5,0,5
2012,India,IND,Indonesia,IDN,0,0,0,5,5
2012,Iran (Islamic Rep. of),IRN,Indonesia,IDN,100,0,5,236,341
2012,Iraq,IRQ,Indonesia,IDN,101,0,11,183,295
2012,Kuwait,KWT,Indonesia,IDN,0,0,0,5,5
2012,Libya,LBY,Indonesia,IDN,0,0,0,5,5
2012,Sri Lanka,LKA,Indonesia,IDN,68,0,5,199,272
2012,Myanmar,MMR,Indonesia,IDN,145,0,0,5,150
2012,Pakistan,PAK,Indonesia,IDN,17,0,5,226,248
2012,Philippines,PHL,Indonesia,IDN,5,0,0,0,5
2012,Senegal,SEN,Indonesia,IDN,0,0,0,5,5
2012,Sierra Leone,SLE,Indonesia,IDN,0,0,5,0,5
2012,Somalia,SOM,Indonesia,IDN,101,0,0,5,106
2012,Sudan,SDN,Indonesia,IDN,5,0,0,0,5
2012,Syrian Arab Rep.,SYR,Indonesia,IDN,5,0,0,5,10
2012,Egypt,EGY,Jordan,JOR,0,0,175,0,175
2012,Chad,TCD,Jordan,JOR,0,0,5,0,5
2012,Eritrea,ERI,Jordan,JOR,5,0,0,5,10
2012,Germany,DEU,Jordan,JOR,0,0,0,5,5
2012,Iraq,IRQ,Jordan,JOR,680,0,420,461,1561
2012,Kuwait,KWT,Jordan,JOR,0,0,0,5,5
2012,Libya,LBY,Jordan,JOR,0,0,0,36,36
2012,Sri Lanka,LKA,Jordan,JOR,0,0,5,0,5
2012,Morocco,MAR,Jordan,JOR,0,0,0,5,5
2012,Pakistan,PAK,Jordan,JOR,0,0,5,5,10
2012,Philippines,PHL,Jordan,JOR,0,0,5,0,5
2012,Somalia,SOM,Jordan,JOR,144,0,20,17,181
2012,Sudan,SDN,Jordan,JOR,102,0,134,29,265
2012,Syrian Arab Rep.,SYR,Jordan,JOR,12,0,13,2102,2127
2012,Tunisia,TUN,Jordan,JOR,0,0,0,5,5
2012,Yemen,YEM,Jordan,JOR,5,0,105,5,115
2012,Afghanistan,AFG,Kyrgyzstan,KGZ,5,0,16,19,40
2012,China,CHN,Kyrgyzstan,KGZ,0,0,0,5,5
2012,Kazakhstan,KAZ,Kyrgyzstan,KGZ,0,0,0,10,10
2012,Syrian Arab Rep.,SYR,Kyrgyzstan,KGZ,0,0,0,5,5
2012,Uzbekistan,UZB,Kyrgyzstan,KGZ,13,0,0,5,18
2012,Eritrea,ERI,Kuwait,KWT,0,0,0,5,5
2012,Iran (Islamic Rep. of),IRN,Kuwait,KWT,0,0,10,10,20
2012,Iraq,IRQ,Kuwait,KWT,78,0,0,381,459
2012,Jordan,JOR,Kuwait,KWT,0,0,0,5,5
2012,Somalia,SOM,Kuwait,KWT,29,0,0,22,51
2012,Syrian Arab Rep.,SYR,Kuwait,KWT,0,0,0,5,5
2012,Afghanistan,AFG,Sri Lanka,LKA,5,0,0,0,5
2012,Pakistan,PAK,Sri Lanka,LKA,88,0,17,22,127
2012,Somalia,SOM,Sri Lanka,LKA,0,0,0,5,5
2012,Dem. Rep. of the Congo,COD,Mauritania,MRT,0,0,53,0,53
2012,Cote d'Ivoire,CIV,Mauritania,MRT,5,14,0,0,19
2012,Senegal,SEN,Mauritania,MRT,5,0,0,0,5
2012,Afghanistan,AFG,Pakistan,PAK,1653,0,374,206,2233
2012,Iran (Islamic Rep. of),IRN,Pakistan,PAK,13,0,0,0,13
2012,Somalia,SOM,Pakistan,PAK,12,0,0,10,22
2012,Pakistan,PAK,Singapore,SGP,5,0,0,0,5
2012,Palestinian,PSE,United Arab Emirates,ARE,0,0,0,5,5
2012,Iraq,IRQ,United Arab Emirates,ARE,126,13,0,0,139
2012,Sri Lanka,LKA,United Arab Emirates,ARE,41,0,5,0,46
2012,Syrian Arab Rep.,SYR,United Arab Emirates,ARE,5,0,0,0,5
2012,Afghanistan,AFG,Ukraine,UKR,11,0,0,52,63
2012,Angola,AGO,Ukraine,UKR,0,0,0,5,5
2012,Azerbaijan,AZE,Ukraine,UKR,0,0,0,5,5
2012,Cameroon,CMR,Ukraine,UKR,0,0,0,5,5
2012,Dem. Rep. of the Congo,COD,Ukraine,UKR,5,0,0,0,5
2012,Georgia,GEO,Ukraine,UKR,0,0,0,5,5
2012,Iran (Islamic Rep. of),IRN,Ukraine,UKR,0,0,0,10,10
2012,Iraq,IRQ,Ukraine,UKR,5,0,0,5,10
2012,Kyrgyzstan,KGZ,Ukraine,UKR,12,0,0,0,12
2012,Sri Lanka,LKA,Ukraine,UKR,0,0,0,10,10
2012,Russian Federation,RUS,Ukraine,UKR,5,0,0,0,5
2012,Somalia,SOM,Ukraine,UKR,5,0,0,0,5
2012,Uzbekistan,UZB,Ukraine,UKR,13,0,5,0,18
2012,Congo,COG,Yemen,YEM,5,0,0,0,5
2012,Dem. Rep. of the Congo,COD,Yemen,YEM,0,0,0,5,5
2012,Comoros,COM,Yemen,YEM,0,0,0,5,5
2012,Eritrea,ERI,Yemen,YEM,255,0,0,87,342
2012,Ethiopia,ETH,Yemen,YEM,593,0,156,1516,2265
2012,Palestinian,PSE,Yemen,YEM,5,0,0,26,31
2012,Iran (Islamic Rep. of),IRN,Yemen,YEM,0,0,0,5,5
2012,Iraq,IRQ,Yemen,YEM,26,0,0,75,101
2012,Sudan,SDN,Yemen,YEM,0,0,0,22,22
2012,Syrian Arab Rep.,SYR,Yemen,YEM,0,0,0,5,5
2013,Chad,TCD,Egypt,EGY,11,0,0,0,11
2013,Dem. Rep. of the Congo,COD,Egypt,EGY,0,0,5,0,5
2013,Eritrea,ERI,Egypt,EGY,554,0,14,0,568
2013,Ethiopia,ETH,Egypt,EGY,369,0,97,5,471
2013,Palestinian,PSE,Egypt,EGY,0,0,0,5,5
2013,Guinea,GIN,Egypt,EGY,5,0,0,0,5
2013,Cote d'Ivoire,CIV,Egypt,EGY,17,0,0,0,17
2013,Iraq,IRQ,Egypt,EGY,159,0,0,17,176
2013,Nigeria,NGA,Egypt,EGY,0,0,0,5,5
2013,Somalia,SOM,Egypt,EGY,503,0,38,17,558
2013,Sudan,SDN,Egypt,EGY,2329,0,164,0,2493
2013,South Sudan,SSD,Egypt,EGY,168,0,5,0,173
2013,Tajikistan,TJK,Egypt,EGY,5,0,0,0,5
2013,Uganda,UGA,Egypt,EGY,5,0,0,0,5
2013,Uzbekistan,UZB,Egypt,EGY,0,0,0,12,12
2013,Yemen,YEM,Egypt,EGY,11,0,0,0,11
2013,Zimbabwe,ZWE,Egypt,EGY,5,0,0,0,5
2013,Iraq,IRQ,China,CHN,10,0,0,0,10
2013,Liberia,LBR,China,CHN,0,0,15,12,27
2013,Nigeria,NGA,China,CHN,0,0,5,0,5
2013,Somalia,SOM,China,CHN,41,0,30,25,96
2013,Uganda,UGA,China,CHN,0,0,0,5,5
2013,Syrian Arab Rep.,SYR,Cuba,CUB,25,0,0,0,25
2013,Ethiopia,ETH,Eritrea,ERI,5,0,0,0,5
2013,Sudan,SDN,Eritrea,ERI,5,0,0,0,5
2013,Yemen,YEM,Eritrea,ERI,5,0,0,0,5
2013,Egypt,EGY,Jordan,JOR,17,0,53,10,80
2013,Eritrea,ERI,Jordan,JOR,5,0,0,0,5
2013,Iran (Islamic Rep. of),IRN,Jordan,JOR,0,0,0,5,5
2013,Iraq,IRQ,Jordan,JOR,2117,0,277,800,3194
2013,Lebanon,LBN,Jordan,JOR,0,0,5,0,5
2013,Philippines,PHL,Jordan,JOR,5,0,0,0,5
2013,Somalia,SOM,Jordan,JOR,184,0,32,0,216
2013,Sudan,SDN,Jordan,JOR,129,0,52,126,307
2013,Syrian Arab Rep.,SYR,Jordan,JOR,800,0,0,491,1291
2013,Tunisia,TUN,Jordan,JOR,0,0,5,5,10
2013,Turkey,TUR,Jordan,JOR,5,0,0,0,5
2013,Yemen,YEM,Jordan,JOR,0,0,28,39,67
2013,Stateless,XXA,Jordan,JOR,0,0,0,10,10
2013,Afghanistan,AFG,Kyrgyzstan,KGZ,42,0,44,12,98
2013,China,CHN,Kyrgyzstan,KGZ,0,0,0,5,5
2013,Iran (Islamic Rep. of),IRN,Kyrgyzstan,KGZ,0,0,10,0,10
2013,Russian Federation,RUS,Kyrgyzstan,KGZ,0,0,0,5,5
2013,Uzbekistan,UZB,Kyrgyzstan,KGZ,14,0,5,21,40
2013,Afghanistan,AFG,Pakistan,PAK,2117,0,638,229,2984
2013,China,CHN,Pakistan,PAK,0,0,0,5,5
2013,Palestinian,PSE,Pakistan,PAK,5,0,0,0,5
2013,Iran (Islamic Rep. of),IRN,Pakistan,PAK,17,0,0,5,22
2013,Iraq,IRQ,Pakistan,PAK,5,0,0,0,5
2013,Somalia,SOM,Pakistan,PAK,43,0,10,0,53
2013,United Rep. of Tanzania,TZA,Pakistan,PAK,0,0,5,0,5
2013,Afghanistan,AFG,Tajikistan,TJK,57,0,53,17,127
2013,Pakistan,PAK,Tajikistan,TJK,0,0,0,11,11
2013,Afghanistan,AFG,United Arab Emirates,ARE,0,0,5,0,5
2013,Iran (Islamic Rep. of),IRN,United Arab Emirates,ARE,5,0,0,5,10
2013,Iraq,IRQ,United Arab Emirates,ARE,225,0,0,5,230
2013,Pakistan,PAK,United Arab Emirates,ARE,5,0,0,0,5
2013,Somalia,SOM,United Arab Emirates,ARE,10,0,0,0,10
2013,Sudan,SDN,United Arab Emirates,ARE,0,0,14,0,14
2013,Afghanistan,AFG,Ukraine,UKR,11,0,0,11,22
2013,Azerbaijan,AZE,Ukraine,UKR,12,0,0,0,12
2013,Dem. Rep. of the Congo,COD,Ukraine,UKR,10,0,0,0,10
2013,Palestinian,PSE,Ukraine,UKR,0,0,0,5,5
2013,Iran (Islamic Rep. of),IRN,Ukraine,UKR,0,0,0,11,11
2013,Iraq,IRQ,Ukraine,UKR,0,0,0,5,5
2013,Russian Federation,RUS,Ukraine,UKR,5,0,0,0,5
2013,Somalia,SOM,Ukraine,UKR,5,0,0,5,10
2013,Syrian Arab Rep.,SYR,Ukraine,UKR,0,0,0,5,5
2013,Uzbekistan,UZB,Ukraine,UKR,15,0,0,0,15
2014,Afghanistan,AFG,Cuba,CUB,5,0,0,0,5
2014,Iran (Islamic Rep. of),IRN,Cuba,CUB,5,0,0,0,5
2014,Syrian Arab Rep.,SYR,Cuba,CUB,5,0,0,0,5
2014,Burundi,BDI,Mauritania,MRT,0,0,0,5,5
2014,Central African Rep.,CAF,Mauritania,MRT,217,0,0,45,262
2014,Cameroon,CMR,Mauritania,MRT,0,0,14,5,19
2014,Congo,COG,Mauritania,MRT,0,0,0,13,13
2014,Dem. Rep. of the Congo,COD,Mauritania,MRT,5,0,27,19,51
2014,Palestinian,PSE,Mauritania,MRT,5,0,0,0,5
2014,Guinea,GIN,Mauritania,MRT,5,0,0,0,5
2014,Cote d'Ivoire,CIV,Mauritania,MRT,56,0,202,261,519
2014,Iraq,IRQ,Mauritania,MRT,5,0,0,0,5
2014,Liberia,LBR,Mauritania,MRT,0,0,0,5,5
2014,Mali,MLI,Mauritania,MRT,0,0,0,5,5
2014,Nigeria,NGA,Mauritania,MRT,0,0,0,14,14
2014,Senegal,SEN,Mauritania,MRT,26,0,33,0,59
2014,Somalia,SOM,Mauritania,MRT,5,0,0,0,5
2014,Sudan,SDN,Mauritania,MRT,5,0,0,0,5
2014,Syrian Arab Rep.,SYR,Mauritania,MRT,40,0,0,5,45
2014,Togo,TGO,Mauritania,MRT,0,0,0,13,13
2014,Afghanistan,AFG,United Arab Emirates,ARE,5,0,0,0,5
2014,Ethiopia,ETH,United Arab Emirates,ARE,10,0,0,0,10
2014,Iran (Islamic Rep. of),IRN,United Arab Emirates,ARE,5,0,0,0,5
2014,Iraq,IRQ,United Arab Emirates,ARE,85,0,0,0,85
2014,Somalia,SOM,United Arab Emirates,ARE,0,0,0,12,12
2014,Syrian Arab Rep.,SYR,United Arab Emirates,ARE,5,0,0,0,5
2015,Afghanistan,AFG,Cuba,CUB,12,0,5,0,17
2015,Eritrea,ERI,Cuba,CUB,16,0,0,0,16
2015,Ethiopia,ETH,Cuba,CUB,5,0,0,0,5
2015,Palestinian,PSE,Cuba,CUB,5,0,0,0,5
2015,Iran (Islamic Rep. of),IRN,Cuba,CUB,28,0,0,0,28
2015,Somalia,SOM,Cuba,CUB,5,0,0,0,5
2015,Syrian Arab Rep.,SYR,Cuba,CUB,21,0,0,5,26
2015,Yemen,YEM,Cuba,CUB,13,0,0,0,13
2015,Cameroon,CMR,Cyprus,CYP,0,0,5,0,5
2015,Guinea,GIN,Cyprus,CYP,0,0,5,0,5
2015,Cote d'Ivoire,CIV,Cyprus,CYP,0,0,5,0,5
2015,Iran (Islamic Rep. of),IRN,Cyprus,CYP,0,0,5,0,5
2015,Syrian Arab Rep.,SYR,Cyprus,CYP,54,0,0,0,54
2015,Togo,TGO,Cyprus,CYP,0,0,5,0,5
2015,Central African Rep.,CAF,Mauritania,MRT,203,0,23,0,226
2015,Cameroon,CMR,Mauritania,MRT,5,0,20,0,25
2015,Congo,COG,Mauritania,MRT,0,0,5,0,5
2015,Dem. Rep. of the Congo,COD,Mauritania,MRT,5,0,5,25,35
2015,Palestinian,PSE,Mauritania,MRT,18,0,0,0,18
2015,Guinea,GIN,Mauritania,MRT,0,0,10,0,10
2015,Cote d'Ivoire,CIV,Mauritania,MRT,5,0,136,24,165
2015,Iraq,IRQ,Mauritania,MRT,5,0,0,0,5
2015,Liberia,LBR,Mauritania,MRT,0,0,5,0,5
2015,Mali,MLI,Mauritania,MRT,0,0,5,0,5
2015,Nigeria,NGA,Mauritania,MRT,10,0,18,0,28
2015,Senegal,SEN,Mauritania,MRT,18,0,5,0,23
2015,Syrian Arab Rep.,SYR,Mauritania,MRT,186,0,0,0,186
2015,Togo,TGO,Mauritania,MRT,0,0,5,0,5
2015,Ukraine,UKR,Mauritania,MRT,5,0,0,0,5
2015,Western Sahara,ESH,Mauritania,MRT,5,0,0,0,5
2016,Afghanistan,AFG,Cuba,CUB,34,0,10,10,54
2016,Eritrea,ERI,Cuba,CUB,10,0,0,0,10
2016,Iran (Islamic Rep. of),IRN,Cuba,CUB,0,0,5,5,10
2016,Syrian Arab Rep.,SYR,Cuba,CUB,5,0,0,0,5
2017,Ethiopia,ETH,Eritrea,ERI,10,0,0,0,10
2017,Eritrea,ERI,Yemen,YEM,35,0,0,0,35
2017,Ethiopia,ETH,Yemen,YEM,388,0,0,34,422
2017,Palestinian,PSE,Yemen,YEM,44,0,0,5,49
2017,Iraq,IRQ,Yemen,YEM,12,0,0,5,17
2017,Sudan,SDN,Yemen,YEM,17,0,0,5,22
2017,Syrian Arab Rep.,SYR,Yemen,YEM,0,0,0,5,5
2018,Eritrea,ERI,Yemen,YEM,88,0,0,18,106
2018,Ethiopia,ETH,Yemen,YEM,167,0,0,2375,2542
2018,Palestinian,PSE,Yemen,YEM,0,0,0,24,24
2018,Somalia,SOM,Yemen,YEM,0,0,0,5,5
2018,Sudan,SDN,Yemen,YEM,0,0,0,5,5
2018,Syrian Arab Rep.,SYR,Yemen,YEM,0,0,0,90,90
2019,Eritrea,ERI,Yemen,YEM,0,0,0,11,11
2019,Ethiopia,ETH,Yemen,YEM,32,0,23,492,547
2019,Palestinian,PSE,Yemen,YEM,0,0,0,13,13
2019,Somalia,SOM,Yemen,YEM,0,0,0,5,5
2019,Sudan,SDN,Yemen,YEM,0,0,0,25,25
2001,Chad,TCD,Algeria,DZA,0,0,16,0,16
2001,Cameroon,CMR,Algeria,DZA,5,0,0,0,5
2001,Congo,COG,Algeria,DZA,0,0,12,0,12
2001,Dem. Rep. of the Congo,COD,Algeria,DZA,0,0,101,0,101
2001,Guinea,GIN,Algeria,DZA,0,0,35,0,35
2001,Iraq,IRQ,Algeria,DZA,5,0,0,0,5
2001,Liberia,LBR,Algeria,DZA,5,0,0,5,10
2001,Libya,LBY,Algeria,DZA,5,0,0,0,5
2001,Rwanda,RWA,Algeria,DZA,0,0,0,21,21
2001,Sierra Leone,SLE,Algeria,DZA,0,0,30,0,30
2001,Somalia,SOM,Algeria,DZA,0,0,14,0,14
2001,Sudan,SDN,Algeria,DZA,0,0,5,0,5
2001,Syrian Arab Rep.,SYR,Algeria,DZA,5,0,0,0,5
2001,Central African Rep.,CAF,Congo,COG,1585,0,0,0,1585
2001,Dem. Rep. of the Congo,COD,Congo,COG,105,0,100,0,205
2001,Angola,AGO,Dem. Rep. of the Congo,COD,10,195,37,0,242
2001,Burundi,BDI,Dem. Rep. of the Congo,COD,0,11,0,0,11
2001,Central African Rep.,CAF,Dem. Rep. of the Congo,COD,5,0,0,0,5
2001,Congo,COG,Dem. Rep. of the Congo,COD,12,0,35,0,47
2001,Iran (Islamic Rep. of),IRN,Dem. Rep. of the Congo,COD,0,0,0,5,5
2001,Liberia,LBR,Dem. Rep. of the Congo,COD,0,0,84,0,84
2001,Rwanda,RWA,Dem. Rep. of the Congo,COD,11,23,15,0,49
2001,Sierra Leone,SLE,Dem. Rep. of the Congo,COD,0,0,19,0,19
2001,Sudan,SDN,Dem. Rep. of the Congo,COD,20,0,0,0,20
2001,Tunisia,TUN,Sudan,SDN,5,0,0,0,5
2001,Afghanistan,AFG,Syrian Arab Rep.,SYR,38,0,87,36,161
2001,Algeria,DZA,Syrian Arab Rep.,SYR,0,0,11,5,16
2001,Azerbaijan,AZE,Syrian Arab Rep.,SYR,0,0,5,0,5
2001,Bahrain,BHR,Syrian Arab Rep.,SYR,0,0,5,0,5
2001,Eritrea,ERI,Syrian Arab Rep.,SYR,0,0,5,0,5
2001,Iran (Islamic Rep. of),IRN,Syrian Arab Rep.,SYR,5,0,50,41,96
2001,Iraq,IRQ,Syrian Arab Rep.,SYR,180,0,1054,494,1728
2001,Jordan,JOR,Syrian Arab Rep.,SYR,0,0,5,5,10
2001,Russian Federation,RUS,Syrian Arab Rep.,SYR,0,0,5,5,10
2001,Somalia,SOM,Syrian Arab Rep.,SYR,15,0,62,25,102
2001,Sudan,SDN,Syrian Arab Rep.,SYR,25,0,201,89,315
2001,Turkey,TUR,Syrian Arab Rep.,SYR,0,0,0,5,5
2001,Yemen,YEM,Syrian Arab Rep.,SYR,0,0,0,13,13
2001,Algeria,DZA,Tunisia,TUN,0,0,0,5,5
2001,Chad,TCD,Tunisia,TUN,0,0,0,5,5
2001,Iraq,IRQ,Tunisia,TUN,0,0,0,5,5
2001,Sierra Leone,SLE,Tunisia,TUN,0,0,0,5,5
2002,Cameroon,CMR,Algeria,DZA,5,0,0,0,5
2002,Congo,COG,Algeria,DZA,0,0,0,27,27
2002,Dem. Rep. of the Congo,COD,Algeria,DZA,0,0,0,58,58
2002,Guinea,GIN,Algeria,DZA,0,0,0,10,10
2002,Liberia,LBR,Algeria,DZA,0,0,0,10,10
2002,Morocco,MAR,Algeria,DZA,0,0,0,5,5
2002,Sierra Leone,SLE,Algeria,DZA,0,0,0,5,5
2002,Angola,AGO,Congo,COG,0,0,0,10,10
2002,Chad,TCD,Congo,COG,0,0,5,0,5
2002,Dem. Rep. of the Congo,COD,Congo,COG,40,0,120,0,160
2002,Guinea,GIN,Congo,COG,0,0,5,0,5
2002,Rwanda,RWA,Congo,COG,0,0,5,48,53
2002,Sierra Leone,SLE,Congo,COG,0,0,5,0,5
2002,Sudan,SDN,Congo,COG,0,0,10,0,10
2002,Angola,AGO,Dem. Rep. of the Congo,COD,221,0,73,95,389
2002,Burundi,BDI,Dem. Rep. of the Congo,COD,0,0,0,12,12
2002,Central African Rep.,CAF,Dem. Rep. of the Congo,COD,13,0,0,10,23
2002,Congo,COG,Dem. Rep. of the Congo,COD,5,0,25,0,30
2002,Liberia,LBR,Dem. Rep. of the Congo,COD,0,0,54,10,64
2002,Rwanda,RWA,Dem. Rep. of the Congo,COD,0,0,42,0,42
2002,Sierra Leone,SLE,Dem. Rep. of the Congo,COD,0,0,10,20,30
2002,Sudan,SDN,Dem. Rep. of the Congo,COD,5,0,10,5,20
2002,Uganda,UGA,Dem. Rep. of the Congo,COD,0,0,5,0,5
2002,Bosnia and Herzegovina,BIH,Libya,LBY,5,0,0,0,5
2002,Dem. Rep. of the Congo,COD,Libya,LBY,0,0,5,0,5
2002,Eritrea,ERI,Libya,LBY,0,0,0,5,5
2002,Palestinian,PSE,Libya,LBY,20,0,0,0,20
2002,Iraq,IRQ,Libya,LBY,5,0,19,0,24
2002,Somalia,SOM,Libya,LBY,0,0,0,71,71
2002,Sudan,SDN,Libya,LBY,5,0,0,0,5
2002,Syrian Arab Rep.,SYR,Libya,LBY,0,0,10,0,10
2002,Stateless,XXA,Libya,LBY,5,0,0,0,5
2002,Chad,TCD,Morocco,MAR,0,0,0,5,5
2002,Congo,COG,Morocco,MAR,5,0,5,106,116
2002,Dem. Rep. of the Congo,COD,Morocco,MAR,5,0,0,34,39
2002,Palestinian,PSE,Morocco,MAR,14,0,0,0,14
2002,Ghana,GHA,Morocco,MAR,0,0,0,5,5
2002,Cote d'Ivoire,CIV,Morocco,MAR,5,0,0,0,5
2002,Iraq,IRQ,Morocco,MAR,0,0,0,12,12
2002,Liberia,LBR,Morocco,MAR,0,0,5,0,5
2002,Niger,NER,Morocco,MAR,0,0,0,5,5
2002,Nigeria,NGA,Morocco,MAR,0,0,0,211,211
2002,Pakistan,PAK,Morocco,MAR,5,0,0,0,5
2002,Sierra Leone,SLE,Morocco,MAR,0,0,0,5,5
2002,Eritrea,ERI,Sudan,SDN,2106,0,1303,0,3409
2002,Ethiopia,ETH,Sudan,SDN,53,0,12,0,65
2002,Uganda,UGA,Sudan,SDN,84,0,16,0,100
2002,Afghanistan,AFG,Syrian Arab Rep.,SYR,14,0,0,0,14
2002,Algeria,DZA,Syrian Arab Rep.,SYR,0,0,13,5,18
2002,Eritrea,ERI,Syrian Arab Rep.,SYR,0,0,5,0,5
2002,Iran (Islamic Rep. of),IRN,Syrian Arab Rep.,SYR,5,0,39,5,49
2002,Iraq,IRQ,Syrian Arab Rep.,SYR,140,0,958,305,1403
2002,Pakistan,PAK,Syrian Arab Rep.,SYR,0,0,5,0,5
2002,Russian Federation,RUS,Syrian Arab Rep.,SYR,0,0,5,0,5
2002,Somalia,SOM,Syrian Arab Rep.,SYR,5,0,81,45,131
2002,Sudan,SDN,Syrian Arab Rep.,SYR,18,0,146,46,210
2002,Tunisia,TUN,Syrian Arab Rep.,SYR,0,0,5,0,5
2002,Turkey,TUR,Syrian Arab Rep.,SYR,0,0,10,0,10
2002,Yemen,YEM,Syrian Arab Rep.,SYR,5,0,0,16,21
2002,Algeria,DZA,Tunisia,TUN,5,0,0,24,29
2002,Iraq,IRQ,Tunisia,TUN,5,0,0,0,5
2003,Angola,AGO,Congo,COG,0,0,5,0,5
2003,Chad,TCD,Congo,COG,5,0,0,0,5
2003,Dem. Rep. of the Congo,COD,Congo,COG,5,0,54,0,59
2003,Algeria,DZA,Dem. Rep. of the Congo,COD,0,0,5,0,5
2003,Angola,AGO,Dem. Rep. of the Congo,COD,18,0,18,134,170
2003,Burundi,BDI,Dem. Rep. of the Congo,COD,10,0,5,66,81
2003,Central African Rep.,CAF,Dem. Rep. of the Congo,COD,5,0,15,5,25
2003,Chad,TCD,Dem. Rep. of the Congo,COD,0,0,0,5,5
2003,Congo,COG,Dem. Rep. of the Congo,COD,0,0,49,51,100
2003,Cote d'Ivoire,CIV,Dem. Rep. of the Congo,COD,0,0,5,0,5
2003,Liberia,LBR,Dem. Rep. of the Congo,COD,0,0,27,44,71
2003,Rwanda,RWA,Dem. Rep. of the Congo,COD,5,0,0,73,78
2003,Sierra Leone,SLE,Dem. Rep. of the Congo,COD,0,0,5,19,24
2003,Somalia,SOM,Dem. Rep. of the Congo,COD,0,0,0,5,5
2003,Sudan,SDN,Dem. Rep. of the Congo,COD,5,0,5,0,10
2003,Uganda,UGA,Dem. Rep. of the Congo,COD,0,0,5,0,5
2003,Cote d'Ivoire,CIV,Mauritania,MRT,10,0,0,0,10
2003,Liberia,LBR,Mauritania,MRT,65,0,0,0,65
2003,Sierra Leone,SLE,Mauritania,MRT,14,0,0,0,14
2003,Ethiopia,ETH,Somalia,SOM,74,0,155,105,334
2003,Eritrea,ERI,Sudan,SDN,29,0,0,23443,23472
2003,Ethiopia,ETH,Sudan,SDN,16,0,33,0,49
2003,Afghanistan,AFG,Syrian Arab Rep.,SYR,0,0,5,0,5
2003,Algeria,DZA,Syrian Arab Rep.,SYR,0,0,10,0,10
2003,Chad,TCD,Syrian Arab Rep.,SYR,0,0,5,0,5
2003,Iran (Islamic Rep. of),IRN,Syrian Arab Rep.,SYR,0,0,44,5,49
2003,Iraq,IRQ,Syrian Arab Rep.,SYR,54,0,576,38,668
2003,Jordan,JOR,Syrian Arab Rep.,SYR,0,0,5,0,5
2003,Somalia,SOM,Syrian Arab Rep.,SYR,31,0,80,5,116
2003,Sudan,SDN,Syrian Arab Rep.,SYR,40,0,114,5,159
2003,Turkey,TUR,Syrian Arab Rep.,SYR,0,0,12,0,12
2003,Stateless,XXA,Syrian Arab Rep.,SYR,5,0,0,0,5
2003,Algeria,DZA,Tunisia,TUN,5,0,0,41,46
2003,Cote d'Ivoire,CIV,Tunisia,TUN,5,0,0,13,18
2003,Iraq,IRQ,Tunisia,TUN,0,0,0,5,5
2004,Myanmar,MMR,Bangladesh,BGD,0,0,10,5,15
2004,Chad,TCD,Congo,COG,5,0,0,0,5
2004,Dem. Rep. of the Congo,COD,Congo,COG,47,0,238,0,285
2004,Cote d'Ivoire,CIV,Congo,COG,0,0,5,0,5
2004,Mauritania,MRT,Congo,COG,0,0,5,0,5
2004,Sudan,SDN,Congo,COG,0,0,5,0,5
2004,Ethiopia,ETH,Somalia,SOM,5,0,29,0,34
2004,Algeria,DZA,Tunisia,TUN,0,0,0,38,38
2004,Dem. Rep. of the Congo,COD,Tunisia,TUN,0,0,0,5,5
2004,Cote d'Ivoire,CIV,Tunisia,TUN,0,0,0,11,11
2004,Iraq,IRQ,Tunisia,TUN,0,0,0,10,10
2004,Sierra Leone,SLE,Tunisia,TUN,0,0,0,5,5
2005,Angola,AGO,Congo,COG,0,0,10,0,10
2005,Burundi,BDI,Congo,COG,0,0,12,0,12
2005,Central African Rep.,CAF,Congo,COG,0,0,17,0,17
2005,Chad,TCD,Congo,COG,0,0,19,0,19
2005,Dem. Rep. of the Congo,COD,Congo,COG,29,0,153,0,182
2005,Cote d'Ivoire,CIV,Congo,COG,0,0,43,0,43
2005,Liberia,LBR,Congo,COG,0,0,14,0,14
2005,Mauritania,MRT,Congo,COG,0,0,30,0,30
2005,Sierra Leone,SLE,Congo,COG,0,0,13,0,13
2005,Sudan,SDN,Congo,COG,5,0,0,0,5
2005,Dem. Rep. of the Congo,COD,Somalia,SOM,5,0,0,0,5
2005,Eritrea,ERI,Somalia,SOM,5,0,5,0,10
2005,Ethiopia,ETH,Somalia,SOM,42,0,169,247,458
2005,Sudan,SDN,Somalia,SOM,0,0,5,0,5
2006,Ethiopia,ETH,Somalia,SOM,112,0,149,0,261
2007,Ethiopia,ETH,Somalia,SOM,173,0,277,165,615
2007,Sudan,SDN,Somalia,SOM,5,0,0,0,5
2013,Central African Rep.,CAF,South Sudan,SSD,0,0,0,5,5
2013,Dem. Rep. of the Congo,COD,South Sudan,SSD,0,0,0,10,10
2013,Eritrea,ERI,South Sudan,SSD,0,0,0,5,5
2013,Ethiopia,ETH,South Sudan,SSD,5,0,0,5,10
2014,Sri Lanka,LKA,Haiti,HTI,5,0,0,0,5
2014,Congo,COG,South Sudan,SSD,0,0,0,10,10
2014,Eritrea,ERI,South Sudan,SSD,5,0,0,0,5
2014,Ethiopia,ETH,South Sudan,SSD,0,0,0,5,5
2014,Rwanda,RWA,South Sudan,SSD,0,0,0,5,5
2014,Sudan,SDN,South Sudan,SSD,5,0,0,0,5
2015,Burundi,BDI,South Sudan,SSD,0,0,0,5,5
2015,Central African Rep.,CAF,South Sudan,SSD,0,0,0,5,5
2015,Dem. Rep. of the Congo,COD,South Sudan,SSD,0,0,0,5,5
2015,Eritrea,ERI,South Sudan,SSD,11,0,0,10,21
2015,Ethiopia,ETH,South Sudan,SSD,18,0,0,10,28
2015,Somalia,SOM,South Sudan,SSD,0,0,0,14,14
2015,Sudan,SDN,South Sudan,SSD,0,0,0,5,5
2016,Cuba,CUB,Haiti,HTI,0,0,0,5,5
2016,Ethiopia,ETH,Haiti,HTI,5,0,0,0,5
2018,Yemen,YEM,Haiti,HTI,5,0,0,0,5
2001,Iran (Islamic Rep. of),IRN,Afghanistan,AFG,21,0,68,21,110
2001,Iraq,IRQ,Afghanistan,AFG,5,0,5,5,15
2001,Tajikistan,TJK,Afghanistan,AFG,0,0,5,0,5
2001,Congo,COG,Angola,AGO,0,0,13,0,13
2001,Dem. Rep. of the Congo,COD,Angola,AGO,25,0,58,5,88
2001,Rwanda,RWA,Angola,AGO,12,0,0,0,12
2001,Sierra Leone,SLE,Angola,AGO,5,0,19,0,24
2001,Afghanistan,AFG,Egypt,EGY,21,0,18,0,39
2001,Burundi,BDI,Egypt,EGY,13,0,10,0,23
2001,China,CHN,Egypt,EGY,5,0,5,0,10
2001,Dem. Rep. of the Congo,COD,Egypt,EGY,0,0,11,0,11
2001,Djibouti,DJI,Egypt,EGY,0,0,14,0,14
2001,Eritrea,ERI,Egypt,EGY,31,0,67,0,98
2001,Ethiopia,ETH,Egypt,EGY,89,0,166,0,255
2001,Palestinian,PSE,Egypt,EGY,0,63,0,0,63
2001,Iraq,IRQ,Egypt,EGY,15,0,14,0,29
2001,Jordan,JOR,Egypt,EGY,0,0,5,0,5
2001,Kuwait,KWT,Egypt,EGY,10,0,0,0,10
2001,Liberia,LBR,Egypt,EGY,10,0,0,0,10
2001,Libya,LBY,Egypt,EGY,5,0,0,0,5
2001,Rwanda,RWA,Egypt,EGY,5,0,5,0,10
2001,Sierra Leone,SLE,Egypt,EGY,18,0,0,0,18
2001,Somalia,SOM,Egypt,EGY,506,0,594,0,1100
2001,Sudan,SDN,Egypt,EGY,3400,0,3563,0,6963
2001,Syrian Arab Rep.,SYR,Egypt,EGY,0,0,5,0,5
2001,Yemen,YEM,Egypt,EGY,5,0,22,0,27
2001,Afghanistan,AFG,Azerbaijan,AZE,226,0,45,0,271
2001,Palestinian,PSE,Azerbaijan,AZE,5,0,0,0,5
2001,Iran (Islamic Rep. of),IRN,Azerbaijan,AZE,21,0,11,0,32
2001,Iraq,IRQ,Azerbaijan,AZE,17,0,10,0,27
2001,Russian Federation,RUS,Azerbaijan,AZE,23,0,0,0,23
2001,Iraq,IRQ,Bahrain,BHR,0,0,0,5,5
2001,Zimbabwe,ZWE,Bahrain,BHR,0,0,5,0,5
2001,Myanmar,MMR,Bangladesh,BGD,5,0,0,0,5
2001,Afghanistan,AFG,Bosnia and Herzegovina,BIH,0,0,0,5,5
2001,Algeria,DZA,Bosnia and Herzegovina,BIH,0,0,5,0,5
2001,Bangladesh,BGD,Bosnia and Herzegovina,BIH,0,0,0,12,12
2001,China,CHN,Bosnia and Herzegovina,BIH,0,0,0,30,30
2001,India,IND,Bosnia and Herzegovina,BIH,0,0,0,5,5
2001,Iran (Islamic Rep. of),IRN,Bosnia and Herzegovina,BIH,21,0,52,81,154
2001,Iraq,IRQ,Bosnia and Herzegovina,BIH,11,0,5,25,41
2001,North Macedonia,MKD,Bosnia and Herzegovina,BIH,0,0,0,13,13
2001,Pakistan,PAK,Bosnia and Herzegovina,BIH,0,0,0,28,28
2001,Romania,ROU,Bosnia and Herzegovina,BIH,0,0,0,5,5
2001,Sierra Leone,SLE,Bosnia and Herzegovina,BIH,0,0,0,5,5
2001,Tunisia,TUN,Bosnia and Herzegovina,BIH,0,0,0,5,5
2001,Turkey,TUR,Bosnia and Herzegovina,BIH,5,0,11,93,109
2001,Afghanistan,AFG,Cambodia,KHM,14,0,0,19,33
2001,China,CHN,Cambodia,KHM,5,0,5,5,15
2001,Palestinian,PSE,Cambodia,KHM,0,0,5,0,5
2001,Iraq,IRQ,Cambodia,KHM,0,0,5,0,5
2001,Pakistan,PAK,Cambodia,KHM,0,0,0,11,11
2001,Viet Nam,VNM,Cambodia,KHM,42,0,28,36,106
2001,Sudan,SDN,Cambodia,KHM,0,0,0,5,5
2001,Burundi,BDI,China,CHN,5,0,0,0,5
2001,Congo,COG,China,CHN,0,0,0,5,5
2001,Dem. Rep. of the Congo,COD,China,CHN,0,0,5,0,5
2001,Palestinian,PSE,China,CHN,0,0,0,5,5
2001,Burundi,BDI,Cameroon,CMR,20,0,0,0,20
2001,Central African Rep.,CAF,Cameroon,CMR,348,0,0,0,348
2001,Chad,TCD,Cameroon,CMR,21,0,35,0,56
2001,Congo,COG,Cameroon,CMR,27,0,5,0,32
2001,Dem. Rep. of the Congo,COD,Cameroon,CMR,102,0,44,0,146
2001,Liberia,LBR,Cameroon,CMR,0,0,10,0,10
2001,Rwanda,RWA,Cameroon,CMR,103,0,26,0,129
2001,Afghanistan,AFG,Cuba,CUB,5,0,12,0,17
2001,Algeria,DZA,Cuba,CUB,0,0,0,5,5
2001,Colombia,COL,Cuba,CUB,0,0,5,0,5
2001,Ethiopia,ETH,Cuba,CUB,11,0,10,0,21
2001,Palestinian,PSE,Cuba,CUB,5,0,0,0,5
2001,Iran (Islamic Rep. of),IRN,Cuba,CUB,0,0,11,0,11
2001,Iraq,IRQ,Cuba,CUB,0,0,14,0,14
2001,Sierra Leone,SLE,Cuba,CUB,0,0,5,0,5
2001,Sudan,SDN,Cuba,CUB,0,0,5,0,5
2001,Egypt,EGY,Cyprus,CYP,0,0,5,0,5
2001,Bulgaria,BGR,Cyprus,CYP,0,0,5,0,5
2001,Palestinian,PSE,Cyprus,CYP,0,0,0,5,5
2001,Iran (Islamic Rep. of),IRN,Cyprus,CYP,20,0,130,20,170
2001,Iraq,IRQ,Cyprus,CYP,10,0,0,0,10
2001,Jordan,JOR,Cyprus,CYP,0,0,5,0,5
2001,Lebanon,LBN,Cyprus,CYP,5,0,13,0,18
2001,Sri Lanka,LKA,Cyprus,CYP,0,0,10,0,10
2001,Russian Federation,RUS,Cyprus,CYP,0,0,10,0,10
2001,Serbia and Kosovo: S/RES/1244 (1999),SRB,Cyprus,CYP,0,0,77,40,117
2001,Sierra Leone,SLE,Cyprus,CYP,0,0,5,0,5
2001,Sudan,SDN,Cyprus,CYP,0,0,5,0,5
2001,Syrian Arab Rep.,SYR,Cyprus,CYP,0,0,25,0,25
2001,Turkey,TUR,Cyprus,CYP,0,0,0,5,5
2001,Ukraine,UKR,Cyprus,CYP,0,0,5,0,5
2001,Sudan,SDN,Gabon,GAB,0,0,0,5,5
2001,Colombia,COL,Guatemala,GTM,5,0,12,0,17
2001,India,IND,Guatemala,GTM,0,0,0,11,11
2001,Sri Lanka,LKA,Guatemala,GTM,10,0,0,0,10
2001,El Salvador,SLV,Guatemala,GTM,0,0,16,0,16
2001,Sierra Leone,SLE,Guatemala,GTM,0,0,5,0,5
2001,Bangladesh,BGD,"China, Hong Kong SAR",HKG,0,0,0,5,5
2001,Dem. Rep. of the Congo,COD,"China, Hong Kong SAR",HKG,5,0,0,0,5
2001,India,IND,"China, Hong Kong SAR",HKG,0,0,5,0,5
2001,Iran (Islamic Rep. of),IRN,"China, Hong Kong SAR",HKG,5,0,0,0,5
2001,Iraq,IRQ,"China, Hong Kong SAR",HKG,5,0,0,0,5
2001,Liberia,LBR,"China, Hong Kong SAR",HKG,0,0,5,0,5
2001,Sri Lanka,LKA,"China, Hong Kong SAR",HKG,10,0,10,17,37
2001,Pakistan,PAK,"China, Hong Kong SAR",HKG,10,0,55,56,121
2001,Philippines,PHL,"China, Hong Kong SAR",HKG,0,0,0,5,5
2001,Sierra Leone,SLE,"China, Hong Kong SAR",HKG,0,5,0,0,5
2001,Sudan,SDN,"China, Hong Kong SAR",HKG,10,0,0,0,10
2001,Afghanistan,AFG,Croatia,HRV,0,0,0,11,11
2001,Congo,COG,Croatia,HRV,0,0,0,5,5
2001,Iran (Islamic Rep. of),IRN,Croatia,HRV,0,0,0,29,29
2001,Iraq,IRQ,Croatia,HRV,0,0,0,10,10
2001,Rep. of Moldova,MDA,Croatia,HRV,0,0,0,5,5
2001,Pakistan,PAK,Croatia,HRV,0,0,0,5,5
2001,Sierra Leone,SLE,Croatia,HRV,0,0,0,5,5
2001,Somalia,SOM,Croatia,HRV,0,0,0,5,5
2001,Afghanistan,AFG,India,IND,340,0,53,0,393
2001,Bangladesh,BGD,India,IND,0,0,5,0,5
2001,China,CHN,India,IND,0,0,5,0,5
2001,Cuba,CUB,India,IND,5,0,0,0,5
2001,Ethiopia,ETH,India,IND,0,0,5,0,5
2001,Iran (Islamic Rep. of),IRN,India,IND,24,0,13,0,37
2001,Iraq,IRQ,India,IND,5,0,5,0,10
2001,Israel,ISR,India,IND,0,0,5,0,5
2001,Myanmar,MMR,India,IND,130,0,81,0,211
2001,Nigeria,NGA,India,IND,0,0,5,0,5
2001,Russian Federation,RUS,India,IND,5,0,5,0,10
2001,Somalia,SOM,India,IND,0,0,5,0,5
2001,Sudan,SDN,India,IND,30,0,35,0,65
2001,Afghanistan,AFG,Indonesia,IDN,12,0,14,324,350
2001,Iran (Islamic Rep. of),IRN,Indonesia,IDN,0,0,0,82,82
2001,Iraq,IRQ,Indonesia,IDN,122,0,10,251,383
2001,Liberia,LBR,Indonesia,IDN,0,0,0,5,5
2001,Sri Lanka,LKA,Indonesia,IDN,5,0,0,5,10
2001,Pakistan,PAK,Indonesia,IDN,0,0,0,22,22
2001,Rwanda,RWA,Indonesia,IDN,0,0,0,5,5
2001,Afghanistan,AFG,Iraq,IRQ,18,0,0,0,18
2001,Iran (Islamic Rep. of),IRN,Iraq,IRQ,304,0,260,389,953
2001,Syrian Arab Rep.,SYR,Iraq,IRQ,24,0,49,0,73
2001,Armenia,ARM,Israel,ISR,0,0,10,0,10
2001,Dem. Rep. of the Congo,COD,Israel,ISR,0,0,0,5,5
2001,Colombia,COL,Israel,ISR,5,0,0,0,5
2001,Eritrea,ERI,Israel,ISR,0,0,12,0,12
2001,Ethiopia,ETH,Israel,ISR,58,0,152,15,225
2001,Ghana,GHA,Israel,ISR,0,0,5,0,5
2001,Iran (Islamic Rep. of),IRN,Israel,ISR,5,0,0,0,5
2001,Jordan,JOR,Israel,ISR,0,0,5,0,5
2001,Liberia,LBR,Israel,ISR,5,0,0,0,5
2001,Russian Federation,RUS,Israel,ISR,0,0,5,0,5
2001,Serbia and Kosovo: S/RES/1244 (1999),SRB,Israel,ISR,0,0,5,0,5
2001,Sierra Leone,SLE,Israel,ISR,0,0,0,5,5
2001,Sudan,SDN,Israel,ISR,5,0,0,0,5
2001,Tajikistan,TJK,Israel,ISR,0,0,5,0,5
2001,Afghanistan,AFG,Jordan,JOR,0,0,0,5,5
2001,Algeria,DZA,Jordan,JOR,0,0,14,0,14
2001,Egypt,EGY,Jordan,JOR,0,0,42,0,42
2001,Bangladesh,BGD,Jordan,JOR,0,0,13,5,18
2001,Bosnia and Herzegovina,BIH,Jordan,JOR,0,0,0,22,22
2001,Eritrea,ERI,Jordan,JOR,0,0,11,0,11
2001,Ethiopia,ETH,Jordan,JOR,0,0,11,0,11
2001,Iraq,IRQ,Jordan,JOR,1879,0,2442,2413,6734
2001,Libya,LBY,Jordan,JOR,0,0,0,10,10
2001,Lebanon,LBN,Jordan,JOR,0,0,5,11,16
2001,Sri Lanka,LKA,Jordan,JOR,0,0,19,5,24
2001,Pakistan,PAK,Jordan,JOR,0,0,0,14,14
2001,Philippines,PHL,Jordan,JOR,0,0,5,0,5
2001,Russian Federation,RUS,Jordan,JOR,10,0,0,20,30
2001,Somalia,SOM,Jordan,JOR,12,0,5,0,17
2001,Sudan,SDN,Jordan,JOR,5,0,88,13,106
2001,Syrian Arab Rep.,SYR,Jordan,JOR,0,0,13,30,43
2001,Yemen,YEM,Jordan,JOR,0,0,20,5,25
2001,Stateless,XXA,Jordan,JOR,21,0,0,0,21
2001,Afghanistan,AFG,Kazakhstan,KAZ,11,0,0,0,11
2001,China,CHN,Kazakhstan,KAZ,14,0,0,0,14
2001,Burundi,BDI,Kenya,KEN,124,0,52,19,195
2001,Dem. Rep. of the Congo,COD,Kenya,KEN,570,0,267,76,913
2001,Eritrea,ERI,Kenya,KEN,71,0,194,19,284
2001,Ethiopia,ETH,Kenya,KEN,2121,0,2433,352,4906
2001,Iraq,IRQ,Kenya,KEN,5,0,0,0,5
2001,Liberia,LBR,Kenya,KEN,5,0,0,0,5
2001,Rwanda,RWA,Kenya,KEN,173,0,373,0,546
2001,Somalia,SOM,Kenya,KEN,839,0,103,5,947
2001,Sudan,SDN,Kenya,KEN,31,0,0,143,174
2001,United Rep. of Tanzania,TZA,Kenya,KEN,0,0,5,0,5
2001,Uganda,UGA,Kenya,KEN,25,0,28,71,124
2001,Afghanistan,AFG,Kuwait,KWT,5,0,0,5,10
2001,Egypt,EGY,Kuwait,KWT,0,0,5,0,5
2001,Dominican Rep.,DOM,Kuwait,KWT,0,0,5,0,5
2001,Eritrea,ERI,Kuwait,KWT,10,0,0,0,10
2001,Ethiopia,ETH,Kuwait,KWT,5,0,5,0,10
2001,Palestinian,PSE,Kuwait,KWT,25,0,0,0,25
2001,Iran (Islamic Rep. of),IRN,Kuwait,KWT,5,0,0,0,5
2001,Iraq,IRQ,Kuwait,KWT,56,0,75,5,136
2001,Nigeria,NGA,Kuwait,KWT,0,0,5,0,5
2001,Saudi Arabia,SAU,Kuwait,KWT,0,0,15,0,15
2001,Somalia,SOM,Kuwait,KWT,5,0,22,5,32
2001,Dem. Rep. of the Congo,COD,Libya,LBY,0,0,16,145,161
2001,Iraq,IRQ,Libya,LBY,5,0,0,17,22
2001,Sudan,SDN,Libya,LBY,0,0,0,16,16
2001,Afghanistan,AFG,Lebanon,LBN,17,0,0,0,17
2001,Algeria,DZA,Lebanon,LBN,0,0,18,10,28
2001,Egypt,EGY,Lebanon,LBN,0,0,47,10,57
2001,Burundi,BDI,Lebanon,LBN,0,0,11,0,11
2001,Chad,TCD,Lebanon,LBN,0,0,0,5,5
2001,Dem. Rep. of the Congo,COD,Lebanon,LBN,0,0,5,0,5
2001,Eritrea,ERI,Lebanon,LBN,0,0,0,45,45
2001,Ethiopia,ETH,Lebanon,LBN,0,0,5,19,24
2001,Iran (Islamic Rep. of),IRN,Lebanon,LBN,13,0,5,0,18
2001,Iraq,IRQ,Lebanon,LBN,443,0,981,439,1863
2001,Jordan,JOR,Lebanon,LBN,0,0,12,0,12
2001,Liberia,LBR,Lebanon,LBN,0,0,0,13,13
2001,Nigeria,NGA,Lebanon,LBN,0,0,24,14,38
2001,Rwanda,RWA,Lebanon,LBN,0,0,14,0,14
2001,Sierra Leone,SLE,Lebanon,LBN,24,0,27,0,51
2001,Somalia,SOM,Lebanon,LBN,5,0,34,74,113
2001,Sudan,SDN,Lebanon,LBN,192,0,1315,661,2168
2001,Tunisia,TUN,Lebanon,LBN,5,0,13,0,18
2001,Turkey,TUR,Lebanon,LBN,5,0,0,17,22
2001,Yemen,YEM,Lebanon,LBN,5,0,10,13,28
2001,Iraq,IRQ,Sri Lanka,LKA,12,0,0,0,12
2001,Pakistan,PAK,Sri Lanka,LKA,0,0,0,5,5
2001,Congo,COG,Mauritania,MRT,0,0,0,5,5
2001,Dem. Rep. of the Congo,COD,Mauritania,MRT,0,0,5,10,15
2001,Guinea,GIN,Mauritania,MRT,0,0,0,5,5
2001,Cote d'Ivoire,CIV,Mauritania,MRT,5,0,0,0,5
2001,Liberia,LBR,Mauritania,MRT,0,0,15,0,15
2001,Sierra Leone,SLE,Mauritania,MRT,0,0,14,0,14
2001,Afghanistan,AFG,Rep. of Moldova,MDA,5,0,0,15,20
2001,Angola,AGO,Rep. of Moldova,MDA,0,0,0,5,5
2001,Burkina Faso,BFA,Rep. of Moldova,MDA,0,0,5,0,5
2001,Eritrea,ERI,Rep. of Moldova,MDA,0,0,5,0,5
2001,Georgia,GEO,Rep. of Moldova,MDA,0,0,0,5,5
2001,Iran (Islamic Rep. of),IRN,Rep. of Moldova,MDA,0,0,5,0,5
2001,Iraq,IRQ,Rep. of Moldova,MDA,10,0,18,23,51
2001,Kyrgyzstan,KGZ,Rep. of Moldova,MDA,10,0,0,0,10
2001,Nigeria,NGA,Rep. of Moldova,MDA,0,0,13,0,13
2001,Pakistan,PAK,Rep. of Moldova,MDA,0,0,5,0,5
2001,Russian Federation,RUS,Rep. of Moldova,MDA,117,0,0,15,132
2001,Sierra Leone,SLE,Rep. of Moldova,MDA,5,0,0,5,10
2001,Somalia,SOM,Rep. of Moldova,MDA,0,0,5,12,17
2001,Sudan,SDN,Rep. of Moldova,MDA,0,0,31,14,45
2001,Stateless,XXA,Rep. of Moldova,MDA,0,0,0,5,5
2001,Albania,ALB,Mexico,MEX,0,0,12,0,12
2001,Bangladesh,BGD,Mexico,MEX,0,0,5,5,10
2001,China,CHN,Mexico,MEX,0,0,10,24,34
2001,Chile,CHL,Mexico,MEX,0,0,5,0,5
2001,Colombia,COL,Mexico,MEX,30,0,15,10,55
2001,Cuba,CUB,Mexico,MEX,0,0,30,0,30
2001,Czechia,CZE,Mexico,MEX,0,0,5,0,5
2001,Dominican Rep.,DOM,Mexico,MEX,0,0,0,5,5
2001,Eritrea,ERI,Mexico,MEX,5,0,0,0,5
2001,Ethiopia,ETH,Mexico,MEX,5,0,0,0,5
2001,Palestinian,PSE,Mexico,MEX,5,0,0,0,5
2001,Guatemala,GTM,Mexico,MEX,30,0,5,0,35
2001,Honduras,HND,Mexico,MEX,5,0,0,0,5
2001,India,IND,Mexico,MEX,0,0,11,21,32
2001,Iran (Islamic Rep. of),IRN,Mexico,MEX,11,0,0,0,11
2001,Iraq,IRQ,Mexico,MEX,0,0,5,10,15
2001,Sri Lanka,LKA,Mexico,MEX,17,0,10,0,27
2001,Myanmar,MMR,Mexico,MEX,0,0,5,0,5
2001,Nicaragua,NIC,Mexico,MEX,0,0,5,0,5
2001,Pakistan,PAK,Mexico,MEX,5,0,0,0,5
2001,Peru,PER,Mexico,MEX,0,0,5,0,5
2001,Romania,ROU,Mexico,MEX,0,0,0,12,12
2001,Russian Federation,RUS,Mexico,MEX,5,0,5,0,10
2001,El Salvador,SLV,Mexico,MEX,0,0,0,5,5
2001,Sierra Leone,SLE,Mexico,MEX,14,0,5,5,24
2001,Somalia,SOM,Mexico,MEX,13,0,0,0,13
2001,Sudan,SDN,Mexico,MEX,5,0,0,0,5
2001,Yemen,YEM,Mexico,MEX,0,0,13,0,13
2001,Afghanistan,AFG,Malaysia,MYS,27,0,25,16,68
2001,India,IND,Malaysia,MYS,0,0,0,5,5
2001,Indonesia,IDN,Malaysia,MYS,31,10,119,18,178
2001,Iran (Islamic Rep. of),IRN,Malaysia,MYS,0,0,15,14,29
2001,Iraq,IRQ,Malaysia,MYS,18,0,26,0,44
2001,Sri Lanka,LKA,Malaysia,MYS,0,0,10,0,10
2001,Myanmar,MMR,Malaysia,MYS,24,5,283,65,377
2001,Nigeria,NGA,Malaysia,MYS,0,0,5,0,5
2001,Pakistan,PAK,Malaysia,MYS,0,0,10,0,10
2001,Somalia,SOM,Malaysia,MYS,0,5,0,0,5
2001,Chad,TCD,Niger,NER,0,0,5,0,5
2001,Congo,COG,Niger,NER,5,0,5,0,10
2001,Dem. Rep. of the Congo,COD,Niger,NER,16,0,41,0,57
2001,Rwanda,RWA,Niger,NER,5,0,0,0,5
2001,Sierra Leone,SLE,Niger,NER,0,0,5,0,5
2001,Algeria,DZA,Pakistan,PAK,0,0,5,0,5
2001,Egypt,EGY,Pakistan,PAK,0,0,10,0,10
2001,Azerbaijan,AZE,Pakistan,PAK,0,0,5,0,5
2001,Iran (Islamic Rep. of),IRN,Pakistan,PAK,69,0,521,35,625
2001,Iraq,IRQ,Pakistan,PAK,38,0,190,5,233
2001,Libya,LBY,Pakistan,PAK,5,0,0,0,5
2001,Sri Lanka,LKA,Pakistan,PAK,0,0,5,0,5
2001,Russian Federation,RUS,Pakistan,PAK,0,0,5,0,5
2001,Rwanda,RWA,Pakistan,PAK,0,0,5,0,5
2001,Saudi Arabia,SAU,Pakistan,PAK,0,0,5,0,5
2001,Sierra Leone,SLE,Pakistan,PAK,0,0,5,0,5
2001,Somalia,SOM,Pakistan,PAK,39,0,290,0,329
2001,United Rep. of Tanzania,TZA,Pakistan,PAK,0,0,10,11,21
2001,Tunisia,TUN,Pakistan,PAK,0,0,5,0,5
2001,Cuba,CUB,Paraguay,PRY,0,0,0,5,5
2001,Afghanistan,AFG,Qatar,QAT,0,40,0,0,40
2001,Iraq,IRQ,Qatar,QAT,0,0,5,0,5
2001,Somalia,SOM,Qatar,QAT,0,0,13,0,13
2001,Sudan,SDN,Qatar,QAT,0,0,5,0,5
2001,Angola,AGO,Rwanda,RWA,14,0,0,0,14
2001,Burundi,BDI,Rwanda,RWA,165,0,0,0,165
2001,Chad,TCD,Rwanda,RWA,5,0,0,0,5
2001,Congo,COG,Rwanda,RWA,5,0,0,0,5
2001,Dem. Rep. of the Congo,COD,Rwanda,RWA,4600,0,0,0,4600
2001,Eritrea,ERI,Rwanda,RWA,5,0,0,0,5
2001,Ethiopia,ETH,Rwanda,RWA,12,0,0,0,12
2001,Somalia,SOM,Rwanda,RWA,15,0,0,0,15
2001,Colombia,COL,El Salvador,SLV,15,0,0,0,15
2001,Cuba,CUB,El Salvador,SLV,0,0,5,0,5
2001,Nigeria,NGA,El Salvador,SLV,0,0,5,0,5
2001,Afghanistan,AFG,Saudi Arabia,SAU,0,43,0,0,43
2001,Iraq,IRQ,Saudi Arabia,SAU,0,0,10,10,20
2001,Somalia,SOM,Saudi Arabia,SAU,5,0,82,11,98
2001,Sudan,SDN,Saudi Arabia,SAU,0,0,24,5,29
2001,China,CHN,Singapore,SGP,21,0,0,0,21
2001,Iraq,IRQ,Singapore,SGP,0,0,5,0,5
2001,Sri Lanka,LKA,Singapore,SGP,0,0,5,0,5
2001,Liberia,LBR,Sierra Leone,SLE,721,0,150,132,1003
2001,Burundi,BDI,Somalia,SOM,5,0,0,0,5
2001,Dem. Rep. of the Congo,COD,Somalia,SOM,5,0,0,0,5
2001,Eritrea,ERI,Somalia,SOM,5,0,0,0,5
2001,Ethiopia,ETH,Somalia,SOM,20,0,100,0,120
2001,Sudan,SDN,Somalia,SOM,5,0,0,0,5
2001,Afghanistan,AFG,Turkmenistan,TKM,190,0,190,41,421
2001,Azerbaijan,AZE,Turkmenistan,TKM,13,0,0,13,26
2001,Russian Federation,RUS,Turkmenistan,TKM,5,0,0,0,5
2001,Tajikistan,TJK,Turkmenistan,TKM,0,0,0,276,276
2001,Central African Rep.,CAF,Togo,TGO,5,0,0,0,5
2001,Congo,COG,Togo,TGO,15,0,0,0,15
2001,Rwanda,RWA,Togo,TGO,0,0,31,0,31
2001,Afghanistan,AFG,Turkey,TUR,107,0,21,42,170
2001,Algeria,DZA,Turkey,TUR,0,0,0,10,10
2001,Egypt,EGY,Turkey,TUR,11,0,0,0,11
2001,China,CHN,Turkey,TUR,0,0,5,16,21
2001,Congo,COG,Turkey,TUR,0,0,0,5,5
2001,Eritrea,ERI,Turkey,TUR,0,0,0,5,5
2001,Ethiopia,ETH,Turkey,TUR,0,0,5,5,10
2001,Palestinian,PSE,Turkey,TUR,0,0,0,5,5
2001,Iran (Islamic Rep. of),IRN,Turkey,TUR,2248,0,967,512,3727
2001,Iraq,IRQ,Turkey,TUR,455,0,1074,450,1979
2001,Jordan,JOR,Turkey,TUR,5,0,5,0,10
2001,Kazakhstan,KAZ,Turkey,TUR,0,0,5,0,5
2001,Kenya,KEN,Turkey,TUR,5,0,0,0,5
2001,Libya,LBY,Turkey,TUR,0,0,0,5,5
2001,Sri Lanka,LKA,Turkey,TUR,0,0,0,11,11
2001,Nigeria,NGA,Turkey,TUR,0,0,0,5,5
2001,Pakistan,PAK,Turkey,TUR,0,0,0,5,5
2001,Rwanda,RWA,Turkey,TUR,5,0,0,0,5
2001,Sierra Leone,SLE,Turkey,TUR,0,0,0,5,5
2001,Somalia,SOM,Turkey,TUR,10,0,10,5,25
2001,Sudan,SDN,Turkey,TUR,0,0,0,5,5
2001,Syrian Arab Rep.,SYR,Turkey,TUR,5,0,0,5,10
2001,Tajikistan,TJK,Turkey,TUR,0,0,0,10,10
2001,Uzbekistan,UZB,Turkey,TUR,17,0,10,0,27
2001,Afghanistan,AFG,United Arab Emirates,ARE,0,0,0,5,5
2001,Algeria,DZA,United Arab Emirates,ARE,0,0,5,0,5
2001,India,IND,United Arab Emirates,ARE,0,0,0,5,5
2001,Iran (Islamic Rep. of),IRN,United Arab Emirates,ARE,0,0,5,0,5
2001,Somalia,SOM,United Arab Emirates,ARE,0,0,10,0,10
2001,Sudan,SDN,United Arab Emirates,ARE,0,0,0,5,5
2001,Argentina,ARG,Uruguay,URY,5,0,0,0,5
2001,Afghanistan,AFG,Uzbekistan,UZB,1573,0,247,189,2009
2001,Azerbaijan,AZE,Uzbekistan,UZB,0,0,5,0,5
2001,China,CHN,Uzbekistan,UZB,0,0,5,0,5
2001,Iraq,IRQ,Uzbekistan,UZB,5,0,0,0,5
2001,Serbia and Kosovo: S/RES/1244 (1999),SRB,Uzbekistan,UZB,5,0,0,0,5
2001,Tajikistan,TJK,Uzbekistan,UZB,0,0,0,5,5
2001,Djibouti,DJI,Yemen,YEM,0,0,5,0,5
2001,Eritrea,ERI,Yemen,YEM,11,0,10,22,43
2001,Ethiopia,ETH,Yemen,YEM,33,0,231,459,723
2001,Palestinian,PSE,Yemen,YEM,44,0,5,26,75
2001,Iraq,IRQ,Yemen,YEM,123,0,91,69,283
2001,Kenya,KEN,Yemen,YEM,0,0,0,5,5
2001,Sudan,SDN,Yemen,YEM,12,0,95,120,227
2001,Syrian Arab Rep.,SYR,Yemen,YEM,5,0,0,0,5
2002,Iran (Islamic Rep. of),IRN,Afghanistan,AFG,0,0,13,0,13
2002,Iraq,IRQ,Afghanistan,AFG,0,0,13,0,13
2002,Pakistan,PAK,Afghanistan,AFG,0,0,5,0,5
2002,Tajikistan,TJK,Afghanistan,AFG,0,0,5,0,5
2002,Afghanistan,AFG,Egypt,EGY,0,0,35,0,35
2002,Burundi,BDI,Egypt,EGY,5,0,17,0,22
2002,Chad,TCD,Egypt,EGY,0,0,11,0,11
2002,Congo,COG,Egypt,EGY,0,0,5,0,5
2002,Dem. Rep. of the Congo,COD,Egypt,EGY,0,0,5,0,5
2002,Djibouti,DJI,Egypt,EGY,0,0,5,0,5
2002,Eritrea,ERI,Egypt,EGY,15,0,111,0,126
2002,Ethiopia,ETH,Egypt,EGY,57,0,437,0,494
2002,Palestinian,PSE,Egypt,EGY,56,0,0,0,56
2002,Iraq,IRQ,Egypt,EGY,5,0,25,0,30
2002,Liberia,LBR,Egypt,EGY,10,0,11,0,21
2002,Sri Lanka,LKA,Egypt,EGY,0,0,5,0,5
2002,Russian Federation,RUS,Egypt,EGY,5,0,5,0,10
2002,Rwanda,RWA,Egypt,EGY,0,0,5,0,5
2002,Sierra Leone,SLE,Egypt,EGY,0,0,17,0,17
2002,Somalia,SOM,Egypt,EGY,592,0,952,0,1544
2002,Sudan,SDN,Egypt,EGY,4245,0,5897,0,10142
2002,United Rep. of Tanzania,TZA,Egypt,EGY,0,0,5,0,5
2002,Yemen,YEM,Egypt,EGY,0,0,12,0,12
2002,Zimbabwe,ZWE,Egypt,EGY,5,0,0,0,5
2002,Myanmar,MMR,Bangladesh,BGD,22,0,0,10,32
2002,India,IND,Bosnia and Herzegovina,BIH,0,0,0,5,5
2002,Iran (Islamic Rep. of),IRN,Bosnia and Herzegovina,BIH,5,0,25,0,30
2002,Iraq,IRQ,Bosnia and Herzegovina,BIH,5,0,0,0,5
2002,North Macedonia,MKD,Bosnia and Herzegovina,BIH,0,0,0,210,210
2002,Pakistan,PAK,Bosnia and Herzegovina,BIH,0,0,5,5,10
2002,Serbia and Kosovo: S/RES/1244 (1999),SRB,Bosnia and Herzegovina,BIH,79,0,60,79,218
2002,Tunisia,TUN,Bosnia and Herzegovina,BIH,0,0,0,5,5
2002,Stateless,XXA,Bosnia and Herzegovina,BIH,0,0,0,10,10
2002,Cuba,CUB,Belize,BLZ,0,0,13,0,13
2002,Nigeria,NGA,Belize,BLZ,0,0,0,5,5
2002,Sierra Leone,SLE,Belize,BLZ,0,0,0,10,10
2002,Afghanistan,AFG,Cambodia,KHM,0,0,0,12,12
2002,China,CHN,Cambodia,KHM,5,0,5,0,10
2002,Iran (Islamic Rep. of),IRN,Cambodia,KHM,0,0,5,0,5
2002,Sri Lanka,LKA,Cambodia,KHM,5,0,5,0,10
2002,Pakistan,PAK,Cambodia,KHM,0,0,10,5,15
2002,Viet Nam,VNM,Cambodia,KHM,930,0,92,78,1100
2002,Afghanistan,AFG,China,CHN,5,0,0,0,5
2002,Burundi,BDI,China,CHN,5,0,0,0,5
2002,Liberia,LBR,China,CHN,0,0,5,0,5
2002,Sri Lanka,LKA,China,CHN,5,0,0,0,5
2002,Nigeria,NGA,China,CHN,0,0,5,0,5
2002,Central African Rep.,CAF,Cameroon,CMR,17,0,0,0,17
2002,Chad,TCD,Cameroon,CMR,5,0,0,0,5
2002,Congo,COG,Cameroon,CMR,5,0,0,0,5
2002,Dem. Rep. of the Congo,COD,Cameroon,CMR,19,0,0,0,19
2002,Liberia,LBR,Cameroon,CMR,0,0,5,0,5
2002,Rwanda,RWA,Cameroon,CMR,111,0,0,0,111
2002,Cuba,CUB,Colombia,COL,0,0,5,5,10
2002,Iraq,IRQ,Colombia,COL,0,0,0,5,5
2002,Colombia,COL,Cuba,CUB,5,0,0,0,5
2002,Ethiopia,ETH,Cuba,CUB,0,0,5,0,5
2002,Haiti,HTI,Cuba,CUB,0,0,5,0,5
2002,Iraq,IRQ,Cuba,CUB,5,0,0,0,5
2002,Syrian Arab Rep.,SYR,Cuba,CUB,0,0,16,0,16
2002,Egypt,EGY,Cyprus,CYP,10,0,41,16,67
2002,Dem. Rep. of the Congo,COD,Cyprus,CYP,0,0,5,0,5
2002,Palestinian,PSE,Cyprus,CYP,0,0,0,5,5
2002,Georgia,GEO,Cyprus,CYP,0,0,0,5,5
2002,Iran (Islamic Rep. of),IRN,Cyprus,CYP,62,0,162,114,338
2002,Iraq,IRQ,Cyprus,CYP,5,0,13,14,32
2002,Jordan,JOR,Cyprus,CYP,0,0,13,5,18
2002,Lebanon,LBN,Cyprus,CYP,5,0,23,20,48
2002,Sri Lanka,LKA,Cyprus,CYP,0,0,14,0,14
2002,Nigeria,NGA,Cyprus,CYP,0,0,5,0,5
2002,Pakistan,PAK,Cyprus,CYP,0,0,14,5,19
2002,Russian Federation,RUS,Cyprus,CYP,0,0,24,10,34
2002,Serbia and Kosovo: S/RES/1244 (1999),SRB,Cyprus,CYP,10,0,297,75,382
2002,Syrian Arab Rep.,SYR,Cyprus,CYP,5,0,5,11,21
2002,Turkey,TUR,Cyprus,CYP,0,0,0,10,10
2002,Ethiopia,ETH,Djibouti,DJI,0,0,0,5,5
2002,Ethiopia,ETH,Eritrea,ERI,5,0,0,0,5
2002,Sudan,SDN,Eritrea,ERI,5,0,0,0,5
2002,Sierra Leone,SLE,Gambia,GMB,0,0,0,223,223
2002,Honduras,HND,Guatemala,GTM,5,0,0,0,5
2002,India,IND,Guatemala,GTM,0,0,15,19,34
2002,Nicaragua,NIC,Guatemala,GTM,0,0,0,5,5
2002,Bangladesh,BGD,"China, Hong Kong SAR",HKG,0,0,0,14,14
2002,Dem. Rep. of the Congo,COD,"China, Hong Kong SAR",HKG,5,0,0,0,5
2002,Eritrea,ERI,"China, Hong Kong SAR",HKG,10,0,0,0,10
2002,Ethiopia,ETH,"China, Hong Kong SAR",HKG,5,0,0,0,5
2002,India,IND,"China, Hong Kong SAR",HKG,0,0,5,13,18
2002,Sri Lanka,LKA,"China, Hong Kong SAR",HKG,13,0,42,47,102
2002,Mongolia,MNG,"China, Hong Kong SAR",HKG,0,0,0,5,5
2002,Nigeria,NGA,"China, Hong Kong SAR",HKG,5,0,0,0,5
2002,Pakistan,PAK,"China, Hong Kong SAR",HKG,57,0,158,194,409
2002,Palestinian,PSE,Croatia,HRV,0,0,0,5,5
2002,Iran (Islamic Rep. of),IRN,Croatia,HRV,0,0,0,14,14
2002,Russian Federation,RUS,Croatia,HRV,0,0,0,18,18
2002,Serbia and Kosovo: S/RES/1244 (1999),SRB,Croatia,HRV,0,0,5,12,17
2002,Afghanistan,AFG,India,IND,280,0,66,0,346
2002,Eritrea,ERI,India,IND,5,0,11,0,16
2002,Ethiopia,ETH,India,IND,16,0,10,0,26
2002,Iran (Islamic Rep. of),IRN,India,IND,5,0,5,0,10
2002,Iraq,IRQ,India,IND,5,0,0,0,5
2002,Israel,ISR,India,IND,13,0,0,0,13
2002,Myanmar,MMR,India,IND,135,0,318,0,453
2002,Nigeria,NGA,India,IND,0,0,5,0,5
2002,Sierra Leone,SLE,India,IND,0,0,5,0,5
2002,Somalia,SOM,India,IND,12,0,93,0,105
2002,Sudan,SDN,India,IND,24,0,45,0,69
2002,Afghanistan,AFG,Indonesia,IDN,133,10,138,400,681
2002,Algeria,DZA,Indonesia,IDN,5,0,0,0,5
2002,Angola,AGO,Indonesia,IDN,0,0,0,5,5
2002,Palestinian,PSE,Indonesia,IDN,5,0,0,0,5
2002,Iran (Islamic Rep. of),IRN,Indonesia,IDN,16,0,20,5,41
2002,Iraq,IRQ,Indonesia,IDN,244,26,140,61,471
2002,Sri Lanka,LKA,Indonesia,IDN,0,0,0,16,16
2002,Sierra Leone,SLE,Indonesia,IDN,5,0,0,0,5
2002,Sudan,SDN,Indonesia,IDN,0,0,0,5,5
2002,United Rep. of Tanzania,TZA,Indonesia,IDN,0,0,0,5,5
2002,China,CHN,Iran (Islamic Rep. of),IRN,18,0,5,0,23
2002,Turkey,TUR,Iran (Islamic Rep. of),IRN,0,0,0,10,10
2002,Iran (Islamic Rep. of),IRN,Iraq,IRQ,95,0,201,95,391
2002,Syrian Arab Rep.,SYR,Iraq,IRQ,11,0,0,0,11
2002,Turkey,TUR,Iraq,IRQ,285,0,0,0,285
2002,Algeria,DZA,Jordan,JOR,0,0,0,10,10
2002,Egypt,EGY,Jordan,JOR,0,0,11,87,98
2002,Congo,COG,Jordan,JOR,0,0,5,0,5
2002,Djibouti,DJI,Jordan,JOR,0,0,5,0,5
2002,Eritrea,ERI,Jordan,JOR,0,0,5,0,5
2002,India,IND,Jordan,JOR,0,0,0,21,21
2002,Iraq,IRQ,Jordan,JOR,654,0,1939,795,3388
2002,Sri Lanka,LKA,Jordan,JOR,0,0,0,39,39
2002,North Macedonia,MKD,Jordan,JOR,0,0,0,5,5
2002,Morocco,MAR,Jordan,JOR,0,0,0,5,5
2002,Pakistan,PAK,Jordan,JOR,0,0,0,5,5
2002,Russian Federation,RUS,Jordan,JOR,10,0,0,0,10
2002,Serbia and Kosovo: S/RES/1244 (1999),SRB,Jordan,JOR,0,0,0,5,5
2002,Somalia,SOM,Jordan,JOR,0,0,17,5,22
2002,Sudan,SDN,Jordan,JOR,0,0,93,122,215
2002,Syrian Arab Rep.,SYR,Jordan,JOR,5,0,64,53,122
2002,Tunisia,TUN,Jordan,JOR,0,0,0,5,5
2002,Yemen,YEM,Jordan,JOR,0,0,0,5,5
2002,Stateless,XXA,Jordan,JOR,5,0,0,5,10
2002,China,CHN,Kazakhstan,KAZ,5,0,17,0,22
2002,Burundi,BDI,Kenya,KEN,72,0,35,32,139
2002,Dem. Rep. of the Congo,COD,Kenya,KEN,238,0,195,355,788
2002,Eritrea,ERI,Kenya,KEN,20,0,36,836,892
2002,Ethiopia,ETH,Kenya,KEN,578,0,731,5174,6483
2002,Iraq,IRQ,Kenya,KEN,0,0,0,11,11
2002,Liberia,LBR,Kenya,KEN,5,0,0,0,5
2002,Rwanda,RWA,Kenya,KEN,102,0,110,639,851
2002,Sierra Leone,SLE,Kenya,KEN,0,0,0,5,5
2002,Somalia,SOM,Kenya,KEN,199,0,5,3359,3563
2002,Sudan,SDN,Kenya,KEN,17,0,5,941,963
2002,United Rep. of Tanzania,TZA,Kenya,KEN,0,0,0,19,19
2002,Uganda,UGA,Kenya,KEN,31,0,45,16,92
2002,Palestinian,PSE,Kuwait,KWT,11,0,0,0,11
2002,Iraq,IRQ,Kuwait,KWT,0,0,0,5,5
2002,Afghanistan,AFG,Lebanon,LBN,0,0,0,11,11
2002,Algeria,DZA,Lebanon,LBN,10,0,19,59,88
2002,Egypt,EGY,Lebanon,LBN,0,0,24,72,96
2002,Burundi,BDI,Lebanon,LBN,0,0,0,13,13
2002,Chad,TCD,Lebanon,LBN,0,0,0,13,13
2002,Congo,COG,Lebanon,LBN,0,0,11,0,11
2002,Dem. Rep. of the Congo,COD,Lebanon,LBN,0,0,5,5,10
2002,Eritrea,ERI,Lebanon,LBN,0,0,5,35,40
2002,Ethiopia,ETH,Lebanon,LBN,0,0,0,119,119
2002,Iran (Islamic Rep. of),IRN,Lebanon,LBN,0,0,5,12,17
2002,Iraq,IRQ,Lebanon,LBN,133,0,1374,1605,3112
2002,Jordan,JOR,Lebanon,LBN,0,0,10,15,25
2002,Liberia,LBR,Lebanon,LBN,0,0,10,24,34
2002,Nigeria,NGA,Lebanon,LBN,0,0,10,81,91
2002,Rwanda,RWA,Lebanon,LBN,0,0,10,31,41
2002,Sierra Leone,SLE,Lebanon,LBN,0,0,5,52,57
2002,Somalia,SOM,Lebanon,LBN,0,0,18,51,69
2002,Sudan,SDN,Lebanon,LBN,37,0,627,440,1104
2002,Tunisia,TUN,Lebanon,LBN,0,0,5,5,10
2002,Turkey,TUR,Lebanon,LBN,0,0,14,33,47
2002,Yemen,YEM,Lebanon,LBN,0,0,0,5,5
2002,Stateless,XXA,Lebanon,LBN,0,0,5,5,10
2002,Iraq,IRQ,Sri Lanka,LKA,14,0,5,0,19
2002,Liberia,LBR,Mauritania,MRT,12,0,0,0,12
2002,Sierra Leone,SLE,Mauritania,MRT,40,0,0,0,40
2002,Serbia and Kosovo: S/RES/1244 (1999),SRB,North Macedonia,MKD,0,0,75,32,107
2002,Afghanistan,AFG,Rep. of Moldova,MDA,0,0,0,5,5
2002,Palestinian,PSE,Rep. of Moldova,MDA,0,0,0,5,5
2002,Georgia,GEO,Rep. of Moldova,MDA,0,0,0,5,5
2002,Iran (Islamic Rep. of),IRN,Rep. of Moldova,MDA,0,0,5,0,5
2002,Iraq,IRQ,Rep. of Moldova,MDA,0,0,5,16,21
2002,Russian Federation,RUS,Rep. of Moldova,MDA,44,0,0,28,72
2002,Somalia,SOM,Rep. of Moldova,MDA,0,0,0,5,5
2002,Sudan,SDN,Rep. of Moldova,MDA,0,0,5,0,5
2002,Colombia,COL,Mexico,MEX,13,0,0,0,13
2002,Cuba,CUB,Mexico,MEX,5,0,5,0,10
2002,Palestinian,PSE,Mexico,MEX,0,0,0,5,5
2002,Romania,ROU,Mexico,MEX,0,0,0,5,5
2002,Yemen,YEM,Mexico,MEX,0,0,0,5,5
2002,Afghanistan,AFG,Malaysia,MYS,0,0,36,14,50
2002,Bangladesh,BGD,Malaysia,MYS,0,0,14,5,19
2002,China,CHN,Malaysia,MYS,5,0,5,0,10
2002,Indonesia,IDN,Malaysia,MYS,86,16,206,52,360
2002,Iran (Islamic Rep. of),IRN,Malaysia,MYS,0,0,0,5,5
2002,Iraq,IRQ,Malaysia,MYS,22,0,5,0,27
2002,Sri Lanka,LKA,Malaysia,MYS,0,0,0,5,5
2002,Myanmar,MMR,Malaysia,MYS,108,5,159,23,295
2002,Philippines,PHL,Malaysia,MYS,13,0,0,0,13
2002,Somalia,SOM,Malaysia,MYS,5,0,0,0,5
2002,Uzbekistan,UZB,Malaysia,MYS,0,0,5,0,5
2002,Palestinian,PSE,Malta,MLT,0,0,5,0,5
2002,Iran (Islamic Rep. of),IRN,Malta,MLT,5,0,0,0,5
2002,Iraq,IRQ,Malta,MLT,0,0,11,0,11
2002,Libya,LBY,Malta,MLT,0,0,0,10,10
2002,Sudan,SDN,Malta,MLT,5,0,47,0,52
2002,Turkey,TUR,Malta,MLT,0,0,5,0,5
2002,Algeria,DZA,Niger,NER,0,0,0,5,5
2002,Chad,TCD,Niger,NER,0,0,12,0,12
2002,Cameroon,CMR,Niger,NER,0,0,0,49,49
2002,Congo,COG,Niger,NER,0,0,5,18,23
2002,Dem. Rep. of the Congo,COD,Niger,NER,13,0,31,238,282
2002,Comoros,COM,Niger,NER,0,0,0,5,5
2002,Guinea-Bissau,GNB,Niger,NER,0,0,0,5,5
2002,Cote d'Ivoire,CIV,Niger,NER,0,0,0,10,10
2002,Liberia,LBR,Niger,NER,0,0,0,10,10
2002,Rwanda,RWA,Niger,NER,14,0,0,0,14
2002,Sierra Leone,SLE,Niger,NER,5,0,5,10,20
2002,Somalia,SOM,Niger,NER,0,0,0,20,20
2002,Sudan,SDN,Niger,NER,0,0,0,10,10
2002,Algeria,DZA,Pakistan,PAK,0,0,0,5,5
2002,Angola,AGO,Pakistan,PAK,0,0,5,0,5
2002,Egypt,EGY,Pakistan,PAK,0,0,0,13,13
2002,Azerbaijan,AZE,Pakistan,PAK,0,0,0,5,5
2002,Burundi,BDI,Pakistan,PAK,0,0,0,5,5
2002,China,CHN,Pakistan,PAK,17,0,0,5,22
2002,Congo,COG,Pakistan,PAK,0,0,0,5,5
2002,Ethiopia,ETH,Pakistan,PAK,0,0,0,5,5
2002,Palestinian,PSE,Pakistan,PAK,0,0,0,5,5
2002,Guinea-Bissau,GNB,Pakistan,PAK,0,0,0,5,5
2002,Iran (Islamic Rep. of),IRN,Pakistan,PAK,55,0,123,149,327
2002,Iraq,IRQ,Pakistan,PAK,5,0,96,94,195
2002,Kenya,KEN,Pakistan,PAK,0,0,0,5,5
2002,Liberia,LBR,Pakistan,PAK,0,0,0,17,17
2002,Libya,LBY,Pakistan,PAK,0,0,0,10,10
2002,Sri Lanka,LKA,Pakistan,PAK,0,0,0,5,5
2002,Niger,NER,Pakistan,PAK,0,0,0,10,10
2002,Nigeria,NGA,Pakistan,PAK,0,0,0,110,110
2002,Russian Federation,RUS,Pakistan,PAK,0,0,0,10,10
2002,Rwanda,RWA,Pakistan,PAK,0,0,0,5,5
2002,Saudi Arabia,SAU,Pakistan,PAK,0,0,0,5,5
2002,Sierra Leone,SLE,Pakistan,PAK,0,0,0,29,29
2002,Somalia,SOM,Pakistan,PAK,0,0,96,161,257
2002,Syrian Arab Rep.,SYR,Pakistan,PAK,0,0,0,18,18
2002,United Rep. of Tanzania,TZA,Pakistan,PAK,0,0,64,40,104
2002,Tajikistan,TJK,Pakistan,PAK,0,0,0,5,5
2002,Togo,TGO,Pakistan,PAK,0,0,0,5,5
2002,Uganda,UGA,Pakistan,PAK,0,0,0,5,5
2002,Zimbabwe,ZWE,Pakistan,PAK,0,0,0,5,5
2002,Cuba,CUB,Paraguay,PRY,0,0,0,10,10
2002,Iraq,IRQ,Qatar,QAT,0,0,5,0,5
2002,Sudan,SDN,Qatar,QAT,0,0,5,0,5
2002,Burundi,BDI,Rwanda,RWA,200,0,0,59,259
2002,Dem. Rep. of the Congo,COD,Rwanda,RWA,425,0,0,236,661
2002,Afghanistan,AFG,Saudi Arabia,SAU,0,0,18,5,23
2002,Ethiopia,ETH,Saudi Arabia,SAU,0,0,5,5,10
2002,Iraq,IRQ,Saudi Arabia,SAU,0,0,14,10,24
2002,Somalia,SOM,Saudi Arabia,SAU,49,0,5,71,125
2002,Sudan,SDN,Saudi Arabia,SAU,10,0,47,0,57
2002,Syrian Arab Rep.,SYR,Saudi Arabia,SAU,0,0,17,5,22
2002,Afghanistan,AFG,Serbia and Kosovo: S/RES/1244 (1999),SRB,5,0,30,12,47
2002,Albania,ALB,Serbia and Kosovo: S/RES/1244 (1999),SRB,0,0,5,0,5
2002,Algeria,DZA,Serbia and Kosovo: S/RES/1244 (1999),SRB,0,0,0,5,5
2002,Azerbaijan,AZE,Serbia and Kosovo: S/RES/1244 (1999),SRB,5,0,0,0,5
2002,Iran (Islamic Rep. of),IRN,Serbia and Kosovo: S/RES/1244 (1999),SRB,0,0,5,5,10
2002,Iraq,IRQ,Serbia and Kosovo: S/RES/1244 (1999),SRB,22,0,39,26,87
2002,Russian Federation,RUS,Serbia and Kosovo: S/RES/1244 (1999),SRB,0,0,0,12,12
2002,Sudan,SDN,Serbia and Kosovo: S/RES/1244 (1999),SRB,0,0,5,0,5
2002,Sri Lanka,LKA,Singapore,SGP,0,0,0,5,5
2002,Malaysia,MYS,Singapore,SGP,0,0,0,5,5
2002,Afghanistan,AFG,Sierra Leone,SLE,0,0,0,5,5
2002,Liberia,LBR,Sierra Leone,SLE,5,0,0,0,5
2002,Ethiopia,ETH,Somalia,SOM,36,0,72,147,255
2002,Sudan,SDN,Somalia,SOM,5,0,0,0,5
2002,United Rep. of Tanzania,TZA,Somalia,SOM,0,0,26,0,26
2002,Afghanistan,AFG,Turkmenistan,TKM,5,0,16,72,93
2002,Azerbaijan,AZE,Turkmenistan,TKM,51,0,68,44,163
2002,Russian Federation,RUS,Turkmenistan,TKM,5,0,0,0,5
2002,Tajikistan,TJK,Turkmenistan,TKM,0,0,252,41,293
2002,Indonesia,IDN,Timor-Leste,TLS,0,0,11,0,11
2002,Sri Lanka,LKA,Timor-Leste,TLS,0,0,0,17,17
2002,Congo,COG,Togo,TGO,0,0,5,0,5
2002,Dem. Rep. of the Congo,COD,Togo,TGO,10,0,0,0,10
2002,Rwanda,RWA,Togo,TGO,20,0,5,0,25
2002,Somalia,SOM,Togo,TGO,5,0,0,0,5
2002,Afghanistan,AFG,Turkey,TUR,54,0,86,134,274
2002,Algeria,DZA,Turkey,TUR,0,0,0,13,13
2002,Egypt,EGY,Turkey,TUR,0,0,0,5,5
2002,China,CHN,Turkey,TUR,16,0,20,13,49
2002,Dem. Rep. of the Congo,COD,Turkey,TUR,0,0,14,5,19
2002,Eritrea,ERI,Turkey,TUR,5,0,0,0,5
2002,Ethiopia,ETH,Turkey,TUR,5,0,0,0,5
2002,Palestinian,PSE,Turkey,TUR,17,0,5,5,27
2002,Iran (Islamic Rep. of),IRN,Turkey,TUR,2380,0,982,126,3488
2002,Iraq,IRQ,Turkey,TUR,356,0,803,171,1330
2002,Kenya,KEN,Turkey,TUR,0,0,17,0,17
2002,Sri Lanka,LKA,Turkey,TUR,0,0,12,23,35
2002,Nigeria,NGA,Turkey,TUR,0,0,5,5,10
2002,Pakistan,PAK,Turkey,TUR,0,0,0,5,5
2002,Sierra Leone,SLE,Turkey,TUR,0,0,5,0,5
2002,Somalia,SOM,Turkey,TUR,16,0,5,5,26
2002,Sudan,SDN,Turkey,TUR,0,0,0,5,5
2002,Syrian Arab Rep.,SYR,Turkey,TUR,11,0,0,0,11
2002,Tunisia,TUN,Turkey,TUR,0,0,0,10,10
2002,Uzbekistan,UZB,Turkey,TUR,27,0,5,0,32
2002,Stateless,XXA,Turkey,TUR,5,0,0,0,5
2002,Afghanistan,AFG,United Arab Emirates,ARE,0,0,10,0,10
2002,Ethiopia,ETH,United Arab Emirates,ARE,0,0,0,5,5
2002,Iran (Islamic Rep. of),IRN,United Arab Emirates,ARE,0,0,17,0,17
2002,Iraq,IRQ,United Arab Emirates,ARE,0,0,24,0,24
2002,Jordan,JOR,United Arab Emirates,ARE,0,0,0,5,5
2002,Somalia,SOM,United Arab Emirates,ARE,0,0,59,47,106
2002,Sudan,SDN,United Arab Emirates,ARE,0,0,10,0,10
2002,Tajikistan,TJK,United Arab Emirates,ARE,0,0,10,0,10
2002,Yemen,YEM,United Arab Emirates,ARE,0,0,10,13,23
2002,Colombia,COL,Uruguay,URY,5,0,0,5,10
2002,Afghanistan,AFG,Uzbekistan,UZB,544,0,22,206,772
2002,Azerbaijan,AZE,Uzbekistan,UZB,0,0,5,5,10
2002,Egypt,EGY,Yemen,YEM,0,0,0,14,14
2002,Djibouti,DJI,Yemen,YEM,0,0,0,12,12
2002,Eritrea,ERI,Yemen,YEM,0,0,43,98,141
2002,Ethiopia,ETH,Yemen,YEM,24,0,230,767,1021
2002,Palestinian,PSE,Yemen,YEM,27,0,5,35,67
2002,Iraq,IRQ,Yemen,YEM,48,0,288,457,793
2002,Jordan,JOR,Yemen,YEM,0,0,10,0,10
2002,Saudi Arabia,SAU,Yemen,YEM,0,0,0,53,53
2002,Viet Nam,VNM,Yemen,YEM,0,0,0,5,5
2002,Sudan,SDN,Yemen,YEM,0,0,34,429,463
2003,Iran (Islamic Rep. of),IRN,Afghanistan,AFG,0,0,0,13,13
2003,Iraq,IRQ,Afghanistan,AFG,0,0,5,0,5
2003,Pakistan,PAK,Afghanistan,AFG,5,0,0,0,5
2003,Afghanistan,AFG,Egypt,EGY,0,0,5,0,5
2003,Algeria,DZA,Egypt,EGY,0,0,5,0,5
2003,Burundi,BDI,Egypt,EGY,26,0,0,0,26
2003,Chad,TCD,Egypt,EGY,5,0,5,0,10
2003,China,CHN,Egypt,EGY,0,0,5,0,5
2003,Dem. Rep. of the Congo,COD,Egypt,EGY,0,0,14,0,14
2003,Djibouti,DJI,Egypt,EGY,0,0,5,0,5
2003,Eritrea,ERI,Egypt,EGY,65,0,34,0,99
2003,Ethiopia,ETH,Egypt,EGY,229,0,201,0,430
2003,Palestinian,PSE,Egypt,EGY,18,0,0,0,18
2003,Cote d'Ivoire,CIV,Egypt,EGY,67,0,0,0,67
2003,Iraq,IRQ,Egypt,EGY,0,0,12,0,12
2003,Liberia,LBR,Egypt,EGY,16,0,0,0,16
2003,Libya,LBY,Egypt,EGY,5,0,0,0,5
2003,Russian Federation,RUS,Egypt,EGY,5,0,0,0,5
2003,Rwanda,RWA,Egypt,EGY,5,0,5,0,10
2003,Sierra Leone,SLE,Egypt,EGY,13,0,0,0,13
2003,Somalia,SOM,Egypt,EGY,1590,0,234,0,1824
2003,Sudan,SDN,Egypt,EGY,8674,0,2083,0,10757
2003,Syrian Arab Rep.,SYR,Egypt,EGY,5,0,5,0,10
2003,Togo,TGO,Egypt,EGY,0,0,5,0,5
2003,Tunisia,TUN,Egypt,EGY,0,0,0,5,5
2003,Uganda,UGA,Egypt,EGY,5,0,0,0,5
2003,Yemen,YEM,Egypt,EGY,0,0,10,0,10
2003,Afghanistan,AFG,Azerbaijan,AZE,32,0,15,14,61
2003,Algeria,DZA,Azerbaijan,AZE,0,0,0,5,5
2003,Iran (Islamic Rep. of),IRN,Azerbaijan,AZE,25,0,22,0,47
2003,Iraq,IRQ,Azerbaijan,AZE,0,0,11,0,11
2003,Kuwait,KWT,Azerbaijan,AZE,5,0,0,0,5
2003,Russian Federation,RUS,Azerbaijan,AZE,42,0,0,0,42
2003,Somalia,SOM,Azerbaijan,AZE,5,0,0,0,5
2003,Turkmenistan,TKM,Azerbaijan,AZE,0,0,0,5,5
2003,Turkey,TUR,Azerbaijan,AZE,0,0,0,5,5
2003,Myanmar,MMR,Bangladesh,BGD,29,0,28,5,62
2003,Egypt,EGY,Bosnia and Herzegovina,BIH,0,0,0,5,5
2003,Bangladesh,BGD,Bosnia and Herzegovina,BIH,0,0,0,10,10
2003,Iran (Islamic Rep. of),IRN,Bosnia and Herzegovina,BIH,0,0,0,5,5
2003,Iraq,IRQ,Bosnia and Herzegovina,BIH,0,0,0,5,5
2003,North Macedonia,MKD,Bosnia and Herzegovina,BIH,0,0,39,33,72
2003,Rep. of Moldova,MDA,Bosnia and Herzegovina,BIH,0,0,5,5,10
2003,Romania,ROU,Bosnia and Herzegovina,BIH,0,0,5,0,5
2003,Serbia and Kosovo: S/RES/1244 (1999),SRB,Bosnia and Herzegovina,BIH,16,0,255,101,372
2003,Ukraine,UKR,Bosnia and Herzegovina,BIH,0,0,0,5,5
2003,China,CHN,Cambodia,KHM,0,0,5,0,5
2003,Pakistan,PAK,Cambodia,KHM,0,0,5,0,5
2003,Viet Nam,VNM,Cambodia,KHM,37,0,54,16,107
2003,Burundi,BDI,China,CHN,5,0,0,0,5
2003,Iran (Islamic Rep. of),IRN,China,CHN,5,0,0,0,5
2003,Burundi,BDI,Cameroon,CMR,14,0,0,0,14
2003,Central African Rep.,CAF,Cameroon,CMR,106,0,136,0,242
2003,Chad,TCD,Cameroon,CMR,21,0,35,0,56
2003,Congo,COG,Cameroon,CMR,72,0,45,0,117
2003,Dem. Rep. of the Congo,COD,Cameroon,CMR,97,0,174,5,276
2003,Cote d'Ivoire,CIV,Cameroon,CMR,11,0,28,0,39
2003,Liberia,LBR,Cameroon,CMR,52,0,10,0,62
2003,Rwanda,RWA,Cameroon,CMR,105,0,38,5,148
2003,Iran (Islamic Rep. of),IRN,Colombia,COL,5,0,0,0,5
2003,Ethiopia,ETH,Cuba,CUB,10,0,0,0,10
2003,Iran (Islamic Rep. of),IRN,Cuba,CUB,0,0,5,0,5
2003,Russian Federation,RUS,Cuba,CUB,0,0,0,5,5
2003,Algeria,DZA,Cyprus,CYP,0,0,5,0,5
2003,Armenia,ARM,Cyprus,CYP,0,0,10,0,10
2003,Azerbaijan,AZE,Cyprus,CYP,0,0,0,5,5
2003,Bangladesh,BGD,Cyprus,CYP,0,0,5,0,5
2003,Bosnia and Herzegovina,BIH,Cyprus,CYP,11,0,39,0,50
2003,Bulgaria,BGR,Cyprus,CYP,0,0,5,0,5
2003,Cameroon,CMR,Cyprus,CYP,0,0,15,0,15
2003,Palestinian,PSE,Cyprus,CYP,10,0,12,11,33
2003,Georgia,GEO,Cyprus,CYP,0,0,21,12,33
2003,India,IND,Cyprus,CYP,0,0,5,0,5
2003,Iran (Islamic Rep. of),IRN,Cyprus,CYP,100,0,403,127,630
2003,Iraq,IRQ,Cyprus,CYP,0,0,11,5,16
2003,Jordan,JOR,Cyprus,CYP,0,0,5,0,5
2003,Kyrgyzstan,KGZ,Cyprus,CYP,0,0,5,0,5
2003,Lebanon,LBN,Cyprus,CYP,0,0,27,10,37
2003,Sri Lanka,LKA,Cyprus,CYP,0,0,28,0,28
2003,Rep. of Moldova,MDA,Cyprus,CYP,0,0,0,5,5
2003,Nigeria,NGA,Cyprus,CYP,0,0,5,5,10
2003,Pakistan,PAK,Cyprus,CYP,5,0,168,24,197
2003,Russian Federation,RUS,Cyprus,CYP,15,0,123,36,174
2003,Serbia and Kosovo: S/RES/1244 (1999),SRB,Cyprus,CYP,5,0,175,39,219
2003,Sierra Leone,SLE,Cyprus,CYP,0,0,0,5,5
2003,Somalia,SOM,Cyprus,CYP,0,0,5,0,5
2003,Syrian Arab Rep.,SYR,Cyprus,CYP,5,0,12,0,17
2003,Turkey,TUR,Cyprus,CYP,18,0,26,5,49
2003,Ukraine,UKR,Cyprus,CYP,0,0,36,0,36
2003,Uzbekistan,UZB,Cyprus,CYP,0,0,10,0,10
2003,Ethiopia,ETH,Eritrea,ERI,5,0,0,0,5
2003,Algeria,DZA,"China, Hong Kong SAR",HKG,0,0,0,5,5
2003,Bangladesh,BGD,"China, Hong Kong SAR",HKG,0,0,5,0,5
2003,Cameroon,CMR,"China, Hong Kong SAR",HKG,0,0,20,5,25
2003,Congo,COG,"China, Hong Kong SAR",HKG,5,0,0,0,5
2003,Dem. Rep. of the Congo,COD,"China, Hong Kong SAR",HKG,0,0,0,5,5
2003,Eritrea,ERI,"China, Hong Kong SAR",HKG,0,0,5,0,5
2003,Ethiopia,ETH,"China, Hong Kong SAR",HKG,5,0,0,0,5
2003,Ghana,GHA,"China, Hong Kong SAR",HKG,0,0,0,12,12
2003,Cote d'Ivoire,CIV,"China, Hong Kong SAR",HKG,0,0,12,0,12
2003,India,IND,"China, Hong Kong SAR",HKG,0,0,5,5,10
2003,Indonesia,IDN,"China, Hong Kong SAR",HKG,0,0,5,0,5
2003,Liberia,LBR,"China, Hong Kong SAR",HKG,0,0,5,0,5
2003,Sri Lanka,LKA,"China, Hong Kong SAR",HKG,12,0,28,12,52
2003,Nepal,NPL,"China, Hong Kong SAR",HKG,0,0,5,5,10
2003,Nigeria,NGA,"China, Hong Kong SAR",HKG,0,0,5,0,5
2003,Pakistan,PAK,"China, Hong Kong SAR",HKG,77,10,79,30,196
2003,Sierra Leone,SLE,"China, Hong Kong SAR",HKG,0,0,5,0,5
2003,Togo,TGO,"China, Hong Kong SAR",HKG,0,0,0,5,5
2003,Uganda,UGA,"China, Hong Kong SAR",HKG,0,0,5,0,5
2003,United States of America,USA,"China, Hong Kong SAR",HKG,0,0,0,5,5
2003,Zimbabwe,ZWE,"China, Hong Kong SAR",HKG,5,0,0,0,5
2003,Afghanistan,AFG,Croatia,HRV,0,0,0,5,5
2003,Algeria,DZA,Croatia,HRV,0,0,5,5,10
2003,Bangladesh,BGD,Croatia,HRV,0,0,0,5,5
2003,Palestinian,PSE,Croatia,HRV,0,0,0,5,5
2003,Iran (Islamic Rep. of),IRN,Croatia,HRV,0,0,0,13,13
2003,Iraq,IRQ,Croatia,HRV,0,0,0,15,15
2003,Liberia,LBR,Croatia,HRV,0,0,0,5,5
2003,Pakistan,PAK,Croatia,HRV,0,0,0,5,5
2003,Serbia and Kosovo: S/RES/1244 (1999),SRB,Croatia,HRV,0,0,5,0,5
2003,Afghanistan,AFG,India,IND,74,0,40,35,149
2003,China,CHN,India,IND,5,0,0,0,5
2003,Eritrea,ERI,India,IND,0,0,14,10,24
2003,Ethiopia,ETH,India,IND,5,0,22,15,42
2003,Iran (Islamic Rep. of),IRN,India,IND,12,0,10,0,22
2003,Iraq,IRQ,India,IND,0,0,0,11,11
2003,Liberia,LBR,India,IND,0,0,5,0,5
2003,Myanmar,MMR,India,IND,85,0,233,96,414
2003,Somalia,SOM,India,IND,5,0,26,0,31
2003,Sudan,SDN,India,IND,5,0,47,0,52
2003,Afghanistan,AFG,Indonesia,IDN,14,0,29,10,53
2003,Cameroon,CMR,Indonesia,IDN,0,0,0,5,5
2003,Dem. Rep. of the Congo,COD,Indonesia,IDN,0,0,13,0,13
2003,Cote d'Ivoire,CIV,Indonesia,IDN,0,0,0,5,5
2003,India,IND,Indonesia,IDN,0,0,0,14,14
2003,Iran (Islamic Rep. of),IRN,Indonesia,IDN,0,0,33,0,33
2003,Iraq,IRQ,Indonesia,IDN,23,0,22,38,83
2003,Sri Lanka,LKA,Indonesia,IDN,0,0,5,12,17
2003,Pakistan,PAK,Indonesia,IDN,0,0,5,5,10
2003,Philippines,PHL,Indonesia,IDN,0,0,0,5,5
2003,Somalia,SOM,Indonesia,IDN,11,0,5,0,16
2003,Viet Nam,VNM,Indonesia,IDN,0,0,66,34,100
2003,Sudan,SDN,Indonesia,IDN,0,0,5,0,5
2003,Timor-Leste,TLS,Indonesia,IDN,0,0,0,26,26
2003,Turkey,TUR,Indonesia,IDN,0,0,0,10,10
2003,Somalia,SOM,Iran (Islamic Rep. of),IRN,0,0,19,0,19
2003,Tunisia,TUN,Iran (Islamic Rep. of),IRN,0,0,5,0,5
2003,Turkey,TUR,Iran (Islamic Rep. of),IRN,0,0,0,11,11
2003,Afghanistan,AFG,Jordan,JOR,0,0,0,5,5
2003,Algeria,DZA,Jordan,JOR,0,0,0,11,11
2003,Egypt,EGY,Jordan,JOR,5,0,11,22,38
2003,Eritrea,ERI,Jordan,JOR,0,0,5,0,5
2003,Ethiopia,ETH,Jordan,JOR,5,0,0,0,5
2003,Iran (Islamic Rep. of),IRN,Jordan,JOR,5,0,0,0,5
2003,Iraq,IRQ,Jordan,JOR,247,0,117,75,439
2003,Jamaica,JAM,Jordan,JOR,0,0,0,5,5
2003,Sri Lanka,LKA,Jordan,JOR,0,0,0,5,5
2003,Russian Federation,RUS,Jordan,JOR,0,0,0,5,5
2003,Saudi Arabia,SAU,Jordan,JOR,0,0,0,5,5
2003,Somalia,SOM,Jordan,JOR,46,0,0,0,46
2003,Sudan,SDN,Jordan,JOR,37,0,22,39,98
2003,Syrian Arab Rep.,SYR,Jordan,JOR,21,0,15,33,69
2003,Tunisia,TUN,Jordan,JOR,0,0,5,5,10
2003,Yemen,YEM,Jordan,JOR,5,0,5,0,10
2003,China,CHN,Kazakhstan,KAZ,11,0,0,0,11
2003,Burundi,BDI,Kenya,KEN,53,0,36,0,89
2003,Dem. Rep. of the Congo,COD,Kenya,KEN,268,0,180,0,448
2003,Eritrea,ERI,Kenya,KEN,56,0,55,0,111
2003,Ethiopia,ETH,Kenya,KEN,307,0,706,0,1013
2003,Rwanda,RWA,Kenya,KEN,74,0,122,0,196
2003,Somalia,SOM,Kenya,KEN,108,0,191,0,299
2003,Sudan,SDN,Kenya,KEN,176,0,18,5,199
2003,Uganda,UGA,Kenya,KEN,27,0,202,0,229
2003,Iraq,IRQ,Kuwait,KWT,0,0,0,5,5
2003,Chad,TCD,Libya,LBY,10,0,5,0,15
2003,Dem. Rep. of the Congo,COD,Libya,LBY,0,0,5,11,16
2003,Eritrea,ERI,Libya,LBY,0,0,0,5,5
2003,Ethiopia,ETH,Libya,LBY,0,0,0,5,5
2003,Palestinian,PSE,Libya,LBY,186,0,11,49,246
2003,Cote d'Ivoire,CIV,Libya,LBY,0,0,5,0,5
2003,Iraq,IRQ,Libya,LBY,0,0,5,0,5
2003,Liberia,LBR,Libya,LBY,22,0,5,10,37
2003,Sierra Leone,SLE,Libya,LBY,0,0,5,5,10
2003,Somalia,SOM,Libya,LBY,5,0,0,0,5
2003,Sudan,SDN,Libya,LBY,0,0,5,0,5
2003,Algeria,DZA,Lebanon,LBN,0,0,5,0,5
2003,Egypt,EGY,Lebanon,LBN,0,0,5,0,5
2003,Iran (Islamic Rep. of),IRN,Lebanon,LBN,0,0,5,0,5
2003,Iraq,IRQ,Lebanon,LBN,5,0,26,39,70
2003,Nigeria,NGA,Lebanon,LBN,0,0,0,5,5
2003,Rwanda,RWA,Lebanon,LBN,0,0,5,0,5
2003,Saudi Arabia,SAU,Lebanon,LBN,5,0,0,0,5
2003,Somalia,SOM,Lebanon,LBN,0,0,12,0,12
2003,Sudan,SDN,Lebanon,LBN,0,0,140,45,185
2003,Afghanistan,AFG,Sri Lanka,LKA,14,0,0,0,14
2003,Iraq,IRQ,Sri Lanka,LKA,5,0,0,0,5
2003,Pakistan,PAK,Sri Lanka,LKA,0,0,0,5,5
2003,Afghanistan,AFG,Malaysia,MYS,13,0,0,0,13
2003,Burundi,BDI,Malaysia,MYS,0,0,0,5,5
2003,Bangladesh,BGD,Malaysia,MYS,0,0,5,73,78
2003,China,CHN,Malaysia,MYS,0,0,5,0,5
2003,Eritrea,ERI,Malaysia,MYS,0,0,0,5,5
2003,India,IND,Malaysia,MYS,0,0,0,10,10
2003,Indonesia,IDN,Malaysia,MYS,121,3109,316,1484,5030
2003,Iran (Islamic Rep. of),IRN,Malaysia,MYS,0,0,12,5,17
2003,Iraq,IRQ,Malaysia,MYS,12,0,0,5,17
2003,Liberia,LBR,Malaysia,MYS,0,0,5,48,53
2003,Sri Lanka,LKA,Malaysia,MYS,0,0,5,27,32
2003,Myanmar,MMR,Malaysia,MYS,279,3979,239,1193,5690
2003,Nepal,NPL,Malaysia,MYS,0,0,0,5,5
2003,Pakistan,PAK,Malaysia,MYS,0,0,5,5,10
2003,Russian Federation,RUS,Malaysia,MYS,0,0,0,5,5
2003,Somalia,SOM,Malaysia,MYS,5,0,0,5,10
2003,Uzbekistan,UZB,Malaysia,MYS,5,0,0,0,5
2003,Central African Rep.,CAF,Niger,NER,5,0,0,0,5
2003,Chad,TCD,Niger,NER,10,0,0,0,10
2003,Dem. Rep. of the Congo,COD,Niger,NER,5,0,10,25,40
2003,Palestinian,PSE,Niger,NER,5,0,0,0,5
2003,Cote d'Ivoire,CIV,Niger,NER,10,0,0,0,10
2003,Iraq,IRQ,Niger,NER,5,0,0,0,5
2003,Afghanistan,AFG,Pakistan,PAK,352,0,1408,5820,7580
2003,Angola,AGO,Pakistan,PAK,0,0,5,0,5
2003,Egypt,EGY,Pakistan,PAK,0,0,0,10,10
2003,Burundi,BDI,Pakistan,PAK,0,0,10,0,10
2003,China,CHN,Pakistan,PAK,5,0,21,19,45
2003,Congo,COG,Pakistan,PAK,0,0,5,5,10
2003,Cote d'Ivoire,CIV,Pakistan,PAK,0,0,0,12,12
2003,Iran (Islamic Rep. of),IRN,Pakistan,PAK,26,0,297,128,451
2003,Iraq,IRQ,Pakistan,PAK,0,0,24,83,107
2003,Jordan,JOR,Pakistan,PAK,0,0,0,5,5
2003,Kenya,KEN,Pakistan,PAK,0,0,0,5,5
2003,Liberia,LBR,Pakistan,PAK,0,0,24,15,39
2003,Sri Lanka,LKA,Pakistan,PAK,0,0,5,5,10
2003,Niger,NER,Pakistan,PAK,0,0,5,0,5
2003,Nigeria,NGA,Pakistan,PAK,0,0,185,135,320
2003,Rwanda,RWA,Pakistan,PAK,0,0,5,0,5
2003,Sierra Leone,SLE,Pakistan,PAK,0,0,36,18,54
2003,Somalia,SOM,Pakistan,PAK,5,0,129,57,191
2003,Syrian Arab Rep.,SYR,Pakistan,PAK,5,0,0,0,5
2003,United Rep. of Tanzania,TZA,Pakistan,PAK,0,0,113,31,144
2003,Zimbabwe,ZWE,Pakistan,PAK,0,0,0,5,5
2003,Cuba,CUB,Paraguay,PRY,5,0,0,0,5
2003,Burundi,BDI,Rwanda,RWA,76,0,0,0,76
2003,Chad,TCD,Rwanda,RWA,10,0,0,0,10
2003,Dem. Rep. of the Congo,COD,Rwanda,RWA,151,0,0,0,151
2003,Ethiopia,ETH,Rwanda,RWA,12,0,0,0,12
2003,Uganda,UGA,Rwanda,RWA,10,0,0,0,10
2003,Bangladesh,BGD,Saudi Arabia,SAU,0,0,0,5,5
2003,Palestinian,PSE,Saudi Arabia,SAU,0,0,0,5,5
2003,Iraq,IRQ,Saudi Arabia,SAU,0,0,0,10,10
2003,Myanmar,MMR,Saudi Arabia,SAU,0,0,0,10,10
2003,Nigeria,NGA,Saudi Arabia,SAU,0,0,5,0,5
2003,Pakistan,PAK,Saudi Arabia,SAU,0,0,5,0,5
2003,Somalia,SOM,Saudi Arabia,SAU,17,0,27,0,44
2003,Sudan,SDN,Saudi Arabia,SAU,0,0,13,5,18
2003,Syrian Arab Rep.,SYR,Saudi Arabia,SAU,0,0,0,5,5
2003,Afghanistan,AFG,Serbia and Kosovo: S/RES/1244 (1999),SRB,0,0,32,0,32
2003,Egypt,EGY,Serbia and Kosovo: S/RES/1244 (1999),SRB,0,0,0,5,5
2003,Azerbaijan,AZE,Serbia and Kosovo: S/RES/1244 (1999),SRB,0,0,5,0,5
2003,Bangladesh,BGD,Serbia and Kosovo: S/RES/1244 (1999),SRB,0,0,5,0,5
2003,Iran (Islamic Rep. of),IRN,Serbia and Kosovo: S/RES/1244 (1999),SRB,0,0,0,5,5
2003,Iraq,IRQ,Serbia and Kosovo: S/RES/1244 (1999),SRB,0,0,0,67,67
2003,Rep. of Moldova,MDA,Serbia and Kosovo: S/RES/1244 (1999),SRB,5,0,0,0,5
2003,Russian Federation,RUS,Serbia and Kosovo: S/RES/1244 (1999),SRB,10,0,0,0,10
2003,Liberia,LBR,Sierra Leone,SLE,0,0,0,142,142
2003,Afghanistan,AFG,Turkmenistan,TKM,0,0,5,13,18
2003,Azerbaijan,AZE,Turkmenistan,TKM,13,0,5,0,18
2003,Russian Federation,RUS,Turkmenistan,TKM,0,0,5,0,5
2003,Viet Nam,VNM,Timor-Leste,TLS,0,0,5,0,5
2003,Central African Rep.,CAF,Togo,TGO,5,0,0,0,5
2003,Congo,COG,Togo,TGO,5,0,0,0,5
2003,Dem. Rep. of the Congo,COD,Togo,TGO,17,0,5,0,22
2003,Cote d'Ivoire,CIV,Togo,TGO,56,0,0,0,56
2003,Liberia,LBR,Togo,TGO,5,0,0,0,5
2003,Rwanda,RWA,Togo,TGO,30,0,0,0,30
2003,Sierra Leone,SLE,Togo,TGO,0,0,5,0,5
2003,Afghanistan,AFG,Turkey,TUR,53,0,37,23,113
2003,China,CHN,Turkey,TUR,21,0,10,0,31
2003,Dem. Rep. of the Congo,COD,Turkey,TUR,0,0,0,11,11
2003,Eritrea,ERI,Turkey,TUR,0,0,13,0,13
2003,Ethiopia,ETH,Turkey,TUR,5,0,5,5,15
2003,Palestinian,PSE,Turkey,TUR,0,0,5,5,10
2003,Iran (Islamic Rep. of),IRN,Turkey,TUR,2009,0,380,0,2389
2003,Iraq,IRQ,Turkey,TUR,198,0,20,146,364
2003,Jordan,JOR,Turkey,TUR,0,0,0,5,5
2003,Kenya,KEN,Turkey,TUR,0,0,0,5,5
2003,Libya,LBY,Turkey,TUR,0,0,0,5,5
2003,Lebanon,LBN,Turkey,TUR,0,0,0,5,5
2003,Sri Lanka,LKA,Turkey,TUR,0,0,0,5,5
2003,Morocco,MAR,Turkey,TUR,5,0,0,0,5
2003,Pakistan,PAK,Turkey,TUR,0,0,10,0,10
2003,Somalia,SOM,Turkey,TUR,20,0,5,25,50
2003,Sudan,SDN,Turkey,TUR,12,0,0,0,12
2003,Syrian Arab Rep.,SYR,Turkey,TUR,5,0,0,0,5
2003,Tunisia,TUN,Turkey,TUR,0,0,5,0,5
2003,Uzbekistan,UZB,Turkey,TUR,16,0,5,0,21
2003,Afghanistan,AFG,United Arab Emirates,ARE,0,0,0,16,16
2003,Palestinian,PSE,United Arab Emirates,ARE,0,0,0,33,33
2003,Iraq,IRQ,United Arab Emirates,ARE,0,0,0,69,69
2003,Libya,LBY,United Arab Emirates,ARE,0,0,0,10,10
2003,Mauritania,MRT,United Arab Emirates,ARE,0,0,5,0,5
2003,Qatar,QAT,United Arab Emirates,ARE,0,0,0,16,16
2003,Somalia,SOM,United Arab Emirates,ARE,0,0,11,17,28
2003,Sudan,SDN,United Arab Emirates,ARE,0,0,0,24,24
2003,Syrian Arab Rep.,SYR,United Arab Emirates,ARE,12,0,0,51,63
2003,Tajikistan,TJK,United Arab Emirates,ARE,0,0,10,0,10
2003,Uganda,UGA,United Arab Emirates,ARE,0,0,0,10,10
2003,Uzbekistan,UZB,United Arab Emirates,ARE,5,0,0,0,5
2003,Cameroon,CMR,Uruguay,URY,5,0,0,0,5
2003,Afghanistan,AFG,Uzbekistan,UZB,150,0,218,142,510
2003,Azerbaijan,AZE,Uzbekistan,UZB,5,0,5,0,10
2003,Stateless,XXA,Uzbekistan,UZB,0,0,0,5,5
2003,Eritrea,ERI,Yemen,YEM,15,0,34,16,65
2003,Ethiopia,ETH,Yemen,YEM,100,0,214,2022,2336
2003,Palestinian,PSE,Yemen,YEM,0,207,0,0,207
2003,Iraq,IRQ,Yemen,YEM,0,0,60,0,60
2003,Kenya,KEN,Yemen,YEM,0,0,5,0,5
2003,Viet Nam,VNM,Yemen,YEM,27,0,0,0,27
2003,Sudan,SDN,Yemen,YEM,0,0,25,5,30
2004,China,CHN,Afghanistan,AFG,0,0,0,5,5
2004,Indonesia,IDN,Afghanistan,AFG,0,0,5,0,5
2004,Iran (Islamic Rep. of),IRN,Afghanistan,AFG,11,0,25,36,72
2004,Iraq,IRQ,Afghanistan,AFG,0,0,10,27,37
2004,Pakistan,PAK,Afghanistan,AFG,5,0,5,0,10
2004,Cote d'Ivoire,CIV,Algeria,DZA,0,0,5,0,5
2004,Liberia,LBR,Algeria,DZA,0,0,0,20,20
2004,Algeria,DZA,Egypt,EGY,5,0,0,5,10
2004,Burundi,BDI,Egypt,EGY,19,0,0,0,19
2004,Central African Rep.,CAF,Egypt,EGY,0,0,5,0,5
2004,Chad,TCD,Egypt,EGY,0,0,0,16,16
2004,Cameroon,CMR,Egypt,EGY,0,0,5,5,10
2004,Congo,COG,Egypt,EGY,0,0,0,13,13
2004,Dem. Rep. of the Congo,COD,Egypt,EGY,5,0,16,14,35
2004,Djibouti,DJI,Egypt,EGY,0,0,0,10,10
2004,Eritrea,ERI,Egypt,EGY,80,0,47,169,296
2004,Ethiopia,ETH,Egypt,EGY,146,0,174,369,689
2004,Palestinian,PSE,Egypt,EGY,30,0,0,0,30
2004,Georgia,GEO,Egypt,EGY,0,0,0,5,5
2004,Cote d'Ivoire,CIV,Egypt,EGY,0,0,0,34,34
2004,Iraq,IRQ,Egypt,EGY,0,0,0,80,80
2004,Jordan,JOR,Egypt,EGY,0,0,0,5,5
2004,Myanmar,MMR,Egypt,EGY,0,0,0,5,5
2004,Nigeria,NGA,Egypt,EGY,5,0,5,5,15
2004,Russian Federation,RUS,Egypt,EGY,0,0,0,5,5
2004,Rwanda,RWA,Egypt,EGY,0,0,0,11,11
2004,Saudi Arabia,SAU,Egypt,EGY,0,0,0,5,5
2004,Sierra Leone,SLE,Egypt,EGY,0,0,11,0,11
2004,Somalia,SOM,Egypt,EGY,942,0,5,1053,2000
2004,Sudan,SDN,Egypt,EGY,2436,0,603,932,3971
2004,Syrian Arab Rep.,SYR,Egypt,EGY,0,0,5,10,15
2004,Tajikistan,TJK,Egypt,EGY,0,0,0,5,5
2004,Tunisia,TUN,Egypt,EGY,5,0,0,0,5
2004,Uganda,UGA,Egypt,EGY,0,0,0,13,13
2004,Ukraine,UKR,Egypt,EGY,0,0,0,5,5
2004,Zimbabwe,ZWE,Egypt,EGY,0,0,0,10,10
2004,Afghanistan,AFG,Azerbaijan,AZE,36,0,260,11,307
2004,Iran (Islamic Rep. of),IRN,Azerbaijan,AZE,14,0,22,0,36
2004,Iraq,IRQ,Azerbaijan,AZE,0,0,31,0,31
2004,Russian Federation,RUS,Azerbaijan,AZE,263,0,0,8088,8351
2004,Dem. Rep. of the Congo,COD,Burundi,BDI,17,0,0,0,17
2004,Rwanda,RWA,Burundi,BDI,19,0,0,0,19
2004,Bangladesh,BGD,Bosnia and Herzegovina,BIH,0,0,5,0,5
2004,Palestinian,PSE,Bosnia and Herzegovina,BIH,0,0,0,5,5
2004,Sri Lanka,LKA,Bosnia and Herzegovina,BIH,0,0,0,12,12
2004,North Macedonia,MKD,Bosnia and Herzegovina,BIH,0,0,75,0,75
2004,Rep. of Moldova,MDA,Bosnia and Herzegovina,BIH,12,0,0,0,12
2004,Romania,ROU,Bosnia and Herzegovina,BIH,0,0,5,0,5
2004,Russian Federation,RUS,Bosnia and Herzegovina,BIH,0,0,0,5,5
2004,Serbia and Kosovo: S/RES/1244 (1999),SRB,Bosnia and Herzegovina,BIH,34,0,212,63,309
2004,Tunisia,TUN,Bosnia and Herzegovina,BIH,0,0,0,5,5
2004,Ukraine,UKR,Bosnia and Herzegovina,BIH,0,0,5,0,5
2004,China,CHN,Cambodia,KHM,5,0,0,0,5
2004,Dem. Rep. of the Congo,COD,Cambodia,KHM,5,0,0,0,5
2004,Liberia,LBR,Cambodia,KHM,0,0,0,5,5
2004,Viet Nam,VNM,Cambodia,KHM,407,0,184,19,610
2004,Burundi,BDI,China,CHN,0,5,5,0,10
2004,Dem. Rep. of the Congo,COD,China,CHN,0,0,0,5,5
2004,Cote d'Ivoire,CIV,China,CHN,5,0,0,0,5
2004,Iraq,IRQ,China,CHN,0,0,0,5,5
2004,Liberia,LBR,China,CHN,0,0,12,17,29
2004,Nigeria,NGA,China,CHN,0,0,11,0,11
2004,Pakistan,PAK,China,CHN,51,0,15,26,92
2004,Ethiopia,ETH,Cuba,CUB,10,0,0,0,10
2004,Ethiopia,ETH,Eritrea,ERI,5,0,0,0,5
2004,Algeria,DZA,Croatia,HRV,0,0,0,14,14
2004,Egypt,EGY,Croatia,HRV,0,0,0,5,5
2004,India,IND,Croatia,HRV,0,0,0,10,10
2004,Iraq,IRQ,Croatia,HRV,0,0,0,5,5
2004,Liberia,LBR,Croatia,HRV,0,0,0,10,10
2004,Sri Lanka,LKA,Croatia,HRV,0,0,0,5,5
2004,Nigeria,NGA,Croatia,HRV,0,0,0,5,5
2004,Pakistan,PAK,Croatia,HRV,0,0,0,10,10
2004,Serbia and Kosovo: S/RES/1244 (1999),SRB,Croatia,HRV,12,0,0,0,12
2004,Turkey,TUR,Croatia,HRV,0,0,0,5,5
2004,Afghanistan,AFG,India,IND,93,0,44,12,149
2004,Congo,COG,India,IND,0,0,0,5,5
2004,Eritrea,ERI,India,IND,5,0,5,0,10
2004,Ethiopia,ETH,India,IND,5,0,15,12,32
2004,Iran (Islamic Rep. of),IRN,India,IND,0,0,13,5,18
2004,Iraq,IRQ,India,IND,0,0,0,5,5
2004,Israel,ISR,India,IND,0,0,0,5,5
2004,Myanmar,MMR,India,IND,277,0,201,97,575
2004,Somalia,SOM,India,IND,5,0,24,14,43
2004,Sudan,SDN,India,IND,0,0,17,13,30
2004,Afghanistan,AFG,Iran (Islamic Rep. of),IRN,5,0,21,0,26
2004,Pakistan,PAK,Iran (Islamic Rep. of),IRN,0,0,0,10,10
2004,Algeria,DZA,Jordan,JOR,0,0,0,5,5
2004,Egypt,EGY,Jordan,JOR,0,0,11,0,11
2004,Eritrea,ERI,Jordan,JOR,0,0,0,5,5
2004,Iraq,IRQ,Jordan,JOR,36,0,5,467,508
2004,Lebanon,LBN,Jordan,JOR,5,0,0,0,5
2004,Sri Lanka,LKA,Jordan,JOR,0,0,5,0,5
2004,Russian Federation,RUS,Jordan,JOR,0,0,0,5,5
2004,Saudi Arabia,SAU,Jordan,JOR,0,0,14,0,14
2004,Somalia,SOM,Jordan,JOR,15,0,0,13,28
2004,Sudan,SDN,Jordan,JOR,0,0,14,5,19
2004,Syrian Arab Rep.,SYR,Jordan,JOR,10,0,10,5,25
2004,Yemen,YEM,Jordan,JOR,0,0,0,5,5
2004,Stateless,XXA,Jordan,JOR,5,0,0,0,5
2004,Burundi,BDI,Kenya,KEN,172,0,47,0,219
2004,Dem. Rep. of the Congo,COD,Kenya,KEN,93,0,26,0,119
2004,Eritrea,ERI,Kenya,KEN,38,0,5,0,43
2004,Ethiopia,ETH,Kenya,KEN,293,0,213,0,506
2004,Cote d'Ivoire,CIV,Kenya,KEN,19,0,15,0,34
2004,Rwanda,RWA,Kenya,KEN,17,0,43,0,60
2004,Somalia,SOM,Kenya,KEN,2415,0,120,0,2535
2004,Sudan,SDN,Kenya,KEN,17,0,0,0,17
2004,Uganda,UGA,Kenya,KEN,35,0,28,0,63
2004,China,CHN,Kyrgyzstan,KGZ,0,0,0,11,11
2004,Afghanistan,AFG,Kuwait,KWT,0,0,0,5,5
2004,Chad,TCD,Libya,LBY,0,0,5,5,10
2004,Dem. Rep. of the Congo,COD,Libya,LBY,0,0,5,16,21
2004,Eritrea,ERI,Libya,LBY,10,0,0,48,58
2004,Ethiopia,ETH,Libya,LBY,0,0,5,35,40
2004,Cote d'Ivoire,CIV,Libya,LBY,0,19,0,10,29
2004,Liberia,LBR,Libya,LBY,0,0,0,5,5
2004,Sierra Leone,SLE,Libya,LBY,0,0,12,0,12
2004,Somalia,SOM,Libya,LBY,34,0,34,96,164
2004,Sudan,SDN,Libya,LBY,0,0,10,21,31
2004,United Rep. of Tanzania,TZA,Libya,LBY,0,0,5,0,5
2004,Cote d'Ivoire,CIV,Mauritania,MRT,15,0,5,0,20
2004,Liberia,LBR,Mauritania,MRT,37,0,0,0,37
2004,Dem. Rep. of the Congo,COD,Niger,NER,10,0,5,14,29
2004,Cote d'Ivoire,CIV,Niger,NER,5,0,0,5,10
2004,Liberia,LBR,Niger,NER,5,0,0,0,5
2004,Cuba,CUB,Paraguay,PRY,10,0,0,0,10
2004,Burundi,BDI,Rwanda,RWA,10,0,0,0,10
2004,Dem. Rep. of the Congo,COD,Rwanda,RWA,25,0,0,0,25
2004,Afghanistan,AFG,Serbia and Kosovo: S/RES/1244 (1999),SRB,5,0,5,0,10
2004,Palestinian,PSE,Serbia and Kosovo: S/RES/1244 (1999),SRB,0,0,0,5,5
2004,India,IND,Serbia and Kosovo: S/RES/1244 (1999),SRB,0,0,0,5,5
2004,Iran (Islamic Rep. of),IRN,Serbia and Kosovo: S/RES/1244 (1999),SRB,0,0,0,5,5
2004,Iraq,IRQ,Serbia and Kosovo: S/RES/1244 (1999),SRB,5,0,0,0,5
2004,Mongolia,MNG,Serbia and Kosovo: S/RES/1244 (1999),SRB,0,0,5,0,5
2004,Niger,NER,Serbia and Kosovo: S/RES/1244 (1999),SRB,0,0,5,0,5
2004,Sierra Leone,SLE,Serbia and Kosovo: S/RES/1244 (1999),SRB,0,0,5,0,5
2004,China,CHN,Singapore,SGP,5,0,0,0,5
2004,Sri Lanka,LKA,Singapore,SGP,0,0,5,0,5
2004,Afghanistan,AFG,Turkmenistan,TKM,0,0,10,0,10
2004,Azerbaijan,AZE,Turkmenistan,TKM,19,0,0,0,19
2004,Central African Rep.,CAF,Togo,TGO,5,0,0,0,5
2004,Dem. Rep. of the Congo,COD,Togo,TGO,33,0,24,5,62
2004,Cote d'Ivoire,CIV,Togo,TGO,26,0,0,0,26
2004,Liberia,LBR,Togo,TGO,5,0,0,0,5
2004,Rwanda,RWA,Togo,TGO,21,0,17,19,57
2004,Afghanistan,AFG,Turkey,TUR,27,0,28,0,55
2004,Algeria,DZA,Turkey,TUR,0,0,5,0,5
2004,Azerbaijan,AZE,Turkey,TUR,5,0,0,0,5
2004,China,CHN,Turkey,TUR,5,0,0,0,5
2004,Eritrea,ERI,Turkey,TUR,0,0,14,0,14
2004,Ethiopia,ETH,Turkey,TUR,5,0,28,0,33
2004,Palestinian,PSE,Turkey,TUR,0,0,10,0,10
2004,Iran (Islamic Rep. of),IRN,Turkey,TUR,1530,0,1340,0,2870
2004,Iraq,IRQ,Turkey,TUR,11,0,92,0,103
2004,Sri Lanka,LKA,Turkey,TUR,0,0,10,0,10
2004,Mauritania,MRT,Turkey,TUR,0,0,5,0,5
2004,Morocco,MAR,Turkey,TUR,5,0,5,0,10
2004,Pakistan,PAK,Turkey,TUR,0,0,5,0,5
2004,Sierra Leone,SLE,Turkey,TUR,0,0,5,0,5
2004,Somalia,SOM,Turkey,TUR,78,0,150,0,228
2004,Sudan,SDN,Turkey,TUR,5,0,38,0,43
2004,Syrian Arab Rep.,SYR,Turkey,TUR,5,0,0,0,5
2004,Uzbekistan,UZB,Turkey,TUR,12,0,0,0,12
2004,Iran (Islamic Rep. of),IRN,United Arab Emirates,ARE,0,0,0,10,10
2004,Somalia,SOM,United Arab Emirates,ARE,0,0,0,10,10
2004,Sudan,SDN,United Arab Emirates,ARE,0,0,0,5,5
2004,Syrian Arab Rep.,SYR,United Arab Emirates,ARE,21,0,5,10,36
2004,Afghanistan,AFG,Ukraine,UKR,10,0,29,0,39
2004,Armenia,ARM,Ukraine,UKR,0,0,5,0,5
2004,Bangladesh,BGD,Ukraine,UKR,0,0,10,0,10
2004,Dem. Rep. of the Congo,COD,Ukraine,UKR,0,0,5,0,5
2004,Ethiopia,ETH,Ukraine,UKR,5,0,5,0,10
2004,Guinea-Bissau,GNB,Ukraine,UKR,0,0,5,0,5
2004,Iran (Islamic Rep. of),IRN,Ukraine,UKR,5,0,14,0,19
2004,Iraq,IRQ,Ukraine,UKR,5,0,0,0,5
2004,Sri Lanka,LKA,Ukraine,UKR,0,0,5,0,5
2004,Nigeria,NGA,Ukraine,UKR,5,0,5,0,10
2004,Pakistan,PAK,Ukraine,UKR,0,0,16,0,16
2004,Russian Federation,RUS,Ukraine,UKR,5,0,12,0,17
2004,Somalia,SOM,Ukraine,UKR,5,0,0,0,5
2004,Syrian Arab Rep.,SYR,Ukraine,UKR,0,0,5,0,5
2004,Colombia,COL,Uruguay,URY,5,0,0,0,5
2004,Algeria,DZA,Yemen,YEM,0,0,5,0,5
2004,Egypt,EGY,Yemen,YEM,0,0,0,22,22
2004,Djibouti,DJI,Yemen,YEM,0,0,0,10,10
2004,Eritrea,ERI,Yemen,YEM,15,0,10,45,70
2004,Ethiopia,ETH,Yemen,YEM,199,0,205,590,994
2004,Palestinian,PSE,Yemen,YEM,30,0,0,12,42
2004,Iraq,IRQ,Yemen,YEM,0,0,0,5,5
2004,Sudan,SDN,Yemen,YEM,0,0,47,130,177
2004,Syrian Arab Rep.,SYR,Yemen,YEM,11,0,0,20,31
2005,China,CHN,Afghanistan,AFG,0,0,0,5,5
2005,Iran (Islamic Rep. of),IRN,Afghanistan,AFG,5,0,0,24,29
2005,Iraq,IRQ,Afghanistan,AFG,0,0,0,5,5
2005,Pakistan,PAK,Afghanistan,AFG,0,0,5,0,5
2005,Afghanistan,AFG,Azerbaijan,AZE,0,0,0,752,752
2005,Algeria,DZA,Azerbaijan,AZE,0,0,0,5,5
2005,Palestinian,PSE,Azerbaijan,AZE,0,0,0,11,11
2005,Georgia,GEO,Azerbaijan,AZE,0,0,0,5,5
2005,Iran (Islamic Rep. of),IRN,Azerbaijan,AZE,0,0,0,230,230
2005,Iraq,IRQ,Azerbaijan,AZE,0,0,0,30,30
2005,Pakistan,PAK,Azerbaijan,AZE,0,0,0,53,53
2005,Russian Federation,RUS,Azerbaijan,AZE,123,513,0,0,636
2005,Tajikistan,TJK,Azerbaijan,AZE,0,0,0,5,5
2005,Turkmenistan,TKM,Azerbaijan,AZE,0,0,0,5,5
2005,Turkey,TUR,Azerbaijan,AZE,0,0,0,5,5
2005,Dem. Rep. of the Congo,COD,Burundi,BDI,21,0,0,0,21
2005,Rwanda,RWA,Burundi,BDI,5,0,0,0,5
2005,China,CHN,Cambodia,KHM,5,0,0,0,5
2005,Viet Nam,VNM,Cambodia,KHM,314,0,187,116,617
2005,Ecuador,ECU,Colombia,COL,10,0,0,0,10
2005,Venezuela (Bolivarian Republic of),VEN,Colombia,COL,5,0,0,0,5
2005,Colombia,COL,Cuba,CUB,10,0,0,0,10
2005,Ethiopia,ETH,Cuba,CUB,5,0,0,0,5
2005,Algeria,DZA,"China, Hong Kong SAR",HKG,0,0,0,5,5
2005,Angola,AGO,"China, Hong Kong SAR",HKG,0,0,0,5,5
2005,Bangladesh,BGD,"China, Hong Kong SAR",HKG,0,0,0,5,5
2005,Cameroon,CMR,"China, Hong Kong SAR",HKG,0,0,0,27,27
2005,Congo,COG,"China, Hong Kong SAR",HKG,0,0,0,5,5
2005,Dem. Rep. of the Congo,COD,"China, Hong Kong SAR",HKG,0,0,5,5,10
2005,Ethiopia,ETH,"China, Hong Kong SAR",HKG,5,0,0,0,5
2005,Ghana,GHA,"China, Hong Kong SAR",HKG,0,0,10,13,23
2005,India,IND,"China, Hong Kong SAR",HKG,0,0,5,15,20
2005,Liberia,LBR,"China, Hong Kong SAR",HKG,0,0,0,12,12
2005,Sri Lanka,LKA,"China, Hong Kong SAR",HKG,5,0,31,83,119
2005,Nepal,NPL,"China, Hong Kong SAR",HKG,10,0,15,66,91
2005,Nigeria,NGA,"China, Hong Kong SAR",HKG,0,0,0,16,16
2005,Pakistan,PAK,"China, Hong Kong SAR",HKG,13,0,10,14,37
2005,Somalia,SOM,"China, Hong Kong SAR",HKG,26,0,0,0,26
2005,Togo,TGO,"China, Hong Kong SAR",HKG,0,5,0,0,5
2005,Cote d'Ivoire,CIV,Croatia,HRV,0,0,0,5,5
2005,Serbia and Kosovo: S/RES/1244 (1999),SRB,Croatia,HRV,0,0,5,0,5
2005,Afghanistan,AFG,India,IND,232,0,22,10,264
2005,Congo,COG,India,IND,0,0,14,0,14
2005,Eritrea,ERI,India,IND,0,0,0,5,5
2005,Ethiopia,ETH,India,IND,0,0,14,0,14
2005,Iran (Islamic Rep. of),IRN,India,IND,5,0,11,0,16
2005,Myanmar,MMR,India,IND,337,0,43,10,390
2005,Rwanda,RWA,India,IND,0,0,5,0,5
2005,Somalia,SOM,India,IND,79,0,33,27,139
2005,Sudan,SDN,India,IND,0,0,15,12,27
2005,Afghanistan,AFG,Iran (Islamic Rep. of),IRN,0,0,34,43,77
2005,Iraq,IRQ,Iran (Islamic Rep. of),IRN,5,0,0,13,18
2005,Pakistan,PAK,Iran (Islamic Rep. of),IRN,0,0,0,10,10
2005,Uzbekistan,UZB,Iran (Islamic Rep. of),IRN,47,0,5,44,96
2005,Egypt,EGY,Jordan,JOR,0,0,16,0,16
2005,Dem. Rep. of the Congo,COD,Jordan,JOR,5,0,0,0,5
2005,Iraq,IRQ,Jordan,JOR,13,0,0,138,151
2005,Sri Lanka,LKA,Jordan,JOR,0,0,0,5,5
2005,Russian Federation,RUS,Jordan,JOR,10,0,0,0,10
2005,Somalia,SOM,Jordan,JOR,5,0,0,0,5
2005,Sudan,SDN,Jordan,JOR,0,0,13,5,18
2005,Syrian Arab Rep.,SYR,Jordan,JOR,10,0,0,11,21
2005,Stateless,XXA,Jordan,JOR,5,0,10,0,15
2005,China,CHN,Kazakhstan,KAZ,14,0,10,0,24
2005,Uzbekistan,UZB,Kazakhstan,KAZ,41,0,5,11,57
2005,Burundi,BDI,Kenya,KEN,573,0,11,5,589
2005,Dem. Rep. of the Congo,COD,Kenya,KEN,196,0,36,57,289
2005,Eritrea,ERI,Kenya,KEN,309,0,28,0,337
2005,Ethiopia,ETH,Kenya,KEN,1698,0,970,10,2678
2005,Liberia,LBR,Kenya,KEN,5,0,0,0,5
2005,Rwanda,RWA,Kenya,KEN,1254,0,120,0,1374
2005,Somalia,SOM,Kenya,KEN,13786,0,50,601,14437
2005,Sudan,SDN,Kenya,KEN,9892,0,5,0,9897
2005,Uganda,UGA,Kenya,KEN,2083,0,22,0,2105
2005,Afghanistan,AFG,Kyrgyzstan,KGZ,5,0,0,0,5
2005,China,CHN,Kyrgyzstan,KGZ,5,0,0,5,10
2005,Russian Federation,RUS,Kyrgyzstan,KGZ,5,0,0,0,5
2005,Uzbekistan,UZB,Kyrgyzstan,KGZ,472,0,0,50,522
2005,Congo,COG,Mauritania,MRT,13,0,0,10,23
2005,Dem. Rep. of the Congo,COD,Mauritania,MRT,23,0,5,0,28
2005,Guinea,GIN,Mauritania,MRT,0,0,0,5,5
2005,Cote d'Ivoire,CIV,Mauritania,MRT,75,0,15,23,113
2005,Liberia,LBR,Mauritania,MRT,20,0,10,15,45
2005,Sierra Leone,SLE,Mauritania,MRT,0,0,20,33,53
2005,Sudan,SDN,Mauritania,MRT,0,0,0,5,5
2005,Togo,TGO,Mauritania,MRT,22,0,5,5,32
2005,Uganda,UGA,Mauritania,MRT,0,0,0,5,5
2005,Dem. Rep. of the Congo,COD,Morocco,MAR,16,0,5,10,31
2005,Gambia,GMB,Morocco,MAR,0,0,0,5,5
2005,Ghana,GHA,Morocco,MAR,0,0,14,16,30
2005,Guinea,GIN,Morocco,MAR,0,0,0,5,5
2005,Cote d'Ivoire,CIV,Morocco,MAR,10,0,0,0,10
2005,Liberia,LBR,Morocco,MAR,5,0,15,0,20
2005,Nigeria,NGA,Morocco,MAR,0,0,23,29,52
2005,Sierra Leone,SLE,Morocco,MAR,0,0,14,5,19
2005,Iraq,IRQ,Nepal,NPL,0,0,5,0,5
2005,Myanmar,MMR,Nepal,NPL,5,0,0,0,5
2005,Pakistan,PAK,Nepal,NPL,12,0,110,0,122
2005,Angola,AGO,Rwanda,RWA,0,0,0,5,5
2005,Burundi,BDI,Rwanda,RWA,257,0,75,534,866
2005,Dem. Rep. of the Congo,COD,Rwanda,RWA,754,0,287,818,1859
2005,Ethiopia,ETH,Rwanda,RWA,0,0,0,10,10
2005,Somalia,SOM,Rwanda,RWA,0,0,0,27,27
2005,Sudan,SDN,Rwanda,RWA,10,0,0,0,10
2005,Uganda,UGA,Rwanda,RWA,0,0,0,25,25
2005,Bangladesh,BGD,Serbia and Kosovo: S/RES/1244 (1999),SRB,0,0,14,10,24
2005,Georgia,GEO,Serbia and Kosovo: S/RES/1244 (1999),SRB,0,0,5,5,10
2005,India,IND,Serbia and Kosovo: S/RES/1244 (1999),SRB,0,0,10,0,10
2005,Iraq,IRQ,Serbia and Kosovo: S/RES/1244 (1999),SRB,0,0,0,5,5
2005,Sri Lanka,LKA,Serbia and Kosovo: S/RES/1244 (1999),SRB,0,0,0,5,5
2005,Morocco,MAR,Serbia and Kosovo: S/RES/1244 (1999),SRB,0,0,0,5,5
2005,Pakistan,PAK,Serbia and Kosovo: S/RES/1244 (1999),SRB,0,0,5,0,5
2005,Russian Federation,RUS,Serbia and Kosovo: S/RES/1244 (1999),SRB,0,0,5,0,5
2005,Turkey,TUR,Serbia and Kosovo: S/RES/1244 (1999),SRB,10,0,0,5,15
2005,China,CHN,Singapore,SGP,5,0,5,0,10
2005,Egypt,EGY,Thailand,THA,0,0,5,0,5
2005,Bangladesh,BGD,Thailand,THA,0,0,0,5,5
2005,Cambodia,KHM,Thailand,THA,63,0,199,12,274
2005,China,CHN,Thailand,THA,28,0,28,11,67
2005,Cameroon,CMR,Thailand,THA,0,0,5,0,5
2005,Congo,COG,Thailand,THA,0,0,0,5,5
2005,Dem. Rep. of the Congo,COD,Thailand,THA,13,0,13,5,31
2005,Ethiopia,ETH,Thailand,THA,0,0,5,0,5
2005,Palestinian,PSE,Thailand,THA,5,0,0,5,10
2005,Guinea,GIN,Thailand,THA,0,0,0,5,5
2005,"China, Hong Kong SAR",HKG,Thailand,THA,0,0,5,0,5
2005,Cote d'Ivoire,CIV,Thailand,THA,5,0,5,0,10
2005,India,IND,Thailand,THA,5,0,5,10,20
2005,Indonesia,IDN,Thailand,THA,13,0,0,0,13
2005,Iran (Islamic Rep. of),IRN,Thailand,THA,10,0,18,5,33
2005,Iraq,IRQ,Thailand,THA,0,0,0,115,115
2005,Kenya,KEN,Thailand,THA,0,0,5,0,5
2005,Dem. People's Rep. of Korea,PRK,Thailand,THA,0,0,0,15,15
2005,Lao People's Dem. Rep.,LAO,Thailand,THA,136,0,23,60,219
2005,Liberia,LBR,Thailand,THA,5,0,0,27,32
2005,Sri Lanka,LKA,Thailand,THA,14,0,16,17,47
2005,Myanmar,MMR,Thailand,THA,309,0,38,109,456
2005,Nepal,NPL,Thailand,THA,37,0,22,18,77
2005,Nigeria,NGA,Thailand,THA,0,0,14,15,29
2005,Pakistan,PAK,Thailand,THA,0,0,5,5,10
2005,Sierra Leone,SLE,Thailand,THA,0,0,5,11,16
2005,Somalia,SOM,Thailand,THA,13,0,0,5,18
2005,Viet Nam,VNM,Thailand,THA,13,0,44,25,82
2005,Sudan,SDN,Thailand,THA,0,0,5,5,10
2005,Uganda,UGA,Thailand,THA,0,0,0,5,5
2005,Zimbabwe,ZWE,Thailand,THA,0,0,0,5,5
2005,Algeria,DZA,Tunisia,TUN,0,0,5,46,51
2005,Burkina Faso,BFA,Tunisia,TUN,0,0,0,5,5
2005,Cameroon,CMR,Tunisia,TUN,0,0,0,5,5
2005,Dem. Rep. of the Congo,COD,Tunisia,TUN,0,0,0,5,5
2005,Cote d'Ivoire,CIV,Tunisia,TUN,0,0,0,11,11
2005,Iraq,IRQ,Tunisia,TUN,0,0,0,5,5
2005,Liberia,LBR,Tunisia,TUN,0,0,0,19,19
2005,Sierra Leone,SLE,Tunisia,TUN,0,0,0,5,5
2005,Afghanistan,AFG,Turkey,TUR,58,0,29,351,438
2005,Algeria,DZA,Turkey,TUR,0,0,0,10,10
2005,Egypt,EGY,Turkey,TUR,5,0,0,0,5
2005,Burundi,BDI,Turkey,TUR,5,0,0,0,5
2005,China,CHN,Turkey,TUR,15,0,0,22,37
2005,Dem. Rep. of the Congo,COD,Turkey,TUR,5,0,0,5,10
2005,Eritrea,ERI,Turkey,TUR,5,0,0,14,19
2005,Ethiopia,ETH,Turkey,TUR,0,0,5,19,24
2005,Palestinian,PSE,Turkey,TUR,0,0,0,22,22
2005,Iran (Islamic Rep. of),IRN,Turkey,TUR,1106,0,307,288,1701
2005,Iraq,IRQ,Turkey,TUR,33,0,0,276,309
2005,Kyrgyzstan,KGZ,Turkey,TUR,5,0,0,5,10
2005,Sri Lanka,LKA,Turkey,TUR,0,0,0,5,5
2005,Morocco,MAR,Turkey,TUR,5,0,0,0,5
2005,Myanmar,MMR,Turkey,TUR,0,0,0,5,5
2005,Nigeria,NGA,Turkey,TUR,0,0,0,10,10
2005,Somalia,SOM,Turkey,TUR,82,0,16,152,250
2005,Sudan,SDN,Turkey,TUR,5,0,5,35,45
2005,Syrian Arab Rep.,SYR,Turkey,TUR,12,0,5,0,17
2005,Turkmenistan,TKM,Turkey,TUR,5,0,0,0,5
2005,Tunisia,TUN,Turkey,TUR,0,0,0,5,5
2005,Uzbekistan,UZB,Turkey,TUR,29,0,5,0,34
2005,Western Sahara,ESH,Turkey,TUR,0,0,0,5,5
2005,Yemen,YEM,Turkey,TUR,0,0,0,5,5
2005,China,CHN,United Arab Emirates,ARE,0,0,0,5,5
2005,Iran (Islamic Rep. of),IRN,United Arab Emirates,ARE,0,0,0,5,5
2005,Iraq,IRQ,United Arab Emirates,ARE,0,0,0,10,10
2005,Somalia,SOM,United Arab Emirates,ARE,0,5,0,0,5
2005,Eritrea,ERI,Yemen,YEM,22,0,0,12,34
2005,Ethiopia,ETH,Yemen,YEM,251,70,189,938,1448
2005,Iraq,IRQ,Yemen,YEM,0,827,0,0,827
2005,Sudan,SDN,Yemen,YEM,0,10,12,65,87
2005,Syrian Arab Rep.,SYR,Yemen,YEM,0,0,0,19,19
2006,Iran (Islamic Rep. of),IRN,Afghanistan,AFG,5,0,0,5,10
2006,Pakistan,PAK,Afghanistan,AFG,0,0,5,5,10
2006,Dem. Rep. of the Congo,COD,Algeria,DZA,58,0,29,0,87
2006,Cote d'Ivoire,CIV,Algeria,DZA,10,0,0,0,10
2006,Libya,LBY,Algeria,DZA,0,0,0,5,5
2006,Eritrea,ERI,Egypt,EGY,89,0,96,0,185
2006,Ethiopia,ETH,Egypt,EGY,39,0,136,0,175
2006,Palestinian,PSE,Egypt,EGY,5,0,0,0,5
2006,Iraq,IRQ,Egypt,EGY,10,0,0,56,66
2006,Liberia,LBR,Egypt,EGY,0,0,5,5,10
2006,Rwanda,RWA,Egypt,EGY,5,0,0,0,5
2006,Somalia,SOM,Egypt,EGY,1082,0,11,0,1093
2006,Sudan,SDN,Egypt,EGY,40,0,49,114,203
2006,Afghanistan,AFG,Azerbaijan,AZE,10,0,0,0,10
2006,Russian Federation,RUS,Azerbaijan,AZE,366,0,0,0,366
2006,Dem. Rep. of the Congo,COD,Burundi,BDI,68,0,0,0,68
2006,Ethiopia,ETH,Burundi,BDI,0,0,0,5,5
2006,Rwanda,RWA,Burundi,BDI,0,0,0,51,51
2006,Uganda,UGA,Burundi,BDI,0,0,0,10,10
2006,Liberia,LBR,Bangladesh,BGD,0,0,0,5,5
2006,Myanmar,MMR,Bangladesh,BGD,0,0,0,15,15
2006,Dem. Rep. of the Congo,COD,Cambodia,KHM,5,0,0,0,5
2006,Sri Lanka,LKA,Cambodia,KHM,0,0,5,0,5
2006,Myanmar,MMR,Cambodia,KHM,5,0,0,0,5
2006,Nigeria,NGA,Cambodia,KHM,0,0,0,5,5
2006,Somalia,SOM,Cambodia,KHM,10,0,0,0,10
2006,Viet Nam,VNM,Cambodia,KHM,43,0,187,18,248
2006,Iran (Islamic Rep. of),IRN,Cyprus,CYP,0,0,5,0,5
2006,Iraq,IRQ,Cyprus,CYP,5,0,0,5,10
2006,Eritrea,ERI,Djibouti,DJI,10,0,0,0,10
2006,Ethiopia,ETH,Djibouti,DJI,5,0,0,0,5
2006,Somalia,SOM,Djibouti,DJI,10,0,0,0,10
2006,Bangladesh,BGD,"China, Hong Kong SAR",HKG,0,0,22,141,163
2006,Cameroon,CMR,"China, Hong Kong SAR",HKG,0,0,0,5,5
2006,Congo,COG,"China, Hong Kong SAR",HKG,0,0,12,0,12
2006,Ghana,GHA,"China, Hong Kong SAR",HKG,0,0,51,28,79
2006,Guinea,GIN,"China, Hong Kong SAR",HKG,0,0,5,0,5
2006,India,IND,"China, Hong Kong SAR",HKG,0,0,96,200,296
2006,Indonesia,IDN,"China, Hong Kong SAR",HKG,0,0,5,5,10
2006,Liberia,LBR,"China, Hong Kong SAR",HKG,0,0,10,0,10
2006,Sri Lanka,LKA,"China, Hong Kong SAR",HKG,17,0,133,114,264
2006,Nepal,NPL,"China, Hong Kong SAR",HKG,5,0,27,12,44
2006,Nigeria,NGA,"China, Hong Kong SAR",HKG,0,0,29,15,44
2006,Pakistan,PAK,"China, Hong Kong SAR",HKG,5,0,94,116,215
2006,Philippines,PHL,"China, Hong Kong SAR",HKG,0,0,0,13,13
2006,Somalia,SOM,"China, Hong Kong SAR",HKG,15,0,5,0,20
2006,Togo,TGO,"China, Hong Kong SAR",HKG,0,0,22,5,27
2006,Uganda,UGA,"China, Hong Kong SAR",HKG,5,0,0,0,5
2006,Afghanistan,AFG,India,IND,75,0,91,43,209
2006,Dem. Rep. of the Congo,COD,India,IND,0,0,11,0,11
2006,Eritrea,ERI,India,IND,0,0,0,12,12
2006,Palestinian,PSE,India,IND,56,0,0,29,85
2006,Iran (Islamic Rep. of),IRN,India,IND,5,0,13,11,29
2006,Iraq,IRQ,India,IND,0,0,0,13,13
2006,Liberia,LBR,India,IND,0,0,0,5,5
2006,Myanmar,MMR,India,IND,311,0,68,83,462
2006,Somalia,SOM,India,IND,43,0,16,5,64
2006,Sudan,SDN,India,IND,5,0,5,5,15
2006,Afghanistan,AFG,Iran (Islamic Rep. of),IRN,11,10,36,81,138
2006,Iraq,IRQ,Iran (Islamic Rep. of),IRN,32,0,10,20,62
2006,Pakistan,PAK,Iran (Islamic Rep. of),IRN,0,0,0,11,11
2006,Tajikistan,TJK,Iran (Islamic Rep. of),IRN,0,0,0,16,16
2006,Uzbekistan,UZB,Iran (Islamic Rep. of),IRN,38,0,5,11,54
2006,Iran (Islamic Rep. of),IRN,Iraq,IRQ,0,0,0,45,45
2006,Syrian Arab Rep.,SYR,Iraq,IRQ,0,0,0,83,83
2006,Turkey,TUR,Iraq,IRQ,0,0,0,120,120
2006,Egypt,EGY,Jordan,JOR,5,0,13,5,23
2006,Ethiopia,ETH,Jordan,JOR,0,0,0,5,5
2006,Iran (Islamic Rep. of),IRN,Jordan,JOR,0,0,0,5,5
2006,Iraq,IRQ,Jordan,JOR,121,0,314,1514,1949
2006,Russian Federation,RUS,Jordan,JOR,5,0,0,5,10
2006,Saudi Arabia,SAU,Jordan,JOR,0,0,5,0,5
2006,Somalia,SOM,Jordan,JOR,14,0,0,0,14
2006,Sudan,SDN,Jordan,JOR,5,0,57,19,81
2006,Syrian Arab Rep.,SYR,Jordan,JOR,15,0,10,19,44
2006,Tunisia,TUN,Jordan,JOR,0,0,0,5,5
2006,Stateless,XXA,Jordan,JOR,27,0,0,0,27
2006,Burundi,BDI,Kenya,KEN,22,0,17,10,49
2006,Dem. Rep. of the Congo,COD,Kenya,KEN,129,0,45,22,196
2006,Eritrea,ERI,Kenya,KEN,132,0,38,20,190
2006,Ethiopia,ETH,Kenya,KEN,589,0,1376,871,2836
2006,Cote d'Ivoire,CIV,Kenya,KEN,5,0,0,0,5
2006,Rwanda,RWA,Kenya,KEN,60,0,113,23,196
2006,Somalia,SOM,Kenya,KEN,17718,0,32,9821,27571
2006,Sudan,SDN,Kenya,KEN,4092,0,5,55,4152
2006,United Rep. of Tanzania,TZA,Kenya,KEN,0,0,5,0,5
2006,Uganda,UGA,Kenya,KEN,29,0,89,17,135
2006,Afghanistan,AFG,Kuwait,KWT,0,0,5,0,5
2006,Egypt,EGY,Kuwait,KWT,0,0,0,5,5
2006,China,CHN,Kuwait,KWT,0,0,0,5,5
2006,Iraq,IRQ,Kuwait,KWT,13,0,0,0,13
2006,Libya,LBY,Kuwait,KWT,0,0,0,5,5
2006,Sierra Leone,SLE,Kuwait,KWT,0,0,0,5,5
2006,Somalia,SOM,Kuwait,KWT,0,0,0,33,33
2006,Sudan,SDN,Kuwait,KWT,0,0,0,11,11
2006,Syrian Arab Rep.,SYR,Kuwait,KWT,0,0,0,5,5
2006,Egypt,EGY,Lebanon,LBN,0,0,12,0,12
2006,Ethiopia,ETH,Lebanon,LBN,0,0,5,0,5
2006,Iran (Islamic Rep. of),IRN,Lebanon,LBN,0,0,5,0,5
2006,Iraq,IRQ,Lebanon,LBN,93,48,332,22,495
2006,Somalia,SOM,Lebanon,LBN,5,10,15,0,30
2006,Sudan,SDN,Lebanon,LBN,0,5,88,16,109
2006,Syrian Arab Rep.,SYR,Lebanon,LBN,11,0,5,0,16
2006,Tunisia,TUN,Lebanon,LBN,5,0,0,0,5
2006,Serbia and Kosovo: S/RES/1244 (1999),SRB,Montenegro,MNE,0,0,0,5,5
2006,Liberia,LBR,Nepal,NPL,0,0,0,14,14
2006,Myanmar,MMR,Nepal,NPL,5,0,0,0,5
2006,Nigeria,NGA,Nepal,NPL,0,0,0,5,5
2006,Pakistan,PAK,Nepal,NPL,55,10,44,0,109
2006,Somalia,SOM,Nepal,NPL,49,0,0,0,49
2006,Uganda,UGA,Rwanda,RWA,14,0,0,0,14
2006,China,CHN,Saudi Arabia,SAU,5,0,0,0,5
2006,Eritrea,ERI,Saudi Arabia,SAU,0,0,10,0,10
2006,Somalia,SOM,Saudi Arabia,SAU,0,0,5,0,5
2006,Sudan,SDN,Saudi Arabia,SAU,10,0,0,0,10
2006,Tunisia,TUN,Saudi Arabia,SAU,5,0,0,0,5
2006,Yemen,YEM,Saudi Arabia,SAU,0,0,5,0,5
2006,Egypt,EGY,Serbia and Kosovo: S/RES/1244 (1999),SRB,0,0,5,0,5
2006,Ethiopia,ETH,Serbia and Kosovo: S/RES/1244 (1999),SRB,0,0,0,5,5
2006,India,IND,Serbia and Kosovo: S/RES/1244 (1999),SRB,0,0,5,0,5
2006,Iraq,IRQ,Serbia and Kosovo: S/RES/1244 (1999),SRB,0,0,0,20,20
2006,Rep. of Moldova,MDA,Serbia and Kosovo: S/RES/1244 (1999),SRB,0,0,5,0,5
2006,Mongolia,MNG,Serbia and Kosovo: S/RES/1244 (1999),SRB,0,0,5,0,5
2006,China,CHN,Singapore,SGP,0,0,0,5,5
2006,Dem. Rep. of the Congo,COD,Sierra Leone,SLE,0,0,5,5,10
2006,Cote d'Ivoire,CIV,Sierra Leone,SLE,40,0,10,0,50
2006,Liberia,LBR,Sierra Leone,SLE,26,0,55,50,131
2006,Afghanistan,AFG,Syrian Arab Rep.,SYR,25,0,0,0,25
2006,Chad,TCD,Syrian Arab Rep.,SYR,0,0,5,0,5
2006,Ethiopia,ETH,Syrian Arab Rep.,SYR,5,0,0,0,5
2006,Iran (Islamic Rep. of),IRN,Syrian Arab Rep.,SYR,143,0,13,0,156
2006,Jordan,JOR,Syrian Arab Rep.,SYR,5,0,0,0,5
2006,Kenya,KEN,Syrian Arab Rep.,SYR,5,0,0,0,5
2006,Somalia,SOM,Syrian Arab Rep.,SYR,744,0,20,0,764
2006,Sudan,SDN,Syrian Arab Rep.,SYR,42,0,16,0,58
2006,Stateless,XXA,Syrian Arab Rep.,SYR,10,0,0,0,10
2006,Bangladesh,BGD,Thailand,THA,5,0,0,0,5
2006,Cambodia,KHM,Thailand,THA,37,0,84,5,126
2006,China,CHN,Thailand,THA,53,0,10,11,74
2006,Dem. Rep. of the Congo,COD,Thailand,THA,12,0,21,5,38
2006,Ghana,GHA,Thailand,THA,0,0,0,5,5
2006,Cote d'Ivoire,CIV,Thailand,THA,5,0,5,0,10
2006,India,IND,Thailand,THA,0,0,5,5,10
2006,Iran (Islamic Rep. of),IRN,Thailand,THA,0,0,10,0,10
2006,Iraq,IRQ,Thailand,THA,5,0,0,0,5
2006,Lao People's Dem. Rep.,LAO,Thailand,THA,213,0,0,5,218
2006,Liberia,LBR,Thailand,THA,0,0,0,5,5
2006,Sri Lanka,LKA,Thailand,THA,40,0,24,11,75
2006,Myanmar,MMR,Thailand,THA,14,0,0,0,14
2006,Nepal,NPL,Thailand,THA,34,0,29,15,78
2006,Nigeria,NGA,Thailand,THA,0,0,20,5,25
2006,Pakistan,PAK,Thailand,THA,0,0,5,0,5
2006,Viet Nam,VNM,Thailand,THA,70,0,23,10,103
2006,Sudan,SDN,Thailand,THA,0,0,5,0,5
2006,Uganda,UGA,Thailand,THA,0,0,5,0,5
2006,Afghanistan,AFG,Turkmenistan,TKM,0,0,11,0,11
2006,Azerbaijan,AZE,Turkmenistan,TKM,5,0,0,0,5
2006,Afghanistan,AFG,Turkey,TUR,23,0,56,130,209
2006,Algeria,DZA,Turkey,TUR,0,0,0,5,5
2006,Azerbaijan,AZE,Turkey,TUR,5,0,0,0,5
2006,China,CHN,Turkey,TUR,0,0,0,21,21
2006,Dem. Rep. of the Congo,COD,Turkey,TUR,0,0,0,5,5
2006,Eritrea,ERI,Turkey,TUR,5,0,5,0,10
2006,Ethiopia,ETH,Turkey,TUR,0,0,5,21,26
2006,Palestinian,PSE,Turkey,TUR,11,0,0,12,23
2006,Cote d'Ivoire,CIV,Turkey,TUR,0,0,0,5,5
2006,Iran (Islamic Rep. of),IRN,Turkey,TUR,1373,0,293,213,1879
2006,Iraq,IRQ,Turkey,TUR,36,0,0,318,354
2006,Kazakhstan,KAZ,Turkey,TUR,0,0,5,0,5
2006,Liberia,LBR,Turkey,TUR,0,0,0,5,5
2006,Libya,LBY,Turkey,TUR,0,0,0,5,5
2006,Lebanon,LBN,Turkey,TUR,0,0,0,5,5
2006,Sri Lanka,LKA,Turkey,TUR,0,0,0,10,10
2006,Mauritania,MRT,Turkey,TUR,0,0,5,23,28
2006,Nigeria,NGA,Turkey,TUR,0,0,5,0,5
2006,Sierra Leone,SLE,Turkey,TUR,0,0,0,5,5
2006,Somalia,SOM,Turkey,TUR,108,0,110,303,521
2006,Sudan,SDN,Turkey,TUR,10,0,12,54,76
2006,Syrian Arab Rep.,SYR,Turkey,TUR,0,0,0,10,10
2006,Turkmenistan,TKM,Turkey,TUR,0,0,5,0,5
2006,Uzbekistan,UZB,Turkey,TUR,5,0,0,0,5
2006,Afghanistan,AFG,Uzbekistan,UZB,0,0,0,534,534
2006,Armenia,ARM,Uzbekistan,UZB,0,0,0,5,5
2006,Palestinian,PSE,Uzbekistan,UZB,0,0,0,5,5
2006,Iraq,IRQ,Uzbekistan,UZB,0,0,0,5,5
2006,Syrian Arab Rep.,SYR,Uzbekistan,UZB,0,0,0,10,10
2006,Tajikistan,TJK,Uzbekistan,UZB,0,0,0,5,5
2006,Turkmenistan,TKM,Uzbekistan,UZB,0,0,0,5,5
2006,Stateless,XXA,Uzbekistan,UZB,0,0,0,12,12
2007,Iran (Islamic Rep. of),IRN,Afghanistan,AFG,5,0,0,5,10
2007,Iraq,IRQ,Afghanistan,AFG,5,0,0,0,5
2007,Russian Federation,RUS,Afghanistan,AFG,0,0,0,5,5
2007,Chad,TCD,Algeria,DZA,0,0,10,0,10
2007,Cameroon,CMR,Algeria,DZA,0,0,32,0,32
2007,Congo,COG,Algeria,DZA,0,0,10,0,10
2007,Dem. Rep. of the Congo,COD,Algeria,DZA,0,0,43,0,43
2007,Cote d'Ivoire,CIV,Algeria,DZA,0,0,13,0,13
2007,Niger,NER,Algeria,DZA,0,0,5,0,5
2007,Burundi,BDI,Egypt,EGY,5,0,0,0,5
2007,Chad,TCD,Egypt,EGY,5,0,0,0,5
2007,Dem. Rep. of the Congo,COD,Egypt,EGY,5,0,0,0,5
2007,Eritrea,ERI,Egypt,EGY,123,0,144,5,272
2007,Ethiopia,ETH,Egypt,EGY,12,0,125,5,142
2007,Palestinian,PSE,Egypt,EGY,13,0,0,5,18
2007,Cote d'Ivoire,CIV,Egypt,EGY,45,0,5,12,62
2007,Iraq,IRQ,Egypt,EGY,19,0,0,0,19
2007,Liberia,LBR,Egypt,EGY,0,0,5,0,5
2007,Somalia,SOM,Egypt,EGY,913,0,11,0,924
2007,Sudan,SDN,Egypt,EGY,92,0,20,708,820
2007,Tunisia,TUN,Egypt,EGY,5,0,0,0,5
2007,Uzbekistan,UZB,Egypt,EGY,0,0,5,0,5
2007,Afghanistan,AFG,Azerbaijan,AZE,10,0,0,0,10
2007,Iran (Islamic Rep. of),IRN,Azerbaijan,AZE,5,0,0,0,5
2007,Iraq,IRQ,Azerbaijan,AZE,22,0,0,0,22
2007,Russian Federation,RUS,Azerbaijan,AZE,254,0,0,0,254
2007,Dem. Rep. of the Congo,COD,Burundi,BDI,0,0,10,0,10
2007,Rwanda,RWA,Burundi,BDI,5,0,0,27,32
2007,Afghanistan,AFG,Belarus,BLR,0,0,0,14,14
2007,Dem. People's Rep. of Korea,PRK,Cambodia,KHM,0,0,0,5,5
2007,Myanmar,MMR,Cambodia,KHM,5,0,0,0,5
2007,Nepal,NPL,Cambodia,KHM,0,0,5,0,5
2007,Somalia,SOM,Cambodia,KHM,5,0,0,0,5
2007,Viet Nam,VNM,Cambodia,KHM,100,0,148,24,272
2007,Palestinian,PSE,Cyprus,CYP,5,0,0,0,5
2007,Iran (Islamic Rep. of),IRN,Cyprus,CYP,0,0,5,5,10
2007,Iraq,IRQ,Cyprus,CYP,0,0,0,20,20
2007,Bangladesh,BGD,"China, Hong Kong SAR",HKG,0,0,148,235,383
2007,Dem. Rep. of the Congo,COD,"China, Hong Kong SAR",HKG,0,0,5,0,5
2007,Eritrea,ERI,"China, Hong Kong SAR",HKG,5,0,0,0,5
2007,Ghana,GHA,"China, Hong Kong SAR",HKG,0,0,15,17,32
2007,India,IND,"China, Hong Kong SAR",HKG,0,0,179,250,429
2007,Indonesia,IDN,"China, Hong Kong SAR",HKG,0,0,5,16,21
2007,Sri Lanka,LKA,"China, Hong Kong SAR",HKG,5,0,32,164,201
2007,Nepal,NPL,"China, Hong Kong SAR",HKG,0,0,76,43,119
2007,Nigeria,NGA,"China, Hong Kong SAR",HKG,0,0,13,15,28
2007,Pakistan,PAK,"China, Hong Kong SAR",HKG,0,0,345,371,716
2007,Philippines,PHL,"China, Hong Kong SAR",HKG,0,0,50,18,68
2007,Somalia,SOM,"China, Hong Kong SAR",HKG,11,0,0,0,11
2007,Togo,TGO,"China, Hong Kong SAR",HKG,0,0,15,5,20
2007,Uganda,UGA,"China, Hong Kong SAR",HKG,5,0,0,0,5
2007,Afghanistan,AFG,India,IND,73,0,215,33,321
2007,Dem. Rep. of the Congo,COD,India,IND,0,0,10,0,10
2007,Eritrea,ERI,India,IND,0,0,11,0,11
2007,Ethiopia,ETH,India,IND,0,0,5,0,5
2007,Palestinian,PSE,India,IND,167,0,0,0,167
2007,Iran (Islamic Rep. of),IRN,India,IND,5,0,5,0,10
2007,Iraq,IRQ,India,IND,43,0,0,0,43
2007,Myanmar,MMR,India,IND,343,0,33,19,395
2007,Somalia,SOM,India,IND,95,0,10,5,110
2007,Sudan,SDN,India,IND,5,0,0,0,5
2007,Syrian Arab Rep.,SYR,India,IND,5,0,0,0,5
2007,Afghanistan,AFG,Iran (Islamic Rep. of),IRN,5,5,164,155,329
2007,Iraq,IRQ,Iran (Islamic Rep. of),IRN,0,5,0,148,153
2007,Kyrgyzstan,KGZ,Iran (Islamic Rep. of),IRN,0,0,0,5,5
2007,Pakistan,PAK,Iran (Islamic Rep. of),IRN,5,0,0,32,37
2007,Tajikistan,TJK,Iran (Islamic Rep. of),IRN,0,0,0,5,5
2007,Burundi,BDI,Kenya,KEN,58,0,28,40,126
2007,Dem. Rep. of the Congo,COD,Kenya,KEN,246,0,24,311,581
2007,Eritrea,ERI,Kenya,KEN,67,0,5,26,98
2007,Ethiopia,ETH,Kenya,KEN,1197,0,542,2513,4252
2007,Sri Lanka,LKA,Kenya,KEN,0,0,0,5,5
2007,Namibia,NAM,Kenya,KEN,0,0,0,5,5
2007,Pakistan,PAK,Kenya,KEN,0,0,0,5,5
2007,Rwanda,RWA,Kenya,KEN,95,0,72,92,259
2007,Somalia,SOM,Kenya,KEN,1102,0,109,24037,25248
2007,Sudan,SDN,Kenya,KEN,173,0,329,66,568
2007,United Rep. of Tanzania,TZA,Kenya,KEN,0,0,0,10,10
2007,Uganda,UGA,Kenya,KEN,19,0,96,316,431
2007,Afghanistan,AFG,Kuwait,KWT,5,0,0,27,32
2007,Dominican Rep.,DOM,Kuwait,KWT,0,0,0,5,5
2007,Iran (Islamic Rep. of),IRN,Kuwait,KWT,24,0,0,0,24
2007,Iraq,IRQ,Kuwait,KWT,94,0,0,80,174
2007,Somalia,SOM,Kuwait,KWT,0,0,0,5,5
2007,Sudan,SDN,Kuwait,KWT,0,0,0,5,5
2007,Afghanistan,AFG,Lebanon,LBN,0,5,0,0,5
2007,Egypt,EGY,Lebanon,LBN,0,0,5,0,5
2007,Ethiopia,ETH,Lebanon,LBN,0,0,5,0,5
2007,Iran (Islamic Rep. of),IRN,Lebanon,LBN,10,0,0,0,10
2007,Iraq,IRQ,Lebanon,LBN,23,2268,10,55,2356
2007,Sri Lanka,LKA,Lebanon,LBN,0,0,5,0,5
2007,Somalia,SOM,Lebanon,LBN,0,5,14,0,19
2007,Sudan,SDN,Lebanon,LBN,24,10,215,10,259
2007,Syrian Arab Rep.,SYR,Lebanon,LBN,17,5,33,5,60
2007,Turkey,TUR,Lebanon,LBN,0,5,0,0,5
2007,Stateless,XXA,Lebanon,LBN,5,0,0,0,5
2007,Afghanistan,AFG,Malaysia,MYS,26,0,0,0,26
2007,Bangladesh,BGD,Malaysia,MYS,0,0,49,28,77
2007,Bhutan,BTN,Malaysia,MYS,5,0,0,0,5
2007,Cambodia,KHM,Malaysia,MYS,5,0,123,0,128
2007,Chad,TCD,Malaysia,MYS,0,0,5,0,5
2007,China,CHN,Malaysia,MYS,17,0,5,5,27
2007,Cameroon,CMR,Malaysia,MYS,0,0,21,0,21
2007,Dem. Rep. of the Congo,COD,Malaysia,MYS,5,0,0,0,5
2007,Eritrea,ERI,Malaysia,MYS,5,0,0,0,5
2007,Palestinian,PSE,Malaysia,MYS,48,0,0,0,48
2007,Ghana,GHA,Malaysia,MYS,0,0,5,0,5
2007,Guinea,GIN,Malaysia,MYS,0,0,10,0,10
2007,Cote d'Ivoire,CIV,Malaysia,MYS,5,0,11,0,16
2007,India,IND,Malaysia,MYS,0,0,12,0,12
2007,Indonesia,IDN,Malaysia,MYS,41,0,26,376,443
2007,Iran (Islamic Rep. of),IRN,Malaysia,MYS,14,0,0,5,19
2007,Iraq,IRQ,Malaysia,MYS,151,0,0,0,151
2007,Liberia,LBR,Malaysia,MYS,5,0,110,0,115
2007,Sri Lanka,LKA,Malaysia,MYS,271,0,45,93,409
2007,Mali,MLI,Malaysia,MYS,0,0,5,0,5
2007,Myanmar,MMR,Malaysia,MYS,13470,0,205,607,14282
2007,Nepal,NPL,Malaysia,MYS,0,0,49,59,108
2007,Nigeria,NGA,Malaysia,MYS,0,0,28,0,28
2007,Pakistan,PAK,Malaysia,MYS,10,0,16,0,26
2007,Somalia,SOM,Malaysia,MYS,63,0,0,5,68
2007,Viet Nam,VNM,Malaysia,MYS,0,0,33,0,33
2007,Sudan,SDN,Malaysia,MYS,14,0,5,0,19
2007,Syrian Arab Rep.,SYR,Malaysia,MYS,5,0,0,0,5
2007,Thailand,THA,Malaysia,MYS,0,0,0,27,27
2007,Tunisia,TUN,Malaysia,MYS,0,0,0,5,5
2007,China,CHN,Mongolia,MNG,0,0,0,5,5
2007,Angola,AGO,Morocco,MAR,0,0,5,0,5
2007,Benin,BEN,Morocco,MAR,0,0,5,5,10
2007,Burkina Faso,BFA,Morocco,MAR,0,0,0,5,5
2007,Chad,TCD,Morocco,MAR,0,0,0,5,5
2007,Cameroon,CMR,Morocco,MAR,0,0,15,18,33
2007,Congo,COG,Morocco,MAR,5,0,31,5,41
2007,Dem. Rep. of the Congo,COD,Morocco,MAR,88,0,267,114,469
2007,Gabon,GAB,Morocco,MAR,0,0,0,5,5
2007,Gambia,GMB,Morocco,MAR,0,0,11,22,33
2007,Palestinian,PSE,Morocco,MAR,0,0,0,5,5
2007,Ghana,GHA,Morocco,MAR,0,0,25,70,95
2007,Guinea,GIN,Morocco,MAR,0,0,11,10,21
2007,Cote d'Ivoire,CIV,Morocco,MAR,86,0,23,71,180
2007,Iran (Islamic Rep. of),IRN,Morocco,MAR,0,0,0,5,5
2007,Iraq,IRQ,Morocco,MAR,99,0,0,11,110
2007,Liberia,LBR,Morocco,MAR,0,0,31,5,36
2007,Mauritania,MRT,Morocco,MAR,5,0,0,0,5
2007,Mali,MLI,Morocco,MAR,0,0,0,12,12
2007,Niger,NER,Morocco,MAR,0,0,12,0,12
2007,Nigeria,NGA,Morocco,MAR,0,0,309,173,482
2007,Rwanda,RWA,Morocco,MAR,0,0,0,14,14
2007,Senegal,SEN,Morocco,MAR,0,0,0,5,5
2007,Sierra Leone,SLE,Morocco,MAR,0,0,15,73,88
2007,Somalia,SOM,Morocco,MAR,0,0,0,10,10
2007,Sudan,SDN,Morocco,MAR,0,0,11,0,11
2007,Uganda,UGA,Morocco,MAR,0,0,5,12,17
2007,Zimbabwe,ZWE,Morocco,MAR,0,0,0,5,5
2007,Bosnia and Herzegovina,BIH,Montenegro,MNE,0,0,0,5,5
2007,Serbia and Kosovo: S/RES/1244 (1999),SRB,Montenegro,MNE,0,0,0,5,5
2007,Liberia,LBR,Nepal,NPL,0,0,0,5,5
2007,Myanmar,MMR,Nepal,NPL,0,0,5,0,5
2007,Nigeria,NGA,Nepal,NPL,0,0,0,11,11
2007,Pakistan,PAK,Nepal,NPL,5,0,18,10,33
2007,Somalia,SOM,Nepal,NPL,10,0,5,27,42
2007,Eritrea,ERI,Saudi Arabia,SAU,5,0,0,0,5
2007,Ethiopia,ETH,Saudi Arabia,SAU,0,0,15,0,15
2007,Somalia,SOM,Saudi Arabia,SAU,0,0,15,0,15
2007,Sudan,SDN,Saudi Arabia,SAU,0,0,13,0,13
2007,Cameroon,CMR,Serbia and Kosovo: S/RES/1244 (1999),SRB,5,0,0,0,5
2007,Georgia,GEO,Serbia and Kosovo: S/RES/1244 (1999),SRB,0,0,0,10,10
2007,Iraq,IRQ,Serbia and Kosovo: S/RES/1244 (1999),SRB,5,0,0,0,5
2007,Pakistan,PAK,Serbia and Kosovo: S/RES/1244 (1999),SRB,0,0,0,5,5
2007,Cambodia,KHM,Singapore,SGP,5,0,5,0,10
2007,Cote d'Ivoire,CIV,Singapore,SGP,0,0,0,5,5
2007,Iraq,IRQ,Singapore,SGP,5,0,0,0,5
2007,Sri Lanka,LKA,Singapore,SGP,0,0,0,5,5
2007,Myanmar,MMR,Singapore,SGP,5,0,0,0,5
2007,Cote d'Ivoire,CIV,Sierra Leone,SLE,0,5,0,0,5
2007,Afghanistan,AFG,Syrian Arab Rep.,SYR,27,0,0,0,27
2007,Iran (Islamic Rep. of),IRN,Syrian Arab Rep.,SYR,106,0,24,0,130
2007,Jordan,JOR,Syrian Arab Rep.,SYR,0,0,5,0,5
2007,Liberia,LBR,Syrian Arab Rep.,SYR,0,0,0,5,5
2007,Somalia,SOM,Syrian Arab Rep.,SYR,1047,0,51,0,1098
2007,Sudan,SDN,Syrian Arab Rep.,SYR,24,0,24,0,48
2007,Yemen,YEM,Syrian Arab Rep.,SYR,5,0,0,0,5
2007,Stateless,XXA,Syrian Arab Rep.,SYR,5,0,0,0,5
2007,Cambodia,KHM,Thailand,THA,25,0,37,17,79
2007,China,CHN,Thailand,THA,92,0,15,5,112
2007,Dem. Rep. of the Congo,COD,Thailand,THA,13,0,10,5,28
2007,Ethiopia,ETH,Thailand,THA,0,0,5,0,5
2007,Palestinian,PSE,Thailand,THA,39,0,0,13,52
2007,India,IND,Thailand,THA,0,0,5,0,5
2007,Iran (Islamic Rep. of),IRN,Thailand,THA,5,0,0,15,20
2007,Iraq,IRQ,Thailand,THA,33,0,0,5,38
2007,Lao People's Dem. Rep.,LAO,Thailand,THA,66,0,0,5,71
2007,Sri Lanka,LKA,Thailand,THA,146,0,5,27,178
2007,Myanmar,MMR,Thailand,THA,5,0,0,0,5
2007,Nepal,NPL,Thailand,THA,14,0,18,11,43
2007,Nigeria,NGA,Thailand,THA,0,0,5,0,5
2007,Pakistan,PAK,Thailand,THA,0,0,0,5,5
2007,Somalia,SOM,Thailand,THA,25,0,0,0,25
2007,Viet Nam,VNM,Thailand,THA,10,0,21,5,36
2007,Zimbabwe,ZWE,Thailand,THA,5,0,0,0,5
2007,Senegal,SEN,Trinidad and Tobago,TTO,0,0,5,0,5
2007,Afghanistan,AFG,Turkey,TUR,149,0,19,187,355
2007,China,CHN,Turkey,TUR,5,0,0,24,29
2007,Dem. Rep. of the Congo,COD,Turkey,TUR,5,0,15,16,36
2007,Eritrea,ERI,Turkey,TUR,13,0,5,42,60
2007,Ethiopia,ETH,Turkey,TUR,5,0,17,33,55
2007,Palestinian,PSE,Turkey,TUR,13,0,5,30,48
2007,Guinea,GIN,Turkey,TUR,0,0,0,5,5
2007,Cote d'Ivoire,CIV,Turkey,TUR,0,0,5,15,20
2007,Iran (Islamic Rep. of),IRN,Turkey,TUR,1452,0,138,309,1899
2007,Iraq,IRQ,Turkey,TUR,4442,0,0,499,4941
2007,Liberia,LBR,Turkey,TUR,0,0,12,0,12
2007,Sri Lanka,LKA,Turkey,TUR,5,0,0,47,52
2007,Mauritania,MRT,Turkey,TUR,0,0,5,13,18
2007,Morocco,MAR,Turkey,TUR,5,0,0,12,17
2007,Pakistan,PAK,Turkey,TUR,0,0,0,5,5
2007,Somalia,SOM,Turkey,TUR,594,0,119,268,981
2007,Sudan,SDN,Turkey,TUR,19,0,30,51,100
2007,Syrian Arab Rep.,SYR,Turkey,TUR,0,0,5,5,10
2007,Tunisia,TUN,Turkey,TUR,5,0,0,0,5
2007,Uzbekistan,UZB,Turkey,TUR,49,0,0,5,54
2008,Egypt,EGY,Afghanistan,AFG,0,0,0,5,5
2008,Iran (Islamic Rep. of),IRN,Afghanistan,AFG,0,0,0,5,5
2008,Chad,TCD,Egypt,EGY,5,0,0,0,5
2008,China,CHN,Egypt,EGY,5,0,0,0,5
2008,Dem. Rep. of the Congo,COD,Egypt,EGY,0,0,5,0,5
2008,Eritrea,ERI,Egypt,EGY,374,0,250,5,629
2008,Ethiopia,ETH,Egypt,EGY,14,0,189,45,248
2008,Palestinian,PSE,Egypt,EGY,5,0,0,0,5
2008,Cote d'Ivoire,CIV,Egypt,EGY,16,0,41,0,57
2008,Iraq,IRQ,Egypt,EGY,101,0,0,50,151
2008,Russian Federation,RUS,Egypt,EGY,5,0,0,0,5
2008,Rwanda,RWA,Egypt,EGY,5,0,0,0,5
2008,Somalia,SOM,Egypt,EGY,389,0,15,100,504
2008,Sudan,SDN,Egypt,EGY,152,0,97,562,811
2008,Syrian Arab Rep.,SYR,Egypt,EGY,5,0,0,0,5
2008,Afghanistan,AFG,Azerbaijan,AZE,28,0,0,0,28
2008,Iran (Islamic Rep. of),IRN,Azerbaijan,AZE,5,0,0,0,5
2008,Iraq,IRQ,Azerbaijan,AZE,22,0,0,0,22
2008,Russian Federation,RUS,Azerbaijan,AZE,138,0,0,0,138
2008,Iraq,IRQ,Bahrain,BHR,48,0,0,0,48
2008,Rwanda,RWA,Burundi,BDI,5,0,0,17,22
2008,Uganda,UGA,Burundi,BDI,18,0,0,0,18
2008,Afghanistan,AFG,Belarus,BLR,10,0,0,0,10
2008,Iraq,IRQ,Cambodia,KHM,0,0,0,5,5
2008,Dem. People's Rep. of Korea,PRK,Cambodia,KHM,0,0,0,5,5
2008,Myanmar,MMR,Cambodia,KHM,5,0,0,0,5
2008,Somalia,SOM,Cambodia,KHM,5,0,0,0,5
2008,Viet Nam,VNM,Cambodia,KHM,41,0,272,64,377
2008,Eritrea,ERI,China,CHN,0,0,0,5,5
2008,Palestinian,PSE,China,CHN,0,0,5,0,5
2008,Cote d'Ivoire,CIV,China,CHN,0,0,5,0,5
2008,Iraq,IRQ,China,CHN,13,0,0,13,26
2008,Liberia,LBR,China,CHN,0,0,5,0,5
2008,Nigeria,NGA,China,CHN,0,0,0,5,5
2008,Pakistan,PAK,China,CHN,15,0,0,5,20
2008,Sierra Leone,SLE,China,CHN,0,0,0,5,5
2008,Somalia,SOM,China,CHN,5,0,0,0,5
2008,Eritrea,ERI,Djibouti,DJI,73,0,0,0,73
2008,Ethiopia,ETH,Djibouti,DJI,0,0,0,156,156
2008,Somalia,SOM,Djibouti,DJI,0,20,0,0,20
2008,Yemen,YEM,Djibouti,DJI,5,0,0,0,5
2008,Bangladesh,BGD,"China, Hong Kong SAR",HKG,0,0,249,61,310
2008,Dem. Rep. of the Congo,COD,"China, Hong Kong SAR",HKG,5,0,0,0,5
2008,Eritrea,ERI,"China, Hong Kong SAR",HKG,5,0,0,0,5
2008,Ghana,GHA,"China, Hong Kong SAR",HKG,0,0,5,0,5
2008,Guinea,GIN,"China, Hong Kong SAR",HKG,0,0,0,5,5
2008,Cote d'Ivoire,CIV,"China, Hong Kong SAR",HKG,0,0,5,0,5
2008,India,IND,"China, Hong Kong SAR",HKG,0,0,144,58,202
2008,Indonesia,IDN,"China, Hong Kong SAR",HKG,0,0,25,21,46
2008,Sri Lanka,LKA,"China, Hong Kong SAR",HKG,10,0,26,37,73
2008,Nepal,NPL,"China, Hong Kong SAR",HKG,0,0,102,20,122
2008,Nigeria,NGA,"China, Hong Kong SAR",HKG,0,0,11,5,16
2008,Pakistan,PAK,"China, Hong Kong SAR",HKG,11,0,252,153,416
2008,Philippines,PHL,"China, Hong Kong SAR",HKG,0,0,86,15,101
2008,Somalia,SOM,"China, Hong Kong SAR",HKG,5,0,5,0,10
2008,Thailand,THA,"China, Hong Kong SAR",HKG,0,0,0,5,5
2008,Afghanistan,AFG,India,IND,140,0,177,84,401
2008,Bangladesh,BGD,India,IND,0,0,0,5,5
2008,Dem. Rep. of the Congo,COD,India,IND,0,0,5,0,5
2008,Eritrea,ERI,India,IND,12,0,0,0,12
2008,Ethiopia,ETH,India,IND,0,0,10,0,10
2008,Palestinian,PSE,India,IND,35,0,5,10,50
2008,Iran (Islamic Rep. of),IRN,India,IND,14,0,22,0,36
2008,Iraq,IRQ,India,IND,57,0,14,12,83
2008,Myanmar,MMR,India,IND,726,0,130,76,932
2008,Somalia,SOM,India,IND,275,0,27,29,331
2008,Sudan,SDN,India,IND,0,0,11,5,16
2008,Afghanistan,AFG,Indonesia,IDN,5,0,10,10,25
2008,Ethiopia,ETH,Indonesia,IDN,0,0,5,0,5
2008,Iran (Islamic Rep. of),IRN,Indonesia,IDN,5,0,0,5,10
2008,Iraq,IRQ,Indonesia,IDN,125,0,0,15,140
2008,Sri Lanka,LKA,Indonesia,IDN,13,0,0,5,18
2008,Myanmar,MMR,Indonesia,IDN,17,0,0,0,17
2008,Somalia,SOM,Indonesia,IDN,14,0,0,0,14
2008,Viet Nam,VNM,Indonesia,IDN,0,0,0,10,10
2008,Afghanistan,AFG,Iran (Islamic Rep. of),IRN,73,0,55,135,263
2008,Iraq,IRQ,Iran (Islamic Rep. of),IRN,11,0,10,16,37
2008,Kyrgyzstan,KGZ,Iran (Islamic Rep. of),IRN,0,0,0,5,5
2008,Kuwait,KWT,Iran (Islamic Rep. of),IRN,11,0,0,0,11
2008,Pakistan,PAK,Iran (Islamic Rep. of),IRN,13,0,0,0,13
2008,Tajikistan,TJK,Iran (Islamic Rep. of),IRN,0,0,5,0,5
2008,Uzbekistan,UZB,Iran (Islamic Rep. of),IRN,10,0,0,29,39
2008,Iran (Islamic Rep. of),IRN,Iraq,IRQ,0,0,0,491,491
2008,Syrian Arab Rep.,SYR,Iraq,IRQ,0,0,0,54,54
2008,Turkey,TUR,Iraq,IRQ,0,0,0,96,96
2008,Algeria,DZA,Jordan,JOR,0,0,0,5,5
2008,Egypt,EGY,Jordan,JOR,12,0,0,0,12
2008,Ethiopia,ETH,Jordan,JOR,0,0,0,5,5
2008,Lebanon,LBN,Jordan,JOR,0,0,0,10,10
2008,Sri Lanka,LKA,Jordan,JOR,0,0,0,10,10
2008,Russian Federation,RUS,Jordan,JOR,5,0,0,20,25
2008,Saudi Arabia,SAU,Jordan,JOR,0,0,0,5,5
2008,Somalia,SOM,Jordan,JOR,88,49,0,13,150
2008,Sudan,SDN,Jordan,JOR,21,0,30,5,56
2008,Syrian Arab Rep.,SYR,Jordan,JOR,21,0,5,62,88
2008,Tunisia,TUN,Jordan,JOR,0,0,0,10,10
2008,Turkey,TUR,Jordan,JOR,0,0,0,10,10
2008,Yemen,YEM,Jordan,JOR,0,0,5,0,5
2008,Burundi,BDI,Kenya,KEN,71,0,5,0,76
2008,Dem. Rep. of the Congo,COD,Kenya,KEN,246,0,16,10,272
2008,Eritrea,ERI,Kenya,KEN,96,0,0,53,149
2008,Ethiopia,ETH,Kenya,KEN,1513,0,95,792,2400
2008,India,IND,Kenya,KEN,0,0,0,5,5
2008,Rwanda,RWA,Kenya,KEN,25,0,61,82,168
2008,Sierra Leone,SLE,Kenya,KEN,0,0,0,5,5
2008,Somalia,SOM,Kenya,KEN,553,0,0,240,793
2008,Sudan,SDN,Kenya,KEN,98,0,269,879,1246
2008,United Rep. of Tanzania,TZA,Kenya,KEN,0,0,0,63,63
2008,Uganda,UGA,Kenya,KEN,5,0,10,53,68
2008,Bangladesh,BGD,Kuwait,KWT,0,0,5,0,5
2008,Dem. Rep. of the Congo,COD,Kuwait,KWT,0,0,0,5,5
2008,Palestinian,PSE,Kuwait,KWT,0,0,0,5,5
2008,Iran (Islamic Rep. of),IRN,Kuwait,KWT,22,0,0,5,27
2008,Iraq,IRQ,Kuwait,KWT,84,0,0,0,84
2008,Jordan,JOR,Kuwait,KWT,0,0,5,0,5
2008,Algeria,DZA,Libya,LBY,5,0,0,0,5
2008,Egypt,EGY,Libya,LBY,5,0,0,0,5
2008,Chad,TCD,Libya,LBY,0,0,16,0,16
2008,Dem. Rep. of the Congo,COD,Libya,LBY,21,0,65,5,91
2008,Eritrea,ERI,Libya,LBY,311,0,11,5,327
2008,Ethiopia,ETH,Libya,LBY,29,0,10,5,44
2008,Palestinian,PSE,Libya,LBY,543,343,5,0,891
2008,Cote d'Ivoire,CIV,Libya,LBY,5,0,0,0,5
2008,Iraq,IRQ,Libya,LBY,1160,0,5,26,1191
2008,Liberia,LBR,Libya,LBY,0,0,0,5,5
2008,Nigeria,NGA,Libya,LBY,0,0,0,5,5
2008,Sierra Leone,SLE,Libya,LBY,0,0,0,21,21
2008,Somalia,SOM,Libya,LBY,54,0,0,10,64
2008,Sudan,SDN,Libya,LBY,195,0,64,13,272
2008,Togo,TGO,Libya,LBY,0,0,0,5,5
2008,Egypt,EGY,Lebanon,LBN,0,0,5,0,5
2008,Eritrea,ERI,Lebanon,LBN,0,0,0,5,5
2008,Ethiopia,ETH,Lebanon,LBN,5,0,0,0,5
2008,Palestinian,PSE,Lebanon,LBN,5,0,0,0,5
2008,Iraq,IRQ,Lebanon,LBN,0,0,5,75,80
2008,Kuwait,KWT,Lebanon,LBN,0,0,0,5,5
2008,Somalia,SOM,Lebanon,LBN,0,5,13,0,18
2008,Sudan,SDN,Lebanon,LBN,13,0,128,12,153
2008,Syrian Arab Rep.,SYR,Lebanon,LBN,35,0,20,0,55
2008,Afghanistan,AFG,Malaysia,MYS,10,0,0,25,35
2008,Bangladesh,BGD,Malaysia,MYS,0,0,20,20,40
2008,Cambodia,KHM,Malaysia,MYS,5,0,36,124,165
2008,China,CHN,Malaysia,MYS,5,0,0,0,5
2008,Cameroon,CMR,Malaysia,MYS,0,0,0,28,28
2008,Congo,COG,Malaysia,MYS,0,0,0,5,5
2008,Dem. Rep. of the Congo,COD,Malaysia,MYS,0,0,0,5,5
2008,Palestinian,PSE,Malaysia,MYS,55,0,0,0,55
2008,Guinea,GIN,Malaysia,MYS,0,0,0,14,14
2008,Cote d'Ivoire,CIV,Malaysia,MYS,0,0,5,12,17
2008,India,IND,Malaysia,MYS,0,0,0,10,10
2008,Indonesia,IDN,Malaysia,MYS,28,0,0,276,304
2008,Iran (Islamic Rep. of),IRN,Malaysia,MYS,5,0,0,11,16
2008,Iraq,IRQ,Malaysia,MYS,191,0,0,260,451
2008,Liberia,LBR,Malaysia,MYS,0,0,30,44,74
2008,Sri Lanka,LKA,Malaysia,MYS,957,0,22,283,1262
2008,Myanmar,MMR,Malaysia,MYS,9819,0,84,1508,11411
2008,Nepal,NPL,Malaysia,MYS,0,0,57,84,141
2008,Niger,NER,Malaysia,MYS,0,0,0,5,5
2008,Nigeria,NGA,Malaysia,MYS,0,0,0,14,14
2008,Pakistan,PAK,Malaysia,MYS,0,0,27,25,52
2008,Somalia,SOM,Malaysia,MYS,279,0,0,83,362
2008,Viet Nam,VNM,Malaysia,MYS,0,0,17,17,34
2008,Sudan,SDN,Malaysia,MYS,5,0,0,16,21
2008,Thailand,THA,Malaysia,MYS,0,0,0,16,16
2008,China,CHN,Mongolia,MNG,5,0,0,0,5
2008,Algeria,DZA,Morocco,MAR,0,0,5,0,5
2008,Angola,AGO,Morocco,MAR,0,0,5,0,5
2008,Central African Rep.,CAF,Morocco,MAR,0,0,5,0,5
2008,Chad,TCD,Morocco,MAR,5,0,0,0,5
2008,Cameroon,CMR,Morocco,MAR,0,0,30,11,41
2008,Congo,COG,Morocco,MAR,0,0,12,10,22
2008,Dem. Rep. of the Congo,COD,Morocco,MAR,36,0,218,92,346
2008,Eritrea,ERI,Morocco,MAR,0,0,5,0,5
2008,Gambia,GMB,Morocco,MAR,0,0,0,5,5
2008,Palestinian,PSE,Morocco,MAR,5,0,0,0,5
2008,Ghana,GHA,Morocco,MAR,0,0,0,5,5
2008,Guinea-Bissau,GNB,Morocco,MAR,0,0,0,5,5
2008,Guinea,GIN,Morocco,MAR,0,0,12,0,12
2008,Cote d'Ivoire,CIV,Morocco,MAR,30,0,49,15,94
2008,Iraq,IRQ,Morocco,MAR,27,0,0,29,56
2008,Kenya,KEN,Morocco,MAR,0,0,5,0,5
2008,Liberia,LBR,Morocco,MAR,5,0,17,21,43
2008,Mauritania,MRT,Morocco,MAR,0,0,5,0,5
2008,Niger,NER,Morocco,MAR,0,0,11,0,11
2008,Nigeria,NGA,Morocco,MAR,0,0,157,81,238
2008,Rwanda,RWA,Morocco,MAR,0,0,5,0,5
2008,Sierra Leone,SLE,Morocco,MAR,0,0,5,13,18
2008,Somalia,SOM,Morocco,MAR,5,0,0,0,5
2008,Sudan,SDN,Morocco,MAR,0,0,0,5,5
2008,Togo,TGO,Morocco,MAR,0,0,5,0,5
2008,Iran (Islamic Rep. of),IRN,Nepal,NPL,0,0,0,5,5
2008,Liberia,LBR,Nepal,NPL,0,0,5,0,5
2008,Pakistan,PAK,Nepal,NPL,21,0,0,0,21
2008,Somalia,SOM,Nepal,NPL,21,0,0,26,47
2008,Palestinian,PSE,Qatar,QAT,0,0,0,5,5
2008,Somalia,SOM,Qatar,QAT,0,0,0,11,11
2008,Syrian Arab Rep.,SYR,Qatar,QAT,5,0,0,0,5
2008,Afghanistan,AFG,Saudi Arabia,SAU,0,0,0,5,5
2008,Chad,TCD,Saudi Arabia,SAU,0,0,5,0,5
2008,Eritrea,ERI,Saudi Arabia,SAU,5,0,0,11,16
2008,Ethiopia,ETH,Saudi Arabia,SAU,14,0,0,0,14
2008,Palestinian,PSE,Saudi Arabia,SAU,0,10,0,0,10
2008,Cote d'Ivoire,CIV,Saudi Arabia,SAU,0,0,0,5,5
2008,Iraq,IRQ,Saudi Arabia,SAU,10,0,0,0,10
2008,Liberia,LBR,Saudi Arabia,SAU,5,0,0,25,30
2008,Myanmar,MMR,Saudi Arabia,SAU,0,0,0,10,10
2008,Somalia,SOM,Saudi Arabia,SAU,0,0,0,33,33
2008,Sudan,SDN,Saudi Arabia,SAU,10,0,11,14,35
2008,Syrian Arab Rep.,SYR,Saudi Arabia,SAU,10,0,0,0,10
2008,Uzbekistan,UZB,Saudi Arabia,SAU,5,0,0,0,5
2008,Yemen,YEM,Saudi Arabia,SAU,0,0,5,0,5
2008,China,CHN,Singapore,SGP,5,0,0,5,10
2008,Sri Lanka,LKA,Singapore,SGP,5,0,0,5,10
2008,Myanmar,MMR,Singapore,SGP,11,0,0,5,16
2008,Pakistan,PAK,Singapore,SGP,0,0,0,5,5
2008,Cote d'Ivoire,CIV,Sierra Leone,SLE,0,0,0,21,21
2008,Liberia,LBR,Sierra Leone,SLE,0,0,0,255,255
2008,Nigeria,NGA,Sierra Leone,SLE,0,0,53,0,53
2008,Bangladesh,BGD,Somalia,SOM,5,0,0,0,5
2008,Dem. Rep. of the Congo,COD,Somalia,SOM,5,0,0,0,5
2008,Eritrea,ERI,Somalia,SOM,10,0,0,0,10
2008,Ethiopia,ETH,Somalia,SOM,706,0,610,223,1539
2008,Somalia,SOM,Somalia,SOM,0,0,5,0,5
2008,Sudan,SDN,Somalia,SOM,0,0,10,0,10
2008,Afghanistan,AFG,Syrian Arab Rep.,SYR,223,0,0,101,324
2008,Albania,ALB,Syrian Arab Rep.,SYR,0,0,0,5,5
2008,Algeria,DZA,Syrian Arab Rep.,SYR,0,0,0,84,84
2008,Egypt,EGY,Syrian Arab Rep.,SYR,0,0,0,12,12
2008,Armenia,ARM,Syrian Arab Rep.,SYR,0,0,0,5,5
2008,Chad,TCD,Syrian Arab Rep.,SYR,0,0,0,14,14
2008,Congo,COG,Syrian Arab Rep.,SYR,0,0,0,5,5
2008,Dem. Rep. of the Congo,COD,Syrian Arab Rep.,SYR,12,0,0,0,12
2008,Comoros,COM,Syrian Arab Rep.,SYR,0,0,0,5,5
2008,Eritrea,ERI,Syrian Arab Rep.,SYR,10,0,0,32,42
2008,Ethiopia,ETH,Syrian Arab Rep.,SYR,0,0,5,34,39
2008,Palestinian,PSE,Syrian Arab Rep.,SYR,0,0,0,119,119
2008,India,IND,Syrian Arab Rep.,SYR,0,0,0,5,5
2008,Iran (Islamic Rep. of),IRN,Syrian Arab Rep.,SYR,33,0,19,302,354
2008,Jordan,JOR,Syrian Arab Rep.,SYR,0,0,0,41,41
2008,Kuwait,KWT,Syrian Arab Rep.,SYR,0,0,0,5,5
2008,Liberia,LBR,Syrian Arab Rep.,SYR,0,0,0,5,5
2008,Libya,LBY,Syrian Arab Rep.,SYR,0,0,0,10,10
2008,Lebanon,LBN,Syrian Arab Rep.,SYR,0,0,10,10,20
2008,Sri Lanka,LKA,Syrian Arab Rep.,SYR,0,0,0,5,5
2008,Morocco,MAR,Syrian Arab Rep.,SYR,0,0,0,17,17
2008,Serbia and Kosovo: S/RES/1244 (1999),SRB,Syrian Arab Rep.,SYR,0,0,0,5,5
2008,Sierra Leone,SLE,Syrian Arab Rep.,SYR,0,0,0,16,16
2008,Somalia,SOM,Syrian Arab Rep.,SYR,964,0,24,1349,2337
2008,Sudan,SDN,Syrian Arab Rep.,SYR,121,0,48,479,648
2008,Tunisia,TUN,Syrian Arab Rep.,SYR,0,0,0,17,17
2008,Turkey,TUR,Syrian Arab Rep.,SYR,0,0,0,58,58
2008,Yemen,YEM,Syrian Arab Rep.,SYR,0,0,13,0,13
2008,Stateless,XXA,Syrian Arab Rep.,SYR,5,0,0,49,54
2008,Burundi,BDI,Thailand,THA,5,0,0,0,5
2008,Bangladesh,BGD,Thailand,THA,0,0,5,0,5
2008,Cambodia,KHM,Thailand,THA,26,0,24,24,74
2008,China,CHN,Thailand,THA,36,0,47,5,88
2008,Cameroon,CMR,Thailand,THA,0,0,0,5,5
2008,Dem. Rep. of the Congo,COD,Thailand,THA,5,0,14,5,24
2008,Ethiopia,ETH,Thailand,THA,0,0,0,10,10
2008,Palestinian,PSE,Thailand,THA,5,0,0,0,5
2008,Guinea,GIN,Thailand,THA,0,0,0,5,5
2008,Cote d'Ivoire,CIV,Thailand,THA,0,0,11,5,16
2008,India,IND,Thailand,THA,0,0,5,0,5
2008,Iran (Islamic Rep. of),IRN,Thailand,THA,0,0,12,5,17
2008,Iraq,IRQ,Thailand,THA,46,0,0,39,85
2008,Kuwait,KWT,Thailand,THA,0,0,0,5,5
2008,Lao People's Dem. Rep.,LAO,Thailand,THA,15,0,0,0,15
2008,Sri Lanka,LKA,Thailand,THA,215,0,91,29,335
2008,Myanmar,MMR,Thailand,THA,5,0,0,0,5
2008,Nepal,NPL,Thailand,THA,0,0,5,13,18
2008,Nigeria,NGA,Thailand,THA,0,0,0,5,5
2008,Pakistan,PAK,Thailand,THA,12,0,0,5,17
2008,Rwanda,RWA,Thailand,THA,0,0,0,5,5
2008,Sierra Leone,SLE,Thailand,THA,0,0,5,0,5
2008,Somalia,SOM,Thailand,THA,113,0,0,18,131
2008,Viet Nam,VNM,Thailand,THA,0,0,18,12,30
2008,Sudan,SDN,Thailand,THA,0,0,0,5,5
2008,Azerbaijan,AZE,Turkmenistan,TKM,0,0,16,0,16
2008,Afghanistan,AFG,Turkey,TUR,144,0,113,309,566
2008,Bangladesh,BGD,Turkey,TUR,0,0,0,5,5
2008,Central African Rep.,CAF,Turkey,TUR,0,0,0,5,5
2008,China,CHN,Turkey,TUR,5,0,0,29,34
2008,Cameroon,CMR,Turkey,TUR,0,0,0,5,5
2008,Congo,COG,Turkey,TUR,0,0,0,5,5
2008,Dem. Rep. of the Congo,COD,Turkey,TUR,5,0,12,62,79
2008,Eritrea,ERI,Turkey,TUR,13,0,5,40,58
2008,Ethiopia,ETH,Turkey,TUR,0,0,5,46,51
2008,Palestinian,PSE,Turkey,TUR,58,0,14,112,184
2008,Guinea,GIN,Turkey,TUR,5,0,0,17,22
2008,Cote d'Ivoire,CIV,Turkey,TUR,5,0,5,5,15
2008,Iran (Islamic Rep. of),IRN,Turkey,TUR,1112,0,213,192,1517
2008,Iraq,IRQ,Turkey,TUR,6573,0,21,465,7059
2008,Sri Lanka,LKA,Turkey,TUR,5,0,10,41,56
2008,Mauritania,MRT,Turkey,TUR,0,0,0,18,18
2008,Morocco,MAR,Turkey,TUR,0,0,0,5,5
2008,Nigeria,NGA,Turkey,TUR,0,0,0,10,10
2008,Pakistan,PAK,Turkey,TUR,0,0,0,11,11
2008,Sierra Leone,SLE,Turkey,TUR,0,0,5,0,5
2008,Somalia,SOM,Turkey,TUR,323,0,30,573,926
2008,Sudan,SDN,Turkey,TUR,38,0,24,35,97
2008,Syrian Arab Rep.,SYR,Turkey,TUR,5,0,14,0,19
2008,Turkmenistan,TKM,Turkey,TUR,0,0,0,5,5
2008,Tunisia,TUN,Turkey,TUR,0,0,0,5,5
2008,Uzbekistan,UZB,Turkey,TUR,10,0,0,11,21
2008,Stateless,XXA,Turkey,TUR,5,0,0,0,5
2008,Afghanistan,AFG,Ukraine,UKR,16,0,0,0,16
2008,Ethiopia,ETH,Ukraine,UKR,5,0,0,0,5
2008,Iran (Islamic Rep. of),IRN,Ukraine,UKR,5,0,0,0,5
2008,Iraq,IRQ,Ukraine,UKR,5,0,0,0,5
2008,Russian Federation,RUS,Ukraine,UKR,25,0,0,0,25
2008,Uzbekistan,UZB,Ukraine,UKR,14,0,0,0,14
2008,Sri Lanka,LKA,Vanuatu,VUT,5,0,0,0,5
2009,Iran (Islamic Rep. of),IRN,Afghanistan,AFG,0,0,0,5,5
2009,Pakistan,PAK,Afghanistan,AFG,0,0,5,0,5
2009,Central African Rep.,CAF,Algeria,DZA,0,0,0,14,14
2009,Chad,TCD,Algeria,DZA,0,0,25,56,81
2009,Cameroon,CMR,Algeria,DZA,0,0,108,173,281
2009,Congo,COG,Algeria,DZA,5,0,5,0,10
2009,Dem. Rep. of the Congo,COD,Algeria,DZA,5,0,62,109,176
2009,Palestinian,PSE,Algeria,DZA,0,0,0,5,5
2009,Guinea,GIN,Algeria,DZA,0,0,0,5,5
2009,Cote d'Ivoire,CIV,Algeria,DZA,10,0,62,182,254
2009,Iraq,IRQ,Algeria,DZA,0,0,0,13,13
2009,Liberia,LBR,Algeria,DZA,0,0,132,134,266
2009,Mali,MLI,Algeria,DZA,0,0,0,5,5
2009,Morocco,MAR,Algeria,DZA,0,0,0,5,5
2009,Nigeria,NGA,Algeria,DZA,0,0,110,84,194
2009,South Africa,ZAF,Algeria,DZA,0,0,0,5,5
2009,Sierra Leone,SLE,Algeria,DZA,0,0,0,10,10
2009,Togo,TGO,Algeria,DZA,0,0,0,5,5
2009,Chad,TCD,Egypt,EGY,0,0,0,5,5
2009,Dem. Rep. of the Congo,COD,Egypt,EGY,5,0,0,0,5
2009,Eritrea,ERI,Egypt,EGY,215,0,82,59,356
2009,Ethiopia,ETH,Egypt,EGY,40,0,98,26,164
2009,Palestinian,PSE,Egypt,EGY,14,0,0,0,14
2009,Guinea-Bissau,GNB,Egypt,EGY,0,0,5,0,5
2009,Cote d'Ivoire,CIV,Egypt,EGY,5,0,12,5,22
2009,Iraq,IRQ,Egypt,EGY,69,0,0,23,92
2009,Russian Federation,RUS,Egypt,EGY,5,0,0,0,5
2009,Rwanda,RWA,Egypt,EGY,0,0,5,0,5
2009,Somalia,SOM,Egypt,EGY,603,0,5,5,613
2009,Sudan,SDN,Egypt,EGY,341,0,182,1850,2373
2009,Syrian Arab Rep.,SYR,Egypt,EGY,0,0,0,10,10
2009,Uganda,UGA,Egypt,EGY,0,0,0,5,5
2009,Yemen,YEM,Egypt,EGY,0,0,10,0,10
2009,Zimbabwe,ZWE,Egypt,EGY,5,0,0,0,5
2009,Afghanistan,AFG,Azerbaijan,AZE,10,0,0,0,10
2009,Armenia,ARM,Azerbaijan,AZE,5,0,0,0,5
2009,Iran (Islamic Rep. of),IRN,Azerbaijan,AZE,5,0,0,0,5
2009,Russian Federation,RUS,Azerbaijan,AZE,12,0,5,12,29
2009,Iraq,IRQ,Bahrain,BHR,91,0,0,22,113
2009,Afghanistan,AFG,Belarus,BLR,11,0,0,0,11
2009,China,CHN,Cambodia,KHM,0,0,0,21,21
2009,Myanmar,MMR,Cambodia,KHM,5,0,5,0,10
2009,Viet Nam,VNM,Cambodia,KHM,10,0,24,16,50
2009,Palestinian,PSE,Cyprus,CYP,5,0,0,0,5
2009,Eritrea,ERI,Djibouti,DJI,151,0,0,5,156
2009,Ethiopia,ETH,Djibouti,DJI,41,0,5,46,92
2009,Somalia,SOM,Djibouti,DJI,0,0,26,5,31
2009,Afghanistan,AFG,"China, Hong Kong SAR",HKG,0,0,0,5,5
2009,Algeria,DZA,"China, Hong Kong SAR",HKG,0,0,0,5,5
2009,Bangladesh,BGD,"China, Hong Kong SAR",HKG,0,0,63,31,94
2009,Dem. Rep. of the Congo,COD,"China, Hong Kong SAR",HKG,0,0,5,0,5
2009,Eritrea,ERI,"China, Hong Kong SAR",HKG,5,0,0,0,5
2009,Ghana,GHA,"China, Hong Kong SAR",HKG,0,0,5,5,10
2009,Cote d'Ivoire,CIV,"China, Hong Kong SAR",HKG,0,0,0,5,5
2009,India,IND,"China, Hong Kong SAR",HKG,0,0,61,35,96
2009,Indonesia,IDN,"China, Hong Kong SAR",HKG,0,0,167,85,252
2009,Iran (Islamic Rep. of),IRN,"China, Hong Kong SAR",HKG,5,0,0,0,5
2009,Sri Lanka,LKA,"China, Hong Kong SAR",HKG,0,0,10,48,58
2009,Nepal,NPL,"China, Hong Kong SAR",HKG,0,0,72,23,95
2009,Pakistan,PAK,"China, Hong Kong SAR",HKG,0,0,82,64,146
2009,Philippines,PHL,"China, Hong Kong SAR",HKG,0,0,160,27,187
2009,Somalia,SOM,"China, Hong Kong SAR",HKG,12,0,0,0,12
2009,United Rep. of Tanzania,TZA,"China, Hong Kong SAR",HKG,0,0,0,5,5
2009,Togo,TGO,"China, Hong Kong SAR",HKG,0,0,10,0,10
2009,Afghanistan,AFG,India,IND,400,0,986,947,2333
2009,Egypt,EGY,India,IND,0,0,5,0,5
2009,Dem. Rep. of the Congo,COD,India,IND,0,0,5,10,15
2009,Eritrea,ERI,India,IND,0,0,5,0,5
2009,Palestinian,PSE,India,IND,18,0,0,13,31
2009,Iran (Islamic Rep. of),IRN,India,IND,0,0,5,23,28
2009,Iraq,IRQ,India,IND,38,0,0,45,83
2009,Myanmar,MMR,India,IND,1253,0,22,652,1927
2009,Somalia,SOM,India,IND,169,0,5,61,235
2009,Sudan,SDN,India,IND,5,0,0,12,17
2009,Afghanistan,AFG,Indonesia,IDN,256,0,34,753,1043
2009,Bangladesh,BGD,Indonesia,IDN,0,0,0,122,122
2009,China,CHN,Indonesia,IDN,0,0,5,0,5
2009,Dem. Rep. of the Congo,COD,Indonesia,IDN,5,0,0,0,5
2009,Guinea,GIN,Indonesia,IDN,0,0,5,0,5
2009,Iran (Islamic Rep. of),IRN,Indonesia,IDN,19,0,5,12,36
2009,Iraq,IRQ,Indonesia,IDN,62,0,5,72,139
2009,Kuwait,KWT,Indonesia,IDN,5,0,0,0,5
2009,Sri Lanka,LKA,Indonesia,IDN,105,0,5,18,128
2009,Myanmar,MMR,Indonesia,IDN,283,0,0,10,293
2009,Pakistan,PAK,Indonesia,IDN,5,0,5,0,10
2009,Sierra Leone,SLE,Indonesia,IDN,0,0,0,5,5
2009,Somalia,SOM,Indonesia,IDN,15,0,14,0,29
2009,Afghanistan,AFG,Iran (Islamic Rep. of),IRN,86,0,84,36,206
2009,Iraq,IRQ,Iran (Islamic Rep. of),IRN,0,0,10,5,15
2009,Iran (Islamic Rep. of),IRN,Iraq,IRQ,5,0,0,22,27
2009,Syrian Arab Rep.,SYR,Iraq,IRQ,0,0,0,962,962
2009,Egypt,EGY,Israel,ISR,0,0,0,10,10
2009,Benin,BEN,Israel,ISR,0,0,0,5,5
2009,Bangladesh,BGD,Israel,ISR,0,0,0,5,5
2009,Burkina Faso,BFA,Israel,ISR,0,0,0,20,20
2009,Central African Rep.,CAF,Israel,ISR,0,0,0,12,12
2009,Chad,TCD,Israel,ISR,0,0,0,22,22
2009,China,CHN,Israel,ISR,0,0,0,22,22
2009,Chile,CHL,Israel,ISR,0,0,0,5,5
2009,Cameroon,CMR,Israel,ISR,0,0,0,23,23
2009,Congo,COG,Israel,ISR,0,0,0,5,5
2009,Dem. Rep. of the Congo,COD,Israel,ISR,0,0,0,135,135
2009,Colombia,COL,Israel,ISR,0,0,0,182,182
2009,Cuba,CUB,Israel,ISR,0,0,0,5,5
2009,Ecuador,ECU,Israel,ISR,0,0,0,11,11
2009,Eritrea,ERI,Israel,ISR,0,0,0,5,5
2009,Ethiopia,ETH,Israel,ISR,0,0,0,739,739
2009,Georgia,GEO,Israel,ISR,0,0,0,263,263
2009,Ghana,GHA,Israel,ISR,0,0,0,292,292
2009,Guinea,GIN,Israel,ISR,0,0,0,40,40
2009,Cote d'Ivoire,CIV,Israel,ISR,0,0,0,681,681
2009,India,IND,Israel,ISR,0,0,0,5,5
2009,Iran (Islamic Rep. of),IRN,Israel,ISR,0,0,0,11,11
2009,Iraq,IRQ,Israel,ISR,0,0,0,15,15
2009,Kazakhstan,KAZ,Israel,ISR,0,0,0,5,5
2009,Kenya,KEN,Israel,ISR,0,0,0,23,23
2009,Liberia,LBR,Israel,ISR,0,0,0,34,34
2009,Lebanon,LBN,Israel,ISR,0,0,0,10,10
2009,Sri Lanka,LKA,Israel,ISR,0,0,0,14,14
2009,Lithuania,LTU,Israel,ISR,0,0,0,5,5
2009,Mauritania,MRT,Israel,ISR,0,0,0,5,5
2009,Rep. of Moldova,MDA,Israel,ISR,0,0,0,16,16
2009,Mali,MLI,Israel,ISR,0,0,0,10,10
2009,Mongolia,MNG,Israel,ISR,0,0,0,5,5
2009,Myanmar,MMR,Israel,ISR,0,0,0,85,85
2009,Nepal,NPL,Israel,ISR,0,0,0,10,10
2009,Niger,NER,Israel,ISR,0,0,0,19,19
2009,Nigeria,NGA,Israel,ISR,0,0,0,610,610
2009,Philippines,PHL,Israel,ISR,0,0,0,46,46
2009,South Africa,ZAF,Israel,ISR,0,0,0,11,11
2009,Russian Federation,RUS,Israel,ISR,0,0,0,12,12
2009,Rwanda,RWA,Israel,ISR,0,0,0,10,10
2009,Serbia and Kosovo: S/RES/1244 (1999),SRB,Israel,ISR,0,0,0,5,5
2009,Sierra Leone,SLE,Israel,ISR,0,0,0,11,11
2009,Somalia,SOM,Israel,ISR,0,0,0,24,24
2009,United Rep. of Tanzania,TZA,Israel,ISR,0,0,0,5,5
2009,Togo,TGO,Israel,ISR,0,0,0,18,18
2009,Turkey,TUR,Israel,ISR,0,0,0,233,233
2009,Uzbekistan,UZB,Israel,ISR,0,0,0,5,5
2009,Zimbabwe,ZWE,Israel,ISR,0,0,0,12,12
2009,Afghanistan,AFG,Jordan,JOR,5,0,5,0,10
2009,Egypt,EGY,Jordan,JOR,5,0,49,22,76
2009,Bosnia and Herzegovina,BIH,Jordan,JOR,0,0,5,0,5
2009,Dem. Rep. of the Congo,COD,Jordan,JOR,0,0,0,5,5
2009,Eritrea,ERI,Jordan,JOR,12,0,0,0,12
2009,Georgia,GEO,Jordan,JOR,0,0,0,5,5
2009,Iran (Islamic Rep. of),IRN,Jordan,JOR,0,0,0,5,5
2009,Israel,ISR,Jordan,JOR,5,0,0,0,5
2009,Lebanon,LBN,Jordan,JOR,0,0,0,12,12
2009,Sri Lanka,LKA,Jordan,JOR,0,0,10,0,10
2009,Pakistan,PAK,Jordan,JOR,0,0,10,0,10
2009,Russian Federation,RUS,Jordan,JOR,0,0,0,5,5
2009,Somalia,SOM,Jordan,JOR,72,0,5,138,215
2009,Sudan,SDN,Jordan,JOR,92,0,53,35,180
2009,Syrian Arab Rep.,SYR,Jordan,JOR,97,0,17,37,151
2009,Tunisia,TUN,Jordan,JOR,0,0,5,0,5
2009,Yemen,YEM,Jordan,JOR,5,0,0,0,5
2009,Stateless,XXA,Jordan,JOR,20,0,0,12,32
2009,Burundi,BDI,Kenya,KEN,23,0,23,5,51
2009,Dem. Rep. of the Congo,COD,Kenya,KEN,986,0,74,5,1065
2009,Eritrea,ERI,Kenya,KEN,304,0,0,5,309
2009,Ethiopia,ETH,Kenya,KEN,1025,0,211,319,1555
2009,Rwanda,RWA,Kenya,KEN,42,0,85,10,137
2009,Somalia,SOM,Kenya,KEN,674,0,11,1049,1734
2009,Sudan,SDN,Kenya,KEN,123,0,163,0,286
2009,Uganda,UGA,Kenya,KEN,25,0,27,11,63
2009,Zimbabwe,ZWE,Kenya,KEN,5,0,0,0,5
2009,Iraq,IRQ,Kuwait,KWT,0,0,0,26,26
2009,Somalia,SOM,Kuwait,KWT,5,0,0,0,5
2009,Algeria,DZA,Libya,LBY,0,0,0,5,5
2009,Egypt,EGY,Libya,LBY,0,0,0,26,26
2009,Bangladesh,BGD,Libya,LBY,0,0,0,5,5
2009,Chad,TCD,Libya,LBY,25,0,43,256,324
2009,Cameroon,CMR,Libya,LBY,0,0,0,10,10
2009,Congo,COG,Libya,LBY,0,0,0,5,5
2009,Dem. Rep. of the Congo,COD,Libya,LBY,0,0,0,50,50
2009,Eritrea,ERI,Libya,LBY,383,0,10,514,907
2009,Ethiopia,ETH,Libya,LBY,10,0,0,193,203
2009,Ghana,GHA,Libya,LBY,0,0,0,5,5
2009,Cote d'Ivoire,CIV,Libya,LBY,0,0,0,10,10
2009,Iraq,IRQ,Libya,LBY,641,0,5,309,955
2009,Jordan,JOR,Libya,LBY,0,0,0,5,5
2009,Liberia,LBR,Libya,LBY,5,0,5,42,52
2009,Morocco,MAR,Libya,LBY,0,0,0,10,10
2009,Niger,NER,Libya,LBY,0,0,0,13,13
2009,Nigeria,NGA,Libya,LBY,0,0,0,10,10
2009,Rwanda,RWA,Libya,LBY,0,0,0,10,10
2009,Sierra Leone,SLE,Libya,LBY,0,0,0,24,24
2009,Somalia,SOM,Libya,LBY,91,0,0,167,258
2009,Sudan,SDN,Libya,LBY,541,0,58,950,1549
2009,Syrian Arab Rep.,SYR,Libya,LBY,0,0,0,15,15
2009,Egypt,EGY,Lebanon,LBN,10,0,5,0,15
2009,Ethiopia,ETH,Lebanon,LBN,0,0,5,0,5
2009,Palestinian,PSE,Lebanon,LBN,10,0,0,0,10
2009,Iran (Islamic Rep. of),IRN,Lebanon,LBN,5,0,0,5,10
2009,Iraq,IRQ,Lebanon,LBN,5,0,14,0,19
2009,Sudan,SDN,Lebanon,LBN,36,0,158,90,284
2009,Syrian Arab Rep.,SYR,Lebanon,LBN,21,0,40,5,66
2009,Turkey,TUR,Lebanon,LBN,0,0,5,0,5
2009,Stateless,XXA,Lebanon,LBN,0,0,0,5,5
2009,Angola,AGO,Morocco,MAR,0,0,0,5,5
2009,Benin,BEN,Morocco,MAR,0,0,5,0,5
2009,Bangladesh,BGD,Morocco,MAR,0,0,5,0,5
2009,Central African Rep.,CAF,Morocco,MAR,5,0,5,0,10
2009,Chad,TCD,Morocco,MAR,0,0,12,0,12
2009,Cameroon,CMR,Morocco,MAR,5,0,31,0,36
2009,Congo,COG,Morocco,MAR,5,0,10,0,15
2009,Dem. Rep. of the Congo,COD,Morocco,MAR,26,0,258,24,308
2009,Eritrea,ERI,Morocco,MAR,0,0,13,0,13
2009,Palestinian,PSE,Morocco,MAR,11,0,0,0,11
2009,Guinea-Bissau,GNB,Morocco,MAR,0,0,5,0,5
2009,Guinea,GIN,Morocco,MAR,5,0,5,0,10
2009,Cote d'Ivoire,CIV,Morocco,MAR,20,0,55,10,85
2009,Iraq,IRQ,Morocco,MAR,50,0,0,0,50
2009,Kenya,KEN,Morocco,MAR,0,0,13,0,13
2009,Liberia,LBR,Morocco,MAR,0,0,22,0,22
2009,Nigeria,NGA,Morocco,MAR,0,0,62,17,79
2009,Pakistan,PAK,Morocco,MAR,0,0,10,0,10
2009,Rwanda,RWA,Morocco,MAR,0,0,5,0,5
2009,Senegal,SEN,Morocco,MAR,5,0,0,0,5
2009,Sierra Leone,SLE,Morocco,MAR,0,0,12,0,12
2009,Somalia,SOM,Morocco,MAR,0,0,11,0,11
2009,Sudan,SDN,Morocco,MAR,0,0,10,5,15
2009,Togo,TGO,Morocco,MAR,0,0,5,0,5
2009,Uganda,UGA,Morocco,MAR,0,0,10,0,10
2009,Yemen,YEM,Morocco,MAR,5,0,0,0,5
2009,Zimbabwe,ZWE,Morocco,MAR,0,0,12,0,12
2009,Egypt,EGY,Nepal,NPL,0,0,0,5,5
2009,Iran (Islamic Rep. of),IRN,Nepal,NPL,0,0,0,5,5
2009,Sri Lanka,LKA,Nepal,NPL,0,0,0,5,5
2009,Myanmar,MMR,Nepal,NPL,5,0,0,5,10
2009,Pakistan,PAK,Nepal,NPL,0,0,0,5,5
2009,Somalia,SOM,Nepal,NPL,5,0,0,5,10
2009,Iraq,IRQ,Oman,OMN,19,0,0,35,54
2009,Sudan,SDN,Oman,OMN,0,0,5,0,5
2009,Myanmar,MMR,Palau,PLW,11,0,0,0,11
2009,Iraq,IRQ,Qatar,QAT,16,0,0,12,28
2009,Sudan,SDN,Qatar,QAT,0,0,0,5,5
2009,Chad,TCD,Saudi Arabia,SAU,0,0,0,5,5
2009,China,CHN,Saudi Arabia,SAU,10,0,0,0,10
2009,Eritrea,ERI,Saudi Arabia,SAU,0,0,0,5,5
2009,Ethiopia,ETH,Saudi Arabia,SAU,0,0,0,5,5
2009,Cote d'Ivoire,CIV,Saudi Arabia,SAU,0,0,0,5,5
2009,Iraq,IRQ,Saudi Arabia,SAU,0,0,0,22,22
2009,Myanmar,MMR,Saudi Arabia,SAU,0,0,0,10,10
2009,Somalia,SOM,Saudi Arabia,SAU,0,0,0,5,5
2009,Sudan,SDN,Saudi Arabia,SAU,0,0,0,79,79
2009,Uzbekistan,UZB,Saudi Arabia,SAU,0,0,0,5,5
2009,Yemen,YEM,Saudi Arabia,SAU,0,0,0,5,5
2009,Dem. Rep. of the Congo,COD,Somalia,SOM,0,0,5,0,5
2009,Eritrea,ERI,Somalia,SOM,13,0,0,0,13
2009,Ethiopia,ETH,Somalia,SOM,91,0,25,0,116
2009,United Rep. of Tanzania,TZA,Somalia,SOM,0,0,0,18,18
2009,Eritrea,ERI,Sudan,SDN,44,0,5,0,49
2009,Ethiopia,ETH,Sudan,SDN,49,0,14,0,63
2009,Somalia,SOM,Sudan,SDN,0,0,0,5,5
2009,Afghanistan,AFG,Syrian Arab Rep.,SYR,574,0,10,0,584
2009,Algeria,DZA,Syrian Arab Rep.,SYR,0,0,5,0,5
2009,Egypt,EGY,Syrian Arab Rep.,SYR,0,0,5,0,5
2009,Chad,TCD,Syrian Arab Rep.,SYR,0,0,5,0,5
2009,China,CHN,Syrian Arab Rep.,SYR,0,0,0,5,5
2009,Dem. Rep. of the Congo,COD,Syrian Arab Rep.,SYR,5,0,0,0,5
2009,Colombia,COL,Syrian Arab Rep.,SYR,0,0,5,0,5
2009,Eritrea,ERI,Syrian Arab Rep.,SYR,15,0,0,0,15
2009,Palestinian,PSE,Syrian Arab Rep.,SYR,0,0,0,54,54
2009,Iran (Islamic Rep. of),IRN,Syrian Arab Rep.,SYR,45,0,41,0,86
2009,Kuwait,KWT,Syrian Arab Rep.,SYR,5,0,0,0,5
2009,Lebanon,LBN,Syrian Arab Rep.,SYR,0,0,5,0,5
2009,Pakistan,PAK,Syrian Arab Rep.,SYR,5,0,0,0,5
2009,Somalia,SOM,Syrian Arab Rep.,SYR,343,0,5,0,348
2009,Sudan,SDN,Syrian Arab Rep.,SYR,118,0,150,0,268
2009,Tunisia,TUN,Syrian Arab Rep.,SYR,5,0,0,0,5
2009,Yemen,YEM,Syrian Arab Rep.,SYR,0,0,12,0,12
2009,Stateless,XXA,Syrian Arab Rep.,SYR,18,0,0,5,23
2009,Afghanistan,AFG,Thailand,THA,0,0,0,5,5
2009,Bangladesh,BGD,Thailand,THA,0,0,0,5,5
2009,Cambodia,KHM,Thailand,THA,20,0,5,16,41
2009,China,CHN,Thailand,THA,19,0,19,25,63
2009,Cameroon,CMR,Thailand,THA,0,0,0,10,10
2009,Dem. Rep. of the Congo,COD,Thailand,THA,5,0,16,21,42
2009,Palestinian,PSE,Thailand,THA,15,0,0,0,15
2009,Guinea,GIN,Thailand,THA,0,0,5,0,5
2009,Cote d'Ivoire,CIV,Thailand,THA,0,0,0,11,11
2009,India,IND,Thailand,THA,0,0,5,5,10
2009,Iran (Islamic Rep. of),IRN,Thailand,THA,0,0,5,16,21
2009,Iraq,IRQ,Thailand,THA,43,0,5,16,64
2009,Lao People's Dem. Rep.,LAO,Thailand,THA,13,0,0,5,18
2009,Liberia,LBR,Thailand,THA,5,0,0,0,5
2009,Sri Lanka,LKA,Thailand,THA,149,0,29,109,287
2009,Nepal,NPL,Thailand,THA,0,0,0,10,10
2009,Pakistan,PAK,Thailand,THA,17,0,31,38,86
2009,Sierra Leone,SLE,Thailand,THA,0,0,5,5,10
2009,Somalia,SOM,Thailand,THA,37,0,0,5,42
2009,Viet Nam,VNM,Thailand,THA,18,0,129,75,222
2009,Syrian Arab Rep.,SYR,Thailand,THA,0,0,0,5,5
2009,Afghanistan,AFG,Tajikistan,TJK,16,0,0,0,16
2009,Afghanistan,AFG,Turkey,TUR,771,0,644,948,2363
2009,Algeria,DZA,Turkey,TUR,0,0,0,5,5
2009,Egypt,EGY,Turkey,TUR,0,0,5,0,5
2009,Bangladesh,BGD,Turkey,TUR,0,0,0,5,5
2009,Bhutan,BTN,Turkey,TUR,0,0,0,5,5
2009,Cameroon,CMR,Turkey,TUR,0,0,0,28,28
2009,Dem. Rep. of the Congo,COD,Turkey,TUR,0,0,5,73,78
2009,Eritrea,ERI,Turkey,TUR,20,0,5,48,73
2009,Ethiopia,ETH,Turkey,TUR,10,0,5,5,20
2009,Palestinian,PSE,Turkey,TUR,5,0,0,40,45
2009,Guinea,GIN,Turkey,TUR,0,0,11,10,21
2009,Cote d'Ivoire,CIV,Turkey,TUR,0,0,5,5,10
2009,Iran (Islamic Rep. of),IRN,Turkey,TUR,1345,0,263,311,1919
2009,Iraq,IRQ,Turkey,TUR,3432,0,36,471,3939
2009,Kenya,KEN,Turkey,TUR,0,0,0,5,5
2009,Liberia,LBR,Turkey,TUR,0,0,0,5,5
2009,Sri Lanka,LKA,Turkey,TUR,13,0,5,30,48
2009,Mauritania,MRT,Turkey,TUR,0,0,0,23,23
2009,Morocco,MAR,Turkey,TUR,5,0,0,0,5
2009,Myanmar,MMR,Turkey,TUR,0,0,0,88,88
2009,Nigeria,NGA,Turkey,TUR,0,0,5,12,17
2009,Pakistan,PAK,Turkey,TUR,5,0,0,14,19
2009,Somalia,SOM,Turkey,TUR,237,0,17,214,468
2009,Sudan,SDN,Turkey,TUR,46,0,14,77,137
2009,Syrian Arab Rep.,SYR,Turkey,TUR,0,0,0,14,14
2009,Turkmenistan,TKM,Turkey,TUR,0,0,0,5,5
2009,Uzbekistan,UZB,Turkey,TUR,12,0,0,5,17
2009,Stateless,XXA,Turkey,TUR,5,0,0,5,10
2009,Afghanistan,AFG,Ukraine,UKR,40,0,11,0,51
2009,Angola,AGO,Ukraine,UKR,0,0,5,0,5
2009,Azerbaijan,AZE,Ukraine,UKR,12,0,0,0,12
2009,Belarus,BLR,Ukraine,UKR,0,0,5,0,5
2009,Dem. Rep. of the Congo,COD,Ukraine,UKR,13,0,5,0,18
2009,Ethiopia,ETH,Ukraine,UKR,5,0,0,0,5
2009,Palestinian,PSE,Ukraine,UKR,5,0,0,0,5
2009,Georgia,GEO,Ukraine,UKR,5,0,5,0,10
2009,Iran (Islamic Rep. of),IRN,Ukraine,UKR,13,0,5,0,18
2009,Iraq,IRQ,Ukraine,UKR,12,0,5,0,17
2009,Kazakhstan,KAZ,Ukraine,UKR,10,0,0,0,10
2009,Sri Lanka,LKA,Ukraine,UKR,0,0,11,0,11
2009,Pakistan,PAK,Ukraine,UKR,5,0,0,0,5
2009,Russian Federation,RUS,Ukraine,UKR,10,0,5,5,20
2009,Somalia,SOM,Ukraine,UKR,5,0,0,5,10
2009,Sudan,SDN,Ukraine,UKR,5,0,0,0,5
2009,Syrian Arab Rep.,SYR,Ukraine,UKR,5,0,5,0,10
2009,Tajikistan,TJK,Ukraine,UKR,0,0,0,5,5
2009,Uzbekistan,UZB,Ukraine,UKR,17,0,10,0,27
2010,Iran (Islamic Rep. of),IRN,Afghanistan,AFG,0,0,0,5,5
2010,Pakistan,PAK,Afghanistan,AFG,14,0,0,0,14
2010,Cameroon,CMR,Algeria,DZA,0,0,41,13,54
2010,Dem. Rep. of the Congo,COD,Algeria,DZA,0,0,16,5,21
2010,Guinea,GIN,Algeria,DZA,0,0,0,11,11
2010,Cote d'Ivoire,CIV,Algeria,DZA,5,0,22,0,27
2010,Iraq,IRQ,Algeria,DZA,11,0,0,0,11
2010,Liberia,LBR,Algeria,DZA,0,0,37,23,60
2010,Nigeria,NGA,Algeria,DZA,0,0,30,29,59
2010,Sierra Leone,SLE,Algeria,DZA,0,0,5,5,10
2010,Chad,TCD,Egypt,EGY,11,0,0,0,11
2010,Eritrea,ERI,Egypt,EGY,170,0,100,17,287
2010,Ethiopia,ETH,Egypt,EGY,67,0,136,5,208
2010,Palestinian,PSE,Egypt,EGY,0,0,0,5,5
2010,Guinea,GIN,Egypt,EGY,0,0,5,0,5
2010,Cote d'Ivoire,CIV,Egypt,EGY,12,0,0,0,12
2010,Iraq,IRQ,Egypt,EGY,62,0,5,0,67
2010,Israel,ISR,Egypt,EGY,0,0,0,5,5
2010,Sri Lanka,LKA,Egypt,EGY,0,0,0,5,5
2010,Somalia,SOM,Egypt,EGY,216,0,56,10,282
2010,Sudan,SDN,Egypt,EGY,384,0,378,320,1082
2010,Turkmenistan,TKM,Egypt,EGY,5,0,0,0,5
2010,Georgia,GEO,Armenia,ARM,5,0,0,0,5
2010,Afghanistan,AFG,Azerbaijan,AZE,144,0,0,0,144
2010,Palestinian,PSE,Azerbaijan,AZE,10,0,0,0,10
2010,Iran (Islamic Rep. of),IRN,Azerbaijan,AZE,5,0,0,0,5
2010,Russian Federation,RUS,Azerbaijan,AZE,5,0,5,17,27
2010,Uzbekistan,UZB,Azerbaijan,AZE,5,0,0,0,5
2010,Iraq,IRQ,Bahrain,BHR,63,0,5,0,68
2010,Sudan,SDN,Bahrain,BHR,0,0,10,0,10
2010,Stateless,XXA,Bahrain,BHR,0,0,0,5,5
2010,Myanmar,MMR,Bangladesh,BGD,11,0,5,0,16
2010,Afghanistan,AFG,Belarus,BLR,15,0,0,0,15
2010,China,CHN,Cambodia,KHM,0,0,0,5,5
2010,Myanmar,MMR,Cambodia,KHM,0,0,5,5,10
2010,Viet Nam,VNM,Cambodia,KHM,0,0,15,0,15
2010,Burundi,BDI,Cameroon,CMR,5,0,0,0,5
2010,Central African Rep.,CAF,Cameroon,CMR,984,0,85,128,1197
2010,Chad,TCD,Cameroon,CMR,102,0,159,84,345
2010,Congo,COG,Cameroon,CMR,5,0,5,0,10
2010,Dem. Rep. of the Congo,COD,Cameroon,CMR,52,0,91,15,158
2010,Equatorial Guinea,GNQ,Cameroon,CMR,5,0,0,0,5
2010,Gabon,GAB,Cameroon,CMR,5,0,0,0,5
2010,Guinea-Bissau,GNB,Cameroon,CMR,0,0,10,17,27
2010,Guinea,GIN,Cameroon,CMR,0,0,91,338,429
2010,Cote d'Ivoire,CIV,Cameroon,CMR,5,0,11,65,81
2010,Liberia,LBR,Cameroon,CMR,5,0,0,0,5
2010,Mauritania,MRT,Cameroon,CMR,0,0,0,5,5
2010,Nigeria,NGA,Cameroon,CMR,0,0,5,0,5
2010,Rwanda,RWA,Cameroon,CMR,82,0,58,5,145
2010,Sudan,SDN,Cameroon,CMR,5,0,0,0,5
2010,Togo,TGO,Cameroon,CMR,0,0,0,5,5
2010,Palestinian,PSE,Cyprus,CYP,0,0,0,5,5
2010,Iraq,IRQ,Cyprus,CYP,0,0,0,10,10
2010,Syrian Arab Rep.,SYR,Cyprus,CYP,0,0,0,5,5
2010,Cuba,CUB,Haiti,HTI,0,0,0,5,5
2010,Sri Lanka,LKA,Haiti,HTI,0,0,0,5,5
2010,Afghanistan,AFG,"China, Hong Kong SAR",HKG,12,0,0,0,12
2010,Egypt,EGY,"China, Hong Kong SAR",HKG,5,0,0,0,5
2010,Bangladesh,BGD,"China, Hong Kong SAR",HKG,0,0,5,10,15
2010,Eritrea,ERI,"China, Hong Kong SAR",HKG,5,0,0,0,5
2010,Ethiopia,ETH,"China, Hong Kong SAR",HKG,5,0,0,0,5
2010,Palestinian,PSE,"China, Hong Kong SAR",HKG,0,10,0,0,10
2010,Ghana,GHA,"China, Hong Kong SAR",HKG,0,0,0,5,5
2010,Guinea,GIN,"China, Hong Kong SAR",HKG,0,0,5,0,5
2010,India,IND,"China, Hong Kong SAR",HKG,0,0,21,25,46
2010,Indonesia,IDN,"China, Hong Kong SAR",HKG,0,0,66,100,166
2010,Liberia,LBR,"China, Hong Kong SAR",HKG,0,0,10,0,10
2010,Sri Lanka,LKA,"China, Hong Kong SAR",HKG,11,0,61,20,92
2010,Nepal,NPL,"China, Hong Kong SAR",HKG,0,0,33,10,43
2010,Niger,NER,"China, Hong Kong SAR",HKG,0,0,0,5,5
2010,Nigeria,NGA,"China, Hong Kong SAR",HKG,0,0,12,0,12
2010,Pakistan,PAK,"China, Hong Kong SAR",HKG,5,0,49,53,107
2010,Philippines,PHL,"China, Hong Kong SAR",HKG,0,0,49,55,104
2010,Somalia,SOM,"China, Hong Kong SAR",HKG,39,0,0,0,39
2010,Togo,TGO,"China, Hong Kong SAR",HKG,0,0,5,5,10
2010,Uganda,UGA,"China, Hong Kong SAR",HKG,0,0,5,18,23
2010,Afghanistan,AFG,India,IND,727,0,986,265,1978
2010,Bangladesh,BGD,India,IND,0,0,0,11,11
2010,Dem. Rep. of the Congo,COD,India,IND,13,0,5,5,23
2010,Eritrea,ERI,India,IND,22,0,5,0,27
2010,Ethiopia,ETH,India,IND,5,0,5,0,10
2010,Palestinian,PSE,India,IND,10,0,0,0,10
2010,Iran (Islamic Rep. of),IRN,India,IND,25,0,20,15,60
2010,Iraq,IRQ,India,IND,22,0,5,22,49
2010,Myanmar,MMR,India,IND,2212,0,26,707,2945
2010,Somalia,SOM,India,IND,155,0,0,35,190
2010,Sudan,SDN,India,IND,10,0,5,0,15
2010,Tajikistan,TJK,India,IND,0,0,0,5,5
2010,Uzbekistan,UZB,India,IND,0,0,0,5,5
2010,Afghanistan,AFG,Iran (Islamic Rep. of),IRN,89,0,16,32,137
2010,Uzbekistan,UZB,Iran (Islamic Rep. of),IRN,0,0,0,12,12
2010,Indonesia,IDN,Iraq,IRQ,0,0,0,5,5
2010,Iran (Islamic Rep. of),IRN,Iraq,IRQ,48,0,5,66,119
2010,Turkey,TUR,Iraq,IRQ,0,0,0,1426,1426
2010,Yemen,YEM,Iraq,IRQ,0,0,0,13,13
2010,Afghanistan,AFG,Jordan,JOR,11,0,5,0,16
2010,Egypt,EGY,Jordan,JOR,0,0,42,28,70
2010,Eritrea,ERI,Jordan,JOR,5,0,0,0,5
2010,Iraq,IRQ,Jordan,JOR,379,0,225,247,851
2010,Sri Lanka,LKA,Jordan,JOR,0,0,16,0,16
2010,Russian Federation,RUS,Jordan,JOR,5,0,0,0,5
2010,Somalia,SOM,Jordan,JOR,78,0,29,33,140
2010,Sudan,SDN,Jordan,JOR,96,0,89,45,230
2010,Syrian Arab Rep.,SYR,Jordan,JOR,68,0,38,22,128
2010,Turkey,TUR,Jordan,JOR,0,0,0,13,13
2010,Yemen,YEM,Jordan,JOR,0,0,15,14,29
2010,Stateless,XXA,Jordan,JOR,19,0,0,12,31
2010,Burundi,BDI,Kenya,KEN,58,0,45,5,108
2010,Congo,COG,Kenya,KEN,0,0,0,5,5
2010,Dem. Rep. of the Congo,COD,Kenya,KEN,1623,0,170,32,1825
2010,Eritrea,ERI,Kenya,KEN,303,0,20,28,351
2010,Ethiopia,ETH,Kenya,KEN,4967,0,408,2119,7494
2010,Iran (Islamic Rep. of),IRN,Kenya,KEN,5,0,0,5,10
2010,Pakistan,PAK,Kenya,KEN,0,0,5,0,5
2010,Rwanda,RWA,Kenya,KEN,28,0,90,27,145
2010,Somalia,SOM,Kenya,KEN,256,0,16,78,350
2010,Sudan,SDN,Kenya,KEN,112,0,121,10,243
2010,United Rep. of Tanzania,TZA,Kenya,KEN,0,0,0,17,17
2010,Uganda,UGA,Kenya,KEN,37,0,19,36,92
2010,Zimbabwe,ZWE,Kenya,KEN,0,0,0,5,5
2010,Afghanistan,AFG,Kuwait,KWT,0,0,5,0,5
2010,Iran (Islamic Rep. of),IRN,Kuwait,KWT,0,0,16,0,16
2010,Iraq,IRQ,Kuwait,KWT,0,0,0,30,30
2010,Somalia,SOM,Kuwait,KWT,10,0,0,0,10
2010,Syrian Arab Rep.,SYR,Kuwait,KWT,5,0,0,0,5
2010,Chad,TCD,Libya,LBY,0,0,0,212,212
2010,Dem. Rep. of the Congo,COD,Libya,LBY,0,0,0,10,10
2010,Eritrea,ERI,Libya,LBY,441,0,0,231,672
2010,Ethiopia,ETH,Libya,LBY,14,0,0,23,37
2010,Iraq,IRQ,Libya,LBY,172,0,5,110,287
2010,Liberia,LBR,Libya,LBY,0,0,0,5,5
2010,Niger,NER,Libya,LBY,0,0,0,5,5
2010,Sierra Leone,SLE,Libya,LBY,0,0,0,5,5
2010,Somalia,SOM,Libya,LBY,74,0,0,114,188
2010,Sudan,SDN,Libya,LBY,90,0,12,205,307
2010,Egypt,EGY,Lebanon,LBN,0,0,0,13,13
2010,Eritrea,ERI,Lebanon,LBN,0,0,0,5,5
2010,Ethiopia,ETH,Lebanon,LBN,0,0,0,11,11
2010,Palestinian,PSE,Lebanon,LBN,0,0,0,5,5
2010,Iran (Islamic Rep. of),IRN,Lebanon,LBN,10,0,10,89,109
2010,Iraq,IRQ,Lebanon,LBN,49,10,79,179,317
2010,Jordan,JOR,Lebanon,LBN,5,0,0,14,19
2010,Sri Lanka,LKA,Lebanon,LBN,0,0,0,5,5
2010,Philippines,PHL,Lebanon,LBN,0,0,0,10,10
2010,Somalia,SOM,Lebanon,LBN,5,0,0,14,19
2010,Sudan,SDN,Lebanon,LBN,45,0,203,89,337
2010,Syrian Arab Rep.,SYR,Lebanon,LBN,20,0,50,88,158
2010,Turkey,TUR,Lebanon,LBN,0,0,0,5,5
2010,Stateless,XXA,Lebanon,LBN,0,0,0,5,5
2010,Afghanistan,AFG,Malaysia,MYS,117,0,0,90,207
2010,Bangladesh,BGD,Malaysia,MYS,5,0,0,0,5
2010,Cambodia,KHM,Malaysia,MYS,14,0,0,0,14
2010,China,CHN,Malaysia,MYS,17,0,0,0,17
2010,Palestinian,PSE,Malaysia,MYS,46,0,0,0,46
2010,Guinea,GIN,Malaysia,MYS,0,0,5,0,5
2010,Indonesia,IDN,Malaysia,MYS,52,0,0,29,81
2010,Iran (Islamic Rep. of),IRN,Malaysia,MYS,36,0,5,0,41
2010,Iraq,IRQ,Malaysia,MYS,63,0,0,15,78
2010,Kenya,KEN,Malaysia,MYS,5,0,0,0,5
2010,Sri Lanka,LKA,Malaysia,MYS,265,0,128,0,393
2010,Myanmar,MMR,Malaysia,MYS,21036,0,210,2129,23375
2010,Nigeria,NGA,Malaysia,MYS,0,0,5,0,5
2010,Pakistan,PAK,Malaysia,MYS,34,0,0,0,34
2010,Somalia,SOM,Malaysia,MYS,192,0,10,0,202
2010,Sudan,SDN,Malaysia,MYS,17,0,5,0,22
2010,Thailand,THA,Malaysia,MYS,0,0,0,48,48
2010,Yemen,YEM,Malaysia,MYS,10,0,0,0,10
2010,Zimbabwe,ZWE,Malaysia,MYS,0,0,0,5,5
2010,Afghanistan,AFG,Morocco,MAR,10,0,0,0,10
2010,Angola,AGO,Morocco,MAR,0,0,10,0,10
2010,Central African Rep.,CAF,Morocco,MAR,0,0,5,0,5
2010,Chad,TCD,Morocco,MAR,0,0,5,0,5
2010,Cameroon,CMR,Morocco,MAR,5,0,23,5,33
2010,Congo,COG,Morocco,MAR,5,0,18,5,28
2010,Dem. Rep. of the Congo,COD,Morocco,MAR,39,0,209,17,265
2010,Eritrea,ERI,Morocco,MAR,5,0,0,0,5
2010,Gambia,GMB,Morocco,MAR,0,0,5,0,5
2010,Palestinian,PSE,Morocco,MAR,5,0,0,0,5
2010,Ghana,GHA,Morocco,MAR,0,0,12,0,12
2010,Guinea,GIN,Morocco,MAR,0,0,63,5,68
2010,Cote d'Ivoire,CIV,Morocco,MAR,28,0,50,10,88
2010,Iraq,IRQ,Morocco,MAR,32,0,0,0,32
2010,Liberia,LBR,Morocco,MAR,0,0,24,5,29
2010,Niger,NER,Morocco,MAR,0,0,12,5,17
2010,Nigeria,NGA,Morocco,MAR,0,0,141,10,151
2010,Pakistan,PAK,Morocco,MAR,0,0,0,5,5
2010,Rwanda,RWA,Morocco,MAR,0,0,10,0,10
2010,Senegal,SEN,Morocco,MAR,5,0,0,0,5
2010,Sierra Leone,SLE,Morocco,MAR,0,0,26,0,26
2010,Somalia,SOM,Morocco,MAR,0,0,10,0,10
2010,Sudan,SDN,Morocco,MAR,0,0,10,0,10
2010,Uganda,UGA,Morocco,MAR,0,0,17,5,22
2010,Zimbabwe,ZWE,Morocco,MAR,0,0,10,0,10
2010,Sri Lanka,LKA,Nepal,NPL,0,0,0,5,5
2010,Myanmar,MMR,Nepal,NPL,18,0,10,12,40
2010,Pakistan,PAK,Nepal,NPL,12,0,0,5,17
2010,Iraq,IRQ,Oman,OMN,52,0,0,0,52
2010,Iraq,IRQ,Qatar,QAT,16,0,0,0,16
2010,Pakistan,PAK,Qatar,QAT,0,0,0,5,5
2010,Somalia,SOM,Qatar,QAT,5,0,0,0,5
2010,Sudan,SDN,Qatar,QAT,0,0,0,5,5
2010,Ethiopia,ETH,Saudi Arabia,SAU,0,0,0,5,5
2010,Iraq,IRQ,Saudi Arabia,SAU,0,0,0,10,10
2010,Somalia,SOM,Saudi Arabia,SAU,13,0,0,5,18
2010,Sudan,SDN,Saudi Arabia,SAU,0,0,0,5,5
2010,Uzbekistan,UZB,Saudi Arabia,SAU,0,0,0,5,5
2010,Dem. Rep. of the Congo,COD,Senegal,SEN,0,0,5,0,5
2010,Gambia,GMB,Senegal,SEN,0,0,5,0,5
2010,Guinea,GIN,Senegal,SEN,0,0,48,0,48
2010,Cote d'Ivoire,CIV,Senegal,SEN,0,0,5,0,5
2010,Mauritania,MRT,Senegal,SEN,0,0,5,0,5
2010,Nigeria,NGA,Senegal,SEN,0,0,5,0,5
2010,Sierra Leone,SLE,Senegal,SEN,0,0,5,707,712
2010,Dem. Rep. of the Congo,COD,Somalia,SOM,0,0,0,13,13
2010,Eritrea,ERI,Somalia,SOM,5,0,0,0,5
2010,Ethiopia,ETH,Somalia,SOM,158,0,206,405,769
2010,United Rep. of Tanzania,TZA,Somalia,SOM,0,0,5,0,5
2010,Dem. Rep. of the Congo,COD,Sudan,SDN,0,0,5,0,5
2010,Eritrea,ERI,Sudan,SDN,42,0,0,0,42
2010,Ethiopia,ETH,Sudan,SDN,81,0,15,0,96
2010,Somalia,SOM,Sudan,SDN,0,0,0,13,13
2010,Afghanistan,AFG,Syrian Arab Rep.,SYR,463,0,5,246,714
2010,Algeria,DZA,Syrian Arab Rep.,SYR,0,0,0,17,17
2010,Egypt,EGY,Syrian Arab Rep.,SYR,0,0,0,34,34
2010,Burundi,BDI,Syrian Arab Rep.,SYR,5,0,0,0,5
2010,Chad,TCD,Syrian Arab Rep.,SYR,0,0,0,5,5
2010,Dem. Rep. of the Congo,COD,Syrian Arab Rep.,SYR,0,0,0,5,5
2010,Eritrea,ERI,Syrian Arab Rep.,SYR,18,0,0,13,31
2010,Ethiopia,ETH,Syrian Arab Rep.,SYR,0,0,10,10,20
2010,Palestinian,PSE,Syrian Arab Rep.,SYR,5,0,0,315,320
2010,Cote d'Ivoire,CIV,Syrian Arab Rep.,SYR,0,0,0,5,5
2010,India,IND,Syrian Arab Rep.,SYR,0,0,0,5,5
2010,Iran (Islamic Rep. of),IRN,Syrian Arab Rep.,SYR,22,0,17,90,129
2010,Iraq,IRQ,Syrian Arab Rep.,SYR,97,148,154,0,399
2010,Jordan,JOR,Syrian Arab Rep.,SYR,5,0,5,57,67
2010,Libya,LBY,Syrian Arab Rep.,SYR,0,0,0,5,5
2010,Lebanon,LBN,Syrian Arab Rep.,SYR,0,0,0,66,66
2010,Morocco,MAR,Syrian Arab Rep.,SYR,0,0,0,13,13
2010,Nigeria,NGA,Syrian Arab Rep.,SYR,0,0,0,5,5
2010,Pakistan,PAK,Syrian Arab Rep.,SYR,0,0,0,12,12
2010,Russian Federation,RUS,Syrian Arab Rep.,SYR,0,0,0,5,5
2010,Saudi Arabia,SAU,Syrian Arab Rep.,SYR,0,0,0,10,10
2010,Somalia,SOM,Syrian Arab Rep.,SYR,390,0,16,735,1141
2010,Sudan,SDN,Syrian Arab Rep.,SYR,76,5,83,292,456
2010,Tajikistan,TJK,Syrian Arab Rep.,SYR,0,0,0,5,5
2010,Turkey,TUR,Syrian Arab Rep.,SYR,0,0,0,5,5
2010,Yemen,YEM,Syrian Arab Rep.,SYR,23,0,17,30,70
2010,Stateless,XXA,Syrian Arab Rep.,SYR,17,0,0,35,52
2010,Afghanistan,AFG,Thailand,THA,0,0,0,5,5
2010,Algeria,DZA,Thailand,THA,0,0,5,0,5
2010,Cambodia,KHM,Thailand,THA,5,0,5,25,35
2010,China,CHN,Thailand,THA,10,0,5,22,37
2010,Cameroon,CMR,Thailand,THA,0,0,0,5,5
2010,Dem. Rep. of the Congo,COD,Thailand,THA,0,0,19,19,38
2010,Ethiopia,ETH,Thailand,THA,0,0,0,5,5
2010,Palestinian,PSE,Thailand,THA,0,0,0,5,5
2010,Guinea,GIN,Thailand,THA,0,0,16,11,27
2010,Cote d'Ivoire,CIV,Thailand,THA,5,0,0,5,10
2010,Iran (Islamic Rep. of),IRN,Thailand,THA,5,0,5,27,37
2010,Iraq,IRQ,Thailand,THA,14,0,0,10,24
2010,Kuwait,KWT,Thailand,THA,0,0,5,5,10
2010,Lao People's Dem. Rep.,LAO,Thailand,THA,116,0,0,5,121
2010,Liberia,LBR,Thailand,THA,0,0,0,5,5
2010,Sri Lanka,LKA,Thailand,THA,58,0,134,384,576
2010,Nepal,NPL,Thailand,THA,0,0,0,11,11
2010,Nigeria,NGA,Thailand,THA,0,0,5,0,5
2010,Pakistan,PAK,Thailand,THA,34,0,42,126,202
2010,Sierra Leone,SLE,Thailand,THA,0,0,5,13,18
2010,Somalia,SOM,Thailand,THA,17,0,0,0,17
2010,Viet Nam,VNM,Thailand,THA,5,0,27,81,113
2010,Sudan,SDN,Thailand,THA,0,0,0,5,5
2010,Afghanistan,AFG,Tajikistan,TJK,32,0,0,0,32
2010,Bangladesh,BGD,Trinidad and Tobago,TTO,0,0,0,5,5
2010,Ghana,GHA,Trinidad and Tobago,TTO,0,0,0,63,63
2010,Haiti,HTI,Trinidad and Tobago,TTO,0,5,0,0,5
2010,Liberia,LBR,Trinidad and Tobago,TTO,0,0,0,10,10
2010,Nigeria,NGA,Trinidad and Tobago,TTO,0,0,0,10,10
2010,Sudan,SDN,Trinidad and Tobago,TTO,0,0,0,5,5
2010,Zimbabwe,ZWE,Trinidad and Tobago,TTO,0,0,0,5,5
2010,Afghanistan,AFG,Turkey,TUR,528,0,374,438,1340
2010,Egypt,EGY,Turkey,TUR,5,0,5,0,10
2010,Bangladesh,BGD,Turkey,TUR,0,0,0,18,18
2010,Chad,TCD,Turkey,TUR,0,0,0,5,5
2010,China,CHN,Turkey,TUR,0,0,0,14,14
2010,Cameroon,CMR,Turkey,TUR,0,0,0,19,19
2010,Dem. Rep. of the Congo,COD,Turkey,TUR,5,0,5,36,46
2010,Eritrea,ERI,Turkey,TUR,24,0,5,28,57
2010,Ethiopia,ETH,Turkey,TUR,10,0,12,16,38
2010,Gabon,GAB,Turkey,TUR,0,0,0,5,5
2010,Palestinian,PSE,Turkey,TUR,34,0,10,31,75
2010,Guinea,GIN,Turkey,TUR,0,0,13,11,24
2010,Cote d'Ivoire,CIV,Turkey,TUR,0,0,0,12,12
2010,India,IND,Turkey,TUR,0,0,0,5,5
2010,Indonesia,IDN,Turkey,TUR,0,0,0,5,5
2010,Iran (Islamic Rep. of),IRN,Turkey,TUR,1880,0,979,340,3199
2010,Iraq,IRQ,Turkey,TUR,3323,0,175,248,3746
2010,Jordan,JOR,Turkey,TUR,5,0,0,5,10
2010,Kyrgyzstan,KGZ,Turkey,TUR,0,0,0,10,10
2010,Sri Lanka,LKA,Turkey,TUR,10,0,5,13,28
2010,Mauritania,MRT,Turkey,TUR,0,0,0,16,16
2010,Morocco,MAR,Turkey,TUR,0,0,5,0,5
2010,Myanmar,MMR,Turkey,TUR,0,0,5,58,63
2010,Nigeria,NGA,Turkey,TUR,0,0,0,13,13
2010,Pakistan,PAK,Turkey,TUR,0,0,5,19,24
2010,Russian Federation,RUS,Turkey,TUR,5,0,0,0,5
2010,Saudi Arabia,SAU,Turkey,TUR,0,0,0,5,5
2010,Senegal,SEN,Turkey,TUR,0,0,0,5,5
2010,Sierra Leone,SLE,Turkey,TUR,0,0,5,5,10
2010,Somalia,SOM,Turkey,TUR,282,0,32,93,407
2010,Sudan,SDN,Turkey,TUR,43,0,20,24,87
2010,Syrian Arab Rep.,SYR,Turkey,TUR,5,0,27,5,37
2010,Tajikistan,TJK,Turkey,TUR,0,0,0,14,14
2010,Turkmenistan,TKM,Turkey,TUR,0,0,0,5,5
2010,Uzbekistan,UZB,Turkey,TUR,11,0,0,11,22
2010,Stateless,XXA,Turkey,TUR,0,0,0,5,5
2010,Afghanistan,AFG,Ukraine,UKR,29,0,5,0,34
2010,Dem. Rep. of the Congo,COD,Ukraine,UKR,5,0,0,0,5
2010,Iran (Islamic Rep. of),IRN,Ukraine,UKR,5,0,0,0,5
2010,Iraq,IRQ,Ukraine,UKR,5,0,0,0,5
2010,Kazakhstan,KAZ,Ukraine,UKR,5,0,0,0,5
2010,Russian Federation,RUS,Ukraine,UKR,29,0,0,0,29
2010,Somalia,SOM,Ukraine,UKR,11,0,0,0,11
2010,Uzbekistan,UZB,Ukraine,UKR,13,0,5,0,18
2010,Jamaica,JAM,Curacao ,CUW,5,0,0,0,5
2011,Chad,TCD,Algeria,DZA,0,0,5,5,10
2011,Cameroon,CMR,Algeria,DZA,0,0,83,105,188
2011,Dem. Rep. of the Congo,COD,Algeria,DZA,0,0,10,11,21
2011,Palestinian,PSE,Algeria,DZA,13,0,0,0,13
2011,Guinea,GIN,Algeria,DZA,0,0,5,13,18
2011,Cote d'Ivoire,CIV,Algeria,DZA,0,0,0,36,36
2011,Jordan,JOR,Algeria,DZA,0,0,0,16,16
2011,Liberia,LBR,Algeria,DZA,0,0,5,17,22
2011,Niger,NER,Algeria,DZA,0,0,11,0,11
2011,Nigeria,NGA,Algeria,DZA,0,0,30,55,85
2011,Sierra Leone,SLE,Algeria,DZA,0,0,0,5,5
2011,Somalia,SOM,Algeria,DZA,0,0,0,5,5
2011,Sudan,SDN,Algeria,DZA,0,0,5,16,21
2011,China,CHN,Egypt,EGY,5,0,0,0,5
2011,Cameroon,CMR,Egypt,EGY,0,0,0,5,5
2011,Congo,COG,Egypt,EGY,0,0,5,0,5
2011,Dem. Rep. of the Congo,COD,Egypt,EGY,0,0,5,0,5
2011,Eritrea,ERI,Egypt,EGY,161,0,23,30,214
2011,Ethiopia,ETH,Egypt,EGY,64,0,108,46,218
2011,Palestinian,PSE,Egypt,EGY,10,0,0,0,10
2011,Guinea,GIN,Egypt,EGY,5,0,0,0,5
2011,Cote d'Ivoire,CIV,Egypt,EGY,14,0,0,5,19
2011,Iraq,IRQ,Egypt,EGY,26,0,10,192,228
2011,Kazakhstan,KAZ,Egypt,EGY,0,0,5,0,5
2011,Libya,LBY,Egypt,EGY,5,0,0,0,5
2011,Mali,MLI,Egypt,EGY,0,0,0,5,5
2011,Nigeria,NGA,Egypt,EGY,0,0,5,0,5
2011,Russian Federation,RUS,Egypt,EGY,0,0,5,0,5
2011,Somalia,SOM,Egypt,EGY,164,0,94,28,286
2011,Sudan,SDN,Egypt,EGY,265,0,259,384,908
2011,Syrian Arab Rep.,SYR,Egypt,EGY,0,0,0,10,10
2011,Tajikistan,TJK,Egypt,EGY,12,0,0,0,12
2011,Uzbekistan,UZB,Egypt,EGY,0,0,13,0,13
2011,Afghanistan,AFG,Azerbaijan,AZE,11,5,0,0,16
2011,Armenia,ARM,Azerbaijan,AZE,10,0,0,0,10
2011,Iran (Islamic Rep. of),IRN,Azerbaijan,AZE,0,0,5,0,5
2011,Iraq,IRQ,Azerbaijan,AZE,5,0,0,0,5
2011,Pakistan,PAK,Azerbaijan,AZE,0,0,13,0,13
2011,Russian Federation,RUS,Azerbaijan,AZE,5,0,0,5,10
2011,Iraq,IRQ,Bahrain,BHR,0,47,0,0,47
2011,Myanmar,MMR,Bangladesh,BGD,0,0,5,0,5
2011,Central African Rep.,CAF,Dem. Rep. of the Congo,COD,0,0,0,10,10
2011,Mozambique,MOZ,Dem. Rep. of the Congo,COD,0,0,0,5,5
2011,Eritrea,ERI,Djibouti,DJI,50,0,0,54,104
2011,Ethiopia,ETH,Djibouti,DJI,0,5,0,86,91
2011,Iraq,IRQ,Djibouti,DJI,0,0,0,5,5
2011,Yemen,YEM,Djibouti,DJI,0,0,0,10,10
2011,Somalia,SOM,Eritrea,ERI,0,0,0,135,135
2011,Iran (Islamic Rep. of),IRN,Grenada,GRD,5,0,0,0,5
2011,Afghanistan,AFG,"China, Hong Kong SAR",HKG,0,0,5,0,5
2011,Egypt,EGY,"China, Hong Kong SAR",HKG,0,0,0,12,12
2011,Benin,BEN,"China, Hong Kong SAR",HKG,0,0,5,0,5
2011,Bangladesh,BGD,"China, Hong Kong SAR",HKG,0,0,13,0,13
2011,Dem. Rep. of the Congo,COD,"China, Hong Kong SAR",HKG,0,0,5,0,5
2011,Colombia,COL,"China, Hong Kong SAR",HKG,0,0,0,5,5
2011,Guinea,GIN,"China, Hong Kong SAR",HKG,0,0,0,5,5
2011,India,IND,"China, Hong Kong SAR",HKG,0,0,35,39,74
2011,Indonesia,IDN,"China, Hong Kong SAR",HKG,0,0,63,142,205
2011,Kenya,KEN,"China, Hong Kong SAR",HKG,0,0,5,0,5
2011,Sri Lanka,LKA,"China, Hong Kong SAR",HKG,10,0,44,5,59
2011,Mongolia,MNG,"China, Hong Kong SAR",HKG,0,0,0,5,5
2011,Myanmar,MMR,"China, Hong Kong SAR",HKG,0,0,5,0,5
2011,Nepal,NPL,"China, Hong Kong SAR",HKG,0,0,15,18,33
2011,Pakistan,PAK,"China, Hong Kong SAR",HKG,5,0,42,34,81
2011,Philippines,PHL,"China, Hong Kong SAR",HKG,0,0,58,46,104
2011,South Africa,ZAF,"China, Hong Kong SAR",HKG,0,0,0,5,5
2011,Somalia,SOM,"China, Hong Kong SAR",HKG,16,0,5,0,21
2011,Togo,TGO,"China, Hong Kong SAR",HKG,0,0,5,0,5
2011,Uganda,UGA,"China, Hong Kong SAR",HKG,0,0,0,5,5
2011,Bangladesh,BGD,Honduras,HND,0,0,0,5,5
2011,Colombia,COL,Honduras,HND,5,0,0,0,5
2011,Afghanistan,AFG,India,IND,438,0,418,0,856
2011,Dem. Rep. of the Congo,COD,India,IND,0,0,13,0,13
2011,Eritrea,ERI,India,IND,14,0,0,0,14
2011,Ethiopia,ETH,India,IND,0,0,5,0,5
2011,Palestinian,PSE,India,IND,5,0,0,0,5
2011,Iran (Islamic Rep. of),IRN,India,IND,26,0,5,0,31
2011,Iraq,IRQ,India,IND,26,0,0,0,26
2011,Myanmar,MMR,India,IND,2471,0,59,512,3042
2011,Pakistan,PAK,India,IND,65,0,0,0,65
2011,Rwanda,RWA,India,IND,5,0,0,0,5
2011,Somalia,SOM,India,IND,128,0,0,33,161
2011,Sudan,SDN,India,IND,5,0,5,0,10
2011,Uzbekistan,UZB,India,IND,5,0,0,0,5
2011,Afghanistan,AFG,Iran (Islamic Rep. of),IRN,105,0,175,1055,1335
2011,Iraq,IRQ,Iran (Islamic Rep. of),IRN,0,0,5,90,95
2011,Pakistan,PAK,Iran (Islamic Rep. of),IRN,0,0,0,19,19
2011,Iran (Islamic Rep. of),IRN,Iraq,IRQ,25,0,0,11,36
2011,Egypt,EGY,Israel,ISR,5,0,0,0,5
2011,Chad,TCD,Israel,ISR,5,0,0,0,5
2011,Dem. Rep. of the Congo,COD,Israel,ISR,0,0,5,0,5
2011,Colombia,COL,Israel,ISR,5,0,0,0,5
2011,Eritrea,ERI,Israel,ISR,46,0,10,0,56
2011,Ethiopia,ETH,Israel,ISR,10,0,13,0,23
2011,Ghana,GHA,Israel,ISR,0,0,5,0,5
2011,Guinea,GIN,Israel,ISR,5,0,0,0,5
2011,Cote d'Ivoire,CIV,Israel,ISR,5,14,5,0,24
2011,Nigeria,NGA,Israel,ISR,0,0,10,0,10
2011,Somalia,SOM,Israel,ISR,5,0,0,0,5
2011,Sudan,SDN,Israel,ISR,20,0,11,0,31
2011,Afghanistan,AFG,Kazakhstan,KAZ,5,0,10,17,32
2011,China,CHN,Kazakhstan,KAZ,0,0,0,40,40
2011,Palestinian,PSE,Kazakhstan,KAZ,5,0,0,0,5
2011,Kyrgyzstan,KGZ,Kazakhstan,KAZ,0,0,0,12,12
2011,Uzbekistan,UZB,Kazakhstan,KAZ,5,0,5,215,225
2011,Eritrea,ERI,Kenya,KEN,5,0,0,0,5
2011,Ethiopia,ETH,Kenya,KEN,2906,0,10,570,3486
2011,Somalia,SOM,Kenya,KEN,275,0,0,140,415
2011,Sudan,SDN,Kenya,KEN,0,0,0,13,13
2011,Afghanistan,AFG,Kuwait,KWT,0,0,0,1794,1794
2011,Eritrea,ERI,Kuwait,KWT,0,0,0,5,5
2011,Palestinian,PSE,Kuwait,KWT,0,0,0,124,124
2011,Iran (Islamic Rep. of),IRN,Kuwait,KWT,0,0,0,22,22
2011,Iraq,IRQ,Kuwait,KWT,0,0,0,166,166
2011,Nepal,NPL,Kuwait,KWT,0,0,0,5,5
2011,Somalia,SOM,Kuwait,KWT,0,0,0,42,42
2011,Syrian Arab Rep.,SYR,Kuwait,KWT,12,0,0,0,12
2011,Stateless,XXA,Kuwait,KWT,5,0,0,228,233
2011,Eritrea,ERI,Libya,LBY,0,0,0,285,285
2011,Ethiopia,ETH,Libya,LBY,0,0,0,39,39
2011,Iraq,IRQ,Libya,LBY,0,0,0,15,15
2011,Somalia,SOM,Libya,LBY,0,0,0,45,45
2011,Sudan,SDN,Libya,LBY,0,0,0,5,5
2011,Sri Lanka,LKA,Saint Lucia,LCA,5,0,0,0,5
2011,Egypt,EGY,Lebanon,LBN,0,0,0,14,14
2011,Chad,TCD,Lebanon,LBN,0,0,0,5,5
2011,Dem. Rep. of the Congo,COD,Lebanon,LBN,0,0,0,5,5
2011,Ethiopia,ETH,Lebanon,LBN,0,0,5,12,17
2011,Palestinian,PSE,Lebanon,LBN,0,0,0,10,10
2011,Iran (Islamic Rep. of),IRN,Lebanon,LBN,0,0,0,12,12
2011,Iraq,IRQ,Lebanon,LBN,420,0,98,135,653
2011,Jordan,JOR,Lebanon,LBN,0,0,0,5,5
2011,Philippines,PHL,Lebanon,LBN,0,0,0,5,5
2011,Somalia,SOM,Lebanon,LBN,10,0,0,0,10
2011,Sudan,SDN,Lebanon,LBN,40,0,79,178,297
2011,Syrian Arab Rep.,SYR,Lebanon,LBN,60,0,44,51,155
2011,Stateless,XXA,Lebanon,LBN,0,0,0,11,11
2011,Afghanistan,AFG,Malaysia,MYS,5,0,0,30,35
2011,Bangladesh,BGD,Malaysia,MYS,0,0,0,5,5
2011,Cambodia,KHM,Malaysia,MYS,5,0,0,5,10
2011,China,CHN,Malaysia,MYS,11,0,10,16,37
2011,Congo,COG,Malaysia,MYS,0,0,0,5,5
2011,Palestinian,PSE,Malaysia,MYS,53,0,0,22,75
2011,Guinea,GIN,Malaysia,MYS,0,0,0,5,5
2011,Cote d'Ivoire,CIV,Malaysia,MYS,0,0,0,5,5
2011,Indonesia,IDN,Malaysia,MYS,27,0,5,41,73
2011,Iran (Islamic Rep. of),IRN,Malaysia,MYS,38,0,13,41,92
2011,Iraq,IRQ,Malaysia,MYS,127,0,0,33,160
2011,Sri Lanka,LKA,Malaysia,MYS,100,0,322,131,553
2011,Myanmar,MMR,Malaysia,MYS,10855,0,974,3548,15377
2011,Nigeria,NGA,Malaysia,MYS,0,0,5,0,5
2011,Pakistan,PAK,Malaysia,MYS,13,0,0,0,13
2011,Somalia,SOM,Malaysia,MYS,132,0,5,61,198
2011,Sudan,SDN,Malaysia,MYS,10,0,0,11,21
2011,Syrian Arab Rep.,SYR,Malaysia,MYS,0,0,0,11,11
2011,Yemen,YEM,Malaysia,MYS,10,0,0,0,10
2011,Benin,BEN,Morocco,MAR,0,0,10,0,10
2011,Bangladesh,BGD,Morocco,MAR,0,0,0,5,5
2011,Burkina Faso,BFA,Morocco,MAR,0,0,5,0,5
2011,Central African Rep.,CAF,Morocco,MAR,0,0,5,0,5
2011,Chad,TCD,Morocco,MAR,0,0,0,5,5
2011,Cameroon,CMR,Morocco,MAR,0,0,19,5,24
2011,Congo,COG,Morocco,MAR,0,0,5,5,10
2011,Dem. Rep. of the Congo,COD,Morocco,MAR,10,0,143,33,186
2011,Eritrea,ERI,Morocco,MAR,0,0,5,5,10
2011,Palestinian,PSE,Morocco,MAR,5,0,0,5,10
2011,Ghana,GHA,Morocco,MAR,0,0,13,0,13
2011,Guinea,GIN,Morocco,MAR,0,0,33,15,48
2011,Cote d'Ivoire,CIV,Morocco,MAR,10,0,10,25,45
2011,Iraq,IRQ,Morocco,MAR,5,0,0,0,5
2011,Kenya,KEN,Morocco,MAR,0,0,0,5,5
2011,Liberia,LBR,Morocco,MAR,0,0,20,10,30
2011,Libya,LBY,Morocco,MAR,0,0,0,13,13
2011,Mali,MLI,Morocco,MAR,0,0,5,0,5
2011,Niger,NER,Morocco,MAR,0,0,13,0,13
2011,Nigeria,NGA,Morocco,MAR,0,0,99,14,113
2011,Rwanda,RWA,Morocco,MAR,0,0,5,0,5
2011,Sierra Leone,SLE,Morocco,MAR,0,0,10,0,10
2011,Somalia,SOM,Morocco,MAR,11,0,0,10,21
2011,Sudan,SDN,Morocco,MAR,0,0,5,0,5
2011,Togo,TGO,Morocco,MAR,0,0,10,0,10
2011,Zimbabwe,ZWE,Morocco,MAR,0,0,5,0,5
2011,Sri Lanka,LKA,Nepal,NPL,17,0,0,0,17
2011,Pakistan,PAK,Nepal,NPL,5,0,0,16,21
2011,Somalia,SOM,Nepal,NPL,5,0,0,0,5
2011,Iraq,IRQ,Oman,OMN,5,0,0,0,5
2011,Iraq,IRQ,Qatar,QAT,26,0,0,0,26
2011,Somalia,SOM,Qatar,QAT,0,5,0,0,5
2011,Egypt,EGY,Saudi Arabia,SAU,0,0,5,0,5
2011,Iraq,IRQ,Saudi Arabia,SAU,17,0,0,0,17
2011,Somalia,SOM,Saudi Arabia,SAU,0,0,0,5,5
2011,Ethiopia,ETH,Somalia,SOM,126,0,0,17991,18117
2011,Chad,TCD,Sudan,SDN,10,0,0,0,10
2011,Eritrea,ERI,Sudan,SDN,54,0,0,0,54
2011,Ethiopia,ETH,Sudan,SDN,27,0,5,43,75
2011,Iraq,IRQ,Sudan,SDN,10,0,0,0,10
2011,Burundi,BDI,South Sudan,SSD,0,0,5,0,5
2011,Dem. Rep. of the Congo,COD,South Sudan,SSD,0,0,5,0,5
2011,Eritrea,ERI,South Sudan,SSD,0,0,5,0,5
2011,Ethiopia,ETH,South Sudan,SSD,5,0,112,5,122
2011,Somalia,SOM,South Sudan,SSD,0,0,5,0,5
2011,Sudan,SDN,South Sudan,SSD,5,0,5,0,10
2011,Uganda,UGA,South Sudan,SSD,0,0,5,0,5
2011,Afghanistan,AFG,Syrian Arab Rep.,SYR,359,0,80,168,607
2011,Algeria,DZA,Syrian Arab Rep.,SYR,10,0,17,5,32
2011,Egypt,EGY,Syrian Arab Rep.,SYR,14,0,5,16,35
2011,Burkina Faso,BFA,Syrian Arab Rep.,SYR,0,0,0,5,5
2011,Chad,TCD,Syrian Arab Rep.,SYR,0,0,0,11,11
2011,Congo,COG,Syrian Arab Rep.,SYR,0,0,5,0,5
2011,Colombia,COL,Syrian Arab Rep.,SYR,0,0,0,5,5
2011,Eritrea,ERI,Syrian Arab Rep.,SYR,11,0,5,5,21
2011,Ethiopia,ETH,Syrian Arab Rep.,SYR,5,0,13,34,52
2011,Palestinian,PSE,Syrian Arab Rep.,SYR,0,0,0,62,62
2011,Cote d'Ivoire,CIV,Syrian Arab Rep.,SYR,0,0,5,0,5
2011,Iran (Islamic Rep. of),IRN,Syrian Arab Rep.,SYR,14,0,14,96,124
2011,Iraq,IRQ,Syrian Arab Rep.,SYR,137,0,293,801,1231
2011,Jordan,JOR,Syrian Arab Rep.,SYR,0,0,5,31,36
2011,Kuwait,KWT,Syrian Arab Rep.,SYR,5,0,0,0,5
2011,Libya,LBY,Syrian Arab Rep.,SYR,0,0,0,10,10
2011,Lebanon,LBN,Syrian Arab Rep.,SYR,0,0,0,5,5
2011,Morocco,MAR,Syrian Arab Rep.,SYR,0,0,5,0,5
2011,Pakistan,PAK,Syrian Arab Rep.,SYR,15,0,21,10,46
2011,Russian Federation,RUS,Syrian Arab Rep.,SYR,0,0,0,5,5
2011,Somalia,SOM,Syrian Arab Rep.,SYR,406,0,0,267,673
2011,Sudan,SDN,Syrian Arab Rep.,SYR,48,0,87,254,389
2011,Tunisia,TUN,Syrian Arab Rep.,SYR,0,0,0,17,17
2011,Uzbekistan,UZB,Syrian Arab Rep.,SYR,0,0,0,10,10
2011,Yemen,YEM,Syrian Arab Rep.,SYR,5,0,5,54,64
2011,Stateless,XXA,Syrian Arab Rep.,SYR,0,0,0,19,19
2011,Egypt,EGY,Thailand,THA,5,0,0,0,5
2011,Bangladesh,BGD,Thailand,THA,5,0,5,0,10
2011,Cambodia,KHM,Thailand,THA,21,0,0,0,21
2011,China,CHN,Thailand,THA,25,0,5,15,45
2011,Cameroon,CMR,Thailand,THA,0,0,0,5,5
2011,Dem. Rep. of the Congo,COD,Thailand,THA,0,0,31,25,56
2011,Djibouti,DJI,Thailand,THA,0,0,0,5,5
2011,Palestinian,PSE,Thailand,THA,5,0,0,0,5
2011,Guinea,GIN,Thailand,THA,0,0,5,16,21
2011,Cote d'Ivoire,CIV,Thailand,THA,0,0,0,5,5
2011,India,IND,Thailand,THA,0,0,0,5,5
2011,Iran (Islamic Rep. of),IRN,Thailand,THA,0,0,5,20,25
2011,Iraq,IRQ,Thailand,THA,11,0,5,10,26
2011,Lao People's Dem. Rep.,LAO,Thailand,THA,5,0,0,0,5
2011,Liberia,LBR,Thailand,THA,0,0,10,10,20
2011,Sri Lanka,LKA,Thailand,THA,39,0,100,230,369
2011,Nepal,NPL,Thailand,THA,5,0,0,0,5
2011,Nigeria,NGA,Thailand,THA,0,0,0,5,5
2011,Pakistan,PAK,Thailand,THA,282,0,21,90,393
2011,Somalia,SOM,Thailand,THA,37,0,5,10,52
2011,Viet Nam,VNM,Thailand,THA,67,0,12,5,84
2011,Sudan,SDN,Thailand,THA,0,0,0,5,5
2011,Uganda,UGA,Thailand,THA,0,0,5,5,10
2011,Afghanistan,AFG,Tajikistan,TJK,26,0,0,0,26
2011,Bangladesh,BGD,Trinidad and Tobago,TTO,5,0,0,0,5
2011,Cameroon,CMR,Trinidad and Tobago,TTO,0,0,0,5,5
2011,Cuba,CUB,Trinidad and Tobago,TTO,5,0,0,0,5
2011,Ethiopia,ETH,Trinidad and Tobago,TTO,0,0,0,5,5
2011,Ghana,GHA,Trinidad and Tobago,TTO,0,0,0,5,5
2011,Guinea,GIN,Trinidad and Tobago,TTO,0,0,0,5,5
2011,Cote d'Ivoire,CIV,Trinidad and Tobago,TTO,0,0,5,0,5
2011,Liberia,LBR,Trinidad and Tobago,TTO,0,0,5,5,10
2011,Nigeria,NGA,Trinidad and Tobago,TTO,0,0,0,21,21
2011,Senegal,SEN,Trinidad and Tobago,TTO,0,0,0,11,11
2011,Sierra Leone,SLE,Trinidad and Tobago,TTO,0,0,0,10,10
2011,Togo,TGO,Trinidad and Tobago,TTO,0,0,0,5,5
2011,Zimbabwe,ZWE,Trinidad and Tobago,TTO,0,0,0,5,5
2011,Afghanistan,AFG,Turkey,TUR,870,0,76,595,1541
2011,Algeria,DZA,Turkey,TUR,0,0,0,5,5
2011,Egypt,EGY,Turkey,TUR,5,0,0,0,5
2011,Bangladesh,BGD,Turkey,TUR,0,0,0,14,14
2011,China,CHN,Turkey,TUR,0,0,5,15,20
2011,Cameroon,CMR,Turkey,TUR,5,0,0,38,43
2011,Congo,COG,Turkey,TUR,0,0,0,5,5
2011,Dem. Rep. of the Congo,COD,Turkey,TUR,23,0,0,60,83
2011,Eritrea,ERI,Turkey,TUR,14,0,10,20,44
2011,Ethiopia,ETH,Turkey,TUR,26,0,5,5,36
2011,Palestinian,PSE,Turkey,TUR,36,0,5,53,94
2011,Guinea,GIN,Turkey,TUR,5,0,0,26,31
2011,Cote d'Ivoire,CIV,Turkey,TUR,5,0,0,22,27
2011,India,IND,Turkey,TUR,0,0,0,5,5
2011,Iran (Islamic Rep. of),IRN,Turkey,TUR,2268,0,127,397,2792
2011,Iraq,IRQ,Turkey,TUR,4484,0,25,261,4770
2011,Jordan,JOR,Turkey,TUR,5,0,0,0,5
2011,Kazakhstan,KAZ,Turkey,TUR,0,0,0,5,5
2011,Kyrgyzstan,KGZ,Turkey,TUR,0,0,0,109,109
2011,Liberia,LBR,Turkey,TUR,0,0,0,5,5
2011,Libya,LBY,Turkey,TUR,0,0,0,5,5
2011,Lebanon,LBN,Turkey,TUR,0,0,0,5,5
2011,Mauritania,MRT,Turkey,TUR,5,0,0,0,5
2011,Morocco,MAR,Turkey,TUR,5,0,0,17,22
2011,Myanmar,MMR,Turkey,TUR,0,0,0,12,12
2011,Nepal,NPL,Turkey,TUR,0,0,0,10,10
2011,Nigeria,NGA,Turkey,TUR,0,0,0,13,13
2011,Pakistan,PAK,Turkey,TUR,14,0,10,32,56
2011,Philippines,PHL,Turkey,TUR,0,0,0,5,5
2011,Rwanda,RWA,Turkey,TUR,0,0,0,12,12
2011,Senegal,SEN,Turkey,TUR,0,0,0,5,5
2011,Sierra Leone,SLE,Turkey,TUR,0,0,5,5,10
2011,Somalia,SOM,Turkey,TUR,255,0,17,148,420
2011,Sudan,SDN,Turkey,TUR,32,0,10,18,60
2011,Syrian Arab Rep.,SYR,Turkey,TUR,13,0,5,30,48
2011,United Rep. of Tanzania,TZA,Turkey,TUR,0,0,0,5,5
2011,Tajikistan,TJK,Turkey,TUR,0,0,0,20,20
2011,Turkmenistan,TKM,Turkey,TUR,0,0,0,5,5
2011,Tunisia,TUN,Turkey,TUR,0,0,0,12,12
2011,Uganda,UGA,Turkey,TUR,5,0,0,0,5
2011,Uzbekistan,UZB,Turkey,TUR,5,0,0,46,51
2011,Yemen,YEM,Turkey,TUR,5,0,0,5,10
2011,Stateless,XXA,Turkey,TUR,14,0,0,0,14
2011,Afghanistan,AFG,Ukraine,UKR,25,0,5,5,35
2011,Dem. Rep. of the Congo,COD,Ukraine,UKR,5,0,12,0,17
2011,Ethiopia,ETH,Ukraine,UKR,0,0,0,5,5
2011,Palestinian,PSE,Ukraine,UKR,5,0,0,0,5
2011,Guinea,GIN,Ukraine,UKR,0,0,5,5,10
2011,Iran (Islamic Rep. of),IRN,Ukraine,UKR,5,0,0,11,16
2011,Iraq,IRQ,Ukraine,UKR,5,0,0,5,10
2011,Kyrgyzstan,KGZ,Ukraine,UKR,5,0,0,0,5
2011,Russian Federation,RUS,Ukraine,UKR,5,0,0,11,16
2011,Somalia,SOM,Ukraine,UKR,5,0,0,15,20
2011,Syrian Arab Rep.,SYR,Ukraine,UKR,0,0,10,0,10
2011,Togo,TGO,Ukraine,UKR,0,0,5,0,5
2011,Uzbekistan,UZB,Ukraine,UKR,46,0,0,0,46
2011,Sri Lanka,LKA,Montserrat,MSR,0,0,0,10,10
2011,Colombia,COL,Curacao ,CUW,0,0,0,5,5
2012,Afghanistan,AFG,Algeria,DZA,0,0,0,5,5
2012,Benin,BEN,Algeria,DZA,0,0,11,0,11
2012,Central African Rep.,CAF,Algeria,DZA,5,0,0,0,5
2012,Chad,TCD,Algeria,DZA,0,0,13,10,23
2012,Cameroon,CMR,Algeria,DZA,0,0,108,137,245
2012,Congo,COG,Algeria,DZA,0,0,0,5,5
2012,Dem. Rep. of the Congo,COD,Algeria,DZA,5,0,5,13,23
2012,Palestinian,PSE,Algeria,DZA,5,0,0,0,5
2012,Guinea,GIN,Algeria,DZA,0,0,12,0,12
2012,Cote d'Ivoire,CIV,Algeria,DZA,5,0,5,70,80
2012,Liberia,LBR,Algeria,DZA,0,0,0,5,5
2012,Libya,LBY,Algeria,DZA,0,0,0,12,12
2012,Niger,NER,Algeria,DZA,0,0,5,5,10
2012,Nigeria,NGA,Algeria,DZA,0,0,15,57,72
2012,Sierra Leone,SLE,Algeria,DZA,0,0,0,5,5
2012,Sudan,SDN,Algeria,DZA,0,0,0,26,26
2012,Syrian Arab Rep.,SYR,Algeria,DZA,0,0,0,5,5
2012,Chad,TCD,Egypt,EGY,13,0,0,0,13
2012,Cameroon,CMR,Egypt,EGY,0,0,5,0,5
2012,Dem. Rep. of the Congo,COD,Egypt,EGY,11,0,5,0,16
2012,Eritrea,ERI,Egypt,EGY,320,0,10,0,330
2012,Ethiopia,ETH,Egypt,EGY,299,0,117,5,421
2012,Palestinian,PSE,Egypt,EGY,5,0,0,0,5
2012,Guinea,GIN,Egypt,EGY,0,0,5,0,5
2012,Cote d'Ivoire,CIV,Egypt,EGY,14,0,5,20,39
2012,Iraq,IRQ,Egypt,EGY,277,0,5,550,832
2012,Liberia,LBR,Egypt,EGY,0,0,5,0,5
2012,Libya,LBY,Egypt,EGY,0,0,5,0,5
2012,Nigeria,NGA,Egypt,EGY,0,0,12,0,12
2012,Pakistan,PAK,Egypt,EGY,0,0,5,0,5
2012,Somalia,SOM,Egypt,EGY,444,0,26,0,470
2012,Sudan,SDN,Egypt,EGY,1753,0,110,4168,6031
2012,South Sudan,SSD,Egypt,EGY,5,0,0,0,5
2012,Syrian Arab Rep.,SYR,Egypt,EGY,85,0,0,0,85
2012,Tunisia,TUN,Egypt,EGY,0,0,5,0,5
2012,Uganda,UGA,Egypt,EGY,5,0,0,0,5
2012,Yemen,YEM,Egypt,EGY,0,0,5,0,5
2012,Zimbabwe,ZWE,Egypt,EGY,5,0,0,0,5
2012,Afghanistan,AFG,Azerbaijan,AZE,10,11,5,10,36
2012,Iran (Islamic Rep. of),IRN,Azerbaijan,AZE,12,0,5,0,17
2012,Pakistan,PAK,Azerbaijan,AZE,5,0,14,0,19
2012,Russian Federation,RUS,Azerbaijan,AZE,5,0,5,13,23
2012,Iraq,IRQ,Bahrain,BHR,90,5,0,52,147
2012,Myanmar,MMR,Bangladesh,BGD,5,0,0,0,5
2012,Afghanistan,AFG,Belarus,BLR,0,0,0,10,10
2012,Russian Federation,RUS,Belarus,BLR,0,0,0,5,5
2012,Angola,AGO,Dem. Rep. of the Congo,COD,0,0,0,5,5
2012,Burundi,BDI,Dem. Rep. of the Congo,COD,15,0,29,42,86
2012,Central African Rep.,CAF,Dem. Rep. of the Congo,COD,5,0,0,0,5
2012,Cameroon,CMR,Dem. Rep. of the Congo,COD,5,0,0,0,5
2012,Congo,COG,Dem. Rep. of the Congo,COD,10,0,5,25,40
2012,Cote d'Ivoire,CIV,Dem. Rep. of the Congo,COD,0,0,0,5,5
2012,Rwanda,RWA,Dem. Rep. of the Congo,COD,21,0,5,0,26
2012,Somalia,SOM,Dem. Rep. of the Congo,COD,0,0,0,27,27
2012,Uganda,UGA,Dem. Rep. of the Congo,COD,5,0,0,0,5
2012,Afghanistan,AFG,"China, Hong Kong SAR",HKG,0,0,0,5,5
2012,Bangladesh,BGD,"China, Hong Kong SAR",HKG,0,0,10,10,20
2012,Colombia,COL,"China, Hong Kong SAR",HKG,0,0,0,5,5
2012,Ghana,GHA,"China, Hong Kong SAR",HKG,0,0,0,5,5
2012,India,IND,"China, Hong Kong SAR",HKG,0,0,36,30,66
2012,Indonesia,IDN,"China, Hong Kong SAR",HKG,0,0,172,144,316
2012,Sri Lanka,LKA,"China, Hong Kong SAR",HKG,0,0,17,12,29
2012,Nepal,NPL,"China, Hong Kong SAR",HKG,0,0,5,5,10
2012,Niger,NER,"China, Hong Kong SAR",HKG,0,0,5,0,5
2012,Nigeria,NGA,"China, Hong Kong SAR",HKG,0,0,5,0,5
2012,Pakistan,PAK,"China, Hong Kong SAR",HKG,5,0,36,51,92
2012,Peru,PER,"China, Hong Kong SAR",HKG,0,0,0,5,5
2012,Philippines,PHL,"China, Hong Kong SAR",HKG,0,0,47,42,89
2012,Somalia,SOM,"China, Hong Kong SAR",HKG,5,0,0,0,5
2012,Viet Nam,VNM,"China, Hong Kong SAR",HKG,0,0,0,5,5
2012,Thailand,THA,"China, Hong Kong SAR",HKG,0,0,0,5,5
2012,Togo,TGO,"China, Hong Kong SAR",HKG,0,0,5,5,10
2012,Uganda,UGA,"China, Hong Kong SAR",HKG,0,0,0,11,11
2012,Yemen,YEM,"China, Hong Kong SAR",HKG,0,0,0,10,10
2012,Afghanistan,AFG,India,IND,663,0,320,0,983
2012,Cameroon,CMR,India,IND,0,0,5,0,5
2012,Dem. Rep. of the Congo,COD,India,IND,11,0,15,0,26
2012,Eritrea,ERI,India,IND,5,0,0,0,5
2012,Ethiopia,ETH,India,IND,5,0,0,0,5
2012,Palestinian,PSE,India,IND,24,0,0,0,24
2012,Cote d'Ivoire,CIV,India,IND,0,0,0,5,5
2012,Iran (Islamic Rep. of),IRN,India,IND,25,0,0,0,25
2012,Iraq,IRQ,India,IND,10,0,5,0,15
2012,Myanmar,MMR,India,IND,1145,0,42,421,1608
2012,Somalia,SOM,India,IND,72,0,0,0,72
2012,Sudan,SDN,India,IND,13,0,0,0,13
2012,Syrian Arab Rep.,SYR,India,IND,11,0,0,0,11
2012,Yemen,YEM,India,IND,5,0,0,0,5
2012,Afghanistan,AFG,Iran (Islamic Rep. of),IRN,69,0,216,123,408
2012,Pakistan,PAK,Iran (Islamic Rep. of),IRN,0,0,0,12,12
2012,Uzbekistan,UZB,Iran (Islamic Rep. of),IRN,0,0,0,5,5
2012,Iran (Islamic Rep. of),IRN,Iraq,IRQ,15,0,0,0,15
2012,Syrian Arab Rep.,SYR,Iraq,IRQ,5,0,0,201,206
2012,Turkey,TUR,Iraq,IRQ,43,0,0,17,60
2012,Chad,TCD,Israel,ISR,0,0,0,5,5
2012,China,CHN,Israel,ISR,0,0,0,5,5
2012,Colombia,COL,Israel,ISR,0,0,0,22,22
2012,Eritrea,ERI,Israel,ISR,17,0,10,0,27
2012,Ethiopia,ETH,Israel,ISR,0,0,10,27,37
2012,Ghana,GHA,Israel,ISR,0,0,0,37,37
2012,Guinea,GIN,Israel,ISR,0,0,10,60,70
2012,Cote d'Ivoire,CIV,Israel,ISR,0,0,11,230,241
2012,Nepal,NPL,Israel,ISR,0,0,0,15,15
2012,Nigeria,NGA,Israel,ISR,0,0,5,59,64
2012,Sudan,SDN,Israel,ISR,5,0,0,0,5
2012,South Sudan,SSD,Israel,ISR,0,0,0,118,118
2012,Togo,TGO,Israel,ISR,0,0,0,5,5
2012,Afghanistan,AFG,Kazakhstan,KAZ,0,0,0,5,5
2012,Egypt,EGY,Kenya,KEN,5,0,0,0,5
2012,Burundi,BDI,Kenya,KEN,52,0,70,103,225
2012,Dem. Rep. of the Congo,COD,Kenya,KEN,827,0,279,868,1974
2012,Eritrea,ERI,Kenya,KEN,279,0,29,182,490
2012,Ethiopia,ETH,Kenya,KEN,2486,32,1611,3916,8045
2012,Cote d'Ivoire,CIV,Kenya,KEN,0,0,0,5,5
2012,Liberia,LBR,Kenya,KEN,0,0,5,0,5
2012,Sri Lanka,LKA,Kenya,KEN,5,0,0,5,10
2012,Rwanda,RWA,Kenya,KEN,41,0,91,244,376
2012,Somalia,SOM,Kenya,KEN,242,0,165,620,1027
2012,Sudan,SDN,Kenya,KEN,28,0,25,1301,1354
2012,South Sudan,SSD,Kenya,KEN,218,5,14,323,560
2012,United Rep. of Tanzania,TZA,Kenya,KEN,0,0,0,39,39
2012,Uganda,UGA,Kenya,KEN,18,0,23,62,103
2012,Chad,TCD,Libya,LBY,0,0,0,10,10
2012,Dem. Rep. of the Congo,COD,Libya,LBY,0,0,0,5,5
2012,Eritrea,ERI,Libya,LBY,0,0,0,207,207
2012,Ethiopia,ETH,Libya,LBY,0,0,0,18,18
2012,Palestinian,PSE,Libya,LBY,431,0,0,0,431
2012,Cote d'Ivoire,CIV,Libya,LBY,0,0,0,5,5
2012,Iraq,IRQ,Libya,LBY,0,0,0,10,10
2012,Somalia,SOM,Libya,LBY,0,0,0,77,77
2012,Sudan,SDN,Libya,LBY,0,0,0,33,33
2012,Syrian Arab Rep.,SYR,Libya,LBY,0,0,0,5,5
2012,Afghanistan,AFG,Lebanon,LBN,0,0,0,14,14
2012,Egypt,EGY,Lebanon,LBN,11,0,38,10,59
2012,Eritrea,ERI,Lebanon,LBN,5,0,0,0,5
2012,Ethiopia,ETH,Lebanon,LBN,0,0,10,0,10
2012,Iran (Islamic Rep. of),IRN,Lebanon,LBN,0,0,0,5,5
2012,Iraq,IRQ,Lebanon,LBN,319,16,90,311,736
2012,Jordan,JOR,Lebanon,LBN,11,0,0,0,11
2012,Libya,LBY,Lebanon,LBN,5,0,0,0,5
2012,Madagascar,MDG,Lebanon,LBN,0,0,5,0,5
2012,Sudan,SDN,Lebanon,LBN,73,0,286,97,456
2012,Syrian Arab Rep.,SYR,Lebanon,LBN,32,0,5,229,266
2012,Turkey,TUR,Lebanon,LBN,0,0,5,0,5
2012,Yemen,YEM,Lebanon,LBN,0,0,0,10,10
2012,Afghanistan,AFG,Malaysia,MYS,32,0,0,32,64
2012,Egypt,EGY,Malaysia,MYS,0,0,0,5,5
2012,Bangladesh,BGD,Malaysia,MYS,5,0,0,0,5
2012,Cambodia,KHM,Malaysia,MYS,5,0,0,11,16
2012,China,CHN,Malaysia,MYS,19,0,5,0,24
2012,Ethiopia,ETH,Malaysia,MYS,5,0,0,0,5
2012,Palestinian,PSE,Malaysia,MYS,19,0,5,30,54
2012,Indonesia,IDN,Malaysia,MYS,34,0,0,36,70
2012,Iran (Islamic Rep. of),IRN,Malaysia,MYS,73,0,24,0,97
2012,Iraq,IRQ,Malaysia,MYS,85,0,0,72,157
2012,Liberia,LBR,Malaysia,MYS,5,0,0,0,5
2012,Lebanon,LBN,Malaysia,MYS,0,0,0,5,5
2012,Sri Lanka,LKA,Malaysia,MYS,153,0,292,331,776
2012,Myanmar,MMR,Malaysia,MYS,12164,0,545,4433,17142
2012,Pakistan,PAK,Malaysia,MYS,34,0,12,10,56
2012,Philippines,PHL,Malaysia,MYS,0,0,0,5,5
2012,Somalia,SOM,Malaysia,MYS,118,0,10,60,188
2012,Viet Nam,VNM,Malaysia,MYS,5,0,0,0,5
2012,Sudan,SDN,Malaysia,MYS,20,0,5,0,25
2012,Thailand,THA,Malaysia,MYS,5,0,0,5,10
2012,Yemen,YEM,Malaysia,MYS,5,0,25,0,30
2012,China,CHN,Mongolia,MNG,5,0,0,0,5
2012,Cameroon,CMR,Morocco,MAR,0,0,25,11,36
2012,Dem. Rep. of the Congo,COD,Morocco,MAR,12,10,48,45,115
2012,Palestinian,PSE,Morocco,MAR,0,0,0,10,10
2012,Ghana,GHA,Morocco,MAR,0,0,5,0,5
2012,Guinea,GIN,Morocco,MAR,0,0,24,5,29
2012,Cote d'Ivoire,CIV,Morocco,MAR,82,5,26,153,266
2012,Iraq,IRQ,Morocco,MAR,5,5,0,0,10
2012,Liberia,LBR,Morocco,MAR,0,0,12,0,12
2012,Libya,LBY,Morocco,MAR,0,0,0,13,13
2012,Mali,MLI,Morocco,MAR,0,0,0,5,5
2012,Nigeria,NGA,Morocco,MAR,0,0,75,10,85
2012,Pakistan,PAK,Morocco,MAR,0,0,0,5,5
2012,Senegal,SEN,Morocco,MAR,5,0,0,0,5
2012,Somalia,SOM,Morocco,MAR,0,0,5,0,5
2012,Sudan,SDN,Morocco,MAR,0,0,0,5,5
2012,Dem. Rep. of the Congo,COD,Nepal,NPL,5,0,0,0,5
2012,Iran (Islamic Rep. of),IRN,Nepal,NPL,5,0,0,0,5
2012,Sri Lanka,LKA,Nepal,NPL,10,0,0,0,10
2012,Myanmar,MMR,Nepal,NPL,17,0,0,0,17
2012,Pakistan,PAK,Nepal,NPL,18,0,5,0,23
2012,Somalia,SOM,Nepal,NPL,5,0,0,0,5
2012,Iraq,IRQ,Oman,OMN,55,0,0,0,55
2012,Somalia,SOM,Papua New Guinea,PNG,5,0,0,0,5
2012,Iraq,IRQ,Qatar,QAT,0,0,0,14,14
2012,Eritrea,ERI,Somalia,SOM,5,0,0,0,5
2012,Ethiopia,ETH,Somalia,SOM,119,0,76,764,959
2012,Yemen,YEM,Somalia,SOM,0,0,0,5,5
2012,Egypt,EGY,Sudan,SDN,10,0,0,0,10
2012,Chad,TCD,Sudan,SDN,5,0,0,0,5
2012,Dem. Rep. of the Congo,COD,Sudan,SDN,5,0,0,0,5
2012,Eritrea,ERI,Sudan,SDN,49,0,0,0,49
2012,Ethiopia,ETH,Sudan,SDN,36,0,0,5,41
2012,Iraq,IRQ,Sudan,SDN,5,0,0,0,5
2012,Ethiopia,ETH,South Sudan,SSD,0,0,0,84,84
2012,Afghanistan,AFG,Syrian Arab Rep.,SYR,73,0,30,32,135
2012,Algeria,DZA,Syrian Arab Rep.,SYR,0,0,11,5,16
2012,Egypt,EGY,Syrian Arab Rep.,SYR,0,0,14,0,14
2012,Bosnia and Herzegovina,BIH,Syrian Arab Rep.,SYR,0,0,0,5,5
2012,Chad,TCD,Syrian Arab Rep.,SYR,0,0,5,0,5
2012,Eritrea,ERI,Syrian Arab Rep.,SYR,0,0,5,11,16
2012,Ethiopia,ETH,Syrian Arab Rep.,SYR,0,0,14,0,14
2012,Palestinian,PSE,Syrian Arab Rep.,SYR,0,0,0,5,5
2012,Iran (Islamic Rep. of),IRN,Syrian Arab Rep.,SYR,14,0,25,28,67
2012,Iraq,IRQ,Syrian Arab Rep.,SYR,81,5,332,222,640
2012,Jordan,JOR,Syrian Arab Rep.,SYR,0,0,10,0,10
2012,Kuwait,KWT,Syrian Arab Rep.,SYR,0,0,0,27,27
2012,Libya,LBY,Syrian Arab Rep.,SYR,5,0,0,5,10
2012,Morocco,MAR,Syrian Arab Rep.,SYR,0,0,5,0,5
2012,Pakistan,PAK,Syrian Arab Rep.,SYR,0,0,0,14,14
2012,Somalia,SOM,Syrian Arab Rep.,SYR,115,5,5,56,181
2012,Sudan,SDN,Syrian Arab Rep.,SYR,44,5,115,39,203
2012,South Sudan,SSD,Syrian Arab Rep.,SYR,5,0,0,0,5
2012,Yemen,YEM,Syrian Arab Rep.,SYR,13,0,41,13,67
2012,Afghanistan,AFG,Thailand,THA,0,0,5,0,5
2012,Egypt,EGY,Thailand,THA,11,0,0,0,11
2012,Burundi,BDI,Thailand,THA,0,0,5,0,5
2012,Bangladesh,BGD,Thailand,THA,0,0,5,5,10
2012,Cambodia,KHM,Thailand,THA,32,0,15,5,52
2012,China,CHN,Thailand,THA,46,0,38,15,99
2012,Cameroon,CMR,Thailand,THA,0,0,5,13,18
2012,Dem. Rep. of the Congo,COD,Thailand,THA,0,0,26,26,52
2012,Ethiopia,ETH,Thailand,THA,0,0,5,5,10
2012,Palestinian,PSE,Thailand,THA,40,0,0,5,45
2012,Ghana,GHA,Thailand,THA,0,0,5,0,5
2012,Guinea,GIN,Thailand,THA,0,0,12,5,17
2012,Cote d'Ivoire,CIV,Thailand,THA,0,0,11,0,11
2012,India,IND,Thailand,THA,0,0,5,0,5
2012,Iran (Islamic Rep. of),IRN,Thailand,THA,11,0,36,15,62
2012,Iraq,IRQ,Thailand,THA,17,0,0,10,27
2012,Kuwait,KWT,Thailand,THA,5,0,0,0,5
2012,Lao People's Dem. Rep.,LAO,Thailand,THA,0,0,5,5,10
2012,Liberia,LBR,Thailand,THA,0,0,11,0,11
2012,Sri Lanka,LKA,Thailand,THA,21,0,28,16,65
2012,Nepal,NPL,Thailand,THA,0,0,10,5,15
2012,Pakistan,PAK,Thailand,THA,112,0,10,24,146
2012,Somalia,SOM,Thailand,THA,47,0,5,10,62
2012,Viet Nam,VNM,Thailand,THA,40,0,251,33,324
2012,Sudan,SDN,Thailand,THA,10,0,0,0,10
2012,Syrian Arab Rep.,SYR,Thailand,THA,11,0,0,26,37
2012,Yemen,YEM,Thailand,THA,5,0,0,0,5
2012,Afghanistan,AFG,Tajikistan,TJK,14,0,5,0,19
2012,Kyrgyzstan,KGZ,Tajikistan,TJK,0,0,0,10,10
2012,Colombia,COL,Trinidad and Tobago,TTO,5,0,0,0,5
2012,Chad,TCD,Tunisia,TUN,5,0,5,5,15
2012,Dem. Rep. of the Congo,COD,Tunisia,TUN,0,0,0,5,5
2012,Eritrea,ERI,Tunisia,TUN,43,0,0,0,43
2012,Ethiopia,ETH,Tunisia,TUN,10,0,0,0,10
2012,Guinea,GIN,Tunisia,TUN,0,0,0,5,5
2012,Cote d'Ivoire,CIV,Tunisia,TUN,5,0,0,10,15
2012,Iraq,IRQ,Tunisia,TUN,10,0,0,0,10
2012,Mali,MLI,Tunisia,TUN,5,0,0,5,10
2012,Somalia,SOM,Tunisia,TUN,96,0,5,33,134
2012,Sudan,SDN,Tunisia,TUN,131,0,24,20,175
2012,Afghanistan,AFG,Turkey,TUR,1144,0,185,548,1877
2012,Algeria,DZA,Turkey,TUR,0,0,0,10,10
2012,Egypt,EGY,Turkey,TUR,0,0,0,5,5
2012,Azerbaijan,AZE,Turkey,TUR,5,0,0,0,5
2012,China,CHN,Turkey,TUR,0,0,0,14,14
2012,Cameroon,CMR,Turkey,TUR,0,0,0,18,18
2012,Dem. Rep. of the Congo,COD,Turkey,TUR,13,0,5,29,47
2012,Eritrea,ERI,Turkey,TUR,5,0,0,5,10
2012,Ethiopia,ETH,Turkey,TUR,24,0,0,5,29
2012,Palestinian,PSE,Turkey,TUR,65,0,0,26,91
2012,Ghana,GHA,Turkey,TUR,0,0,0,5,5
2012,Cote d'Ivoire,CIV,Turkey,TUR,5,0,0,19,24
2012,India,IND,Turkey,TUR,0,0,0,5,5
2012,Iran (Islamic Rep. of),IRN,Turkey,TUR,1942,0,179,369,2490
2012,Iraq,IRQ,Turkey,TUR,6381,0,44,721,7146
2012,Jordan,JOR,Turkey,TUR,5,0,0,0,5
2012,Kenya,KEN,Turkey,TUR,0,0,5,5,10
2012,Kyrgyzstan,KGZ,Turkey,TUR,172,0,5,33,210
2012,Kuwait,KWT,Turkey,TUR,0,0,0,5,5
2012,Libya,LBY,Turkey,TUR,0,0,0,11,11
2012,Lebanon,LBN,Turkey,TUR,5,0,0,0,5
2012,Sri Lanka,LKA,Turkey,TUR,0,0,0,5,5
2012,Morocco,MAR,Turkey,TUR,0,0,11,5,16
2012,Nigeria,NGA,Turkey,TUR,0,0,0,11,11
2012,Pakistan,PAK,Turkey,TUR,5,0,0,5,10
2012,Rwanda,RWA,Turkey,TUR,0,0,0,10,10
2012,Saudi Arabia,SAU,Turkey,TUR,5,0,0,0,5
2012,Senegal,SEN,Turkey,TUR,0,0,0,20,20
2012,Sierra Leone,SLE,Turkey,TUR,5,0,0,5,10
2012,Somalia,SOM,Turkey,TUR,840,0,31,160,1031
2012,Sudan,SDN,Turkey,TUR,25,0,0,10,35
2012,Syrian Arab Rep.,SYR,Turkey,TUR,10,0,0,20,30
2012,Tajikistan,TJK,Turkey,TUR,0,0,0,19,19
2012,Turkmenistan,TKM,Turkey,TUR,5,0,5,11,21
2012,Tunisia,TUN,Turkey,TUR,0,0,5,0,5
2012,Uganda,UGA,Turkey,TUR,5,0,0,29,34
2012,Uzbekistan,UZB,Turkey,TUR,14,0,10,84,108
2012,Yemen,YEM,Turkey,TUR,13,0,0,0,13
2012,Stateless,XXA,Turkey,TUR,5,0,0,0,5
2012,Colombia,COL,Curacao ,CUW,0,0,5,0,5
2012,Cuba,CUB,Sint Maarten (Dutch part),SXM,0,0,5,0,5
2013,Iran (Islamic Rep. of),IRN,Afghanistan,AFG,0,0,5,0,5
2013,Pakistan,PAK,Afghanistan,AFG,0,0,15,0,15
2013,Benin,BEN,Algeria,DZA,0,0,29,5,34
2013,Central African Rep.,CAF,Algeria,DZA,0,0,0,5,5
2013,Chad,TCD,Algeria,DZA,0,0,5,17,22
2013,Cameroon,CMR,Algeria,DZA,5,0,632,260,897
2013,Dem. Rep. of the Congo,COD,Algeria,DZA,5,0,45,27,77
2013,Gabon,GAB,Algeria,DZA,0,0,5,0,5
2013,Palestinian,PSE,Algeria,DZA,0,0,0,16,16
2013,Guinea,GIN,Algeria,DZA,0,0,68,26,94
2013,Cote d'Ivoire,CIV,Algeria,DZA,5,0,213,96,314
2013,Liberia,LBR,Algeria,DZA,0,0,18,5,23
2013,Libya,LBY,Algeria,DZA,0,0,0,32,32
2013,Mali,MLI,Algeria,DZA,0,0,14,10,24
2013,Niger,NER,Algeria,DZA,0,0,43,27,70
2013,Nigeria,NGA,Algeria,DZA,0,0,79,60,139
2013,Sudan,SDN,Algeria,DZA,0,0,0,16,16
2013,Syrian Arab Rep.,SYR,Algeria,DZA,0,0,0,48,48
2013,Yemen,YEM,Algeria,DZA,5,0,0,0,5
2013,Afghanistan,AFG,Azerbaijan,AZE,58,0,19,26,103
2013,Algeria,DZA,Azerbaijan,AZE,0,0,5,0,5
2013,Palestinian,PSE,Azerbaijan,AZE,5,0,0,0,5
2013,Iran (Islamic Rep. of),IRN,Azerbaijan,AZE,0,0,14,0,14
2013,Pakistan,PAK,Azerbaijan,AZE,0,0,12,5,17
2013,Russian Federation,RUS,Azerbaijan,AZE,0,0,0,5,5
2013,Syrian Arab Rep.,SYR,Azerbaijan,AZE,5,0,0,0,5
2013,Iraq,IRQ,Bahrain,BHR,16,0,5,11,32
2013,Syrian Arab Rep.,SYR,Bahrain,BHR,0,0,0,5,5
2013,Myanmar,MMR,Bangladesh,BGD,16,0,0,0,16
2013,Mexico,MEX,Cayman Islands,CYM,5,0,0,0,5
2013,Central African Rep.,CAF,Cameroon,CMR,62,0,110,196,368
2013,Chad,TCD,Cameroon,CMR,10,0,23,47,80
2013,Dem. Rep. of the Congo,COD,Cameroon,CMR,0,0,5,0,5
2013,Guinea,GIN,Cameroon,CMR,5,0,83,0,88
2013,Cote d'Ivoire,CIV,Cameroon,CMR,5,0,16,0,21
2013,Libya,LBY,Cameroon,CMR,0,0,0,5,5
2013,Mali,MLI,Cameroon,CMR,0,0,10,5,15
2013,Rwanda,RWA,Cameroon,CMR,0,0,29,11,40
2013,Senegal,SEN,Cameroon,CMR,0,0,42,5,47
2013,Sierra Leone,SLE,Cameroon,CMR,0,0,5,0,5
2013,Palestinian,PSE,Cyprus,CYP,0,0,0,17,17
2013,Jordan,JOR,Cyprus,CYP,0,0,0,5,5
2013,Pakistan,PAK,Cyprus,CYP,0,0,0,5,5
2013,Syrian Arab Rep.,SYR,Cyprus,CYP,0,0,0,22,22
2013,Cuba,CUB,Haiti,HTI,0,0,0,11,11
2013,Egypt,EGY,"China, Hong Kong SAR",HKG,0,0,0,10,10
2013,Bangladesh,BGD,"China, Hong Kong SAR",HKG,0,0,0,20,20
2013,Colombia,COL,"China, Hong Kong SAR",HKG,0,0,0,17,17
2013,Fiji,FJI,"China, Hong Kong SAR",HKG,0,0,0,5,5
2013,India,IND,"China, Hong Kong SAR",HKG,0,0,5,64,69
2013,Indonesia,IDN,"China, Hong Kong SAR",HKG,0,0,43,163,206
2013,Kenya,KEN,"China, Hong Kong SAR",HKG,0,0,5,0,5
2013,Liberia,LBR,"China, Hong Kong SAR",HKG,0,0,0,5,5
2013,Sri Lanka,LKA,"China, Hong Kong SAR",HKG,5,0,0,5,10
2013,Namibia,NAM,"China, Hong Kong SAR",HKG,0,0,5,0,5
2013,Nepal,NPL,"China, Hong Kong SAR",HKG,0,0,0,5,5
2013,Nigeria,NGA,"China, Hong Kong SAR",HKG,0,0,0,5,5
2013,Pakistan,PAK,"China, Hong Kong SAR",HKG,0,0,16,57,73
2013,Philippines,PHL,"China, Hong Kong SAR",HKG,0,0,11,39,50
2013,Rwanda,RWA,"China, Hong Kong SAR",HKG,5,0,0,0,5
2013,Somalia,SOM,"China, Hong Kong SAR",HKG,19,0,0,0,19
2013,Viet Nam,VNM,"China, Hong Kong SAR",HKG,0,0,0,29,29
2013,Syrian Arab Rep.,SYR,"China, Hong Kong SAR",HKG,0,0,0,5,5
2013,United Rep. of Tanzania,TZA,"China, Hong Kong SAR",HKG,0,0,0,5,5
2013,Thailand,THA,"China, Hong Kong SAR",HKG,0,0,0,10,10
2013,Togo,TGO,"China, Hong Kong SAR",HKG,0,0,0,5,5
2013,Uganda,UGA,"China, Hong Kong SAR",HKG,0,0,5,5,10
2013,Yemen,YEM,"China, Hong Kong SAR",HKG,0,0,0,13,13
2013,Afghanistan,AFG,India,IND,894,0,330,217,1441
2013,Dem. Rep. of the Congo,COD,India,IND,13,0,22,5,40
2013,Eritrea,ERI,India,IND,12,0,0,0,12
2013,Palestinian,PSE,India,IND,25,0,0,0,25
2013,Cote d'Ivoire,CIV,India,IND,5,0,0,0,5
2013,Iran (Islamic Rep. of),IRN,India,IND,10,0,0,5,15
2013,Iraq,IRQ,India,IND,24,0,5,11,40
2013,Maldives,MDV,India,IND,5,0,0,0,5
2013,Myanmar,MMR,India,IND,3712,0,75,38,3825
2013,Nigeria,NGA,India,IND,0,0,5,0,5
2013,Romania,ROU,India,IND,5,0,0,0,5
2013,Somalia,SOM,India,IND,38,0,0,26,64
2013,Sudan,SDN,India,IND,19,0,14,0,33
2013,Syrian Arab Rep.,SYR,India,IND,17,0,0,0,17
2013,Yemen,YEM,India,IND,5,0,0,0,5
2013,Afghanistan,AFG,Indonesia,IDN,960,0,81,2542,3583
2013,Egypt,EGY,Indonesia,IDN,0,0,0,5,5
2013,Bangladesh,BGD,Indonesia,IDN,0,0,5,49,54
2013,China,CHN,Indonesia,IDN,11,0,5,0,16
2013,Dem. Rep. of the Congo,COD,Indonesia,IDN,5,0,0,0,5
2013,Eritrea,ERI,Indonesia,IDN,0,0,0,5,5
2013,Ethiopia,ETH,Indonesia,IDN,11,0,0,0,11
2013,Palestinian,PSE,Indonesia,IDN,151,0,0,128,279
2013,Iran (Islamic Rep. of),IRN,Indonesia,IDN,164,0,106,518,788
2013,Iraq,IRQ,Indonesia,IDN,60,0,14,412,486
2013,Kuwait,KWT,Indonesia,IDN,0,0,0,5,5
2013,Lebanon,LBN,Indonesia,IDN,0,0,0,10,10
2013,Sri Lanka,LKA,Indonesia,IDN,137,0,44,192,373
2013,Myanmar,MMR,Indonesia,IDN,560,0,5,262,827
2013,Nepal,NPL,Indonesia,IDN,0,0,0,5,5
2013,Pakistan,PAK,Indonesia,IDN,107,0,10,459,576
2013,Somalia,SOM,Indonesia,IDN,156,0,5,32,193
2013,Viet Nam,VNM,Indonesia,IDN,0,0,0,5,5
2013,Sudan,SDN,Indonesia,IDN,13,0,0,40,53
2013,Syrian Arab Rep.,SYR,Indonesia,IDN,32,0,0,10,42
2013,Yemen,YEM,Indonesia,IDN,0,0,5,0,5
2013,Afghanistan,AFG,Iran (Islamic Rep. of),IRN,11,0,10,0,21
2013,Pakistan,PAK,Iran (Islamic Rep. of),IRN,5,0,0,0,5
2013,Iran (Islamic Rep. of),IRN,Iraq,IRQ,47,0,0,31,78
2013,Syrian Arab Rep.,SYR,Iraq,IRQ,21,0,0,0,21
2013,Turkey,TUR,Iraq,IRQ,23,0,0,0,23
2013,Afghanistan,AFG,Kazakhstan,KAZ,20,0,0,0,20
2013,Uzbekistan,UZB,Kazakhstan,KAZ,0,0,5,0,5
2013,Afghanistan,AFG,Kenya,KEN,5,0,0,0,5
2013,Burundi,BDI,Kenya,KEN,42,0,43,49,134
2013,Dem. Rep. of the Congo,COD,Kenya,KEN,1849,0,143,96,2088
2013,Eritrea,ERI,Kenya,KEN,154,0,10,46,210
2013,Ethiopia,ETH,Kenya,KEN,2625,0,1686,1510,5821
2013,Sri Lanka,LKA,Kenya,KEN,5,0,0,5,10
2013,Nigeria,NGA,Kenya,KEN,0,0,15,0,15
2013,Rwanda,RWA,Kenya,KEN,27,0,63,0,90
2013,Somalia,SOM,Kenya,KEN,371,0,107,636,1114
2013,Sudan,SDN,Kenya,KEN,116,0,11,67,194
2013,South Sudan,SSD,Kenya,KEN,195,0,86,79,360
2013,United Rep. of Tanzania,TZA,Kenya,KEN,0,0,14,0,14
2013,Uganda,UGA,Kenya,KEN,5,0,29,45,79
2013,Egypt,EGY,Kuwait,KWT,5,0,0,5,10
2013,Iran (Islamic Rep. of),IRN,Kuwait,KWT,0,0,10,15,25
2013,Iraq,IRQ,Kuwait,KWT,102,0,0,147,249
2013,Jordan,JOR,Kuwait,KWT,0,0,0,5,5
2013,Lebanon,LBN,Kuwait,KWT,0,0,0,5,5
2013,Somalia,SOM,Kuwait,KWT,38,0,0,30,68
2013,Dem. Rep. of the Congo,COD,Libya,LBY,5,0,0,0,5
2013,Eritrea,ERI,Libya,LBY,5,0,0,5,10
2013,Palestinian,PSE,Libya,LBY,1677,0,0,0,1677
2013,Iraq,IRQ,Libya,LBY,12,0,0,38,50
2013,Somalia,SOM,Libya,LBY,0,0,0,5,5
2013,Sudan,SDN,Libya,LBY,14,0,0,5,19
2013,Afghanistan,AFG,Lebanon,LBN,0,0,5,13,18
2013,Egypt,EGY,Lebanon,LBN,20,0,50,46,116
2013,Bahrain,BHR,Lebanon,LBN,0,0,0,12,12
2013,Dem. Rep. of the Congo,COD,Lebanon,LBN,5,0,0,0,5
2013,Eritrea,ERI,Lebanon,LBN,0,0,5,0,5
2013,Ethiopia,ETH,Lebanon,LBN,0,0,13,0,13
2013,Cote d'Ivoire,CIV,Lebanon,LBN,0,0,5,0,5
2013,Iran (Islamic Rep. of),IRN,Lebanon,LBN,0,0,19,0,19
2013,Iraq,IRQ,Lebanon,LBN,759,0,200,249,1208
2013,Jordan,JOR,Lebanon,LBN,5,0,0,5,10
2013,Saudi Arabia,SAU,Lebanon,LBN,5,0,0,5,10
2013,Somalia,SOM,Lebanon,LBN,15,0,0,10,25
2013,Sudan,SDN,Lebanon,LBN,66,0,151,49,266
2013,Suriname,SUR,Lebanon,LBN,0,0,0,13,13
2013,Syrian Arab Rep.,SYR,Lebanon,LBN,408,0,0,0,408
2013,Yemen,YEM,Lebanon,LBN,0,0,0,5,5
2013,Stateless,XXA,Lebanon,LBN,358,0,0,0,358
2013,Maldives,MDV,Sri Lanka,LKA,0,0,26,21,47
2013,Pakistan,PAK,Sri Lanka,LKA,59,0,75,63,197
2013,Syrian Arab Rep.,SYR,Sri Lanka,LKA,0,0,0,5,5
2013,Pakistan,PAK,Madagascar,MDG,5,0,0,0,5
2013,Burundi,BDI,Mauritania,MRT,0,0,0,5,5
2013,Benin,BEN,Mauritania,MRT,0,0,0,5,5
2013,Chad,TCD,Mauritania,MRT,0,0,0,5,5
2013,Cameroon,CMR,Mauritania,MRT,0,0,0,15,15
2013,Congo,COG,Mauritania,MRT,0,0,5,5,10
2013,Dem. Rep. of the Congo,COD,Mauritania,MRT,0,0,16,123,139
2013,Palestinian,PSE,Mauritania,MRT,0,0,0,5,5
2013,Guinea,GIN,Mauritania,MRT,0,0,0,5,5
2013,Cote d'Ivoire,CIV,Mauritania,MRT,13,0,104,288,405
2013,Iraq,IRQ,Mauritania,MRT,0,0,0,5,5
2013,Liberia,LBR,Mauritania,MRT,0,0,0,5,5
2013,Nigeria,NGA,Mauritania,MRT,0,0,0,5,5
2013,Senegal,SEN,Mauritania,MRT,0,0,0,5,5
2013,Syrian Arab Rep.,SYR,Mauritania,MRT,5,0,0,0,5
2013,Togo,TGO,Mauritania,MRT,0,0,0,5,5
2013,Afghanistan,AFG,Malaysia,MYS,22,0,0,27,49
2013,Egypt,EGY,Malaysia,MYS,0,0,10,5,15
2013,Bangladesh,BGD,Malaysia,MYS,0,0,0,5,5
2013,Cambodia,KHM,Malaysia,MYS,14,0,0,0,14
2013,Congo,COG,Malaysia,MYS,0,0,0,5,5
2013,Dem. Rep. of the Congo,COD,Malaysia,MYS,5,0,0,0,5
2013,Eritrea,ERI,Malaysia,MYS,0,0,0,5,5
2013,Palestinian,PSE,Malaysia,MYS,80,0,10,26,116
2013,India,IND,Malaysia,MYS,0,0,0,5,5
2013,Indonesia,IDN,Malaysia,MYS,69,0,10,23,102
2013,Iran (Islamic Rep. of),IRN,Malaysia,MYS,82,0,45,47,174
2013,Iraq,IRQ,Malaysia,MYS,131,0,5,54,190
2013,Jordan,JOR,Malaysia,MYS,5,0,0,0,5
2013,Liberia,LBR,Malaysia,MYS,5,0,0,0,5
2013,Sri Lanka,LKA,Malaysia,MYS,109,0,307,598,1014
2013,Mali,MLI,Malaysia,MYS,5,0,0,0,5
2013,Myanmar,MMR,Malaysia,MYS,13465,0,649,5711,19825
2013,Nepal,NPL,Malaysia,MYS,5,0,0,5,10
2013,Nigeria,NGA,Malaysia,MYS,0,0,0,10,10
2013,Pakistan,PAK,Malaysia,MYS,82,0,56,46,184
2013,Philippines,PHL,Malaysia,MYS,0,0,0,5,5
2013,Somalia,SOM,Malaysia,MYS,139,0,20,82,241
2013,Sudan,SDN,Malaysia,MYS,30,0,13,5,48
2013,Syrian Arab Rep.,SYR,Malaysia,MYS,100,0,0,17,117
2013,Thailand,THA,Malaysia,MYS,0,0,0,25,25
2013,Yemen,YEM,Malaysia,MYS,13,0,0,41,54
2013,Afghanistan,AFG,Mongolia,MNG,0,0,0,5,5
2013,China,CHN,Mongolia,MNG,10,0,0,0,10
2013,Burkina Faso,BFA,Morocco,MAR,0,0,0,5,5
2013,Chad,TCD,Morocco,MAR,0,0,5,0,5
2013,Cameroon,CMR,Morocco,MAR,11,0,61,10,82
2013,Congo,COG,Morocco,MAR,5,0,32,0,37
2013,Dem. Rep. of the Congo,COD,Morocco,MAR,12,0,140,22,174
2013,Eritrea,ERI,Morocco,MAR,0,0,5,0,5
2013,Ethiopia,ETH,Morocco,MAR,0,0,5,0,5
2013,Gambia,GMB,Morocco,MAR,0,0,10,0,10
2013,Palestinian,PSE,Morocco,MAR,11,0,0,5,16
2013,Ghana,GHA,Morocco,MAR,0,0,14,0,14
2013,Guinea-Bissau,GNB,Morocco,MAR,0,0,0,5,5
2013,Guinea,GIN,Morocco,MAR,0,0,24,10,34
2013,Cote d'Ivoire,CIV,Morocco,MAR,141,0,90,0,231
2013,Kenya,KEN,Morocco,MAR,0,0,5,0,5
2013,Liberia,LBR,Morocco,MAR,0,0,13,0,13
2013,Mali,MLI,Morocco,MAR,0,0,0,10,10
2013,Niger,NER,Morocco,MAR,0,0,13,0,13
2013,Nigeria,NGA,Morocco,MAR,0,0,211,5,216
2013,Rwanda,RWA,Morocco,MAR,0,0,5,0,5
2013,Saudi Arabia,SAU,Morocco,MAR,0,0,0,5,5
2013,Senegal,SEN,Morocco,MAR,14,0,0,0,14
2013,Sierra Leone,SLE,Morocco,MAR,0,0,5,5,10
2013,Somalia,SOM,Morocco,MAR,0,0,0,5,5
2013,Sudan,SDN,Morocco,MAR,0,0,17,5,22
2013,Syrian Arab Rep.,SYR,Morocco,MAR,0,0,0,858,858
2013,Togo,TGO,Morocco,MAR,0,0,0,5,5
2013,Uganda,UGA,Morocco,MAR,0,0,5,5,10
2013,Zimbabwe,ZWE,Morocco,MAR,0,0,0,5,5
2013,Sri Lanka,LKA,Nepal,NPL,5,0,0,0,5
2013,Myanmar,MMR,Nepal,NPL,46,0,0,0,46
2013,Pakistan,PAK,Nepal,NPL,32,0,27,10,69
2013,Iraq,IRQ,Oman,OMN,5,0,0,0,5
2013,India,IND,Qatar,QAT,0,0,0,5,5
2013,Iraq,IRQ,Qatar,QAT,39,0,0,12,51
2013,Yemen,YEM,Qatar,QAT,0,0,0,5,5
2013,Eritrea,ERI,Saudi Arabia,SAU,10,0,0,0,10
2013,Iraq,IRQ,Saudi Arabia,SAU,10,0,0,0,10
2013,Syrian Arab Rep.,SYR,Saudi Arabia,SAU,5,0,0,0,5
2013,Eritrea,ERI,Somalia,SOM,0,0,0,5,5
2013,Ethiopia,ETH,Somalia,SOM,55,0,83,1322,1460
2013,United Rep. of Tanzania,TZA,Somalia,SOM,0,0,0,5,5
2013,Eritrea,ERI,Sudan,SDN,59,0,0,0,59
2013,Ethiopia,ETH,Sudan,SDN,14,0,0,0,14
2013,Afghanistan,AFG,Syrian Arab Rep.,SYR,123,0,0,38,161
2013,Algeria,DZA,Syrian Arab Rep.,SYR,0,0,5,0,5
2013,Egypt,EGY,Syrian Arab Rep.,SYR,0,0,53,10,63
2013,Burkina Faso,BFA,Syrian Arab Rep.,SYR,0,0,5,0,5
2013,Eritrea,ERI,Syrian Arab Rep.,SYR,5,0,0,0,5
2013,Ethiopia,ETH,Syrian Arab Rep.,SYR,10,0,25,0,35
2013,Guinea,GIN,Syrian Arab Rep.,SYR,5,0,12,0,17
2013,Cote d'Ivoire,CIV,Syrian Arab Rep.,SYR,0,0,0,5,5
2013,Iran (Islamic Rep. of),IRN,Syrian Arab Rep.,SYR,0,0,26,23,49
2013,Iraq,IRQ,Syrian Arab Rep.,SYR,113,0,79,100,292
2013,Jordan,JOR,Syrian Arab Rep.,SYR,0,0,45,5,50
2013,Kenya,KEN,Syrian Arab Rep.,SYR,0,0,12,0,12
2013,Kuwait,KWT,Syrian Arab Rep.,SYR,0,0,0,13,13
2013,Libya,LBY,Syrian Arab Rep.,SYR,0,0,5,5,10
2013,Lebanon,LBN,Syrian Arab Rep.,SYR,0,0,55,0,55
2013,Morocco,MAR,Syrian Arab Rep.,SYR,0,0,10,0,10
2013,Nigeria,NGA,Syrian Arab Rep.,SYR,0,0,5,0,5
2013,Pakistan,PAK,Syrian Arab Rep.,SYR,15,0,45,15,75
2013,Philippines,PHL,Syrian Arab Rep.,SYR,0,0,18,0,18
2013,Saudi Arabia,SAU,Syrian Arab Rep.,SYR,5,0,0,0,5
2013,Somalia,SOM,Syrian Arab Rep.,SYR,10,0,5,38,53
2013,Sudan,SDN,Syrian Arab Rep.,SYR,97,0,113,169,379
2013,South Sudan,SSD,Syrian Arab Rep.,SYR,0,0,10,0,10
2013,Tunisia,TUN,Syrian Arab Rep.,SYR,0,0,13,0,13
2013,Yemen,YEM,Syrian Arab Rep.,SYR,28,0,26,65,119
2013,Afghanistan,AFG,Thailand,THA,10,0,0,0,10
2013,Egypt,EGY,Thailand,THA,0,0,0,5,5
2013,Cambodia,KHM,Thailand,THA,27,0,0,10,37
2013,China,CHN,Thailand,THA,32,0,0,5,37
2013,Cameroon,CMR,Thailand,THA,0,0,5,5,10
2013,Dem. Rep. of the Congo,COD,Thailand,THA,5,0,0,0,5
2013,Palestinian,PSE,Thailand,THA,97,0,0,21,118
2013,Guinea,GIN,Thailand,THA,5,0,0,0,5
2013,Cote d'Ivoire,CIV,Thailand,THA,5,0,0,5,10
2013,India,IND,Thailand,THA,0,0,0,5,5
2013,Iran (Islamic Rep. of),IRN,Thailand,THA,5,0,0,25,30
2013,Iraq,IRQ,Thailand,THA,5,0,0,0,5
2013,Sri Lanka,LKA,Thailand,THA,18,0,0,20,38
2013,Nepal,NPL,Thailand,THA,0,0,5,5,10
2013,Pakistan,PAK,Thailand,THA,115,0,15,30,160
2013,Somalia,SOM,Thailand,THA,17,0,0,0,17
2013,Viet Nam,VNM,Thailand,THA,29,0,5,38,72
2013,Syrian Arab Rep.,SYR,Thailand,THA,35,0,0,36,71
2013,Uganda,UGA,Thailand,THA,0,0,0,5,5
2013,Egypt,EGY,Tunisia,TUN,0,0,0,22,22
2013,Dem. Rep. of the Congo,COD,Tunisia,TUN,0,0,0,5,5
2013,Eritrea,ERI,Tunisia,TUN,17,0,0,23,40
2013,Gambia,GMB,Tunisia,TUN,0,0,0,5,5
2013,Cote d'Ivoire,CIV,Tunisia,TUN,0,0,0,139,139
2013,Iraq,IRQ,Tunisia,TUN,5,0,0,0,5
2013,Libya,LBY,Tunisia,TUN,0,0,0,5,5
2013,Mali,MLI,Tunisia,TUN,0,0,0,17,17
2013,Somalia,SOM,Tunisia,TUN,0,0,0,13,13
2013,Sudan,SDN,Tunisia,TUN,10,0,0,16,26
2013,Afghanistan,AFG,Turkey,TUR,797,0,259,204,1260
2013,Angola,AGO,Turkey,TUR,0,0,0,5,5
2013,Egypt,EGY,Turkey,TUR,0,0,0,14,14
2013,Bangladesh,BGD,Turkey,TUR,0,0,5,0,5
2013,China,CHN,Turkey,TUR,11,0,0,21,32
2013,Cameroon,CMR,Turkey,TUR,0,0,5,16,21
2013,Congo,COG,Turkey,TUR,0,0,0,5,5
2013,Dem. Rep. of the Congo,COD,Turkey,TUR,14,0,0,29,43
2013,Eritrea,ERI,Turkey,TUR,5,0,5,11,21
2013,Ethiopia,ETH,Turkey,TUR,26,0,0,10,36
2013,Palestinian,PSE,Turkey,TUR,458,0,0,40,498
2013,Ghana,GHA,Turkey,TUR,0,0,0,5,5
2013,Guinea,GIN,Turkey,TUR,0,0,0,5,5
2013,Cote d'Ivoire,CIV,Turkey,TUR,5,0,0,18,23
2013,Iran (Islamic Rep. of),IRN,Turkey,TUR,2635,0,790,461,3886
2013,Iraq,IRQ,Turkey,TUR,9069,0,100,541,9710
2013,Israel,ISR,Turkey,TUR,0,0,0,5,5
2013,Jordan,JOR,Turkey,TUR,14,0,0,0,14
2013,Kazakhstan,KAZ,Turkey,TUR,0,0,0,11,11
2013,Kenya,KEN,Turkey,TUR,0,0,0,5,5
2013,Kyrgyzstan,KGZ,Turkey,TUR,51,0,34,31,116
2013,Liberia,LBR,Turkey,TUR,0,0,0,5,5
2013,Libya,LBY,Turkey,TUR,0,0,5,0,5
2013,Lebanon,LBN,Turkey,TUR,0,0,0,5,5
2013,Mauritania,MRT,Turkey,TUR,5,0,0,0,5
2013,Morocco,MAR,Turkey,TUR,5,0,5,0,10
2013,Myanmar,MMR,Turkey,TUR,0,0,0,5,5
2013,Nigeria,NGA,Turkey,TUR,0,0,10,12,22
2013,Pakistan,PAK,Turkey,TUR,5,0,5,13,23
2013,Russian Federation,RUS,Turkey,TUR,0,0,0,5,5
2013,Saudi Arabia,SAU,Turkey,TUR,5,0,0,0,5
2013,Senegal,SEN,Turkey,TUR,0,0,12,21,33
2013,Somalia,SOM,Turkey,TUR,726,0,11,53,790
2013,Sudan,SDN,Turkey,TUR,32,0,5,5,42
2013,Syrian Arab Rep.,SYR,Turkey,TUR,100,0,0,92,192
2013,Tajikistan,TJK,Turkey,TUR,12,0,19,15,46
2013,Turkmenistan,TKM,Turkey,TUR,0,0,20,25,45
2013,Tunisia,TUN,Turkey,TUR,5,0,0,0,5
2013,Uganda,UGA,Turkey,TUR,5,0,5,10,20
2013,Uzbekistan,UZB,Turkey,TUR,0,0,45,41,86
2013,Yemen,YEM,Turkey,TUR,17,0,22,10,49
2013,Stateless,XXA,Turkey,TUR,5,0,0,12,17
2013,Eritrea,ERI,Yemen,YEM,75,0,5,215,295
2013,Ethiopia,ETH,Yemen,YEM,271,0,425,3201,3897
2013,Palestinian,PSE,Yemen,YEM,18,0,0,61,79
2013,Iraq,IRQ,Yemen,YEM,11,0,0,47,58
2013,Jordan,JOR,Yemen,YEM,5,0,0,0,5
2013,Russian Federation,RUS,Yemen,YEM,0,0,0,5,5
2013,Sudan,SDN,Yemen,YEM,5,0,0,11,16
2013,Syrian Arab Rep.,SYR,Yemen,YEM,12,0,0,84,96
2013,Tajikistan,TJK,Yemen,YEM,0,0,0,10,10
2013,Sri Lanka,LKA,Montserrat,MSR,0,0,0,5,5
2013,Cuba,CUB,Sint Maarten (Dutch part),SXM,0,0,0,5,5
2014,Iran (Islamic Rep. of),IRN,Afghanistan,AFG,5,0,5,0,10
2014,Pakistan,PAK,Afghanistan,AFG,27,0,5,0,32
2014,Burundi,BDI,Algeria,DZA,0,0,5,0,5
2014,Benin,BEN,Algeria,DZA,0,0,33,0,33
2014,Burkina Faso,BFA,Algeria,DZA,0,0,5,0,5
2014,Central African Rep.,CAF,Algeria,DZA,0,0,5,10,15
2014,Chad,TCD,Algeria,DZA,0,0,13,0,13
2014,Cameroon,CMR,Algeria,DZA,0,0,102,41,143
2014,Congo,COG,Algeria,DZA,0,0,5,0,5
2014,Dem. Rep. of the Congo,COD,Algeria,DZA,0,0,40,18,58
2014,Palestinian,PSE,Algeria,DZA,0,0,0,30,30
2014,Guinea,GIN,Algeria,DZA,0,0,25,10,35
2014,Cote d'Ivoire,CIV,Algeria,DZA,0,0,152,37,189
2014,Iraq,IRQ,Algeria,DZA,5,0,0,0,5
2014,Libya,LBY,Algeria,DZA,0,0,0,12,12
2014,Mali,MLI,Algeria,DZA,0,0,265,151,416
2014,Nigeria,NGA,Algeria,DZA,0,0,24,10,34
2014,Senegal,SEN,Algeria,DZA,0,0,5,0,5
2014,Sierra Leone,SLE,Algeria,DZA,0,0,5,0,5
2014,Sudan,SDN,Algeria,DZA,0,0,0,11,11
2014,Syrian Arab Rep.,SYR,Algeria,DZA,0,0,0,166,166
2014,Togo,TGO,Algeria,DZA,0,0,10,0,10
2014,Afghanistan,AFG,Egypt,EGY,5,0,0,5,10
2014,Chad,TCD,Egypt,EGY,5,0,0,16,21
2014,Cameroon,CMR,Egypt,EGY,0,0,0,27,27
2014,Congo,COG,Egypt,EGY,0,0,0,10,10
2014,Dem. Rep. of the Congo,COD,Egypt,EGY,0,0,0,17,17
2014,Eritrea,ERI,Egypt,EGY,361,0,45,284,690
2014,Ethiopia,ETH,Egypt,EGY,262,0,207,221,690
2014,Palestinian,PSE,Egypt,EGY,0,0,0,13,13
2014,Guinea-Bissau,GNB,Egypt,EGY,0,0,0,5,5
2014,Guinea,GIN,Egypt,EGY,0,0,0,28,28
2014,Cote d'Ivoire,CIV,Egypt,EGY,0,0,5,68,73
2014,Iran (Islamic Rep. of),IRN,Egypt,EGY,5,0,0,0,5
2014,Iraq,IRQ,Egypt,EGY,524,0,72,0,596
2014,Jordan,JOR,Egypt,EGY,0,0,0,5,5
2014,Liberia,LBR,Egypt,EGY,0,0,0,5,5
2014,Libya,LBY,Egypt,EGY,0,0,0,5,5
2014,Lebanon,LBN,Egypt,EGY,0,0,0,5,5
2014,Madagascar,MDG,Egypt,EGY,0,0,0,5,5
2014,Nigeria,NGA,Egypt,EGY,5,0,5,57,67
2014,Russian Federation,RUS,Egypt,EGY,5,0,5,0,10
2014,Rwanda,RWA,Egypt,EGY,0,0,5,0,5
2014,Saudi Arabia,SAU,Egypt,EGY,0,0,0,5,5
2014,Somalia,SOM,Egypt,EGY,440,0,10,209,659
2014,Sudan,SDN,Egypt,EGY,2035,0,564,1886,4485
2014,South Sudan,SSD,Egypt,EGY,151,0,10,0,161
2014,Tajikistan,TJK,Egypt,EGY,0,0,0,5,5
2014,Turkmenistan,TKM,Egypt,EGY,0,0,0,5,5
2014,Tunisia,TUN,Egypt,EGY,0,0,0,5,5
2014,Uganda,UGA,Egypt,EGY,0,0,0,12,12
2014,Uzbekistan,UZB,Egypt,EGY,0,0,0,11,11
2014,Yemen,YEM,Egypt,EGY,10,0,5,24,39
2014,Zimbabwe,ZWE,Egypt,EGY,5,0,0,0,5
2014,Afghanistan,AFG,Azerbaijan,AZE,53,0,80,24,157
2014,Iraq,IRQ,Azerbaijan,AZE,0,0,0,5,5
2014,Pakistan,PAK,Azerbaijan,AZE,5,0,20,25,50
2014,Russian Federation,RUS,Azerbaijan,AZE,10,0,10,18,38
2014,Syrian Arab Rep.,SYR,Azerbaijan,AZE,0,0,0,5,5
2014,Egypt,EGY,Bahrain,BHR,0,0,5,0,5
2014,Iraq,IRQ,Bahrain,BHR,52,0,0,0,52
2014,Yemen,YEM,Bahrain,BHR,5,0,0,0,5
2014,Burkina Faso,BFA,China,CHN,0,0,0,5,5
2014,Central African Rep.,CAF,China,CHN,0,0,0,5,5
2014,Cameroon,CMR,China,CHN,0,0,0,5,5
2014,Eritrea,ERI,China,CHN,5,0,0,0,5
2014,Palestinian,PSE,China,CHN,0,0,0,5,5
2014,Ghana,GHA,China,CHN,0,0,5,5,10
2014,Guinea,GIN,China,CHN,0,0,0,5,5
2014,Kenya,KEN,China,CHN,0,0,0,5,5
2014,Liberia,LBR,China,CHN,0,0,0,17,17
2014,Nigeria,NGA,China,CHN,0,0,35,35,70
2014,Pakistan,PAK,China,CHN,0,0,5,0,5
2014,Sierra Leone,SLE,China,CHN,0,0,0,10,10
2014,Somalia,SOM,China,CHN,54,0,68,35,157
2014,Syrian Arab Rep.,SYR,China,CHN,5,0,0,5,10
2014,Burkina Faso,BFA,Cameroon,CMR,0,0,0,5,5
2014,Central African Rep.,CAF,Cameroon,CMR,3808,0,162,891,4861
2014,Chad,TCD,Cameroon,CMR,17,0,108,111,236
2014,Congo,COG,Cameroon,CMR,0,0,0,12,12
2014,Dem. Rep. of the Congo,COD,Cameroon,CMR,12,0,117,46,175
2014,Gambia,GMB,Cameroon,CMR,0,0,0,17,17
2014,Guinea-Bissau,GNB,Cameroon,CMR,0,0,10,18,28
2014,Guinea,GIN,Cameroon,CMR,0,0,113,239,352
2014,Cote d'Ivoire,CIV,Cameroon,CMR,0,0,37,94,131
2014,Iran (Islamic Rep. of),IRN,Cameroon,CMR,5,0,0,0,5
2014,Liberia,LBR,Cameroon,CMR,0,0,0,12,12
2014,Mauritania,MRT,Cameroon,CMR,0,0,5,0,5
2014,Mali,MLI,Cameroon,CMR,0,0,17,22,39
2014,Niger,NER,Cameroon,CMR,0,0,5,0,5
2014,Nigeria,NGA,Cameroon,CMR,0,0,5,0,5
2014,Rwanda,RWA,Cameroon,CMR,5,0,103,0,108
2014,Senegal,SEN,Cameroon,CMR,0,0,25,81,106
2014,Sierra Leone,SLE,Cameroon,CMR,0,0,0,12,12
2014,Sudan,SDN,Cameroon,CMR,23,0,5,5,33
2014,South Sudan,SSD,Cameroon,CMR,5,0,0,0,5
2014,Angola,AGO,Dem. Rep. of the Congo,COD,5,0,5,0,10
2014,Burundi,BDI,Dem. Rep. of the Congo,COD,0,0,5,306,311
2014,Rwanda,RWA,Dem. Rep. of the Congo,COD,0,0,10,67,77
2014,Egypt,EGY,Cyprus,CYP,0,0,5,0,5
2014,Palestinian,PSE,Cyprus,CYP,11,0,0,38,49
2014,Iran (Islamic Rep. of),IRN,Cyprus,CYP,0,0,5,0,5
2014,Nigeria,NGA,Cyprus,CYP,5,0,0,0,5
2014,Pakistan,PAK,Cyprus,CYP,0,0,0,5,5
2014,Syrian Arab Rep.,SYR,Cyprus,CYP,11,0,0,5,16
2014,Togo,TGO,Cyprus,CYP,0,0,5,0,5
2014,Cuba,CUB,United Kingdom of Great Britain and Northern Ireland,GBR,0,0,0,10,10
2014,Haiti,HTI,United Kingdom of Great Britain and Northern Ireland,GBR,0,0,0,5,5
2014,Egypt,EGY,"China, Hong Kong SAR",HKG,14,0,0,0,14
2014,Bangladesh,BGD,"China, Hong Kong SAR",HKG,0,0,0,5,5
2014,Central African Rep.,CAF,"China, Hong Kong SAR",HKG,0,0,0,5,5
2014,Colombia,COL,"China, Hong Kong SAR",HKG,0,0,0,5,5
2014,Gambia,GMB,"China, Hong Kong SAR",HKG,5,0,0,0,5
2014,Guinea,GIN,"China, Hong Kong SAR",HKG,0,0,0,5,5
2014,India,IND,"China, Hong Kong SAR",HKG,5,0,5,12,22
2014,Indonesia,IDN,"China, Hong Kong SAR",HKG,0,0,5,46,51
2014,Kenya,KEN,"China, Hong Kong SAR",HKG,0,0,0,5,5
2014,Sri Lanka,LKA,"China, Hong Kong SAR",HKG,0,0,0,5,5
2014,Nigeria,NGA,"China, Hong Kong SAR",HKG,0,0,0,5,5
2014,Pakistan,PAK,"China, Hong Kong SAR",HKG,5,0,10,10,25
2014,Philippines,PHL,"China, Hong Kong SAR",HKG,5,0,0,12,17
2014,Rwanda,RWA,"China, Hong Kong SAR",HKG,12,0,0,5,17
2014,Somalia,SOM,"China, Hong Kong SAR",HKG,28,0,5,5,38
2014,Viet Nam,VNM,"China, Hong Kong SAR",HKG,0,0,0,25,25
2014,Uganda,UGA,"China, Hong Kong SAR",HKG,5,0,0,5,10
2014,Afghanistan,AFG,India,IND,543,0,338,415,1296
2014,Cameroon,CMR,India,IND,0,0,5,0,5
2014,Dem. Rep. of the Congo,COD,India,IND,5,0,11,5,21
2014,Ethiopia,ETH,India,IND,5,0,0,0,5
2014,Palestinian,PSE,India,IND,18,0,0,0,18
2014,Iran (Islamic Rep. of),IRN,India,IND,0,0,5,0,5
2014,Iraq,IRQ,India,IND,25,0,5,12,42
2014,Myanmar,MMR,India,IND,3660,0,201,142,4003
2014,Nigeria,NGA,India,IND,0,0,82,0,82
2014,Somalia,SOM,India,IND,41,0,5,0,46
2014,Sudan,SDN,India,IND,5,0,24,0,29
2014,Syrian Arab Rep.,SYR,India,IND,10,0,0,12,22
2014,Tunisia,TUN,India,IND,0,0,0,5,5
2014,Ukraine,UKR,India,IND,0,0,5,0,5
2014,Afghanistan,AFG,Indonesia,IDN,1023,0,174,1138,2335
2014,Egypt,EGY,Indonesia,IDN,12,0,0,5,17
2014,Bangladesh,BGD,Indonesia,IDN,0,0,5,90,95
2014,China,CHN,Indonesia,IDN,12,0,0,0,12
2014,Cameroon,CMR,Indonesia,IDN,0,0,0,5,5
2014,Dem. Rep. of the Congo,COD,Indonesia,IDN,5,0,0,5,10
2014,Eritrea,ERI,Indonesia,IDN,12,0,0,10,22
2014,Ethiopia,ETH,Indonesia,IDN,15,0,0,5,20
2014,Palestinian,PSE,Indonesia,IDN,129,0,0,40,169
2014,India,IND,Indonesia,IDN,0,0,0,5,5
2014,Iran (Islamic Rep. of),IRN,Indonesia,IDN,192,0,198,371,761
2014,Iraq,IRQ,Indonesia,IDN,118,0,13,163,294
2014,Kuwait,KWT,Indonesia,IDN,0,0,0,5,5
2014,Lebanon,LBN,Indonesia,IDN,0,0,0,5,5
2014,Sri Lanka,LKA,Indonesia,IDN,140,0,64,296,500
2014,Mali,MLI,Indonesia,IDN,0,0,0,5,5
2014,Myanmar,MMR,Indonesia,IDN,330,0,5,451,786
2014,Nepal,NPL,Indonesia,IDN,0,0,0,17,17
2014,Pakistan,PAK,Indonesia,IDN,125,0,10,352,487
2014,Somalia,SOM,Indonesia,IDN,197,0,0,116,313
2014,Sudan,SDN,Indonesia,IDN,103,0,10,87,200
2014,Syrian Arab Rep.,SYR,Indonesia,IDN,10,0,0,15,25
2014,Yemen,YEM,Indonesia,IDN,0,0,11,0,11
2014,Afghanistan,AFG,Iran (Islamic Rep. of),IRN,5,0,0,0,5
2014,Iran (Islamic Rep. of),IRN,Iraq,IRQ,97,0,5,56,158
2014,Syrian Arab Rep.,SYR,Iraq,IRQ,38,0,0,0,38
2014,Turkey,TUR,Iraq,IRQ,41,0,14,0,55
2014,Burundi,BDI,Israel,ISR,5,0,0,0,5
2014,Eritrea,ERI,Israel,ISR,141,0,0,0,141
2014,Iraq,IRQ,Israel,ISR,10,0,0,0,10
2014,Sudan,SDN,Israel,ISR,30,0,0,0,30
2014,South Sudan,SSD,Israel,ISR,41,0,0,0,41
2014,Afghanistan,AFG,Jordan,JOR,0,0,0,5,5
2014,Algeria,DZA,Jordan,JOR,0,0,0,5,5
2014,Egypt,EGY,Jordan,JOR,10,0,0,18,28
2014,Eritrea,ERI,Jordan,JOR,5,0,0,0,5
2014,Iraq,IRQ,Jordan,JOR,7440,0,44,61,7545
2014,Kuwait,KWT,Jordan,JOR,0,0,0,12,12
2014,Lebanon,LBN,Jordan,JOR,0,0,5,5,10
2014,Morocco,MAR,Jordan,JOR,0,0,0,5,5
2014,Pakistan,PAK,Jordan,JOR,5,0,0,0,5
2014,Saudi Arabia,SAU,Jordan,JOR,0,0,0,5,5
2014,Somalia,SOM,Jordan,JOR,166,0,5,5,176
2014,Sudan,SDN,Jordan,JOR,632,0,24,0,656
2014,Syrian Arab Rep.,SYR,Jordan,JOR,5401,0,5,660,6066
2014,Turkey,TUR,Jordan,JOR,0,0,0,10,10
2014,Yemen,YEM,Jordan,JOR,16,0,10,0,26
2014,Stateless,XXA,Jordan,JOR,0,0,0,38,38
2014,Afghanistan,AFG,Kazakhstan,KAZ,0,0,14,0,14
2014,Kyrgyzstan,KGZ,Kazakhstan,KAZ,0,0,5,0,5
2014,Uzbekistan,UZB,Kazakhstan,KAZ,0,0,0,5,5
2014,Burundi,BDI,Kenya,KEN,31,0,15,5206,5252
2014,Chad,TCD,Kenya,KEN,0,0,0,5,5
2014,Cameroon,CMR,Kenya,KEN,0,0,0,19,19
2014,Congo,COG,Kenya,KEN,0,0,0,32,32
2014,Dem. Rep. of the Congo,COD,Kenya,KEN,525,0,40,8193,8758
2014,Eritrea,ERI,Kenya,KEN,39,0,5,299,343
2014,Ethiopia,ETH,Kenya,KEN,372,0,316,7295,7983
2014,Cote d'Ivoire,CIV,Kenya,KEN,0,0,0,10,10
2014,Sri Lanka,LKA,Kenya,KEN,0,0,0,5,5
2014,Mozambique,MOZ,Kenya,KEN,0,0,0,5,5
2014,Nigeria,NGA,Kenya,KEN,0,0,0,12,12
2014,Rwanda,RWA,Kenya,KEN,5,0,12,464,481
2014,Somalia,SOM,Kenya,KEN,27,0,10,5173,5210
2014,Sudan,SDN,Kenya,KEN,14,0,0,5679,5693
2014,South Sudan,SSD,Kenya,KEN,5,0,0,26804,26809
2014,Syrian Arab Rep.,SYR,Kenya,KEN,0,0,0,12,12
2014,United Rep. of Tanzania,TZA,Kenya,KEN,5,0,0,14,19
2014,Uganda,UGA,Kenya,KEN,38,0,10,654,702
2014,Zimbabwe,ZWE,Kenya,KEN,0,0,0,5,5
2014,Afghanistan,AFG,Kyrgyzstan,KGZ,5,5,21,0,31
2014,Syrian Arab Rep.,SYR,Kyrgyzstan,KGZ,0,0,0,5,5
2014,Uzbekistan,UZB,Kyrgyzstan,KGZ,5,0,0,37,42
2014,Iran (Islamic Rep. of),IRN,Kuwait,KWT,0,0,5,5,10
2014,Iraq,IRQ,Kuwait,KWT,76,0,0,5,81
2014,Dem. Rep. of the Congo,COD,Libya,LBY,5,0,0,0,5
2014,Eritrea,ERI,Libya,LBY,10,0,0,0,10
2014,Palestinian,PSE,Libya,LBY,598,0,0,0,598
2014,Iraq,IRQ,Libya,LBY,5,0,0,0,5
2014,Jordan,JOR,Libya,LBY,0,0,0,5,5
2014,Sudan,SDN,Libya,LBY,5,0,0,0,5
2014,Afghanistan,AFG,Lebanon,LBN,0,0,11,5,16
2014,Egypt,EGY,Lebanon,LBN,19,0,46,21,86
2014,Bahrain,BHR,Lebanon,LBN,12,0,0,0,12
2014,Bangladesh,BGD,Lebanon,LBN,0,0,5,0,5
2014,Eritrea,ERI,Lebanon,LBN,10,0,15,5,30
2014,Ethiopia,ETH,Lebanon,LBN,0,0,33,11,44
2014,Cote d'Ivoire,CIV,Lebanon,LBN,0,0,0,5,5
2014,Iran (Islamic Rep. of),IRN,Lebanon,LBN,5,0,33,5,43
2014,Iraq,IRQ,Lebanon,LBN,1608,0,83,187,1878
2014,Jordan,JOR,Lebanon,LBN,5,0,24,5,34
2014,Kenya,KEN,Lebanon,LBN,5,0,0,0,5
2014,Kuwait,KWT,Lebanon,LBN,0,0,0,5,5
2014,Madagascar,MDG,Lebanon,LBN,0,0,16,5,21
2014,Somalia,SOM,Lebanon,LBN,0,0,13,0,13
2014,Sudan,SDN,Lebanon,LBN,195,0,330,60,585
2014,South Sudan,SSD,Lebanon,LBN,26,0,0,0,26
2014,Syrian Arab Rep.,SYR,Lebanon,LBN,6733,0,0,0,6733
2014,Tunisia,TUN,Lebanon,LBN,0,0,0,5,5
2014,Turkey,TUR,Lebanon,LBN,5,0,0,0,5
2014,Yemen,YEM,Lebanon,LBN,0,0,5,5,10
2014,Afghanistan,AFG,Sri Lanka,LKA,34,0,0,88,122
2014,Palestinian,PSE,Sri Lanka,LKA,17,0,0,0,17
2014,Iran (Islamic Rep. of),IRN,Sri Lanka,LKA,5,0,5,0,10
2014,Maldives,MDV,Sri Lanka,LKA,0,0,0,5,5
2014,Myanmar,MMR,Sri Lanka,LKA,96,0,0,0,96
2014,Pakistan,PAK,Sri Lanka,LKA,301,0,142,467,910
2014,Syrian Arab Rep.,SYR,Sri Lanka,LKA,5,0,0,0,5
2014,Afghanistan,AFG,Malaysia,MYS,57,0,18,45,120
2014,Algeria,DZA,Malaysia,MYS,5,0,0,0,5
2014,Egypt,EGY,Malaysia,MYS,0,0,12,5,17
2014,Bangladesh,BGD,Malaysia,MYS,0,0,11,0,11
2014,Cambodia,KHM,Malaysia,MYS,13,0,0,0,13
2014,China,CHN,Malaysia,MYS,0,0,0,14,14
2014,Palestinian,PSE,Malaysia,MYS,58,0,10,19,87
2014,Guinea,GIN,Malaysia,MYS,0,0,0,5,5
2014,Indonesia,IDN,Malaysia,MYS,90,0,5,5,100
2014,Iran (Islamic Rep. of),IRN,Malaysia,MYS,97,0,59,54,210
2014,Iraq,IRQ,Malaysia,MYS,114,0,5,91,210
2014,Liberia,LBR,Malaysia,MYS,5,0,0,0,5
2014,Lebanon,LBN,Malaysia,MYS,5,0,0,0,5
2014,Sri Lanka,LKA,Malaysia,MYS,124,0,475,468,1067
2014,Mali,MLI,Malaysia,MYS,5,0,5,0,10
2014,Myanmar,MMR,Malaysia,MYS,11072,0,395,2837,14304
2014,Nigeria,NGA,Malaysia,MYS,0,0,0,5,5
2014,Pakistan,PAK,Malaysia,MYS,99,0,221,118,438
2014,Sierra Leone,SLE,Malaysia,MYS,0,0,5,0,5
2014,Somalia,SOM,Malaysia,MYS,121,0,49,71,241
2014,Sudan,SDN,Malaysia,MYS,18,0,5,17,40
2014,Syrian Arab Rep.,SYR,Malaysia,MYS,377,0,5,63,445
2014,Thailand,THA,Malaysia,MYS,5,0,0,65,70
2014,Tunisia,TUN,Malaysia,MYS,0,0,5,0,5
2014,Yemen,YEM,Malaysia,MYS,10,0,0,54,64
2014,China,CHN,Mongolia,MNG,0,0,0,5,5
2014,Syrian Arab Rep.,SYR,Mongolia,MNG,5,0,0,0,5
2014,Algeria,DZA,Morocco,MAR,0,0,0,5,5
2014,Angola,AGO,Morocco,MAR,0,0,0,5,5
2014,Benin,BEN,Morocco,MAR,0,0,5,16,21
2014,Bangladesh,BGD,Morocco,MAR,0,0,0,5,5
2014,Burkina Faso,BFA,Morocco,MAR,0,0,5,5,10
2014,Central African Rep.,CAF,Morocco,MAR,0,0,5,53,58
2014,Chad,TCD,Morocco,MAR,0,0,0,10,10
2014,Cameroon,CMR,Morocco,MAR,10,0,63,243,316
2014,Congo,COG,Morocco,MAR,5,0,27,35,67
2014,Dem. Rep. of the Congo,COD,Morocco,MAR,15,0,189,76,280
2014,Eritrea,ERI,Morocco,MAR,0,0,0,5,5
2014,Gabon,GAB,Morocco,MAR,0,0,5,0,5
2014,Gambia,GMB,Morocco,MAR,0,0,5,17,22
2014,Palestinian,PSE,Morocco,MAR,0,0,0,15,15
2014,Ghana,GHA,Morocco,MAR,0,0,10,35,45
2014,Guinea-Bissau,GNB,Morocco,MAR,0,0,0,5,5
2014,Guinea,GIN,Morocco,MAR,5,0,25,72,102
2014,Cote d'Ivoire,CIV,Morocco,MAR,10,0,149,247,406
2014,Iraq,IRQ,Morocco,MAR,5,0,0,14,19
2014,Kenya,KEN,Morocco,MAR,0,0,5,12,17
2014,Liberia,LBR,Morocco,MAR,0,0,12,38,50
2014,Libya,LBY,Morocco,MAR,0,0,0,5,5
2014,Mali,MLI,Morocco,MAR,0,0,10,373,383
2014,Niger,NER,Morocco,MAR,0,0,5,25,30
2014,Nigeria,NGA,Morocco,MAR,5,0,117,508,630
2014,Rwanda,RWA,Morocco,MAR,0,0,0,5,5
2014,Senegal,SEN,Morocco,MAR,5,0,0,16,21
2014,Sierra Leone,SLE,Morocco,MAR,0,0,5,39,44
2014,Somalia,SOM,Morocco,MAR,0,0,5,27,32
2014,Sudan,SDN,Morocco,MAR,0,0,10,58,68
2014,Togo,TGO,Morocco,MAR,0,0,5,5,10
2014,Uganda,UGA,Morocco,MAR,0,0,5,19,24
2014,Zambia,ZMB,Morocco,MAR,0,0,0,5,5
2014,Zimbabwe,ZWE,Morocco,MAR,0,0,0,5,5
2014,Afghanistan,AFG,Nepal,NPL,14,0,0,0,14
2014,Iran (Islamic Rep. of),IRN,Nepal,NPL,5,0,0,0,5
2014,Sri Lanka,LKA,Nepal,NPL,5,0,0,0,5
2014,Myanmar,MMR,Nepal,NPL,24,0,0,5,29
2014,Pakistan,PAK,Nepal,NPL,85,0,91,26,202
2014,Somalia,SOM,Nepal,NPL,5,0,0,0,5
2014,Iraq,IRQ,Oman,OMN,10,0,0,0,10
2014,Afghanistan,AFG,Pakistan,PAK,1833,0,3202,248,5283
2014,Palestinian,PSE,Pakistan,PAK,13,0,0,0,13
2014,Iran (Islamic Rep. of),IRN,Pakistan,PAK,0,0,0,14,14
2014,Myanmar,MMR,Pakistan,PAK,10,0,0,0,10
2014,Nigeria,NGA,Pakistan,PAK,0,0,10,0,10
2014,Somalia,SOM,Pakistan,PAK,31,0,10,0,41
2014,Syrian Arab Rep.,SYR,Pakistan,PAK,5,0,0,0,5
2014,Uzbekistan,UZB,Pakistan,PAK,0,0,0,5,5
2014,Syrian Arab Rep.,SYR,Qatar,QAT,5,0,0,0,5
2014,Pakistan,PAK,Saudi Arabia,SAU,5,0,0,0,5
2014,Syrian Arab Rep.,SYR,Saudi Arabia,SAU,5,0,0,0,5
2014,Fiji,FJI,Solomon Islands,SLB,5,0,0,0,5
2014,Eritrea,ERI,Somalia,SOM,0,0,0,11,11
2014,Ethiopia,ETH,Somalia,SOM,208,0,172,809,1189
2014,Yemen,YEM,Somalia,SOM,0,0,0,5,5
2014,Egypt,EGY,Sudan,SDN,14,0,0,0,14
2014,Armenia,ARM,Sudan,SDN,5,0,0,0,5
2014,Dem. Rep. of the Congo,COD,Sudan,SDN,5,0,0,0,5
2014,Eritrea,ERI,Sudan,SDN,149,0,0,0,149
2014,Ethiopia,ETH,Sudan,SDN,181,0,0,0,181
2014,Palestinian,PSE,Sudan,SDN,0,0,0,10,10
2014,Somalia,SOM,Sudan,SDN,5,0,0,0,5
2014,Afghanistan,AFG,Syrian Arab Rep.,SYR,121,0,0,0,121
2014,Albania,ALB,Syrian Arab Rep.,SYR,0,0,0,5,5
2014,Algeria,DZA,Syrian Arab Rep.,SYR,0,0,48,0,48
2014,Egypt,EGY,Syrian Arab Rep.,SYR,0,0,60,0,60
2014,Burkina Faso,BFA,Syrian Arab Rep.,SYR,11,0,0,0,11
2014,Ethiopia,ETH,Syrian Arab Rep.,SYR,0,0,0,5,5
2014,Palestinian,PSE,Syrian Arab Rep.,SYR,0,0,0,17,17
2014,Guinea,GIN,Syrian Arab Rep.,SYR,5,0,12,0,17
2014,Cote d'Ivoire,CIV,Syrian Arab Rep.,SYR,0,0,0,5,5
2014,Iran (Islamic Rep. of),IRN,Syrian Arab Rep.,SYR,0,0,132,14,146
2014,Iraq,IRQ,Syrian Arab Rep.,SYR,312,0,15,112,439
2014,Jordan,JOR,Syrian Arab Rep.,SYR,0,0,17,5,22
2014,Lebanon,LBN,Syrian Arab Rep.,SYR,5,0,117,5,127
2014,Sri Lanka,LKA,Syrian Arab Rep.,SYR,0,0,5,0,5
2014,Morocco,MAR,Syrian Arab Rep.,SYR,0,0,5,0,5
2014,Pakistan,PAK,Syrian Arab Rep.,SYR,16,0,10,0,26
2014,Philippines,PHL,Syrian Arab Rep.,SYR,0,0,30,0,30
2014,Sierra Leone,SLE,Syrian Arab Rep.,SYR,0,0,5,0,5
2014,Somalia,SOM,Syrian Arab Rep.,SYR,5,0,0,16,21
2014,Sudan,SDN,Syrian Arab Rep.,SYR,57,0,46,159,262
2014,South Sudan,SSD,Syrian Arab Rep.,SYR,0,0,0,15,15
2014,United Rep. of Tanzania,TZA,Syrian Arab Rep.,SYR,0,0,5,0,5
2014,Tunisia,TUN,Syrian Arab Rep.,SYR,0,0,14,5,19
2014,Yemen,YEM,Syrian Arab Rep.,SYR,0,0,13,21,34
2014,Afghanistan,AFG,Thailand,THA,12,0,0,0,12
2014,Egypt,EGY,Thailand,THA,0,0,0,10,10
2014,Cambodia,KHM,Thailand,THA,39,0,0,5,44
2014,China,CHN,Thailand,THA,42,0,11,15,68
2014,Cameroon,CMR,Thailand,THA,0,0,0,5,5
2014,Palestinian,PSE,Thailand,THA,230,0,5,41,276
2014,Cote d'Ivoire,CIV,Thailand,THA,5,0,0,0,5
2014,Iran (Islamic Rep. of),IRN,Thailand,THA,14,0,19,25,58
2014,Iraq,IRQ,Thailand,THA,5,0,0,12,17
2014,Jordan,JOR,Thailand,THA,5,0,0,0,5
2014,Libya,LBY,Thailand,THA,0,0,0,5,5
2014,Sri Lanka,LKA,Thailand,THA,21,0,0,5,26
2014,Nepal,NPL,Thailand,THA,0,0,0,5,5
2014,Pakistan,PAK,Thailand,THA,291,0,334,195,820
2014,Somalia,SOM,Thailand,THA,30,0,0,16,46
2014,Viet Nam,VNM,Thailand,THA,10,0,5,22,37
2014,Sudan,SDN,Thailand,THA,0,0,0,5,5
2014,Syrian Arab Rep.,SYR,Thailand,THA,72,0,0,61,133
2014,Afghanistan,AFG,Tajikistan,TJK,214,0,104,0,318
2014,Iran (Islamic Rep. of),IRN,Tajikistan,TJK,5,0,0,0,5
2014,Bangladesh,BGD,Trinidad and Tobago,TTO,13,0,0,0,13
2014,Colombia,COL,Trinidad and Tobago,TTO,10,0,0,0,10
2014,Cuba,CUB,Trinidad and Tobago,TTO,38,0,17,35,90
2014,Sri Lanka,LKA,Trinidad and Tobago,TTO,5,0,0,0,5
2014,Mexico,MEX,Trinidad and Tobago,TTO,5,0,0,0,5
2014,Pakistan,PAK,Trinidad and Tobago,TTO,5,0,0,0,5
2014,Syrian Arab Rep.,SYR,Trinidad and Tobago,TTO,10,0,0,0,10
2014,Cameroon,CMR,Tunisia,TUN,0,0,5,0,5
2014,Dem. Rep. of the Congo,COD,Tunisia,TUN,5,0,0,5,10
2014,Eritrea,ERI,Tunisia,TUN,43,0,5,46,94
2014,Ethiopia,ETH,Tunisia,TUN,12,0,0,20,32
2014,Palestinian,PSE,Tunisia,TUN,5,0,0,12,17
2014,Cote d'Ivoire,CIV,Tunisia,TUN,0,0,71,132,203
2014,Iraq,IRQ,Tunisia,TUN,10,0,0,0,10
2014,Libya,LBY,Tunisia,TUN,0,0,0,5,5
2014,Mali,MLI,Tunisia,TUN,0,0,0,5,5
2014,Somalia,SOM,Tunisia,TUN,14,0,13,10,37
2014,Sudan,SDN,Tunisia,TUN,5,0,24,20,49
2014,Afghanistan,AFG,Turkey,TUR,546,0,0,4345,4891
2014,Algeria,DZA,Turkey,TUR,0,0,0,11,11
2014,Angola,AGO,Turkey,TUR,0,0,0,5,5
2014,Egypt,EGY,Turkey,TUR,5,0,5,52,62
2014,Azerbaijan,AZE,Turkey,TUR,5,0,0,0,5
2014,Burundi,BDI,Turkey,TUR,5,0,0,0,5
2014,Bangladesh,BGD,Turkey,TUR,0,0,0,64,64
2014,Central African Rep.,CAF,Turkey,TUR,0,0,0,13,13
2014,China,CHN,Turkey,TUR,0,0,0,10,10
2014,Cameroon,CMR,Turkey,TUR,5,0,5,108,118
2014,Congo,COG,Turkey,TUR,10,0,5,19,34
2014,Dem. Rep. of the Congo,COD,Turkey,TUR,20,0,12,77,109
2014,Eritrea,ERI,Turkey,TUR,19,0,0,35,54
2014,Ethiopia,ETH,Turkey,TUR,14,0,0,49,63
2014,Gabon,GAB,Turkey,TUR,0,0,0,5,5
2014,Gambia,GMB,Turkey,TUR,0,0,5,0,5
2014,Palestinian,PSE,Turkey,TUR,322,0,0,64,386
2014,Ghana,GHA,Turkey,TUR,0,0,0,28,28
2014,Guinea,GIN,Turkey,TUR,0,0,0,12,12
2014,Cote d'Ivoire,CIV,Turkey,TUR,10,0,5,38,53
2014,India,IND,Turkey,TUR,0,0,0,5,5
2014,Iran (Islamic Rep. of),IRN,Turkey,TUR,2361,0,658,441,3460
2014,Iraq,IRQ,Turkey,TUR,10174,0,30,4836,15040
2014,Jordan,JOR,Turkey,TUR,14,0,0,0,14
2014,Kazakhstan,KAZ,Turkey,TUR,0,0,0,13,13
2014,Kenya,KEN,Turkey,TUR,0,0,5,0,5
2014,Kyrgyzstan,KGZ,Turkey,TUR,0,0,0,14,14
2014,Libya,LBY,Turkey,TUR,12,0,0,5,17
2014,Lebanon,LBN,Turkey,TUR,0,0,0,14,14
2014,Mali,MLI,Turkey,TUR,5,0,0,67,72
2014,Mongolia,MNG,Turkey,TUR,0,0,0,23,23
2014,Morocco,MAR,Turkey,TUR,13,0,0,10,23
2014,Myanmar,MMR,Turkey,TUR,0,0,0,10,10
2014,Niger,NER,Turkey,TUR,0,0,0,10,10
2014,Nigeria,NGA,Turkey,TUR,5,0,10,45,60
2014,Pakistan,PAK,Turkey,TUR,5,0,0,306,311
2014,Senegal,SEN,Turkey,TUR,0,0,0,22,22
2014,Sierra Leone,SLE,Turkey,TUR,0,0,5,0,5
2014,Somalia,SOM,Turkey,TUR,371,0,5,131,507
2014,Sudan,SDN,Turkey,TUR,43,0,10,45,98
2014,Syrian Arab Rep.,SYR,Turkey,TUR,8230,0,0,0,8230
2014,Tajikistan,TJK,Turkey,TUR,5,0,0,32,37
2014,Turkmenistan,TKM,Turkey,TUR,0,0,10,38,48
2014,Togo,TGO,Turkey,TUR,0,0,0,5,5
2014,Tunisia,TUN,Turkey,TUR,5,0,0,5,10
2014,Uganda,UGA,Turkey,TUR,16,0,14,135,165
2014,Uzbekistan,UZB,Turkey,TUR,10,0,10,74,94
2014,Yemen,YEM,Turkey,TUR,10,0,14,84,108
2014,Stateless,XXA,Turkey,TUR,50,0,0,0,50
2014,Afghanistan,AFG,Ukraine,UKR,18,0,11,5,34
2014,Dem. Rep. of the Congo,COD,Ukraine,UKR,5,0,0,5,10
2014,Iran (Islamic Rep. of),IRN,Ukraine,UKR,0,0,0,5,5
2014,Iraq,IRQ,Ukraine,UKR,0,0,0,5,5
2014,Russian Federation,RUS,Ukraine,UKR,0,0,0,14,14
2014,Somalia,SOM,Ukraine,UKR,5,0,0,5,10
2014,Syrian Arab Rep.,SYR,Ukraine,UKR,0,0,0,5,5
2014,Turkey,TUR,Ukraine,UKR,0,0,0,5,5
2014,Uzbekistan,UZB,Ukraine,UKR,0,0,0,5,5
2014,Eritrea,ERI,Yemen,YEM,266,0,5,42,313
2014,Ethiopia,ETH,Yemen,YEM,116,0,455,1380,1951
2014,Palestinian,PSE,Yemen,YEM,5,0,0,13,18
2014,Iraq,IRQ,Yemen,YEM,5,0,0,10,15
2014,Nigeria,NGA,Yemen,YEM,0,0,0,5,5
2014,Sudan,SDN,Yemen,YEM,5,0,0,0,5
2014,Syrian Arab Rep.,SYR,Yemen,YEM,0,0,0,1065,1065
2014,Colombia,COL,Curacao ,CUW,17,0,0,5,22
2014,Cuba,CUB,Curacao ,CUW,0,0,14,5,19
2015,Iran (Islamic Rep. of),IRN,Afghanistan,AFG,0,0,5,5,10
2015,Pakistan,PAK,Afghanistan,AFG,90,0,0,0,90
2015,Burkina Faso,BFA,Algeria,DZA,0,0,5,5,10
2015,Central African Rep.,CAF,Algeria,DZA,18,0,5,28,51
2015,Chad,TCD,Algeria,DZA,0,0,10,0,10
2015,Cameroon,CMR,Algeria,DZA,0,0,27,11,38
2015,Congo,COG,Algeria,DZA,0,0,0,5,5
2015,Dem. Rep. of the Congo,COD,Algeria,DZA,10,0,21,10,41
2015,Palestinian,PSE,Algeria,DZA,0,0,0,307,307
2015,Guinea,GIN,Algeria,DZA,0,0,57,25,82
2015,Cote d'Ivoire,CIV,Algeria,DZA,5,0,50,26,81
2015,Iraq,IRQ,Algeria,DZA,5,0,0,0,5
2015,Liberia,LBR,Algeria,DZA,0,0,10,0,10
2015,Libya,LBY,Algeria,DZA,13,0,0,5,18
2015,Mali,MLI,Algeria,DZA,14,0,135,63,212
2015,Nigeria,NGA,Algeria,DZA,0,0,5,13,18
2015,Sierra Leone,SLE,Algeria,DZA,0,0,0,5,5
2015,Sudan,SDN,Algeria,DZA,0,0,0,12,12
2015,Syrian Arab Rep.,SYR,Algeria,DZA,0,0,0,16,16
2015,Togo,TGO,Algeria,DZA,0,0,5,0,5
2015,Angola,AGO,Egypt,EGY,0,0,0,5,5
2015,Bangladesh,BGD,Egypt,EGY,0,0,0,5,5
2015,Belarus,BLR,Egypt,EGY,0,0,0,5,5
2015,Chad,TCD,Egypt,EGY,5,0,0,11,16
2015,Congo,COG,Egypt,EGY,0,0,5,0,5
2015,Dem. Rep. of the Congo,COD,Egypt,EGY,0,0,0,5,5
2015,Djibouti,DJI,Egypt,EGY,0,0,5,0,5
2015,Eritrea,ERI,Egypt,EGY,188,23,11,89,311
2015,Ethiopia,ETH,Egypt,EGY,168,35,107,0,310
2015,Palestinian,PSE,Egypt,EGY,0,0,0,13,13
2015,Guinea,GIN,Egypt,EGY,0,0,0,11,11
2015,Cote d'Ivoire,CIV,Egypt,EGY,0,0,0,12,12
2015,Iraq,IRQ,Egypt,EGY,197,87,5,79,368
2015,Kazakhstan,KAZ,Egypt,EGY,0,0,0,5,5
2015,Myanmar,MMR,Egypt,EGY,0,0,0,5,5
2015,Nigeria,NGA,Egypt,EGY,0,0,40,0,40
2015,Russian Federation,RUS,Egypt,EGY,0,0,51,0,51
2015,Somalia,SOM,Egypt,EGY,201,80,5,0,286
2015,Sudan,SDN,Egypt,EGY,2189,357,617,1752,4915
2015,South Sudan,SSD,Egypt,EGY,1160,49,0,0,1209
2015,Syrian Arab Rep.,SYR,Egypt,EGY,2415,0,0,0,2415
2015,Tajikistan,TJK,Egypt,EGY,0,0,16,0,16
2015,Turkmenistan,TKM,Egypt,EGY,0,0,12,0,12
2015,Uganda,UGA,Egypt,EGY,0,0,0,5,5
2015,Uzbekistan,UZB,Egypt,EGY,0,0,62,0,62
2015,Yemen,YEM,Egypt,EGY,10,5,0,16,31
2015,Afghanistan,AFG,Azerbaijan,AZE,76,0,60,30,166
2015,Bangladesh,BGD,Azerbaijan,AZE,0,0,0,5,5
2015,India,IND,Azerbaijan,AZE,0,0,5,0,5
2015,Iran (Islamic Rep. of),IRN,Azerbaijan,AZE,0,0,14,0,14
2015,Iraq,IRQ,Azerbaijan,AZE,11,0,0,0,11
2015,Nepal,NPL,Azerbaijan,AZE,0,0,5,0,5
2015,Pakistan,PAK,Azerbaijan,AZE,0,0,159,42,201
2015,Russian Federation,RUS,Azerbaijan,AZE,15,0,5,15,35
2015,Syrian Arab Rep.,SYR,Azerbaijan,AZE,5,0,0,0,5
2015,Ukraine,UKR,Azerbaijan,AZE,17,0,5,0,22
2015,Yemen,YEM,Azerbaijan,AZE,5,0,0,0,5
2015,Myanmar,MMR,Bangladesh,BGD,0,0,5,5,10
2015,Somalia,SOM,Bangladesh,BGD,0,0,0,5,5
2015,Cameroon,CMR,China,CHN,0,0,0,10,10
2015,Congo,COG,China,CHN,0,0,5,0,5
2015,Dem. Rep. of the Congo,COD,China,CHN,5,0,0,5,10
2015,Gambia,GMB,China,CHN,0,0,0,5,5
2015,Ghana,GHA,China,CHN,0,0,0,5,5
2015,Guinea,GIN,China,CHN,0,0,5,11,16
2015,Cote d'Ivoire,CIV,China,CHN,0,0,0,5,5
2015,Iraq,IRQ,China,CHN,0,0,0,5,5
2015,Kenya,KEN,China,CHN,0,0,0,5,5
2015,Liberia,LBR,China,CHN,0,0,5,13,18
2015,Mali,MLI,China,CHN,0,0,5,0,5
2015,Niger,NER,China,CHN,0,0,0,5,5
2015,Nigeria,NGA,China,CHN,0,0,28,39,67
2015,Philippines,PHL,China,CHN,0,0,10,0,10
2015,Sierra Leone,SLE,China,CHN,0,0,5,12,17
2015,Somalia,SOM,China,CHN,24,0,5,5,34
2015,Syrian Arab Rep.,SYR,China,CHN,10,0,0,0,10
2015,Uganda,UGA,China,CHN,0,0,0,11,11
2015,Zimbabwe,ZWE,China,CHN,0,0,5,0,5
2015,Burkina Faso,BFA,Cameroon,CMR,0,0,5,5,10
2015,Central African Rep.,CAF,Cameroon,CMR,5342,0,127,4202,9671
2015,Chad,TCD,Cameroon,CMR,10,0,151,151,312
2015,Congo,COG,Cameroon,CMR,0,0,0,5,5
2015,Dem. Rep. of the Congo,COD,Cameroon,CMR,35,0,154,89,278
2015,Equatorial Guinea,GNQ,Cameroon,CMR,0,0,0,5,5
2015,Gambia,GMB,Cameroon,CMR,0,0,5,10,15
2015,Guinea-Bissau,GNB,Cameroon,CMR,0,0,20,37,57
2015,Guinea,GIN,Cameroon,CMR,0,0,102,290,392
2015,Cote d'Ivoire,CIV,Cameroon,CMR,10,0,48,111,169
2015,Liberia,LBR,Cameroon,CMR,5,0,0,0,5
2015,Mauritania,MRT,Cameroon,CMR,0,0,0,10,10
2015,Mali,MLI,Cameroon,CMR,0,0,5,35,40
2015,Nigeria,NGA,Cameroon,CMR,14,0,0,15,29
2015,Rwanda,RWA,Cameroon,CMR,16,0,67,40,123
2015,Senegal,SEN,Cameroon,CMR,0,0,36,79,115
2015,Sierra Leone,SLE,Cameroon,CMR,0,0,5,10,15
2015,Sudan,SDN,Cameroon,CMR,83,0,5,60,148
2015,South Sudan,SSD,Cameroon,CMR,5,0,0,0,5
2015,Syrian Arab Rep.,SYR,Cameroon,CMR,15,0,0,0,15
2015,Togo,TGO,Cameroon,CMR,0,0,0,5,5
2015,India,IND,Micronesia (Federated States of),FSM,0,0,14,0,14
2015,Nepal,NPL,Micronesia (Federated States of),FSM,5,0,10,0,15
2015,Somalia,SOM,"China, Hong Kong SAR",HKG,5,0,0,0,5
2015,Afghanistan,AFG,India,IND,187,0,655,619,1461
2015,Cameroon,CMR,India,IND,0,0,17,5,22
2015,Dem. Rep. of the Congo,COD,India,IND,0,0,10,11,21
2015,Eritrea,ERI,India,IND,12,0,0,0,12
2015,Ethiopia,ETH,India,IND,5,0,0,0,5
2015,Palestinian,PSE,India,IND,13,0,0,5,18
2015,Cote d'Ivoire,CIV,India,IND,0,0,0,5,5
2015,Iran (Islamic Rep. of),IRN,India,IND,0,0,0,5,5
2015,Iraq,IRQ,India,IND,197,0,5,54,256
2015,Mexico,MEX,India,IND,0,0,5,0,5
2015,Myanmar,MMR,India,IND,2141,0,126,681,2948
2015,Nigeria,NGA,India,IND,0,0,222,156,378
2015,Somalia,SOM,India,IND,39,0,60,0,99
2015,Sudan,SDN,India,IND,17,0,17,13,47
2015,Syrian Arab Rep.,SYR,India,IND,19,0,0,0,19
2015,Uganda,UGA,India,IND,0,0,10,0,10
2015,Ukraine,UKR,India,IND,0,0,5,0,5
2015,Uzbekistan,UZB,India,IND,0,0,0,5,5
2015,Yemen,YEM,India,IND,0,0,0,5,5
2015,Afghanistan,AFG,Indonesia,IDN,1462,0,59,171,1692
2015,Egypt,EGY,Indonesia,IDN,0,0,0,5,5
2015,Bangladesh,BGD,Indonesia,IDN,0,0,5,60,65
2015,China,CHN,Indonesia,IDN,0,0,0,5,5
2015,Cameroon,CMR,Indonesia,IDN,0,0,5,0,5
2015,Eritrea,ERI,Indonesia,IDN,5,0,0,0,5
2015,Ethiopia,ETH,Indonesia,IDN,19,0,5,0,24
2015,Palestinian,PSE,Indonesia,IDN,96,0,0,0,96
2015,Ghana,GHA,Indonesia,IDN,0,0,0,5,5
2015,Cote d'Ivoire,CIV,Indonesia,IDN,0,0,0,5,5
2015,India,IND,Indonesia,IDN,0,0,0,10,10
2015,Iran (Islamic Rep. of),IRN,Indonesia,IDN,133,0,107,68,308
2015,Iraq,IRQ,Indonesia,IDN,108,0,0,133,241
2015,Kuwait,KWT,Indonesia,IDN,5,0,0,0,5
2015,Sri Lanka,LKA,Indonesia,IDN,60,0,33,53,146
2015,Myanmar,MMR,Indonesia,IDN,58,0,0,608,666
2015,Nepal,NPL,Indonesia,IDN,0,0,0,5,5
2015,Nigeria,NGA,Indonesia,IDN,0,0,0,11,11
2015,Pakistan,PAK,Indonesia,IDN,138,0,10,15,163
2015,Somalia,SOM,Indonesia,IDN,159,0,5,29,193
2015,Sudan,SDN,Indonesia,IDN,52,0,10,20,82
2015,Syrian Arab Rep.,SYR,Indonesia,IDN,19,0,0,11,30
2015,Yemen,YEM,Indonesia,IDN,5,0,0,5,10
2015,Myanmar,MMR,Iran (Islamic Rep. of),IRN,5,0,0,0,5
2015,Algeria,DZA,Iraq,IRQ,0,0,0,5,5
2015,Palestinian,PSE,Iraq,IRQ,0,23,0,0,23
2015,Iran (Islamic Rep. of),IRN,Iraq,IRQ,5,5,0,76,86
2015,Jordan,JOR,Iraq,IRQ,0,10,0,0,10
2015,Kuwait,KWT,Iraq,IRQ,0,0,0,5,5
2015,Monaco,MCO,Iraq,IRQ,0,0,0,5,5
2015,Syrian Arab Rep.,SYR,Iraq,IRQ,5,393,0,827,1225
2015,Turkey,TUR,Iraq,IRQ,5,0,0,0,5
2015,Eritrea,ERI,Israel,ISR,100,0,0,0,100
2015,Ethiopia,ETH,Israel,ISR,5,0,0,0,5
2015,Sudan,SDN,Israel,ISR,32,0,0,0,32
2015,South Sudan,SSD,Israel,ISR,28,0,0,0,28
2015,Egypt,EGY,Jordan,JOR,11,0,5,0,16
2015,Eritrea,ERI,Jordan,JOR,10,0,0,0,10
2015,Iran (Islamic Rep. of),IRN,Jordan,JOR,5,0,0,0,5
2015,Iraq,IRQ,Jordan,JOR,4449,0,14,10,4473
2015,Lebanon,LBN,Jordan,JOR,0,0,5,0,5
2015,Somalia,SOM,Jordan,JOR,38,0,5,0,43
2015,Sudan,SDN,Jordan,JOR,1184,0,32,0,1216
2015,Syrian Arab Rep.,SYR,Jordan,JOR,7367,0,0,46,7413
2015,Yemen,YEM,Jordan,JOR,32,0,0,0,32
2015,Stateless,XXA,Jordan,JOR,0,0,0,13,13
2015,Afghanistan,AFG,Kazakhstan,KAZ,0,0,0,18,18
2015,Kyrgyzstan,KGZ,Kazakhstan,KAZ,0,0,5,0,5
2015,Syrian Arab Rep.,SYR,Kazakhstan,KAZ,10,0,0,0,10
2015,Afghanistan,AFG,Kyrgyzstan,KGZ,5,0,0,0,5
2015,Uzbekistan,UZB,Kyrgyzstan,KGZ,10,0,0,13,23
2015,Iraq,IRQ,Kuwait,KWT,48,0,0,10,58
2015,Somalia,SOM,Kuwait,KWT,288,0,0,10,298
2015,Eritrea,ERI,Libya,LBY,5,0,0,34,39
2015,Ethiopia,ETH,Libya,LBY,0,0,0,5,5
2015,Iraq,IRQ,Libya,LBY,0,0,0,10,10
2015,Sudan,SDN,Libya,LBY,0,0,0,24,24
2015,Egypt,EGY,Lebanon,LBN,22,0,21,0,43
2015,Bahrain,BHR,Lebanon,LBN,11,0,0,0,11
2015,Bangladesh,BGD,Lebanon,LBN,0,0,5,0,5
2015,Dem. Rep. of the Congo,COD,Lebanon,LBN,5,0,0,0,5
2015,Eritrea,ERI,Lebanon,LBN,10,0,5,0,15
2015,Ethiopia,ETH,Lebanon,LBN,10,0,27,31,68
2015,Palestinian,PSE,Lebanon,LBN,5,0,0,19,24
2015,Cote d'Ivoire,CIV,Lebanon,LBN,0,0,5,0,5
2015,Iran (Islamic Rep. of),IRN,Lebanon,LBN,5,0,5,15,25
2015,Iraq,IRQ,Lebanon,LBN,1465,0,17,1165,2647
2015,Jordan,JOR,Lebanon,LBN,5,0,12,16,33
2015,Kenya,KEN,Lebanon,LBN,0,0,0,10,10
2015,Kuwait,KWT,Lebanon,LBN,0,0,0,10,10
2015,Libya,LBY,Lebanon,LBN,0,0,0,5,5
2015,Sri Lanka,LKA,Lebanon,LBN,0,0,5,5,10
2015,Madagascar,MDG,Lebanon,LBN,0,0,5,0,5
2015,Morocco,MAR,Lebanon,LBN,0,0,0,5,5
2015,Nigeria,NGA,Lebanon,LBN,0,0,10,0,10
2015,Pakistan,PAK,Lebanon,LBN,0,0,0,10,10
2015,Philippines,PHL,Lebanon,LBN,0,0,5,14,19
2015,Saudi Arabia,SAU,Lebanon,LBN,0,0,0,5,5
2015,Somalia,SOM,Lebanon,LBN,14,0,0,0,14
2015,Sudan,SDN,Lebanon,LBN,305,0,310,78,693
2015,South Sudan,SSD,Lebanon,LBN,28,0,0,0,28
2015,Syrian Arab Rep.,SYR,Lebanon,LBN,9062,0,0,399,9461
2015,Ukraine,UKR,Lebanon,LBN,0,0,0,5,5
2015,Yemen,YEM,Lebanon,LBN,10,0,0,0,10
2015,Afghanistan,AFG,Sri Lanka,LKA,88,0,5,5,98
2015,Iran (Islamic Rep. of),IRN,Sri Lanka,LKA,5,0,0,0,5
2015,Myanmar,MMR,Sri Lanka,LKA,12,0,0,0,12
2015,Pakistan,PAK,Sri Lanka,LKA,404,0,166,234,804
2015,Afghanistan,AFG,Malaysia,MYS,51,0,5,63,119
2015,Egypt,EGY,Malaysia,MYS,0,0,5,5,10
2015,Bangladesh,BGD,Malaysia,MYS,0,0,10,0,10
2015,Cambodia,KHM,Malaysia,MYS,5,0,0,0,5
2015,Central African Rep.,CAF,Malaysia,MYS,5,0,0,0,5
2015,China,CHN,Malaysia,MYS,5,0,0,10,15
2015,Congo,COG,Malaysia,MYS,0,0,0,5,5
2015,Palestinian,PSE,Malaysia,MYS,28,0,0,36,64
2015,Cote d'Ivoire,CIV,Malaysia,MYS,5,0,0,0,5
2015,Indonesia,IDN,Malaysia,MYS,63,0,0,0,63
2015,Iran (Islamic Rep. of),IRN,Malaysia,MYS,33,0,54,74,161
2015,Iraq,IRQ,Malaysia,MYS,41,0,0,78,119
2015,Liberia,LBR,Malaysia,MYS,0,0,0,14,14
2015,Lebanon,LBN,Malaysia,MYS,0,0,0,12,12
2015,Sri Lanka,LKA,Malaysia,MYS,62,0,175,766,1003
2015,Mali,MLI,Malaysia,MYS,0,0,0,5,5
2015,Myanmar,MMR,Malaysia,MYS,7983,0,225,2034,10242
2015,Nigeria,NGA,Malaysia,MYS,0,0,0,5,5
2015,Pakistan,PAK,Malaysia,MYS,51,0,121,311,483
2015,Saudi Arabia,SAU,Malaysia,MYS,0,0,0,5,5
2015,Sierra Leone,SLE,Malaysia,MYS,0,0,0,10,10
2015,Somalia,SOM,Malaysia,MYS,52,0,0,115,167
2015,Sudan,SDN,Malaysia,MYS,5,0,0,21,26
2015,South Sudan,SSD,Malaysia,MYS,13,0,0,0,13
2015,Syrian Arab Rep.,SYR,Malaysia,MYS,54,0,0,151,205
2015,Thailand,THA,Malaysia,MYS,5,0,0,0,5
2015,Yemen,YEM,Malaysia,MYS,18,0,0,11,29
2015,China,CHN,Mongolia,MNG,5,0,0,0,5
2015,Angola,AGO,Morocco,MAR,0,0,0,5,5
2015,Benin,BEN,Morocco,MAR,0,0,0,5,5
2015,Burkina Faso,BFA,Morocco,MAR,0,0,0,5,5
2015,Central African Rep.,CAF,Morocco,MAR,65,0,0,29,94
2015,Chad,TCD,Morocco,MAR,0,0,0,5,5
2015,Cameroon,CMR,Morocco,MAR,37,0,71,74,182
2015,Congo,COG,Morocco,MAR,5,0,19,38,62
2015,Dem. Rep. of the Congo,COD,Morocco,MAR,26,0,209,241,476
2015,Gambia,GMB,Morocco,MAR,0,0,5,0,5
2015,Palestinian,PSE,Morocco,MAR,11,0,0,5,16
2015,Guinea,GIN,Morocco,MAR,10,0,42,24,76
2015,Cote d'Ivoire,CIV,Morocco,MAR,32,0,163,127,322
2015,Iraq,IRQ,Morocco,MAR,31,0,0,5,36
2015,Kenya,KEN,Morocco,MAR,0,0,5,0,5
2015,Liberia,LBR,Morocco,MAR,5,0,12,11,28
2015,Libya,LBY,Morocco,MAR,10,0,0,0,10
2015,Mali,MLI,Morocco,MAR,5,0,62,65,132
2015,Niger,NER,Morocco,MAR,5,0,0,0,5
2015,Nigeria,NGA,Morocco,MAR,5,0,64,59,128
2015,Rwanda,RWA,Morocco,MAR,0,0,5,0,5
2015,Senegal,SEN,Morocco,MAR,35,0,11,0,46
2015,Sierra Leone,SLE,Morocco,MAR,0,0,10,0,10
2015,Somalia,SOM,Morocco,MAR,0,0,0,10,10
2015,Togo,TGO,Morocco,MAR,0,0,5,0,5
2015,Uganda,UGA,Morocco,MAR,0,0,5,0,5
2015,Yemen,YEM,Morocco,MAR,10,0,0,0,10
2015,Afghanistan,AFG,Nepal,NPL,61,0,10,26,97
2015,Sri Lanka,LKA,Nepal,NPL,13,0,0,0,13
2015,Myanmar,MMR,Nepal,NPL,65,0,0,0,65
2015,Pakistan,PAK,Nepal,NPL,26,0,12,0,38
2015,Somalia,SOM,Nepal,NPL,5,0,0,0,5
2015,Iraq,IRQ,Oman,OMN,133,0,0,11,144
2015,Afghanistan,AFG,Pakistan,PAK,2322,0,2729,1168,6219
2015,Palestinian,PSE,Pakistan,PAK,12,0,0,0,12
2015,Iran (Islamic Rep. of),IRN,Pakistan,PAK,0,0,5,0,5
2015,Libya,LBY,Pakistan,PAK,5,0,0,0,5
2015,Myanmar,MMR,Pakistan,PAK,5,0,0,0,5
2015,Somalia,SOM,Pakistan,PAK,27,0,15,0,42
2015,Syrian Arab Rep.,SYR,Pakistan,PAK,5,0,0,0,5
2015,Afghanistan,AFG,Saudi Arabia,SAU,0,0,0,5,5
2015,Ethiopia,ETH,Saudi Arabia,SAU,0,0,0,5,5
2015,Iraq,IRQ,Saudi Arabia,SAU,0,0,0,19,19
2015,Somalia,SOM,Saudi Arabia,SAU,0,0,0,19,19
2015,Sudan,SDN,Saudi Arabia,SAU,0,0,0,10,10
2015,Syrian Arab Rep.,SYR,Saudi Arabia,SAU,0,0,0,12,12
2015,Yemen,YEM,Saudi Arabia,SAU,5,0,0,0,5
2015,Eritrea,ERI,Somalia,SOM,0,0,5,0,5
2015,Ethiopia,ETH,Somalia,SOM,144,0,226,0,370
2015,Yemen,YEM,Somalia,SOM,29,0,0,0,29
2015,Afghanistan,AFG,Sudan,SDN,5,0,0,0,5
2015,Egypt,EGY,Sudan,SDN,5,0,14,0,19
2015,Eritrea,ERI,Sudan,SDN,262,0,0,0,262
2015,Ethiopia,ETH,Sudan,SDN,12,0,16,5,33
2015,Somalia,SOM,Sudan,SDN,5,0,0,0,5
2015,Syrian Arab Rep.,SYR,Sudan,SDN,12,0,0,0,12
2015,Afghanistan,AFG,Syrian Arab Rep.,SYR,46,0,143,0,189
2015,Egypt,EGY,Syrian Arab Rep.,SYR,5,0,41,5,51
2015,Argentina,ARG,Syrian Arab Rep.,SYR,0,0,5,0,5
2015,Bangladesh,BGD,Syrian Arab Rep.,SYR,0,0,5,0,5
2015,Chad,TCD,Syrian Arab Rep.,SYR,0,0,0,5,5
2015,Comoros,COM,Syrian Arab Rep.,SYR,0,0,5,0,5
2015,Eritrea,ERI,Syrian Arab Rep.,SYR,5,0,0,0,5
2015,Ethiopia,ETH,Syrian Arab Rep.,SYR,0,0,0,12,12
2015,Guinea,GIN,Syrian Arab Rep.,SYR,0,0,11,0,11
2015,India,IND,Syrian Arab Rep.,SYR,0,0,0,5,5
2015,Indonesia,IDN,Syrian Arab Rep.,SYR,0,0,5,0,5
2015,Iran (Islamic Rep. of),IRN,Syrian Arab Rep.,SYR,5,0,206,11,222
2015,Iraq,IRQ,Syrian Arab Rep.,SYR,987,0,10,193,1190
2015,Jordan,JOR,Syrian Arab Rep.,SYR,5,0,43,0,48
2015,Lebanon,LBN,Syrian Arab Rep.,SYR,5,0,125,27,157
2015,Sri Lanka,LKA,Syrian Arab Rep.,SYR,0,0,5,5,10
2015,Morocco,MAR,Syrian Arab Rep.,SYR,0,0,5,0,5
2015,Pakistan,PAK,Syrian Arab Rep.,SYR,23,0,31,0,54
2015,Philippines,PHL,Syrian Arab Rep.,SYR,0,0,0,5,5
2015,Sudan,SDN,Syrian Arab Rep.,SYR,22,0,15,19,56
2015,Tunisia,TUN,Syrian Arab Rep.,SYR,0,0,19,5,24
2015,Uzbekistan,UZB,Syrian Arab Rep.,SYR,0,0,5,0,5
2015,Afghanistan,AFG,Thailand,THA,12,0,0,0,12
2015,Egypt,EGY,Thailand,THA,0,0,0,11,11
2015,Bahrain,BHR,Thailand,THA,0,0,0,5,5
2015,Bangladesh,BGD,Thailand,THA,0,0,0,5,5
2015,Cambodia,KHM,Thailand,THA,16,0,0,13,29
2015,China,CHN,Thailand,THA,63,0,0,19,82
2015,Cameroon,CMR,Thailand,THA,0,0,0,12,12
2015,Dem. Rep. of the Congo,COD,Thailand,THA,0,0,0,12,12
2015,Ethiopia,ETH,Thailand,THA,5,0,0,0,5
2015,Palestinian,PSE,Thailand,THA,232,0,5,10,247
2015,Guinea,GIN,Thailand,THA,0,0,0,5,5
2015,Cote d'Ivoire,CIV,Thailand,THA,5,0,0,0,5
2015,India,IND,Thailand,THA,0,0,0,5,5
2015,Iran (Islamic Rep. of),IRN,Thailand,THA,10,0,20,39,69
2015,Iraq,IRQ,Thailand,THA,22,0,0,65,87
2015,Jordan,JOR,Thailand,THA,5,0,0,0,5
2015,Liberia,LBR,Thailand,THA,0,0,5,68,73
2015,Sri Lanka,LKA,Thailand,THA,22,0,10,53,85
2015,Nigeria,NGA,Thailand,THA,0,0,11,0,11
2015,Pakistan,PAK,Thailand,THA,306,0,163,472,941
2015,Sierra Leone,SLE,Thailand,THA,0,0,0,13,13
2015,Somalia,SOM,Thailand,THA,34,0,28,50,112
2015,Viet Nam,VNM,Thailand,THA,77,0,17,78,172
2015,Sudan,SDN,Thailand,THA,14,0,0,0,14
2015,Syrian Arab Rep.,SYR,Thailand,THA,36,0,0,66,102
2015,United Rep. of Tanzania,TZA,Thailand,THA,5,0,0,0,5
2015,Uzbekistan,UZB,Thailand,THA,0,0,0,5,5
2015,Yemen,YEM,Thailand,THA,0,0,0,5,5
2015,Afghanistan,AFG,Tajikistan,TJK,22,0,40,0,62
2015,Bangladesh,BGD,Trinidad and Tobago,TTO,0,0,5,0,5
2015,Colombia,COL,Trinidad and Tobago,TTO,5,0,0,0,5
2015,Cuba,CUB,Trinidad and Tobago,TTO,22,0,5,11,38
2015,Jamaica,JAM,Trinidad and Tobago,TTO,5,0,0,0,5
2015,Nigeria,NGA,Trinidad and Tobago,TTO,5,0,11,0,16
2015,Pakistan,PAK,Trinidad and Tobago,TTO,5,0,0,0,5
2015,Syrian Arab Rep.,SYR,Trinidad and Tobago,TTO,19,0,0,0,19
2015,Central African Rep.,CAF,Tunisia,TUN,5,0,0,0,5
2015,Dem. Rep. of the Congo,COD,Tunisia,TUN,0,0,0,5,5
2015,Eritrea,ERI,Tunisia,TUN,5,0,0,5,10
2015,Ethiopia,ETH,Tunisia,TUN,5,0,0,0,5
2015,Palestinian,PSE,Tunisia,TUN,10,0,0,0,10
2015,Cote d'Ivoire,CIV,Tunisia,TUN,0,0,44,84,128
2015,Iraq,IRQ,Tunisia,TUN,0,0,0,5,5
2015,Somalia,SOM,Tunisia,TUN,5,0,5,41,51
2015,Sudan,SDN,Tunisia,TUN,5,0,0,5,10
2015,Afghanistan,AFG,Turkey,TUR,318,0,0,5890,6208
2015,Algeria,DZA,Turkey,TUR,0,0,5,10,15
2015,Angola,AGO,Turkey,TUR,0,0,0,5,5
2015,Egypt,EGY,Turkey,TUR,11,0,5,5,21
2015,Central African Rep.,CAF,Turkey,TUR,0,0,0,5,5
2015,China,CHN,Turkey,TUR,0,0,0,10,10
2015,Cameroon,CMR,Turkey,TUR,0,0,5,17,22
2015,Congo,COG,Turkey,TUR,0,0,5,64,69
2015,Dem. Rep. of the Congo,COD,Turkey,TUR,5,0,10,22,37
2015,Eritrea,ERI,Turkey,TUR,18,0,0,39,57
2015,Ethiopia,ETH,Turkey,TUR,0,0,0,55,55
2015,Palestinian,PSE,Turkey,TUR,138,0,0,90,228
2015,Ghana,GHA,Turkey,TUR,0,0,0,10,10
2015,Guinea,GIN,Turkey,TUR,0,0,0,5,5
2015,Cote d'Ivoire,CIV,Turkey,TUR,0,0,5,29,34
2015,Iran (Islamic Rep. of),IRN,Turkey,TUR,3161,0,661,1896,5718
2015,Iraq,IRQ,Turkey,TUR,10628,0,18,10188,20834
2015,Jordan,JOR,Turkey,TUR,0,0,0,12,12
2015,Kazakhstan,KAZ,Turkey,TUR,0,0,0,5,5
2015,Kenya,KEN,Turkey,TUR,0,0,0,11,11
2015,Kyrgyzstan,KGZ,Turkey,TUR,5,0,5,11,21
2015,Kuwait,KWT,Turkey,TUR,0,0,0,5,5
2015,Libya,LBY,Turkey,TUR,14,0,0,0,14
2015,Lebanon,LBN,Turkey,TUR,0,0,12,0,12
2015,Sri Lanka,LKA,Turkey,TUR,0,0,0,5,5
2015,Mali,MLI,Turkey,TUR,0,0,0,10,10
2015,Mongolia,MNG,Turkey,TUR,0,0,0,24,24
2015,Morocco,MAR,Turkey,TUR,0,0,5,29,34
2015,Myanmar,MMR,Turkey,TUR,0,0,0,5,5
2015,Nepal,NPL,Turkey,TUR,0,0,0,5,5
2015,Nigeria,NGA,Turkey,TUR,0,0,11,63,74
2015,Pakistan,PAK,Turkey,TUR,13,0,19,424,456
2015,Philippines,PHL,Turkey,TUR,0,0,0,5,5
2015,Russian Federation,RUS,Turkey,TUR,0,0,0,5,5
2015,Rwanda,RWA,Turkey,TUR,0,0,0,5,5
2015,Senegal,SEN,Turkey,TUR,0,0,0,14,14
2015,Sierra Leone,SLE,Turkey,TUR,0,0,0,10,10
2015,Somalia,SOM,Turkey,TUR,118,0,5,399,522
2015,Sudan,SDN,Turkey,TUR,31,0,0,107,138
2015,South Sudan,SSD,Turkey,TUR,5,0,0,0,5
2015,United Rep. of Tanzania,TZA,Turkey,TUR,0,0,0,5,5
2015,Tajikistan,TJK,Turkey,TUR,5,0,0,30,35
2015,Turkmenistan,TKM,Turkey,TUR,0,0,0,71,71
2015,Uganda,UGA,Turkey,TUR,0,0,16,217,233
2015,Uzbekistan,UZB,Turkey,TUR,5,0,10,86,101
2015,Yemen,YEM,Turkey,TUR,40,0,0,94,134
2015,Stateless,XXA,Turkey,TUR,5,0,0,25,30
2015,Afghanistan,AFG,Ukraine,UKR,31,0,0,20,51
2015,Chad,TCD,Ukraine,UKR,0,0,0,5,5
2015,Cameroon,CMR,Ukraine,UKR,0,0,0,5,5
2015,Eritrea,ERI,Ukraine,UKR,5,0,0,0,5
2015,Ethiopia,ETH,Ukraine,UKR,5,0,0,0,5
2015,Guinea,GIN,Ukraine,UKR,0,0,0,5,5
2015,Iran (Islamic Rep. of),IRN,Ukraine,UKR,5,0,0,0,5
2015,Nigeria,NGA,Ukraine,UKR,0,0,0,5,5
2015,Russian Federation,RUS,Ukraine,UKR,0,0,0,10,10
2015,Somalia,SOM,Ukraine,UKR,5,0,0,12,17
2015,Syrian Arab Rep.,SYR,Ukraine,UKR,11,0,0,5,16
2015,Turkey,TUR,Ukraine,UKR,0,0,0,5,5
2015,Uzbekistan,UZB,Ukraine,UKR,0,0,0,5,5
2015,Eritrea,ERI,Yemen,YEM,26,0,0,20,46
2015,Ethiopia,ETH,Yemen,YEM,82,0,5,817,904
2015,Palestinian,PSE,Yemen,YEM,17,0,0,22,39
2015,Iraq,IRQ,Yemen,YEM,5,0,0,36,41
2015,Saudi Arabia,SAU,Yemen,YEM,5,0,0,0,5
2015,Sudan,SDN,Yemen,YEM,5,0,0,0,5
2015,Syrian Arab Rep.,SYR,Yemen,YEM,5,0,0,420,425
2015,Colombia,COL,Aruba,ABW,0,0,5,0,5
2015,Colombia,COL,Curacao ,CUW,5,0,0,0,5
2015,Cuba,CUB,Curacao ,CUW,5,0,0,0,5
2016,Iran (Islamic Rep. of),IRN,Afghanistan,AFG,5,0,0,5,10
2016,Pakistan,PAK,Afghanistan,AFG,5,0,0,0,5
2016,Benin,BEN,Algeria,DZA,0,0,5,0,5
2016,Burkina Faso,BFA,Algeria,DZA,0,0,0,5,5
2016,Central African Rep.,CAF,Algeria,DZA,27,0,0,5,32
2016,Cameroon,CMR,Algeria,DZA,5,0,14,5,24
2016,Congo,COG,Algeria,DZA,0,0,0,5,5
2016,Dem. Rep. of the Congo,COD,Algeria,DZA,0,0,12,12,24
2016,Palestinian,PSE,Algeria,DZA,0,0,0,60,60
2016,Guinea,GIN,Algeria,DZA,0,0,35,5,40
2016,Cote d'Ivoire,CIV,Algeria,DZA,13,0,21,5,39
2016,Liberia,LBR,Algeria,DZA,0,0,0,5,5
2016,Libya,LBY,Algeria,DZA,0,0,0,14,14
2016,Lebanon,LBN,Algeria,DZA,0,0,0,5,5
2016,Mali,MLI,Algeria,DZA,16,0,26,19,61
2016,Nigeria,NGA,Algeria,DZA,0,0,0,5,5
2016,Syrian Arab Rep.,SYR,Algeria,DZA,0,0,0,2398,2398
2016,Togo,TGO,Algeria,DZA,0,0,5,0,5
2016,Yemen,YEM,Algeria,DZA,0,0,0,34,34
2016,Afghanistan,AFG,Egypt,EGY,13,0,5,5,23
2016,Algeria,DZA,Egypt,EGY,0,0,0,5,5
2016,Azerbaijan,AZE,Egypt,EGY,0,0,5,0,5
2016,Burundi,BDI,Egypt,EGY,0,0,5,0,5
2016,Benin,BEN,Egypt,EGY,0,0,5,0,5
2016,Bangladesh,BGD,Egypt,EGY,0,0,5,12,17
2016,Burkina Faso,BFA,Egypt,EGY,0,0,5,0,5
2016,Central African Rep.,CAF,Egypt,EGY,5,0,0,0,5
2016,Chad,TCD,Egypt,EGY,0,0,22,17,39
2016,China,CHN,Egypt,EGY,0,0,0,5,5
2016,Cameroon,CMR,Egypt,EGY,5,0,19,28,52
2016,Congo,COG,Egypt,EGY,0,0,5,11,16
2016,Dem. Rep. of the Congo,COD,Egypt,EGY,5,0,5,12,22
2016,Djibouti,DJI,Egypt,EGY,0,0,5,0,5
2016,Eritrea,ERI,Egypt,EGY,516,0,10,916,1442
2016,Ethiopia,ETH,Egypt,EGY,529,0,1234,364,2127
2016,Gambia,GMB,Egypt,EGY,0,0,10,0,10
2016,Palestinian,PSE,Egypt,EGY,10,0,0,14,24
2016,Ghana,GHA,Egypt,EGY,0,0,40,5,45
2016,Guinea,GIN,Egypt,EGY,0,0,28,35,63
2016,Cote d'Ivoire,CIV,Egypt,EGY,0,0,5,20,25
2016,Iraq,IRQ,Egypt,EGY,371,0,0,566,937
2016,Jordan,JOR,Egypt,EGY,0,0,0,5,5
2016,Kenya,KEN,Egypt,EGY,0,0,5,0,5
2016,Liberia,LBR,Egypt,EGY,0,0,10,0,10
2016,Sri Lanka,LKA,Egypt,EGY,0,0,0,5,5
2016,Madagascar,MDG,Egypt,EGY,0,0,0,5,5
2016,Mali,MLI,Egypt,EGY,0,0,0,5,5
2016,Morocco,MAR,Egypt,EGY,0,0,0,11,11
2016,Niger,NER,Egypt,EGY,0,0,0,5,5
2016,Nigeria,NGA,Egypt,EGY,5,0,391,461,857
2016,Russian Federation,RUS,Egypt,EGY,5,0,39,5,49
2016,Senegal,SEN,Egypt,EGY,0,0,0,10,10
2016,Sierra Leone,SLE,Egypt,EGY,0,0,5,5,10
2016,Somalia,SOM,Egypt,EGY,492,0,59,1403,1954
2016,Sudan,SDN,Egypt,EGY,3736,0,1769,3050,8555
2016,South Sudan,SSD,Egypt,EGY,979,0,5,270,1254
2016,Tajikistan,TJK,Egypt,EGY,0,0,10,0,10
2016,Togo,TGO,Egypt,EGY,0,0,5,0,5
2016,Tunisia,TUN,Egypt,EGY,0,0,0,5,5
2016,Uganda,UGA,Egypt,EGY,0,0,20,14,34
2016,Uzbekistan,UZB,Egypt,EGY,0,0,38,11,49
2016,Yemen,YEM,Egypt,EGY,17,0,0,182,199
2016,Zimbabwe,ZWE,Egypt,EGY,5,0,0,0,5
2016,Afghanistan,AFG,Azerbaijan,AZE,60,0,10,32,102
2016,Iran (Islamic Rep. of),IRN,Azerbaijan,AZE,12,0,0,0,12
2016,Iraq,IRQ,Azerbaijan,AZE,0,0,0,10,10
2016,Pakistan,PAK,Azerbaijan,AZE,5,0,15,10,30
2016,Russian Federation,RUS,Azerbaijan,AZE,10,0,0,11,21
2016,Syrian Arab Rep.,SYR,Azerbaijan,AZE,10,0,0,0,10
2016,Iraq,IRQ,Bahrain,BHR,29,0,0,10,39
2016,Turkey,TUR,Bahrain,BHR,5,0,0,0,5
2016,Yemen,YEM,Bangladesh,BGD,5,0,0,0,5
2016,Central African Rep.,CAF,China,CHN,0,0,0,5,5
2016,Cameroon,CMR,China,CHN,0,0,5,14,19
2016,Congo,COG,China,CHN,0,0,0,5,5
2016,Dem. Rep. of the Congo,COD,China,CHN,0,0,0,5,5
2016,Gambia,GMB,China,CHN,0,0,0,13,13
2016,Palestinian,PSE,China,CHN,5,0,0,0,5
2016,Ghana,GHA,China,CHN,0,0,30,38,68
2016,Guinea,GIN,China,CHN,0,0,10,10,20
2016,Cote d'Ivoire,CIV,China,CHN,0,0,12,0,12
2016,Iran (Islamic Rep. of),IRN,China,CHN,5,0,0,0,5
2016,Iraq,IRQ,China,CHN,5,0,0,36,41
2016,Kenya,KEN,China,CHN,0,0,0,5,5
2016,Liberia,LBR,China,CHN,0,0,10,25,35
2016,Mali,MLI,China,CHN,0,0,0,12,12
2016,Mozambique,MOZ,China,CHN,0,0,0,5,5
2016,Nigeria,NGA,China,CHN,0,0,34,21,55
2016,Pakistan,PAK,China,CHN,5,0,0,0,5
2016,Philippines,PHL,China,CHN,0,0,11,0,11
2016,Sierra Leone,SLE,China,CHN,0,0,5,15,20
2016,Somalia,SOM,China,CHN,10,0,5,5,20
2016,Syrian Arab Rep.,SYR,China,CHN,11,0,0,0,11
2016,Uganda,UGA,China,CHN,0,0,5,24,29
2016,Yemen,YEM,China,CHN,0,0,0,5,5
2016,Zimbabwe,ZWE,China,CHN,0,0,5,0,5
2016,Burundi,BDI,Cameroon,CMR,5,0,0,0,5
2016,Central African Rep.,CAF,Cameroon,CMR,2146,0,67,1351,3564
2016,Chad,TCD,Cameroon,CMR,5,0,86,145,236
2016,Congo,COG,Cameroon,CMR,0,0,5,5,10
2016,Dem. Rep. of the Congo,COD,Cameroon,CMR,29,0,46,45,120
2016,Equatorial Guinea,GNQ,Cameroon,CMR,0,0,0,5,5
2016,Gambia,GMB,Cameroon,CMR,0,0,0,5,5
2016,Ghana,GHA,Cameroon,CMR,0,0,5,0,5
2016,Guinea-Bissau,GNB,Cameroon,CMR,0,0,0,5,5
2016,Guinea,GIN,Cameroon,CMR,0,0,12,0,12
2016,Cote d'Ivoire,CIV,Cameroon,CMR,0,0,18,100,118
2016,Mali,MLI,Cameroon,CMR,5,0,5,0,10
2016,Nigeria,NGA,Cameroon,CMR,10,0,0,27,37
2016,Rwanda,RWA,Cameroon,CMR,5,0,31,0,36
2016,Sudan,SDN,Cameroon,CMR,5,0,0,12,17
2016,South Sudan,SSD,Cameroon,CMR,0,0,0,5,5
2016,Syrian Arab Rep.,SYR,Cameroon,CMR,10,0,0,0,10
2016,Togo,TGO,Cameroon,CMR,0,0,5,0,5
2016,Cuba,CUB,Dominican Rep.,DOM,0,0,0,5,5
2016,Ukraine,UKR,Dominican Rep.,DOM,5,0,0,0,5
2016,India,IND,Micronesia (Federated States of),FSM,0,0,5,0,5
2016,Cuba,CUB,United Kingdom of Great Britain and Northern Ireland,GBR,0,0,0,17,17
2016,Iran (Islamic Rep. of),IRN,"China, Hong Kong SAR",HKG,5,0,0,0,5
2016,Rwanda,RWA,"China, Hong Kong SAR",HKG,5,0,0,0,5
2016,Afghanistan,AFG,India,IND,1221,0,287,998,2506
2016,Cameroon,CMR,India,IND,0,0,10,5,15
2016,Dem. Rep. of the Congo,COD,India,IND,13,0,5,0,18
2016,Eritrea,ERI,India,IND,5,0,0,0,5
2016,Ethiopia,ETH,India,IND,10,0,0,0,10
2016,Palestinian,PSE,India,IND,11,0,0,5,16
2016,Iran (Islamic Rep. of),IRN,India,IND,11,0,0,5,16
2016,Iraq,IRQ,India,IND,113,0,0,34,147
2016,Myanmar,MMR,India,IND,1438,0,36,768,2242
2016,Nigeria,NGA,India,IND,0,0,10,40,50
2016,Rwanda,RWA,India,IND,0,0,5,0,5
2016,Somalia,SOM,India,IND,135,0,0,41,176
2016,Sudan,SDN,India,IND,24,0,5,5,34
2016,South Sudan,SSD,India,IND,5,0,0,0,5
2016,Syrian Arab Rep.,SYR,India,IND,29,0,0,13,42
2016,Tajikistan,TJK,India,IND,0,0,0,5,5
2016,Ukraine,UKR,India,IND,0,0,11,0,11
2016,Yemen,YEM,India,IND,0,0,0,23,23
2016,Afghanistan,AFG,Indonesia,IDN,1980,0,61,108,2149
2016,Egypt,EGY,Indonesia,IDN,0,0,0,5,5
2016,Bangladesh,BGD,Indonesia,IDN,0,0,0,57,57
2016,Cameroon,CMR,Indonesia,IDN,5,0,0,0,5
2016,Dem. Rep. of the Congo,COD,Indonesia,IDN,0,0,0,5,5
2016,Eritrea,ERI,Indonesia,IDN,5,0,0,0,5
2016,Ethiopia,ETH,Indonesia,IDN,17,0,42,27,86
2016,Palestinian,PSE,Indonesia,IDN,82,0,0,10,92
2016,Guinea,GIN,Indonesia,IDN,0,0,5,0,5
2016,Iran (Islamic Rep. of),IRN,Indonesia,IDN,49,0,38,30,117
2016,Iraq,IRQ,Indonesia,IDN,195,0,0,173,368
2016,Liberia,LBR,Indonesia,IDN,0,0,0,5,5
2016,Sri Lanka,LKA,Indonesia,IDN,54,0,52,45,151
2016,Myanmar,MMR,Indonesia,IDN,330,0,5,104,439
2016,Nepal,NPL,Indonesia,IDN,0,0,0,5,5
2016,Nigeria,NGA,Indonesia,IDN,0,0,16,34,50
2016,Pakistan,PAK,Indonesia,IDN,62,0,10,10,82
2016,Sierra Leone,SLE,Indonesia,IDN,0,0,0,5,5
2016,Somalia,SOM,Indonesia,IDN,242,0,5,61,308
2016,Sudan,SDN,Indonesia,IDN,72,0,0,18,90
2016,Syrian Arab Rep.,SYR,Indonesia,IDN,12,0,0,0,12
2016,Yemen,YEM,Indonesia,IDN,5,0,0,26,31
2016,Afghanistan,AFG,Iran (Islamic Rep. of),IRN,0,0,0,26,26
2016,Pakistan,PAK,Iran (Islamic Rep. of),IRN,0,0,0,10,10
2016,Afghanistan,AFG,Iraq,IRQ,0,0,0,29,29
2016,Egypt,EGY,Iraq,IRQ,0,0,0,16,16
2016,Palestinian,PSE,Iraq,IRQ,66,0,0,0,66
2016,India,IND,Iraq,IRQ,0,0,0,5,5
2016,Iran (Islamic Rep. of),IRN,Iraq,IRQ,18,0,0,0,18
2016,Kuwait,KWT,Iraq,IRQ,0,0,0,10,10
2016,Pakistan,PAK,Iraq,IRQ,0,0,0,64,64
2016,Turkey,TUR,Iraq,IRQ,11,0,0,0,11
2016,Eritrea,ERI,Israel,ISR,151,0,0,0,151
2016,Ethiopia,ETH,Israel,ISR,5,0,0,0,5
2016,Sudan,SDN,Israel,ISR,25,0,0,0,25
2016,South Sudan,SSD,Israel,ISR,20,0,0,0,20
2016,Turkey,TUR,Israel,ISR,5,0,0,0,5
2016,Cuba,CUB,Jamaica,JAM,0,0,0,11,11
2016,Egypt,EGY,Jordan,JOR,15,0,22,0,37
2016,Eritrea,ERI,Jordan,JOR,5,0,0,5,10
2016,Ethiopia,ETH,Jordan,JOR,5,0,0,0,5
2016,Iran (Islamic Rep. of),IRN,Jordan,JOR,5,0,0,0,5
2016,Iraq,IRQ,Jordan,JOR,698,0,0,5,703
2016,Libya,LBY,Jordan,JOR,16,0,0,0,16
2016,Pakistan,PAK,Jordan,JOR,0,0,0,5,5
2016,Somalia,SOM,Jordan,JOR,67,0,0,0,67
2016,Sudan,SDN,Jordan,JOR,398,0,35,0,433
2016,South Sudan,SSD,Jordan,JOR,5,0,0,0,5
2016,Turkey,TUR,Jordan,JOR,0,0,0,5,5
2016,Yemen,YEM,Jordan,JOR,135,0,0,0,135
2016,Afghanistan,AFG,Kyrgyzstan,KGZ,5,0,25,0,30
2016,Syrian Arab Rep.,SYR,Kyrgyzstan,KGZ,5,0,0,0,5
2016,Egypt,EGY,Kuwait,KWT,0,0,5,0,5
2016,Iran (Islamic Rep. of),IRN,Kuwait,KWT,0,0,10,0,10
2016,Iraq,IRQ,Kuwait,KWT,74,0,0,0,74
2016,Somalia,SOM,Kuwait,KWT,165,0,0,0,165
2016,Syrian Arab Rep.,SYR,Kuwait,KWT,36,0,0,0,36
2016,Chad,TCD,Libya,LBY,0,0,0,5,5
2016,Eritrea,ERI,Libya,LBY,0,0,0,18,18
2016,Ethiopia,ETH,Libya,LBY,0,0,0,5,5
2016,Iraq,IRQ,Libya,LBY,0,0,0,26,26
2016,Somalia,SOM,Libya,LBY,0,0,0,5,5
2016,Sudan,SDN,Libya,LBY,0,0,0,38,38
2016,Syrian Arab Rep.,SYR,Libya,LBY,25,0,0,25,50
2016,Afghanistan,AFG,Lebanon,LBN,5,0,0,5,10
2016,Egypt,EGY,Lebanon,LBN,5,0,30,43,78
2016,Bahrain,BHR,Lebanon,LBN,12,0,0,0,12
2016,Bangladesh,BGD,Lebanon,LBN,0,0,0,19,19
2016,Cameroon,CMR,Lebanon,LBN,0,0,0,5,5
2016,Dem. Rep. of the Congo,COD,Lebanon,LBN,0,0,0,5,5
2016,Eritrea,ERI,Lebanon,LBN,5,0,13,14,32
2016,Ethiopia,ETH,Lebanon,LBN,11,0,93,142,246
2016,Palestinian,PSE,Lebanon,LBN,0,0,0,5,5
2016,India,IND,Lebanon,LBN,0,0,0,5,5
2016,Iran (Islamic Rep. of),IRN,Lebanon,LBN,5,0,5,14,24
2016,Iraq,IRQ,Lebanon,LBN,32,0,19,764,815
2016,Jordan,JOR,Lebanon,LBN,0,0,0,14,14
2016,Kenya,KEN,Lebanon,LBN,0,0,5,13,18
2016,Libya,LBY,Lebanon,LBN,10,0,0,0,10
2016,Sri Lanka,LKA,Lebanon,LBN,0,0,0,5,5
2016,Madagascar,MDG,Lebanon,LBN,0,0,0,5,5
2016,Morocco,MAR,Lebanon,LBN,0,0,0,5,5
2016,Nigeria,NGA,Lebanon,LBN,0,0,5,0,5
2016,Philippines,PHL,Lebanon,LBN,0,0,0,13,13
2016,Somalia,SOM,Lebanon,LBN,5,0,0,0,5
2016,Sudan,SDN,Lebanon,LBN,176,0,519,335,1030
2016,South Sudan,SSD,Lebanon,LBN,5,0,0,0,5
2016,Turkey,TUR,Lebanon,LBN,0,0,0,5,5
2016,Yemen,YEM,Lebanon,LBN,0,0,0,13,13
2016,Afghanistan,AFG,Sri Lanka,LKA,48,0,0,5,53
2016,Bangladesh,BGD,Sri Lanka,LKA,10,0,0,0,10
2016,Palestinian,PSE,Sri Lanka,LKA,0,0,0,5,5
2016,Iran (Islamic Rep. of),IRN,Sri Lanka,LKA,5,0,5,0,10
2016,Maldives,MDV,Sri Lanka,LKA,10,0,0,0,10
2016,Pakistan,PAK,Sri Lanka,LKA,131,0,35,5,171
2016,Syrian Arab Rep.,SYR,Sri Lanka,LKA,5,0,0,0,5
2016,Ukraine,UKR,Sri Lanka,LKA,0,0,0,5,5
2016,Pakistan,PAK,Madagascar,MDG,12,0,0,0,12
2016,Syrian Arab Rep.,SYR,Madagascar,MDG,0,0,0,5,5
2016,Yemen,YEM,Madagascar,MDG,10,0,0,0,10
2016,Burundi,BDI,Mauritania,MRT,5,0,0,0,5
2016,Central African Rep.,CAF,Mauritania,MRT,90,0,0,0,90
2016,Cameroon,CMR,Mauritania,MRT,0,0,10,15,25
2016,Congo,COG,Mauritania,MRT,0,0,5,0,5
2016,Dem. Rep. of the Congo,COD,Mauritania,MRT,0,0,14,0,14
2016,Palestinian,PSE,Mauritania,MRT,12,0,0,0,12
2016,Guinea,GIN,Mauritania,MRT,0,0,0,11,11
2016,Cote d'Ivoire,CIV,Mauritania,MRT,0,0,5,64,69
2016,Iraq,IRQ,Mauritania,MRT,10,0,0,0,10
2016,Nigeria,NGA,Mauritania,MRT,5,0,19,27,51
2016,Senegal,SEN,Mauritania,MRT,17,0,10,10,37
2016,Sudan,SDN,Mauritania,MRT,5,0,0,0,5
2016,Syrian Arab Rep.,SYR,Mauritania,MRT,179,0,0,24,203
2016,Togo,TGO,Mauritania,MRT,0,0,0,5,5
2016,Yemen,YEM,Mauritania,MRT,5,0,0,0,5
2016,Afghanistan,AFG,Malaysia,MYS,107,0,89,50,246
2016,Egypt,EGY,Malaysia,MYS,5,0,13,0,18
2016,Bangladesh,BGD,Malaysia,MYS,0,0,5,5,10
2016,Central African Rep.,CAF,Malaysia,MYS,0,0,0,5,5
2016,China,CHN,Malaysia,MYS,0,0,5,0,5
2016,Cameroon,CMR,Malaysia,MYS,0,0,0,5,5
2016,Dem. Rep. of the Congo,COD,Malaysia,MYS,0,0,0,5,5
2016,Eritrea,ERI,Malaysia,MYS,0,0,0,5,5
2016,Palestinian,PSE,Malaysia,MYS,32,0,5,75,112
2016,Guinea,GIN,Malaysia,MYS,0,0,5,5,10
2016,India,IND,Malaysia,MYS,0,0,0,5,5
2016,Indonesia,IDN,Malaysia,MYS,49,0,5,0,54
2016,Iran (Islamic Rep. of),IRN,Malaysia,MYS,11,0,52,0,63
2016,Iraq,IRQ,Malaysia,MYS,37,0,0,245,282
2016,Liberia,LBR,Malaysia,MYS,0,0,13,0,13
2016,Libya,LBY,Malaysia,MYS,5,0,12,0,17
2016,Sri Lanka,LKA,Malaysia,MYS,36,0,451,296,783
2016,Mali,MLI,Malaysia,MYS,0,0,5,0,5
2016,Myanmar,MMR,Malaysia,MYS,18917,0,1196,0,20113
2016,Nigeria,NGA,Malaysia,MYS,0,0,5,10,15
2016,Pakistan,PAK,Malaysia,MYS,419,0,368,93,880
2016,Philippines,PHL,Malaysia,MYS,0,0,0,10,10
2016,Russian Federation,RUS,Malaysia,MYS,0,0,0,5,5
2016,Saudi Arabia,SAU,Malaysia,MYS,5,0,0,0,5
2016,Sierra Leone,SLE,Malaysia,MYS,0,0,12,0,12
2016,Somalia,SOM,Malaysia,MYS,137,0,74,13,224
2016,Sudan,SDN,Malaysia,MYS,10,0,16,39,65
2016,Syrian Arab Rep.,SYR,Malaysia,MYS,64,0,0,191,255
2016,Togo,TGO,Malaysia,MYS,0,0,0,5,5
2016,Uzbekistan,UZB,Malaysia,MYS,0,0,0,15,15
2016,Yemen,YEM,Malaysia,MYS,12,0,0,643,655
2016,Afghanistan,AFG,Mongolia,MNG,5,0,0,0,5
2016,Nigeria,NGA,Mongolia,MNG,0,0,5,0,5
2016,Algeria,DZA,Morocco,MAR,5,0,0,0,5
2016,Benin,BEN,Morocco,MAR,0,0,5,0,5
2016,Bangladesh,BGD,Morocco,MAR,0,0,0,5,5
2016,Burkina Faso,BFA,Morocco,MAR,0,0,0,11,11
2016,Central African Rep.,CAF,Morocco,MAR,104,0,11,28,143
2016,Chad,TCD,Morocco,MAR,0,0,5,0,5
2016,Cameroon,CMR,Morocco,MAR,24,0,82,219,325
2016,Congo,COG,Morocco,MAR,0,0,24,0,24
2016,Dem. Rep. of the Congo,COD,Morocco,MAR,26,0,92,95,213
2016,Gambia,GMB,Morocco,MAR,0,0,0,14,14
2016,Palestinian,PSE,Morocco,MAR,13,0,0,5,18
2016,Ghana,GHA,Morocco,MAR,0,0,0,5,5
2016,Guinea,GIN,Morocco,MAR,13,0,83,97,193
2016,Cote d'Ivoire,CIV,Morocco,MAR,19,0,109,130,258
2016,Iraq,IRQ,Morocco,MAR,5,0,0,10,15
2016,Liberia,LBR,Morocco,MAR,0,0,10,19,29
2016,Libya,LBY,Morocco,MAR,14,0,0,0,14
2016,Mali,MLI,Morocco,MAR,10,0,56,52,118
2016,Niger,NER,Morocco,MAR,0,0,0,5,5
2016,Nigeria,NGA,Morocco,MAR,0,0,31,70,101
2016,Pakistan,PAK,Morocco,MAR,5,0,0,0,5
2016,Senegal,SEN,Morocco,MAR,11,0,10,23,44
2016,Sierra Leone,SLE,Morocco,MAR,0,0,0,10,10
2016,Somalia,SOM,Morocco,MAR,0,0,0,10,10
2016,Sudan,SDN,Morocco,MAR,0,0,10,0,10
2016,Syrian Arab Rep.,SYR,Morocco,MAR,5,0,0,0,5
2016,Togo,TGO,Morocco,MAR,0,0,5,5,10
2016,Turkey,TUR,Morocco,MAR,0,0,0,5,5
2016,Bangladesh,BGD,Nepal,NPL,23,0,0,0,23
2016,Sri Lanka,LKA,Nepal,NPL,5,0,0,0,5
2016,Myanmar,MMR,Nepal,NPL,12,0,5,0,17
2016,Pakistan,PAK,Nepal,NPL,20,0,0,0,20
2016,Somalia,SOM,Nepal,NPL,5,0,0,0,5
2016,Iraq,IRQ,Oman,OMN,87,0,0,5,92
2016,Afghanistan,AFG,Pakistan,PAK,1210,0,1721,1990,4921
2016,Iran (Islamic Rep. of),IRN,Pakistan,PAK,17,0,5,0,22
2016,Iraq,IRQ,Pakistan,PAK,0,0,0,10,10
2016,Somalia,SOM,Pakistan,PAK,16,0,5,11,32
2016,Syrian Arab Rep.,SYR,Pakistan,PAK,5,0,0,0,5
2016,Turkey,TUR,Pakistan,PAK,0,0,0,10,10
2016,Yemen,YEM,Pakistan,PAK,24,0,0,5,29
2016,Iraq,IRQ,Qatar,QAT,45,0,0,0,45
2016,Syrian Arab Rep.,SYR,Qatar,QAT,18,0,0,0,18
2016,Syrian Arab Rep.,SYR,Saudi Arabia,SAU,10,0,0,0,10
2016,Yemen,YEM,Saudi Arabia,SAU,5,0,0,0,5
2016,Eritrea,ERI,Somalia,SOM,5,0,0,0,5
2016,Ethiopia,ETH,Somalia,SOM,271,0,52,37,360
2016,Palestinian,PSE,Somalia,SOM,0,0,0,15,15
2016,Syrian Arab Rep.,SYR,Somalia,SOM,0,0,0,100,100
2016,Yemen,YEM,Somalia,SOM,0,0,0,10,10
2016,Burundi,BDI,Sudan,SDN,0,5,0,0,5
2016,Eritrea,ERI,Sudan,SDN,148,45,5,15,213
2016,Ethiopia,ETH,Sudan,SDN,12,5,0,0,17
2016,Syrian Arab Rep.,SYR,Sudan,SDN,0,0,0,17,17
2016,Eritrea,ERI,South Sudan,SSD,5,0,0,5,10
2016,Ethiopia,ETH,South Sudan,SSD,13,0,5,43,61
2016,Somalia,SOM,South Sudan,SSD,0,0,0,17,17
2016,Sudan,SDN,South Sudan,SSD,5,0,0,11,16
2016,Afghanistan,AFG,Syrian Arab Rep.,SYR,39,0,13,0,52
2016,Algeria,DZA,Syrian Arab Rep.,SYR,0,0,47,0,47
2016,Egypt,EGY,Syrian Arab Rep.,SYR,0,0,76,5,81
2016,Bangladesh,BGD,Syrian Arab Rep.,SYR,0,0,5,0,5
2016,Burkina Faso,BFA,Syrian Arab Rep.,SYR,0,0,10,0,10
2016,Chad,TCD,Syrian Arab Rep.,SYR,0,0,5,0,5
2016,Chile,CHL,Syrian Arab Rep.,SYR,0,0,5,0,5
2016,Guinea,GIN,Syrian Arab Rep.,SYR,19,0,24,0,43
2016,Cote d'Ivoire,CIV,Syrian Arab Rep.,SYR,0,0,5,0,5
2016,Iran (Islamic Rep. of),IRN,Syrian Arab Rep.,SYR,5,0,645,57,707
2016,Iraq,IRQ,Syrian Arab Rep.,SYR,535,0,24,240,799
2016,Jordan,JOR,Syrian Arab Rep.,SYR,0,0,131,11,142
2016,Libya,LBY,Syrian Arab Rep.,SYR,5,0,0,0,5
2016,Lebanon,LBN,Syrian Arab Rep.,SYR,0,0,295,21,316
2016,Sri Lanka,LKA,Syrian Arab Rep.,SYR,0,0,0,5,5
2016,Mali,MLI,Syrian Arab Rep.,SYR,0,0,0,5,5
2016,Morocco,MAR,Syrian Arab Rep.,SYR,0,0,0,5,5
2016,Pakistan,PAK,Syrian Arab Rep.,SYR,57,0,24,13,94
2016,Philippines,PHL,Syrian Arab Rep.,SYR,0,0,5,0,5
2016,Sierra Leone,SLE,Syrian Arab Rep.,SYR,15,0,5,0,20
2016,Somalia,SOM,Syrian Arab Rep.,SYR,5,0,0,10,15
2016,Sudan,SDN,Syrian Arab Rep.,SYR,28,0,32,0,60
2016,Tunisia,TUN,Syrian Arab Rep.,SYR,0,0,15,0,15
2016,Ukraine,UKR,Syrian Arab Rep.,SYR,0,0,5,0,5
2016,Yemen,YEM,Syrian Arab Rep.,SYR,0,0,0,14,14
2016,Stateless,XXA,Syrian Arab Rep.,SYR,0,0,0,5,5
2016,Afghanistan,AFG,Thailand,THA,44,0,5,10,59
2016,Egypt,EGY,Thailand,THA,0,0,0,14,14
2016,Bangladesh,BGD,Thailand,THA,0,0,0,5,5
2016,Cambodia,KHM,Thailand,THA,36,0,13,10,59
2016,China,CHN,Thailand,THA,97,0,16,24,137
2016,Cameroon,CMR,Thailand,THA,0,0,0,11,11
2016,Dem. Rep. of the Congo,COD,Thailand,THA,15,0,0,5,20
2016,Eritrea,ERI,Thailand,THA,5,0,0,0,5
2016,Ethiopia,ETH,Thailand,THA,5,0,5,14,24
2016,Palestinian,PSE,Thailand,THA,103,0,10,17,130
2016,Guinea,GIN,Thailand,THA,0,0,0,5,5
2016,Cote d'Ivoire,CIV,Thailand,THA,5,0,0,0,5
2016,India,IND,Thailand,THA,0,0,15,11,26
2016,Iran (Islamic Rep. of),IRN,Thailand,THA,10,0,25,41,76
2016,Iraq,IRQ,Thailand,THA,171,0,0,73,244
2016,Jordan,JOR,Thailand,THA,0,0,5,0,5
2016,Liberia,LBR,Thailand,THA,0,0,0,5,5
2016,Sri Lanka,LKA,Thailand,THA,16,0,36,37,89
2016,Nepal,NPL,Thailand,THA,5,0,5,0,10
2016,Nigeria,NGA,Thailand,THA,0,0,5,11,16
2016,Pakistan,PAK,Thailand,THA,1396,0,960,636,2992
2016,Russian Federation,RUS,Thailand,THA,0,0,5,0,5
2016,Sierra Leone,SLE,Thailand,THA,0,0,5,0,5
2016,Somalia,SOM,Thailand,THA,108,0,34,95,237
2016,Viet Nam,VNM,Thailand,THA,121,0,55,98,274
2016,Sudan,SDN,Thailand,THA,5,0,5,11,21
2016,Syrian Arab Rep.,SYR,Thailand,THA,230,0,0,41,271
2016,Ukraine,UKR,Thailand,THA,5,0,0,0,5
2016,Uzbekistan,UZB,Thailand,THA,0,0,0,5,5
2016,Yemen,YEM,Thailand,THA,14,0,0,15,29
2016,Afghanistan,AFG,Tajikistan,TJK,11,0,0,20,31
2016,Colombia,COL,Trinidad and Tobago,TTO,5,0,0,0,5
2016,Cuba,CUB,Trinidad and Tobago,TTO,5,0,0,15,20
2016,Syrian Arab Rep.,SYR,Trinidad and Tobago,TTO,14,0,0,0,14
2016,Cote d'Ivoire,CIV,Tunisia,TUN,0,0,0,38,38
2016,Iraq,IRQ,Tunisia,TUN,12,0,0,0,12
2016,Morocco,MAR,Tunisia,TUN,5,0,0,0,5
2016,Somalia,SOM,Tunisia,TUN,0,0,0,5,5
2016,Sudan,SDN,Tunisia,TUN,0,0,0,5,5
2016,Turkey,TUR,Tunisia,TUN,5,0,0,0,5
2016,Afghanistan,AFG,Turkey,TUR,1252,0,0,8872,10124
2016,Egypt,EGY,Turkey,TUR,25,0,29,44,98
2016,Burundi,BDI,Turkey,TUR,0,0,0,5,5
2016,Bangladesh,BGD,Turkey,TUR,0,0,0,233,233
2016,Central African Rep.,CAF,Turkey,TUR,0,0,0,10,10
2016,China,CHN,Turkey,TUR,0,0,0,27,27
2016,Cameroon,CMR,Turkey,TUR,5,0,0,38,43
2016,Congo,COG,Turkey,TUR,0,0,0,147,147
2016,Dem. Rep. of the Congo,COD,Turkey,TUR,14,0,5,123,142
2016,Eritrea,ERI,Turkey,TUR,11,0,0,125,136
2016,Ethiopia,ETH,Turkey,TUR,16,0,0,45,61
2016,Gabon,GAB,Turkey,TUR,0,0,0,5,5
2016,Gambia,GMB,Turkey,TUR,0,0,0,5,5
2016,Palestinian,PSE,Turkey,TUR,105,0,0,158,263
2016,Ghana,GHA,Turkey,TUR,0,0,0,13,13
2016,Guinea,GIN,Turkey,TUR,0,0,0,5,5
2016,Cote d'Ivoire,CIV,Turkey,TUR,0,0,0,19,19
2016,India,IND,Turkey,TUR,0,0,0,10,10
2016,Iran (Islamic Rep. of),IRN,Turkey,TUR,3764,0,753,2088,6605
2016,Iraq,IRQ,Turkey,TUR,12615,0,36,10887,23538
2016,Jordan,JOR,Turkey,TUR,5,0,0,16,21
2016,Kazakhstan,KAZ,Turkey,TUR,0,0,0,22,22
2016,Kyrgyzstan,KGZ,Turkey,TUR,0,0,0,16,16
2016,Libya,LBY,Turkey,TUR,13,0,0,10,23
2016,Lebanon,LBN,Turkey,TUR,5,0,0,19,24
2016,Sri Lanka,LKA,Turkey,TUR,0,0,0,5,5
2016,Mali,MLI,Turkey,TUR,0,0,5,5,10
2016,Mongolia,MNG,Turkey,TUR,0,0,0,33,33
2016,Morocco,MAR,Turkey,TUR,5,0,0,13,18
2016,Myanmar,MMR,Turkey,TUR,0,0,0,5,5
2016,Nepal,NPL,Turkey,TUR,0,0,0,5,5
2016,Nigeria,NGA,Turkey,TUR,0,0,0,53,53
2016,Pakistan,PAK,Turkey,TUR,14,0,0,1828,1842
2016,Philippines,PHL,Turkey,TUR,0,0,0,5,5
2016,Saudi Arabia,SAU,Turkey,TUR,5,0,0,0,5
2016,Senegal,SEN,Turkey,TUR,0,0,0,14,14
2016,Sierra Leone,SLE,Turkey,TUR,0,0,0,5,5
2016,Somalia,SOM,Turkey,TUR,189,0,0,661,850
2016,Sudan,SDN,Turkey,TUR,30,0,5,38,73
2016,Syrian Arab Rep.,SYR,Turkey,TUR,10,0,0,128,138
2016,Tajikistan,TJK,Turkey,TUR,0,0,10,42,52
2016,Turkmenistan,TKM,Turkey,TUR,0,0,5,108,113
2016,Tunisia,TUN,Turkey,TUR,0,0,0,10,10
2016,United Arab Emirates,ARE,Turkey,TUR,0,0,0,5,5
2016,Uganda,UGA,Turkey,TUR,5,0,27,155,187
2016,Uzbekistan,UZB,Turkey,TUR,5,0,0,109,114
2016,Yemen,YEM,Turkey,TUR,74,0,0,91,165
2016,Stateless,XXA,Turkey,TUR,14,0,0,0,14
2016,Afghanistan,AFG,Ukraine,UKR,17,0,0,5,22
2016,Dem. Rep. of the Congo,COD,Ukraine,UKR,5,0,0,0,5
2016,Guinea,GIN,Ukraine,UKR,5,0,0,0,5
2016,Iran (Islamic Rep. of),IRN,Ukraine,UKR,5,0,0,0,5
2016,Kyrgyzstan,KGZ,Ukraine,UKR,0,0,10,0,10
2016,Russian Federation,RUS,Ukraine,UKR,0,0,0,10,10
2016,Somalia,SOM,Ukraine,UKR,24,0,0,5,29
2016,Syrian Arab Rep.,SYR,Ukraine,UKR,10,0,0,15,25
2016,Uzbekistan,UZB,Ukraine,UKR,0,0,0,5,5
2016,Sri Lanka,LKA,Samoa,WSM,5,0,0,0,5
2016,Egypt,EGY,Yemen,YEM,0,0,0,12,12
2016,Djibouti,DJI,Yemen,YEM,5,0,0,0,5
2016,Eritrea,ERI,Yemen,YEM,118,0,0,220,338
2016,Ethiopia,ETH,Yemen,YEM,165,0,121,3966,4252
2016,Palestinian,PSE,Yemen,YEM,64,0,0,75,139
2016,Iran (Islamic Rep. of),IRN,Yemen,YEM,0,0,0,5,5
2016,Iraq,IRQ,Yemen,YEM,10,0,0,100,110
2016,Jordan,JOR,Yemen,YEM,0,0,0,5,5
2016,Viet Nam,VNM,Yemen,YEM,0,0,0,5,5
2016,Sudan,SDN,Yemen,YEM,36,0,10,49,95
2016,Syrian Arab Rep.,SYR,Yemen,YEM,14,0,0,99,113
2016,Uzbekistan,UZB,Yemen,YEM,0,0,0,5,5
2016,Colombia,COL,Curacao ,CUW,5,0,0,5,10
2016,Cuba,CUB,Curacao ,CUW,0,0,5,0,5
2016,Syrian Arab Rep.,SYR,Curacao ,CUW,0,0,0,5,5
2016,Venezuela (Bolivarian Republic of),VEN,Curacao ,CUW,5,0,0,0,5
2016,Syrian Arab Rep.,SYR,Sint Maarten (Dutch part),SXM,0,0,0,5,5
2017,Iran (Islamic Rep. of),IRN,Afghanistan,AFG,5,0,0,0,5
2017,Pakistan,PAK,Afghanistan,AFG,5,0,5,13,23
2017,Turkey,TUR,Afghanistan,AFG,0,0,0,10,10
2017,Burkina Faso,BFA,Algeria,DZA,0,0,5,0,5
2017,Central African Rep.,CAF,Algeria,DZA,15,0,5,0,20
2017,Chad,TCD,Algeria,DZA,5,0,0,0,5
2017,Cameroon,CMR,Algeria,DZA,10,0,11,0,21
2017,Dem. Rep. of the Congo,COD,Algeria,DZA,14,0,5,0,19
2017,Guinea,GIN,Algeria,DZA,5,0,14,5,24
2017,Cote d'Ivoire,CIV,Algeria,DZA,5,0,12,0,17
2017,Libya,LBY,Algeria,DZA,0,0,0,13,13
2017,Lebanon,LBN,Algeria,DZA,0,0,0,10,10
2017,Mali,MLI,Algeria,DZA,11,0,13,5,29
2017,Syrian Arab Rep.,SYR,Algeria,DZA,11,0,0,1472,1483
2017,Yemen,YEM,Algeria,DZA,0,0,0,53,53
2017,Afghanistan,AFG,Egypt,EGY,0,0,5,10,15
2017,Burundi,BDI,Egypt,EGY,12,0,5,5,22
2017,Bangladesh,BGD,Egypt,EGY,0,0,13,0,13
2017,Central African Rep.,CAF,Egypt,EGY,13,0,0,5,18
2017,Chad,TCD,Egypt,EGY,0,0,12,0,12
2017,Cameroon,CMR,Egypt,EGY,0,0,24,0,24
2017,Congo,COG,Egypt,EGY,0,0,12,5,17
2017,Dem. Rep. of the Congo,COD,Egypt,EGY,0,0,20,0,20
2017,Djibouti,DJI,Egypt,EGY,0,0,0,5,5
2017,Eritrea,ERI,Egypt,EGY,1401,0,16,609,2026
2017,Ethiopia,ETH,Egypt,EGY,1319,0,1750,650,3719
2017,Gambia,GMB,Egypt,EGY,0,0,0,5,5
2017,Palestinian,PSE,Egypt,EGY,0,0,0,12,12
2017,Ghana,GHA,Egypt,EGY,0,0,5,17,22
2017,Guinea,GIN,Egypt,EGY,0,0,10,10,20
2017,Cote d'Ivoire,CIV,Egypt,EGY,0,0,11,5,16
2017,Iraq,IRQ,Egypt,EGY,575,0,10,835,1420
2017,Kenya,KEN,Egypt,EGY,0,0,5,0,5
2017,Kyrgyzstan,KGZ,Egypt,EGY,0,0,0,5,5
2017,Liberia,LBR,Egypt,EGY,0,0,5,0,5
2017,Libya,LBY,Egypt,EGY,0,0,0,5,5
2017,Mali,MLI,Egypt,EGY,0,0,5,0,5
2017,Morocco,MAR,Egypt,EGY,0,0,0,5,5
2017,Niger,NER,Egypt,EGY,0,0,0,5,5
2017,Nigeria,NGA,Egypt,EGY,5,0,82,930,1017
2017,Russian Federation,RUS,Egypt,EGY,0,0,0,26,26
2017,Saudi Arabia,SAU,Egypt,EGY,0,0,0,5,5
2017,Sierra Leone,SLE,Egypt,EGY,0,0,22,5,27
2017,Somalia,SOM,Egypt,EGY,766,0,133,857,1756
2017,Sudan,SDN,Egypt,EGY,3974,0,2471,2247,8692
2017,South Sudan,SSD,Egypt,EGY,2523,0,5,371,2899
2017,Tajikistan,TJK,Egypt,EGY,0,0,5,14,19
2017,Togo,TGO,Egypt,EGY,0,0,0,5,5
2017,Tunisia,TUN,Egypt,EGY,0,0,5,0,5
2017,Uganda,UGA,Egypt,EGY,0,0,13,5,18
2017,Uzbekistan,UZB,Egypt,EGY,0,0,0,5,5
2017,Yemen,YEM,Egypt,EGY,28,0,0,528,556
2017,Zimbabwe,ZWE,Egypt,EGY,5,0,11,0,16
2017,Afghanistan,AFG,Azerbaijan,AZE,44,0,10,0,54
2017,Iran (Islamic Rep. of),IRN,Azerbaijan,AZE,0,0,5,0,5
2017,Iraq,IRQ,Azerbaijan,AZE,5,0,0,0,5
2017,Russian Federation,RUS,Azerbaijan,AZE,10,0,5,37,52
2017,Turkey,TUR,Azerbaijan,AZE,5,0,0,0,5
2017,Yemen,YEM,Azerbaijan,AZE,5,0,0,0,5
2017,Afghanistan,AFG,China,CHN,5,0,0,0,5
2017,Angola,AGO,China,CHN,0,0,0,5,5
2017,Burundi,BDI,China,CHN,5,0,0,5,10
2017,Benin,BEN,China,CHN,0,0,5,0,5
2017,Cameroon,CMR,China,CHN,0,0,15,12,27
2017,Dem. Rep. of the Congo,COD,China,CHN,0,0,0,12,12
2017,Colombia,COL,China,CHN,0,0,5,0,5
2017,Gambia,GMB,China,CHN,0,0,5,5,10
2017,Ghana,GHA,China,CHN,0,0,20,13,33
2017,Guinea,GIN,China,CHN,0,0,5,5,10
2017,Cote d'Ivoire,CIV,China,CHN,0,0,0,11,11
2017,Iraq,IRQ,China,CHN,5,0,0,15,20
2017,Kenya,KEN,China,CHN,0,0,0,5,5
2017,Liberia,LBR,China,CHN,0,0,78,29,107
2017,Mali,MLI,China,CHN,0,0,5,0,5
2017,Mozambique,MOZ,China,CHN,0,0,5,5,10
2017,Niger,NER,China,CHN,0,0,5,0,5
2017,Nigeria,NGA,China,CHN,0,0,52,16,68
2017,Pakistan,PAK,China,CHN,10,0,0,0,10
2017,Philippines,PHL,China,CHN,0,0,0,5,5
2017,Sierra Leone,SLE,China,CHN,0,0,5,0,5
2017,Somalia,SOM,China,CHN,14,0,0,0,14
2017,Syrian Arab Rep.,SYR,China,CHN,23,0,0,0,23
2017,Uganda,UGA,China,CHN,5,0,27,5,37
2017,Yemen,YEM,China,CHN,5,0,0,5,10
2017,Zimbabwe,ZWE,China,CHN,5,0,18,5,28
2017,Central African Rep.,CAF,Cameroon,CMR,1151,0,254,0,1405
2017,Chad,TCD,Cameroon,CMR,25,0,71,0,96
2017,Dem. Rep. of the Congo,COD,Cameroon,CMR,5,0,44,0,49
2017,Guinea-Bissau,GNB,Cameroon,CMR,0,0,5,0,5
2017,Guinea,GIN,Cameroon,CMR,0,0,13,0,13
2017,Cote d'Ivoire,CIV,Cameroon,CMR,0,0,15,0,15
2017,Nigeria,NGA,Cameroon,CMR,5,0,0,0,5
2017,Rwanda,RWA,Cameroon,CMR,5,0,15,0,20
2017,Sudan,SDN,Cameroon,CMR,11,0,0,0,11
2017,Angola,AGO,Cuba,CUB,0,0,5,0,5
2017,Palestinian,PSE,Cuba,CUB,0,0,0,5,5
2017,Iran (Islamic Rep. of),IRN,Cuba,CUB,0,0,5,0,5
2017,Iraq,IRQ,Cuba,CUB,0,0,0,5,5
2017,Syrian Arab Rep.,SYR,Cuba,CUB,10,0,0,0,10
2017,Yemen,YEM,Cuba,CUB,5,0,0,0,5
2017,Pakistan,PAK,Guyana,GUY,5,0,0,0,5
2017,Yemen,YEM,"China, Hong Kong SAR",HKG,5,0,0,0,5
2017,Afghanistan,AFG,India,IND,1477,0,962,826,3265
2017,Congo,COG,India,IND,0,0,5,0,5
2017,Dem. Rep. of the Congo,COD,India,IND,10,0,13,0,23
2017,Eritrea,ERI,India,IND,0,0,0,5,5
2017,Ethiopia,ETH,India,IND,0,0,0,5,5
2017,Palestinian,PSE,India,IND,16,0,0,5,21
2017,Cote d'Ivoire,CIV,India,IND,0,0,5,0,5
2017,Iran (Islamic Rep. of),IRN,India,IND,0,0,5,0,5
2017,Iraq,IRQ,India,IND,104,0,0,57,161
2017,Mali,MLI,India,IND,0,0,0,5,5
2017,Myanmar,MMR,India,IND,2512,0,37,1455,4004
2017,Nigeria,NGA,India,IND,0,0,0,70,70
2017,Philippines,PHL,India,IND,0,0,0,5,5
2017,Russian Federation,RUS,India,IND,0,0,5,5,10
2017,Rwanda,RWA,India,IND,0,0,5,0,5
2017,Somalia,SOM,India,IND,131,0,37,5,173
2017,Sudan,SDN,India,IND,12,0,5,10,27
2017,South Sudan,SSD,India,IND,5,0,0,0,5
2017,Syrian Arab Rep.,SYR,India,IND,37,0,0,5,42
2017,Uganda,UGA,India,IND,0,0,0,5,5
2017,Ukraine,UKR,India,IND,0,0,0,5,5
2017,Uzbekistan,UZB,India,IND,5,0,0,0,5
2017,Yemen,YEM,India,IND,0,0,0,26,26
2017,Afghanistan,AFG,Indonesia,IDN,1467,0,0,47,1514
2017,Algeria,DZA,Indonesia,IDN,0,0,0,5,5
2017,Egypt,EGY,Indonesia,IDN,0,0,10,5,15
2017,Bangladesh,BGD,Indonesia,IDN,0,0,10,45,55
2017,Belarus,BLR,Indonesia,IDN,0,0,0,5,5
2017,China,CHN,Indonesia,IDN,0,0,0,5,5
2017,Cameroon,CMR,Indonesia,IDN,0,0,32,10,42
2017,Dem. Rep. of the Congo,COD,Indonesia,IDN,0,0,12,5,17
2017,Eritrea,ERI,Indonesia,IDN,12,0,0,0,12
2017,Ethiopia,ETH,Indonesia,IDN,80,0,64,13,157
2017,Gabon,GAB,Indonesia,IDN,0,0,0,12,12
2017,Palestinian,PSE,Indonesia,IDN,15,0,0,76,91
2017,Ghana,GHA,Indonesia,IDN,0,0,5,0,5
2017,Guinea,GIN,Indonesia,IDN,0,0,5,5,10
2017,Cote d'Ivoire,CIV,Indonesia,IDN,0,0,5,5,10
2017,India,IND,Indonesia,IDN,0,0,0,11,11
2017,Iran (Islamic Rep. of),IRN,Indonesia,IDN,37,0,19,14,70
2017,Iraq,IRQ,Indonesia,IDN,212,0,5,161,378
2017,Kuwait,KWT,Indonesia,IDN,0,0,0,5,5
2017,Liberia,LBR,Indonesia,IDN,0,0,0,14,14
2017,Libya,LBY,Indonesia,IDN,11,0,0,0,11
2017,Sri Lanka,LKA,Indonesia,IDN,36,0,36,54,126
2017,Mali,MLI,Indonesia,IDN,0,0,5,0,5
2017,Myanmar,MMR,Indonesia,IDN,18,0,0,49,67
2017,Nigeria,NGA,Indonesia,IDN,0,0,149,696,845
2017,Pakistan,PAK,Indonesia,IDN,47,0,0,10,57
2017,Senegal,SEN,Indonesia,IDN,0,0,5,0,5
2017,Sierra Leone,SLE,Indonesia,IDN,0,0,5,14,19
2017,Somalia,SOM,Indonesia,IDN,452,0,10,117,579
2017,Viet Nam,VNM,Indonesia,IDN,18,0,0,0,18
2017,Sudan,SDN,Indonesia,IDN,104,0,0,19,123
2017,Syrian Arab Rep.,SYR,Indonesia,IDN,0,0,0,15,15
2017,Turkey,TUR,Indonesia,IDN,0,0,0,5,5
2017,Yemen,YEM,Indonesia,IDN,66,0,0,78,144
2017,Afghanistan,AFG,Iran (Islamic Rep. of),IRN,0,0,0,5,5
2017,Eritrea,ERI,Iraq,IRQ,5,0,0,0,5
2017,Palestinian,PSE,Iraq,IRQ,0,0,0,130,130
2017,Iran (Islamic Rep. of),IRN,Iraq,IRQ,5,0,0,457,462
2017,Kuwait,KWT,Iraq,IRQ,0,0,0,10,10
2017,Saudi Arabia,SAU,Iraq,IRQ,0,0,0,13,13
2017,South Sudan,SSD,Iraq,IRQ,5,0,10,155,170
2017,Turkey,TUR,Iraq,IRQ,0,0,0,192,192
2017,Eritrea,ERI,Israel,ISR,177,0,0,0,177
2017,Ethiopia,ETH,Israel,ISR,5,0,0,0,5
2017,Palestinian,PSE,Israel,ISR,5,0,0,0,5
2017,Sudan,SDN,Israel,ISR,26,0,0,0,26
2017,South Sudan,SSD,Israel,ISR,22,0,0,0,22
2017,Burkina Faso,BFA,Jordan,JOR,0,0,0,5,5
2017,Eritrea,ERI,Jordan,JOR,5,0,0,0,5
2017,Ethiopia,ETH,Jordan,JOR,5,0,0,0,5
2017,Iraq,IRQ,Jordan,JOR,1605,0,0,0,1605
2017,Libya,LBY,Jordan,JOR,11,0,0,0,11
2017,Lebanon,LBN,Jordan,JOR,5,0,0,0,5
2017,Somalia,SOM,Jordan,JOR,25,0,0,0,25
2017,Sudan,SDN,Jordan,JOR,269,0,10,0,279
2017,Tunisia,TUN,Jordan,JOR,0,0,0,5,5
2017,Ukraine,UKR,Jordan,JOR,0,0,0,10,10
2017,Yemen,YEM,Jordan,JOR,304,0,0,0,304
2017,Stateless,XXA,Jordan,JOR,0,0,0,168,168
2017,Iran (Islamic Rep. of),IRN,Kuwait,KWT,0,0,5,13,18
2017,Iraq,IRQ,Kuwait,KWT,5,0,0,0,5
2017,Dem. People's Rep. of Korea,PRK,Kuwait,KWT,5,0,0,0,5
2017,Turkey,TUR,Kuwait,KWT,5,0,0,0,5
2017,Stateless,XXA,Kuwait,KWT,0,0,0,16,16
2017,Eritrea,ERI,Libya,LBY,34,0,0,0,34
2017,Palestinian,PSE,Libya,LBY,5,0,0,0,5
2017,Iraq,IRQ,Libya,LBY,5,0,0,0,5
2017,Sudan,SDN,Libya,LBY,5,0,0,0,5
2017,Syrian Arab Rep.,SYR,Libya,LBY,115,0,0,0,115
2017,Egypt,EGY,Lebanon,LBN,22,0,27,22,71
2017,Bangladesh,BGD,Lebanon,LBN,0,0,5,5,10
2017,Cameroon,CMR,Lebanon,LBN,0,0,0,5,5
2017,Eritrea,ERI,Lebanon,LBN,5,0,20,16,41
2017,Ethiopia,ETH,Lebanon,LBN,12,0,152,126,290
2017,Iran (Islamic Rep. of),IRN,Lebanon,LBN,0,0,10,10,20
2017,Iraq,IRQ,Lebanon,LBN,149,0,10,15,174
2017,Jordan,JOR,Lebanon,LBN,14,0,0,0,14
2017,Kenya,KEN,Lebanon,LBN,0,0,5,5,10
2017,Sri Lanka,LKA,Lebanon,LBN,0,0,0,5,5
2017,Madagascar,MDG,Lebanon,LBN,0,0,0,5,5
2017,Saudi Arabia,SAU,Lebanon,LBN,5,0,0,0,5
2017,Somalia,SOM,Lebanon,LBN,0,0,5,0,5
2017,Sudan,SDN,Lebanon,LBN,65,0,299,226,590
2017,South Sudan,SSD,Lebanon,LBN,5,0,0,0,5
2017,Syrian Arab Rep.,SYR,Lebanon,LBN,0,0,0,5,5
2017,Turkey,TUR,Lebanon,LBN,0,0,0,5,5
2017,Yemen,YEM,Lebanon,LBN,5,0,0,0,5
2017,Afghanistan,AFG,Sri Lanka,LKA,57,0,0,13,70
2017,Pakistan,PAK,Sri Lanka,LKA,189,0,0,22,211
2017,Syrian Arab Rep.,SYR,Sri Lanka,LKA,5,0,0,0,5
2017,Yemen,YEM,Sri Lanka,LKA,11,0,0,0,11
2017,Afghanistan,AFG,Madagascar,MDG,5,0,0,0,5
2017,Kyrgyzstan,KGZ,Madagascar,MDG,0,0,0,5,5
2017,Turkey,TUR,Madagascar,MDG,0,0,0,23,23
2017,Yemen,YEM,Madagascar,MDG,12,0,0,0,12
2017,Central African Rep.,CAF,Mauritania,MRT,45,0,0,34,79
2017,Chad,TCD,Mauritania,MRT,0,0,0,5,5
2017,Cameroon,CMR,Mauritania,MRT,0,0,10,0,10
2017,Congo,COG,Mauritania,MRT,5,0,0,0,5
2017,Palestinian,PSE,Mauritania,MRT,5,0,0,5,10
2017,Ghana,GHA,Mauritania,MRT,0,0,0,5,5
2017,Guinea,GIN,Mauritania,MRT,0,0,10,5,15
2017,Cote d'Ivoire,CIV,Mauritania,MRT,10,0,10,0,20
2017,Liberia,LBR,Mauritania,MRT,0,0,0,5,5
2017,Mali,MLI,Mauritania,MRT,0,0,5,0,5
2017,Nigeria,NGA,Mauritania,MRT,5,0,28,23,56
2017,Senegal,SEN,Mauritania,MRT,17,0,12,5,34
2017,Syrian Arab Rep.,SYR,Mauritania,MRT,96,0,0,14,110
2017,Togo,TGO,Mauritania,MRT,0,0,5,0,5
2017,Turkey,TUR,Mauritania,MRT,0,0,0,11,11
2017,Afghanistan,AFG,Malaysia,MYS,164,0,37,0,201
2017,Egypt,EGY,Malaysia,MYS,0,0,5,0,5
2017,Bangladesh,BGD,Malaysia,MYS,0,0,5,5,10
2017,Cambodia,KHM,Malaysia,MYS,5,0,0,24,29
2017,China,CHN,Malaysia,MYS,5,0,0,5,10
2017,Ethiopia,ETH,Malaysia,MYS,5,0,0,0,5
2017,Palestinian,PSE,Malaysia,MYS,13,0,5,0,18
2017,United Kingdom of Great Britain and Northern Ireland,GBR,Malaysia,MYS,0,0,0,5,5
2017,Guinea,GIN,Malaysia,MYS,0,0,5,0,5
2017,Indonesia,IDN,Malaysia,MYS,15,0,5,268,288
2017,Iran (Islamic Rep. of),IRN,Malaysia,MYS,11,0,22,17,50
2017,Iraq,IRQ,Malaysia,MYS,32,0,0,0,32
2017,Jordan,JOR,Malaysia,MYS,0,0,0,5,5
2017,Liberia,LBR,Malaysia,MYS,0,0,10,0,10
2017,Lebanon,LBN,Malaysia,MYS,0,0,0,5,5
2017,Sri Lanka,LKA,Malaysia,MYS,35,0,200,28,263
2017,Myanmar,MMR,Malaysia,MYS,17566,0,2135,11843,31544
2017,Nepal,NPL,Malaysia,MYS,0,0,0,5,5
2017,Pakistan,PAK,Malaysia,MYS,508,0,230,0,738
2017,Philippines,PHL,Malaysia,MYS,0,0,0,5,5
2017,Somalia,SOM,Malaysia,MYS,169,0,48,59,276
2017,Sudan,SDN,Malaysia,MYS,30,0,11,0,41
2017,South Sudan,SSD,Malaysia,MYS,0,0,0,13,13
2017,Syrian Arab Rep.,SYR,Malaysia,MYS,29,0,0,35,64
2017,Thailand,THA,Malaysia,MYS,0,0,0,20,20
2017,Turkey,TUR,Malaysia,MYS,0,0,0,13,13
2017,United States of America,USA,Malaysia,MYS,0,0,0,5,5
2017,Uzbekistan,UZB,Malaysia,MYS,0,0,5,0,5
2017,Yemen,YEM,Malaysia,MYS,34,0,0,0,34
2017,Afghanistan,AFG,Mongolia,MNG,5,0,0,0,5
2017,Algeria,DZA,Morocco,MAR,0,0,0,10,10
2017,Egypt,EGY,Morocco,MAR,5,0,0,0,5
2017,Burundi,BDI,Morocco,MAR,0,0,0,5,5
2017,Benin,BEN,Morocco,MAR,0,0,5,0,5
2017,Bangladesh,BGD,Morocco,MAR,0,0,0,5,5
2017,Burkina Faso,BFA,Morocco,MAR,0,0,5,5,10
2017,Central African Rep.,CAF,Morocco,MAR,83,0,5,14,102
2017,Chad,TCD,Morocco,MAR,0,0,5,0,5
2017,Cameroon,CMR,Morocco,MAR,25,0,122,313,460
2017,Congo,COG,Morocco,MAR,0,0,41,36,77
2017,Dem. Rep. of the Congo,COD,Morocco,MAR,10,0,123,91,224
2017,Gambia,GMB,Morocco,MAR,0,0,5,19,24
2017,Palestinian,PSE,Morocco,MAR,19,0,0,5,24
2017,Ghana,GHA,Morocco,MAR,0,0,0,5,5
2017,Guinea-Bissau,GNB,Morocco,MAR,0,0,0,5,5
2017,Guinea,GIN,Morocco,MAR,5,0,156,158,319
2017,Cote d'Ivoire,CIV,Morocco,MAR,29,0,135,142,306
2017,Iraq,IRQ,Morocco,MAR,23,0,0,10,33
2017,Liberia,LBR,Morocco,MAR,0,0,18,5,23
2017,Libya,LBY,Morocco,MAR,15,0,0,16,31
2017,Lebanon,LBN,Morocco,MAR,0,0,5,37,42
2017,Mali,MLI,Morocco,MAR,0,0,48,87,135
2017,Niger,NER,Morocco,MAR,0,0,0,5,5
2017,Nigeria,NGA,Morocco,MAR,5,0,27,69,101
2017,Senegal,SEN,Morocco,MAR,30,0,47,49,126
2017,Sierra Leone,SLE,Morocco,MAR,0,0,12,0,12
2017,Somalia,SOM,Morocco,MAR,5,0,0,5,10
2017,Sudan,SDN,Morocco,MAR,0,0,0,10,10
2017,Syrian Arab Rep.,SYR,Morocco,MAR,24,0,0,795,819
2017,Turkey,TUR,Morocco,MAR,0,0,0,126,126
2017,Yemen,YEM,Morocco,MAR,5,0,0,91,96
2017,Syrian Arab Rep.,SYR,Mauritius,MUS,5,0,0,0,5
2017,Myanmar,MMR,Nepal,NPL,41,0,0,5,46
2017,Pakistan,PAK,Nepal,NPL,5,0,0,0,5
2017,Somalia,SOM,Nepal,NPL,5,0,0,0,5
2017,Afghanistan,AFG,Pakistan,PAK,0,0,0,1986,1986
2017,Egypt,EGY,Pakistan,PAK,0,0,0,5,5
2017,Palestinian,PSE,Pakistan,PAK,0,0,0,5,5
2017,Iran (Islamic Rep. of),IRN,Pakistan,PAK,5,0,0,0,5
2017,Iraq,IRQ,Pakistan,PAK,0,0,10,0,10
2017,Somalia,SOM,Pakistan,PAK,35,0,0,0,35
2017,Syrian Arab Rep.,SYR,Pakistan,PAK,13,0,0,0,13
2017,Tajikistan,TJK,Pakistan,PAK,5,0,0,0,5
2017,Turkey,TUR,Pakistan,PAK,0,0,0,150,150
2017,Yemen,YEM,Pakistan,PAK,89,0,0,11,100
2017,Syrian Arab Rep.,SYR,Palau,PLW,5,0,0,0,5
2017,Egypt,EGY,Qatar,QAT,10,0,0,0,10
2017,Iraq,IRQ,Qatar,QAT,5,0,0,0,5
2017,Chad,TCD,Saudi Arabia,SAU,10,0,0,0,10
2017,Syrian Arab Rep.,SYR,Saudi Arabia,SAU,0,0,0,5,5
2017,Yemen,YEM,Saudi Arabia,SAU,5,0,0,0,5
2017,Eritrea,ERI,Somalia,SOM,10,0,0,0,10
2017,Ethiopia,ETH,Somalia,SOM,590,0,51,27,668
2017,Yemen,YEM,Somalia,SOM,272,0,0,0,272
2017,Egypt,EGY,Sudan,SDN,0,0,0,20,20
2017,Burundi,BDI,Sudan,SDN,0,0,0,5,5
2017,Central African Rep.,CAF,Sudan,SDN,0,0,0,5,5
2017,Chad,TCD,Sudan,SDN,0,0,0,5,5
2017,Congo,COG,Sudan,SDN,0,0,0,5,5
2017,Dem. Rep. of the Congo,COD,Sudan,SDN,0,0,0,181,181
2017,Eritrea,ERI,Sudan,SDN,4173,0,72,0,4245
2017,Ethiopia,ETH,Sudan,SDN,307,0,75,0,382
2017,Somalia,SOM,Sudan,SDN,27,0,0,0,27
2017,Syrian Arab Rep.,SYR,Sudan,SDN,0,0,0,55,55
2017,Cuba,CUB,Suriname,SUR,29,0,14,21,64
2017,Burundi,BDI,South Sudan,SSD,0,0,0,227,227
2017,Eritrea,ERI,South Sudan,SSD,68,0,0,344,412
2017,Ethiopia,ETH,South Sudan,SSD,17,0,0,105,122
2017,Kenya,KEN,South Sudan,SSD,0,0,0,5,5
2017,Somalia,SOM,South Sudan,SSD,0,0,0,136,136
2017,Sudan,SDN,South Sudan,SSD,0,0,0,10,10
2017,Afghanistan,AFG,Syrian Arab Rep.,SYR,34,0,86,20,140
2017,Algeria,DZA,Syrian Arab Rep.,SYR,0,0,22,12,34
2017,Egypt,EGY,Syrian Arab Rep.,SYR,5,0,52,5,62
2017,Burkina Faso,BFA,Syrian Arab Rep.,SYR,0,0,5,0,5
2017,Bosnia and Herzegovina,BIH,Syrian Arab Rep.,SYR,0,0,5,0,5
2017,Chad,TCD,Syrian Arab Rep.,SYR,0,0,12,5,17
2017,Ethiopia,ETH,Syrian Arab Rep.,SYR,0,0,5,0,5
2017,Palestinian,PSE,Syrian Arab Rep.,SYR,0,0,0,5,5
2017,Iran (Islamic Rep. of),IRN,Syrian Arab Rep.,SYR,18,0,151,5,174
2017,Iraq,IRQ,Syrian Arab Rep.,SYR,424,0,76,2314,2814
2017,Jordan,JOR,Syrian Arab Rep.,SYR,0,0,20,5,25
2017,Lebanon,LBN,Syrian Arab Rep.,SYR,0,0,32,5,37
2017,Pakistan,PAK,Syrian Arab Rep.,SYR,14,0,29,0,43
2017,Romania,ROU,Syrian Arab Rep.,SYR,0,0,5,0,5
2017,Saudi Arabia,SAU,Syrian Arab Rep.,SYR,0,0,12,0,12
2017,Sierra Leone,SLE,Syrian Arab Rep.,SYR,0,0,5,5,10
2017,Somalia,SOM,Syrian Arab Rep.,SYR,16,0,0,0,16
2017,Sudan,SDN,Syrian Arab Rep.,SYR,28,0,38,18,84
2017,Tajikistan,TJK,Syrian Arab Rep.,SYR,0,0,0,5,5
2017,Tunisia,TUN,Syrian Arab Rep.,SYR,0,0,10,0,10
2017,Turkey,TUR,Syrian Arab Rep.,SYR,0,0,13,0,13
2017,Yemen,YEM,Syrian Arab Rep.,SYR,69,0,0,18,87
2017,Stateless,XXA,Syrian Arab Rep.,SYR,0,0,5,0,5
2017,Afghanistan,AFG,Thailand,THA,43,0,0,11,54
2017,Egypt,EGY,Thailand,THA,12,0,14,5,31
2017,Bangladesh,BGD,Thailand,THA,0,0,5,0,5
2017,Cambodia,KHM,Thailand,THA,63,0,20,30,113
2017,China,CHN,Thailand,THA,52,0,10,19,81
2017,Cameroon,CMR,Thailand,THA,0,0,0,5,5
2017,Dem. Rep. of the Congo,COD,Thailand,THA,11,0,0,5,16
2017,Eritrea,ERI,Thailand,THA,5,0,0,0,5
2017,Ethiopia,ETH,Thailand,THA,5,0,5,11,21
2017,Palestinian,PSE,Thailand,THA,31,0,0,12,43
2017,Guinea,GIN,Thailand,THA,0,0,5,5,10
2017,India,IND,Thailand,THA,0,0,5,14,19
2017,Iran (Islamic Rep. of),IRN,Thailand,THA,25,0,34,42,101
2017,Iraq,IRQ,Thailand,THA,94,0,5,11,110
2017,Sri Lanka,LKA,Thailand,THA,27,0,32,26,85
2017,Nepal,NPL,Thailand,THA,0,0,0,5,5
2017,Nigeria,NGA,Thailand,THA,0,0,5,10,15
2017,Pakistan,PAK,Thailand,THA,372,0,1262,833,2467
2017,Philippines,PHL,Thailand,THA,0,0,5,0,5
2017,Russian Federation,RUS,Thailand,THA,0,0,5,5,10
2017,Somalia,SOM,Thailand,THA,80,0,34,36,150
2017,Viet Nam,VNM,Thailand,THA,194,0,191,25,410
2017,Sudan,SDN,Thailand,THA,0,0,0,5,5
2017,Syrian Arab Rep.,SYR,Thailand,THA,73,0,0,17,90
2017,Uzbekistan,UZB,Thailand,THA,0,0,0,5,5
2017,Yemen,YEM,Thailand,THA,24,0,0,0,24
2017,Zimbabwe,ZWE,Thailand,THA,10,0,0,0,10
2017,Afghanistan,AFG,Tajikistan,TJK,0,0,0,17,17
2017,Bangladesh,BGD,Trinidad and Tobago,TTO,5,0,5,0,10
2017,Cuba,CUB,Trinidad and Tobago,TTO,85,0,5,10,100
2017,Guyana,GUY,Trinidad and Tobago,TTO,5,0,0,0,5
2017,Jamaica,JAM,Trinidad and Tobago,TTO,18,0,0,0,18
2017,Pakistan,PAK,Trinidad and Tobago,TTO,5,0,0,0,5
2017,Syrian Arab Rep.,SYR,Trinidad and Tobago,TTO,27,0,0,0,27
2017,Saint Vincent and the Grenadines,VCT,Trinidad and Tobago,TTO,5,0,0,0,5
2017,Venezuela (Bolivarian Republic of),VEN,Trinidad and Tobago,TTO,46,0,0,5,51
2017,Congo,COG,Tunisia,TUN,0,0,5,0,5
2017,Palestinian,PSE,Tunisia,TUN,5,0,0,0,5
2017,Cote d'Ivoire,CIV,Tunisia,TUN,0,0,5,0,5
2017,Iraq,IRQ,Tunisia,TUN,5,0,0,16,21
2017,Sierra Leone,SLE,Tunisia,TUN,0,0,0,5,5
2017,Yemen,YEM,Tunisia,TUN,0,0,0,5,5
2017,Afghanistan,AFG,Turkey,TUR,2670,0,0,21532,24202
2017,Algeria,DZA,Turkey,TUR,0,0,0,10,10
2017,Angola,AGO,Turkey,TUR,0,0,0,5,5
2017,Egypt,EGY,Turkey,TUR,5,0,0,25,30
2017,Burundi,BDI,Turkey,TUR,5,0,0,5,10
2017,Bangladesh,BGD,Turkey,TUR,0,0,0,21,21
2017,China,CHN,Turkey,TUR,0,0,0,5,5
2017,Cameroon,CMR,Turkey,TUR,0,0,0,31,31
2017,Congo,COG,Turkey,TUR,0,0,0,63,63
2017,Dem. Rep. of the Congo,COD,Turkey,TUR,5,0,5,68,78
2017,Djibouti,DJI,Turkey,TUR,0,0,0,5,5
2017,Dominican Rep.,DOM,Turkey,TUR,0,0,0,5,5
2017,Eritrea,ERI,Turkey,TUR,0,0,0,24,24
2017,Ethiopia,ETH,Turkey,TUR,10,0,0,62,72
2017,Palestinian,PSE,Turkey,TUR,160,0,0,213,373
2017,Ghana,GHA,Turkey,TUR,0,0,0,5,5
2017,Guinea,GIN,Turkey,TUR,5,0,0,5,10
2017,Cote d'Ivoire,CIV,Turkey,TUR,0,0,0,5,5
2017,Iran (Islamic Rep. of),IRN,Turkey,TUR,2143,0,785,5848,8776
2017,Iraq,IRQ,Turkey,TUR,10200,0,5,18318,28523
2017,Jordan,JOR,Turkey,TUR,0,0,0,13,13
2017,Kazakhstan,KAZ,Turkey,TUR,0,0,0,17,17
2017,Kenya,KEN,Turkey,TUR,0,0,0,5,5
2017,Kyrgyzstan,KGZ,Turkey,TUR,0,0,0,31,31
2017,Kuwait,KWT,Turkey,TUR,0,0,0,5,5
2017,Lebanon,LBN,Turkey,TUR,0,0,0,5,5
2017,Sri Lanka,LKA,Turkey,TUR,5,0,0,0,5
2017,Mali,MLI,Turkey,TUR,0,0,0,5,5
2017,Mongolia,MNG,Turkey,TUR,0,0,0,20,20
2017,Morocco,MAR,Turkey,TUR,0,0,0,18,18
2017,Myanmar,MMR,Turkey,TUR,0,0,0,10,10
2017,Nigeria,NGA,Turkey,TUR,0,0,0,28,28
2017,Pakistan,PAK,Turkey,TUR,10,0,5,97,112
2017,Romania,ROU,Turkey,TUR,0,0,0,5,5
2017,Russian Federation,RUS,Turkey,TUR,0,0,0,5,5
2017,Senegal,SEN,Turkey,TUR,0,0,0,5,5
2017,Sierra Leone,SLE,Turkey,TUR,0,0,0,12,12
2017,Somalia,SOM,Turkey,TUR,83,0,5,432,520
2017,Sudan,SDN,Turkey,TUR,10,0,0,22,32
2017,Syrian Arab Rep.,SYR,Turkey,TUR,5,0,0,30,35
2017,Tajikistan,TJK,Turkey,TUR,0,0,0,37,37
2017,Turkmenistan,TKM,Turkey,TUR,0,0,0,123,123
2017,Tunisia,TUN,Turkey,TUR,5,0,0,12,17
2017,United Arab Emirates,ARE,Turkey,TUR,5,0,0,0,5
2017,Uganda,UGA,Turkey,TUR,0,0,11,152,163
2017,Uzbekistan,UZB,Turkey,TUR,5,0,0,143,148
2017,Yemen,YEM,Turkey,TUR,13,0,0,16,29
2017,Afghanistan,AFG,United Arab Emirates,ARE,5,0,0,0,5
2017,Palestinian,PSE,United Arab Emirates,ARE,5,0,0,22,27
2017,Iran (Islamic Rep. of),IRN,United Arab Emirates,ARE,5,0,0,0,5
2017,Iraq,IRQ,United Arab Emirates,ARE,50,0,5,0,55
2017,Lebanon,LBN,United Arab Emirates,ARE,5,0,0,0,5
2017,Saudi Arabia,SAU,United Arab Emirates,ARE,5,0,0,0,5
2017,Sudan,SDN,United Arab Emirates,ARE,5,0,0,0,5
2017,Syrian Arab Rep.,SYR,United Arab Emirates,ARE,45,0,0,247,292
2017,Uganda,UGA,United Arab Emirates,ARE,5,0,0,0,5
2017,Yemen,YEM,United Arab Emirates,ARE,0,0,5,0,5
2017,Afghanistan,AFG,Ukraine,UKR,21,0,0,0,21
2017,Azerbaijan,AZE,Ukraine,UKR,0,0,5,0,5
2017,Somalia,SOM,Ukraine,UKR,5,0,0,0,5
2017,Sudan,SDN,Ukraine,UKR,5,0,0,0,5
2017,Uzbekistan,UZB,Ukraine,UKR,5,0,0,0,5
2017,Colombia,COL,Curacao ,CUW,12,0,5,0,17
2017,Venezuela (Bolivarian Republic of),VEN,Curacao ,CUW,21,0,0,0,21
2018,Turkey,TUR,Afghanistan,AFG,0,0,0,91,91
2018,Benin,BEN,Algeria,DZA,5,0,0,0,5
2018,Burkina Faso,BFA,Algeria,DZA,0,0,5,5,10
2018,Central African Rep.,CAF,Algeria,DZA,18,0,0,14,32
2018,Chad,TCD,Algeria,DZA,10,0,0,5,15
2018,Cameroon,CMR,Algeria,DZA,16,0,21,27,64
2018,Congo,COG,Algeria,DZA,0,0,5,0,5
2018,Dem. Rep. of the Congo,COD,Algeria,DZA,24,0,23,24,71
2018,Palestinian,PSE,Algeria,DZA,0,0,0,5,5
2018,Guinea,GIN,Algeria,DZA,10,0,103,74,187
2018,Cote d'Ivoire,CIV,Algeria,DZA,15,0,63,40,118
2018,Liberia,LBR,Algeria,DZA,0,0,0,11,11
2018,Libya,LBY,Algeria,DZA,0,0,0,5,5
2018,Mali,MLI,Algeria,DZA,24,0,48,36,108
2018,Niger,NER,Algeria,DZA,0,0,0,5,5
2018,Nigeria,NGA,Algeria,DZA,0,0,0,5,5
2018,Sierra Leone,SLE,Algeria,DZA,0,0,0,5,5
2018,Sudan,SDN,Algeria,DZA,5,0,0,5,10
2018,Syrian Arab Rep.,SYR,Algeria,DZA,13,0,0,69,82
2018,Togo,TGO,Algeria,DZA,0,0,0,5,5
2018,Tunisia,TUN,Algeria,DZA,0,0,0,5,5
2018,Yemen,YEM,Algeria,DZA,5,0,0,30,35
2018,Afghanistan,AFG,Egypt,EGY,5,0,0,0,5
2018,Burundi,BDI,Egypt,EGY,5,0,0,0,5
2018,Central African Rep.,CAF,Egypt,EGY,5,0,0,0,5
2018,Chad,TCD,Egypt,EGY,5,0,11,12,28
2018,Cameroon,CMR,Egypt,EGY,0,0,11,0,11
2018,Dem. Rep. of the Congo,COD,Egypt,EGY,5,0,0,0,5
2018,Djibouti,DJI,Egypt,EGY,5,0,0,0,5
2018,Eritrea,ERI,Egypt,EGY,1941,60,10,187,2198
2018,Ethiopia,ETH,Egypt,EGY,1215,33,941,253,2442
2018,Guinea,GIN,Egypt,EGY,0,0,17,18,35
2018,Iraq,IRQ,Egypt,EGY,328,26,5,83,442
2018,Jordan,JOR,Egypt,EGY,5,0,0,0,5
2018,Liberia,LBR,Egypt,EGY,0,0,5,0,5
2018,Libya,LBY,Egypt,EGY,5,0,0,0,5
2018,Niger,NER,Egypt,EGY,0,0,5,0,5
2018,Nigeria,NGA,Egypt,EGY,0,5,56,0,61
2018,Russian Federation,RUS,Egypt,EGY,0,0,5,0,5
2018,Sierra Leone,SLE,Egypt,EGY,0,0,5,0,5
2018,Somalia,SOM,Egypt,EGY,521,17,53,146,737
2018,Sudan,SDN,Egypt,EGY,2013,99,865,980,3957
2018,South Sudan,SSD,Egypt,EGY,2212,53,5,142,2412
2018,Turkey,TUR,Egypt,EGY,0,0,0,26,26
2018,Uganda,UGA,Egypt,EGY,0,0,12,5,17
2018,Uzbekistan,UZB,Egypt,EGY,0,0,0,11,11
2018,Yemen,YEM,Egypt,EGY,20,0,0,319,339
2018,Zimbabwe,ZWE,Egypt,EGY,5,0,0,0,5
2018,Afghanistan,AFG,Azerbaijan,AZE,34,0,0,0,34
2018,Iraq,IRQ,Bahrain,BHR,10,0,0,40,50
2018,Jordan,JOR,Bahrain,BHR,0,0,0,5,5
2018,Turkey,TUR,Bahrain,BHR,0,0,0,5,5
2018,Turkey,TUR,Bangladesh,BGD,0,0,0,101,101
2018,Afghanistan,AFG,China,CHN,0,0,0,5,5
2018,Cameroon,CMR,China,CHN,0,0,24,28,52
2018,Dem. Rep. of the Congo,COD,China,CHN,0,0,0,5,5
2018,Eritrea,ERI,China,CHN,5,0,0,0,5
2018,Palestinian,PSE,China,CHN,0,0,0,13,13
2018,Ghana,GHA,China,CHN,0,0,0,14,14
2018,Guinea,GIN,China,CHN,0,0,0,5,5
2018,Iraq,IRQ,China,CHN,0,0,0,5,5
2018,Kenya,KEN,China,CHN,0,0,20,5,25
2018,Liberia,LBR,China,CHN,0,0,10,55,65
2018,Mozambique,MOZ,China,CHN,0,0,0,13,13
2018,Nigeria,NGA,China,CHN,0,0,5,18,23
2018,Sierra Leone,SLE,China,CHN,0,0,0,11,11
2018,Somalia,SOM,China,CHN,10,0,0,0,10
2018,Syrian Arab Rep.,SYR,China,CHN,10,0,0,12,22
2018,Turkey,TUR,China,CHN,0,0,0,5,5
2018,Uganda,UGA,China,CHN,0,0,0,14,14
2018,Yemen,YEM,China,CHN,5,0,0,10,15
2018,Zimbabwe,ZWE,China,CHN,0,0,11,36,47
2018,Burundi,BDI,Cameroon,CMR,5,0,0,0,5
2018,Central African Rep.,CAF,Cameroon,CMR,2322,0,74,15,2411
2018,Chad,TCD,Cameroon,CMR,30,0,41,0,71
2018,Congo,COG,Cameroon,CMR,0,0,5,0,5
2018,Dem. Rep. of the Congo,COD,Cameroon,CMR,10,0,16,0,26
2018,Gambia,GMB,Cameroon,CMR,0,0,5,0,5
2018,Guinea,GIN,Cameroon,CMR,0,0,17,0,17
2018,Cote d'Ivoire,CIV,Cameroon,CMR,0,0,14,0,14
2018,Nigeria,NGA,Cameroon,CMR,5,0,0,0,5
2018,Rwanda,RWA,Cameroon,CMR,10,0,13,0,23
2018,Senegal,SEN,Cameroon,CMR,0,0,5,0,5
2018,Sudan,SDN,Cameroon,CMR,16,0,0,0,16
2018,Syrian Arab Rep.,SYR,Cameroon,CMR,5,0,0,0,5
2018,Ethiopia,ETH,Cuba,CUB,0,0,5,0,5
2018,Haiti,HTI,Cuba,CUB,0,0,5,0,5
2018,Colombia,COL,Dominican Rep.,DOM,0,0,0,10,10
2018,Cuba,CUB,Dominican Rep.,DOM,0,0,0,15,15
2018,Haiti,HTI,Dominican Rep.,DOM,0,0,0,509,509
2018,Syrian Arab Rep.,SYR,Dominican Rep.,DOM,0,0,0,5,5
2018,Turkey,TUR,Dominican Rep.,DOM,0,0,0,5,5
2018,Cuba,CUB,Guyana,GUY,5,0,0,0,5
2018,Afghanistan,AFG,India,IND,425,0,900,1742,3067
2018,Cameroon,CMR,India,IND,0,0,5,5,10
2018,Congo,COG,India,IND,5,0,0,5,10
2018,Dem. Rep. of the Congo,COD,India,IND,0,0,10,11,21
2018,Eritrea,ERI,India,IND,0,0,0,5,5
2018,Ethiopia,ETH,India,IND,0,0,11,0,11
2018,Palestinian,PSE,India,IND,0,0,0,5,5
2018,Cote d'Ivoire,CIV,India,IND,0,0,0,5,5
2018,Iran (Islamic Rep. of),IRN,India,IND,0,0,0,5,5
2018,Iraq,IRQ,India,IND,12,0,0,49,61
2018,Myanmar,MMR,India,IND,1217,0,46,1768,3031
2018,Nigeria,NGA,India,IND,0,0,0,10,10
2018,Russian Federation,RUS,India,IND,0,0,0,5,5
2018,Somalia,SOM,India,IND,15,0,69,83,167
2018,Sudan,SDN,India,IND,5,0,0,17,22
2018,Syrian Arab Rep.,SYR,India,IND,0,0,0,12,12
2018,Ukraine,UKR,India,IND,0,0,0,5,5
2018,Yemen,YEM,India,IND,0,0,0,36,36
2018,Afghanistan,AFG,Indonesia,IDN,873,0,0,59,932
2018,Egypt,EGY,Indonesia,IDN,0,0,0,12,12
2018,Bangladesh,BGD,Indonesia,IDN,0,0,10,5,15
2018,China,CHN,Indonesia,IDN,5,0,0,0,5
2018,Cameroon,CMR,Indonesia,IDN,0,0,29,22,51
2018,Dem. Rep. of the Congo,COD,Indonesia,IDN,0,0,11,0,11
2018,Eritrea,ERI,Indonesia,IDN,10,0,0,0,10
2018,Ethiopia,ETH,Indonesia,IDN,17,0,17,0,34
2018,Palestinian,PSE,Indonesia,IDN,10,0,0,10,20
2018,Ghana,GHA,Indonesia,IDN,0,0,5,0,5
2018,Cote d'Ivoire,CIV,Indonesia,IDN,0,0,14,0,14
2018,India,IND,Indonesia,IDN,0,0,5,5,10
2018,Iran (Islamic Rep. of),IRN,Indonesia,IDN,45,0,38,0,83
2018,Iraq,IRQ,Indonesia,IDN,75,0,0,70,145
2018,Libya,LBY,Indonesia,IDN,5,0,0,0,5
2018,Lebanon,LBN,Indonesia,IDN,5,0,0,0,5
2018,Sri Lanka,LKA,Indonesia,IDN,43,0,43,35,121
2018,Myanmar,MMR,Indonesia,IDN,30,0,0,34,64
2018,Nigeria,NGA,Indonesia,IDN,0,0,5,0,5
2018,Pakistan,PAK,Indonesia,IDN,17,0,5,0,22
2018,Russian Federation,RUS,Indonesia,IDN,5,0,0,0,5
2018,Senegal,SEN,Indonesia,IDN,0,0,5,0,5
2018,Somalia,SOM,Indonesia,IDN,170,0,5,56,231
2018,Viet Nam,VNM,Indonesia,IDN,5,0,0,0,5
2018,Sudan,SDN,Indonesia,IDN,112,0,5,11,128
2018,Syrian Arab Rep.,SYR,Indonesia,IDN,0,0,0,15,15
2018,Turkey,TUR,Indonesia,IDN,0,0,0,25,25
2018,Uganda,UGA,Indonesia,IDN,0,0,5,0,5
2018,Yemen,YEM,Indonesia,IDN,34,0,0,18,52
2018,Myanmar,MMR,Iran (Islamic Rep. of),IRN,0,0,0,51,51
2018,Afghanistan,AFG,Iraq,IRQ,0,0,0,41,41
2018,Bahrain,BHR,Iraq,IRQ,0,0,0,19,19
2018,Palestinian,PSE,Iraq,IRQ,0,0,0,5,5
2018,Iran (Islamic Rep. of),IRN,Iraq,IRQ,5,0,0,162,167
2018,Morocco,MAR,Iraq,IRQ,0,0,0,5,5
2018,Pakistan,PAK,Iraq,IRQ,0,0,0,19,19
2018,Saudi Arabia,SAU,Iraq,IRQ,0,0,0,5,5
2018,Somalia,SOM,Iraq,IRQ,5,0,0,0,5
2018,Sudan,SDN,Iraq,IRQ,22,0,15,68,105
2018,Turkey,TUR,Iraq,IRQ,0,0,0,173,173
2018,Yemen,YEM,Iraq,IRQ,0,0,0,5,5
2018,Egypt,EGY,Jordan,JOR,15,0,10,0,25
2018,Eritrea,ERI,Jordan,JOR,5,0,0,0,5
2018,Ethiopia,ETH,Jordan,JOR,5,0,0,0,5
2018,Iraq,IRQ,Jordan,JOR,1199,0,0,13,1212
2018,Kenya,KEN,Jordan,JOR,0,0,5,0,5
2018,Libya,LBY,Jordan,JOR,0,0,0,5,5
2018,Lebanon,LBN,Jordan,JOR,5,0,0,0,5
2018,Somalia,SOM,Jordan,JOR,56,0,0,0,56
2018,Sudan,SDN,Jordan,JOR,183,0,63,0,246
2018,Yemen,YEM,Jordan,JOR,143,0,0,5,148
2018,Uzbekistan,UZB,Kyrgyzstan,KGZ,0,0,0,5,5
2018,Iraq,IRQ,Kuwait,KWT,23,0,0,0,23
2018,Somalia,SOM,Kuwait,KWT,0,0,0,5,5
2018,Syrian Arab Rep.,SYR,Kuwait,KWT,29,0,0,0,29
2018,Egypt,EGY,Libya,LBY,0,0,0,23,23
2018,Chad,TCD,Libya,LBY,0,0,0,19,19
2018,Cameroon,CMR,Libya,LBY,0,0,0,5,5
2018,Dem. Rep. of the Congo,COD,Libya,LBY,0,0,0,14,14
2018,Eritrea,ERI,Libya,LBY,110,0,0,2009,2119
2018,Ethiopia,ETH,Libya,LBY,14,0,5,221,240
2018,Palestinian,PSE,Libya,LBY,5,0,0,0,5
2018,Iraq,IRQ,Libya,LBY,15,0,0,517,532
2018,Liberia,LBR,Libya,LBY,0,0,0,10,10
2018,Nigeria,NGA,Libya,LBY,0,0,0,5,5
2018,Somalia,SOM,Libya,LBY,18,0,0,490,508
2018,Sudan,SDN,Libya,LBY,373,0,10,146,529
2018,South Sudan,SSD,Libya,LBY,0,0,0,5,5
2018,Syrian Arab Rep.,SYR,Libya,LBY,412,0,0,55,467
2018,Yemen,YEM,Libya,LBY,0,0,0,26,26
2018,Algeria,DZA,Lebanon,LBN,0,0,0,5,5
2018,Egypt,EGY,Lebanon,LBN,14,0,5,19,38
2018,Bangladesh,BGD,Lebanon,LBN,0,0,11,5,16
2018,Burkina Faso,BFA,Lebanon,LBN,0,0,0,5,5
2018,Cameroon,CMR,Lebanon,LBN,0,0,11,0,11
2018,Eritrea,ERI,Lebanon,LBN,5,0,0,5,10
2018,Ethiopia,ETH,Lebanon,LBN,21,0,147,68,236
2018,Ghana,GHA,Lebanon,LBN,0,0,5,0,5
2018,Iran (Islamic Rep. of),IRN,Lebanon,LBN,0,0,0,5,5
2018,Iraq,IRQ,Lebanon,LBN,396,0,41,12,449
2018,Jordan,JOR,Lebanon,LBN,5,0,0,0,5
2018,Kenya,KEN,Lebanon,LBN,0,0,11,0,11
2018,Sri Lanka,LKA,Lebanon,LBN,0,0,5,0,5
2018,Nigeria,NGA,Lebanon,LBN,0,0,11,0,11
2018,Philippines,PHL,Lebanon,LBN,0,0,19,10,29
2018,Saudi Arabia,SAU,Lebanon,LBN,5,0,0,5,10
2018,Somalia,SOM,Lebanon,LBN,0,0,0,5,5
2018,Sudan,SDN,Lebanon,LBN,50,0,131,92,273
2018,Syrian Arab Rep.,SYR,Lebanon,LBN,0,0,0,5,5
2018,Yemen,YEM,Lebanon,LBN,10,0,0,0,10
2018,Afghanistan,AFG,Sri Lanka,LKA,44,0,0,5,49
2018,Iran (Islamic Rep. of),IRN,Sri Lanka,LKA,10,0,5,0,15
2018,Maldives,MDV,Sri Lanka,LKA,0,0,0,5,5
2018,Nepal,NPL,Sri Lanka,LKA,0,0,0,5,5
2018,Nigeria,NGA,Sri Lanka,LKA,0,0,0,5,5
2018,Pakistan,PAK,Sri Lanka,LKA,204,0,10,12,226
2018,Yemen,YEM,Sri Lanka,LKA,0,0,0,10,10
2018,Algeria,DZA,Mauritania,MRT,0,0,0,10,10
2018,Egypt,EGY,Mauritania,MRT,0,0,0,5,5
2018,Benin,BEN,Mauritania,MRT,0,0,5,0,5
2018,Central African Rep.,CAF,Mauritania,MRT,68,0,0,10,78
2018,Cameroon,CMR,Mauritania,MRT,0,0,5,31,36
2018,Dem. Rep. of the Congo,COD,Mauritania,MRT,5,0,0,12,17
2018,Gambia,GMB,Mauritania,MRT,0,0,5,0,5
2018,Palestinian,PSE,Mauritania,MRT,0,0,0,11,11
2018,Guinea-Bissau,GNB,Mauritania,MRT,0,0,5,0,5
2018,Guinea,GIN,Mauritania,MRT,0,0,20,0,20
2018,Cote d'Ivoire,CIV,Mauritania,MRT,16,0,18,10,44
2018,Iraq,IRQ,Mauritania,MRT,5,0,0,0,5
2018,Libya,LBY,Mauritania,MRT,0,0,0,5,5
2018,Lebanon,LBN,Mauritania,MRT,5,0,0,0,5
2018,Mali,MLI,Mauritania,MRT,0,0,10,14,24
2018,Morocco,MAR,Mauritania,MRT,0,0,0,5,5
2018,Nigeria,NGA,Mauritania,MRT,0,0,11,35,46
2018,Senegal,SEN,Mauritania,MRT,10,0,5,20,35
2018,Sierra Leone,SLE,Mauritania,MRT,0,0,27,10,37
2018,Somalia,SOM,Mauritania,MRT,0,0,0,5,5
2018,Sudan,SDN,Mauritania,MRT,5,0,0,10,15
2018,South Sudan,SSD,Mauritania,MRT,5,0,0,0,5
2018,Syrian Arab Rep.,SYR,Mauritania,MRT,30,0,0,73,103
2018,Togo,TGO,Mauritania,MRT,5,0,0,0,5
2018,Turkey,TUR,Mauritania,MRT,0,0,0,47,47
2018,Afghanistan,AFG,Malaysia,MYS,267,0,85,67,419
2018,Algeria,DZA,Malaysia,MYS,0,0,0,5,5
2018,Egypt,EGY,Malaysia,MYS,5,0,5,0,10
2018,Austria,AUT,Malaysia,MYS,0,0,0,5,5
2018,Bangladesh,BGD,Malaysia,MYS,0,0,5,10,15
2018,Cambodia,KHM,Malaysia,MYS,0,0,0,5,5
2018,Central African Rep.,CAF,Malaysia,MYS,0,0,5,0,5
2018,Dem. Rep. of the Congo,COD,Malaysia,MYS,0,0,5,0,5
2018,Palestinian,PSE,Malaysia,MYS,21,0,0,22,43
2018,Guinea,GIN,Malaysia,MYS,0,0,0,5,5
2018,Indonesia,IDN,Malaysia,MYS,10,0,5,63,78
2018,Iran (Islamic Rep. of),IRN,Malaysia,MYS,31,0,23,5,59
2018,Iraq,IRQ,Malaysia,MYS,31,0,0,44,75
2018,Liberia,LBR,Malaysia,MYS,0,0,5,5,10
2018,Lebanon,LBN,Malaysia,MYS,0,0,5,0,5
2018,Sri Lanka,LKA,Malaysia,MYS,14,0,146,115,275
2018,Myanmar,MMR,Malaysia,MYS,19592,0,5429,3129,28150
2018,Pakistan,PAK,Malaysia,MYS,624,0,232,128,984
2018,Russian Federation,RUS,Malaysia,MYS,0,0,0,5,5
2018,Sierra Leone,SLE,Malaysia,MYS,0,0,5,0,5
2018,Somalia,SOM,Malaysia,MYS,275,0,109,144,528
2018,Sudan,SDN,Malaysia,MYS,16,0,40,0,56
2018,Syrian Arab Rep.,SYR,Malaysia,MYS,56,0,0,95,151
2018,Thailand,THA,Malaysia,MYS,0,0,0,5,5
2018,Togo,TGO,Malaysia,MYS,0,0,5,0,5
2018,Uganda,UGA,Malaysia,MYS,0,0,10,0,10
2018,Yemen,YEM,Malaysia,MYS,94,0,0,100,194
2018,Algeria,DZA,Morocco,MAR,5,0,0,0,5
2018,Egypt,EGY,Morocco,MAR,0,0,0,5,5
2018,Benin,BEN,Morocco,MAR,0,0,5,5,10
2018,Burkina Faso,BFA,Morocco,MAR,0,0,5,13,18
2018,Central African Rep.,CAF,Morocco,MAR,173,0,13,24,210
2018,Chad,TCD,Morocco,MAR,0,0,0,5,5
2018,China,CHN,Morocco,MAR,0,0,0,5,5
2018,Cameroon,CMR,Morocco,MAR,33,0,117,592,742
2018,Congo,COG,Morocco,MAR,0,0,29,21,50
2018,Dem. Rep. of the Congo,COD,Morocco,MAR,12,0,74,55,141
2018,Eritrea,ERI,Morocco,MAR,10,0,0,0,10
2018,Gambia,GMB,Morocco,MAR,0,0,5,5,10
2018,Palestinian,PSE,Morocco,MAR,14,0,0,23,37
2018,Guinea-Bissau,GNB,Morocco,MAR,0,0,0,11,11
2018,Guinea,GIN,Morocco,MAR,15,0,216,484,715
2018,Cote d'Ivoire,CIV,Morocco,MAR,20,0,116,177,313
2018,Iraq,IRQ,Morocco,MAR,12,0,0,0,12
2018,Liberia,LBR,Morocco,MAR,0,0,10,24,34
2018,Libya,LBY,Morocco,MAR,5,0,0,5,10
2018,Lebanon,LBN,Morocco,MAR,0,0,0,11,11
2018,Mauritania,MRT,Morocco,MAR,5,0,0,0,5
2018,Mali,MLI,Morocco,MAR,5,0,35,68,108
2018,Niger,NER,Morocco,MAR,0,0,0,5,5
2018,Nigeria,NGA,Morocco,MAR,0,0,44,40,84
2018,Pakistan,PAK,Morocco,MAR,5,0,0,0,5
2018,Senegal,SEN,Morocco,MAR,29,0,28,63,120
2018,Sierra Leone,SLE,Morocco,MAR,0,0,10,37,47
2018,Somalia,SOM,Morocco,MAR,5,0,0,0,5
2018,Sudan,SDN,Morocco,MAR,5,0,0,5,10
2018,South Sudan,SSD,Morocco,MAR,25,0,0,134,159
2018,Syrian Arab Rep.,SYR,Morocco,MAR,5,0,0,790,795
2018,Togo,TGO,Morocco,MAR,0,0,10,0,10
2018,Turkey,TUR,Morocco,MAR,0,0,0,32,32
2018,Yemen,YEM,Morocco,MAR,11,0,0,251,262
2018,Dem. Rep. of the Congo,COD,Mauritius,MUS,11,0,0,0,11
2018,Sri Lanka,LKA,Nepal,NPL,0,0,0,5,5
2018,Myanmar,MMR,Nepal,NPL,144,0,0,5,149
2018,Pakistan,PAK,Nepal,NPL,0,0,13,0,13
2018,Somalia,SOM,Nepal,NPL,5,0,0,0,5
2018,Iraq,IRQ,Oman,OMN,0,0,0,156,156
2018,Sudan,SDN,Oman,OMN,0,0,0,5,5
2018,Syrian Arab Rep.,SYR,Oman,OMN,0,0,0,5,5
2018,Afghanistan,AFG,Pakistan,PAK,0,0,0,65,65
2018,Turkey,TUR,Pakistan,PAK,0,0,0,173,173
2018,Yemen,YEM,Pakistan,PAK,17,0,0,0,17
2018,Cuba,CUB,Paraguay,PRY,11,0,0,0,11
2018,El Salvador,SLV,Paraguay,PRY,5,0,0,0,5
2018,Syrian Arab Rep.,SYR,Paraguay,PRY,11,0,0,0,11
2018,Venezuela (Bolivarian Republic of),VEN,Paraguay,PRY,31,0,0,5,36
2018,Iraq,IRQ,Qatar,QAT,0,0,0,41,41
2018,Iraq,IRQ,Saudi Arabia,SAU,5,0,0,0,5
2018,Syrian Arab Rep.,SYR,Saudi Arabia,SAU,89,0,0,78,167
2018,Yemen,YEM,Saudi Arabia,SAU,20,0,0,0,20
2018,Dem. Rep. of the Congo,COD,Somalia,SOM,0,0,0,5,5
2018,Ethiopia,ETH,Somalia,SOM,442,0,0,13,455
2018,Yemen,YEM,Somalia,SOM,17,0,0,0,17
2018,Dem. Rep. of the Congo,COD,Sudan,SDN,0,0,0,403,403
2018,Eritrea,ERI,Sudan,SDN,0,0,0,386,386
2018,Ethiopia,ETH,Sudan,SDN,0,0,0,8544,8544
2018,Somalia,SOM,Sudan,SDN,0,0,0,55,55
2018,Syrian Arab Rep.,SYR,Sudan,SDN,0,0,0,251,251
2018,Yemen,YEM,Sudan,SDN,0,0,0,325,325
2018,Cuba,CUB,Suriname,SUR,5,0,12,31,48
2018,Dominican Rep.,DOM,Suriname,SUR,0,0,5,0,5
2018,Venezuela (Bolivarian Republic of),VEN,Suriname,SUR,5,0,0,0,5
2018,Afghanistan,AFG,Syrian Arab Rep.,SYR,11,0,0,5,16
2018,Egypt,EGY,Syrian Arab Rep.,SYR,0,0,5,12,17
2018,Burkina Faso,BFA,Syrian Arab Rep.,SYR,0,0,5,0,5
2018,Iran (Islamic Rep. of),IRN,Syrian Arab Rep.,SYR,0,0,10,12,22
2018,Iraq,IRQ,Syrian Arab Rep.,SYR,210,0,30,3611,3851
2018,Jordan,JOR,Syrian Arab Rep.,SYR,0,0,0,13,13
2018,Pakistan,PAK,Syrian Arab Rep.,SYR,0,0,11,0,11
2018,Somalia,SOM,Syrian Arab Rep.,SYR,0,0,0,5,5
2018,Sudan,SDN,Syrian Arab Rep.,SYR,0,0,14,5,19
2018,Tunisia,TUN,Syrian Arab Rep.,SYR,0,0,5,0,5
2018,Yemen,YEM,Syrian Arab Rep.,SYR,26,0,0,24,50
2018,Afghanistan,AFG,Thailand,THA,50,0,0,0,50
2018,Egypt,EGY,Thailand,THA,0,0,14,0,14
2018,Bangladesh,BGD,Thailand,THA,0,0,0,5,5
2018,Cambodia,KHM,Thailand,THA,47,0,124,103,274
2018,China,CHN,Thailand,THA,21,0,10,10,41
2018,Cameroon,CMR,Thailand,THA,0,0,5,0,5
2018,Dem. Rep. of the Congo,COD,Thailand,THA,0,0,0,10,10
2018,Ethiopia,ETH,Thailand,THA,0,0,0,12,12
2018,Palestinian,PSE,Thailand,THA,13,0,0,0,13
2018,Iran (Islamic Rep. of),IRN,Thailand,THA,13,0,13,29,55
2018,Iraq,IRQ,Thailand,THA,5,0,0,44,49
2018,Lao People's Dem. Rep.,LAO,Thailand,THA,0,0,12,0,12
2018,Sri Lanka,LKA,Thailand,THA,5,0,5,17,27
2018,Malaysia,MYS,Thailand,THA,0,0,0,5,5
2018,Myanmar,MMR,Thailand,THA,0,0,0,254,254
2018,Nigeria,NGA,Thailand,THA,0,0,0,5,5
2018,Pakistan,PAK,Thailand,THA,96,0,40,140,276
2018,Russian Federation,RUS,Thailand,THA,0,0,5,5,10
2018,Somalia,SOM,Thailand,THA,30,0,46,41,117
2018,Viet Nam,VNM,Thailand,THA,220,0,137,78,435
2018,Sudan,SDN,Thailand,THA,0,0,0,5,5
2018,Syrian Arab Rep.,SYR,Thailand,THA,12,0,0,0,12
2018,Yemen,YEM,Thailand,THA,5,0,0,0,5
2018,Bangladesh,BGD,Trinidad and Tobago,TTO,0,0,0,5,5
2018,Cuba,CUB,Trinidad and Tobago,TTO,56,0,11,35,102
2018,Jamaica,JAM,Trinidad and Tobago,TTO,10,0,0,13,23
2018,Syrian Arab Rep.,SYR,Trinidad and Tobago,TTO,14,0,0,0,14
2018,Venezuela (Bolivarian Republic of),VEN,Trinidad and Tobago,TTO,464,0,0,58,522
2018,Central African Rep.,CAF,Tunisia,TUN,5,0,0,0,5
2018,Cameroon,CMR,Tunisia,TUN,5,0,0,5,10
2018,Dem. Rep. of the Congo,COD,Tunisia,TUN,0,0,0,5,5
2018,Eritrea,ERI,Tunisia,TUN,5,0,0,0,5
2018,Palestinian,PSE,Tunisia,TUN,5,0,0,0,5
2018,Guinea,GIN,Tunisia,TUN,0,0,0,5,5
2018,Cote d'Ivoire,CIV,Tunisia,TUN,0,0,0,5,5
2018,Iraq,IRQ,Tunisia,TUN,5,0,0,0,5
2018,Lebanon,LBN,Tunisia,TUN,5,0,0,0,5
2018,Morocco,MAR,Tunisia,TUN,0,0,0,5,5
2018,Nigeria,NGA,Tunisia,TUN,0,0,0,5,5
2018,Senegal,SEN,Tunisia,TUN,0,0,0,5,5
2018,Sierra Leone,SLE,Tunisia,TUN,0,0,0,5,5
2018,Yemen,YEM,Tunisia,TUN,0,0,0,5,5
2018,Afghanistan,AFG,Turkey,TUR,1155,0,0,44773,45928
2018,Algeria,DZA,Turkey,TUR,0,0,0,5,5
2018,Egypt,EGY,Turkey,TUR,10,0,0,19,29
2018,Burundi,BDI,Turkey,TUR,0,0,0,5,5
2018,Bangladesh,BGD,Turkey,TUR,0,0,0,43,43
2018,Central African Rep.,CAF,Turkey,TUR,0,0,0,5,5
2018,China,CHN,Turkey,TUR,0,0,0,5,5
2018,Cameroon,CMR,Turkey,TUR,0,0,0,25,25
2018,Congo,COG,Turkey,TUR,0,0,0,30,30
2018,Dem. Rep. of the Congo,COD,Turkey,TUR,0,0,0,44,44
2018,Eritrea,ERI,Turkey,TUR,0,0,0,10,10
2018,Ethiopia,ETH,Turkey,TUR,0,0,0,56,56
2018,Palestinian,PSE,Turkey,TUR,103,0,0,138,241
2018,Ghana,GHA,Turkey,TUR,0,0,0,5,5
2018,Cote d'Ivoire,CIV,Turkey,TUR,0,0,0,5,5
2018,Iran (Islamic Rep. of),IRN,Turkey,TUR,640,0,359,819,1818
2018,Iraq,IRQ,Turkey,TUR,2918,0,0,29056,31974
2018,Jordan,JOR,Turkey,TUR,5,0,0,12,17
2018,Kazakhstan,KAZ,Turkey,TUR,0,0,0,21,21
2018,Kyrgyzstan,KGZ,Turkey,TUR,0,0,0,21,21
2018,Libya,LBY,Turkey,TUR,5,0,0,14,19
2018,Lebanon,LBN,Turkey,TUR,0,0,0,5,5
2018,Mali,MLI,Turkey,TUR,0,0,0,5,5
2018,Mongolia,MNG,Turkey,TUR,0,0,0,10,10
2018,Morocco,MAR,Turkey,TUR,0,0,0,21,21
2018,Nigeria,NGA,Turkey,TUR,0,0,0,21,21
2018,Pakistan,PAK,Turkey,TUR,5,0,5,40,50
2018,Rwanda,RWA,Turkey,TUR,0,0,0,5,5
2018,Senegal,SEN,Turkey,TUR,0,0,0,5,5
2018,Sierra Leone,SLE,Turkey,TUR,0,0,0,10,10
2018,Somalia,SOM,Turkey,TUR,32,0,0,345,377
2018,Sudan,SDN,Turkey,TUR,5,0,5,27,37
2018,Syrian Arab Rep.,SYR,Turkey,TUR,0,0,0,56,56
2018,Tajikistan,TJK,Turkey,TUR,0,0,0,51,51
2018,Turkmenistan,TKM,Turkey,TUR,0,0,0,62,62
2018,Tunisia,TUN,Turkey,TUR,0,0,0,5,5
2018,Uganda,UGA,Turkey,TUR,0,0,0,99,99
2018,Uzbekistan,UZB,Turkey,TUR,0,0,0,50,50
2018,Yemen,YEM,Turkey,TUR,15,0,0,50,65
2018,Zimbabwe,ZWE,Turkey,TUR,5,0,0,0,5
2018,Stateless,XXA,Turkey,TUR,0,0,0,11,11
2018,Eritrea,ERI,United Arab Emirates,ARE,5,0,0,0,5
2018,Ethiopia,ETH,United Arab Emirates,ARE,5,0,0,0,5
2018,Palestinian,PSE,United Arab Emirates,ARE,5,0,0,130,135
2018,Iran (Islamic Rep. of),IRN,United Arab Emirates,ARE,5,0,0,0,5
2018,Iraq,IRQ,United Arab Emirates,ARE,85,0,0,0,85
2018,Jordan,JOR,United Arab Emirates,ARE,5,0,0,0,5
2018,Kuwait,KWT,United Arab Emirates,ARE,5,0,0,0,5
2018,Liberia,LBR,United Arab Emirates,ARE,0,0,0,5,5
2018,Lebanon,LBN,United Arab Emirates,ARE,11,0,0,0,11
2018,Pakistan,PAK,United Arab Emirates,ARE,5,0,0,0,5
2018,Somalia,SOM,United Arab Emirates,ARE,5,0,0,0,5
2018,Syrian Arab Rep.,SYR,United Arab Emirates,ARE,170,0,0,2418,2588
2018,Yemen,YEM,United Arab Emirates,ARE,5,0,0,0,5
2018,Somalia,SOM,Ukraine,UKR,5,0,0,0,5
2018,Tajikistan,TJK,Ukraine,UKR,5,0,0,0,5
2018,Colombia,COL,Curacao ,CUW,5,0,0,0,5
2018,Venezuela (Bolivarian Republic of),VEN,Curacao ,CUW,5,0,0,0,5
2019,Tajikistan,TJK,Afghanistan,AFG,0,0,0,5,5
2019,Turkey,TUR,Afghanistan,AFG,0,0,0,60,60
2019,Benin,BEN,Algeria,DZA,0,0,0,12,12
2019,Burkina Faso,BFA,Algeria,DZA,0,0,5,0,5
2019,Central African Rep.,CAF,Algeria,DZA,28,0,0,5,33
2019,Chad,TCD,Algeria,DZA,0,0,5,5,10
2019,Cameroon,CMR,Algeria,DZA,47,0,56,40,143
2019,Dem. Rep. of the Congo,COD,Algeria,DZA,24,0,35,20,79
2019,Gambia,GMB,Algeria,DZA,0,0,0,5,5
2019,Palestinian,PSE,Algeria,DZA,0,0,0,170,170
2019,Ghana,GHA,Algeria,DZA,0,0,0,5,5
2019,Guinea,GIN,Algeria,DZA,21,0,67,91,179
2019,Cote d'Ivoire,CIV,Algeria,DZA,17,0,62,52,131
2019,Liberia,LBR,Algeria,DZA,0,0,0,12,12
2019,Mali,MLI,Algeria,DZA,32,0,51,79,162
2019,Niger,NER,Algeria,DZA,5,0,0,12,17
2019,Nigeria,NGA,Algeria,DZA,0,0,21,60,81
2019,Somalia,SOM,Algeria,DZA,0,0,0,5,5
2019,Sudan,SDN,Algeria,DZA,0,0,0,12,12
2019,Syrian Arab Rep.,SYR,Algeria,DZA,15,0,0,8388,8403
2019,Togo,TGO,Algeria,DZA,0,0,5,0,5
2019,Yemen,YEM,Algeria,DZA,0,0,0,272,272
2019,Afghanistan,AFG,Egypt,EGY,12,0,0,0,12
2019,Burundi,BDI,Egypt,EGY,26,0,0,5,31
2019,Benin,BEN,Egypt,EGY,0,0,0,5,5
2019,Bangladesh,BGD,Egypt,EGY,0,0,0,5,5
2019,Central African Rep.,CAF,Egypt,EGY,13,0,0,5,18
2019,Chad,TCD,Egypt,EGY,0,0,0,5,5
2019,China,CHN,Egypt,EGY,0,0,0,5,5
2019,Cameroon,CMR,Egypt,EGY,13,0,0,0,13
2019,Congo,COG,Egypt,EGY,10,0,0,5,15
2019,Dem. Rep. of the Congo,COD,Egypt,EGY,13,0,5,0,18
2019,Djibouti,DJI,Egypt,EGY,13,0,0,0,13
2019,Eritrea,ERI,Egypt,EGY,4776,0,10,411,5197
2019,Ethiopia,ETH,Egypt,EGY,844,0,644,1838,3326
2019,Gambia,GMB,Egypt,EGY,0,0,5,0,5
2019,Ghana,GHA,Egypt,EGY,0,0,0,10,10
2019,Guinea,GIN,Egypt,EGY,5,0,12,0,17
2019,Iraq,IRQ,Egypt,EGY,362,0,10,458,830
2019,Jordan,JOR,Egypt,EGY,10,0,0,0,10
2019,Kenya,KEN,Egypt,EGY,0,0,5,0,5
2019,Liberia,LBR,Egypt,EGY,0,0,0,12,12
2019,Niger,NER,Egypt,EGY,0,0,0,5,5
2019,Nigeria,NGA,Egypt,EGY,5,0,85,215,305
2019,Russian Federation,RUS,Egypt,EGY,0,0,0,22,22
2019,Rwanda,RWA,Egypt,EGY,5,0,0,0,5
2019,Saudi Arabia,SAU,Egypt,EGY,5,0,0,0,5
2019,Sierra Leone,SLE,Egypt,EGY,0,0,5,5,10
2019,Somalia,SOM,Egypt,EGY,643,0,75,847,1565
2019,Sudan,SDN,Egypt,EGY,2576,0,688,2444,5708
2019,South Sudan,SSD,Egypt,EGY,6962,0,0,291,7253
2019,Tajikistan,TJK,Egypt,EGY,0,0,17,0,17
2019,Turkey,TUR,Egypt,EGY,0,0,0,33,33
2019,Uganda,UGA,Egypt,EGY,0,0,5,0,5
2019,Uzbekistan,UZB,Egypt,EGY,0,0,0,18,18
2019,Yemen,YEM,Egypt,EGY,26,0,0,1111,1137
2019,Zimbabwe,ZWE,Egypt,EGY,10,0,21,0,31
2019,Afghanistan,AFG,Azerbaijan,AZE,12,0,0,0,12
2019,Syrian Arab Rep.,SYR,Azerbaijan,AZE,5,0,0,0,5
2019,Turkey,TUR,Azerbaijan,AZE,5,0,0,0,5
2019,Yemen,YEM,Azerbaijan,AZE,5,0,0,0,5
2019,Somalia,SOM,Bangladesh,BGD,5,0,0,0,5
2019,Turkey,TUR,Bangladesh,BGD,0,0,0,5,5
2019,Yemen,YEM,Bangladesh,BGD,5,0,0,0,5
2019,Cuba,CUB,Bahamas,BHS,0,0,0,10,10
2019,Haiti,HTI,Bahamas,BHS,0,0,0,5,5
2019,Dem. Rep. of the Congo,COD,Botswana,BWA,21,0,0,0,21
2019,Afghanistan,AFG,China,CHN,12,0,0,0,12
2019,Burundi,BDI,China,CHN,5,0,0,0,5
2019,Cameroon,CMR,China,CHN,5,0,5,29,39
2019,Dem. Rep. of the Congo,COD,China,CHN,0,0,0,14,14
2019,Ghana,GHA,China,CHN,0,0,5,0,5
2019,Iraq,IRQ,China,CHN,11,0,0,0,11
2019,Kenya,KEN,China,CHN,0,0,25,40,65
2019,Liberia,LBR,China,CHN,0,0,0,5,5
2019,Mozambique,MOZ,China,CHN,0,0,0,5,5
2019,Nigeria,NGA,China,CHN,0,0,0,10,10
2019,Pakistan,PAK,China,CHN,5,0,0,0,5
2019,Somalia,SOM,China,CHN,10,0,0,0,10
2019,Syrian Arab Rep.,SYR,China,CHN,0,0,0,10,10
2019,Uganda,UGA,China,CHN,0,0,20,21,41
2019,Yemen,YEM,China,CHN,5,0,0,0,5
2019,Zimbabwe,ZWE,China,CHN,0,0,21,35,56
2019,Burkina Faso,BFA,Cameroon,CMR,0,0,5,0,5
2019,Central African Rep.,CAF,Cameroon,CMR,1522,0,56,170,1748
2019,Chad,TCD,Cameroon,CMR,16,0,42,5,63
2019,Dem. Rep. of the Congo,COD,Cameroon,CMR,0,0,16,0,16
2019,Guinea,GIN,Cameroon,CMR,0,0,17,0,17
2019,Mali,MLI,Cameroon,CMR,10,0,15,5,30
2019,Niger,NER,Cameroon,CMR,0,0,5,0,5
2019,Nigeria,NGA,Cameroon,CMR,5,0,0,0,5
2019,Rwanda,RWA,Cameroon,CMR,0,0,0,14,14
2019,Sudan,SDN,Cameroon,CMR,5,0,0,0,5
2019,Togo,TGO,Cameroon,CMR,0,0,5,0,5
2019,Turkey,TUR,Cameroon,CMR,0,0,0,23,23
2019,Haiti,HTI,Cuba,CUB,5,0,0,0,5
2019,Iran (Islamic Rep. of),IRN,Cuba,CUB,0,0,23,0,23
2019,Syrian Arab Rep.,SYR,Cuba,CUB,5,0,0,0,5
2019,Venezuela (Bolivarian Republic of),VEN,Dominican Rep.,DOM,0,0,5,0,5
2019,Cuba,CUB,Guyana,GUY,0,0,5,0,5
2019,Afghanistan,AFG,India,IND,1265,0,808,1220,3293
2019,Burundi,BDI,India,IND,0,0,5,0,5
2019,Cameroon,CMR,India,IND,0,0,5,18,23
2019,Dem. Rep. of the Congo,COD,India,IND,0,0,0,11,11
2019,Ethiopia,ETH,India,IND,0,0,0,11,11
2019,Cote d'Ivoire,CIV,India,IND,0,0,0,5,5
2019,Iran (Islamic Rep. of),IRN,India,IND,0,0,0,14,14
2019,Iraq,IRQ,India,IND,16,0,10,35,61
2019,Libya,LBY,India,IND,5,0,0,0,5
2019,Myanmar,MMR,India,IND,39,0,11,1851,1901
2019,Nigeria,NGA,India,IND,0,0,5,0,5
2019,Russian Federation,RUS,India,IND,0,0,0,5,5
2019,Somalia,SOM,India,IND,21,0,36,90,147
2019,Sudan,SDN,India,IND,5,0,0,11,16
2019,Syrian Arab Rep.,SYR,India,IND,5,0,0,5,10
2019,Thailand,THA,India,IND,0,0,0,5,5
2019,Tajikistan,TJK,India,IND,5,0,0,5,10
2019,Turkey,TUR,India,IND,29,0,0,0,29
2019,Yemen,YEM,India,IND,0,0,0,470,470
2019,Stateless,XXA,India,IND,1705,0,0,0,1705
2019,Afghanistan,AFG,Indonesia,IDN,79,0,0,102,181
2019,Algeria,DZA,Indonesia,IDN,0,0,0,5,5
2019,Angola,AGO,Indonesia,IDN,5,0,0,0,5
2019,Egypt,EGY,Indonesia,IDN,0,0,12,0,12
2019,Cameroon,CMR,Indonesia,IDN,0,0,5,0,5
2019,Dem. Rep. of the Congo,COD,Indonesia,IDN,5,0,0,0,5
2019,Eritrea,ERI,Indonesia,IDN,22,0,0,15,37
2019,Ethiopia,ETH,Indonesia,IDN,0,0,12,0,12
2019,Palestinian,PSE,Indonesia,IDN,5,0,0,10,15
2019,Cote d'Ivoire,CIV,Indonesia,IDN,0,0,5,0,5
2019,Iran (Islamic Rep. of),IRN,Indonesia,IDN,14,0,5,5,24
2019,Iraq,IRQ,Indonesia,IDN,0,0,0,42,42
2019,Sri Lanka,LKA,Indonesia,IDN,5,0,25,96,126
2019,Mali,MLI,Indonesia,IDN,0,0,5,0,5
2019,Myanmar,MMR,Indonesia,IDN,0,0,0,104,104
2019,Pakistan,PAK,Indonesia,IDN,5,0,0,5,10
2019,Somalia,SOM,Indonesia,IDN,35,0,0,65,100
2019,Sudan,SDN,Indonesia,IDN,5,0,10,20,35
2019,Turkey,TUR,Indonesia,IDN,0,0,0,31,31
2019,Uganda,UGA,Indonesia,IDN,0,0,5,0,5
2019,Yemen,YEM,Indonesia,IDN,5,0,0,48,53
2019,Afghanistan,AFG,Iraq,IRQ,0,0,0,10,10
2019,Egypt,EGY,Iraq,IRQ,0,0,0,5,5
2019,Palestinian,PSE,Iraq,IRQ,0,0,0,43,43
2019,Iran (Islamic Rep. of),IRN,Iraq,IRQ,5,0,0,1146,1151
2019,Kuwait,KWT,Iraq,IRQ,0,0,0,26,26
2019,Pakistan,PAK,Iraq,IRQ,0,0,0,5,5
2019,Sudan,SDN,Iraq,IRQ,0,0,0,149,149
2019,Turkey,TUR,Iraq,IRQ,5,0,0,730,735
2019,Yemen,YEM,Iraq,IRQ,5,0,0,5,10
2019,Egypt,EGY,Jordan,JOR,14,0,21,26,61
2019,Central African Rep.,CAF,Jordan,JOR,5,0,0,0,5
2019,Chad,TCD,Jordan,JOR,10,0,0,0,10
2019,Eritrea,ERI,Jordan,JOR,5,0,0,0,5
2019,Ethiopia,ETH,Jordan,JOR,0,0,0,13,13
2019,Iraq,IRQ,Jordan,JOR,315,0,5,168,488
2019,Kenya,KEN,Jordan,JOR,0,0,0,5,5
2019,Libya,LBY,Jordan,JOR,0,0,0,18,18
2019,Lebanon,LBN,Jordan,JOR,0,0,0,5,5
2019,Morocco,MAR,Jordan,JOR,0,0,0,5,5
2019,Nigeria,NGA,Jordan,JOR,0,0,0,5,5
2019,Philippines,PHL,Jordan,JOR,0,0,0,5,5
2019,South Africa,ZAF,Jordan,JOR,0,0,0,5,5
2019,Russian Federation,RUS,Jordan,JOR,0,0,0,5,5
2019,Somalia,SOM,Jordan,JOR,12,0,0,20,32
2019,Sudan,SDN,Jordan,JOR,335,0,65,94,494
2019,Suriname,SUR,Jordan,JOR,0,0,0,5,5
2019,Yemen,YEM,Jordan,JOR,62,0,0,30,92
2019,Stateless,XXA,Jordan,JOR,0,0,0,56,56
2019,Iraq,IRQ,Kuwait,KWT,13,0,0,0,13
2019,Dem. People's Rep. of Korea,PRK,Kuwait,KWT,0,0,0,5,5
2019,Syrian Arab Rep.,SYR,Kuwait,KWT,24,0,0,0,24
2019,Thailand,THA,Lao People's Dem. Rep.,LAO,10,0,0,0,10
2019,Algeria,DZA,Libya,LBY,0,0,0,5,5
2019,Egypt,EGY,Libya,LBY,0,0,0,18,18
2019,Chad,TCD,Libya,LBY,0,0,0,23,23
2019,Dem. Rep. of the Congo,COD,Libya,LBY,0,0,0,5,5
2019,Eritrea,ERI,Libya,LBY,283,0,0,4566,4849
2019,Ethiopia,ETH,Libya,LBY,5,0,5,453,463
2019,Palestinian,PSE,Libya,LBY,10,0,0,40,50
2019,Iraq,IRQ,Libya,LBY,0,0,0,334,334
2019,Jordan,JOR,Libya,LBY,0,0,0,11,11
2019,Liberia,LBR,Libya,LBY,0,0,0,5,5
2019,Morocco,MAR,Libya,LBY,0,0,0,11,11
2019,Somalia,SOM,Libya,LBY,5,0,0,1680,1685
2019,Sudan,SDN,Libya,LBY,237,0,23,1063,1323
2019,South Sudan,SSD,Libya,LBY,5,0,0,0,5
2019,Syrian Arab Rep.,SYR,Libya,LBY,525,0,0,9515,10040
2019,Yemen,YEM,Libya,LBY,0,0,0,5,5
2019,Algeria,DZA,Lebanon,LBN,0,0,5,0,5
2019,Egypt,EGY,Lebanon,LBN,22,0,49,30,101
2019,Benin,BEN,Lebanon,LBN,0,0,5,0,5
2019,Bangladesh,BGD,Lebanon,LBN,0,0,13,16,29
2019,Cameroon,CMR,Lebanon,LBN,0,0,11,5,16
2019,Congo,COG,Lebanon,LBN,0,0,10,0,10
2019,Eritrea,ERI,Lebanon,LBN,0,0,5,14,19
2019,Ethiopia,ETH,Lebanon,LBN,12,0,129,123,264
2019,Gambia,GMB,Lebanon,LBN,0,0,0,5,5
2019,Palestinian,PSE,Lebanon,LBN,0,0,0,18,18
2019,Ghana,GHA,Lebanon,LBN,0,0,0,5,5
2019,Cote d'Ivoire,CIV,Lebanon,LBN,0,0,0,5,5
2019,Iran (Islamic Rep. of),IRN,Lebanon,LBN,14,0,0,0,14
2019,Iraq,IRQ,Lebanon,LBN,35,0,15,5742,5792
2019,Jordan,JOR,Lebanon,LBN,0,0,0,11,11
2019,Kenya,KEN,Lebanon,LBN,0,0,10,10,20
2019,Kuwait,KWT,Lebanon,LBN,10,0,0,0,10
2019,Libya,LBY,Lebanon,LBN,0,0,0,5,5
2019,Madagascar,MDG,Lebanon,LBN,0,0,5,0,5
2019,Morocco,MAR,Lebanon,LBN,0,0,0,5,5
2019,Nigeria,NGA,Lebanon,LBN,0,0,68,26,94
2019,Philippines,PHL,Lebanon,LBN,0,0,28,24,52
2019,Somalia,SOM,Lebanon,LBN,0,0,0,5,5
2019,Sudan,SDN,Lebanon,LBN,41,0,97,180,318
2019,Turkey,TUR,Lebanon,LBN,0,0,0,5,5
2019,Yemen,YEM,Lebanon,LBN,5,0,0,31,36
2019,Afghanistan,AFG,Sri Lanka,LKA,30,0,0,0,30
2019,Maldives,MDV,Sri Lanka,LKA,0,0,0,5,5
2019,Nigeria,NGA,Sri Lanka,LKA,0,0,0,5,5
2019,Pakistan,PAK,Sri Lanka,LKA,549,0,10,66,625
2019,Yemen,YEM,Sri Lanka,LKA,5,0,0,0,5
2019,Afghanistan,AFG,Madagascar,MDG,5,0,0,0,5
2019,Dem. Rep. of the Congo,COD,Madagascar,MDG,11,0,0,0,11
2019,Pakistan,PAK,Madagascar,MDG,39,0,0,0,39
2019,Somalia,SOM,Madagascar,MDG,0,0,0,5,5
2019,Syrian Arab Rep.,SYR,Madagascar,MDG,5,0,0,0,5
2019,Turkey,TUR,Madagascar,MDG,5,0,0,42,47
2019,Yemen,YEM,Madagascar,MDG,0,0,0,25,25
2019,Afghanistan,AFG,Mauritania,MRT,0,0,0,14,14
2019,Algeria,DZA,Mauritania,MRT,5,0,0,0,5
2019,Central African Rep.,CAF,Mauritania,MRT,71,0,0,28,99
2019,China,CHN,Mauritania,MRT,5,0,0,0,5
2019,Cameroon,CMR,Mauritania,MRT,0,0,5,12,17
2019,Congo,COG,Mauritania,MRT,0,0,5,19,24
2019,Gabon,GAB,Mauritania,MRT,0,0,0,5,5
2019,Gambia,GMB,Mauritania,MRT,0,0,0,5,5
2019,Palestinian,PSE,Mauritania,MRT,31,0,0,0,31
2019,Ghana,GHA,Mauritania,MRT,0,0,5,5,10
2019,Guinea-Bissau,GNB,Mauritania,MRT,0,0,0,13,13
2019,Guinea,GIN,Mauritania,MRT,0,0,27,19,46
2019,Cote d'Ivoire,CIV,Mauritania,MRT,13,0,14,33,60
2019,Liberia,LBR,Mauritania,MRT,0,0,5,5,10
2019,Libya,LBY,Mauritania,MRT,0,0,0,5,5
2019,Mali,MLI,Mauritania,MRT,727,0,5,0,732
2019,Niger,NER,Mauritania,MRT,0,0,0,5,5
2019,Senegal,SEN,Mauritania,MRT,11,0,16,0,27
2019,Sierra Leone,SLE,Mauritania,MRT,0,0,48,137,185
2019,Sudan,SDN,Mauritania,MRT,0,0,0,5,5
2019,Syrian Arab Rep.,SYR,Mauritania,MRT,59,0,0,0,59
2019,Togo,TGO,Mauritania,MRT,0,0,15,10,25
2019,Yemen,YEM,Mauritania,MRT,10,0,0,0,10
2019,Afghanistan,AFG,Malaysia,MYS,694,0,12,0,706
2019,Egypt,EGY,Malaysia,MYS,5,0,0,0,5
2019,Bangladesh,BGD,Malaysia,MYS,5,0,0,5,10
2019,Cambodia,KHM,Malaysia,MYS,16,0,0,5,21
2019,China,CHN,Malaysia,MYS,19,0,0,0,19
2019,Cameroon,CMR,Malaysia,MYS,5,0,0,0,5
2019,Eritrea,ERI,Malaysia,MYS,5,0,0,0,5
2019,Palestinian,PSE,Malaysia,MYS,29,0,0,24,53
2019,Guinea,GIN,Malaysia,MYS,5,0,0,0,5
2019,India,IND,Malaysia,MYS,0,0,0,10,10
2019,Indonesia,IDN,Malaysia,MYS,30,0,0,66,96
2019,Iran (Islamic Rep. of),IRN,Malaysia,MYS,57,0,13,0,70
2019,Iraq,IRQ,Malaysia,MYS,38,0,0,100,138
2019,Liberia,LBR,Malaysia,MYS,10,0,0,0,10
2019,Libya,LBY,Malaysia,MYS,10,0,0,0,10
2019,Sri Lanka,LKA,Malaysia,MYS,33,0,64,84,181
2019,Morocco,MAR,Malaysia,MYS,0,0,0,5,5
2019,Myanmar,MMR,Malaysia,MYS,12904,0,241,860,14005
2019,Nigeria,NGA,Malaysia,MYS,0,0,10,0,10
2019,Pakistan,PAK,Malaysia,MYS,1606,0,68,133,1807
2019,Philippines,PHL,Malaysia,MYS,0,0,0,5,5
2019,Sierra Leone,SLE,Malaysia,MYS,14,0,0,0,14
2019,Somalia,SOM,Malaysia,MYS,605,0,28,66,699
2019,Sudan,SDN,Malaysia,MYS,58,0,5,5,68
2019,South Sudan,SSD,Malaysia,MYS,5,0,0,5,10
2019,Syrian Arab Rep.,SYR,Malaysia,MYS,47,0,0,0,47
2019,Turkey,TUR,Malaysia,MYS,5,0,0,0,5
2019,Uganda,UGA,Malaysia,MYS,5,0,0,0,5
2019,Yemen,YEM,Malaysia,MYS,59,0,0,152,211
2019,Turkey,TUR,Mongolia,MNG,21,0,0,0,21
2019,Afghanistan,AFG,Morocco,MAR,0,0,0,5,5
2019,Algeria,DZA,Morocco,MAR,5,0,0,0,5
2019,Egypt,EGY,Morocco,MAR,0,0,0,10,10
2019,Benin,BEN,Morocco,MAR,0,0,5,0,5
2019,Bangladesh,BGD,Morocco,MAR,0,0,5,109,114
2019,Burkina Faso,BFA,Morocco,MAR,0,0,5,0,5
2019,Central African Rep.,CAF,Morocco,MAR,188,0,5,30,223
2019,Chad,TCD,Morocco,MAR,5,0,0,5,10
2019,Cameroon,CMR,Morocco,MAR,32,0,167,463,662
2019,Congo,COG,Morocco,MAR,0,0,13,30,43
2019,Dem. Rep. of the Congo,COD,Morocco,MAR,5,0,37,82,124
2019,Eritrea,ERI,Morocco,MAR,5,0,0,5,10
2019,Gabon,GAB,Morocco,MAR,0,0,0,5,5
2019,Gambia,GMB,Morocco,MAR,0,0,5,5,10
2019,Palestinian,PSE,Morocco,MAR,13,0,0,196,209
2019,Ghana,GHA,Morocco,MAR,0,0,0,10,10
2019,Guinea-Bissau,GNB,Morocco,MAR,0,0,0,10,10
2019,Guinea,GIN,Morocco,MAR,35,0,165,408,608
2019,Cote d'Ivoire,CIV,Morocco,MAR,39,0,110,165,314
2019,Iraq,IRQ,Morocco,MAR,5,0,0,0,5
2019,Liberia,LBR,Morocco,MAR,0,0,5,32,37
2019,Libya,LBY,Morocco,MAR,0,0,0,5,5
2019,Lebanon,LBN,Morocco,MAR,5,0,0,0,5
2019,Sri Lanka,LKA,Morocco,MAR,0,0,0,5,5
2019,Mauritania,MRT,Morocco,MAR,5,0,0,0,5
2019,Mali,MLI,Morocco,MAR,14,0,18,55,87
2019,Niger,NER,Morocco,MAR,0,0,0,5,5
2019,Nigeria,NGA,Morocco,MAR,10,0,60,150,220
2019,Pakistan,PAK,Morocco,MAR,0,0,0,5,5
2019,Senegal,SEN,Morocco,MAR,15,0,40,131,186
2019,Sierra Leone,SLE,Morocco,MAR,0,0,10,25,35
2019,Somalia,SOM,Morocco,MAR,0,0,0,5,5
2019,Sudan,SDN,Morocco,MAR,5,0,0,11,16
2019,South Sudan,SSD,Morocco,MAR,0,0,0,134,134
2019,Syrian Arab Rep.,SYR,Morocco,MAR,0,0,0,729,729
2019,Togo,TGO,Morocco,MAR,0,0,5,5,10
2019,Turkey,TUR,Morocco,MAR,0,0,0,10,10
2019,Yemen,YEM,Morocco,MAR,0,0,0,271,271
2019,Pakistan,PAK,Mauritius,MUS,5,0,0,0,5
2019,South Africa,ZAF,Mauritius,MUS,5,0,0,0,5
2019,Myanmar,MMR,Nepal,NPL,35,0,0,5,40
2019,Pakistan,PAK,Nepal,NPL,0,0,5,0,5
2019,Afghanistan,AFG,Pakistan,PAK,21,0,0,128,149
2019,China,CHN,Pakistan,PAK,5,0,0,0,5
2019,Somalia,SOM,Pakistan,PAK,0,0,0,5,5
2019,Syrian Arab Rep.,SYR,Pakistan,PAK,15,0,0,0,15
2019,Turkey,TUR,Pakistan,PAK,0,0,0,49,49
2019,Yemen,YEM,Pakistan,PAK,12,0,0,0,12
2019,Egypt,EGY,Qatar,QAT,5,0,0,0,5
2019,Iraq,IRQ,Qatar,QAT,5,0,0,0,5
2019,Yemen,YEM,Qatar,QAT,5,0,0,0,5
2019,Eritrea,ERI,Saudi Arabia,SAU,11,0,0,0,11
2019,Syrian Arab Rep.,SYR,Saudi Arabia,SAU,101,0,0,39,140
2019,Yemen,YEM,Saudi Arabia,SAU,12,0,0,5,17
2019,Cameroon,CMR,Somalia,SOM,5,0,0,0,5
2019,Eritrea,ERI,Somalia,SOM,13,0,0,0,13
2019,Ethiopia,ETH,Somalia,SOM,238,0,135,177,550
2019,Mozambique,MOZ,Somalia,SOM,0,0,5,0,5
2019,Yemen,YEM,Somalia,SOM,0,0,5,0,5
2019,Afghanistan,AFG,Viet Nam,VNM,5,0,0,0,5
2019,Central African Rep.,CAF,Sudan,SDN,0,0,0,5,5
2019,Chad,TCD,Sudan,SDN,0,0,0,5,5
2019,Eritrea,ERI,Sudan,SDN,0,0,0,2268,2268
2019,Ethiopia,ETH,Sudan,SDN,0,0,0,332,332
2019,Somalia,SOM,Sudan,SDN,0,0,0,45,45
2019,Yemen,YEM,Sudan,SDN,0,0,0,2523,2523
2019,Cuba,CUB,Suriname,SUR,5,0,29,17,51
2019,Dominican Rep.,DOM,Suriname,SUR,5,0,0,0,5
2019,Egypt,EGY,Syrian Arab Rep.,SYR,0,0,0,5,5
2019,Dem. Rep. of the Congo,COD,Syrian Arab Rep.,SYR,0,0,5,0,5
2019,Eritrea,ERI,Syrian Arab Rep.,SYR,5,0,0,0,5
2019,Palestinian,PSE,Syrian Arab Rep.,SYR,0,0,0,5,5
2019,Iran (Islamic Rep. of),IRN,Syrian Arab Rep.,SYR,0,0,0,5,5
2019,Iraq,IRQ,Syrian Arab Rep.,SYR,53,0,15,7925,7993
2019,Lebanon,LBN,Syrian Arab Rep.,SYR,0,0,0,5,5
2019,Pakistan,PAK,Syrian Arab Rep.,SYR,0,0,0,13,13
2019,Somalia,SOM,Syrian Arab Rep.,SYR,12,0,0,0,12
2019,Sudan,SDN,Syrian Arab Rep.,SYR,5,0,0,0,5
2019,Turkey,TUR,Syrian Arab Rep.,SYR,0,0,0,5,5
2019,Yemen,YEM,Syrian Arab Rep.,SYR,11,0,0,45,56
2019,Afghanistan,AFG,Thailand,THA,22,0,0,5,27
2019,Egypt,EGY,Thailand,THA,0,0,0,5,5
2019,Bangladesh,BGD,Thailand,THA,0,0,5,0,5
2019,Cambodia,KHM,Thailand,THA,43,0,48,70,161
2019,China,CHN,Thailand,THA,11,0,0,11,22
2019,Cameroon,CMR,Thailand,THA,27,0,0,0,27
2019,Dem. Rep. of the Congo,COD,Thailand,THA,0,0,0,5,5
2019,Ethiopia,ETH,Thailand,THA,10,0,0,5,15
2019,Palestinian,PSE,Thailand,THA,5,0,5,0,10
2019,Iran (Islamic Rep. of),IRN,Thailand,THA,5,0,5,26,36
2019,Iraq,IRQ,Thailand,THA,5,0,5,19,29
2019,Kuwait,KWT,Thailand,THA,0,0,5,0,5
2019,Lao People's Dem. Rep.,LAO,Thailand,THA,5,0,0,0,5
2019,Sri Lanka,LKA,Thailand,THA,0,0,0,11,11
2019,Pakistan,PAK,Thailand,THA,88,0,22,20,130
2019,Somalia,SOM,Thailand,THA,13,0,5,16,34
2019,Viet Nam,VNM,Thailand,THA,82,0,89,93,264
2019,Sudan,SDN,Thailand,THA,0,0,0,5,5
2019,South Sudan,SSD,Thailand,THA,0,0,0,5,5
2019,Syrian Arab Rep.,SYR,Thailand,THA,12,0,0,0,12
2019,Uzbekistan,UZB,Thailand,THA,0,0,0,5,5
2019,Yemen,YEM,Thailand,THA,10,0,0,0,10
2019,Afghanistan,AFG,Tajikistan,TJK,5,0,0,0,5
2019,Cuba,CUB,Trinidad and Tobago,TTO,18,0,13,40,71
2019,Jamaica,JAM,Trinidad and Tobago,TTO,11,0,5,0,16
2019,Syrian Arab Rep.,SYR,Trinidad and Tobago,TTO,10,0,0,0,10
2019,Venezuela (Bolivarian Republic of),VEN,Trinidad and Tobago,TTO,1574,0,0,105,1679
2019,Cameroon,CMR,Tunisia,TUN,5,0,0,0,5
2019,Eritrea,ERI,Tunisia,TUN,129,0,0,0,129
2019,Ethiopia,ETH,Tunisia,TUN,0,0,0,5,5
2019,Gambia,GMB,Tunisia,TUN,0,0,5,0,5
2019,Palestinian,PSE,Tunisia,TUN,5,0,0,0,5
2019,Cote d'Ivoire,CIV,Tunisia,TUN,11,0,0,0,11
2019,Libya,LBY,Tunisia,TUN,10,0,0,0,10
2019,Sierra Leone,SLE,Tunisia,TUN,5,0,0,0,5
2019,Somalia,SOM,Tunisia,TUN,12,0,5,0,17
2019,Sudan,SDN,Tunisia,TUN,21,0,0,0,21
2019,Egypt,EGY,United Arab Emirates,ARE,5,0,0,0,5
2019,Chad,TCD,United Arab Emirates,ARE,5,0,0,0,5
2019,Palestinian,PSE,United Arab Emirates,ARE,5,0,0,39,44
2019,Iran (Islamic Rep. of),IRN,United Arab Emirates,ARE,5,0,0,0,5
2019,Iraq,IRQ,United Arab Emirates,ARE,35,0,0,0,35
2019,Sudan,SDN,United Arab Emirates,ARE,0,0,0,10,10
2019,Syrian Arab Rep.,SYR,United Arab Emirates,ARE,112,0,0,650,762
2019,Russian Federation,RUS,Ukraine,UKR,5,0,0,0,5
2019,Tajikistan,TJK,Ukraine,UKR,5,0,0,0,5
2019,Colombia,COL,Curacao ,CUW,0,0,5,14,19
2019,Cuba,CUB,Curacao ,CUW,0,0,0,5,5
2019,Venezuela (Bolivarian Republic of),VEN,Curacao ,CUW,12,0,0,10,22
2020,Pakistan,PAK,Afghanistan,AFG,0,0,0,5,5
2020,Turkey,TUR,Afghanistan,AFG,61,0,0,18,79
2020,Benin,BEN,Algeria,DZA,0,0,0,5,5
2020,Burkina Faso,BFA,Algeria,DZA,5,0,0,0,5
2020,Central African Rep.,CAF,Algeria,DZA,14,0,0,5,19
2020,Chad,TCD,Algeria,DZA,0,0,5,0,5
2020,Cameroon,CMR,Algeria,DZA,54,0,38,10,102
2020,Dem. Rep. of the Congo,COD,Algeria,DZA,13,0,24,0,37
2020,Palestinian,PSE,Algeria,DZA,0,0,0,13,13
2020,Guinea,GIN,Algeria,DZA,5,0,34,5,44
2020,Cote d'Ivoire,CIV,Algeria,DZA,11,0,23,10,44
2020,Liberia,LBR,Algeria,DZA,0,0,0,5,5
2020,Mali,MLI,Algeria,DZA,54,0,38,0,92
2020,Niger,NER,Algeria,DZA,0,0,5,5,10
2020,Nigeria,NGA,Algeria,DZA,0,0,5,28,33
2020,Senegal,SEN,Algeria,DZA,0,0,0,5,5
2020,Sierra Leone,SLE,Algeria,DZA,0,0,0,5,5
2020,Sudan,SDN,Algeria,DZA,5,0,0,0,5
2020,Syrian Arab Rep.,SYR,Algeria,DZA,11,0,0,325,336
2020,Yemen,YEM,Algeria,DZA,0,0,0,11,11
2020,Afghanistan,AFG,Egypt,EGY,5,0,0,0,5
2020,Burundi,BDI,Egypt,EGY,5,0,0,0,5
2020,Central African Rep.,CAF,Egypt,EGY,5,0,0,0,5
2020,Chad,TCD,Egypt,EGY,10,0,0,0,10
2020,China,CHN,Egypt,EGY,0,0,0,5,5
2020,Cameroon,CMR,Egypt,EGY,5,0,0,0,5
2020,Dem. Rep. of the Congo,COD,Egypt,EGY,0,0,0,5,5
2020,Eritrea,ERI,Egypt,EGY,4862,0,85,772,5719
2020,Ethiopia,ETH,Egypt,EGY,815,0,1385,399,2599
2020,Guinea,GIN,Egypt,EGY,0,0,5,5,10
2020,Iraq,IRQ,Egypt,EGY,274,0,85,5,364
2020,Nigeria,NGA,Egypt,EGY,5,0,33,5,43
2020,Russian Federation,RUS,Egypt,EGY,0,0,0,5,5
2020,Saudi Arabia,SAU,Egypt,EGY,11,0,0,0,11
2020,Somalia,SOM,Egypt,EGY,677,0,130,190,997
2020,Sudan,SDN,Egypt,EGY,3726,0,1991,344,6061
2020,South Sudan,SSD,Egypt,EGY,3390,0,5,91,3486
2020,Tajikistan,TJK,Egypt,EGY,0,0,0,14,14
2020,Turkey,TUR,Egypt,EGY,0,0,0,21,21
2020,Uganda,UGA,Egypt,EGY,0,0,5,0,5
2020,Uzbekistan,UZB,Egypt,EGY,0,0,5,0,5
2020,Yemen,YEM,Egypt,EGY,27,0,0,173,200
2020,Zimbabwe,ZWE,Egypt,EGY,14,0,5,0,19
2020,Afghanistan,AFG,Azerbaijan,AZE,470,0,0,0,470
2020,Iraq,IRQ,Azerbaijan,AZE,5,0,0,0,5
2020,Syrian Arab Rep.,SYR,Azerbaijan,AZE,13,0,0,0,13
2020,Uzbekistan,UZB,Azerbaijan,AZE,5,0,0,0,5
2020,Trinidad and Tobago,TTO,Barbados,BRB,0,0,0,5,5
2020,Myanmar,MMR,Bangladesh,BGD,5,0,0,0,5
2020,Somalia,SOM,Bangladesh,BGD,0,0,12,0,12
2020,Turkey,TUR,Bangladesh,BGD,14,0,0,0,14
2020,Cambodia,KHM,Bahamas,BHS,5,0,0,0,5
2020,Afghanistan,AFG,Belarus,BLR,10,0,0,0,10
2020,Rwanda,RWA,Botswana,BWA,0,0,0,5,5
2020,Somalia,SOM,Botswana,BWA,5,0,0,0,5
2020,Zimbabwe,ZWE,Botswana,BWA,0,0,0,21,21
2020,Afghanistan,AFG,China,CHN,5,0,0,5,10
2020,Cameroon,CMR,China,CHN,0,0,12,5,17
2020,Dem. Rep. of the Congo,COD,China,CHN,0,0,0,5,5
2020,Eritrea,ERI,China,CHN,5,0,0,0,5
2020,Palestinian,PSE,China,CHN,0,0,0,5,5
2020,Ghana,GHA,China,CHN,0,0,14,0,14
2020,Cote d'Ivoire,CIV,China,CHN,0,0,0,5,5
2020,Iran (Islamic Rep. of),IRN,China,CHN,5,0,0,0,5
2020,Kenya,KEN,China,CHN,0,0,11,0,11
2020,Liberia,LBR,China,CHN,0,0,0,5,5
2020,Mozambique,MOZ,China,CHN,0,0,0,5,5
2020,Nigeria,NGA,China,CHN,0,0,0,12,12
2020,Pakistan,PAK,China,CHN,10,0,0,5,15
2020,Sierra Leone,SLE,China,CHN,0,0,0,5,5
2020,Somalia,SOM,China,CHN,18,0,5,0,23
2020,Turkey,TUR,China,CHN,0,0,0,10,10
2020,Uganda,UGA,China,CHN,0,0,41,5,46
2020,Yemen,YEM,China,CHN,10,0,0,0,10
2020,Zimbabwe,ZWE,China,CHN,0,0,38,12,50
2020,Burundi,BDI,Cameroon,CMR,0,0,0,5,5
2020,Central African Rep.,CAF,Cameroon,CMR,1393,0,17,2319,3729
2020,Chad,TCD,Cameroon,CMR,11,0,46,163,220
2020,Congo,COG,Cameroon,CMR,0,0,0,12,12
2020,Dem. Rep. of the Congo,COD,Cameroon,CMR,0,0,15,45,60
2020,Gabon,GAB,Cameroon,CMR,0,0,0,5,5
2020,Guinea,GIN,Cameroon,CMR,0,0,10,0,10
2020,Cote d'Ivoire,CIV,Cameroon,CMR,0,0,5,0,5
2020,Mali,MLI,Cameroon,CMR,10,0,5,20,35
2020,Niger,NER,Cameroon,CMR,0,0,23,5,28
2020,Nigeria,NGA,Cameroon,CMR,0,0,0,20,20
2020,Rwanda,RWA,Cameroon,CMR,0,0,11,55,66
2020,Sudan,SDN,Cameroon,CMR,5,0,0,19,24
2020,Togo,TGO,Cameroon,CMR,0,0,0,5,5
2020,Turkey,TUR,Cameroon,CMR,0,0,0,33,33
2020,Yemen,YEM,Cameroon,CMR,5,0,0,0,5
2020,Burundi,BDI,Comoros,COM,0,0,0,14,14
2020,Iraq,IRQ,Cuba,CUB,0,0,5,0,5
2020,Sudan,SDN,Cuba,CUB,10,0,0,0,10
2020,Cuba,CUB,Guyana,GUY,11,0,0,0,11
2020,Afghanistan,AFG,India,IND,981,0,427,921,2329
2020,Cameroon,CMR,India,IND,5,0,0,21,26
2020,Congo,COG,India,IND,5,0,0,0,5
2020,Dem. Rep. of the Congo,COD,India,IND,5,0,11,5,21
2020,Eritrea,ERI,India,IND,5,0,0,0,5
2020,Ethiopia,ETH,India,IND,0,0,10,0,10
2020,Cote d'Ivoire,CIV,India,IND,0,0,5,0,5
2020,Iran (Islamic Rep. of),IRN,India,IND,0,0,0,5,5
2020,Iraq,IRQ,India,IND,0,0,10,5,15
2020,Myanmar,MMR,India,IND,349,0,57,290,696
2020,Nigeria,NGA,India,IND,0,0,64,0,64
2020,Somalia,SOM,India,IND,5,0,21,41,67
2020,Sudan,SDN,India,IND,0,0,5,16,21
2020,South Sudan,SSD,India,IND,0,0,0,10,10
2020,Syrian Arab Rep.,SYR,India,IND,0,0,0,5,5
2020,Ukraine,UKR,India,IND,0,0,5,0,5
2020,Uzbekistan,UZB,India,IND,0,0,5,0,5
2020,Venezuela (Bolivarian Republic of),VEN,India,IND,5,0,0,0,5
2020,Yemen,YEM,India,IND,0,0,0,65,65
2020,Afghanistan,AFG,Indonesia,IDN,89,0,0,39,128
2020,Bangladesh,BGD,Indonesia,IDN,0,0,5,0,5
2020,Cameroon,CMR,Indonesia,IDN,0,0,5,0,5
2020,Eritrea,ERI,Indonesia,IDN,48,0,0,0,48
2020,Ethiopia,ETH,Indonesia,IDN,0,0,5,0,5
2020,Palestinian,PSE,Indonesia,IDN,0,0,0,15,15
2020,Iran (Islamic Rep. of),IRN,Indonesia,IDN,5,0,5,0,10
2020,Iraq,IRQ,Indonesia,IDN,14,0,0,0,14
2020,Libya,LBY,Indonesia,IDN,0,0,0,5,5
2020,Sri Lanka,LKA,Indonesia,IDN,0,0,5,0,5
2020,Myanmar,MMR,Indonesia,IDN,0,0,0,20,20
2020,Somalia,SOM,Indonesia,IDN,75,0,0,5,80
2020,Sudan,SDN,Indonesia,IDN,5,0,0,0,5
2020,Yemen,YEM,Indonesia,IDN,15,0,0,13,28
2020,Egypt,EGY,Iraq,IRQ,0,0,0,14,14
2020,Eritrea,ERI,Iraq,IRQ,0,0,0,5,5
2020,Palestinian,PSE,Iraq,IRQ,0,0,0,97,97
2020,Iran (Islamic Rep. of),IRN,Iraq,IRQ,5,0,0,455,460
2020,Kuwait,KWT,Iraq,IRQ,0,0,0,5,5
2020,Sudan,SDN,Iraq,IRQ,0,0,0,36,36
2020,Turkey,TUR,Iraq,IRQ,0,0,0,153,153
2020,Yemen,YEM,Iraq,IRQ,0,0,0,5,5
2020,Egypt,EGY,Jordan,JOR,21,0,61,48,130
2020,Chad,TCD,Jordan,JOR,0,0,5,0,5
2020,Ethiopia,ETH,Jordan,JOR,5,0,0,0,5
2020,India,IND,Jordan,JOR,0,0,5,0,5
2020,Iraq,IRQ,Jordan,JOR,228,0,5,349,582
2020,Kenya,KEN,Jordan,JOR,5,0,0,0,5
2020,Libya,LBY,Jordan,JOR,16,0,0,32,48
2020,Sri Lanka,LKA,Jordan,JOR,0,0,0,5,5
2020,Niger,NER,Jordan,JOR,0,0,0,5,5
2020,Nigeria,NGA,Jordan,JOR,0,0,11,32,43
2020,Saudi Arabia,SAU,Jordan,JOR,0,0,0,5,5
2020,Somalia,SOM,Jordan,JOR,12,0,0,11,23
2020,Sudan,SDN,Jordan,JOR,493,0,185,132,810
2020,Tunisia,TUN,Jordan,JOR,5,0,0,0,5
2020,Ukraine,UKR,Jordan,JOR,0,0,0,10,10
2020,Yemen,YEM,Jordan,JOR,115,0,0,613,728
2020,Stateless,XXA,Jordan,JOR,0,0,0,5,5
2020,Iraq,IRQ,Kuwait,KWT,0,0,0,5,5
2020,Sudan,SDN,Kuwait,KWT,0,0,0,5,5
2020,Syrian Arab Rep.,SYR,Kuwait,KWT,40,0,0,5,45
2020,Afghanistan,AFG,Libya,LBY,0,0,0,11,11
2020,Central African Rep.,CAF,Libya,LBY,0,0,0,5,5
2020,Chad,TCD,Libya,LBY,0,0,0,30,30
2020,Congo,COG,Libya,LBY,0,0,0,5,5
2020,Dem. Rep. of the Congo,COD,Libya,LBY,0,0,0,10,10
2020,Eritrea,ERI,Libya,LBY,240,0,33,523,796
2020,Ethiopia,ETH,Libya,LBY,11,0,26,156,193
2020,Palestinian,PSE,Libya,LBY,0,0,0,531,531
2020,Iraq,IRQ,Libya,LBY,0,0,5,46,51
2020,Niger,NER,Libya,LBY,0,0,0,5,5
2020,Somalia,SOM,Libya,LBY,12,0,0,285,297
2020,Sudan,SDN,Libya,LBY,431,0,194,1026,1651
2020,South Sudan,SSD,Libya,LBY,0,0,0,11,11
2020,Syrian Arab Rep.,SYR,Libya,LBY,126,0,0,5038,5164
2020,Algeria,DZA,Lebanon,LBN,5,0,0,0,5
2020,Egypt,EGY,Lebanon,LBN,26,0,34,68,128
2020,Bangladesh,BGD,Lebanon,LBN,0,0,10,14,24
2020,Cameroon,CMR,Lebanon,LBN,0,0,5,5,10
2020,Congo,COG,Lebanon,LBN,0,0,0,5,5
2020,Eritrea,ERI,Lebanon,LBN,5,0,0,5,10
2020,Ethiopia,ETH,Lebanon,LBN,5,0,182,126,313
2020,Gambia,GMB,Lebanon,LBN,0,0,5,0,5
2020,Palestinian,PSE,Lebanon,LBN,0,0,0,17,17
2020,Cote d'Ivoire,CIV,Lebanon,LBN,0,0,5,0,5
2020,India,IND,Lebanon,LBN,0,0,5,0,5
2020,Iran (Islamic Rep. of),IRN,Lebanon,LBN,5,0,5,0,10
2020,Iraq,IRQ,Lebanon,LBN,5,0,5,1997,2007
2020,Jordan,JOR,Lebanon,LBN,5,0,5,10,20
2020,Kenya,KEN,Lebanon,LBN,0,0,5,5,10
2020,Sri Lanka,LKA,Lebanon,LBN,0,0,5,5,10
2020,Madagascar,MDG,Lebanon,LBN,0,0,10,0,10
2020,Morocco,MAR,Lebanon,LBN,5,0,0,0,5
2020,Nigeria,NGA,Lebanon,LBN,0,0,21,30,51
2020,Philippines,PHL,Lebanon,LBN,0,0,12,10,22
2020,Sudan,SDN,Lebanon,LBN,56,0,320,289,665
2020,Togo,TGO,Lebanon,LBN,0,0,5,0,5
2020,Yemen,YEM,Lebanon,LBN,5,0,0,35,40
2020,Afghanistan,AFG,Sri Lanka,LKA,39,0,0,0,39
2020,Iran (Islamic Rep. of),IRN,Sri Lanka,LKA,5,0,0,0,5
2020,Nigeria,NGA,Sri Lanka,LKA,0,0,0,5,5
2020,Pakistan,PAK,Sri Lanka,LKA,123,0,34,10,167
2020,Sudan,SDN,Sri Lanka,LKA,5,0,0,0,5
2020,Turkey,TUR,Madagascar,MDG,10,0,0,0,10
2020,Benin,BEN,Mauritania,MRT,0,0,0,5,5
2020,Burkina Faso,BFA,Mauritania,MRT,15,0,0,10,25
2020,Central African Rep.,CAF,Mauritania,MRT,21,0,5,29,55
2020,Cameroon,CMR,Mauritania,MRT,15,0,27,0,42
2020,Gambia,GMB,Mauritania,MRT,0,0,0,5,5
2020,Palestinian,PSE,Mauritania,MRT,21,0,0,0,21
2020,Ghana,GHA,Mauritania,MRT,0,0,0,5,5
2020,Guinea-Bissau,GNB,Mauritania,MRT,0,0,14,0,14
2020,Guinea,GIN,Mauritania,MRT,0,0,70,60,130
2020,Cote d'Ivoire,CIV,Mauritania,MRT,12,0,26,50,88
2020,Liberia,LBR,Mauritania,MRT,0,0,0,19,19
2020,Mali,MLI,Mauritania,MRT,1158,0,5,16,1179
2020,Morocco,MAR,Mauritania,MRT,0,0,0,5,5
2020,Nigeria,NGA,Mauritania,MRT,0,0,32,26,58
2020,Senegal,SEN,Mauritania,MRT,36,0,14,0,50
2020,Sierra Leone,SLE,Mauritania,MRT,0,0,42,102,144
2020,Sudan,SDN,Mauritania,MRT,0,0,0,11,11
2020,Syrian Arab Rep.,SYR,Mauritania,MRT,21,0,0,10,31
2020,Togo,TGO,Mauritania,MRT,0,0,10,23,33
2020,Turkey,TUR,Mauritania,MRT,5,0,0,0,5
2020,Yemen,YEM,Mauritania,MRT,28,0,0,0,28
2020,Afghanistan,AFG,Malaysia,MYS,213,0,0,0,213
2020,Egypt,EGY,Malaysia,MYS,0,0,0,5,5
2020,China,CHN,Malaysia,MYS,5,0,0,0,5
2020,Cameroon,CMR,Malaysia,MYS,5,0,0,0,5
2020,Eritrea,ERI,Malaysia,MYS,5,0,0,0,5
2020,Palestinian,PSE,Malaysia,MYS,18,0,0,40,58
2020,Indonesia,IDN,Malaysia,MYS,11,0,0,24,35
2020,Iran (Islamic Rep. of),IRN,Malaysia,MYS,13,0,0,0,13
2020,Iraq,IRQ,Malaysia,MYS,5,0,0,77,82
2020,Jordan,JOR,Malaysia,MYS,0,0,0,5,5
2020,Lao People's Dem. Rep.,LAO,Malaysia,MYS,0,0,0,5,5
2020,Libya,LBY,Malaysia,MYS,0,0,0,5,5
2020,Sri Lanka,LKA,Malaysia,MYS,15,0,10,56,81
2020,Myanmar,MMR,Malaysia,MYS,2840,0,23,1990,4853
2020,Pakistan,PAK,Malaysia,MYS,244,0,12,134,390
2020,Somalia,SOM,Malaysia,MYS,320,0,5,65,390
2020,Sudan,SDN,Malaysia,MYS,5,0,0,5,10
2020,South Sudan,SSD,Malaysia,MYS,5,0,0,5,10
2020,Syrian Arab Rep.,SYR,Malaysia,MYS,12,0,0,101,113
2020,Uganda,UGA,Malaysia,MYS,0,0,0,5,5
2020,Yemen,YEM,Malaysia,MYS,36,0,0,155,191
2020,Burundi,BDI,Morocco,MAR,5,0,0,0,5
2020,Benin,BEN,Morocco,MAR,0,0,0,5,5
2020,Bangladesh,BGD,Morocco,MAR,0,0,0,30,30
2020,Burkina Faso,BFA,Morocco,MAR,0,0,5,0,5
2020,Central African Rep.,CAF,Morocco,MAR,21,0,0,0,21
2020,Cameroon,CMR,Morocco,MAR,28,0,81,0,109
2020,Congo,COG,Morocco,MAR,5,0,11,0,16
2020,Dem. Rep. of the Congo,COD,Morocco,MAR,5,0,29,0,34
2020,Eritrea,ERI,Morocco,MAR,5,0,0,0,5
2020,Ghana,GHA,Morocco,MAR,0,0,0,5,5
2020,Guinea,GIN,Morocco,MAR,38,0,136,0,174
2020,Cote d'Ivoire,CIV,Morocco,MAR,22,0,81,10,113
2020,Iraq,IRQ,Morocco,MAR,5,0,0,0,5
2020,Libya,LBY,Morocco,MAR,21,0,0,0,21
2020,Mali,MLI,Morocco,MAR,11,0,41,0,52
2020,Nigeria,NGA,Morocco,MAR,5,0,22,5,32
2020,Pakistan,PAK,Morocco,MAR,5,0,0,0,5
2020,Senegal,SEN,Morocco,MAR,16,0,13,5,34
2020,Sierra Leone,SLE,Morocco,MAR,0,0,10,0,10
2020,Somalia,SOM,Morocco,MAR,13,0,0,0,13
2020,Sudan,SDN,Morocco,MAR,5,0,0,0,5
2020,South Sudan,SSD,Morocco,MAR,0,0,0,56,56
2020,Turkey,TUR,Morocco,MAR,5,0,0,0,5
2020,Philippines,PHL,Mauritius,MUS,0,0,0,5,5
2020,Iran (Islamic Rep. of),IRN,Nepal,NPL,5,0,0,0,5
2020,Myanmar,MMR,Nepal,NPL,0,0,0,5,5
2020,Pakistan,PAK,Nepal,NPL,15,0,0,0,15
2020,Yemen,YEM,Nepal,NPL,0,0,0,5,5
2020,Afghanistan,AFG,Pakistan,PAK,5,0,0,17,22
2020,Iran (Islamic Rep. of),IRN,Pakistan,PAK,0,0,0,5,5
2020,Syrian Arab Rep.,SYR,Saudi Arabia,SAU,32,0,0,0,32
2020,Egypt,EGY,Somalia,SOM,0,0,0,24,24
2020,Djibouti,DJI,Somalia,SOM,0,0,0,10,10
2020,Eritrea,ERI,Somalia,SOM,0,0,0,20,20
2020,Ethiopia,ETH,Somalia,SOM,156,0,429,5743,6328
2020,Nigeria,NGA,Somalia,SOM,0,0,0,5,5
2020,Pakistan,PAK,Somalia,SOM,0,0,0,5,5
2020,Sudan,SDN,Somalia,SOM,0,0,0,10,10
2020,Syrian Arab Rep.,SYR,Somalia,SOM,0,0,0,18,18
2020,United Rep. of Tanzania,TZA,Somalia,SOM,0,0,0,5,5
2020,Yemen,YEM,Somalia,SOM,0,0,0,31,31
2020,Cuba,CUB,Suriname,SUR,10,0,10,147,167
2020,Dominican Rep.,DOM,Suriname,SUR,0,0,0,5,5
2020,Venezuela (Bolivarian Republic of),VEN,Suriname,SUR,5,0,0,19,24
2020,Iraq,IRQ,Syrian Arab Rep.,SYR,10,0,0,3435,3445
2020,Somalia,SOM,Syrian Arab Rep.,SYR,5,0,0,0,5
2020,Sudan,SDN,Syrian Arab Rep.,SYR,0,0,0,5,5
2020,Yemen,YEM,Syrian Arab Rep.,SYR,0,0,0,10,10
2020,Sri Lanka,LKA,Turks and Caicos Islands,TCA,10,0,5,0,15
2020,Afghanistan,AFG,Thailand,THA,36,0,0,0,36
2020,Cambodia,KHM,Thailand,THA,29,0,5,15,49
2020,China,CHN,Thailand,THA,10,0,0,5,15
2020,Cameroon,CMR,Thailand,THA,20,0,0,5,25
2020,Ethiopia,ETH,Thailand,THA,5,0,0,0,5
2020,Palestinian,PSE,Thailand,THA,5,0,0,0,5
2020,Iran (Islamic Rep. of),IRN,Thailand,THA,15,0,0,0,15
2020,Lao People's Dem. Rep.,LAO,Thailand,THA,5,0,0,0,5
2020,Sri Lanka,LKA,Thailand,THA,0,0,5,0,5
2020,Pakistan,PAK,Thailand,THA,63,0,0,11,74
2020,Somalia,SOM,Thailand,THA,11,0,0,0,11
2020,Viet Nam,VNM,Thailand,THA,93,0,28,34,155
2020,Syrian Arab Rep.,SYR,Thailand,THA,13,0,0,0,13
2020,Zimbabwe,ZWE,Thailand,THA,10,0,0,0,10
2020,Afghanistan,AFG,Tajikistan,TJK,15,0,0,0,15
2020,Cuba,CUB,Trinidad and Tobago,TTO,16,0,13,28,57
2020,Guyana,GUY,Trinidad and Tobago,TTO,18,0,0,0,18
2020,Jamaica,JAM,Trinidad and Tobago,TTO,25,0,0,0,25
2020,Syrian Arab Rep.,SYR,Trinidad and Tobago,TTO,10,0,0,0,10
2020,Venezuela (Bolivarian Republic of),VEN,Trinidad and Tobago,TTO,801,0,0,75,876
2020,Chad,TCD,Tunisia,TUN,0,0,0,5,5
2020,Cameroon,CMR,Tunisia,TUN,10,0,0,0,10
2020,Eritrea,ERI,Tunisia,TUN,90,0,0,5,95
2020,Ethiopia,ETH,Tunisia,TUN,0,0,0,5,5
2020,Palestinian,PSE,Tunisia,TUN,0,0,0,5,5
2020,Guinea,GIN,Tunisia,TUN,0,0,0,5,5
2020,Cote d'Ivoire,CIV,Tunisia,TUN,20,0,0,17,37
2020,Iran (Islamic Rep. of),IRN,Tunisia,TUN,5,0,0,0,5
2020,Iraq,IRQ,Tunisia,TUN,5,0,0,0,5
2020,Libya,LBY,Tunisia,TUN,26,0,0,0,26
2020,Mali,MLI,Tunisia,TUN,5,0,0,0,5
2020,Nigeria,NGA,Tunisia,TUN,5,0,0,0,5
2020,Somalia,SOM,Tunisia,TUN,18,0,0,32,50
2020,Sudan,SDN,Tunisia,TUN,96,0,0,28,124
2020,South Sudan,SSD,Tunisia,TUN,5,0,0,5,10
2020,Turkey,TUR,Tunisia,TUN,10,0,0,0,10
2020,Yemen,YEM,Tunisia,TUN,10,0,0,0,10
2020,Iran (Islamic Rep. of),IRN,United Arab Emirates,ARE,5,0,0,0,5
2020,Iraq,IRQ,United Arab Emirates,ARE,25,0,0,5,30
2020,Lebanon,LBN,United Arab Emirates,ARE,5,0,0,0,5
2020,Sudan,SDN,United Arab Emirates,ARE,0,0,0,5,5
2020,Syrian Arab Rep.,SYR,United Arab Emirates,ARE,86,0,0,12,98
2020,Eritrea,ERI,Yemen,YEM,5,0,0,0,5
2020,Ethiopia,ETH,Yemen,YEM,5,0,0,699,704
2020,Lebanon,LBN,Yemen,YEM,0,0,0,5,5
2020,Sudan,SDN,Yemen,YEM,0,0,0,5,5
2020,Colombia,COL,Curacao ,CUW,19,0,0,0,19
2020,Venezuela (Bolivarian Republic of),VEN,Curacao ,CUW,11,0,0,0,11
2020,Cuba,CUB,Sint Maarten (Dutch part),SXM,5,0,0,0,5
2021,Benin,BEN,Algeria,DZA,0,0,5,5,10
2021,Burkina Faso,BFA,Algeria,DZA,10,0,0,0,10
2021,Central African Rep.,CAF,Algeria,DZA,16,0,0,5,21
2021,Chad,TCD,Algeria,DZA,0,0,5,5,10
2021,Cameroon,CMR,Algeria,DZA,20,0,38,10,68
2021,Dem. Rep. of the Congo,COD,Algeria,DZA,11,0,24,0,35
2021,Palestinian,PSE,Algeria,DZA,0,0,0,13,13
2021,Ghana,GHA,Algeria,DZA,5,0,0,0,5
2021,Guinea,GIN,Algeria,DZA,13,0,36,5,54
2021,Cote d'Ivoire,CIV,Algeria,DZA,5,0,23,10,38
2021,Liberia,LBR,Algeria,DZA,0,0,0,5,5
2021,Mali,MLI,Algeria,DZA,62,0,38,0,100
2021,Niger,NER,Algeria,DZA,5,0,0,5,10
2021,Nigeria,NGA,Algeria,DZA,0,0,5,27,32
2021,Senegal,SEN,Algeria,DZA,0,0,0,5,5
2021,Sierra Leone,SLE,Algeria,DZA,0,0,0,5,5
2021,Sudan,SDN,Algeria,DZA,10,0,0,0,10
2021,Syrian Arab Rep.,SYR,Algeria,DZA,33,0,0,303,336
2021,Yemen,YEM,Algeria,DZA,11,0,0,0,11
2021,Afghanistan,AFG,Egypt,EGY,10,0,0,0,10
2021,Bangladesh,BGD,Egypt,EGY,0,0,5,0,5
2021,Central African Rep.,CAF,Egypt,EGY,5,0,0,0,5
2021,Chad,TCD,Egypt,EGY,5,0,0,5,10
2021,China,CHN,Egypt,EGY,0,0,0,5,5
2021,Congo,COG,Egypt,EGY,0,0,5,5,10
2021,Dem. Rep. of the Congo,COD,Egypt,EGY,0,0,5,0,5
2021,Djibouti,DJI,Egypt,EGY,11,0,0,0,11
2021,Eritrea,ERI,Egypt,EGY,703,0,55,243,1001
2021,Ethiopia,ETH,Egypt,EGY,140,0,639,851,1630
2021,Guinea,GIN,Egypt,EGY,0,0,5,0,5
2021,Iraq,IRQ,Egypt,EGY,53,0,92,49,194
2021,Kenya,KEN,Egypt,EGY,0,0,5,0,5
2021,Liberia,LBR,Egypt,EGY,0,0,0,5,5
2021,Nigeria,NGA,Egypt,EGY,0,0,35,57,92
2021,Saudi Arabia,SAU,Egypt,EGY,0,0,5,0,5
2021,Somalia,SOM,Egypt,EGY,174,0,111,127,412
2021,Sudan,SDN,Egypt,EGY,932,0,1048,928,2908
2021,South Sudan,SSD,Egypt,EGY,271,0,5,232,508
2021,Tajikistan,TJK,Egypt,EGY,0,0,5,0,5
2021,Turkey,TUR,Egypt,EGY,0,0,0,30,30
2021,Zimbabwe,ZWE,Egypt,EGY,0,0,0,5,5
2021,Afghanistan,AFG,Azerbaijan,AZE,136,0,0,0,136
2021,Iran (Islamic Rep. of),IRN,Azerbaijan,AZE,10,0,0,0,10
2021,Pakistan,PAK,Azerbaijan,AZE,27,0,17,0,44
2021,Russian Federation,RUS,Azerbaijan,AZE,0,0,5,0,5
2021,Yemen,YEM,Azerbaijan,AZE,5,0,0,0,5
2021,Syrian Arab Rep.,SYR,Bahrain,BHR,5,0,0,0,5
2021,Somalia,SOM,Bangladesh,BGD,0,0,0,5,5
2021,Cameroon,CMR,Bahamas,BHS,5,0,0,0,5
2021,Dem. Rep. of the Congo,COD,Botswana,BWA,96,0,0,14,110
2021,Somalia,SOM,Botswana,BWA,28,0,0,10,38
2021,Zimbabwe,ZWE,Botswana,BWA,0,0,212,80,292
2021,Afghanistan,AFG,China,CHN,14,0,0,0,14
2021,Cameroon,CMR,China,CHN,18,0,5,75,98
2021,Dem. Rep. of the Congo,COD,China,CHN,0,0,5,5,10
2021,Ethiopia,ETH,China,CHN,0,0,5,0,5
2021,Palestinian,PSE,China,CHN,0,0,0,5,5
2021,Ghana,GHA,China,CHN,0,0,0,12,12
2021,Cote d'Ivoire,CIV,China,CHN,0,0,5,5,10
2021,Kenya,KEN,China,CHN,0,0,13,22,35
2021,Morocco,MAR,China,CHN,5,0,0,0,5
2021,Mozambique,MOZ,China,CHN,0,0,0,5,5
2021,Nigeria,NGA,China,CHN,0,0,5,5,10
2021,Somalia,SOM,China,CHN,0,0,5,5,10
2021,Syrian Arab Rep.,SYR,China,CHN,10,0,0,0,10
2021,Uganda,UGA,China,CHN,0,0,18,25,43
2021,Yemen,YEM,China,CHN,12,0,0,0,12
2021,Zimbabwe,ZWE,China,CHN,0,0,24,30,54
2021,Burkina Faso,BFA,Cameroon,CMR,0,0,0,15,15
2021,Central African Rep.,CAF,Cameroon,CMR,768,0,5,525,1298
2021,Chad,TCD,Cameroon,CMR,0,0,14,56,70
2021,Dem. Rep. of the Congo,COD,Cameroon,CMR,0,0,5,0,5
2021,Guinea,GIN,Cameroon,CMR,0,0,0,111,111
2021,Cote d'Ivoire,CIV,Cameroon,CMR,0,0,0,42,42
2021,Mali,MLI,Cameroon,CMR,0,0,0,84,84
2021,Niger,NER,Cameroon,CMR,0,0,21,338,359
2021,Nigeria,NGA,Cameroon,CMR,0,0,0,15,15
2021,Senegal,SEN,Cameroon,CMR,0,0,0,21,21
2021,Sierra Leone,SLE,Cameroon,CMR,0,0,0,10,10
2021,Sudan,SDN,Cameroon,CMR,5,0,0,14,19
2021,Togo,TGO,Cameroon,CMR,0,0,5,0,5
2021,Turkey,TUR,Cameroon,CMR,0,0,0,25,25
2021,Dem. Rep. of the Congo,COD,Comoros,COM,28,0,0,0,28
2021,Cuba,CUB,Guyana,GUY,21,0,0,5,26
2021,Afghanistan,AFG,India,IND,1570,0,175,417,2162
2021,Cameroon,CMR,India,IND,16,0,14,5,35
2021,Congo,COG,India,IND,0,0,0,11,11
2021,Dem. Rep. of the Congo,COD,India,IND,5,0,13,0,18
2021,Eritrea,ERI,India,IND,5,0,0,0,5
2021,Ethiopia,ETH,India,IND,16,0,0,0,16
2021,Cote d'Ivoire,CIV,India,IND,0,0,10,0,10
2021,Iran (Islamic Rep. of),IRN,India,IND,11,0,0,5,16
2021,Iraq,IRQ,India,IND,5,0,12,5,22
2021,Kenya,KEN,India,IND,5,0,0,0,5
2021,Myanmar,MMR,India,IND,175,0,0,1193,1368
2021,Nigeria,NGA,India,IND,0,0,112,25,137
2021,Russian Federation,RUS,India,IND,0,0,5,0,5
2021,Somalia,SOM,India,IND,26,0,23,30,79
2021,Sudan,SDN,India,IND,5,0,14,0,19
2021,South Sudan,SSD,India,IND,5,0,0,0,5
2021,Syrian Arab Rep.,SYR,India,IND,10,0,0,0,10
2021,Turkmenistan,TKM,India,IND,0,0,5,0,5
2021,Turkey,TUR,India,IND,5,0,0,0,5
2021,Ukraine,UKR,India,IND,0,0,5,0,5
2021,Yemen,YEM,India,IND,5,0,0,0,5
2021,Afghanistan,AFG,Indonesia,IDN,146,0,0,0,146
2021,Egypt,EGY,Indonesia,IDN,0,0,5,0,5
2021,Eritrea,ERI,Indonesia,IDN,36,0,0,0,36
2021,Iraq,IRQ,Indonesia,IDN,24,0,0,0,24
2021,Sri Lanka,LKA,Indonesia,IDN,0,0,10,5,15
2021,Myanmar,MMR,Indonesia,IDN,5,0,0,0,5
2021,Pakistan,PAK,Indonesia,IDN,5,0,0,0,5
2021,Somalia,SOM,Indonesia,IDN,40,0,0,0,40
2021,Sudan,SDN,Indonesia,IDN,10,0,0,0,10
2021,Uganda,UGA,Indonesia,IDN,0,0,5,0,5
2021,Yemen,YEM,Indonesia,IDN,11,0,0,5,16
2021,Iran (Islamic Rep. of),IRN,Iraq,IRQ,89,0,0,0,89
2021,Sudan,SDN,Iraq,IRQ,0,0,5,20,25
2021,Turkey,TUR,Iraq,IRQ,210,0,0,0,210
2021,Egypt,EGY,Jordan,JOR,13,0,98,38,149
2021,Chad,TCD,Jordan,JOR,5,0,0,0,5
2021,Eritrea,ERI,Jordan,JOR,5,0,0,0,5
2021,Ethiopia,ETH,Jordan,JOR,5,0,0,0,5
2021,Iraq,IRQ,Jordan,JOR,248,0,5,27,280
2021,Libya,LBY,Jordan,JOR,0,0,0,15,15
2021,Lebanon,LBN,Jordan,JOR,0,0,0,5,5
2021,Nigeria,NGA,Jordan,JOR,0,0,14,0,14
2021,Pakistan,PAK,Jordan,JOR,0,0,5,5,10
2021,Philippines,PHL,Jordan,JOR,5,0,0,0,5
2021,Russian Federation,RUS,Jordan,JOR,0,0,0,5,5
2021,Saudi Arabia,SAU,Jordan,JOR,0,0,0,5,5
2021,Somalia,SOM,Jordan,JOR,14,0,0,5,19
2021,Sudan,SDN,Jordan,JOR,209,0,141,99,449
2021,United Arab Emirates,ARE,Jordan,JOR,0,0,0,5,5
2021,Yemen,YEM,Jordan,JOR,303,0,0,96,399
2021,Ethiopia,ETH,Kuwait,KWT,0,0,0,5,5
2021,Palestinian,PSE,Kuwait,KWT,5,0,0,0,5
2021,Iraq,IRQ,Kuwait,KWT,5,0,0,5,10
2021,Somalia,SOM,Kuwait,KWT,0,0,0,5,5
2021,Syrian Arab Rep.,SYR,Kuwait,KWT,21,0,0,20,41
2021,Yemen,YEM,Kuwait,KWT,5,0,0,0,5
2021,Chad,TCD,Libya,LBY,0,0,0,5,5
2021,Congo,COG,Libya,LBY,0,0,0,5,5
2021,Eritrea,ERI,Libya,LBY,161,0,10,2717,2888
2021,Ethiopia,ETH,Libya,LBY,16,0,15,522,553
2021,Palestinian,PSE,Libya,LBY,20,0,0,1342,1362
2021,Guinea,GIN,Libya,LBY,0,0,0,5,5
2021,Iraq,IRQ,Libya,LBY,0,0,5,157,162
2021,Nigeria,NGA,Libya,LBY,0,0,0,5,5
2021,Somalia,SOM,Libya,LBY,5,0,0,1643,1648
2021,Sudan,SDN,Libya,LBY,566,0,105,5091,5762
2021,South Sudan,SSD,Libya,LBY,5,0,0,163,168
2021,Syrian Arab Rep.,SYR,Libya,LBY,140,0,0,4819,4959
2021,Yemen,YEM,Libya,LBY,10,0,0,19,29
2021,Afghanistan,AFG,Lebanon,LBN,5,0,0,0,5
2021,Egypt,EGY,Lebanon,LBN,38,0,0,5,43
2021,Bangladesh,BGD,Lebanon,LBN,0,0,0,5,5
2021,Cameroon,CMR,Lebanon,LBN,5,0,0,5,10
2021,Eritrea,ERI,Lebanon,LBN,5,0,0,0,5
2021,Ethiopia,ETH,Lebanon,LBN,14,0,10,44,68
2021,Iran (Islamic Rep. of),IRN,Lebanon,LBN,5,0,0,14,19
2021,Jordan,JOR,Lebanon,LBN,10,0,0,0,10
2021,Kenya,KEN,Lebanon,LBN,0,0,0,5,5
2021,Nigeria,NGA,Lebanon,LBN,5,0,0,0,5
2021,Somalia,SOM,Lebanon,LBN,0,0,0,10,10
2021,Sudan,SDN,Lebanon,LBN,120,0,10,104,234
2021,South Sudan,SSD,Lebanon,LBN,5,0,0,0,5
2021,Yemen,YEM,Lebanon,LBN,10,0,0,0,10
2021,Afghanistan,AFG,Sri Lanka,LKA,5,0,0,0,5
2021,Bangladesh,BGD,Sri Lanka,LKA,0,0,5,0,5
2021,Iran (Islamic Rep. of),IRN,Sri Lanka,LKA,5,0,0,0,5
2021,Pakistan,PAK,Sri Lanka,LKA,31,0,20,12,63
2021,Afghanistan,AFG,Madagascar,MDG,10,0,0,0,10
2021,Comoros,COM,Madagascar,MDG,5,0,0,0,5
2021,Guinea,GIN,Madagascar,MDG,5,0,0,0,5
2021,Pakistan,PAK,Madagascar,MDG,46,0,0,0,46
2021,Turkey,TUR,Madagascar,MDG,5,0,0,0,5
2021,Burkina Faso,BFA,Mauritania,MRT,5,0,0,5,10
2021,Central African Rep.,CAF,Mauritania,MRT,14,0,0,26,40
2021,Cameroon,CMR,Mauritania,MRT,5,0,10,47,62
2021,Dem. Rep. of the Congo,COD,Mauritania,MRT,0,0,0,11,11
2021,Gambia,GMB,Mauritania,MRT,0,0,5,0,5
2021,Palestinian,PSE,Mauritania,MRT,5,0,0,5,10
2021,Ghana,GHA,Mauritania,MRT,0,0,0,5,5
2021,Guinea-Bissau,GNB,Mauritania,MRT,0,0,0,10,10
2021,Guinea,GIN,Mauritania,MRT,10,0,19,63,92
2021,Cote d'Ivoire,CIV,Mauritania,MRT,0,0,26,34,60
2021,Liberia,LBR,Mauritania,MRT,0,0,0,10,10
2021,Libya,LBY,Mauritania,MRT,5,0,0,5,10
2021,Mali,MLI,Mauritania,MRT,2918,0,85,0,3003
2021,Niger,NER,Mauritania,MRT,5,0,0,0,5
2021,Nigeria,NGA,Mauritania,MRT,0,0,10,41,51
2021,Russian Federation,RUS,Mauritania,MRT,11,0,0,0,11
2021,Senegal,SEN,Mauritania,MRT,36,0,16,18,70
2021,Sierra Leone,SLE,Mauritania,MRT,0,0,18,29,47
2021,Sudan,SDN,Mauritania,MRT,0,0,0,10,10
2021,Syrian Arab Rep.,SYR,Mauritania,MRT,0,0,0,13,13
2021,Togo,TGO,Mauritania,MRT,0,0,28,5,33
2021,Turkey,TUR,Mauritania,MRT,0,0,0,12,12
2021,Yemen,YEM,Mauritania,MRT,15,0,0,5,20
2021,Afghanistan,AFG,Malaysia,MYS,245,0,0,0,245
2021,Egypt,EGY,Malaysia,MYS,5,0,0,0,5
2021,Cameroon,CMR,Malaysia,MYS,5,0,0,0,5
2021,Eritrea,ERI,Malaysia,MYS,16,0,0,0,16
2021,Palestinian,PSE,Malaysia,MYS,29,0,0,0,29
2021,Indonesia,IDN,Malaysia,MYS,5,0,0,0,5
2021,Iran (Islamic Rep. of),IRN,Malaysia,MYS,22,0,5,0,27
2021,Iraq,IRQ,Malaysia,MYS,19,0,0,0,19
2021,Sri Lanka,LKA,Malaysia,MYS,5,0,17,0,22
2021,Myanmar,MMR,Malaysia,MYS,1752,0,0,0,1752
2021,Nigeria,NGA,Malaysia,MYS,0,0,5,0,5
2021,Pakistan,PAK,Malaysia,MYS,556,0,11,0,567
2021,Somalia,SOM,Malaysia,MYS,444,0,10,0,454
2021,Sudan,SDN,Malaysia,MYS,18,0,0,0,18
2021,South Sudan,SSD,Malaysia,MYS,5,0,0,0,5
2021,Syrian Arab Rep.,SYR,Malaysia,MYS,80,0,0,0,80
2021,Yemen,YEM,Malaysia,MYS,105,0,0,0,105
2021,Afghanistan,AFG,Morocco,MAR,5,0,0,0,5
2021,Bangladesh,BGD,Morocco,MAR,0,0,0,67,67
2021,Burkina Faso,BFA,Morocco,MAR,0,0,0,5,5
2021,Central African Rep.,CAF,Morocco,MAR,5,0,0,0,5
2021,Chad,TCD,Morocco,MAR,0,0,0,10,10
2021,Cameroon,CMR,Morocco,MAR,32,0,57,184,273
2021,Congo,COG,Morocco,MAR,0,0,0,10,10
2021,Dem. Rep. of the Congo,COD,Morocco,MAR,5,0,14,22,41
2021,Gambia,GMB,Morocco,MAR,0,0,13,5,18
2021,Ghana,GHA,Morocco,MAR,0,0,0,5,5
2021,Guinea-Bissau,GNB,Morocco,MAR,0,0,5,0,5
2021,Guinea,GIN,Morocco,MAR,31,0,238,261,530
2021,Cote d'Ivoire,CIV,Morocco,MAR,28,0,63,98,189
2021,Liberia,LBR,Morocco,MAR,0,0,5,11,16
2021,Mauritania,MRT,Morocco,MAR,0,0,0,5,5
2021,Mali,MLI,Morocco,MAR,13,0,49,77,139
2021,Nigeria,NGA,Morocco,MAR,5,0,42,48,95
2021,Senegal,SEN,Morocco,MAR,19,0,198,16,233
2021,Sierra Leone,SLE,Morocco,MAR,0,0,5,16,21
2021,Somalia,SOM,Morocco,MAR,5,0,0,0,5
2021,Sudan,SDN,Morocco,MAR,34,0,0,13,47
2021,South Sudan,SSD,Morocco,MAR,5,0,0,0,5
2021,Togo,TGO,Morocco,MAR,0,0,0,5,5
2021,Sri Lanka,LKA,Nepal,NPL,0,0,0,5,5
2021,Afghanistan,AFG,Pakistan,PAK,5,0,0,16,21
2021,Iran (Islamic Rep. of),IRN,Pakistan,PAK,0,0,0,5,5
2021,Somalia,SOM,Pakistan,PAK,0,0,0,5,5
2021,Pakistan,PAK,Qatar,QAT,5,0,0,0,5
2021,Syrian Arab Rep.,SYR,Saudi Arabia,SAU,62,0,0,0,62
2021,Yemen,YEM,Saudi Arabia,SAU,5,0,0,0,5
2021,Ethiopia,ETH,Somalia,SOM,130,0,0,0,130
2021,Yemen,YEM,Somalia,SOM,0,0,0,19,19
2021,Cuba,CUB,Suriname,SUR,10,0,0,346,356
2021,Venezuela (Bolivarian Republic of),VEN,Suriname,SUR,0,0,0,21,21
2021,Afghanistan,AFG,Syrian Arab Rep.,SYR,15,0,0,0,15
2021,Iraq,IRQ,Syrian Arab Rep.,SYR,34,0,0,0,34
2021,Pakistan,PAK,Syrian Arab Rep.,SYR,5,0,0,0,5
2021,Somalia,SOM,Syrian Arab Rep.,SYR,14,0,0,0,14
2021,Sudan,SDN,Syrian Arab Rep.,SYR,15,0,0,0,15
2021,Yemen,YEM,Syrian Arab Rep.,SYR,5,0,0,0,5
2021,Afghanistan,AFG,Thailand,THA,18,0,0,5,23
2021,Cambodia,KHM,Thailand,THA,62,0,22,29,113
2021,China,CHN,Thailand,THA,12,0,5,5,22
2021,Cameroon,CMR,Thailand,THA,13,0,5,0,18
2021,Ethiopia,ETH,Thailand,THA,5,0,0,0,5
2021,Palestinian,PSE,Thailand,THA,5,0,0,0,5
2021,Guinea,GIN,Thailand,THA,0,0,0,5,5
2021,Iran (Islamic Rep. of),IRN,Thailand,THA,14,0,0,10,24
2021,Sri Lanka,LKA,Thailand,THA,0,0,0,5,5
2021,Myanmar,MMR,Thailand,THA,5,0,0,0,5
2021,Pakistan,PAK,Thailand,THA,23,0,13,14,50
2021,Somalia,SOM,Thailand,THA,5,0,0,5,10
2021,Viet Nam,VNM,Thailand,THA,102,0,83,65,250
2021,Syrian Arab Rep.,SYR,Thailand,THA,5,0,0,0,5
2021,Yemen,YEM,Thailand,THA,5,0,0,0,5
2021,Cuba,CUB,Trinidad and Tobago,TTO,18,0,12,0,30
2021,Jamaica,JAM,Trinidad and Tobago,TTO,5,0,5,0,10
2021,Nigeria,NGA,Trinidad and Tobago,TTO,0,0,10,0,10
2021,Venezuela (Bolivarian Republic of),VEN,Trinidad and Tobago,TTO,472,0,0,0,472
2021,Algeria,DZA,Tunisia,TUN,0,0,0,15,15
2021,Bangladesh,BGD,Tunisia,TUN,0,0,0,11,11
2021,Burkina Faso,BFA,Tunisia,TUN,13,0,0,5,18
2021,Central African Rep.,CAF,Tunisia,TUN,11,0,0,0,11
2021,Chad,TCD,Tunisia,TUN,5,0,0,5,10
2021,Cameroon,CMR,Tunisia,TUN,28,0,5,25,58
2021,Congo,COG,Tunisia,TUN,0,0,0,5,5
2021,Dem. Rep. of the Congo,COD,Tunisia,TUN,0,0,5,13,18
2021,Eritrea,ERI,Tunisia,TUN,23,0,0,27,50
2021,Ethiopia,ETH,Tunisia,TUN,0,0,0,11,11
2021,Guinea,GIN,Tunisia,TUN,10,0,16,36,62
2021,Cote d'Ivoire,CIV,Tunisia,TUN,33,0,161,207,401
2021,Liberia,LBR,Tunisia,TUN,0,0,0,5,5
2021,Libya,LBY,Tunisia,TUN,37,0,0,13,50
2021,Mauritania,MRT,Tunisia,TUN,0,0,0,5,5
2021,Mali,MLI,Tunisia,TUN,11,0,0,5,16
2021,Nigeria,NGA,Tunisia,TUN,0,0,0,10,10
2021,Somalia,SOM,Tunisia,TUN,5,0,0,49,54
2021,Sudan,SDN,Tunisia,TUN,56,0,0,40,96
2021,South Sudan,SSD,Tunisia,TUN,0,0,0,5,5
2021,Syrian Arab Rep.,SYR,Tunisia,TUN,12,0,0,0,12
2021,Turkey,TUR,Tunisia,TUN,5,0,0,0,5
2021,Yemen,YEM,Tunisia,TUN,12,0,0,10,22
2021,Iraq,IRQ,United Arab Emirates,ARE,16,0,0,5,21
2021,Kyrgyzstan,KGZ,United Arab Emirates,ARE,0,0,0,5,5
2021,Libya,LBY,United Arab Emirates,ARE,0,0,0,5,5
2021,Syrian Arab Rep.,SYR,United Arab Emirates,ARE,68,0,0,23,91
2021,Afghanistan,AFG,Ukraine,UKR,5,0,0,0,5
2021,Bangladesh,BGD,Vanuatu,VUT,0,0,5,0,5
2021,Eritrea,ERI,Yemen,YEM,0,0,0,10,10
2021,Ethiopia,ETH,Yemen,YEM,0,0,124,210,334
2021,Palestinian,PSE,Yemen,YEM,0,0,0,5,5
2021,Sudan,SDN,Yemen,YEM,0,0,0,11,11
2021,Syrian Arab Rep.,SYR,Yemen,YEM,0,0,0,10,10
2009,Cote d'Ivoire,CIV,Israel,ISR,0,0,0,5,5
2009,Turkey,TUR,Israel,ISR,0,0,0,10,10
2016,Afghanistan,AFG,Syrian Arab Rep.,SYR,10,0,5,0,15
2016,Algeria,DZA,Syrian Arab Rep.,SYR,0,0,11,0,11
2016,Egypt,EGY,Syrian Arab Rep.,SYR,0,0,39,5,44
2016,Argentina,ARG,Syrian Arab Rep.,SYR,0,0,5,0,5
2016,Burkina Faso,BFA,Syrian Arab Rep.,SYR,0,0,5,0,5
2016,Comoros,COM,Syrian Arab Rep.,SYR,0,0,5,0,5
2016,Ethiopia,ETH,Syrian Arab Rep.,SYR,0,0,5,5,10
2016,Guinea,GIN,Syrian Arab Rep.,SYR,0,0,10,0,10
2016,Iran (Islamic Rep. of),IRN,Syrian Arab Rep.,SYR,0,0,381,0,381
2016,Iraq,IRQ,Syrian Arab Rep.,SYR,15,0,10,12,37
2016,Jordan,JOR,Syrian Arab Rep.,SYR,0,0,63,27,90
2016,Liberia,LBR,Syrian Arab Rep.,SYR,5,0,0,0,5
2016,Lebanon,LBN,Syrian Arab Rep.,SYR,0,0,95,21,116
2016,Morocco,MAR,Syrian Arab Rep.,SYR,0,0,5,0,5
2016,Pakistan,PAK,Syrian Arab Rep.,SYR,11,0,15,5,31
2016,Sierra Leone,SLE,Syrian Arab Rep.,SYR,0,0,5,5,10
2016,Sudan,SDN,Syrian Arab Rep.,SYR,15,0,45,44,104
2016,South Sudan,SSD,Syrian Arab Rep.,SYR,5,0,0,0,5
2016,Tunisia,TUN,Syrian Arab Rep.,SYR,0,0,13,5,18
2017,Afghanistan,AFG,Syrian Arab Rep.,SYR,15,0,173,5,193
2017,Algeria,DZA,Syrian Arab Rep.,SYR,0,0,10,0,10
2017,Egypt,EGY,Syrian Arab Rep.,SYR,5,0,44,0,49
2017,Bangladesh,BGD,Syrian Arab Rep.,SYR,0,0,5,0,5
2017,Burkina Faso,BFA,Syrian Arab Rep.,SYR,0,0,0,11,11
2017,Chad,TCD,Syrian Arab Rep.,SYR,0,0,5,0,5
2017,Eritrea,ERI,Syrian Arab Rep.,SYR,5,0,0,0,5
2017,Guinea,GIN,Syrian Arab Rep.,SYR,0,0,0,5,5
2017,Iran (Islamic Rep. of),IRN,Syrian Arab Rep.,SYR,0,0,256,117,373
2017,Iraq,IRQ,Syrian Arab Rep.,SYR,10,0,44,15,69
2017,Jordan,JOR,Syrian Arab Rep.,SYR,0,0,0,5,5
2017,Lebanon,LBN,Syrian Arab Rep.,SYR,0,0,40,16,56
2017,Pakistan,PAK,Syrian Arab Rep.,SYR,5,0,11,0,16
2017,Philippines,PHL,Syrian Arab Rep.,SYR,0,0,5,0,5
2017,Saudi Arabia,SAU,Syrian Arab Rep.,SYR,0,0,5,0,5
2017,Sierra Leone,SLE,Syrian Arab Rep.,SYR,0,0,5,0,5
2017,Sudan,SDN,Syrian Arab Rep.,SYR,5,0,55,0,60
2017,United Rep. of Tanzania,TZA,Syrian Arab Rep.,SYR,0,0,5,0,5
2017,Turkey,TUR,Syrian Arab Rep.,SYR,0,0,5,0,5
2017,Ukraine,UKR,Syrian Arab Rep.,SYR,0,0,0,5,5
2017,Uzbekistan,UZB,Syrian Arab Rep.,SYR,0,0,5,0,5
2017,Yemen,YEM,Syrian Arab Rep.,SYR,5,0,0,11,16
2018,Afghanistan,AFG,Syrian Arab Rep.,SYR,0,0,10,12,22
2018,Guinea,GIN,Syrian Arab Rep.,SYR,0,0,5,0,5
2018,Iran (Islamic Rep. of),IRN,Syrian Arab Rep.,SYR,0,0,5,5,10
2018,Iraq,IRQ,Syrian Arab Rep.,SYR,0,0,27,5,32
2018,Jordan,JOR,Syrian Arab Rep.,SYR,0,0,5,0,5
2018,Pakistan,PAK,Syrian Arab Rep.,SYR,0,0,15,0,15
2018,Sudan,SDN,Syrian Arab Rep.,SYR,0,0,48,0,48
2018,Yemen,YEM,Syrian Arab Rep.,SYR,10,0,0,0,10
2018,Stateless,XXA,Syrian Arab Rep.,SYR,0,0,0,5,5
2019,Iraq,IRQ,Syrian Arab Rep.,SYR,0,0,0,10,10
2019,Sudan,SDN,Syrian Arab Rep.,SYR,18,0,0,0,18
2019,Yemen,YEM,Syrian Arab Rep.,SYR,0,0,0,10,10
2016,Iraq,IRQ,United Arab Emirates,ARE,224,0,0,0,224
2016,Syrian Arab Rep.,SYR,United Arab Emirates,ARE,101,0,0,0,101
2005,Cameroon,CMR,"China, Hong Kong SAR",HKG,0,0,5,0,5
2005,Sri Lanka,LKA,"China, Hong Kong SAR",HKG,0,0,5,0,5
2005,Pakistan,PAK,"China, Hong Kong SAR",HKG,0,0,5,0,5
2005,Cambodia,KHM,Thailand,THA,0,0,10,0,10
2005,China,CHN,Thailand,THA,5,0,0,0,5
2005,Dem. Rep. of the Congo,COD,Thailand,THA,0,0,0,5,5
2005,Iran (Islamic Rep. of),IRN,Thailand,THA,0,0,5,0,5
2005,Lao People's Dem. Rep.,LAO,Thailand,THA,0,0,0,5,5
2005,Myanmar,MMR,Thailand,THA,33,0,31,0,64
2005,Viet Nam,VNM,Thailand,THA,0,0,0,5,5
2006,Sri Lanka,LKA,"China, Hong Kong SAR",HKG,0,0,13,0,13
2006,Pakistan,PAK,"China, Hong Kong SAR",HKG,0,0,5,0,5
2006,Afghanistan,AFG,Syrian Arab Rep.,SYR,5,0,0,0,5
2006,Eritrea,ERI,Syrian Arab Rep.,SYR,0,0,0,5,5
2006,Iran (Islamic Rep. of),IRN,Syrian Arab Rep.,SYR,0,0,14,0,14
2006,Somalia,SOM,Syrian Arab Rep.,SYR,168,0,15,0,183
2006,Sudan,SDN,Syrian Arab Rep.,SYR,15,0,11,0,26
2006,Cambodia,KHM,Thailand,THA,0,0,0,5,5
2006,China,CHN,Thailand,THA,0,0,5,0,5
2006,Sri Lanka,LKA,Thailand,THA,0,0,5,0,5
2006,Afghanistan,AFG,Turkey,TUR,0,0,5,0,5
2006,Iran (Islamic Rep. of),IRN,Turkey,TUR,76,0,26,0,102
2006,Iraq,IRQ,Turkey,TUR,10,0,0,0,10
2007,Rwanda,RWA,Cameroon,CMR,5,0,36,0,41
2007,Congo,COG,"China, Hong Kong SAR",HKG,0,5,0,0,5
2007,Sri Lanka,LKA,"China, Hong Kong SAR",HKG,0,0,5,0,5
2007,Nepal,NPL,"China, Hong Kong SAR",HKG,0,0,10,0,10
2007,Afghanistan,AFG,Syrian Arab Rep.,SYR,13,0,5,0,18
2007,Somalia,SOM,Syrian Arab Rep.,SYR,28,0,0,0,28
2007,Sudan,SDN,Syrian Arab Rep.,SYR,0,0,5,0,5
2007,Cambodia,KHM,Thailand,THA,0,0,5,43,48
2007,China,CHN,Thailand,THA,5,0,0,21,26
2007,Dem. Rep. of the Congo,COD,Thailand,THA,0,0,0,5,5
2007,Iraq,IRQ,Thailand,THA,5,0,0,0,5
2007,Sri Lanka,LKA,Thailand,THA,0,0,0,10,10
2007,Viet Nam,VNM,Thailand,THA,0,0,10,55,65
2007,Eritrea,ERI,Turkey,TUR,0,0,0,5,5
2007,Iran (Islamic Rep. of),IRN,Turkey,TUR,61,0,16,0,77
2007,Iraq,IRQ,Turkey,TUR,80,0,0,22,102
2007,Kazakhstan,KAZ,Turkey,TUR,0,0,0,5,5
2007,Somalia,SOM,Turkey,TUR,0,0,0,5,5
2007,Uzbekistan,UZB,Turkey,TUR,5,0,0,0,5
2008,Afghanistan,AFG,Syrian Arab Rep.,SYR,0,0,0,5,5
2008,Iran (Islamic Rep. of),IRN,Syrian Arab Rep.,SYR,0,0,0,12,12
2008,Kuwait,KWT,Syrian Arab Rep.,SYR,5,0,0,0,5
2008,Somalia,SOM,Syrian Arab Rep.,SYR,5,0,0,0,5
2008,Sudan,SDN,Syrian Arab Rep.,SYR,0,0,0,23,23
2008,Stateless,XXA,Syrian Arab Rep.,SYR,13,0,0,0,13
2008,Cambodia,KHM,Thailand,THA,0,0,0,22,22
2008,China,CHN,Thailand,THA,10,0,5,11,26
2008,Sri Lanka,LKA,Thailand,THA,5,0,10,18,33
2008,Pakistan,PAK,Thailand,THA,0,0,0,5,5
2008,Viet Nam,VNM,Thailand,THA,0,0,5,0,5
2008,Iran (Islamic Rep. of),IRN,Turkey,TUR,48,0,20,5,73
2008,Iraq,IRQ,Turkey,TUR,32,0,5,0,37
2009,Sri Lanka,LKA,"China, Hong Kong SAR",HKG,0,0,0,10,10
2009,Pakistan,PAK,"China, Hong Kong SAR",HKG,0,0,0,5,5
2009,Egypt,EGY,Jordan,JOR,0,0,5,0,5
2009,Sudan,SDN,Jordan,JOR,30,0,10,0,40
2009,Afghanistan,AFG,Syrian Arab Rep.,SYR,5,0,0,0,5
2009,Iran (Islamic Rep. of),IRN,Syrian Arab Rep.,SYR,0,0,0,5,5
2009,Sudan,SDN,Syrian Arab Rep.,SYR,5,0,0,0,5
2009,Cambodia,KHM,Thailand,THA,0,0,0,13,13
2009,China,CHN,Thailand,THA,0,0,14,5,19
2009,Iraq,IRQ,Thailand,THA,5,0,5,0,10
2009,Kuwait,KWT,Thailand,THA,0,0,0,5,5
2009,Sri Lanka,LKA,Thailand,THA,10,0,0,10,20
2009,Viet Nam,VNM,Thailand,THA,0,0,5,5,10
2009,Afghanistan,AFG,Turkey,TUR,0,0,5,0,5
2009,Ethiopia,ETH,Turkey,TUR,0,0,5,0,5
2009,Iran (Islamic Rep. of),IRN,Turkey,TUR,12,0,5,14,31
2009,Iraq,IRQ,Turkey,TUR,16,0,5,14,35
2009,Syrian Arab Rep.,SYR,Turkey,TUR,0,0,5,0,5
2009,Uzbekistan,UZB,Turkey,TUR,14,0,0,0,14
2010,Burundi,BDI,Cameroon,CMR,0,0,5,0,5
2010,Central African Rep.,CAF,Cameroon,CMR,0,0,5,13,18
2010,Chad,TCD,Cameroon,CMR,0,0,28,5,33
2010,Dem. Rep. of the Congo,COD,Cameroon,CMR,0,0,10,0,10
2010,Guinea,GIN,Cameroon,CMR,0,0,0,5,5
2010,Cote d'Ivoire,CIV,Cameroon,CMR,0,0,5,0,5
2010,Rwanda,RWA,Cameroon,CMR,0,0,5,5,10
2010,Sudan,SDN,Cameroon,CMR,0,0,5,0,5
2010,Bangladesh,BGD,"China, Hong Kong SAR",HKG,0,0,11,0,11
2010,India,IND,"China, Hong Kong SAR",HKG,0,0,0,5,5
2010,Indonesia,IDN,"China, Hong Kong SAR",HKG,0,0,0,13,13
2010,Sri Lanka,LKA,"China, Hong Kong SAR",HKG,0,0,5,12,17
2010,Nepal,NPL,"China, Hong Kong SAR",HKG,0,0,5,0,5
2010,Pakistan,PAK,"China, Hong Kong SAR",HKG,0,0,10,10,20
2010,Philippines,PHL,"China, Hong Kong SAR",HKG,0,0,0,5,5
2010,Egypt,EGY,Jordan,JOR,0,0,0,15,15
2010,Iraq,IRQ,Jordan,JOR,0,0,0,40,40
2010,Pakistan,PAK,Jordan,JOR,0,0,0,10,10
2010,Sudan,SDN,Jordan,JOR,5,0,0,19,24
2010,Syrian Arab Rep.,SYR,Jordan,JOR,0,0,0,11,11
2010,Stateless,XXA,Jordan,JOR,0,0,0,10,10
2010,Iraq,IRQ,Lebanon,LBN,0,0,5,0,5
2010,Sudan,SDN,Lebanon,LBN,0,0,0,5,5
2010,Afghanistan,AFG,Syrian Arab Rep.,SYR,11,0,0,23,34
2010,Somalia,SOM,Syrian Arab Rep.,SYR,0,0,0,50,50
2010,Sudan,SDN,Syrian Arab Rep.,SYR,0,0,0,34,34
2010,Stateless,XXA,Syrian Arab Rep.,SYR,10,0,0,0,10
2010,Cambodia,KHM,Thailand,THA,0,0,19,23,42
2010,China,CHN,Thailand,THA,5,0,5,19,29
2010,India,IND,Thailand,THA,0,0,0,5,5
2010,Iran (Islamic Rep. of),IRN,Thailand,THA,0,0,0,5,5
2010,Iraq,IRQ,Thailand,THA,0,0,0,5,5
2010,Sri Lanka,LKA,Thailand,THA,0,0,13,17,30
2010,Pakistan,PAK,Thailand,THA,0,0,0,10,10
2010,Viet Nam,VNM,Thailand,THA,0,0,12,24,36
2010,Afghanistan,AFG,Turkey,TUR,5,0,0,0,5
2010,Iran (Islamic Rep. of),IRN,Turkey,TUR,35,0,5,0,40
2010,Iraq,IRQ,Turkey,TUR,5,0,0,0,5
2010,Uzbekistan,UZB,Turkey,TUR,5,0,0,0,5
2010,Stateless,XXA,Turkey,TUR,5,0,0,0,5
2011,Burundi,BDI,Cameroon,CMR,0,0,5,0,5
2011,Central African Rep.,CAF,Cameroon,CMR,5,0,52,144,201
2011,Chad,TCD,Cameroon,CMR,0,0,59,5,64
2011,Dem. Rep. of the Congo,COD,Cameroon,CMR,0,0,21,0,21
2011,Guinea,GIN,Cameroon,CMR,0,0,5,0,5
2011,Cote d'Ivoire,CIV,Cameroon,CMR,10,0,0,0,10
2011,Liberia,LBR,Cameroon,CMR,0,0,0,5,5
2011,Rwanda,RWA,Cameroon,CMR,5,0,56,48,109
2011,Bangladesh,BGD,"China, Hong Kong SAR",HKG,0,0,0,5,5
2011,Indonesia,IDN,"China, Hong Kong SAR",HKG,0,0,0,5,5
2011,Sri Lanka,LKA,"China, Hong Kong SAR",HKG,5,0,0,0,5
2011,Nepal,NPL,"China, Hong Kong SAR",HKG,0,0,0,5,5
2011,Pakistan,PAK,"China, Hong Kong SAR",HKG,0,0,0,10,10
2011,Philippines,PHL,"China, Hong Kong SAR",HKG,0,0,5,0,5
2011,Iraq,IRQ,Lebanon,LBN,0,0,0,18,18
2011,Sudan,SDN,Lebanon,LBN,0,0,0,13,13
2011,Afghanistan,AFG,Syrian Arab Rep.,SYR,5,0,0,0,5
2011,China,CHN,Thailand,THA,14,0,0,5,19
2011,Iraq,IRQ,Thailand,THA,0,0,0,5,5
2011,Sri Lanka,LKA,Thailand,THA,0,0,5,19,24
2011,Pakistan,PAK,Thailand,THA,5,0,0,5,10
2011,Viet Nam,VNM,Thailand,THA,0,0,0,28,28
2011,Afghanistan,AFG,Turkey,TUR,15,0,0,0,15
2011,Iran (Islamic Rep. of),IRN,Turkey,TUR,70,0,10,0,80
2011,Iraq,IRQ,Turkey,TUR,0,0,0,10,10
2011,Morocco,MAR,Turkey,TUR,0,0,0,10,10
2011,Somalia,SOM,Turkey,TUR,5,0,0,0,5
2011,Syrian Arab Rep.,SYR,Turkey,TUR,0,0,0,5,5
2012,Central African Rep.,CAF,Cameroon,CMR,0,0,0,28,28
2012,Chad,TCD,Cameroon,CMR,0,0,0,13,13
2012,Dem. Rep. of the Congo,COD,Cameroon,CMR,0,0,5,0,5
2012,Guinea,GIN,Cameroon,CMR,0,0,0,5,5
2012,Rwanda,RWA,Cameroon,CMR,0,0,14,0,14
2012,India,IND,"China, Hong Kong SAR",HKG,0,0,0,5,5
2012,Indonesia,IDN,"China, Hong Kong SAR",HKG,0,0,0,11,11
2012,Sri Lanka,LKA,"China, Hong Kong SAR",HKG,0,0,0,5,5
2012,Nepal,NPL,"China, Hong Kong SAR",HKG,0,0,5,0,5
2012,Egypt,EGY,Lebanon,LBN,0,0,0,5,5
2012,Iraq,IRQ,Lebanon,LBN,0,0,0,52,52
2012,Sudan,SDN,Lebanon,LBN,0,0,0,15,15
2012,Chad,TCD,Syrian Arab Rep.,SYR,0,0,0,5,5
2012,Iraq,IRQ,Syrian Arab Rep.,SYR,0,0,5,0,5
2012,Somalia,SOM,Syrian Arab Rep.,SYR,5,0,0,0,5
2012,Sudan,SDN,Syrian Arab Rep.,SYR,11,0,0,0,11
2012,Cambodia,KHM,Thailand,THA,10,0,17,0,27
2012,China,CHN,Thailand,THA,14,0,5,0,19
2012,Dem. Rep. of the Congo,COD,Thailand,THA,0,0,14,0,14
2012,Iran (Islamic Rep. of),IRN,Thailand,THA,5,0,0,0,5
2012,Iraq,IRQ,Thailand,THA,0,0,0,5,5
2012,Sri Lanka,LKA,Thailand,THA,0,0,24,5,29
2012,Pakistan,PAK,Thailand,THA,0,0,5,0,5
2012,Viet Nam,VNM,Thailand,THA,0,0,30,24,54
2012,Iran (Islamic Rep. of),IRN,Turkey,TUR,11,0,0,5,16
2012,Iraq,IRQ,Turkey,TUR,0,0,0,5,5
2012,Kazakhstan,KAZ,Turkey,TUR,0,0,0,5,5
2012,Somalia,SOM,Turkey,TUR,11,0,0,0,11
2012,Yemen,YEM,Turkey,TUR,0,0,0,5,5
2012,Stateless,XXA,Turkey,TUR,0,0,0,11,11
2013,Cameroon,CMR,Algeria,DZA,0,0,14,20,34
2013,Dem. Rep. of the Congo,COD,Algeria,DZA,0,0,0,5,5
2013,Cote d'Ivoire,CIV,Algeria,DZA,0,0,10,13,23
2013,Liberia,LBR,Algeria,DZA,0,0,5,0,5
2013,Central African Rep.,CAF,Cameroon,CMR,5,0,0,11,16
2013,Chad,TCD,Cameroon,CMR,0,0,0,10,10
2013,Cote d'Ivoire,CIV,Cameroon,CMR,0,0,5,0,5
2013,Indonesia,IDN,"China, Hong Kong SAR",HKG,0,0,0,10,10
2013,Sri Lanka,LKA,"China, Hong Kong SAR",HKG,0,0,0,11,11
2013,Philippines,PHL,"China, Hong Kong SAR",HKG,0,0,5,0,5
2013,Iraq,IRQ,Lebanon,LBN,0,0,71,0,71
2013,Syrian Arab Rep.,SYR,Lebanon,LBN,5,0,0,0,5
2013,Afghanistan,AFG,Syrian Arab Rep.,SYR,11,0,0,0,11
2013,Chad,TCD,Syrian Arab Rep.,SYR,0,0,5,0,5
2013,Iraq,IRQ,Syrian Arab Rep.,SYR,0,0,5,0,5
2013,Sudan,SDN,Syrian Arab Rep.,SYR,42,0,5,0,47
2013,Cambodia,KHM,Thailand,THA,5,0,0,0,5
2013,China,CHN,Thailand,THA,5,0,0,0,5
2013,Sri Lanka,LKA,Thailand,THA,0,0,0,5,5
2013,Viet Nam,VNM,Thailand,THA,12,0,0,0,12
2013,Afghanistan,AFG,Turkey,TUR,5,0,0,0,5
2013,Bangladesh,BGD,Turkey,TUR,0,0,0,5,5
2013,Iran (Islamic Rep. of),IRN,Turkey,TUR,42,0,11,0,53
2013,Iraq,IRQ,Turkey,TUR,0,0,5,12,17
2013,Pakistan,PAK,Turkey,TUR,5,0,0,0,5
2013,Somalia,SOM,Turkey,TUR,0,0,0,18,18
2013,Syrian Arab Rep.,SYR,Turkey,TUR,16,0,0,0,16
2013,Uzbekistan,UZB,Turkey,TUR,0,0,0,14,14
2014,Dem. Rep. of the Congo,COD,Algeria,DZA,0,0,5,0,5
2014,Eritrea,ERI,Egypt,EGY,16,0,31,0,47
2014,Ethiopia,ETH,Egypt,EGY,5,0,24,0,29
2014,Iraq,IRQ,Egypt,EGY,66,0,0,0,66
2014,Somalia,SOM,Egypt,EGY,5,0,5,0,10
2014,Sudan,SDN,Egypt,EGY,291,0,50,0,341
2014,South Sudan,SSD,Egypt,EGY,32,0,0,0,32
2014,Yemen,YEM,Egypt,EGY,5,0,0,0,5
2014,Central African Rep.,CAF,Cameroon,CMR,68,0,0,0,68
2014,Egypt,EGY,Jordan,JOR,0,0,5,0,5
2014,Iraq,IRQ,Jordan,JOR,12,0,0,0,12
2014,Sudan,SDN,Jordan,JOR,10,0,0,0,10
2014,Afghanistan,AFG,Syrian Arab Rep.,SYR,17,0,0,0,17
2014,Chad,TCD,Syrian Arab Rep.,SYR,5,0,0,0,5
2014,Ethiopia,ETH,Syrian Arab Rep.,SYR,5,0,0,0,5
2014,Iran (Islamic Rep. of),IRN,Syrian Arab Rep.,SYR,0,0,5,0,5
2014,Iraq,IRQ,Syrian Arab Rep.,SYR,20,0,0,5,25
2014,Jordan,JOR,Syrian Arab Rep.,SYR,0,0,0,5,5
2014,Lebanon,LBN,Syrian Arab Rep.,SYR,0,0,0,11,11
2014,Somalia,SOM,Syrian Arab Rep.,SYR,0,0,0,11,11
2014,Sudan,SDN,Syrian Arab Rep.,SYR,60,0,0,0,60
2014,South Sudan,SSD,Syrian Arab Rep.,SYR,42,0,0,0,42
2014,Yemen,YEM,Syrian Arab Rep.,SYR,0,0,0,10,10
2014,Stateless,XXA,Syrian Arab Rep.,SYR,0,0,5,0,5
2014,Cambodia,KHM,Thailand,THA,0,0,0,11,11
2014,China,CHN,Thailand,THA,5,0,0,0,5
2014,Iran (Islamic Rep. of),IRN,Thailand,THA,0,0,0,5,5
2014,Iraq,IRQ,Thailand,THA,0,0,0,5,5
2014,Sri Lanka,LKA,Thailand,THA,18,0,0,5,23
2014,Viet Nam,VNM,Thailand,THA,40,0,5,0,45
2014,Iran (Islamic Rep. of),IRN,Turkey,TUR,11,0,10,0,21
2014,Morocco,MAR,Turkey,TUR,0,0,0,5,5
2015,Central African Rep.,CAF,Algeria,DZA,5,0,0,0,5
2015,Guinea,GIN,Algeria,DZA,0,0,0,5,5
2015,Cote d'Ivoire,CIV,Algeria,DZA,0,0,0,5,5
2015,Libya,LBY,Algeria,DZA,0,0,0,10,10
2015,Mali,MLI,Algeria,DZA,0,0,0,5,5
2015,Syrian Arab Rep.,SYR,Algeria,DZA,0,0,0,5,5
2015,Eritrea,ERI,Egypt,EGY,5,0,0,0,5
2015,Ethiopia,ETH,Egypt,EGY,10,0,0,0,10
2015,Iraq,IRQ,Egypt,EGY,34,0,0,0,34
2015,Somalia,SOM,Egypt,EGY,18,0,0,0,18
2015,Sudan,SDN,Egypt,EGY,197,0,5,0,202
2015,South Sudan,SSD,Egypt,EGY,16,0,0,0,16
2015,Central African Rep.,CAF,Cameroon,CMR,397,0,0,25,422
2015,Sudan,SDN,Cameroon,CMR,5,0,0,0,5
2015,Iraq,IRQ,Jordan,JOR,57,0,0,0,57
2015,Sudan,SDN,Jordan,JOR,13,0,0,0,13
2015,Afghanistan,AFG,Syrian Arab Rep.,SYR,13,0,5,0,18
2015,Egypt,EGY,Syrian Arab Rep.,SYR,5,0,10,0,15
2015,Ethiopia,ETH,Syrian Arab Rep.,SYR,5,0,0,0,5
2015,Iran (Islamic Rep. of),IRN,Syrian Arab Rep.,SYR,0,0,17,0,17
2015,Iraq,IRQ,Syrian Arab Rep.,SYR,22,0,0,0,22
2015,Lebanon,LBN,Syrian Arab Rep.,SYR,0,0,5,0,5
2015,Pakistan,PAK,Syrian Arab Rep.,SYR,0,0,5,0,5
2015,Sudan,SDN,Syrian Arab Rep.,SYR,36,0,26,5,67
2015,Tajikistan,TJK,Syrian Arab Rep.,SYR,5,0,0,0,5
2015,Turkey,TUR,Syrian Arab Rep.,SYR,0,0,5,0,5
2015,Cambodia,KHM,Thailand,THA,5,0,0,0,5
2015,China,CHN,Thailand,THA,5,0,0,0,5
2015,Sri Lanka,LKA,Thailand,THA,14,0,11,0,25
2015,Pakistan,PAK,Thailand,THA,0,0,5,0,5
2015,Viet Nam,VNM,Thailand,THA,40,0,5,0,45
2015,Afghanistan,AFG,Turkey,TUR,15,0,0,17,32
2015,Iran (Islamic Rep. of),IRN,Turkey,TUR,50,0,19,91,160
2015,Iraq,IRQ,Turkey,TUR,10,0,0,359,369
2015,Somalia,SOM,Turkey,TUR,5,0,0,5,10
2015,Sudan,SDN,Turkey,TUR,5,0,0,0,5
2016,Central African Rep.,CAF,Algeria,DZA,5,0,0,0,5
2016,Cote d'Ivoire,CIV,Algeria,DZA,0,0,0,5,5
2016,Mali,MLI,Algeria,DZA,0,0,5,5,10
2016,Syrian Arab Rep.,SYR,Algeria,DZA,0,0,0,5,5
2016,Eritrea,ERI,Egypt,EGY,0,0,12,0,12
2016,Guinea-Bissau,GNB,Egypt,EGY,0,0,0,5,5
2016,Somalia,SOM,Egypt,EGY,10,0,0,0,10
2016,Sudan,SDN,Egypt,EGY,90,0,29,0,119
2016,South Sudan,SSD,Egypt,EGY,25,0,0,0,25
2016,Central African Rep.,CAF,Cameroon,CMR,662,0,0,148,810
2016,Chad,TCD,Cameroon,CMR,0,0,5,13,18
2016,Dem. Rep. of the Congo,COD,Cameroon,CMR,0,0,0,5,5
2016,Guinea,GIN,Cameroon,CMR,0,0,5,5,10
2016,Cote d'Ivoire,CIV,Cameroon,CMR,0,0,0,5,5
2016,Sudan,SDN,Jordan,JOR,11,0,0,0,11
2016,Cambodia,KHM,Thailand,THA,12,0,0,5,17
2016,Pakistan,PAK,Thailand,THA,0,0,5,0,5
2016,Viet Nam,VNM,Thailand,THA,5,0,19,5,29
2016,Syrian Arab Rep.,SYR,Thailand,THA,0,0,0,5,5
2016,Afghanistan,AFG,Turkey,TUR,10,0,0,15,25
2016,Iran (Islamic Rep. of),IRN,Turkey,TUR,39,0,16,21,76
2016,Iraq,IRQ,Turkey,TUR,5,0,0,93,98
2017,Cote d'Ivoire,CIV,Algeria,DZA,0,0,5,5,10
2017,Mali,MLI,Algeria,DZA,0,0,5,0,5
2017,Syrian Arab Rep.,SYR,Algeria,DZA,5,0,0,0,5
2017,Eritrea,ERI,Egypt,EGY,5,0,0,0,5
2017,Somalia,SOM,Egypt,EGY,5,0,0,0,5
2017,Sudan,SDN,Egypt,EGY,72,0,0,5,77
2017,South Sudan,SSD,Egypt,EGY,38,0,0,0,38
2017,Central African Rep.,CAF,Cameroon,CMR,86,0,0,66,152
2017,Chad,TCD,Cameroon,CMR,0,0,0,5,5
2017,Dem. Rep. of the Congo,COD,Cameroon,CMR,0,0,0,5,5
2017,Pakistan,PAK,Thailand,THA,5,0,5,0,10
2017,Viet Nam,VNM,Thailand,THA,16,0,11,0,27
2017,Afghanistan,AFG,Turkey,TUR,0,0,0,10,10
2017,Iran (Islamic Rep. of),IRN,Turkey,TUR,5,0,10,52,67
2017,Iraq,IRQ,Turkey,TUR,5,0,0,11,16
2018,Cameroon,CMR,Algeria,DZA,0,0,0,5,5
2018,Guinea,GIN,Algeria,DZA,0,0,5,5,10
2018,Cote d'Ivoire,CIV,Algeria,DZA,0,0,0,11,11
2018,Mali,MLI,Algeria,DZA,0,0,0,5,5
2018,Syrian Arab Rep.,SYR,Algeria,DZA,0,0,0,5,5
2018,Eritrea,ERI,Egypt,EGY,0,0,15,0,15
2018,Ethiopia,ETH,Egypt,EGY,0,0,17,0,17
2018,Iraq,IRQ,Egypt,EGY,0,0,5,0,5
2018,Nigeria,NGA,Egypt,EGY,0,0,0,10,10
2018,Somalia,SOM,Egypt,EGY,5,0,15,5,25
2018,Sudan,SDN,Egypt,EGY,71,0,291,12,374
2018,South Sudan,SSD,Egypt,EGY,67,0,0,0,67
2018,Central African Rep.,CAF,Cameroon,CMR,103,0,5,48,156
2018,Chad,TCD,Cameroon,CMR,0,0,12,0,12
2018,Dem. Rep. of the Congo,COD,Cameroon,CMR,5,0,0,0,5
2018,Cote d'Ivoire,CIV,Cameroon,CMR,0,0,0,5,5
2018,China,CHN,Thailand,THA,0,0,5,0,5
2018,Pakistan,PAK,Thailand,THA,12,0,0,0,12
2018,Viet Nam,VNM,Thailand,THA,5,0,11,5,21
2018,Afghanistan,AFG,Turkey,TUR,0,0,0,5,5
2018,Iran (Islamic Rep. of),IRN,Turkey,TUR,5,0,0,0,5
2019,Cameroon,CMR,Algeria,DZA,0,0,5,0,5
2019,Guinea,GIN,Algeria,DZA,0,0,0,5,5
2019,Cote d'Ivoire,CIV,Algeria,DZA,0,0,0,11,11
2019,Libya,LBY,Algeria,DZA,0,0,0,5,5
2019,Mali,MLI,Algeria,DZA,0,0,5,0,5
2019,Syrian Arab Rep.,SYR,Algeria,DZA,0,0,0,42,42
2019,Yemen,YEM,Algeria,DZA,0,0,0,5,5
2019,Eritrea,ERI,Egypt,EGY,0,0,5,0,5
2019,Ethiopia,ETH,Egypt,EGY,0,0,5,5,10
2019,Sudan,SDN,Egypt,EGY,33,0,11,10,54
2019,South Sudan,SSD,Egypt,EGY,37,0,0,0,37
2019,Central African Rep.,CAF,Cameroon,CMR,38,0,0,30,68
2019,Chad,TCD,Cameroon,CMR,0,0,0,29,29
2019,Dem. Rep. of the Congo,COD,Cameroon,CMR,0,0,0,12,12
2019,Guinea,GIN,Cameroon,CMR,0,0,0,11,11
2019,Pakistan,PAK,Thailand,THA,0,0,14,0,14
2019,Viet Nam,VNM,Thailand,THA,0,0,0,5,5
2020,Cameroon,CMR,Algeria,DZA,0,0,0,5,5
2020,Guinea,GIN,Algeria,DZA,0,0,0,5,5
2020,Cote d'Ivoire,CIV,Algeria,DZA,0,0,0,5,5
2020,Mali,MLI,Algeria,DZA,5,0,0,5,10
2020,Sudan,SDN,Egypt,EGY,14,0,0,0,14
2020,South Sudan,SSD,Egypt,EGY,10,0,0,0,10
2020,Central African Rep.,CAF,Cameroon,CMR,26,0,0,127,153
2020,Chad,TCD,Cameroon,CMR,0,0,0,5,5
2020,Rwanda,RWA,Cameroon,CMR,0,0,0,10,10
2020,Egypt,EGY,Jordan,JOR,0,0,0,5,5
2020,Sudan,SDN,Jordan,JOR,0,0,0,15,15
2020,Yemen,YEM,Jordan,JOR,0,0,0,14,14
2020,Pakistan,PAK,Thailand,THA,0,0,5,0,5
2020,Somalia,SOM,Thailand,THA,5,0,0,0,5
2020,Viet Nam,VNM,Thailand,THA,5,0,0,0,5
2021,Cameroon,CMR,Algeria,DZA,0,0,0,5,5
2021,Guinea,GIN,Algeria,DZA,0,0,0,5,5
2021,Cote d'Ivoire,CIV,Algeria,DZA,0,0,0,5,5
2021,Mali,MLI,Algeria,DZA,5,0,0,5,10
2021,Dem. Rep. of the Congo,COD,Egypt,EGY,0,0,0,10,10
2021,Eritrea,ERI,Egypt,EGY,0,0,0,93,93
2021,Ethiopia,ETH,Egypt,EGY,0,0,0,152,152
2021,Nigeria,NGA,Egypt,EGY,0,0,0,5,5
2021,Somalia,SOM,Egypt,EGY,0,0,0,53,53
2021,Sudan,SDN,Egypt,EGY,5,0,0,827,832
2021,Uzbekistan,UZB,Egypt,EGY,0,0,0,5,5
2021,Central African Rep.,CAF,Cameroon,CMR,5,0,0,90,95
2021,Chad,TCD,Cameroon,CMR,0,0,0,5,5
2021,Cote d'Ivoire,CIV,Cameroon,CMR,0,0,0,5,5
2021,Sri Lanka,LKA,Indonesia,IDN,5,0,0,0,5
2021,Somalia,SOM,Syrian Arab Rep.,SYR,5,0,0,0,5
2021,Cambodia,KHM,Thailand,THA,5,0,0,0,5
2021,Dem. Rep. of the Congo,COD,Thailand,THA,5,0,0,0,5
2021,Iran (Islamic Rep. of),IRN,Thailand,THA,5,0,0,0,5
2021,Pakistan,PAK,Thailand,THA,15,0,10,0,25
2021,Viet Nam,VNM,Thailand,THA,17,0,5,0,22
